date,country,country_population,state_province,state_province_population,new_cases,new_deaths,cumulative_cases,cumulative_deaths
2020-03-14,Argentina,NA,Buenos Aires Province,17370144,2,0,12,2
2020-03-15,Argentina,NA,Buenos Aires Province,17370144,0,0,12,2
2020-03-16,Argentina,NA,Buenos Aires Province,17370144,3,0,15,3
2020-03-17,Argentina,NA,Buenos Aires Province,17370144,3,3,18,3
2020-03-18,Argentina,NA,Buenos Aires Province,17370144,10,0,28,5
2020-03-19,Argentina,NA,Buenos Aires Province,17370144,11,2,39,7
2020-03-20,Argentina,NA,Buenos Aires Province,17370144,8,0,47,8
2020-03-21,Argentina,NA,Buenos Aires Province,17370144,14,2,61,10
2020-03-22,Argentina,NA,Buenos Aires Province,17370144,10,1,71,11
2020-03-23,Argentina,NA,Buenos Aires Province,17370144,9,1,80,12
2020-03-24,Argentina,NA,Buenos Aires Province,17370144,31,4,111,16
2020-03-25,Argentina,NA,Buenos Aires Province,17370144,42,1,153,17
2020-03-26,Argentina,NA,Buenos Aires Province,17370144,35,8,188,25
2020-03-27,Argentina,NA,Buenos Aires Province,17370144,25,5,213,30
2020-03-28,Argentina,NA,Buenos Aires Province,17370144,12,10,225,40
2020-03-29,Argentina,NA,Buenos Aires Province,17370144,19,9,244,48
2020-03-30,Argentina,NA,Buenos Aires Province,17370144,22,6,266,53
2020-03-31,Argentina,NA,Buenos Aires Province,17370144,21,8,287,57
2020-04-01,Argentina,NA,Buenos Aires Province,17370144,29,5,316,63
2020-04-02,Argentina,NA,Buenos Aires Province,17370144,31,11,347,69
2020-04-03,Argentina,NA,Buenos Aires Province,17370144,32,9,379,75
2020-04-04,Argentina,NA,Buenos Aires Province,17370144,31,8,410,82
2020-04-05,Argentina,NA,Buenos Aires Province,17370144,13,18,423,84
2020-04-06,Argentina,NA,Buenos Aires Province,17370144,32,16,455,91
2020-04-07,Argentina,NA,Buenos Aires Province,17370144,17,12,472,94
2020-04-08,Argentina,NA,Buenos Aires Province,17370144,23,14,495,99
2020-04-09,Argentina,NA,Buenos Aires Province,17370144,20,12,515,103
2020-04-10,Argentina,NA,Buenos Aires Province,17370144,43,9,558,111
2020-04-11,Argentina,NA,Buenos Aires Province,17370144,18,9,576,115
2020-04-12,Argentina,NA,Buenos Aires Province,17370144,35,12,611,122
2020-04-13,Argentina,NA,Buenos Aires Province,17370144,23,16,634,126
2020-04-14,Argentina,NA,Buenos Aires Province,17370144,63,11,697,139
2020-04-15,Argentina,NA,Buenos Aires Province,17370144,50,18,747,149
2020-04-16,Argentina,NA,Buenos Aires Province,17370144,41,15,788,157
2020-04-17,Argentina,NA,Buenos Aires Province,17370144,35,15,823,164
2020-04-18,Argentina,NA,Buenos Aires Province,17370144,59,18,882,176
2020-04-19,Argentina,NA,Buenos Aires Province,17370144,26,14,908,181
2020-04-20,Argentina,NA,Buenos Aires Province,17370144,48,13,956,191
2020-04-21,Argentina,NA,Buenos Aires Province,17370144,62,16,1018,203
2020-04-22,Argentina,NA,Buenos Aires Province,17370144,59,18,1077,215
2020-04-23,Argentina,NA,Buenos Aires Province,17370144,69,19,1146,229
2020-04-24,Argentina,NA,Buenos Aires Province,17370144,77,14,1223,244
2020-04-25,Argentina,NA,Buenos Aires Province,17370144,79,13,1302,260
2020-04-26,Argentina,NA,Buenos Aires Province,17370144,30,17,1332,266
2020-04-27,Argentina,NA,Buenos Aires Province,17370144,67,32,1399,279
2020-04-28,Argentina,NA,Buenos Aires Province,17370144,62,16,1461,292
2020-04-29,Argentina,NA,Buenos Aires Province,17370144,89,11,1550,310
2020-04-30,Argentina,NA,Buenos Aires Province,17370144,47,16,1597,319
2020-05-01,Argentina,NA,Buenos Aires Province,17370144,48,17,1645,329
2020-05-02,Argentina,NA,Buenos Aires Province,17370144,39,9,1684,336
2020-05-03,Argentina,NA,Buenos Aires Province,17370144,31,17,1715,343
2020-05-04,Argentina,NA,Buenos Aires Province,17370144,46,14,1761,352
2020-05-05,Argentina,NA,Buenos Aires Province,17370144,77,10,1838,367
2020-05-06,Argentina,NA,Buenos Aires Province,17370144,58,13,1896,379
2020-05-07,Argentina,NA,Buenos Aires Province,17370144,58,22,1954,390
2020-05-08,Argentina,NA,Buenos Aires Province,17370144,74,12,2028,405
2020-05-09,Argentina,NA,Buenos Aires Province,17370144,57,18,2085,417
2020-05-10,Argentina,NA,Buenos Aires Province,17370144,39,17,2124,424
2020-05-11,Argentina,NA,Buenos Aires Province,17370144,57,16,2181,436
2020-05-12,Argentina,NA,Buenos Aires Province,17370144,89,18,2270,454
2020-05-13,Argentina,NA,Buenos Aires Province,17370144,95,14,2365,473
2020-05-14,Argentina,NA,Buenos Aires Province,17370144,92,17,2457,491
2020-05-15,Argentina,NA,Buenos Aires Province,17370144,97,17,2554,510
2020-05-16,Argentina,NA,Buenos Aires Province,17370144,118,21,2672,534
2020-05-17,Argentina,NA,Buenos Aires Province,17370144,53,13,2725,545
2020-05-18,Argentina,NA,Buenos Aires Province,17370144,156,17,2881,576
2020-05-19,Argentina,NA,Buenos Aires Province,17370144,154,15,3035,607
2020-05-20,Argentina,NA,Buenos Aires Province,17370144,194,24,3229,645
2020-05-21,Argentina,NA,Buenos Aires Province,17370144,266,19,3495,699
2020-05-22,Argentina,NA,Buenos Aires Province,17370144,298,25,3793,758
2020-05-23,Argentina,NA,Buenos Aires Province,17370144,224,14,4017,803
2020-05-24,Argentina,NA,Buenos Aires Province,17370144,153,12,4170,834
2020-05-25,Argentina,NA,Buenos Aires Province,17370144,245,24,4415,883
2020-05-26,Argentina,NA,Buenos Aires Province,17370144,270,17,4685,922
2020-05-27,Argentina,NA,Buenos Aires Province,17370144,268,17,4953,939
2020-05-28,Argentina,NA,Buenos Aires Province,17370144,260,18,5213,957
2020-05-29,Argentina,NA,Buenos Aires Province,17370144,331,17,5544,974
2020-05-30,Argentina,NA,Buenos Aires Province,17370144,313,23,5857,997
2020-05-31,Argentina,NA,Buenos Aires Province,17370144,201,23,6058,1020
2020-06-01,Argentina,NA,Buenos Aires Province,17370144,414,27,6472,1047
2020-06-02,Argentina,NA,Buenos Aires Province,17370144,475,24,6947,1071
2020-06-03,Argentina,NA,Buenos Aires Province,17370144,400,28,7347,1099
2020-06-04,Argentina,NA,Buenos Aires Province,17370144,385,25,7732,1124
2020-06-05,Argentina,NA,Buenos Aires Province,17370144,442,23,8174,1147
2020-06-06,Argentina,NA,Buenos Aires Province,17370144,553,31,8727,1178
2020-06-07,Argentina,NA,Buenos Aires Province,17370144,236,31,8963,1209
2020-06-08,Argentina,NA,Buenos Aires Province,17370144,457,34,9420,1243
2020-06-09,Argentina,NA,Buenos Aires Province,17370144,679,29,10099,1272
2020-06-10,Argentina,NA,Buenos Aires Province,17370144,690,30,10789,1302
2020-06-11,Argentina,NA,Buenos Aires Province,17370144,814,24,11603,1326
2020-06-12,Argentina,NA,Buenos Aires Province,17370144,811,24,12414,1350
2020-06-13,Argentina,NA,Buenos Aires Province,17370144,835,31,13249,1381
2020-06-14,Argentina,NA,Buenos Aires Province,17370144,481,32,13730,1413
2020-06-15,Argentina,NA,Buenos Aires Province,17370144,700,33,14430,1446
2020-06-16,Argentina,NA,Buenos Aires Province,17370144,880,39,15310,1485
2020-06-17,Argentina,NA,Buenos Aires Province,17370144,1072,34,16382,1519
2020-06-18,Argentina,NA,Buenos Aires Province,17370144,1102,36,17484,1555
2020-06-19,Argentina,NA,Buenos Aires Province,17370144,1158,30,18642,1585
2020-06-20,Argentina,NA,Buenos Aires Province,17370144,1422,29,20064,1614
2020-06-21,Argentina,NA,Buenos Aires Province,17370144,628,43,20692,1657
2020-06-22,Argentina,NA,Buenos Aires Province,17370144,1144,42,21836,1699
2020-06-23,Argentina,NA,Buenos Aires Province,17370144,1452,39,23288,1738
2020-06-24,Argentina,NA,Buenos Aires Province,17370144,1414,47,24702,1785
2020-06-25,Argentina,NA,Buenos Aires Province,17370144,1738,38,26440,1823
2020-06-26,Argentina,NA,Buenos Aires Province,17370144,1836,60,28276,1883
2020-06-27,Argentina,NA,Buenos Aires Province,17370144,1487,57,29763,1940
2020-06-28,Argentina,NA,Buenos Aires Province,17370144,962,48,30725,1988
2020-06-29,Argentina,NA,Buenos Aires Province,17370144,1347,44,32072,2032
2020-06-30,Argentina,NA,Buenos Aires Province,17370144,1745,61,33817,2093
2020-07-01,Argentina,NA,Buenos Aires Province,17370144,1779,73,35596,2166
2020-07-02,Argentina,NA,Buenos Aires Province,17370144,1737,61,37333,2227
2020-07-03,Argentina,NA,Buenos Aires Province,17370144,2143,56,39476,2283
2020-07-04,Argentina,NA,Buenos Aires Province,17370144,2206,79,41682,2362
2020-07-05,Argentina,NA,Buenos Aires Province,17370144,1060,82,42742,2444
2020-07-06,Argentina,NA,Buenos Aires Province,17370144,1757,71,44499,2515
2020-07-07,Argentina,NA,Buenos Aires Province,17370144,2127,72,46626,2587
2020-07-08,Argentina,NA,Buenos Aires Province,17370144,2672,95,49298,2682
2020-07-09,Argentina,NA,Buenos Aires Province,17370144,2364,78,51662,2760
2020-07-10,Argentina,NA,Buenos Aires Province,17370144,2339,104,54001,2864
2020-07-11,Argentina,NA,Buenos Aires Province,17370144,2196,88,56197,2952
2020-07-12,Argentina,NA,Buenos Aires Province,17370144,1254,70,57451,3022
2020-07-13,Argentina,NA,Buenos Aires Province,17370144,2185,86,59636,3108
2020-07-14,Argentina,NA,Buenos Aires Province,17370144,2718,95,62354,3203
2020-07-15,Argentina,NA,Buenos Aires Province,17370144,2707,115,65061,3318
2020-07-16,Argentina,NA,Buenos Aires Province,17370144,3018,81,68079,3399
2020-07-17,Argentina,NA,Buenos Aires Province,17370144,3159,98,71238,3497
2020-07-18,Argentina,NA,Buenos Aires Province,17370144,3037,118,74275,3615
2020-07-19,Argentina,NA,Buenos Aires Province,17370144,1854,99,76129,3714
2020-07-20,Argentina,NA,Buenos Aires Province,17370144,3071,100,79200,3814
2020-07-21,Argentina,NA,Buenos Aires Province,17370144,3630,117,82830,3931
2020-07-22,Argentina,NA,Buenos Aires Province,17370144,4047,126,86877,4057
2020-07-23,Argentina,NA,Buenos Aires Province,17370144,4114,107,90991,4164
2020-07-24,Argentina,NA,Buenos Aires Province,17370144,4405,111,95396,4275
2020-07-25,Argentina,NA,Buenos Aires Province,17370144,3422,104,98818,4379
2020-07-26,Argentina,NA,Buenos Aires Province,17370144,2125,119,100943,4498
2020-07-27,Argentina,NA,Buenos Aires Province,17370144,3602,136,104545,4634
2020-07-28,Argentina,NA,Buenos Aires Province,17370144,4165,117,108710,4751
2020-07-29,Argentina,NA,Buenos Aires Province,17370144,4513,127,113223,4878
2020-07-30,Argentina,NA,Buenos Aires Province,17370144,4296,123,117519,5001
2020-07-31,Argentina,NA,Buenos Aires Province,17370144,5010,129,122529,5130
2020-08-01,Argentina,NA,Buenos Aires Province,17370144,3453,111,125982,5241
2020-08-02,Argentina,NA,Buenos Aires Province,17370144,2909,127,128891,5368
2020-08-03,Argentina,NA,Buenos Aires Province,17370144,4094,141,132985,5509
2020-08-04,Argentina,NA,Buenos Aires Province,17370144,4850,116,137835,5625
2020-08-05,Argentina,NA,Buenos Aires Province,17370144,5591,130,143426,5755
2020-08-06,Argentina,NA,Buenos Aires Province,17370144,5452,148,148878,5903
2020-08-07,Argentina,NA,Buenos Aires Province,17370144,5720,142,154598,6045
2020-08-08,Argentina,NA,Buenos Aires Province,17370144,4447,134,159045,6179
2020-08-09,Argentina,NA,Buenos Aires Province,17370144,2739,137,161784,6316
2020-08-10,Argentina,NA,Buenos Aires Province,17370144,4434,157,166218,6473
2020-08-11,Argentina,NA,Buenos Aires Province,17370144,4827,116,171045,6589
2020-08-12,Argentina,NA,Buenos Aires Province,17370144,4918,141,175963,6730
2020-08-13,Argentina,NA,Buenos Aires Province,17370144,4788,132,180751,6862
2020-08-14,Argentina,NA,Buenos Aires Province,17370144,4488,150,185239,7012
2020-08-15,Argentina,NA,Buenos Aires Province,17370144,4164,134,189403,7146
2020-08-16,Argentina,NA,Buenos Aires Province,17370144,1782,122,191185,7268
2020-08-17,Argentina,NA,Buenos Aires Province,17370144,3239,164,194424,7432
2020-08-18,Argentina,NA,Buenos Aires Province,17370144,4087,144,198511,7576
2020-08-19,Argentina,NA,Buenos Aires Province,17370144,5029,136,203540,7712
2020-08-20,Argentina,NA,Buenos Aires Province,17370144,5663,121,209203,7833
2020-08-21,Argentina,NA,Buenos Aires Province,17370144,5106,136,214309,7969
2020-08-22,Argentina,NA,Buenos Aires Province,17370144,4572,132,218881,8101
2020-08-23,Argentina,NA,Buenos Aires Province,17370144,2424,115,221305,8216
2020-08-24,Argentina,NA,Buenos Aires Province,17370144,4847,175,226152,8391
2020-08-25,Argentina,NA,Buenos Aires Province,17370144,5486,125,231638,8516
2020-08-26,Argentina,NA,Buenos Aires Province,17370144,6168,117,237806,8633
2020-08-27,Argentina,NA,Buenos Aires Province,17370144,6539,125,244345,8758
2020-08-28,Argentina,NA,Buenos Aires Province,17370144,5901,133,250246,8891
2020-08-29,Argentina,NA,Buenos Aires Province,17370144,4916,140,255162,9031
2020-08-30,Argentina,NA,Buenos Aires Province,17370144,3163,125,258325,9156
2020-08-31,Argentina,NA,Buenos Aires Province,17370144,5167,140,263492,9296
2020-09-01,Argentina,NA,Buenos Aires Province,17370144,5796,118,269288,9414
2020-09-02,Argentina,NA,Buenos Aires Province,17370144,5847,105,275135,9519
2020-09-03,Argentina,NA,Buenos Aires Province,17370144,5371,115,280506,9634
2020-09-04,Argentina,NA,Buenos Aires Province,17370144,4974,104,285480,9738
2020-09-05,Argentina,NA,Buenos Aires Province,17370144,4584,114,290064,9852
2020-09-06,Argentina,NA,Buenos Aires Province,17370144,2523,103,292587,9955
2020-09-07,Argentina,NA,Buenos Aires Province,17370144,4769,118,297356,10073
2020-09-08,Argentina,NA,Buenos Aires Province,17370144,5844,95,303200,10168
2020-09-09,Argentina,NA,Buenos Aires Province,17370144,5904,108,309104,10276
2020-09-10,Argentina,NA,Buenos Aires Province,17370144,5293,100,314397,10376
2020-09-11,Argentina,NA,Buenos Aires Province,17370144,5699,109,320096,10485
2020-09-12,Argentina,NA,Buenos Aires Province,17370144,4472,83,324568,10568
2020-09-13,Argentina,NA,Buenos Aires Province,17370144,2379,106,326947,10674
2020-09-14,Argentina,NA,Buenos Aires Province,17370144,4683,115,331630,10789
2020-09-15,Argentina,NA,Buenos Aires Province,17370144,5102,93,336732,10882
2020-09-16,Argentina,NA,Buenos Aires Province,17370144,5033,89,341765,10971
2020-09-17,Argentina,NA,Buenos Aires Province,17370144,5274,86,347039,11057
2020-09-18,Argentina,NA,Buenos Aires Province,17370144,4664,77,351703,11134
2020-09-19,Argentina,NA,Buenos Aires Province,17370144,3539,77,355242,11211
2020-09-20,Argentina,NA,Buenos Aires Province,17370144,1768,67,357010,11278
2020-09-21,Argentina,NA,Buenos Aires Province,17370144,3731,70,360741,11348
2020-09-22,Argentina,NA,Buenos Aires Province,17370144,3938,54,364679,11402
2020-09-23,Argentina,NA,Buenos Aires Province,17370144,3970,49,368649,11451
2020-03-16,Argentina,NA,Chaco,1192616,4,0,11,1
2020-03-17,Argentina,NA,Chaco,1192616,1,0,12,1
2020-03-18,Argentina,NA,Chaco,1192616,1,0,13,1
2020-03-19,Argentina,NA,Chaco,1192616,2,0,15,1
2020-03-20,Argentina,NA,Chaco,1192616,1,0,16,1
2020-03-21,Argentina,NA,Chaco,1192616,5,0,21,1
2020-03-22,Argentina,NA,Chaco,1192616,7,0,28,1
2020-03-23,Argentina,NA,Chaco,1192616,4,0,32,1
2020-03-24,Argentina,NA,Chaco,1192616,14,1,46,2
2020-03-25,Argentina,NA,Chaco,1192616,2,4,48,6
2020-03-26,Argentina,NA,Chaco,1192616,7,1,55,7
2020-03-27,Argentina,NA,Chaco,1192616,4,0,59,7
2020-03-28,Argentina,NA,Chaco,1192616,5,1,64,8
2020-03-29,Argentina,NA,Chaco,1192616,13,0,77,8
2020-03-30,Argentina,NA,Chaco,1192616,3,1,80,9
2020-03-31,Argentina,NA,Chaco,1192616,4,1,84,10
2020-04-01,Argentina,NA,Chaco,1192616,8,2,92,12
2020-04-02,Argentina,NA,Chaco,1192616,9,1,101,13
2020-04-03,Argentina,NA,Chaco,1192616,5,0,106,13
2020-04-04,Argentina,NA,Chaco,1192616,2,0,108,13
2020-04-06,Argentina,NA,Chaco,1192616,10,2,118,15
2020-04-07,Argentina,NA,Chaco,1192616,12,0,130,15
2020-04-08,Argentina,NA,Chaco,1192616,3,1,133,16
2020-04-09,Argentina,NA,Chaco,1192616,6,0,139,16
2020-04-10,Argentina,NA,Chaco,1192616,0,0,139,16
2020-04-11,Argentina,NA,Chaco,1192616,1,1,140,17
2020-04-12,Argentina,NA,Chaco,1192616,1,0,141,17
2020-04-13,Argentina,NA,Chaco,1192616,26,1,167,18
2020-04-14,Argentina,NA,Chaco,1192616,2,2,169,20
2020-04-15,Argentina,NA,Chaco,1192616,14,4,183,24
2020-04-16,Argentina,NA,Chaco,1192616,22,1,205,25
2020-04-17,Argentina,NA,Chaco,1192616,16,0,221,25
2020-04-18,Argentina,NA,Chaco,1192616,9,0,230,25
2020-04-19,Argentina,NA,Chaco,1192616,3,3,233,28
2020-04-20,Argentina,NA,Chaco,1192616,4,1,237,29
2020-04-21,Argentina,NA,Chaco,1192616,7,3,244,32
2020-04-22,Argentina,NA,Chaco,1192616,6,1,250,33
2020-04-23,Argentina,NA,Chaco,1192616,7,1,257,34
2020-04-24,Argentina,NA,Chaco,1192616,14,2,271,36
2020-04-25,Argentina,NA,Chaco,1192616,6,1,277,37
2020-04-26,Argentina,NA,Chaco,1192616,8,0,285,37
2020-04-27,Argentina,NA,Chaco,1192616,3,1,288,38
2020-04-28,Argentina,NA,Chaco,1192616,4,2,292,40
2020-04-29,Argentina,NA,Chaco,1192616,3,1,295,41
2020-04-30,Argentina,NA,Chaco,1192616,14,0,309,41
2020-05-01,Argentina,NA,Chaco,1192616,17,4,326,45
2020-05-02,Argentina,NA,Chaco,1192616,4,4,330,49
2020-05-03,Argentina,NA,Chaco,1192616,4,3,334,52
2020-05-04,Argentina,NA,Chaco,1192616,12,3,346,55
2020-05-05,Argentina,NA,Chaco,1192616,7,1,353,56
2020-05-06,Argentina,NA,Chaco,1192616,24,3,377,59
2020-05-07,Argentina,NA,Chaco,1192616,33,1,410,60
2020-05-08,Argentina,NA,Chaco,1192616,11,2,421,62
2020-05-09,Argentina,NA,Chaco,1192616,33,1,454,63
2020-05-10,Argentina,NA,Chaco,1192616,22,2,476,65
2020-05-11,Argentina,NA,Chaco,1192616,0,4,476,69
2020-05-12,Argentina,NA,Chaco,1192616,18,2,494,71
2020-05-13,Argentina,NA,Chaco,1192616,19,2,513,73
2020-05-14,Argentina,NA,Chaco,1192616,27,1,540,74
2020-05-15,Argentina,NA,Chaco,1192616,16,5,556,79
2020-05-16,Argentina,NA,Chaco,1192616,25,3,581,82
2020-05-17,Argentina,NA,Chaco,1192616,14,2,595,84
2020-05-18,Argentina,NA,Chaco,1192616,25,5,620,89
2020-05-19,Argentina,NA,Chaco,1192616,31,1,651,90
2020-05-20,Argentina,NA,Chaco,1192616,25,2,676,92
2020-05-21,Argentina,NA,Chaco,1192616,25,0,701,92
2020-05-22,Argentina,NA,Chaco,1192616,26,4,727,96
2020-05-23,Argentina,NA,Chaco,1192616,23,1,750,97
2020-05-24,Argentina,NA,Chaco,1192616,5,1,755,98
2020-05-25,Argentina,NA,Chaco,1192616,18,2,773,100
2020-05-26,Argentina,NA,Chaco,1192616,14,2,787,102
2020-05-27,Argentina,NA,Chaco,1192616,33,2,820,104
2020-05-28,Argentina,NA,Chaco,1192616,24,6,844,110
2020-05-29,Argentina,NA,Chaco,1192616,28,2,872,112
2020-05-30,Argentina,NA,Chaco,1192616,17,2,889,114
2020-05-31,Argentina,NA,Chaco,1192616,2,3,891,117
2020-06-01,Argentina,NA,Chaco,1192616,32,4,923,121
2020-06-02,Argentina,NA,Chaco,1192616,8,1,931,122
2020-06-03,Argentina,NA,Chaco,1192616,49,3,980,125
2020-06-04,Argentina,NA,Chaco,1192616,40,2,1020,127
2020-06-05,Argentina,NA,Chaco,1192616,19,3,1039,130
2020-06-06,Argentina,NA,Chaco,1192616,19,1,1058,131
2020-06-07,Argentina,NA,Chaco,1192616,37,1,1095,132
2020-06-08,Argentina,NA,Chaco,1192616,37,3,1132,135
2020-06-09,Argentina,NA,Chaco,1192616,36,0,1168,135
2020-06-10,Argentina,NA,Chaco,1192616,67,5,1235,140
2020-06-11,Argentina,NA,Chaco,1192616,17,1,1252,141
2020-06-12,Argentina,NA,Chaco,1192616,52,4,1304,145
2020-06-13,Argentina,NA,Chaco,1192616,50,0,1354,145
2020-06-14,Argentina,NA,Chaco,1192616,34,6,1388,151
2020-06-15,Argentina,NA,Chaco,1192616,23,0,1411,151
2020-06-16,Argentina,NA,Chaco,1192616,25,0,1436,151
2020-06-17,Argentina,NA,Chaco,1192616,59,3,1495,154
2020-06-18,Argentina,NA,Chaco,1192616,45,2,1540,156
2020-06-19,Argentina,NA,Chaco,1192616,38,8,1578,164
2020-06-20,Argentina,NA,Chaco,1192616,55,1,1633,165
2020-06-21,Argentina,NA,Chaco,1192616,26,1,1659,166
2020-06-22,Argentina,NA,Chaco,1192616,45,4,1704,170
2020-06-23,Argentina,NA,Chaco,1192616,54,3,1758,173
2020-06-24,Argentina,NA,Chaco,1192616,40,1,1798,174
2020-06-25,Argentina,NA,Chaco,1192616,41,3,1839,177
2020-06-26,Argentina,NA,Chaco,1192616,89,3,1928,180
2020-06-27,Argentina,NA,Chaco,1192616,70,2,1998,182
2020-06-28,Argentina,NA,Chaco,1192616,29,3,2027,185
2020-06-29,Argentina,NA,Chaco,1192616,43,3,2070,188
2020-06-30,Argentina,NA,Chaco,1192616,48,2,2118,190
2020-07-01,Argentina,NA,Chaco,1192616,81,5,2199,195
2020-07-02,Argentina,NA,Chaco,1192616,42,2,2241,197
2020-07-03,Argentina,NA,Chaco,1192616,58,6,2299,203
2020-07-04,Argentina,NA,Chaco,1192616,46,3,2345,206
2020-07-05,Argentina,NA,Chaco,1192616,26,1,2371,207
2020-07-06,Argentina,NA,Chaco,1192616,25,1,2396,208
2020-07-07,Argentina,NA,Chaco,1192616,58,0,2454,208
2020-07-08,Argentina,NA,Chaco,1192616,32,5,2486,213
2020-07-09,Argentina,NA,Chaco,1192616,49,2,2535,215
2020-07-10,Argentina,NA,Chaco,1192616,57,4,2592,219
2020-07-11,Argentina,NA,Chaco,1192616,25,5,2617,224
2020-07-12,Argentina,NA,Chaco,1192616,22,3,2639,227
2020-07-13,Argentina,NA,Chaco,1192616,77,6,2716,233
2020-07-14,Argentina,NA,Chaco,1192616,67,3,2783,236
2020-07-15,Argentina,NA,Chaco,1192616,37,2,2820,238
2020-07-16,Argentina,NA,Chaco,1192616,59,2,2879,240
2020-07-17,Argentina,NA,Chaco,1192616,50,2,2929,242
2020-07-18,Argentina,NA,Chaco,1192616,50,3,2979,245
2020-07-19,Argentina,NA,Chaco,1192616,29,2,3008,247
2020-07-20,Argentina,NA,Chaco,1192616,42,2,3050,249
2020-07-21,Argentina,NA,Chaco,1192616,74,2,3124,251
2020-07-22,Argentina,NA,Chaco,1192616,49,2,3173,253
2020-07-23,Argentina,NA,Chaco,1192616,58,5,3231,258
2020-07-24,Argentina,NA,Chaco,1192616,39,1,3270,259
2020-07-25,Argentina,NA,Chaco,1192616,71,2,3341,261
2020-07-26,Argentina,NA,Chaco,1192616,27,3,3368,264
2020-07-27,Argentina,NA,Chaco,1192616,22,2,3390,266
2020-07-28,Argentina,NA,Chaco,1192616,82,4,3472,270
2020-07-29,Argentina,NA,Chaco,1192616,65,2,3537,272
2020-07-30,Argentina,NA,Chaco,1192616,56,3,3593,275
2020-07-31,Argentina,NA,Chaco,1192616,51,2,3644,277
2020-08-01,Argentina,NA,Chaco,1192616,44,2,3688,279
2020-08-02,Argentina,NA,Chaco,1192616,29,5,3717,284
2020-08-03,Argentina,NA,Chaco,1192616,55,5,3772,289
2020-08-04,Argentina,NA,Chaco,1192616,69,2,3841,291
2020-08-05,Argentina,NA,Chaco,1192616,47,2,3888,293
2020-08-06,Argentina,NA,Chaco,1192616,75,5,3963,298
2020-08-07,Argentina,NA,Chaco,1192616,54,1,4017,299
2020-08-08,Argentina,NA,Chaco,1192616,73,1,4090,300
2020-08-09,Argentina,NA,Chaco,1192616,14,2,4104,302
2020-08-10,Argentina,NA,Chaco,1192616,64,3,4168,305
2020-08-11,Argentina,NA,Chaco,1192616,70,2,4238,307
2020-08-12,Argentina,NA,Chaco,1192616,58,5,4296,312
2020-08-13,Argentina,NA,Chaco,1192616,53,4,4349,316
2020-08-14,Argentina,NA,Chaco,1192616,38,6,4387,322
2020-08-15,Argentina,NA,Chaco,1192616,73,1,4460,323
2020-08-16,Argentina,NA,Chaco,1192616,69,3,4529,326
2020-08-17,Argentina,NA,Chaco,1192616,55,2,4584,328
2020-08-18,Argentina,NA,Chaco,1192616,50,2,4634,330
2020-08-19,Argentina,NA,Chaco,1192616,79,3,4713,333
2020-08-20,Argentina,NA,Chaco,1192616,60,2,4773,335
2020-08-21,Argentina,NA,Chaco,1192616,53,1,4826,336
2020-08-22,Argentina,NA,Chaco,1192616,52,5,4878,341
2020-08-23,Argentina,NA,Chaco,1192616,40,3,4918,344
2020-08-24,Argentina,NA,Chaco,1192616,50,7,4968,351
2020-08-25,Argentina,NA,Chaco,1192616,85,8,5053,359
2020-08-26,Argentina,NA,Chaco,1192616,52,2,5105,361
2020-08-27,Argentina,NA,Chaco,1192616,75,3,5180,364
2020-08-28,Argentina,NA,Chaco,1192616,93,4,5273,368
2020-08-29,Argentina,NA,Chaco,1192616,70,2,5343,370
2020-08-30,Argentina,NA,Chaco,1192616,63,3,5406,373
2020-08-31,Argentina,NA,Chaco,1192616,76,3,5482,376
2020-09-01,Argentina,NA,Chaco,1192616,85,1,5567,377
2020-09-02,Argentina,NA,Chaco,1192616,107,5,5674,382
2020-09-03,Argentina,NA,Chaco,1192616,94,2,5768,384
2020-09-04,Argentina,NA,Chaco,1192616,124,2,5892,386
2020-09-05,Argentina,NA,Chaco,1192616,124,3,6016,389
2020-09-06,Argentina,NA,Chaco,1192616,45,3,6061,392
2020-09-07,Argentina,NA,Chaco,1192616,92,1,6153,393
2020-09-08,Argentina,NA,Chaco,1192616,122,2,6275,395
2020-09-09,Argentina,NA,Chaco,1192616,144,4,6419,399
2020-09-10,Argentina,NA,Chaco,1192616,97,5,6516,404
2020-09-11,Argentina,NA,Chaco,1192616,134,5,6650,409
2020-09-12,Argentina,NA,Chaco,1192616,98,3,6748,412
2020-09-13,Argentina,NA,Chaco,1192616,53,2,6801,414
2020-09-14,Argentina,NA,Chaco,1192616,84,4,6885,418
2020-09-15,Argentina,NA,Chaco,1192616,118,6,7003,424
2020-09-16,Argentina,NA,Chaco,1192616,108,4,7111,428
2020-09-17,Argentina,NA,Chaco,1192616,118,3,7229,431
2020-09-18,Argentina,NA,Chaco,1192616,133,7,7362,438
2020-09-19,Argentina,NA,Chaco,1192616,67,6,7429,444
2020-09-20,Argentina,NA,Chaco,1192616,70,3,7499,447
2020-09-21,Argentina,NA,Chaco,1192616,85,2,7584,449
2020-09-22,Argentina,NA,Chaco,1192616,96,3,7680,452
2020-09-23,Argentina,NA,Chaco,1192616,102,2,7782,454
2020-06-02,Argentina,NA,Chubut,618994,1,0,11,2
2020-06-03,Argentina,NA,Chubut,618994,0,0,11,2
2020-06-04,Argentina,NA,Chubut,618994,3,0,14,2
2020-06-05,Argentina,NA,Chubut,618994,1,0,15,3
2020-06-06,Argentina,NA,Chubut,618994,6,0,21,4
2020-06-07,Argentina,NA,Chubut,618994,0,0,21,4
2020-06-08,Argentina,NA,Chubut,618994,5,0,26,5
2020-06-09,Argentina,NA,Chubut,618994,1,0,27,5
2020-06-10,Argentina,NA,Chubut,618994,0,1,27,5
2020-06-11,Argentina,NA,Chubut,618994,3,0,30,6
2020-06-12,Argentina,NA,Chubut,618994,9,0,39,7
2020-06-13,Argentina,NA,Chubut,618994,2,0,41,8
2020-06-14,Argentina,NA,Chubut,618994,23,0,64,12
2020-06-15,Argentina,NA,Chubut,618994,9,0,73,13
2020-06-16,Argentina,NA,Chubut,618994,0,0,73,13
2020-06-17,Argentina,NA,Chubut,618994,11,0,84,13
2020-06-18,Argentina,NA,Chubut,618994,3,0,87,13
2020-06-19,Argentina,NA,Chubut,618994,2,0,89,13
2020-06-20,Argentina,NA,Chubut,618994,6,0,95,13
2020-06-21,Argentina,NA,Chubut,618994,4,0,99,13
2020-06-22,Argentina,NA,Chubut,618994,1,0,100,13
2020-06-23,Argentina,NA,Chubut,618994,3,0,103,13
2020-06-24,Argentina,NA,Chubut,618994,1,0,104,13
2020-06-25,Argentina,NA,Chubut,618994,9,2,113,15
2020-06-26,Argentina,NA,Chubut,618994,1,0,114,15
2020-06-27,Argentina,NA,Chubut,618994,5,0,119,15
2020-06-28,Argentina,NA,Chubut,618994,1,0,120,15
2020-06-29,Argentina,NA,Chubut,618994,7,0,127,15
2020-06-30,Argentina,NA,Chubut,618994,4,0,131,15
2020-07-01,Argentina,NA,Chubut,618994,5,0,136,15
2020-07-02,Argentina,NA,Chubut,618994,8,0,144,15
2020-07-03,Argentina,NA,Chubut,618994,5,0,149,15
2020-07-04,Argentina,NA,Chubut,618994,9,0,158,15
2020-07-05,Argentina,NA,Chubut,618994,3,0,161,15
2020-07-06,Argentina,NA,Chubut,618994,5,0,166,15
2020-07-07,Argentina,NA,Chubut,618994,10,0,176,15
2020-07-08,Argentina,NA,Chubut,618994,19,0,195,15
2020-07-09,Argentina,NA,Chubut,618994,4,1,199,16
2020-07-10,Argentina,NA,Chubut,618994,8,0,207,16
2020-07-11,Argentina,NA,Chubut,618994,1,0,208,16
2020-07-12,Argentina,NA,Chubut,618994,8,0,216,16
2020-07-13,Argentina,NA,Chubut,618994,1,0,217,16
2020-07-14,Argentina,NA,Chubut,618994,5,0,222,16
2020-07-15,Argentina,NA,Chubut,618994,1,0,223,16
2020-07-16,Argentina,NA,Chubut,618994,7,0,230,16
2020-07-17,Argentina,NA,Chubut,618994,7,1,237,17
2020-07-18,Argentina,NA,Chubut,618994,3,0,240,17
2020-07-19,Argentina,NA,Chubut,618994,6,0,246,17
2020-07-20,Argentina,NA,Chubut,618994,11,0,257,17
2020-07-21,Argentina,NA,Chubut,618994,1,0,258,17
2020-07-22,Argentina,NA,Chubut,618994,2,0,260,17
2020-07-23,Argentina,NA,Chubut,618994,3,0,263,17
2020-07-24,Argentina,NA,Chubut,618994,3,0,266,17
2020-07-25,Argentina,NA,Chubut,618994,1,0,267,17
2020-07-26,Argentina,NA,Chubut,618994,1,0,268,17
2020-07-27,Argentina,NA,Chubut,618994,4,0,272,17
2020-07-28,Argentina,NA,Chubut,618994,2,0,274,17
2020-07-29,Argentina,NA,Chubut,618994,3,1,277,18
2020-07-30,Argentina,NA,Chubut,618994,2,0,279,18
2020-07-31,Argentina,NA,Chubut,618994,11,0,290,18
2020-08-01,Argentina,NA,Chubut,618994,2,0,292,18
2020-08-02,Argentina,NA,Chubut,618994,4,0,296,18
2020-08-03,Argentina,NA,Chubut,618994,1,0,297,18
2020-08-04,Argentina,NA,Chubut,618994,7,0,304,18
2020-08-05,Argentina,NA,Chubut,618994,5,0,309,18
2020-08-06,Argentina,NA,Chubut,618994,11,0,320,18
2020-08-07,Argentina,NA,Chubut,618994,7,0,327,18
2020-08-08,Argentina,NA,Chubut,618994,20,0,347,18
2020-08-09,Argentina,NA,Chubut,618994,5,0,352,18
2020-08-10,Argentina,NA,Chubut,618994,5,0,357,18
2020-08-11,Argentina,NA,Chubut,618994,7,1,364,19
2020-08-12,Argentina,NA,Chubut,618994,20,0,384,19
2020-08-13,Argentina,NA,Chubut,618994,9,0,393,19
2020-08-14,Argentina,NA,Chubut,618994,2,0,395,19
2020-08-15,Argentina,NA,Chubut,618994,9,0,404,19
2020-08-16,Argentina,NA,Chubut,618994,14,0,418,19
2020-08-17,Argentina,NA,Chubut,618994,9,0,427,19
2020-08-18,Argentina,NA,Chubut,618994,12,1,439,20
2020-08-19,Argentina,NA,Chubut,618994,19,0,458,20
2020-08-20,Argentina,NA,Chubut,618994,12,1,470,21
2020-08-21,Argentina,NA,Chubut,618994,44,0,514,21
2020-08-22,Argentina,NA,Chubut,618994,26,0,540,21
2020-08-23,Argentina,NA,Chubut,618994,18,0,558,21
2020-08-24,Argentina,NA,Chubut,618994,33,0,591,21
2020-08-25,Argentina,NA,Chubut,618994,73,0,664,21
2020-08-26,Argentina,NA,Chubut,618994,45,0,709,21
2020-08-27,Argentina,NA,Chubut,618994,67,1,776,22
2020-08-28,Argentina,NA,Chubut,618994,57,0,833,22
2020-08-29,Argentina,NA,Chubut,618994,37,0,870,22
2020-08-30,Argentina,NA,Chubut,618994,38,0,908,22
2020-08-31,Argentina,NA,Chubut,618994,46,0,954,22
2020-09-01,Argentina,NA,Chubut,618994,37,0,991,22
2020-09-02,Argentina,NA,Chubut,618994,85,0,1076,22
2020-09-03,Argentina,NA,Chubut,618994,51,1,1127,23
2020-09-04,Argentina,NA,Chubut,618994,54,1,1181,24
2020-09-05,Argentina,NA,Chubut,618994,38,0,1219,24
2020-09-06,Argentina,NA,Chubut,618994,24,1,1243,25
2020-09-07,Argentina,NA,Chubut,618994,55,1,1298,26
2020-09-08,Argentina,NA,Chubut,618994,58,0,1356,26
2020-09-09,Argentina,NA,Chubut,618994,29,0,1385,26
2020-09-10,Argentina,NA,Chubut,618994,58,2,1443,28
2020-09-11,Argentina,NA,Chubut,618994,104,2,1547,30
2020-09-12,Argentina,NA,Chubut,618994,39,3,1586,33
2020-09-13,Argentina,NA,Chubut,618994,10,1,1596,34
2020-09-14,Argentina,NA,Chubut,618994,46,3,1642,37
2020-09-15,Argentina,NA,Chubut,618994,83,1,1725,38
2020-09-16,Argentina,NA,Chubut,618994,48,0,1773,38
2020-09-17,Argentina,NA,Chubut,618994,98,2,1871,40
2020-09-18,Argentina,NA,Chubut,618994,83,2,1954,42
2020-09-19,Argentina,NA,Chubut,618994,36,0,1990,42
2020-09-20,Argentina,NA,Chubut,618994,8,0,1998,42
2020-09-21,Argentina,NA,Chubut,618994,61,0,2059,42
2020-09-22,Argentina,NA,Chubut,618994,34,0,2093,42
2020-09-23,Argentina,NA,Chubut,618994,27,0,2120,42
2020-03-11,Argentina,NA,City of Buenos Aires,3063728,2,0,12,2
2020-03-12,Argentina,NA,City of Buenos Aires,3063728,1,0,13,2
2020-03-13,Argentina,NA,City of Buenos Aires,3063728,3,0,16,3
2020-03-14,Argentina,NA,City of Buenos Aires,3063728,5,0,21,3
2020-03-15,Argentina,NA,City of Buenos Aires,3063728,7,1,28,4
2020-03-16,Argentina,NA,City of Buenos Aires,3063728,3,0,31,4
2020-03-17,Argentina,NA,City of Buenos Aires,3063728,6,1,37,5
2020-03-18,Argentina,NA,City of Buenos Aires,3063728,17,1,54,6
2020-03-19,Argentina,NA,City of Buenos Aires,3063728,3,3,57,9
2020-03-20,Argentina,NA,City of Buenos Aires,3063728,10,1,67,10
2020-03-21,Argentina,NA,City of Buenos Aires,3063728,27,0,94,10
2020-03-22,Argentina,NA,City of Buenos Aires,3063728,12,1,106,11
2020-03-23,Argentina,NA,City of Buenos Aires,3063728,13,0,119,11
2020-03-24,Argentina,NA,City of Buenos Aires,3063728,27,3,146,14
2020-03-25,Argentina,NA,City of Buenos Aires,3063728,32,3,178,17
2020-03-26,Argentina,NA,City of Buenos Aires,3063728,45,1,223,18
2020-03-27,Argentina,NA,City of Buenos Aires,3063728,23,5,246,23
2020-03-28,Argentina,NA,City of Buenos Aires,3063728,23,6,269,29
2020-03-29,Argentina,NA,City of Buenos Aires,3063728,20,4,289,33
2020-03-30,Argentina,NA,City of Buenos Aires,3063728,16,4,305,37
2020-03-31,Argentina,NA,City of Buenos Aires,3063728,26,3,331,40
2020-04-01,Argentina,NA,City of Buenos Aires,3063728,20,5,351,45
2020-04-02,Argentina,NA,City of Buenos Aires,3063728,34,0,385,45
2020-04-03,Argentina,NA,City of Buenos Aires,3063728,33,4,418,49
2020-04-04,Argentina,NA,City of Buenos Aires,3063728,36,9,454,58
2020-04-05,Argentina,NA,City of Buenos Aires,3063728,20,6,474,64
2020-04-06,Argentina,NA,City of Buenos Aires,3063728,37,8,511,72
2020-04-07,Argentina,NA,City of Buenos Aires,3063728,13,3,524,75
2020-04-08,Argentina,NA,City of Buenos Aires,3063728,28,8,552,83
2020-04-09,Argentina,NA,City of Buenos Aires,3063728,24,16,576,99
2020-04-10,Argentina,NA,City of Buenos Aires,3063728,24,6,600,105
2020-04-11,Argentina,NA,City of Buenos Aires,3063728,8,6,608,111
2020-04-12,Argentina,NA,City of Buenos Aires,3063728,8,6,616,117
2020-04-13,Argentina,NA,City of Buenos Aires,3063728,9,4,625,121
2020-04-14,Argentina,NA,City of Buenos Aires,3063728,16,9,641,128
2020-04-15,Argentina,NA,City of Buenos Aires,3063728,32,11,673,134
2020-04-16,Argentina,NA,City of Buenos Aires,3063728,18,9,691,138
2020-04-17,Argentina,NA,City of Buenos Aires,3063728,15,11,706,141
2020-04-18,Argentina,NA,City of Buenos Aires,3063728,25,2,731,146
2020-04-19,Argentina,NA,City of Buenos Aires,3063728,19,7,750,150
2020-04-20,Argentina,NA,City of Buenos Aires,3063728,15,8,765,153
2020-04-21,Argentina,NA,City of Buenos Aires,3063728,53,8,818,163
2020-04-22,Argentina,NA,City of Buenos Aires,3063728,24,9,842,168
2020-04-23,Argentina,NA,City of Buenos Aires,3063728,49,7,891,178
2020-04-24,Argentina,NA,City of Buenos Aires,3063728,76,12,967,193
2020-04-25,Argentina,NA,City of Buenos Aires,3063728,55,9,1022,204
2020-04-26,Argentina,NA,City of Buenos Aires,3063728,33,6,1055,211
2020-04-27,Argentina,NA,City of Buenos Aires,3063728,39,8,1094,218
2020-04-28,Argentina,NA,City of Buenos Aires,3063728,42,11,1136,227
2020-04-29,Argentina,NA,City of Buenos Aires,3063728,27,12,1163,232
2020-04-30,Argentina,NA,City of Buenos Aires,3063728,26,8,1189,237
2020-05-01,Argentina,NA,City of Buenos Aires,3063728,57,14,1246,249
2020-05-02,Argentina,NA,City of Buenos Aires,3063728,47,4,1293,258
2020-05-03,Argentina,NA,City of Buenos Aires,3063728,41,7,1334,266
2020-05-04,Argentina,NA,City of Buenos Aires,3063728,53,7,1387,277
2020-05-05,Argentina,NA,City of Buenos Aires,3063728,77,5,1464,292
2020-05-06,Argentina,NA,City of Buenos Aires,3063728,103,6,1567,311
2020-05-07,Argentina,NA,City of Buenos Aires,3063728,134,9,1701,320
2020-05-08,Argentina,NA,City of Buenos Aires,3063728,104,6,1805,326
2020-05-09,Argentina,NA,City of Buenos Aires,3063728,146,10,1951,336
2020-05-10,Argentina,NA,City of Buenos Aires,3063728,120,13,2071,349
2020-05-11,Argentina,NA,City of Buenos Aires,3063728,169,9,2240,358
2020-05-12,Argentina,NA,City of Buenos Aires,3063728,168,6,2408,364
2020-05-13,Argentina,NA,City of Buenos Aires,3063728,192,11,2600,375
2020-05-14,Argentina,NA,City of Buenos Aires,3063728,169,2,2769,377
2020-05-15,Argentina,NA,City of Buenos Aires,3063728,264,8,3033,385
2020-05-16,Argentina,NA,City of Buenos Aires,3063728,168,10,3201,395
2020-05-17,Argentina,NA,City of Buenos Aires,3063728,150,11,3351,406
2020-05-18,Argentina,NA,City of Buenos Aires,3063728,179,8,3530,414
2020-05-19,Argentina,NA,City of Buenos Aires,3063728,334,5,3864,419
2020-05-20,Argentina,NA,City of Buenos Aires,3063728,370,9,4234,428
2020-05-21,Argentina,NA,City of Buenos Aires,3063728,435,10,4669,438
2020-05-22,Argentina,NA,City of Buenos Aires,3063728,474,7,5143,445
2020-05-23,Argentina,NA,City of Buenos Aires,3063728,356,7,5499,452
2020-05-24,Argentina,NA,City of Buenos Aires,3063728,334,18,5833,470
2020-05-25,Argentina,NA,City of Buenos Aires,3063728,278,10,6111,480
2020-05-26,Argentina,NA,City of Buenos Aires,3063728,347,13,6458,493
2020-05-27,Argentina,NA,City of Buenos Aires,3063728,397,9,6855,502
2020-05-28,Argentina,NA,City of Buenos Aires,3063728,465,14,7320,516
2020-05-29,Argentina,NA,City of Buenos Aires,3063728,446,15,7766,531
2020-05-30,Argentina,NA,City of Buenos Aires,3063728,349,15,8115,546
2020-05-31,Argentina,NA,City of Buenos Aires,3063728,317,8,8432,554
2020-06-01,Argentina,NA,City of Buenos Aires,3063728,370,11,8802,565
2020-06-02,Argentina,NA,City of Buenos Aires,3063728,411,10,9213,575
2020-06-03,Argentina,NA,City of Buenos Aires,3063728,460,15,9673,590
2020-06-04,Argentina,NA,City of Buenos Aires,3063728,420,23,10093,613
2020-06-05,Argentina,NA,City of Buenos Aires,3063728,476,15,10569,628
2020-06-06,Argentina,NA,City of Buenos Aires,3063728,490,18,11059,646
2020-06-07,Argentina,NA,City of Buenos Aires,3063728,292,11,11351,657
2020-06-08,Argentina,NA,City of Buenos Aires,3063728,505,20,11856,677
2020-06-09,Argentina,NA,City of Buenos Aires,3063728,603,12,12459,689
2020-06-10,Argentina,NA,City of Buenos Aires,3063728,539,19,12998,708
2020-06-11,Argentina,NA,City of Buenos Aires,3063728,652,23,13650,731
2020-06-12,Argentina,NA,City of Buenos Aires,3063728,680,13,14330,744
2020-06-13,Argentina,NA,City of Buenos Aires,3063728,549,17,14879,761
2020-06-14,Argentina,NA,City of Buenos Aires,3063728,474,26,15353,787
2020-06-15,Argentina,NA,City of Buenos Aires,3063728,508,20,15861,807
2020-06-16,Argentina,NA,City of Buenos Aires,3063728,687,27,16548,834
2020-06-17,Argentina,NA,City of Buenos Aires,3063728,722,24,17270,858
2020-06-18,Argentina,NA,City of Buenos Aires,3063728,799,21,18069,879
2020-06-19,Argentina,NA,City of Buenos Aires,3063728,797,20,18866,899
2020-06-20,Argentina,NA,City of Buenos Aires,3063728,809,24,19675,923
2020-06-21,Argentina,NA,City of Buenos Aires,3063728,742,25,20417,948
2020-06-22,Argentina,NA,City of Buenos Aires,3063728,950,24,21367,972
2020-06-23,Argentina,NA,City of Buenos Aires,3063728,975,27,22342,999
2020-06-24,Argentina,NA,City of Buenos Aires,3063728,952,17,23294,1016
2020-06-25,Argentina,NA,City of Buenos Aires,3063728,1016,26,24310,1042
2020-06-26,Argentina,NA,City of Buenos Aires,3063728,976,20,25286,1062
2020-06-27,Argentina,NA,City of Buenos Aires,3063728,705,27,25991,1089
2020-06-28,Argentina,NA,City of Buenos Aires,3063728,736,26,26727,1115
2020-06-29,Argentina,NA,City of Buenos Aires,3063728,804,22,27531,1137
2020-06-30,Argentina,NA,City of Buenos Aires,3063728,923,25,28454,1162
2020-07-01,Argentina,NA,City of Buenos Aires,3063728,816,24,29270,1186
2020-07-02,Argentina,NA,City of Buenos Aires,3063728,955,26,30225,1212
2020-07-03,Argentina,NA,City of Buenos Aires,3063728,1052,26,31277,1238
2020-07-04,Argentina,NA,City of Buenos Aires,3063728,911,25,32188,1263
2020-07-05,Argentina,NA,City of Buenos Aires,3063728,771,31,32959,1294
2020-07-06,Argentina,NA,City of Buenos Aires,3063728,956,15,33915,1309
2020-07-07,Argentina,NA,City of Buenos Aires,3063728,1013,31,34928,1340
2020-07-08,Argentina,NA,City of Buenos Aires,3063728,1200,31,36128,1371
2020-07-09,Argentina,NA,City of Buenos Aires,3063728,1009,22,37137,1393
2020-07-10,Argentina,NA,City of Buenos Aires,3063728,964,23,38101,1416
2020-07-11,Argentina,NA,City of Buenos Aires,3063728,870,34,38971,1450
2020-07-12,Argentina,NA,City of Buenos Aires,3063728,642,35,39613,1485
2020-07-13,Argentina,NA,City of Buenos Aires,3063728,970,37,40583,1522
2020-07-14,Argentina,NA,City of Buenos Aires,3063728,1121,43,41704,1565
2020-07-15,Argentina,NA,City of Buenos Aires,3063728,1184,33,42888,1598
2020-07-16,Argentina,NA,City of Buenos Aires,3063728,1108,46,43996,1644
2020-07-17,Argentina,NA,City of Buenos Aires,3063728,1268,28,45264,1672
2020-07-18,Argentina,NA,City of Buenos Aires,3063728,1136,31,46400,1703
2020-07-19,Argentina,NA,City of Buenos Aires,3063728,864,40,47264,1743
2020-07-20,Argentina,NA,City of Buenos Aires,3063728,1279,44,48543,1787
2020-07-21,Argentina,NA,City of Buenos Aires,3063728,1413,35,49956,1822
2020-07-22,Argentina,NA,City of Buenos Aires,3063728,1209,32,51165,1854
2020-07-23,Argentina,NA,City of Buenos Aires,3063728,1247,27,52412,1881
2020-07-24,Argentina,NA,City of Buenos Aires,3063728,1302,39,53714,1920
2020-07-25,Argentina,NA,City of Buenos Aires,3063728,942,27,54656,1947
2020-07-26,Argentina,NA,City of Buenos Aires,3063728,939,32,55595,1979
2020-07-27,Argentina,NA,City of Buenos Aires,3063728,995,41,56590,2020
2020-07-28,Argentina,NA,City of Buenos Aires,3063728,1252,32,57842,2052
2020-07-29,Argentina,NA,City of Buenos Aires,3063728,1154,34,58996,2086
2020-07-30,Argentina,NA,City of Buenos Aires,3063728,1150,39,60146,2125
2020-07-31,Argentina,NA,City of Buenos Aires,3063728,1146,27,61292,2152
2020-08-01,Argentina,NA,City of Buenos Aires,3063728,1055,32,62347,2184
2020-08-02,Argentina,NA,City of Buenos Aires,3063728,1016,50,63363,2234
2020-08-03,Argentina,NA,City of Buenos Aires,3063728,1366,37,64729,2271
2020-08-04,Argentina,NA,City of Buenos Aires,3063728,1459,33,66188,2304
2020-08-05,Argentina,NA,City of Buenos Aires,3063728,1461,39,67649,2343
2020-08-06,Argentina,NA,City of Buenos Aires,3063728,1212,39,68861,2382
2020-08-07,Argentina,NA,City of Buenos Aires,3063728,1216,39,70077,2421
2020-08-08,Argentina,NA,City of Buenos Aires,3063728,1020,33,71097,2454
2020-08-09,Argentina,NA,City of Buenos Aires,3063728,911,38,72008,2492
2020-08-10,Argentina,NA,City of Buenos Aires,3063728,1141,32,73149,2524
2020-08-11,Argentina,NA,City of Buenos Aires,3063728,1118,33,74267,2557
2020-08-12,Argentina,NA,City of Buenos Aires,3063728,1132,40,75399,2597
2020-08-13,Argentina,NA,City of Buenos Aires,3063728,1197,40,76596,2637
2020-08-14,Argentina,NA,City of Buenos Aires,3063728,1174,31,77770,2668
2020-08-15,Argentina,NA,City of Buenos Aires,3063728,1011,34,78781,2702
2020-08-16,Argentina,NA,City of Buenos Aires,3063728,768,38,79549,2740
2020-08-17,Argentina,NA,City of Buenos Aires,3063728,889,35,80438,2775
2020-08-18,Argentina,NA,City of Buenos Aires,3063728,1168,39,81606,2814
2020-08-19,Argentina,NA,City of Buenos Aires,3063728,1348,39,82954,2853
2020-08-20,Argentina,NA,City of Buenos Aires,3063728,1207,24,84161,2877
2020-08-21,Argentina,NA,City of Buenos Aires,3063728,1150,30,85311,2907
2020-08-22,Argentina,NA,City of Buenos Aires,3063728,1022,29,86333,2936
2020-08-23,Argentina,NA,City of Buenos Aires,3063728,760,31,87093,2967
2020-08-24,Argentina,NA,City of Buenos Aires,3063728,1305,26,88398,2993
2020-08-25,Argentina,NA,City of Buenos Aires,3063728,1388,33,89786,3026
2020-08-26,Argentina,NA,City of Buenos Aires,3063728,1448,36,91234,3062
2020-08-27,Argentina,NA,City of Buenos Aires,3063728,1550,28,92784,3090
2020-08-28,Argentina,NA,City of Buenos Aires,3063728,1347,34,94131,3124
2020-08-29,Argentina,NA,City of Buenos Aires,3063728,1042,28,95173,3152
2020-08-30,Argentina,NA,City of Buenos Aires,3063728,1089,31,96262,3183
2020-08-31,Argentina,NA,City of Buenos Aires,3063728,1255,30,97517,3213
2020-09-01,Argentina,NA,City of Buenos Aires,3063728,1311,42,98828,3255
2020-09-02,Argentina,NA,City of Buenos Aires,3063728,1110,28,99938,3283
2020-09-03,Argentina,NA,City of Buenos Aires,3063728,1188,32,101126,3315
2020-09-04,Argentina,NA,City of Buenos Aires,3063728,1061,35,102187,3350
2020-09-05,Argentina,NA,City of Buenos Aires,3063728,1050,25,103237,3375
2020-09-06,Argentina,NA,City of Buenos Aires,3063728,755,27,103992,3402
2020-09-07,Argentina,NA,City of Buenos Aires,3063728,1068,35,105060,3437
2020-09-08,Argentina,NA,City of Buenos Aires,3063728,1267,34,106327,3471
2020-09-09,Argentina,NA,City of Buenos Aires,3063728,1283,41,107610,3512
2020-09-10,Argentina,NA,City of Buenos Aires,3063728,1121,38,108731,3550
2020-09-11,Argentina,NA,City of Buenos Aires,3063728,1172,39,109903,3589
2020-09-12,Argentina,NA,City of Buenos Aires,3063728,872,34,110775,3623
2020-09-13,Argentina,NA,City of Buenos Aires,3063728,760,29,111535,3652
2020-09-14,Argentina,NA,City of Buenos Aires,3063728,903,32,112438,3684
2020-09-15,Argentina,NA,City of Buenos Aires,3063728,966,36,113404,3720
2020-09-16,Argentina,NA,City of Buenos Aires,3063728,923,25,114327,3745
2020-09-17,Argentina,NA,City of Buenos Aires,3063728,950,25,115277,3770
2020-09-18,Argentina,NA,City of Buenos Aires,3063728,810,28,116087,3798
2020-09-19,Argentina,NA,City of Buenos Aires,3063728,769,30,116856,3828
2020-09-20,Argentina,NA,City of Buenos Aires,3063728,524,25,117380,3853
2020-09-21,Argentina,NA,City of Buenos Aires,3063728,659,16,118039,3869
2020-09-22,Argentina,NA,City of Buenos Aires,3063728,813,25,118852,3894
2020-09-23,Argentina,NA,City of Buenos Aires,3063728,726,17,119578,3911
2020-03-20,Argentina,NA,Cordoba,3722332,4,0,12,0
2020-03-21,Argentina,NA,Cordoba,3722332,0,0,12,0
2020-03-22,Argentina,NA,Cordoba,3722332,8,0,20,0
2020-03-23,Argentina,NA,Cordoba,3722332,3,0,23,0
2020-03-24,Argentina,NA,Cordoba,3722332,6,0,29,0
2020-03-25,Argentina,NA,Cordoba,3722332,8,2,37,2
2020-03-26,Argentina,NA,Cordoba,3722332,1,0,38,2
2020-03-27,Argentina,NA,Cordoba,3722332,1,0,39,2
2020-03-28,Argentina,NA,Cordoba,3722332,3,0,42,2
2020-03-29,Argentina,NA,Cordoba,3722332,17,1,59,3
2020-03-30,Argentina,NA,Cordoba,3722332,9,1,68,4
2020-03-31,Argentina,NA,Cordoba,3722332,5,0,73,4
2020-04-01,Argentina,NA,Cordoba,3722332,16,0,89,4
2020-04-02,Argentina,NA,Cordoba,3722332,20,0,109,4
2020-04-03,Argentina,NA,Cordoba,3722332,4,0,113,4
2020-04-04,Argentina,NA,Cordoba,3722332,5,0,118,4
2020-04-05,Argentina,NA,Cordoba,3722332,8,1,126,5
2020-04-06,Argentina,NA,Cordoba,3722332,7,2,133,7
2020-04-07,Argentina,NA,Cordoba,3722332,5,0,138,7
2020-04-08,Argentina,NA,Cordoba,3722332,6,0,144,7
2020-04-09,Argentina,NA,Cordoba,3722332,20,0,164,7
2020-04-10,Argentina,NA,Cordoba,3722332,33,0,197,7
2020-04-11,Argentina,NA,Cordoba,3722332,6,1,203,8
2020-04-12,Argentina,NA,Cordoba,3722332,6,0,209,8
2020-04-13,Argentina,NA,Cordoba,3722332,14,2,223,10
2020-04-14,Argentina,NA,Cordoba,3722332,14,0,237,10
2020-04-15,Argentina,NA,Cordoba,3722332,2,2,239,12
2020-04-16,Argentina,NA,Cordoba,3722332,6,3,245,15
2020-04-17,Argentina,NA,Cordoba,3722332,2,0,247,15
2020-04-18,Argentina,NA,Cordoba,3722332,11,0,258,15
2020-04-19,Argentina,NA,Cordoba,3722332,0,1,258,16
2020-04-20,Argentina,NA,Cordoba,3722332,1,2,259,18
2020-04-21,Argentina,NA,Cordoba,3722332,2,1,261,19
2020-04-22,Argentina,NA,Cordoba,3722332,4,1,265,20
2020-04-23,Argentina,NA,Cordoba,3722332,2,1,267,21
2020-04-24,Argentina,NA,Cordoba,3722332,1,1,268,22
2020-04-25,Argentina,NA,Cordoba,3722332,1,1,269,23
2020-04-26,Argentina,NA,Cordoba,3722332,2,0,271,23
2020-04-27,Argentina,NA,Cordoba,3722332,2,3,273,26
2020-04-28,Argentina,NA,Cordoba,3722332,0,2,273,28
2020-04-29,Argentina,NA,Cordoba,3722332,3,0,276,28
2020-04-30,Argentina,NA,Cordoba,3722332,13,0,289,28
2020-05-01,Argentina,NA,Cordoba,3722332,13,2,302,30
2020-05-02,Argentina,NA,Cordoba,3722332,0,3,302,33
2020-05-03,Argentina,NA,Cordoba,3722332,7,0,309,33
2020-05-04,Argentina,NA,Cordoba,3722332,1,3,310,36
2020-05-05,Argentina,NA,Cordoba,3722332,6,1,316,37
2020-05-06,Argentina,NA,Cordoba,3722332,2,0,318,37
2020-05-07,Argentina,NA,Cordoba,3722332,3,0,321,37
2020-05-08,Argentina,NA,Cordoba,3722332,3,0,324,37
2020-05-09,Argentina,NA,Cordoba,3722332,8,0,332,37
2020-05-10,Argentina,NA,Cordoba,3722332,14,0,346,37
2020-05-11,Argentina,NA,Cordoba,3722332,3,1,349,38
2020-05-12,Argentina,NA,Cordoba,3722332,7,0,356,38
2020-05-13,Argentina,NA,Cordoba,3722332,8,0,364,38
2020-05-14,Argentina,NA,Cordoba,3722332,3,2,367,40
2020-05-15,Argentina,NA,Cordoba,3722332,7,0,374,40
2020-05-16,Argentina,NA,Cordoba,3722332,18,0,392,40
2020-05-17,Argentina,NA,Cordoba,3722332,16,1,408,41
2020-05-18,Argentina,NA,Cordoba,3722332,16,1,424,42
2020-05-19,Argentina,NA,Cordoba,3722332,3,1,427,43
2020-05-20,Argentina,NA,Cordoba,3722332,12,1,439,44
2020-05-21,Argentina,NA,Cordoba,3722332,8,1,447,45
2020-05-22,Argentina,NA,Cordoba,3722332,0,1,447,46
2020-05-23,Argentina,NA,Cordoba,3722332,0,0,447,46
2020-05-24,Argentina,NA,Cordoba,3722332,6,1,453,47
2020-05-25,Argentina,NA,Cordoba,3722332,1,0,454,47
2020-05-26,Argentina,NA,Cordoba,3722332,0,2,454,49
2020-05-27,Argentina,NA,Cordoba,3722332,1,0,455,49
2020-05-28,Argentina,NA,Cordoba,3722332,0,0,455,49
2020-05-29,Argentina,NA,Cordoba,3722332,0,0,455,49
2020-05-30,Argentina,NA,Cordoba,3722332,1,0,456,49
2020-05-31,Argentina,NA,Cordoba,3722332,0,1,456,50
2020-06-01,Argentina,NA,Cordoba,3722332,0,0,456,50
2020-06-02,Argentina,NA,Cordoba,3722332,2,1,458,51
2020-06-03,Argentina,NA,Cordoba,3722332,0,1,458,52
2020-06-04,Argentina,NA,Cordoba,3722332,4,0,462,52
2020-06-05,Argentina,NA,Cordoba,3722332,1,1,463,53
2020-06-06,Argentina,NA,Cordoba,3722332,0,0,463,53
2020-06-07,Argentina,NA,Cordoba,3722332,0,0,463,53
2020-06-08,Argentina,NA,Cordoba,3722332,1,0,464,53
2020-06-09,Argentina,NA,Cordoba,3722332,4,0,468,53
2020-06-10,Argentina,NA,Cordoba,3722332,2,0,470,53
2020-06-11,Argentina,NA,Cordoba,3722332,11,0,481,53
2020-06-12,Argentina,NA,Cordoba,3722332,2,3,483,56
2020-06-13,Argentina,NA,Cordoba,3722332,8,0,491,56
2020-06-14,Argentina,NA,Cordoba,3722332,5,2,496,58
2020-06-15,Argentina,NA,Cordoba,3722332,2,0,498,58
2020-06-16,Argentina,NA,Cordoba,3722332,3,0,501,58
2020-06-17,Argentina,NA,Cordoba,3722332,7,0,508,58
2020-06-18,Argentina,NA,Cordoba,3722332,15,0,523,58
2020-06-19,Argentina,NA,Cordoba,3722332,18,0,541,58
2020-06-20,Argentina,NA,Cordoba,3722332,17,0,558,58
2020-06-21,Argentina,NA,Cordoba,3722332,19,0,577,58
2020-06-22,Argentina,NA,Cordoba,3722332,3,1,580,59
2020-06-23,Argentina,NA,Cordoba,3722332,19,0,599,59
2020-06-24,Argentina,NA,Cordoba,3722332,3,0,602,59
2020-06-25,Argentina,NA,Cordoba,3722332,8,0,610,59
2020-06-26,Argentina,NA,Cordoba,3722332,20,0,630,59
2020-06-27,Argentina,NA,Cordoba,3722332,3,1,633,60
2020-06-28,Argentina,NA,Cordoba,3722332,4,0,637,60
2020-06-29,Argentina,NA,Cordoba,3722332,4,0,641,60
2020-06-30,Argentina,NA,Cordoba,3722332,11,0,652,60
2020-07-01,Argentina,NA,Cordoba,3722332,9,0,661,60
2020-07-02,Argentina,NA,Cordoba,3722332,10,1,671,61
2020-07-03,Argentina,NA,Cordoba,3722332,8,1,679,62
2020-07-04,Argentina,NA,Cordoba,3722332,14,0,693,62
2020-07-05,Argentina,NA,Cordoba,3722332,18,0,711,62
2020-07-06,Argentina,NA,Cordoba,3722332,40,0,751,62
2020-07-07,Argentina,NA,Cordoba,3722332,36,0,787,62
2020-07-08,Argentina,NA,Cordoba,3722332,36,0,823,62
2020-07-09,Argentina,NA,Cordoba,3722332,11,0,834,62
2020-07-10,Argentina,NA,Cordoba,3722332,35,0,869,62
2020-07-11,Argentina,NA,Cordoba,3722332,31,1,900,63
2020-07-12,Argentina,NA,Cordoba,3722332,47,0,947,63
2020-07-13,Argentina,NA,Cordoba,3722332,29,1,976,64
2020-07-14,Argentina,NA,Cordoba,3722332,32,0,1008,64
2020-07-15,Argentina,NA,Cordoba,3722332,32,0,1040,64
2020-07-16,Argentina,NA,Cordoba,3722332,47,1,1087,65
2020-07-17,Argentina,NA,Cordoba,3722332,81,0,1168,65
2020-07-18,Argentina,NA,Cordoba,3722332,42,1,1210,66
2020-07-19,Argentina,NA,Cordoba,3722332,100,0,1310,66
2020-07-20,Argentina,NA,Cordoba,3722332,71,3,1381,69
2020-07-21,Argentina,NA,Cordoba,3722332,100,1,1481,70
2020-07-22,Argentina,NA,Cordoba,3722332,66,0,1547,70
2020-07-23,Argentina,NA,Cordoba,3722332,79,0,1626,70
2020-07-24,Argentina,NA,Cordoba,3722332,71,1,1697,71
2020-07-25,Argentina,NA,Cordoba,3722332,45,0,1742,71
2020-07-26,Argentina,NA,Cordoba,3722332,117,1,1859,72
2020-07-27,Argentina,NA,Cordoba,3722332,110,0,1969,72
2020-07-28,Argentina,NA,Cordoba,3722332,84,3,2053,75
2020-07-29,Argentina,NA,Cordoba,3722332,104,2,2157,77
2020-07-30,Argentina,NA,Cordoba,3722332,71,1,2228,78
2020-07-31,Argentina,NA,Cordoba,3722332,139,0,2367,78
2020-08-01,Argentina,NA,Cordoba,3722332,92,1,2459,79
2020-08-02,Argentina,NA,Cordoba,3722332,85,1,2544,80
2020-08-03,Argentina,NA,Cordoba,3722332,118,3,2662,83
2020-08-04,Argentina,NA,Cordoba,3722332,205,1,2867,84
2020-08-05,Argentina,NA,Cordoba,3722332,114,3,2981,87
2020-08-06,Argentina,NA,Cordoba,3722332,160,7,3141,94
2020-08-07,Argentina,NA,Cordoba,3722332,188,1,3329,95
2020-08-08,Argentina,NA,Cordoba,3722332,152,2,3481,97
2020-08-09,Argentina,NA,Cordoba,3722332,163,4,3644,101
2020-08-10,Argentina,NA,Cordoba,3722332,175,2,3819,103
2020-08-11,Argentina,NA,Cordoba,3722332,143,2,3962,105
2020-08-12,Argentina,NA,Cordoba,3722332,193,1,4155,106
2020-08-13,Argentina,NA,Cordoba,3722332,184,0,4339,106
2020-08-14,Argentina,NA,Cordoba,3722332,138,0,4477,106
2020-08-15,Argentina,NA,Cordoba,3722332,142,5,4619,111
2020-08-16,Argentina,NA,Cordoba,3722332,119,2,4738,113
2020-08-17,Argentina,NA,Cordoba,3722332,271,3,5009,116
2020-08-18,Argentina,NA,Cordoba,3722332,97,4,5106,120
2020-08-19,Argentina,NA,Cordoba,3722332,264,4,5370,124
2020-08-20,Argentina,NA,Cordoba,3722332,149,2,5519,126
2020-08-21,Argentina,NA,Cordoba,3722332,263,4,5782,130
2020-08-22,Argentina,NA,Cordoba,3722332,178,3,5960,133
2020-08-23,Argentina,NA,Cordoba,3722332,312,5,6272,138
2020-08-24,Argentina,NA,Cordoba,3722332,256,3,6528,141
2020-08-25,Argentina,NA,Cordoba,3722332,395,6,6923,147
2020-08-26,Argentina,NA,Cordoba,3722332,277,1,7200,148
2020-08-27,Argentina,NA,Cordoba,3722332,357,5,7557,153
2020-08-28,Argentina,NA,Cordoba,3722332,399,10,7956,163
2020-08-29,Argentina,NA,Cordoba,3722332,389,3,8345,166
2020-08-30,Argentina,NA,Cordoba,3722332,378,1,8723,167
2020-08-31,Argentina,NA,Cordoba,3722332,443,10,9166,177
2020-09-01,Argentina,NA,Cordoba,3722332,557,5,9723,182
2020-09-02,Argentina,NA,Cordoba,3722332,590,5,10313,187
2020-09-03,Argentina,NA,Cordoba,3722332,467,7,10780,194
2020-09-04,Argentina,NA,Cordoba,3722332,502,8,11282,202
2020-09-05,Argentina,NA,Cordoba,3722332,399,3,11681,205
2020-09-06,Argentina,NA,Cordoba,3722332,417,7,12098,212
2020-09-07,Argentina,NA,Cordoba,3722332,332,7,12430,219
2020-09-08,Argentina,NA,Cordoba,3722332,486,11,12916,230
2020-09-09,Argentina,NA,Cordoba,3722332,391,9,13307,239
2020-09-10,Argentina,NA,Cordoba,3722332,565,6,13872,245
2020-09-11,Argentina,NA,Cordoba,3722332,605,8,14477,253
2020-09-12,Argentina,NA,Cordoba,3722332,1020,6,15497,259
2020-09-13,Argentina,NA,Cordoba,3722332,542,9,16039,268
2020-09-14,Argentina,NA,Cordoba,3722332,408,3,16447,271
2020-09-15,Argentina,NA,Cordoba,3722332,429,10,16876,281
2020-09-16,Argentina,NA,Cordoba,3722332,589,3,17465,284
2020-09-17,Argentina,NA,Cordoba,3722332,666,11,18131,295
2020-09-18,Argentina,NA,Cordoba,3722332,1357,6,19488,301
2020-09-19,Argentina,NA,Cordoba,3722332,1017,3,20505,304
2020-09-20,Argentina,NA,Cordoba,3722332,676,7,21181,311
2020-09-21,Argentina,NA,Cordoba,3722332,1215,6,22396,317
2020-09-22,Argentina,NA,Cordoba,3722332,931,5,23327,322
2020-09-23,Argentina,NA,Cordoba,3722332,663,4,23990,326
2020-03-27,Argentina,NA,Corrientes,1111052,10,0,13,0
2020-03-28,Argentina,NA,Corrientes,1111052,2,0,15,0
2020-03-30,Argentina,NA,Corrientes,1111052,4,0,19,0
2020-03-31,Argentina,NA,Corrientes,1111052,0,0,19,0
2020-04-01,Argentina,NA,Corrientes,1111052,3,0,22,0
2020-04-02,Argentina,NA,Corrientes,1111052,2,0,24,0
2020-04-03,Argentina,NA,Corrientes,1111052,0,0,24,0
2020-04-06,Argentina,NA,Corrientes,1111052,1,0,25,0
2020-04-07,Argentina,NA,Corrientes,1111052,0,0,25,0
2020-04-08,Argentina,NA,Corrientes,1111052,4,0,29,0
2020-04-10,Argentina,NA,Corrientes,1111052,0,0,29,0
2020-04-11,Argentina,NA,Corrientes,1111052,0,0,29,0
2020-04-13,Argentina,NA,Corrientes,1111052,1,0,30,0
2020-04-15,Argentina,NA,Corrientes,1111052,0,0,30,0
2020-04-16,Argentina,NA,Corrientes,1111052,1,0,31,0
2020-04-17,Argentina,NA,Corrientes,1111052,1,0,32,0
2020-04-18,Argentina,NA,Corrientes,1111052,2,0,34,0
2020-04-22,Argentina,NA,Corrientes,1111052,1,0,35,0
2020-04-23,Argentina,NA,Corrientes,1111052,2,0,37,0
2020-04-24,Argentina,NA,Corrientes,1111052,2,0,39,0
2020-04-25,Argentina,NA,Corrientes,1111052,5,0,44,0
2020-04-26,Argentina,NA,Corrientes,1111052,2,0,46,0
2020-04-27,Argentina,NA,Corrientes,1111052,0,0,46,0
2020-04-28,Argentina,NA,Corrientes,1111052,1,0,47,0
2020-04-29,Argentina,NA,Corrientes,1111052,1,0,48,0
2020-04-30,Argentina,NA,Corrientes,1111052,1,0,49,0
2020-05-02,Argentina,NA,Corrientes,1111052,0,0,49,0
2020-05-04,Argentina,NA,Corrientes,1111052,0,0,49,0
2020-05-05,Argentina,NA,Corrientes,1111052,0,0,49,0
2020-05-06,Argentina,NA,Corrientes,1111052,4,0,53,0
2020-05-07,Argentina,NA,Corrientes,1111052,1,0,54,0
2020-05-08,Argentina,NA,Corrientes,1111052,0,0,54,0
2020-05-09,Argentina,NA,Corrientes,1111052,0,0,54,0
2020-05-10,Argentina,NA,Corrientes,1111052,0,0,54,0
2020-05-11,Argentina,NA,Corrientes,1111052,17,0,71,0
2020-05-12,Argentina,NA,Corrientes,1111052,2,0,73,0
2020-05-13,Argentina,NA,Corrientes,1111052,4,0,77,0
2020-05-15,Argentina,NA,Corrientes,1111052,0,0,77,0
2020-05-16,Argentina,NA,Corrientes,1111052,0,0,77,0
2020-05-17,Argentina,NA,Corrientes,1111052,0,0,77,0
2020-05-19,Argentina,NA,Corrientes,1111052,0,0,77,0
2020-05-20,Argentina,NA,Corrientes,1111052,0,0,77,0
2020-05-21,Argentina,NA,Corrientes,1111052,0,0,77,0
2020-05-22,Argentina,NA,Corrientes,1111052,0,0,77,0
2020-05-23,Argentina,NA,Corrientes,1111052,0,0,77,0
2020-05-24,Argentina,NA,Corrientes,1111052,0,1,77,1
2020-05-25,Argentina,NA,Corrientes,1111052,0,0,77,1
2020-05-26,Argentina,NA,Corrientes,1111052,2,0,79,1
2020-05-27,Argentina,NA,Corrientes,1111052,1,0,80,1
2020-05-29,Argentina,NA,Corrientes,1111052,6,0,86,1
2020-05-31,Argentina,NA,Corrientes,1111052,6,0,92,1
2020-06-01,Argentina,NA,Corrientes,1111052,0,0,92,1
2020-06-02,Argentina,NA,Corrientes,1111052,2,0,94,1
2020-06-03,Argentina,NA,Corrientes,1111052,0,0,94,1
2020-06-04,Argentina,NA,Corrientes,1111052,0,1,94,2
2020-06-07,Argentina,NA,Corrientes,1111052,0,0,94,2
2020-06-08,Argentina,NA,Corrientes,1111052,2,0,96,2
2020-06-10,Argentina,NA,Corrientes,1111052,1,0,97,2
2020-06-11,Argentina,NA,Corrientes,1111052,2,0,99,2
2020-06-12,Argentina,NA,Corrientes,1111052,1,0,100,2
2020-06-13,Argentina,NA,Corrientes,1111052,1,0,101,2
2020-06-14,Argentina,NA,Corrientes,1111052,3,0,104,2
2020-06-16,Argentina,NA,Corrientes,1111052,1,0,105,2
2020-06-17,Argentina,NA,Corrientes,1111052,2,0,107,2
2020-06-18,Argentina,NA,Corrientes,1111052,1,0,108,2
2020-06-19,Argentina,NA,Corrientes,1111052,3,0,111,2
2020-06-20,Argentina,NA,Corrientes,1111052,1,0,112,2
2020-06-22,Argentina,NA,Corrientes,1111052,2,0,114,2
2020-06-23,Argentina,NA,Corrientes,1111052,0,0,114,2
2020-06-24,Argentina,NA,Corrientes,1111052,1,0,115,2
2020-06-26,Argentina,NA,Corrientes,1111052,0,0,115,2
2020-06-28,Argentina,NA,Corrientes,1111052,0,0,115,2
2020-06-29,Argentina,NA,Corrientes,1111052,1,0,116,2
2020-06-30,Argentina,NA,Corrientes,1111052,1,0,117,2
2020-07-01,Argentina,NA,Corrientes,1111052,0,0,117,2
2020-07-04,Argentina,NA,Corrientes,1111052,1,0,118,2
2020-07-06,Argentina,NA,Corrientes,1111052,2,0,120,2
2020-07-07,Argentina,NA,Corrientes,1111052,3,0,123,2
2020-07-09,Argentina,NA,Corrientes,1111052,0,0,123,2
2020-07-10,Argentina,NA,Corrientes,1111052,1,0,124,2
2020-07-12,Argentina,NA,Corrientes,1111052,0,0,124,2
2020-07-13,Argentina,NA,Corrientes,1111052,1,0,125,2
2020-07-15,Argentina,NA,Corrientes,1111052,3,0,128,2
2020-07-18,Argentina,NA,Corrientes,1111052,0,1,128,3
2020-07-19,Argentina,NA,Corrientes,1111052,0,0,128,3
2020-07-20,Argentina,NA,Corrientes,1111052,0,0,128,3
2020-07-21,Argentina,NA,Corrientes,1111052,1,0,129,3
2020-07-22,Argentina,NA,Corrientes,1111052,1,0,130,3
2020-07-23,Argentina,NA,Corrientes,1111052,0,0,130,3
2020-07-24,Argentina,NA,Corrientes,1111052,2,0,132,3
2020-07-25,Argentina,NA,Corrientes,1111052,4,0,136,3
2020-07-26,Argentina,NA,Corrientes,1111052,12,0,148,3
2020-07-27,Argentina,NA,Corrientes,1111052,0,0,148,3
2020-07-28,Argentina,NA,Corrientes,1111052,13,0,161,3
2020-07-29,Argentina,NA,Corrientes,1111052,1,0,162,3
2020-07-30,Argentina,NA,Corrientes,1111052,1,0,163,3
2020-07-31,Argentina,NA,Corrientes,1111052,22,1,185,4
2020-08-01,Argentina,NA,Corrientes,1111052,4,0,189,4
2020-08-02,Argentina,NA,Corrientes,1111052,2,0,191,4
2020-08-03,Argentina,NA,Corrientes,1111052,0,0,191,4
2020-08-04,Argentina,NA,Corrientes,1111052,2,0,193,4
2020-08-05,Argentina,NA,Corrientes,1111052,2,0,195,4
2020-08-06,Argentina,NA,Corrientes,1111052,2,0,197,4
2020-08-08,Argentina,NA,Corrientes,1111052,0,0,197,4
2020-08-09,Argentina,NA,Corrientes,1111052,5,0,202,4
2020-08-10,Argentina,NA,Corrientes,1111052,1,0,203,4
2020-08-12,Argentina,NA,Corrientes,1111052,2,0,205,4
2020-08-13,Argentina,NA,Corrientes,1111052,2,0,207,4
2020-08-14,Argentina,NA,Corrientes,1111052,3,0,210,4
2020-08-17,Argentina,NA,Corrientes,1111052,1,0,211,4
2020-08-18,Argentina,NA,Corrientes,1111052,1,0,212,4
2020-08-20,Argentina,NA,Corrientes,1111052,10,0,222,4
2020-08-21,Argentina,NA,Corrientes,1111052,7,0,229,4
2020-08-22,Argentina,NA,Corrientes,1111052,12,0,241,4
2020-08-24,Argentina,NA,Corrientes,1111052,15,0,256,4
2020-08-25,Argentina,NA,Corrientes,1111052,7,0,263,4
2020-08-26,Argentina,NA,Corrientes,1111052,4,0,267,4
2020-08-27,Argentina,NA,Corrientes,1111052,12,0,279,4
2020-08-28,Argentina,NA,Corrientes,1111052,34,0,313,4
2020-08-29,Argentina,NA,Corrientes,1111052,17,0,330,4
2020-08-30,Argentina,NA,Corrientes,1111052,14,0,344,4
2020-08-31,Argentina,NA,Corrientes,1111052,20,1,364,5
2020-09-01,Argentina,NA,Corrientes,1111052,37,0,401,5
2020-09-02,Argentina,NA,Corrientes,1111052,18,0,419,5
2020-09-03,Argentina,NA,Corrientes,1111052,12,0,431,5
2020-09-04,Argentina,NA,Corrientes,1111052,26,0,457,5
2020-09-05,Argentina,NA,Corrientes,1111052,29,0,486,5
2020-09-06,Argentina,NA,Corrientes,1111052,13,0,499,5
2020-09-07,Argentina,NA,Corrientes,1111052,35,0,534,5
2020-09-08,Argentina,NA,Corrientes,1111052,18,1,552,6
2020-09-09,Argentina,NA,Corrientes,1111052,22,0,574,6
2020-09-10,Argentina,NA,Corrientes,1111052,49,1,623,7
2020-09-11,Argentina,NA,Corrientes,1111052,30,1,653,8
2020-09-12,Argentina,NA,Corrientes,1111052,12,0,665,8
2020-09-13,Argentina,NA,Corrientes,1111052,26,2,691,10
2020-09-14,Argentina,NA,Corrientes,1111052,49,0,740,10
2020-09-15,Argentina,NA,Corrientes,1111052,42,2,782,12
2020-09-16,Argentina,NA,Corrientes,1111052,55,0,837,12
2020-09-17,Argentina,NA,Corrientes,1111052,43,1,880,13
2020-09-18,Argentina,NA,Corrientes,1111052,27,1,907,14
2020-09-19,Argentina,NA,Corrientes,1111052,47,0,954,14
2020-09-20,Argentina,NA,Corrientes,1111052,15,0,969,14
2020-09-21,Argentina,NA,Corrientes,1111052,27,0,996,14
2020-09-22,Argentina,NA,Corrientes,1111052,5,0,1001,14
2020-09-23,Argentina,NA,Corrientes,1111052,4,0,1005,14
2020-03-30,Argentina,NA,Entre Rios,1235994,3,2,12,2
2020-03-31,Argentina,NA,Entre Rios,1235994,0,0,12,2
2020-04-01,Argentina,NA,Entre Rios,1235994,2,0,14,2
2020-04-02,Argentina,NA,Entre Rios,1235994,1,0,15,3
2020-04-03,Argentina,NA,Entre Rios,1235994,2,0,17,3
2020-04-04,Argentina,NA,Entre Rios,1235994,1,0,18,3
2020-04-05,Argentina,NA,Entre Rios,1235994,0,0,18,3
2020-04-06,Argentina,NA,Entre Rios,1235994,1,1,19,3
2020-04-07,Argentina,NA,Entre Rios,1235994,0,1,19,3
2020-04-08,Argentina,NA,Entre Rios,1235994,0,2,19,3
2020-04-09,Argentina,NA,Entre Rios,1235994,1,1,20,4
2020-04-10,Argentina,NA,Entre Rios,1235994,0,5,20,4
2020-04-11,Argentina,NA,Entre Rios,1235994,0,1,20,4
2020-04-12,Argentina,NA,Entre Rios,1235994,0,0,20,4
2020-04-13,Argentina,NA,Entre Rios,1235994,0,0,20,4
2020-04-14,Argentina,NA,Entre Rios,1235994,0,2,20,4
2020-04-15,Argentina,NA,Entre Rios,1235994,1,1,21,4
2020-04-16,Argentina,NA,Entre Rios,1235994,0,1,21,4
2020-04-17,Argentina,NA,Entre Rios,1235994,0,0,21,4
2020-04-18,Argentina,NA,Entre Rios,1235994,0,3,21,4
2020-04-19,Argentina,NA,Entre Rios,1235994,0,1,21,4
2020-04-20,Argentina,NA,Entre Rios,1235994,0,4,21,4
2020-04-21,Argentina,NA,Entre Rios,1235994,0,3,21,4
2020-04-22,Argentina,NA,Entre Rios,1235994,0,1,21,4
2020-04-23,Argentina,NA,Entre Rios,1235994,0,1,21,4
2020-04-24,Argentina,NA,Entre Rios,1235994,0,1,21,4
2020-04-25,Argentina,NA,Entre Rios,1235994,0,0,21,4
2020-04-26,Argentina,NA,Entre Rios,1235994,0,0,21,4
2020-04-27,Argentina,NA,Entre Rios,1235994,1,1,22,4
2020-04-28,Argentina,NA,Entre Rios,1235994,0,1,22,4
2020-04-29,Argentina,NA,Entre Rios,1235994,0,0,22,4
2020-04-30,Argentina,NA,Entre Rios,1235994,2,2,24,4
2020-05-01,Argentina,NA,Entre Rios,1235994,0,0,24,4
2020-05-02,Argentina,NA,Entre Rios,1235994,2,2,26,5
2020-05-03,Argentina,NA,Entre Rios,1235994,0,0,26,5
2020-05-04,Argentina,NA,Entre Rios,1235994,1,0,27,5
2020-05-05,Argentina,NA,Entre Rios,1235994,1,2,28,5
2020-05-06,Argentina,NA,Entre Rios,1235994,0,0,28,5
2020-05-07,Argentina,NA,Entre Rios,1235994,0,1,28,5
2020-05-08,Argentina,NA,Entre Rios,1235994,0,1,28,5
2020-05-09,Argentina,NA,Entre Rios,1235994,0,2,28,5
2020-05-10,Argentina,NA,Entre Rios,1235994,0,0,28,5
2020-05-11,Argentina,NA,Entre Rios,1235994,0,1,28,5
2020-05-12,Argentina,NA,Entre Rios,1235994,1,0,29,5
2020-05-13,Argentina,NA,Entre Rios,1235994,0,1,29,5
2020-05-14,Argentina,NA,Entre Rios,1235994,0,0,29,5
2020-05-15,Argentina,NA,Entre Rios,1235994,0,1,29,5
2020-05-16,Argentina,NA,Entre Rios,1235994,0,1,29,5
2020-05-17,Argentina,NA,Entre Rios,1235994,0,1,29,5
2020-05-18,Argentina,NA,Entre Rios,1235994,0,1,29,5
2020-05-19,Argentina,NA,Entre Rios,1235994,0,0,29,5
2020-05-20,Argentina,NA,Entre Rios,1235994,0,2,29,5
2020-05-21,Argentina,NA,Entre Rios,1235994,0,0,29,5
2020-05-22,Argentina,NA,Entre Rios,1235994,0,1,29,5
2020-05-23,Argentina,NA,Entre Rios,1235994,0,0,29,5
2020-05-24,Argentina,NA,Entre Rios,1235994,0,1,29,5
2020-05-25,Argentina,NA,Entre Rios,1235994,0,1,29,5
2020-05-26,Argentina,NA,Entre Rios,1235994,0,2,29,5
2020-05-27,Argentina,NA,Entre Rios,1235994,0,1,29,5
2020-05-28,Argentina,NA,Entre Rios,1235994,1,0,30,6
2020-05-29,Argentina,NA,Entre Rios,1235994,0,0,30,6
2020-05-30,Argentina,NA,Entre Rios,1235994,1,2,31,6
2020-05-31,Argentina,NA,Entre Rios,1235994,0,1,31,6
2020-06-01,Argentina,NA,Entre Rios,1235994,2,1,33,6
2020-06-02,Argentina,NA,Entre Rios,1235994,0,2,33,6
2020-06-03,Argentina,NA,Entre Rios,1235994,2,0,35,7
2020-06-04,Argentina,NA,Entre Rios,1235994,4,3,39,7
2020-06-05,Argentina,NA,Entre Rios,1235994,7,3,46,9
2020-06-06,Argentina,NA,Entre Rios,1235994,4,2,50,10
2020-06-07,Argentina,NA,Entre Rios,1235994,2,1,52,10
2020-06-08,Argentina,NA,Entre Rios,1235994,2,0,54,10
2020-06-09,Argentina,NA,Entre Rios,1235994,3,1,57,11
2020-06-10,Argentina,NA,Entre Rios,1235994,6,1,63,12
2020-06-11,Argentina,NA,Entre Rios,1235994,5,1,68,13
2020-06-12,Argentina,NA,Entre Rios,1235994,2,1,70,14
2020-06-13,Argentina,NA,Entre Rios,1235994,17,1,87,17
2020-06-14,Argentina,NA,Entre Rios,1235994,1,0,88,17
2020-06-15,Argentina,NA,Entre Rios,1235994,9,3,97,19
2020-06-16,Argentina,NA,Entre Rios,1235994,7,1,104,20
2020-06-17,Argentina,NA,Entre Rios,1235994,5,0,109,21
2020-06-18,Argentina,NA,Entre Rios,1235994,4,2,113,22
2020-06-19,Argentina,NA,Entre Rios,1235994,0,0,113,22
2020-06-20,Argentina,NA,Entre Rios,1235994,19,0,132,26
2020-06-21,Argentina,NA,Entre Rios,1235994,8,3,140,28
2020-06-22,Argentina,NA,Entre Rios,1235994,17,0,157,31
2020-06-23,Argentina,NA,Entre Rios,1235994,17,2,174,34
2020-06-24,Argentina,NA,Entre Rios,1235994,24,2,198,39
2020-06-25,Argentina,NA,Entre Rios,1235994,16,0,214,42
2020-06-26,Argentina,NA,Entre Rios,1235994,20,1,234,46
2020-06-27,Argentina,NA,Entre Rios,1235994,10,1,244,48
2020-06-28,Argentina,NA,Entre Rios,1235994,24,0,268,53
2020-06-29,Argentina,NA,Entre Rios,1235994,5,3,273,54
2020-06-30,Argentina,NA,Entre Rios,1235994,5,2,278,55
2020-07-01,Argentina,NA,Entre Rios,1235994,9,2,287,57
2020-07-02,Argentina,NA,Entre Rios,1235994,15,0,302,60
2020-07-03,Argentina,NA,Entre Rios,1235994,10,1,312,62
2020-07-04,Argentina,NA,Entre Rios,1235994,6,1,318,63
2020-07-05,Argentina,NA,Entre Rios,1235994,6,5,324,64
2020-07-06,Argentina,NA,Entre Rios,1235994,6,1,330,66
2020-07-07,Argentina,NA,Entre Rios,1235994,9,3,339,67
2020-07-08,Argentina,NA,Entre Rios,1235994,11,2,350,70
2020-07-09,Argentina,NA,Entre Rios,1235994,20,4,370,74
2020-07-10,Argentina,NA,Entre Rios,1235994,25,0,395,79
2020-07-11,Argentina,NA,Entre Rios,1235994,31,0,426,85
2020-07-12,Argentina,NA,Entre Rios,1235994,60,3,486,97
2020-07-13,Argentina,NA,Entre Rios,1235994,43,3,529,105
2020-07-14,Argentina,NA,Entre Rios,1235994,20,2,549,109
2020-07-15,Argentina,NA,Entre Rios,1235994,9,3,558,111
2020-07-16,Argentina,NA,Entre Rios,1235994,14,0,572,114
2020-07-17,Argentina,NA,Entre Rios,1235994,24,1,596,119
2020-07-18,Argentina,NA,Entre Rios,1235994,15,0,611,122
2020-07-19,Argentina,NA,Entre Rios,1235994,14,1,625,125
2020-07-20,Argentina,NA,Entre Rios,1235994,19,2,644,128
2020-07-21,Argentina,NA,Entre Rios,1235994,11,3,655,131
2020-07-22,Argentina,NA,Entre Rios,1235994,28,1,683,136
2020-07-23,Argentina,NA,Entre Rios,1235994,28,0,711,136
2020-07-24,Argentina,NA,Entre Rios,1235994,10,1,721,137
2020-07-25,Argentina,NA,Entre Rios,1235994,17,3,738,140
2020-07-26,Argentina,NA,Entre Rios,1235994,22,0,760,140
2020-07-27,Argentina,NA,Entre Rios,1235994,4,3,764,143
2020-07-28,Argentina,NA,Entre Rios,1235994,8,3,772,146
2020-07-29,Argentina,NA,Entre Rios,1235994,14,0,786,146
2020-07-30,Argentina,NA,Entre Rios,1235994,22,0,808,146
2020-07-31,Argentina,NA,Entre Rios,1235994,12,0,820,146
2020-08-01,Argentina,NA,Entre Rios,1235994,12,1,832,147
2020-08-02,Argentina,NA,Entre Rios,1235994,22,3,854,150
2020-08-03,Argentina,NA,Entre Rios,1235994,31,1,885,151
2020-08-04,Argentina,NA,Entre Rios,1235994,23,0,908,151
2020-08-05,Argentina,NA,Entre Rios,1235994,42,4,950,155
2020-08-06,Argentina,NA,Entre Rios,1235994,67,0,1017,155
2020-08-07,Argentina,NA,Entre Rios,1235994,48,0,1065,155
2020-08-08,Argentina,NA,Entre Rios,1235994,31,0,1096,155
2020-08-09,Argentina,NA,Entre Rios,1235994,72,0,1168,155
2020-08-10,Argentina,NA,Entre Rios,1235994,48,2,1216,157
2020-08-11,Argentina,NA,Entre Rios,1235994,35,1,1251,158
2020-08-12,Argentina,NA,Entre Rios,1235994,67,2,1318,160
2020-08-13,Argentina,NA,Entre Rios,1235994,61,2,1379,162
2020-08-14,Argentina,NA,Entre Rios,1235994,110,3,1489,165
2020-08-15,Argentina,NA,Entre Rios,1235994,89,2,1578,167
2020-08-16,Argentina,NA,Entre Rios,1235994,75,3,1653,170
2020-08-17,Argentina,NA,Entre Rios,1235994,60,1,1713,171
2020-08-18,Argentina,NA,Entre Rios,1235994,56,2,1769,173
2020-08-19,Argentina,NA,Entre Rios,1235994,43,0,1812,173
2020-08-20,Argentina,NA,Entre Rios,1235994,61,3,1873,176
2020-08-21,Argentina,NA,Entre Rios,1235994,125,0,1998,176
2020-08-22,Argentina,NA,Entre Rios,1235994,146,2,2144,178
2020-08-23,Argentina,NA,Entre Rios,1235994,91,0,2235,178
2020-08-24,Argentina,NA,Entre Rios,1235994,122,3,2357,181
2020-08-25,Argentina,NA,Entre Rios,1235994,106,3,2463,184
2020-08-26,Argentina,NA,Entre Rios,1235994,99,3,2562,187
2020-08-27,Argentina,NA,Entre Rios,1235994,155,3,2717,190
2020-08-28,Argentina,NA,Entre Rios,1235994,180,3,2897,193
2020-08-29,Argentina,NA,Entre Rios,1235994,96,9,2993,202
2020-08-30,Argentina,NA,Entre Rios,1235994,125,6,3118,208
2020-08-31,Argentina,NA,Entre Rios,1235994,236,5,3354,213
2020-09-01,Argentina,NA,Entre Rios,1235994,179,3,3533,216
2020-09-02,Argentina,NA,Entre Rios,1235994,122,2,3655,218
2020-09-03,Argentina,NA,Entre Rios,1235994,178,3,3833,221
2020-09-04,Argentina,NA,Entre Rios,1235994,145,3,3978,224
2020-09-05,Argentina,NA,Entre Rios,1235994,73,6,4051,230
2020-09-06,Argentina,NA,Entre Rios,1235994,40,5,4091,235
2020-09-07,Argentina,NA,Entre Rios,1235994,84,2,4175,237
2020-09-08,Argentina,NA,Entre Rios,1235994,122,4,4297,241
2020-09-09,Argentina,NA,Entre Rios,1235994,77,5,4374,246
2020-09-10,Argentina,NA,Entre Rios,1235994,145,8,4519,254
2020-09-11,Argentina,NA,Entre Rios,1235994,127,1,4646,255
2020-09-12,Argentina,NA,Entre Rios,1235994,117,4,4763,259
2020-09-13,Argentina,NA,Entre Rios,1235994,58,6,4821,265
2020-09-14,Argentina,NA,Entre Rios,1235994,99,3,4920,268
2020-09-15,Argentina,NA,Entre Rios,1235994,125,6,5045,274
2020-09-16,Argentina,NA,Entre Rios,1235994,122,3,5167,277
2020-09-17,Argentina,NA,Entre Rios,1235994,145,6,5312,283
2020-09-18,Argentina,NA,Entre Rios,1235994,160,4,5472,287
2020-09-19,Argentina,NA,Entre Rios,1235994,38,2,5510,289
2020-09-20,Argentina,NA,Entre Rios,1235994,115,5,5625,294
2020-09-21,Argentina,NA,Entre Rios,1235994,66,4,5691,298
2020-09-22,Argentina,NA,Entre Rios,1235994,105,5,5796,303
2020-09-23,Argentina,NA,Entre Rios,1235994,83,1,5879,304
2020-06-16,Argentina,NA,Jujuy,762440,4,0,11,1
2020-06-17,Argentina,NA,Jujuy,762440,4,0,15,1
2020-06-18,Argentina,NA,Jujuy,762440,5,0,20,1
2020-06-19,Argentina,NA,Jujuy,762440,5,0,25,1
2020-06-20,Argentina,NA,Jujuy,762440,13,0,38,1
2020-06-21,Argentina,NA,Jujuy,762440,5,0,43,1
2020-06-22,Argentina,NA,Jujuy,762440,6,1,49,2
2020-06-23,Argentina,NA,Jujuy,762440,3,0,52,2
2020-06-24,Argentina,NA,Jujuy,762440,5,0,57,2
2020-06-25,Argentina,NA,Jujuy,762440,10,0,67,2
2020-06-26,Argentina,NA,Jujuy,762440,10,0,77,2
2020-06-27,Argentina,NA,Jujuy,762440,10,0,87,2
2020-06-28,Argentina,NA,Jujuy,762440,4,1,91,3
2020-06-29,Argentina,NA,Jujuy,762440,4,0,95,3
2020-06-30,Argentina,NA,Jujuy,762440,18,0,113,3
2020-07-01,Argentina,NA,Jujuy,762440,18,2,131,5
2020-07-02,Argentina,NA,Jujuy,762440,33,0,164,5
2020-07-03,Argentina,NA,Jujuy,762440,17,1,181,6
2020-07-04,Argentina,NA,Jujuy,762440,36,1,217,7
2020-07-05,Argentina,NA,Jujuy,762440,24,2,241,9
2020-07-06,Argentina,NA,Jujuy,762440,50,1,291,10
2020-07-07,Argentina,NA,Jujuy,762440,31,1,322,11
2020-07-08,Argentina,NA,Jujuy,762440,34,2,356,13
2020-07-09,Argentina,NA,Jujuy,762440,45,1,401,14
2020-07-10,Argentina,NA,Jujuy,762440,39,0,440,14
2020-07-11,Argentina,NA,Jujuy,762440,65,2,505,16
2020-07-12,Argentina,NA,Jujuy,762440,15,4,520,20
2020-07-13,Argentina,NA,Jujuy,762440,41,2,561,22
2020-07-14,Argentina,NA,Jujuy,762440,34,2,595,24
2020-07-15,Argentina,NA,Jujuy,762440,75,4,670,28
2020-07-16,Argentina,NA,Jujuy,762440,68,5,738,33
2020-07-17,Argentina,NA,Jujuy,762440,105,3,843,36
2020-07-18,Argentina,NA,Jujuy,762440,77,1,920,37
2020-07-19,Argentina,NA,Jujuy,762440,47,1,967,38
2020-07-20,Argentina,NA,Jujuy,762440,102,1,1069,39
2020-07-21,Argentina,NA,Jujuy,762440,190,7,1259,46
2020-07-22,Argentina,NA,Jujuy,762440,201,2,1460,48
2020-07-23,Argentina,NA,Jujuy,762440,160,1,1620,49
2020-07-24,Argentina,NA,Jujuy,762440,150,3,1770,52
2020-07-25,Argentina,NA,Jujuy,762440,92,3,1862,55
2020-07-26,Argentina,NA,Jujuy,762440,98,1,1960,56
2020-07-27,Argentina,NA,Jujuy,762440,195,3,2155,59
2020-07-28,Argentina,NA,Jujuy,762440,112,3,2267,62
2020-07-29,Argentina,NA,Jujuy,762440,154,8,2421,70
2020-07-30,Argentina,NA,Jujuy,762440,111,6,2532,76
2020-07-31,Argentina,NA,Jujuy,762440,192,4,2724,80
2020-08-01,Argentina,NA,Jujuy,762440,128,6,2852,86
2020-08-02,Argentina,NA,Jujuy,762440,63,5,2915,91
2020-08-03,Argentina,NA,Jujuy,762440,124,6,3039,97
2020-08-04,Argentina,NA,Jujuy,762440,148,10,3187,107
2020-08-05,Argentina,NA,Jujuy,762440,165,4,3352,111
2020-08-06,Argentina,NA,Jujuy,762440,116,4,3468,115
2020-08-07,Argentina,NA,Jujuy,762440,220,4,3688,119
2020-08-08,Argentina,NA,Jujuy,762440,126,6,3814,125
2020-08-09,Argentina,NA,Jujuy,762440,84,7,3898,132
2020-08-10,Argentina,NA,Jujuy,762440,112,5,4010,137
2020-08-11,Argentina,NA,Jujuy,762440,240,6,4250,143
2020-08-12,Argentina,NA,Jujuy,762440,157,2,4407,145
2020-08-13,Argentina,NA,Jujuy,762440,173,12,4580,157
2020-08-14,Argentina,NA,Jujuy,762440,199,7,4779,164
2020-08-15,Argentina,NA,Jujuy,762440,291,5,5070,169
2020-08-16,Argentina,NA,Jujuy,762440,139,8,5209,177
2020-08-17,Argentina,NA,Jujuy,762440,151,9,5360,186
2020-08-18,Argentina,NA,Jujuy,762440,218,11,5578,197
2020-08-19,Argentina,NA,Jujuy,762440,255,6,5833,203
2020-08-20,Argentina,NA,Jujuy,762440,169,4,6002,207
2020-08-21,Argentina,NA,Jujuy,762440,234,4,6236,211
2020-08-22,Argentina,NA,Jujuy,762440,253,5,6489,216
2020-08-23,Argentina,NA,Jujuy,762440,235,3,6724,219
2020-08-24,Argentina,NA,Jujuy,762440,231,9,6955,228
2020-08-25,Argentina,NA,Jujuy,762440,307,10,7262,238
2020-08-26,Argentina,NA,Jujuy,762440,287,13,7549,251
2020-08-27,Argentina,NA,Jujuy,762440,336,11,7885,262
2020-08-28,Argentina,NA,Jujuy,762440,321,10,8206,272
2020-08-29,Argentina,NA,Jujuy,762440,324,15,8530,287
2020-08-30,Argentina,NA,Jujuy,762440,180,8,8710,295
2020-08-31,Argentina,NA,Jujuy,762440,220,5,8930,300
2020-09-01,Argentina,NA,Jujuy,762440,179,6,9109,306
2020-09-02,Argentina,NA,Jujuy,762440,452,8,9561,314
2020-09-03,Argentina,NA,Jujuy,762440,407,13,9968,327
2020-09-04,Argentina,NA,Jujuy,762440,295,11,10263,338
2020-09-05,Argentina,NA,Jujuy,762440,251,10,10514,348
2020-09-06,Argentina,NA,Jujuy,762440,177,10,10691,358
2020-09-07,Argentina,NA,Jujuy,762440,339,14,11030,372
2020-09-08,Argentina,NA,Jujuy,762440,292,12,11322,384
2020-09-09,Argentina,NA,Jujuy,762440,424,14,11746,398
2020-09-10,Argentina,NA,Jujuy,762440,223,7,11969,405
2020-09-11,Argentina,NA,Jujuy,762440,249,2,12218,407
2020-09-12,Argentina,NA,Jujuy,762440,250,0,12468,407
2020-09-13,Argentina,NA,Jujuy,762440,304,0,12772,407
2020-09-14,Argentina,NA,Jujuy,762440,229,0,13001,407
2020-09-15,Argentina,NA,Jujuy,762440,145,0,13146,407
2020-09-16,Argentina,NA,Jujuy,762440,292,0,13438,407
2020-09-17,Argentina,NA,Jujuy,762440,315,0,13753,407
2020-09-18,Argentina,NA,Jujuy,762440,284,0,14037,407
2020-09-19,Argentina,NA,Jujuy,762440,187,0,14224,407
2020-09-20,Argentina,NA,Jujuy,762440,81,0,14305,407
2020-09-21,Argentina,NA,Jujuy,762440,109,0,14414,407
2020-09-22,Argentina,NA,Jujuy,762440,184,2,14598,409
2020-09-23,Argentina,NA,Jujuy,762440,166,0,14764,409
2020-07-24,Argentina,NA,La Pampa,355422,14,0,24,4
2020-07-25,Argentina,NA,La Pampa,355422,9,0,33,6
2020-07-26,Argentina,NA,La Pampa,355422,13,0,46,9
2020-07-27,Argentina,NA,La Pampa,355422,12,0,58,11
2020-07-28,Argentina,NA,La Pampa,355422,12,1,70,14
2020-07-29,Argentina,NA,La Pampa,355422,7,0,77,14
2020-07-30,Argentina,NA,La Pampa,355422,26,0,103,14
2020-07-31,Argentina,NA,La Pampa,355422,28,0,131,14
2020-08-01,Argentina,NA,La Pampa,355422,35,0,166,14
2020-08-02,Argentina,NA,La Pampa,355422,1,0,167,14
2020-08-03,Argentina,NA,La Pampa,355422,0,0,167,14
2020-08-04,Argentina,NA,La Pampa,355422,1,0,168,14
2020-08-05,Argentina,NA,La Pampa,355422,0,0,168,14
2020-08-06,Argentina,NA,La Pampa,355422,3,0,171,14
2020-08-07,Argentina,NA,La Pampa,355422,4,0,175,14
2020-08-08,Argentina,NA,La Pampa,355422,0,0,175,14
2020-08-09,Argentina,NA,La Pampa,355422,0,0,175,14
2020-08-10,Argentina,NA,La Pampa,355422,1,0,176,14
2020-08-11,Argentina,NA,La Pampa,355422,1,0,177,14
2020-08-12,Argentina,NA,La Pampa,355422,0,0,177,14
2020-08-13,Argentina,NA,La Pampa,355422,2,0,179,14
2020-08-14,Argentina,NA,La Pampa,355422,0,0,179,14
2020-08-15,Argentina,NA,La Pampa,355422,1,0,180,14
2020-08-16,Argentina,NA,La Pampa,355422,1,1,181,15
2020-08-17,Argentina,NA,La Pampa,355422,1,1,182,16
2020-08-18,Argentina,NA,La Pampa,355422,1,0,183,16
2020-08-19,Argentina,NA,La Pampa,355422,0,0,183,16
2020-08-20,Argentina,NA,La Pampa,355422,1,0,184,16
2020-08-21,Argentina,NA,La Pampa,355422,2,0,186,16
2020-08-22,Argentina,NA,La Pampa,355422,0,0,186,16
2020-08-23,Argentina,NA,La Pampa,355422,0,0,186,16
2020-08-24,Argentina,NA,La Pampa,355422,1,0,187,16
2020-08-25,Argentina,NA,La Pampa,355422,1,1,188,17
2020-08-26,Argentina,NA,La Pampa,355422,1,0,189,17
2020-08-27,Argentina,NA,La Pampa,355422,0,0,189,17
2020-08-28,Argentina,NA,La Pampa,355422,4,0,193,17
2020-08-29,Argentina,NA,La Pampa,355422,3,0,196,17
2020-08-30,Argentina,NA,La Pampa,355422,0,1,196,18
2020-08-31,Argentina,NA,La Pampa,355422,3,0,199,18
2020-09-01,Argentina,NA,La Pampa,355422,7,1,206,19
2020-09-02,Argentina,NA,La Pampa,355422,2,0,208,19
2020-09-03,Argentina,NA,La Pampa,355422,5,1,213,20
2020-09-04,Argentina,NA,La Pampa,355422,11,0,224,20
2020-09-05,Argentina,NA,La Pampa,355422,1,0,225,20
2020-09-06,Argentina,NA,La Pampa,355422,4,0,229,20
2020-09-07,Argentina,NA,La Pampa,355422,6,0,235,20
2020-09-08,Argentina,NA,La Pampa,355422,16,0,251,20
2020-09-09,Argentina,NA,La Pampa,355422,24,0,275,20
2020-09-10,Argentina,NA,La Pampa,355422,23,0,298,20
2020-09-11,Argentina,NA,La Pampa,355422,46,0,344,20
2020-09-12,Argentina,NA,La Pampa,355422,20,0,364,20
2020-09-13,Argentina,NA,La Pampa,355422,58,0,422,20
2020-09-14,Argentina,NA,La Pampa,355422,26,0,448,20
2020-09-15,Argentina,NA,La Pampa,355422,30,0,478,20
2020-09-16,Argentina,NA,La Pampa,355422,28,0,506,20
2020-09-17,Argentina,NA,La Pampa,355422,20,0,526,20
2020-09-18,Argentina,NA,La Pampa,355422,5,0,531,20
2020-09-19,Argentina,NA,La Pampa,355422,13,0,544,20
2020-09-20,Argentina,NA,La Pampa,355422,28,0,572,20
2020-09-21,Argentina,NA,La Pampa,355422,24,0,596,20
2020-09-22,Argentina,NA,La Pampa,355422,19,0,615,20
2020-09-23,Argentina,NA,La Pampa,355422,13,0,628,20
2020-04-08,Argentina,NA,La Rioja,388386,4,0,13,2
2020-04-09,Argentina,NA,La Rioja,388386,1,0,14,2
2020-04-10,Argentina,NA,La Rioja,388386,2,0,16,3
2020-04-11,Argentina,NA,La Rioja,388386,2,1,18,3
2020-04-12,Argentina,NA,La Rioja,388386,4,0,22,4
2020-04-13,Argentina,NA,La Rioja,388386,6,2,28,5
2020-04-14,Argentina,NA,La Rioja,388386,1,0,29,5
2020-04-15,Argentina,NA,La Rioja,388386,5,0,34,6
2020-04-16,Argentina,NA,La Rioja,388386,1,0,35,7
2020-04-17,Argentina,NA,La Rioja,388386,0,1,35,7
2020-04-18,Argentina,NA,La Rioja,388386,1,0,36,7
2020-04-19,Argentina,NA,La Rioja,388386,3,0,39,7
2020-04-20,Argentina,NA,La Rioja,388386,1,0,40,8
2020-04-21,Argentina,NA,La Rioja,388386,5,2,45,9
2020-04-22,Argentina,NA,La Rioja,388386,0,1,45,9
2020-04-23,Argentina,NA,La Rioja,388386,0,0,45,9
2020-04-24,Argentina,NA,La Rioja,388386,5,0,50,10
2020-04-25,Argentina,NA,La Rioja,388386,1,0,51,10
2020-04-27,Argentina,NA,La Rioja,388386,1,0,52,10
2020-04-28,Argentina,NA,La Rioja,388386,1,0,53,10
2020-04-29,Argentina,NA,La Rioja,388386,0,0,53,10
2020-04-30,Argentina,NA,La Rioja,388386,3,0,56,11
2020-05-01,Argentina,NA,La Rioja,388386,0,0,56,11
2020-05-02,Argentina,NA,La Rioja,388386,0,0,56,11
2020-05-03,Argentina,NA,La Rioja,388386,0,0,56,11
2020-05-04,Argentina,NA,La Rioja,388386,0,0,56,11
2020-05-05,Argentina,NA,La Rioja,388386,1,0,57,11
2020-05-06,Argentina,NA,La Rioja,388386,1,0,58,11
2020-05-07,Argentina,NA,La Rioja,388386,1,1,59,11
2020-05-08,Argentina,NA,La Rioja,388386,0,1,59,11
2020-05-09,Argentina,NA,La Rioja,388386,0,0,59,11
2020-05-10,Argentina,NA,La Rioja,388386,1,0,60,12
2020-05-11,Argentina,NA,La Rioja,388386,0,0,60,12
2020-05-12,Argentina,NA,La Rioja,388386,0,0,60,12
2020-05-13,Argentina,NA,La Rioja,388386,0,0,60,12
2020-05-14,Argentina,NA,La Rioja,388386,0,0,60,12
2020-05-15,Argentina,NA,La Rioja,388386,0,0,60,12
2020-05-16,Argentina,NA,La Rioja,388386,1,0,61,12
2020-05-17,Argentina,NA,La Rioja,388386,2,1,63,12
2020-05-18,Argentina,NA,La Rioja,388386,0,0,63,12
2020-05-19,Argentina,NA,La Rioja,388386,0,0,63,12
2020-05-20,Argentina,NA,La Rioja,388386,0,1,63,12
2020-05-21,Argentina,NA,La Rioja,388386,0,0,63,12
2020-05-22,Argentina,NA,La Rioja,388386,0,0,63,12
2020-05-23,Argentina,NA,La Rioja,388386,0,0,63,12
2020-05-24,Argentina,NA,La Rioja,388386,0,0,63,12
2020-05-25,Argentina,NA,La Rioja,388386,0,0,63,12
2020-05-26,Argentina,NA,La Rioja,388386,0,0,63,12
2020-05-27,Argentina,NA,La Rioja,388386,0,0,63,12
2020-05-28,Argentina,NA,La Rioja,388386,0,1,63,12
2020-05-29,Argentina,NA,La Rioja,388386,0,2,63,12
2020-05-30,Argentina,NA,La Rioja,388386,0,0,63,12
2020-05-31,Argentina,NA,La Rioja,388386,0,0,63,12
2020-06-01,Argentina,NA,La Rioja,388386,0,0,63,12
2020-06-02,Argentina,NA,La Rioja,388386,0,0,63,12
2020-06-03,Argentina,NA,La Rioja,388386,0,0,63,12
2020-06-04,Argentina,NA,La Rioja,388386,0,0,63,12
2020-06-05,Argentina,NA,La Rioja,388386,0,0,63,12
2020-06-06,Argentina,NA,La Rioja,388386,1,2,64,12
2020-06-07,Argentina,NA,La Rioja,388386,0,0,64,12
2020-06-08,Argentina,NA,La Rioja,388386,0,0,64,12
2020-06-09,Argentina,NA,La Rioja,388386,0,0,64,12
2020-06-10,Argentina,NA,La Rioja,388386,0,0,64,12
2020-06-11,Argentina,NA,La Rioja,388386,0,0,64,12
2020-06-12,Argentina,NA,La Rioja,388386,0,0,64,12
2020-06-13,Argentina,NA,La Rioja,388386,0,0,64,12
2020-06-14,Argentina,NA,La Rioja,388386,0,0,64,12
2020-06-15,Argentina,NA,La Rioja,388386,0,0,64,12
2020-06-16,Argentina,NA,La Rioja,388386,0,0,64,12
2020-06-17,Argentina,NA,La Rioja,388386,0,0,64,12
2020-06-18,Argentina,NA,La Rioja,388386,0,1,64,12
2020-06-19,Argentina,NA,La Rioja,388386,0,0,64,12
2020-06-20,Argentina,NA,La Rioja,388386,0,0,64,12
2020-06-21,Argentina,NA,La Rioja,388386,0,0,64,12
2020-06-22,Argentina,NA,La Rioja,388386,1,0,65,13
2020-06-23,Argentina,NA,La Rioja,388386,6,0,71,14
2020-06-24,Argentina,NA,La Rioja,388386,2,0,73,14
2020-06-25,Argentina,NA,La Rioja,388386,1,0,74,14
2020-06-26,Argentina,NA,La Rioja,388386,0,0,74,14
2020-06-27,Argentina,NA,La Rioja,388386,1,1,75,15
2020-06-28,Argentina,NA,La Rioja,388386,6,0,81,16
2020-06-29,Argentina,NA,La Rioja,388386,4,1,85,17
2020-06-30,Argentina,NA,La Rioja,388386,1,0,86,17
2020-07-01,Argentina,NA,La Rioja,388386,3,0,89,17
2020-07-02,Argentina,NA,La Rioja,388386,3,0,92,18
2020-07-03,Argentina,NA,La Rioja,388386,5,0,97,19
2020-07-04,Argentina,NA,La Rioja,388386,5,0,102,20
2020-07-05,Argentina,NA,La Rioja,388386,4,0,106,21
2020-07-06,Argentina,NA,La Rioja,388386,14,1,120,24
2020-07-07,Argentina,NA,La Rioja,388386,6,0,126,24
2020-07-08,Argentina,NA,La Rioja,388386,1,0,127,24
2020-07-09,Argentina,NA,La Rioja,388386,6,1,133,25
2020-07-10,Argentina,NA,La Rioja,388386,5,1,138,26
2020-07-11,Argentina,NA,La Rioja,388386,5,0,143,26
2020-07-12,Argentina,NA,La Rioja,388386,6,0,149,26
2020-07-13,Argentina,NA,La Rioja,388386,8,0,157,26
2020-07-14,Argentina,NA,La Rioja,388386,2,2,159,28
2020-07-15,Argentina,NA,La Rioja,388386,5,0,164,28
2020-07-16,Argentina,NA,La Rioja,388386,5,0,169,28
2020-07-17,Argentina,NA,La Rioja,388386,17,2,186,30
2020-07-18,Argentina,NA,La Rioja,388386,5,1,191,31
2020-07-20,Argentina,NA,La Rioja,388386,1,0,192,31
2020-07-21,Argentina,NA,La Rioja,388386,10,1,202,32
2020-07-22,Argentina,NA,La Rioja,388386,9,1,211,33
2020-07-23,Argentina,NA,La Rioja,388386,10,0,221,33
2020-07-24,Argentina,NA,La Rioja,388386,16,0,237,33
2020-07-25,Argentina,NA,La Rioja,388386,6,0,243,33
2020-07-26,Argentina,NA,La Rioja,388386,12,1,255,34
2020-07-27,Argentina,NA,La Rioja,388386,14,1,269,35
2020-07-28,Argentina,NA,La Rioja,388386,32,1,301,36
2020-07-29,Argentina,NA,La Rioja,388386,11,0,312,36
2020-07-30,Argentina,NA,La Rioja,388386,36,0,348,36
2020-07-31,Argentina,NA,La Rioja,388386,16,2,364,38
2020-08-01,Argentina,NA,La Rioja,388386,14,0,378,38
2020-08-02,Argentina,NA,La Rioja,388386,8,0,386,38
2020-08-03,Argentina,NA,La Rioja,388386,21,2,407,40
2020-08-04,Argentina,NA,La Rioja,388386,27,1,434,41
2020-08-05,Argentina,NA,La Rioja,388386,39,0,473,41
2020-08-06,Argentina,NA,La Rioja,388386,31,1,504,42
2020-08-07,Argentina,NA,La Rioja,388386,36,2,540,44
2020-08-08,Argentina,NA,La Rioja,388386,15,0,555,44
2020-08-09,Argentina,NA,La Rioja,388386,27,0,582,44
2020-08-10,Argentina,NA,La Rioja,388386,51,2,633,46
2020-08-11,Argentina,NA,La Rioja,388386,42,0,675,46
2020-08-12,Argentina,NA,La Rioja,388386,57,2,732,48
2020-08-13,Argentina,NA,La Rioja,388386,49,0,781,48
2020-08-14,Argentina,NA,La Rioja,388386,101,0,882,48
2020-08-15,Argentina,NA,La Rioja,388386,56,2,938,50
2020-08-16,Argentina,NA,La Rioja,388386,40,0,978,50
2020-08-17,Argentina,NA,La Rioja,388386,21,3,999,53
2020-08-18,Argentina,NA,La Rioja,388386,53,3,1052,56
2020-08-19,Argentina,NA,La Rioja,388386,46,1,1098,57
2020-08-20,Argentina,NA,La Rioja,388386,61,0,1159,57
2020-08-21,Argentina,NA,La Rioja,388386,38,1,1197,58
2020-08-22,Argentina,NA,La Rioja,388386,44,3,1241,61
2020-08-23,Argentina,NA,La Rioja,388386,59,4,1300,65
2020-08-24,Argentina,NA,La Rioja,388386,56,4,1356,69
2020-08-25,Argentina,NA,La Rioja,388386,83,4,1439,73
2020-08-26,Argentina,NA,La Rioja,388386,111,3,1550,76
2020-08-27,Argentina,NA,La Rioja,388386,98,2,1648,78
2020-08-28,Argentina,NA,La Rioja,388386,97,5,1745,83
2020-08-29,Argentina,NA,La Rioja,388386,109,6,1854,89
2020-08-30,Argentina,NA,La Rioja,388386,97,4,1951,93
2020-08-31,Argentina,NA,La Rioja,388386,131,4,2082,97
2020-09-01,Argentina,NA,La Rioja,388386,157,0,2239,97
2020-09-02,Argentina,NA,La Rioja,388386,77,1,2316,98
2020-09-03,Argentina,NA,La Rioja,388386,107,5,2423,103
2020-09-04,Argentina,NA,La Rioja,388386,145,3,2568,106
2020-09-05,Argentina,NA,La Rioja,388386,138,3,2706,109
2020-09-06,Argentina,NA,La Rioja,388386,76,4,2782,113
2020-09-07,Argentina,NA,La Rioja,388386,142,4,2924,117
2020-09-08,Argentina,NA,La Rioja,388386,64,3,2988,120
2020-09-09,Argentina,NA,La Rioja,388386,107,5,3095,125
2020-09-10,Argentina,NA,La Rioja,388386,143,3,3238,128
2020-09-11,Argentina,NA,La Rioja,388386,134,3,3372,131
2020-09-12,Argentina,NA,La Rioja,388386,77,2,3449,133
2020-09-13,Argentina,NA,La Rioja,388386,87,1,3536,134
2020-09-14,Argentina,NA,La Rioja,388386,104,0,3640,134
2020-09-15,Argentina,NA,La Rioja,388386,113,2,3753,136
2020-09-16,Argentina,NA,La Rioja,388386,79,0,3832,136
2020-09-17,Argentina,NA,La Rioja,388386,71,5,3903,141
2020-09-18,Argentina,NA,La Rioja,388386,122,0,4025,141
2020-09-19,Argentina,NA,La Rioja,388386,106,0,4131,141
2020-09-20,Argentina,NA,La Rioja,388386,70,0,4201,141
2020-09-21,Argentina,NA,La Rioja,388386,53,0,4254,141
2020-09-22,Argentina,NA,La Rioja,388386,82,0,4336,141
2020-09-23,Argentina,NA,La Rioja,388386,25,0,4361,141
2020-03-29,Argentina,NA,Mendoza,1969982,1,0,11,2
2020-03-30,Argentina,NA,Mendoza,1969982,0,0,11,2
2020-03-31,Argentina,NA,Mendoza,1969982,2,0,13,2
2020-04-01,Argentina,NA,Mendoza,1969982,10,2,23,4
2020-04-02,Argentina,NA,Mendoza,1969982,2,2,25,5
2020-04-03,Argentina,NA,Mendoza,1969982,3,0,28,5
2020-04-04,Argentina,NA,Mendoza,1969982,2,2,30,6
2020-04-05,Argentina,NA,Mendoza,1969982,1,1,31,6
2020-04-06,Argentina,NA,Mendoza,1969982,0,0,31,6
2020-04-07,Argentina,NA,Mendoza,1969982,5,2,36,7
2020-04-08,Argentina,NA,Mendoza,1969982,5,0,41,8
2020-04-09,Argentina,NA,Mendoza,1969982,7,0,48,9
2020-04-10,Argentina,NA,Mendoza,1969982,2,0,50,10
2020-04-11,Argentina,NA,Mendoza,1969982,5,0,55,11
2020-04-12,Argentina,NA,Mendoza,1969982,2,1,57,11
2020-04-13,Argentina,NA,Mendoza,1969982,1,1,58,11
2020-04-14,Argentina,NA,Mendoza,1969982,4,2,62,12
2020-04-15,Argentina,NA,Mendoza,1969982,1,1,63,12
2020-04-16,Argentina,NA,Mendoza,1969982,4,2,67,13
2020-04-17,Argentina,NA,Mendoza,1969982,1,0,68,13
2020-04-18,Argentina,NA,Mendoza,1969982,1,1,69,13
2020-04-19,Argentina,NA,Mendoza,1969982,1,3,70,14
2020-04-20,Argentina,NA,Mendoza,1969982,1,0,71,14
2020-04-21,Argentina,NA,Mendoza,1969982,2,1,73,14
2020-04-22,Argentina,NA,Mendoza,1969982,1,0,74,14
2020-04-23,Argentina,NA,Mendoza,1969982,0,3,74,14
2020-04-24,Argentina,NA,Mendoza,1969982,0,0,74,14
2020-04-25,Argentina,NA,Mendoza,1969982,1,0,75,15
2020-04-26,Argentina,NA,Mendoza,1969982,0,0,75,15
2020-04-27,Argentina,NA,Mendoza,1969982,0,2,75,15
2020-04-28,Argentina,NA,Mendoza,1969982,1,4,76,15
2020-04-29,Argentina,NA,Mendoza,1969982,3,0,79,15
2020-04-30,Argentina,NA,Mendoza,1969982,5,1,84,16
2020-05-01,Argentina,NA,Mendoza,1969982,0,1,84,16
2020-05-02,Argentina,NA,Mendoza,1969982,0,0,84,16
2020-05-03,Argentina,NA,Mendoza,1969982,0,1,84,16
2020-05-04,Argentina,NA,Mendoza,1969982,1,0,85,17
2020-05-05,Argentina,NA,Mendoza,1969982,0,0,85,17
2020-05-06,Argentina,NA,Mendoza,1969982,0,1,85,17
2020-05-07,Argentina,NA,Mendoza,1969982,0,0,85,17
2020-05-08,Argentina,NA,Mendoza,1969982,1,1,86,17
2020-05-09,Argentina,NA,Mendoza,1969982,0,0,86,17
2020-05-10,Argentina,NA,Mendoza,1969982,0,4,86,17
2020-05-11,Argentina,NA,Mendoza,1969982,0,0,86,17
2020-05-12,Argentina,NA,Mendoza,1969982,1,0,87,17
2020-05-13,Argentina,NA,Mendoza,1969982,0,0,87,17
2020-05-14,Argentina,NA,Mendoza,1969982,0,1,87,17
2020-05-15,Argentina,NA,Mendoza,1969982,0,0,87,17
2020-05-16,Argentina,NA,Mendoza,1969982,0,0,87,17
2020-05-17,Argentina,NA,Mendoza,1969982,0,0,87,17
2020-05-18,Argentina,NA,Mendoza,1969982,0,1,87,17
2020-05-19,Argentina,NA,Mendoza,1969982,0,0,87,17
2020-05-20,Argentina,NA,Mendoza,1969982,0,1,87,17
2020-05-21,Argentina,NA,Mendoza,1969982,1,0,88,17
2020-05-22,Argentina,NA,Mendoza,1969982,0,0,88,17
2020-05-23,Argentina,NA,Mendoza,1969982,0,0,88,17
2020-05-24,Argentina,NA,Mendoza,1969982,0,1,88,17
2020-05-25,Argentina,NA,Mendoza,1969982,0,2,88,17
2020-05-26,Argentina,NA,Mendoza,1969982,0,3,88,17
2020-05-27,Argentina,NA,Mendoza,1969982,0,0,88,17
2020-05-28,Argentina,NA,Mendoza,1969982,0,2,88,17
2020-05-29,Argentina,NA,Mendoza,1969982,3,1,91,18
2020-05-30,Argentina,NA,Mendoza,1969982,0,0,91,18
2020-05-31,Argentina,NA,Mendoza,1969982,8,0,99,19
2020-06-01,Argentina,NA,Mendoza,1969982,0,0,99,19
2020-06-02,Argentina,NA,Mendoza,1969982,0,1,99,19
2020-06-03,Argentina,NA,Mendoza,1969982,0,0,99,19
2020-06-04,Argentina,NA,Mendoza,1969982,0,0,99,19
2020-06-05,Argentina,NA,Mendoza,1969982,0,0,99,19
2020-06-06,Argentina,NA,Mendoza,1969982,0,0,99,19
2020-06-07,Argentina,NA,Mendoza,1969982,0,1,99,19
2020-06-08,Argentina,NA,Mendoza,1969982,1,0,100,20
2020-06-09,Argentina,NA,Mendoza,1969982,1,0,101,20
2020-06-10,Argentina,NA,Mendoza,1969982,1,0,102,20
2020-06-11,Argentina,NA,Mendoza,1969982,1,1,103,20
2020-06-12,Argentina,NA,Mendoza,1969982,1,0,104,20
2020-06-13,Argentina,NA,Mendoza,1969982,1,0,105,21
2020-06-14,Argentina,NA,Mendoza,1969982,6,0,111,22
2020-06-15,Argentina,NA,Mendoza,1969982,3,1,114,22
2020-06-16,Argentina,NA,Mendoza,1969982,1,1,115,23
2020-06-17,Argentina,NA,Mendoza,1969982,1,2,116,23
2020-06-18,Argentina,NA,Mendoza,1969982,3,0,119,23
2020-06-19,Argentina,NA,Mendoza,1969982,4,0,123,24
2020-06-20,Argentina,NA,Mendoza,1969982,7,0,130,26
2020-06-21,Argentina,NA,Mendoza,1969982,1,0,131,26
2020-06-22,Argentina,NA,Mendoza,1969982,4,1,135,27
2020-06-23,Argentina,NA,Mendoza,1969982,8,2,143,28
2020-06-24,Argentina,NA,Mendoza,1969982,5,0,148,29
2020-06-25,Argentina,NA,Mendoza,1969982,2,0,150,30
2020-06-26,Argentina,NA,Mendoza,1969982,6,0,156,31
2020-06-27,Argentina,NA,Mendoza,1969982,4,2,160,32
2020-06-28,Argentina,NA,Mendoza,1969982,3,1,163,32
2020-06-29,Argentina,NA,Mendoza,1969982,0,0,163,32
2020-06-30,Argentina,NA,Mendoza,1969982,6,0,169,33
2020-07-01,Argentina,NA,Mendoza,1969982,6,0,175,35
2020-07-02,Argentina,NA,Mendoza,1969982,4,0,179,35
2020-07-03,Argentina,NA,Mendoza,1969982,4,0,183,36
2020-07-04,Argentina,NA,Mendoza,1969982,7,0,190,38
2020-07-05,Argentina,NA,Mendoza,1969982,6,1,196,39
2020-07-06,Argentina,NA,Mendoza,1969982,22,1,218,43
2020-07-07,Argentina,NA,Mendoza,1969982,21,0,239,47
2020-07-08,Argentina,NA,Mendoza,1969982,14,1,253,50
2020-07-09,Argentina,NA,Mendoza,1969982,9,0,262,52
2020-07-10,Argentina,NA,Mendoza,1969982,17,0,279,55
2020-07-11,Argentina,NA,Mendoza,1969982,10,0,289,57
2020-07-12,Argentina,NA,Mendoza,1969982,16,0,305,61
2020-07-13,Argentina,NA,Mendoza,1969982,15,1,320,64
2020-07-14,Argentina,NA,Mendoza,1969982,40,0,360,70
2020-07-15,Argentina,NA,Mendoza,1969982,23,2,383,72
2020-07-16,Argentina,NA,Mendoza,1969982,18,3,401,75
2020-07-17,Argentina,NA,Mendoza,1969982,44,2,445,77
2020-07-18,Argentina,NA,Mendoza,1969982,42,2,487,79
2020-07-19,Argentina,NA,Mendoza,1969982,30,1,517,80
2020-07-20,Argentina,NA,Mendoza,1969982,38,1,555,81
2020-07-21,Argentina,NA,Mendoza,1969982,62,0,617,81
2020-07-22,Argentina,NA,Mendoza,1969982,42,2,659,83
2020-07-23,Argentina,NA,Mendoza,1969982,53,3,712,86
2020-07-24,Argentina,NA,Mendoza,1969982,75,1,787,87
2020-07-25,Argentina,NA,Mendoza,1969982,31,4,818,91
2020-07-26,Argentina,NA,Mendoza,1969982,47,2,865,93
2020-07-27,Argentina,NA,Mendoza,1969982,78,2,943,95
2020-07-28,Argentina,NA,Mendoza,1969982,68,3,1011,98
2020-07-29,Argentina,NA,Mendoza,1969982,68,5,1079,103
2020-07-30,Argentina,NA,Mendoza,1969982,109,2,1188,105
2020-07-31,Argentina,NA,Mendoza,1969982,127,1,1315,106
2020-08-01,Argentina,NA,Mendoza,1969982,69,4,1384,110
2020-08-02,Argentina,NA,Mendoza,1969982,111,7,1495,117
2020-08-03,Argentina,NA,Mendoza,1969982,96,3,1591,120
2020-08-04,Argentina,NA,Mendoza,1969982,96,3,1687,123
2020-08-05,Argentina,NA,Mendoza,1969982,83,2,1770,125
2020-08-06,Argentina,NA,Mendoza,1969982,147,2,1917,127
2020-08-07,Argentina,NA,Mendoza,1969982,126,2,2043,129
2020-08-08,Argentina,NA,Mendoza,1969982,117,2,2160,131
2020-08-09,Argentina,NA,Mendoza,1969982,79,3,2239,134
2020-08-10,Argentina,NA,Mendoza,1969982,145,4,2384,138
2020-08-11,Argentina,NA,Mendoza,1969982,178,5,2562,143
2020-08-12,Argentina,NA,Mendoza,1969982,147,3,2709,146
2020-08-13,Argentina,NA,Mendoza,1969982,206,3,2915,149
2020-08-14,Argentina,NA,Mendoza,1969982,237,6,3152,155
2020-08-15,Argentina,NA,Mendoza,1969982,204,3,3356,158
2020-08-16,Argentina,NA,Mendoza,1969982,161,2,3517,160
2020-08-17,Argentina,NA,Mendoza,1969982,144,12,3661,172
2020-08-18,Argentina,NA,Mendoza,1969982,139,4,3800,176
2020-08-19,Argentina,NA,Mendoza,1969982,241,2,4041,178
2020-08-20,Argentina,NA,Mendoza,1969982,271,7,4312,185
2020-08-21,Argentina,NA,Mendoza,1969982,199,4,4511,189
2020-08-22,Argentina,NA,Mendoza,1969982,204,5,4715,194
2020-08-23,Argentina,NA,Mendoza,1969982,139,5,4854,199
2020-08-24,Argentina,NA,Mendoza,1969982,247,8,5101,207
2020-08-25,Argentina,NA,Mendoza,1969982,315,6,5416,213
2020-08-26,Argentina,NA,Mendoza,1969982,305,3,5721,216
2020-08-27,Argentina,NA,Mendoza,1969982,331,7,6052,223
2020-08-28,Argentina,NA,Mendoza,1969982,396,4,6448,227
2020-08-29,Argentina,NA,Mendoza,1969982,349,3,6797,230
2020-08-30,Argentina,NA,Mendoza,1969982,273,9,7070,239
2020-08-31,Argentina,NA,Mendoza,1969982,324,4,7394,243
2020-09-01,Argentina,NA,Mendoza,1969982,486,1,7880,244
2020-09-02,Argentina,NA,Mendoza,1969982,604,2,8484,246
2020-09-03,Argentina,NA,Mendoza,1969982,644,5,9128,251
2020-09-04,Argentina,NA,Mendoza,1969982,640,7,9768,258
2020-09-05,Argentina,NA,Mendoza,1969982,482,3,10250,261
2020-09-06,Argentina,NA,Mendoza,1969982,464,8,10714,269
2020-09-07,Argentina,NA,Mendoza,1969982,559,9,11273,278
2020-09-08,Argentina,NA,Mendoza,1969982,554,6,11827,284
2020-09-09,Argentina,NA,Mendoza,1969982,761,10,12588,294
2020-09-10,Argentina,NA,Mendoza,1969982,732,6,13320,300
2020-09-11,Argentina,NA,Mendoza,1969982,808,7,14128,307
2020-09-12,Argentina,NA,Mendoza,1969982,637,2,14765,309
2020-09-13,Argentina,NA,Mendoza,1969982,491,7,15256,316
2020-09-14,Argentina,NA,Mendoza,1969982,516,3,15772,319
2020-09-15,Argentina,NA,Mendoza,1969982,659,4,16431,323
2020-09-16,Argentina,NA,Mendoza,1969982,660,4,17091,327
2020-09-17,Argentina,NA,Mendoza,1969982,509,11,17600,338
2020-09-18,Argentina,NA,Mendoza,1969982,690,4,18290,342
2020-09-19,Argentina,NA,Mendoza,1969982,547,7,18837,349
2020-09-20,Argentina,NA,Mendoza,1969982,414,4,19251,353
2020-09-21,Argentina,NA,Mendoza,1969982,256,7,19507,360
2020-09-22,Argentina,NA,Mendoza,1969982,327,6,19834,366
2020-09-23,Argentina,NA,Mendoza,1969982,421,4,20255,370
2020-03-28,Argentina,NA,Neuquen,655501,2,0,11,1
2020-03-29,Argentina,NA,Neuquen,655501,5,0,16,1
2020-03-30,Argentina,NA,Neuquen,655501,4,1,20,2
2020-03-31,Argentina,NA,Neuquen,655501,4,1,24,3
2020-04-01,Argentina,NA,Neuquen,655501,3,0,27,3
2020-04-02,Argentina,NA,Neuquen,655501,3,0,30,3
2020-04-03,Argentina,NA,Neuquen,655501,1,0,31,3
2020-04-04,Argentina,NA,Neuquen,655501,8,0,39,3
2020-04-05,Argentina,NA,Neuquen,655501,11,0,50,3
2020-04-06,Argentina,NA,Neuquen,655501,1,1,51,4
2020-04-07,Argentina,NA,Neuquen,655501,4,0,55,4
2020-04-08,Argentina,NA,Neuquen,655501,12,1,67,5
2020-04-09,Argentina,NA,Neuquen,655501,4,0,71,5
2020-04-10,Argentina,NA,Neuquen,655501,1,0,72,5
2020-04-11,Argentina,NA,Neuquen,655501,1,0,73,5
2020-04-12,Argentina,NA,Neuquen,655501,5,0,78,5
2020-04-13,Argentina,NA,Neuquen,655501,1,0,79,5
2020-04-14,Argentina,NA,Neuquen,655501,2,0,81,5
2020-04-15,Argentina,NA,Neuquen,655501,1,0,82,5
2020-04-16,Argentina,NA,Neuquen,655501,0,0,82,5
2020-04-17,Argentina,NA,Neuquen,655501,3,0,85,5
2020-04-18,Argentina,NA,Neuquen,655501,2,0,87,5
2020-04-19,Argentina,NA,Neuquen,655501,1,0,88,5
2020-04-20,Argentina,NA,Neuquen,655501,4,1,92,6
2020-04-21,Argentina,NA,Neuquen,655501,7,0,99,6
2020-04-22,Argentina,NA,Neuquen,655501,3,0,102,6
2020-04-23,Argentina,NA,Neuquen,655501,0,0,102,6
2020-04-24,Argentina,NA,Neuquen,655501,0,1,102,7
2020-04-25,Argentina,NA,Neuquen,655501,1,0,103,7
2020-04-26,Argentina,NA,Neuquen,655501,3,0,106,7
2020-04-27,Argentina,NA,Neuquen,655501,0,1,106,8
2020-04-28,Argentina,NA,Neuquen,655501,0,1,106,9
2020-04-29,Argentina,NA,Neuquen,655501,2,0,108,9
2020-04-30,Argentina,NA,Neuquen,655501,0,0,108,9
2020-05-01,Argentina,NA,Neuquen,655501,0,0,108,9
2020-05-02,Argentina,NA,Neuquen,655501,1,1,109,10
2020-05-03,Argentina,NA,Neuquen,655501,0,0,109,10
2020-05-04,Argentina,NA,Neuquen,655501,0,0,109,10
2020-05-05,Argentina,NA,Neuquen,655501,1,0,110,10
2020-05-06,Argentina,NA,Neuquen,655501,2,0,112,10
2020-05-07,Argentina,NA,Neuquen,655501,0,0,112,10
2020-05-08,Argentina,NA,Neuquen,655501,0,0,112,10
2020-05-09,Argentina,NA,Neuquen,655501,1,0,113,10
2020-05-10,Argentina,NA,Neuquen,655501,0,0,113,10
2020-05-11,Argentina,NA,Neuquen,655501,0,0,113,10
2020-05-12,Argentina,NA,Neuquen,655501,0,0,113,10
2020-05-13,Argentina,NA,Neuquen,655501,2,0,115,10
2020-05-14,Argentina,NA,Neuquen,655501,1,0,116,10
2020-05-15,Argentina,NA,Neuquen,655501,0,0,116,10
2020-05-16,Argentina,NA,Neuquen,655501,0,0,116,10
2020-05-17,Argentina,NA,Neuquen,655501,0,0,116,10
2020-05-18,Argentina,NA,Neuquen,655501,0,0,116,10
2020-05-19,Argentina,NA,Neuquen,655501,0,0,116,10
2020-05-20,Argentina,NA,Neuquen,655501,0,0,116,10
2020-05-21,Argentina,NA,Neuquen,655501,0,0,116,10
2020-05-22,Argentina,NA,Neuquen,655501,1,0,117,10
2020-05-23,Argentina,NA,Neuquen,655501,0,0,117,10
2020-05-24,Argentina,NA,Neuquen,655501,0,0,117,10
2020-05-25,Argentina,NA,Neuquen,655501,1,0,118,10
2020-05-26,Argentina,NA,Neuquen,655501,1,1,119,11
2020-05-27,Argentina,NA,Neuquen,655501,2,0,121,11
2020-05-28,Argentina,NA,Neuquen,655501,2,0,123,11
2020-05-29,Argentina,NA,Neuquen,655501,4,0,127,11
2020-05-30,Argentina,NA,Neuquen,655501,0,0,127,11
2020-05-31,Argentina,NA,Neuquen,655501,3,0,130,11
2020-06-01,Argentina,NA,Neuquen,655501,4,0,134,11
2020-06-02,Argentina,NA,Neuquen,655501,12,1,146,12
2020-06-03,Argentina,NA,Neuquen,655501,0,1,146,13
2020-06-04,Argentina,NA,Neuquen,655501,1,0,147,13
2020-06-05,Argentina,NA,Neuquen,655501,1,0,148,13
2020-06-06,Argentina,NA,Neuquen,655501,0,0,148,13
2020-06-07,Argentina,NA,Neuquen,655501,0,0,148,13
2020-06-08,Argentina,NA,Neuquen,655501,3,0,151,13
2020-06-09,Argentina,NA,Neuquen,655501,8,0,159,13
2020-06-10,Argentina,NA,Neuquen,655501,14,0,173,13
2020-06-11,Argentina,NA,Neuquen,655501,18,0,191,13
2020-06-12,Argentina,NA,Neuquen,655501,11,1,202,14
2020-06-13,Argentina,NA,Neuquen,655501,10,0,212,14
2020-06-14,Argentina,NA,Neuquen,655501,7,0,219,14
2020-06-15,Argentina,NA,Neuquen,655501,18,1,237,15
2020-06-16,Argentina,NA,Neuquen,655501,12,0,249,15
2020-06-17,Argentina,NA,Neuquen,655501,8,1,257,16
2020-06-18,Argentina,NA,Neuquen,655501,19,0,276,16
2020-06-19,Argentina,NA,Neuquen,655501,16,2,292,18
2020-06-20,Argentina,NA,Neuquen,655501,13,1,305,19
2020-06-21,Argentina,NA,Neuquen,655501,13,0,318,19
2020-06-22,Argentina,NA,Neuquen,655501,24,0,342,19
2020-06-23,Argentina,NA,Neuquen,655501,23,2,365,21
2020-06-24,Argentina,NA,Neuquen,655501,16,1,381,22
2020-06-25,Argentina,NA,Neuquen,655501,28,0,409,22
2020-06-26,Argentina,NA,Neuquen,655501,19,0,428,22
2020-06-27,Argentina,NA,Neuquen,655501,15,1,443,23
2020-06-28,Argentina,NA,Neuquen,655501,16,1,459,24
2020-06-29,Argentina,NA,Neuquen,655501,10,0,469,24
2020-06-30,Argentina,NA,Neuquen,655501,14,0,483,24
2020-07-01,Argentina,NA,Neuquen,655501,18,0,501,24
2020-07-02,Argentina,NA,Neuquen,655501,27,1,528,25
2020-07-03,Argentina,NA,Neuquen,655501,10,2,538,27
2020-07-04,Argentina,NA,Neuquen,655501,14,2,552,29
2020-07-05,Argentina,NA,Neuquen,655501,21,1,573,30
2020-07-06,Argentina,NA,Neuquen,655501,34,0,607,30
2020-07-07,Argentina,NA,Neuquen,655501,22,0,629,30
2020-07-08,Argentina,NA,Neuquen,655501,20,0,649,30
2020-07-09,Argentina,NA,Neuquen,655501,15,0,664,30
2020-07-10,Argentina,NA,Neuquen,655501,13,1,677,31
2020-07-11,Argentina,NA,Neuquen,655501,4,0,681,31
2020-07-12,Argentina,NA,Neuquen,655501,21,0,702,31
2020-07-13,Argentina,NA,Neuquen,655501,41,0,743,31
2020-07-14,Argentina,NA,Neuquen,655501,35,1,778,32
2020-07-15,Argentina,NA,Neuquen,655501,22,0,800,32
2020-07-16,Argentina,NA,Neuquen,655501,16,0,816,32
2020-07-17,Argentina,NA,Neuquen,655501,40,0,856,32
2020-07-18,Argentina,NA,Neuquen,655501,17,0,873,32
2020-07-19,Argentina,NA,Neuquen,655501,17,0,890,32
2020-07-20,Argentina,NA,Neuquen,655501,17,0,907,32
2020-07-21,Argentina,NA,Neuquen,655501,30,0,937,32
2020-07-22,Argentina,NA,Neuquen,655501,17,0,954,32
2020-07-23,Argentina,NA,Neuquen,655501,33,1,987,33
2020-07-24,Argentina,NA,Neuquen,655501,13,0,1000,33
2020-07-25,Argentina,NA,Neuquen,655501,23,0,1023,33
2020-07-26,Argentina,NA,Neuquen,655501,16,0,1039,33
2020-07-27,Argentina,NA,Neuquen,655501,44,0,1083,33
2020-07-28,Argentina,NA,Neuquen,655501,30,0,1113,33
2020-07-29,Argentina,NA,Neuquen,655501,17,1,1130,34
2020-07-30,Argentina,NA,Neuquen,655501,33,0,1163,34
2020-07-31,Argentina,NA,Neuquen,655501,24,0,1187,34
2020-08-01,Argentina,NA,Neuquen,655501,19,0,1206,34
2020-08-02,Argentina,NA,Neuquen,655501,23,2,1229,36
2020-08-03,Argentina,NA,Neuquen,655501,16,1,1245,37
2020-08-04,Argentina,NA,Neuquen,655501,75,0,1320,37
2020-08-05,Argentina,NA,Neuquen,655501,28,2,1348,39
2020-08-06,Argentina,NA,Neuquen,655501,40,1,1388,40
2020-08-07,Argentina,NA,Neuquen,655501,48,0,1436,40
2020-08-08,Argentina,NA,Neuquen,655501,27,0,1463,40
2020-08-09,Argentina,NA,Neuquen,655501,29,0,1492,40
2020-08-10,Argentina,NA,Neuquen,655501,83,1,1575,41
2020-08-11,Argentina,NA,Neuquen,655501,86,0,1661,41
2020-08-12,Argentina,NA,Neuquen,655501,35,0,1696,41
2020-08-13,Argentina,NA,Neuquen,655501,46,1,1742,42
2020-08-14,Argentina,NA,Neuquen,655501,40,0,1782,42
2020-08-15,Argentina,NA,Neuquen,655501,43,0,1825,42
2020-08-16,Argentina,NA,Neuquen,655501,50,1,1875,43
2020-08-17,Argentina,NA,Neuquen,655501,56,1,1931,44
2020-08-18,Argentina,NA,Neuquen,655501,33,2,1964,46
2020-08-19,Argentina,NA,Neuquen,655501,50,1,2014,47
2020-08-20,Argentina,NA,Neuquen,655501,64,2,2078,49
2020-08-21,Argentina,NA,Neuquen,655501,88,0,2166,49
2020-08-22,Argentina,NA,Neuquen,655501,84,2,2250,51
2020-08-23,Argentina,NA,Neuquen,655501,70,0,2320,51
2020-08-24,Argentina,NA,Neuquen,655501,104,1,2424,52
2020-08-25,Argentina,NA,Neuquen,655501,85,2,2509,54
2020-08-26,Argentina,NA,Neuquen,655501,135,0,2644,54
2020-08-27,Argentina,NA,Neuquen,655501,98,5,2742,59
2020-08-28,Argentina,NA,Neuquen,655501,99,1,2841,60
2020-08-29,Argentina,NA,Neuquen,655501,92,1,2933,61
2020-08-30,Argentina,NA,Neuquen,655501,69,2,3002,63
2020-08-31,Argentina,NA,Neuquen,655501,139,1,3141,64
2020-09-01,Argentina,NA,Neuquen,655501,150,4,3291,68
2020-09-02,Argentina,NA,Neuquen,655501,110,1,3401,69
2020-09-03,Argentina,NA,Neuquen,655501,136,6,3537,75
2020-09-04,Argentina,NA,Neuquen,655501,190,1,3727,76
2020-09-05,Argentina,NA,Neuquen,655501,141,3,3868,79
2020-09-06,Argentina,NA,Neuquen,655501,111,4,3979,83
2020-09-07,Argentina,NA,Neuquen,655501,122,2,4101,85
2020-09-08,Argentina,NA,Neuquen,655501,174,2,4275,87
2020-09-09,Argentina,NA,Neuquen,655501,138,2,4413,89
2020-09-10,Argentina,NA,Neuquen,655501,163,2,4576,91
2020-09-11,Argentina,NA,Neuquen,655501,192,0,4768,91
2020-09-12,Argentina,NA,Neuquen,655501,122,5,4890,96
2020-09-13,Argentina,NA,Neuquen,655501,350,3,5240,99
2020-09-14,Argentina,NA,Neuquen,655501,171,3,5411,102
2020-09-15,Argentina,NA,Neuquen,655501,118,4,5529,106
2020-09-16,Argentina,NA,Neuquen,655501,102,5,5631,111
2020-09-17,Argentina,NA,Neuquen,655501,44,8,5675,119
2020-09-18,Argentina,NA,Neuquen,655501,192,2,5867,121
2020-09-19,Argentina,NA,Neuquen,655501,230,5,6097,126
2020-09-20,Argentina,NA,Neuquen,655501,87,4,6184,130
2020-09-21,Argentina,NA,Neuquen,655501,142,5,6326,135
2020-09-22,Argentina,NA,Neuquen,655501,123,7,6449,142
2020-09-23,Argentina,NA,Neuquen,655501,70,2,6519,144
2020-04-03,Argentina,NA,Rio Negro,738060,4,0,13,2
2020-04-04,Argentina,NA,Rio Negro,738060,3,0,16,3
2020-04-05,Argentina,NA,Rio Negro,738060,2,0,18,3
2020-04-06,Argentina,NA,Rio Negro,738060,3,0,21,3
2020-04-07,Argentina,NA,Rio Negro,738060,6,1,27,4
2020-04-08,Argentina,NA,Rio Negro,738060,7,0,34,4
2020-04-09,Argentina,NA,Rio Negro,738060,7,2,41,6
2020-04-10,Argentina,NA,Rio Negro,738060,10,0,51,6
2020-04-11,Argentina,NA,Rio Negro,738060,18,0,69,6
2020-04-12,Argentina,NA,Rio Negro,738060,0,0,69,6
2020-04-13,Argentina,NA,Rio Negro,738060,7,1,76,7
2020-04-14,Argentina,NA,Rio Negro,738060,16,0,92,7
2020-04-15,Argentina,NA,Rio Negro,738060,12,0,104,7
2020-04-16,Argentina,NA,Rio Negro,738060,8,0,112,7
2020-04-17,Argentina,NA,Rio Negro,738060,4,0,116,7
2020-04-18,Argentina,NA,Rio Negro,738060,6,0,122,7
2020-04-19,Argentina,NA,Rio Negro,738060,5,1,127,8
2020-04-20,Argentina,NA,Rio Negro,738060,16,2,143,10
2020-04-21,Argentina,NA,Rio Negro,738060,13,0,156,10
2020-04-22,Argentina,NA,Rio Negro,738060,13,0,169,10
2020-04-23,Argentina,NA,Rio Negro,738060,6,0,175,10
2020-04-24,Argentina,NA,Rio Negro,738060,3,1,178,11
2020-04-25,Argentina,NA,Rio Negro,738060,10,1,188,12
2020-04-26,Argentina,NA,Rio Negro,738060,0,0,188,12
2020-04-27,Argentina,NA,Rio Negro,738060,6,1,194,13
2020-04-28,Argentina,NA,Rio Negro,738060,9,0,203,13
2020-04-29,Argentina,NA,Rio Negro,738060,10,1,213,14
2020-04-30,Argentina,NA,Rio Negro,738060,21,0,234,14
2020-05-01,Argentina,NA,Rio Negro,738060,2,0,236,14
2020-05-02,Argentina,NA,Rio Negro,738060,7,0,243,14
2020-05-03,Argentina,NA,Rio Negro,738060,3,1,246,15
2020-05-04,Argentina,NA,Rio Negro,738060,5,2,251,17
2020-05-05,Argentina,NA,Rio Negro,738060,9,0,260,17
2020-05-06,Argentina,NA,Rio Negro,738060,3,1,263,18
2020-05-07,Argentina,NA,Rio Negro,738060,3,0,266,18
2020-05-08,Argentina,NA,Rio Negro,738060,4,0,270,18
2020-05-09,Argentina,NA,Rio Negro,738060,1,1,271,19
2020-05-10,Argentina,NA,Rio Negro,738060,2,1,273,20
2020-05-11,Argentina,NA,Rio Negro,738060,14,0,287,20
2020-05-12,Argentina,NA,Rio Negro,738060,1,0,288,20
2020-05-13,Argentina,NA,Rio Negro,738060,4,1,292,21
2020-05-14,Argentina,NA,Rio Negro,738060,12,0,304,21
2020-05-15,Argentina,NA,Rio Negro,738060,10,1,314,22
2020-05-16,Argentina,NA,Rio Negro,738060,6,1,320,23
2020-05-17,Argentina,NA,Rio Negro,738060,2,0,322,23
2020-05-18,Argentina,NA,Rio Negro,738060,5,0,327,23
2020-05-19,Argentina,NA,Rio Negro,738060,2,1,329,24
2020-05-20,Argentina,NA,Rio Negro,738060,2,0,331,24
2020-05-21,Argentina,NA,Rio Negro,738060,6,1,337,25
2020-05-22,Argentina,NA,Rio Negro,738060,5,3,342,28
2020-05-23,Argentina,NA,Rio Negro,738060,5,0,347,28
2020-05-24,Argentina,NA,Rio Negro,738060,2,0,349,28
2020-05-25,Argentina,NA,Rio Negro,738060,3,1,352,29
2020-05-26,Argentina,NA,Rio Negro,738060,9,0,361,29
2020-05-27,Argentina,NA,Rio Negro,738060,4,0,365,29
2020-05-28,Argentina,NA,Rio Negro,738060,7,0,372,29
2020-05-29,Argentina,NA,Rio Negro,738060,15,0,387,29
2020-05-30,Argentina,NA,Rio Negro,738060,3,0,390,29
2020-05-31,Argentina,NA,Rio Negro,738060,1,1,391,30
2020-06-01,Argentina,NA,Rio Negro,738060,13,0,404,30
2020-06-02,Argentina,NA,Rio Negro,738060,5,0,409,30
2020-06-03,Argentina,NA,Rio Negro,738060,13,2,422,32
2020-06-04,Argentina,NA,Rio Negro,738060,12,0,434,32
2020-06-05,Argentina,NA,Rio Negro,738060,14,0,448,32
2020-06-06,Argentina,NA,Rio Negro,738060,14,1,462,33
2020-06-07,Argentina,NA,Rio Negro,738060,5,1,467,34
2020-06-08,Argentina,NA,Rio Negro,738060,13,3,480,37
2020-06-09,Argentina,NA,Rio Negro,738060,16,1,496,38
2020-06-10,Argentina,NA,Rio Negro,738060,15,1,511,39
2020-06-11,Argentina,NA,Rio Negro,738060,9,3,520,42
2020-06-12,Argentina,NA,Rio Negro,738060,18,1,538,43
2020-06-13,Argentina,NA,Rio Negro,738060,14,1,552,44
2020-06-14,Argentina,NA,Rio Negro,738060,0,0,552,44
2020-06-15,Argentina,NA,Rio Negro,738060,12,1,564,45
2020-06-16,Argentina,NA,Rio Negro,738060,23,0,587,45
2020-06-17,Argentina,NA,Rio Negro,738060,15,3,602,48
2020-06-18,Argentina,NA,Rio Negro,738060,43,1,645,49
2020-06-19,Argentina,NA,Rio Negro,738060,16,1,661,50
2020-06-20,Argentina,NA,Rio Negro,738060,28,2,689,52
2020-06-21,Argentina,NA,Rio Negro,738060,2,2,691,54
2020-06-22,Argentina,NA,Rio Negro,738060,15,2,706,56
2020-06-23,Argentina,NA,Rio Negro,738060,21,1,727,57
2020-06-24,Argentina,NA,Rio Negro,738060,38,1,765,58
2020-06-25,Argentina,NA,Rio Negro,738060,29,0,794,58
2020-06-26,Argentina,NA,Rio Negro,738060,20,1,814,59
2020-06-27,Argentina,NA,Rio Negro,738060,10,0,824,59
2020-06-28,Argentina,NA,Rio Negro,738060,1,0,825,59
2020-06-29,Argentina,NA,Rio Negro,738060,23,0,848,59
2020-06-30,Argentina,NA,Rio Negro,738060,18,0,866,59
2020-07-01,Argentina,NA,Rio Negro,738060,24,0,890,59
2020-07-02,Argentina,NA,Rio Negro,738060,19,1,909,60
2020-07-03,Argentina,NA,Rio Negro,738060,35,0,944,60
2020-07-04,Argentina,NA,Rio Negro,738060,17,0,961,60
2020-07-05,Argentina,NA,Rio Negro,738060,1,3,962,63
2020-07-06,Argentina,NA,Rio Negro,738060,16,2,978,65
2020-07-07,Argentina,NA,Rio Negro,738060,19,0,997,65
2020-07-08,Argentina,NA,Rio Negro,738060,16,2,1013,67
2020-07-09,Argentina,NA,Rio Negro,738060,23,1,1036,68
2020-07-10,Argentina,NA,Rio Negro,738060,26,3,1062,71
2020-07-11,Argentina,NA,Rio Negro,738060,34,0,1096,71
2020-07-12,Argentina,NA,Rio Negro,738060,2,0,1098,71
2020-07-13,Argentina,NA,Rio Negro,738060,52,1,1150,72
2020-07-14,Argentina,NA,Rio Negro,738060,22,2,1172,74
2020-07-15,Argentina,NA,Rio Negro,738060,23,0,1195,74
2020-07-16,Argentina,NA,Rio Negro,738060,52,1,1247,75
2020-07-17,Argentina,NA,Rio Negro,738060,38,3,1285,78
2020-07-18,Argentina,NA,Rio Negro,738060,29,0,1314,78
2020-07-19,Argentina,NA,Rio Negro,738060,7,4,1321,82
2020-07-20,Argentina,NA,Rio Negro,738060,35,3,1356,85
2020-07-21,Argentina,NA,Rio Negro,738060,46,1,1402,86
2020-07-22,Argentina,NA,Rio Negro,738060,60,1,1462,87
2020-07-23,Argentina,NA,Rio Negro,738060,33,0,1495,87
2020-07-24,Argentina,NA,Rio Negro,738060,51,3,1546,90
2020-07-25,Argentina,NA,Rio Negro,738060,47,1,1593,91
2020-07-26,Argentina,NA,Rio Negro,738060,6,1,1599,92
2020-07-27,Argentina,NA,Rio Negro,738060,62,1,1661,93
2020-07-28,Argentina,NA,Rio Negro,738060,66,3,1727,96
2020-07-29,Argentina,NA,Rio Negro,738060,70,2,1797,98
2020-07-30,Argentina,NA,Rio Negro,738060,106,3,1903,101
2020-07-31,Argentina,NA,Rio Negro,738060,103,2,2006,103
2020-08-01,Argentina,NA,Rio Negro,738060,74,1,2080,104
2020-08-02,Argentina,NA,Rio Negro,738060,22,2,2102,106
2020-08-03,Argentina,NA,Rio Negro,738060,183,2,2285,108
2020-08-04,Argentina,NA,Rio Negro,738060,115,3,2400,111
2020-08-05,Argentina,NA,Rio Negro,738060,180,2,2580,113
2020-08-06,Argentina,NA,Rio Negro,738060,144,2,2724,115
2020-08-07,Argentina,NA,Rio Negro,738060,109,0,2833,115
2020-08-08,Argentina,NA,Rio Negro,738060,83,7,2916,122
2020-08-09,Argentina,NA,Rio Negro,738060,32,4,2948,126
2020-08-10,Argentina,NA,Rio Negro,738060,208,5,3156,131
2020-08-11,Argentina,NA,Rio Negro,738060,159,3,3315,134
2020-08-12,Argentina,NA,Rio Negro,738060,151,3,3466,137
2020-08-13,Argentina,NA,Rio Negro,738060,104,3,3570,140
2020-08-14,Argentina,NA,Rio Negro,738060,105,0,3675,140
2020-08-15,Argentina,NA,Rio Negro,738060,103,6,3778,146
2020-08-16,Argentina,NA,Rio Negro,738060,61,3,3839,149
2020-08-17,Argentina,NA,Rio Negro,738060,75,1,3914,150
2020-08-18,Argentina,NA,Rio Negro,738060,122,3,4036,153
2020-08-19,Argentina,NA,Rio Negro,738060,97,7,4133,160
2020-08-20,Argentina,NA,Rio Negro,738060,135,2,4268,162
2020-08-21,Argentina,NA,Rio Negro,738060,171,1,4439,163
2020-08-22,Argentina,NA,Rio Negro,738060,181,4,4620,167
2020-08-23,Argentina,NA,Rio Negro,738060,50,5,4670,172
2020-08-24,Argentina,NA,Rio Negro,738060,165,8,4835,180
2020-08-25,Argentina,NA,Rio Negro,738060,140,6,4975,186
2020-08-26,Argentina,NA,Rio Negro,738060,217,6,5192,192
2020-08-27,Argentina,NA,Rio Negro,738060,136,6,5328,198
2020-08-28,Argentina,NA,Rio Negro,738060,170,3,5498,201
2020-08-29,Argentina,NA,Rio Negro,738060,169,10,5667,211
2020-08-30,Argentina,NA,Rio Negro,738060,55,5,5722,216
2020-08-31,Argentina,NA,Rio Negro,738060,133,3,5855,219
2020-09-01,Argentina,NA,Rio Negro,738060,143,7,5998,226
2020-09-02,Argentina,NA,Rio Negro,738060,143,5,6141,231
2020-09-03,Argentina,NA,Rio Negro,738060,210,5,6351,236
2020-09-04,Argentina,NA,Rio Negro,738060,176,8,6527,244
2020-09-05,Argentina,NA,Rio Negro,738060,172,5,6699,249
2020-09-06,Argentina,NA,Rio Negro,738060,66,8,6765,257
2020-09-07,Argentina,NA,Rio Negro,738060,194,8,6959,265
2020-09-08,Argentina,NA,Rio Negro,738060,269,6,7228,271
2020-09-09,Argentina,NA,Rio Negro,738060,242,8,7470,279
2020-09-10,Argentina,NA,Rio Negro,738060,289,3,7759,282
2020-09-11,Argentina,NA,Rio Negro,738060,197,3,7956,285
2020-09-12,Argentina,NA,Rio Negro,738060,251,5,8207,290
2020-09-13,Argentina,NA,Rio Negro,738060,56,4,8263,294
2020-09-14,Argentina,NA,Rio Negro,738060,213,6,8476,300
2020-09-15,Argentina,NA,Rio Negro,738060,263,3,8739,303
2020-09-16,Argentina,NA,Rio Negro,738060,247,7,8986,310
2020-09-17,Argentina,NA,Rio Negro,738060,240,8,9226,318
2020-09-18,Argentina,NA,Rio Negro,738060,199,5,9425,323
2020-09-19,Argentina,NA,Rio Negro,738060,214,6,9639,329
2020-09-20,Argentina,NA,Rio Negro,738060,61,8,9700,337
2020-09-21,Argentina,NA,Rio Negro,738060,157,15,9857,352
2020-09-22,Argentina,NA,Rio Negro,738060,233,9,10090,361
2020-09-23,Argentina,NA,Rio Negro,738060,199,8,10289,369
2020-05-31,Argentina,NA,Salta,1406584,3,0,11,2
2020-06-01,Argentina,NA,Salta,1406584,1,0,12,2
2020-06-02,Argentina,NA,Salta,1406584,4,0,16,3
2020-06-03,Argentina,NA,Salta,1406584,0,0,16,3
2020-06-04,Argentina,NA,Salta,1406584,0,0,16,3
2020-06-05,Argentina,NA,Salta,1406584,0,1,16,3
2020-06-06,Argentina,NA,Salta,1406584,0,0,16,3
2020-06-07,Argentina,NA,Salta,1406584,0,1,16,3
2020-06-08,Argentina,NA,Salta,1406584,0,0,16,3
2020-06-09,Argentina,NA,Salta,1406584,1,0,17,3
2020-06-10,Argentina,NA,Salta,1406584,0,0,17,3
2020-06-11,Argentina,NA,Salta,1406584,0,0,17,3
2020-06-13,Argentina,NA,Salta,1406584,2,0,19,3
2020-06-14,Argentina,NA,Salta,1406584,1,0,20,4
2020-06-15,Argentina,NA,Salta,1406584,0,0,20,4
2020-06-16,Argentina,NA,Salta,1406584,0,0,20,4
2020-06-17,Argentina,NA,Salta,1406584,0,0,20,4
2020-06-18,Argentina,NA,Salta,1406584,0,0,20,4
2020-06-19,Argentina,NA,Salta,1406584,0,0,20,4
2020-06-20,Argentina,NA,Salta,1406584,0,0,20,4
2020-06-21,Argentina,NA,Salta,1406584,0,0,20,4
2020-06-22,Argentina,NA,Salta,1406584,1,0,21,4
2020-06-23,Argentina,NA,Salta,1406584,3,0,24,4
2020-06-24,Argentina,NA,Salta,1406584,0,0,24,4
2020-06-25,Argentina,NA,Salta,1406584,0,0,24,4
2020-06-26,Argentina,NA,Salta,1406584,2,0,26,5
2020-06-27,Argentina,NA,Salta,1406584,0,0,26,5
2020-06-28,Argentina,NA,Salta,1406584,0,0,26,5
2020-06-29,Argentina,NA,Salta,1406584,4,0,30,6
2020-06-30,Argentina,NA,Salta,1406584,2,0,32,6
2020-07-01,Argentina,NA,Salta,1406584,0,0,32,6
2020-07-02,Argentina,NA,Salta,1406584,1,1,33,6
2020-07-03,Argentina,NA,Salta,1406584,7,1,40,8
2020-07-04,Argentina,NA,Salta,1406584,10,0,50,10
2020-07-05,Argentina,NA,Salta,1406584,2,0,52,10
2020-07-06,Argentina,NA,Salta,1406584,1,0,53,10
2020-07-07,Argentina,NA,Salta,1406584,10,0,63,11
2020-07-08,Argentina,NA,Salta,1406584,2,0,65,11
2020-07-09,Argentina,NA,Salta,1406584,2,1,67,12
2020-07-10,Argentina,NA,Salta,1406584,5,0,72,12
2020-07-11,Argentina,NA,Salta,1406584,8,0,80,12
2020-07-12,Argentina,NA,Salta,1406584,5,0,85,12
2020-07-13,Argentina,NA,Salta,1406584,6,0,91,12
2020-07-14,Argentina,NA,Salta,1406584,11,0,102,12
2020-07-15,Argentina,NA,Salta,1406584,8,1,110,13
2020-07-16,Argentina,NA,Salta,1406584,4,1,114,14
2020-07-17,Argentina,NA,Salta,1406584,6,0,120,14
2020-07-18,Argentina,NA,Salta,1406584,14,0,134,14
2020-07-19,Argentina,NA,Salta,1406584,2,1,136,15
2020-07-20,Argentina,NA,Salta,1406584,4,0,140,15
2020-07-21,Argentina,NA,Salta,1406584,17,1,157,16
2020-07-22,Argentina,NA,Salta,1406584,12,1,169,17
2020-07-23,Argentina,NA,Salta,1406584,14,0,183,17
2020-07-24,Argentina,NA,Salta,1406584,14,0,197,17
2020-07-25,Argentina,NA,Salta,1406584,12,0,209,17
2020-07-26,Argentina,NA,Salta,1406584,0,2,209,19
2020-07-27,Argentina,NA,Salta,1406584,3,1,212,20
2020-07-28,Argentina,NA,Salta,1406584,4,0,216,20
2020-07-29,Argentina,NA,Salta,1406584,23,0,239,20
2020-07-30,Argentina,NA,Salta,1406584,7,0,246,20
2020-07-31,Argentina,NA,Salta,1406584,21,1,267,21
2020-08-01,Argentina,NA,Salta,1406584,20,0,287,21
2020-08-02,Argentina,NA,Salta,1406584,4,2,291,23
2020-08-03,Argentina,NA,Salta,1406584,31,2,322,25
2020-08-04,Argentina,NA,Salta,1406584,29,0,351,25
2020-08-05,Argentina,NA,Salta,1406584,35,2,386,27
2020-08-06,Argentina,NA,Salta,1406584,64,2,450,29
2020-08-07,Argentina,NA,Salta,1406584,45,1,495,30
2020-08-08,Argentina,NA,Salta,1406584,80,0,575,30
2020-08-09,Argentina,NA,Salta,1406584,31,0,606,30
2020-08-10,Argentina,NA,Salta,1406584,50,1,656,31
2020-08-11,Argentina,NA,Salta,1406584,63,0,719,31
2020-08-12,Argentina,NA,Salta,1406584,91,1,810,32
2020-08-13,Argentina,NA,Salta,1406584,71,1,881,33
2020-08-14,Argentina,NA,Salta,1406584,91,4,972,37
2020-08-15,Argentina,NA,Salta,1406584,102,3,1074,40
2020-08-16,Argentina,NA,Salta,1406584,72,5,1146,45
2020-08-17,Argentina,NA,Salta,1406584,129,2,1275,47
2020-08-18,Argentina,NA,Salta,1406584,87,3,1362,50
2020-08-19,Argentina,NA,Salta,1406584,133,2,1495,52
2020-08-20,Argentina,NA,Salta,1406584,102,5,1597,57
2020-08-21,Argentina,NA,Salta,1406584,136,4,1733,61
2020-08-22,Argentina,NA,Salta,1406584,106,5,1839,66
2020-08-23,Argentina,NA,Salta,1406584,77,7,1916,73
2020-08-24,Argentina,NA,Salta,1406584,150,5,2066,78
2020-08-25,Argentina,NA,Salta,1406584,121,7,2187,85
2020-08-26,Argentina,NA,Salta,1406584,231,5,2418,90
2020-08-27,Argentina,NA,Salta,1406584,282,5,2700,95
2020-08-28,Argentina,NA,Salta,1406584,244,3,2944,98
2020-08-29,Argentina,NA,Salta,1406584,265,5,3209,103
2020-08-30,Argentina,NA,Salta,1406584,121,7,3330,110
2020-08-31,Argentina,NA,Salta,1406584,158,2,3488,112
2020-09-01,Argentina,NA,Salta,1406584,239,5,3727,117
2020-09-02,Argentina,NA,Salta,1406584,193,4,3920,121
2020-09-03,Argentina,NA,Salta,1406584,300,9,4220,130
2020-09-04,Argentina,NA,Salta,1406584,379,9,4599,139
2020-09-05,Argentina,NA,Salta,1406584,296,5,4895,144
2020-09-06,Argentina,NA,Salta,1406584,94,9,4989,153
2020-09-07,Argentina,NA,Salta,1406584,136,5,5125,158
2020-09-08,Argentina,NA,Salta,1406584,334,5,5459,163
2020-09-09,Argentina,NA,Salta,1406584,333,12,5792,175
2020-09-10,Argentina,NA,Salta,1406584,388,11,6180,186
2020-09-11,Argentina,NA,Salta,1406584,327,8,6507,194
2020-09-12,Argentina,NA,Salta,1406584,348,6,6855,200
2020-09-13,Argentina,NA,Salta,1406584,124,14,6979,214
2020-09-14,Argentina,NA,Salta,1406584,361,7,7340,221
2020-09-15,Argentina,NA,Salta,1406584,301,11,7641,232
2020-09-16,Argentina,NA,Salta,1406584,296,11,7937,243
2020-09-17,Argentina,NA,Salta,1406584,394,12,8331,255
2020-09-18,Argentina,NA,Salta,1406584,537,8,8868,263
2020-09-19,Argentina,NA,Salta,1406584,236,11,9104,274
2020-09-20,Argentina,NA,Salta,1406584,107,9,9211,283
2020-09-21,Argentina,NA,Salta,1406584,289,7,9500,290
2020-09-22,Argentina,NA,Salta,1406584,347,8,9847,298
2020-09-23,Argentina,NA,Salta,1406584,276,4,10123,302
2020-07-13,Argentina,NA,San Juan,772876,4,0,13,0
2020-07-14,Argentina,NA,San Juan,772876,0,0,13,0
2020-07-15,Argentina,NA,San Juan,772876,0,0,13,0
2020-07-16,Argentina,NA,San Juan,772876,0,0,13,0
2020-07-17,Argentina,NA,San Juan,772876,0,0,13,0
2020-07-18,Argentina,NA,San Juan,772876,0,0,13,0
2020-07-19,Argentina,NA,San Juan,772876,2,0,15,0
2020-07-20,Argentina,NA,San Juan,772876,0,0,15,0
2020-07-21,Argentina,NA,San Juan,772876,3,0,18,0
2020-07-22,Argentina,NA,San Juan,772876,0,0,18,0
2020-07-23,Argentina,NA,San Juan,772876,0,0,18,0
2020-07-24,Argentina,NA,San Juan,772876,0,0,18,0
2020-07-25,Argentina,NA,San Juan,772876,0,0,18,0
2020-07-26,Argentina,NA,San Juan,772876,1,0,19,0
2020-07-27,Argentina,NA,San Juan,772876,0,0,19,0
2020-07-28,Argentina,NA,San Juan,772876,0,0,19,0
2020-07-29,Argentina,NA,San Juan,772876,0,0,19,0
2020-07-30,Argentina,NA,San Juan,772876,0,0,19,0
2020-07-31,Argentina,NA,San Juan,772876,0,0,19,0
2020-08-01,Argentina,NA,San Juan,772876,0,0,19,0
2020-08-02,Argentina,NA,San Juan,772876,0,0,19,0
2020-08-03,Argentina,NA,San Juan,772876,2,0,21,0
2020-08-04,Argentina,NA,San Juan,772876,0,0,21,0
2020-08-05,Argentina,NA,San Juan,772876,0,0,21,0
2020-08-06,Argentina,NA,San Juan,772876,0,0,21,0
2020-08-07,Argentina,NA,San Juan,772876,0,0,21,0
2020-08-08,Argentina,NA,San Juan,772876,0,0,21,0
2020-08-09,Argentina,NA,San Juan,772876,0,0,21,0
2020-08-10,Argentina,NA,San Juan,772876,0,0,21,0
2020-08-11,Argentina,NA,San Juan,772876,0,0,21,0
2020-08-12,Argentina,NA,San Juan,772876,0,0,21,0
2020-08-13,Argentina,NA,San Juan,772876,0,0,21,0
2020-08-14,Argentina,NA,San Juan,772876,0,0,21,0
2020-08-15,Argentina,NA,San Juan,772876,0,0,21,0
2020-08-17,Argentina,NA,San Juan,772876,0,0,21,0
2020-08-18,Argentina,NA,San Juan,772876,0,0,21,0
2020-08-19,Argentina,NA,San Juan,772876,5,0,26,0
2020-08-20,Argentina,NA,San Juan,772876,8,0,34,0
2020-08-21,Argentina,NA,San Juan,772876,15,0,49,0
2020-08-22,Argentina,NA,San Juan,772876,13,0,62,0
2020-08-23,Argentina,NA,San Juan,772876,23,1,85,1
2020-08-24,Argentina,NA,San Juan,772876,8,0,93,1
2020-08-25,Argentina,NA,San Juan,772876,13,0,106,1
2020-08-26,Argentina,NA,San Juan,772876,49,0,155,1
2020-08-27,Argentina,NA,San Juan,772876,24,0,179,1
2020-08-28,Argentina,NA,San Juan,772876,12,1,191,2
2020-08-29,Argentina,NA,San Juan,772876,21,3,212,5
2020-08-30,Argentina,NA,San Juan,772876,26,1,238,6
2020-08-31,Argentina,NA,San Juan,772876,1,2,239,8
2020-09-01,Argentina,NA,San Juan,772876,30,0,269,8
2020-09-02,Argentina,NA,San Juan,772876,11,1,280,9
2020-09-03,Argentina,NA,San Juan,772876,59,0,339,9
2020-09-04,Argentina,NA,San Juan,772876,20,4,359,13
2020-09-05,Argentina,NA,San Juan,772876,9,0,368,13
2020-09-06,Argentina,NA,San Juan,772876,1,1,369,14
2020-09-07,Argentina,NA,San Juan,772876,0,1,369,15
2020-09-08,Argentina,NA,San Juan,772876,14,3,383,18
2020-09-09,Argentina,NA,San Juan,772876,10,0,393,18
2020-09-10,Argentina,NA,San Juan,772876,10,0,403,18
2020-09-11,Argentina,NA,San Juan,772876,12,2,415,20
2020-09-12,Argentina,NA,San Juan,772876,4,1,419,21
2020-09-13,Argentina,NA,San Juan,772876,3,1,422,22
2020-09-14,Argentina,NA,San Juan,772876,7,1,429,23
2020-09-15,Argentina,NA,San Juan,772876,4,0,433,23
2020-09-16,Argentina,NA,San Juan,772876,19,0,452,23
2020-09-17,Argentina,NA,San Juan,772876,7,1,459,24
2020-09-18,Argentina,NA,San Juan,772876,7,1,466,25
2020-09-19,Argentina,NA,San Juan,772876,8,1,474,26
2020-09-20,Argentina,NA,San Juan,772876,40,1,514,27
2020-09-21,Argentina,NA,San Juan,772876,4,1,518,28
2020-09-22,Argentina,NA,San Juan,772876,18,0,536,28
2020-09-23,Argentina,NA,San Juan,772876,11,0,547,28
2020-04-05,Argentina,NA,San Luis,502000,1,0,11,0
2020-04-06,Argentina,NA,San Luis,502000,0,0,11,0
2020-04-07,Argentina,NA,San Luis,502000,0,0,11,0
2020-04-08,Argentina,NA,San Luis,502000,0,0,11,0
2020-04-09,Argentina,NA,San Luis,502000,0,0,11,0
2020-04-10,Argentina,NA,San Luis,502000,0,0,11,0
2020-04-11,Argentina,NA,San Luis,502000,0,0,11,0
2020-04-12,Argentina,NA,San Luis,502000,0,0,11,0
2020-04-13,Argentina,NA,San Luis,502000,0,0,11,0
2020-04-14,Argentina,NA,San Luis,502000,0,0,11,0
2020-04-15,Argentina,NA,San Luis,502000,0,0,11,0
2020-04-16,Argentina,NA,San Luis,502000,0,0,11,0
2020-04-17,Argentina,NA,San Luis,502000,0,0,11,0
2020-04-18,Argentina,NA,San Luis,502000,0,0,11,0
2020-04-20,Argentina,NA,San Luis,502000,0,0,11,0
2020-04-21,Argentina,NA,San Luis,502000,0,0,11,0
2020-04-22,Argentina,NA,San Luis,502000,0,0,11,0
2020-04-23,Argentina,NA,San Luis,502000,0,0,11,0
2020-04-24,Argentina,NA,San Luis,502000,0,0,11,0
2020-04-25,Argentina,NA,San Luis,502000,0,0,11,0
2020-04-26,Argentina,NA,San Luis,502000,0,0,11,0
2020-04-27,Argentina,NA,San Luis,502000,0,0,11,0
2020-04-28,Argentina,NA,San Luis,502000,0,0,11,0
2020-05-02,Argentina,NA,San Luis,502000,0,0,11,0
2020-05-03,Argentina,NA,San Luis,502000,0,0,11,0
2020-05-04,Argentina,NA,San Luis,502000,0,0,11,0
2020-05-05,Argentina,NA,San Luis,502000,0,0,11,0
2020-05-06,Argentina,NA,San Luis,502000,0,0,11,0
2020-05-08,Argentina,NA,San Luis,502000,0,0,11,0
2020-05-09,Argentina,NA,San Luis,502000,0,0,11,0
2020-05-10,Argentina,NA,San Luis,502000,0,0,11,0
2020-05-11,Argentina,NA,San Luis,502000,0,0,11,0
2020-05-13,Argentina,NA,San Luis,502000,0,0,11,0
2020-05-14,Argentina,NA,San Luis,502000,0,0,11,0
2020-05-15,Argentina,NA,San Luis,502000,0,0,11,0
2020-05-16,Argentina,NA,San Luis,502000,0,0,11,0
2020-05-17,Argentina,NA,San Luis,502000,0,0,11,0
2020-05-18,Argentina,NA,San Luis,502000,0,0,11,0
2020-05-20,Argentina,NA,San Luis,502000,0,0,11,0
2020-05-21,Argentina,NA,San Luis,502000,0,0,11,0
2020-05-22,Argentina,NA,San Luis,502000,0,0,11,0
2020-05-23,Argentina,NA,San Luis,502000,0,0,11,0
2020-05-24,Argentina,NA,San Luis,502000,0,0,11,0
2020-05-25,Argentina,NA,San Luis,502000,0,0,11,0
2020-05-26,Argentina,NA,San Luis,502000,0,0,11,0
2020-05-27,Argentina,NA,San Luis,502000,0,0,11,0
2020-05-28,Argentina,NA,San Luis,502000,0,1,11,1
2020-05-29,Argentina,NA,San Luis,502000,0,0,11,1
2020-05-30,Argentina,NA,San Luis,502000,0,0,11,1
2020-05-31,Argentina,NA,San Luis,502000,0,0,11,1
2020-06-01,Argentina,NA,San Luis,502000,0,0,11,1
2020-06-02,Argentina,NA,San Luis,502000,0,0,11,1
2020-06-04,Argentina,NA,San Luis,502000,0,0,11,1
2020-06-05,Argentina,NA,San Luis,502000,0,0,11,1
2020-06-07,Argentina,NA,San Luis,502000,0,0,11,1
2020-06-08,Argentina,NA,San Luis,502000,0,2,11,2
2020-06-09,Argentina,NA,San Luis,502000,0,0,11,2
2020-06-10,Argentina,NA,San Luis,502000,0,0,11,2
2020-06-11,Argentina,NA,San Luis,502000,0,0,11,2
2020-06-12,Argentina,NA,San Luis,502000,0,0,11,2
2020-06-13,Argentina,NA,San Luis,502000,0,0,11,2
2020-06-15,Argentina,NA,San Luis,502000,0,0,11,2
2020-06-17,Argentina,NA,San Luis,502000,0,0,11,2
2020-06-19,Argentina,NA,San Luis,502000,0,0,11,2
2020-06-21,Argentina,NA,San Luis,502000,0,0,11,2
2020-06-22,Argentina,NA,San Luis,502000,0,0,11,2
2020-06-24,Argentina,NA,San Luis,502000,0,0,11,2
2020-06-25,Argentina,NA,San Luis,502000,0,0,11,2
2020-06-26,Argentina,NA,San Luis,502000,0,0,11,2
2020-06-28,Argentina,NA,San Luis,502000,0,0,11,2
2020-06-29,Argentina,NA,San Luis,502000,0,0,11,2
2020-06-30,Argentina,NA,San Luis,502000,0,0,11,2
2020-07-02,Argentina,NA,San Luis,502000,0,0,11,2
2020-07-03,Argentina,NA,San Luis,502000,1,0,12,2
2020-07-04,Argentina,NA,San Luis,502000,0,0,12,2
2020-07-05,Argentina,NA,San Luis,502000,0,0,12,2
2020-07-06,Argentina,NA,San Luis,502000,0,0,12,2
2020-07-07,Argentina,NA,San Luis,502000,0,0,12,2
2020-07-09,Argentina,NA,San Luis,502000,0,0,12,2
2020-07-10,Argentina,NA,San Luis,502000,0,0,12,2
2020-07-11,Argentina,NA,San Luis,502000,0,0,12,2
2020-07-12,Argentina,NA,San Luis,502000,1,0,13,2
2020-07-13,Argentina,NA,San Luis,502000,0,0,13,2
2020-07-14,Argentina,NA,San Luis,502000,0,0,13,2
2020-07-15,Argentina,NA,San Luis,502000,0,0,13,2
2020-07-16,Argentina,NA,San Luis,502000,0,0,13,2
2020-07-17,Argentina,NA,San Luis,502000,1,0,14,2
2020-07-18,Argentina,NA,San Luis,502000,0,0,14,2
2020-07-19,Argentina,NA,San Luis,502000,0,0,14,2
2020-07-20,Argentina,NA,San Luis,502000,1,0,15,3
2020-07-21,Argentina,NA,San Luis,502000,1,0,16,3
2020-07-22,Argentina,NA,San Luis,502000,2,0,18,3
2020-07-23,Argentina,NA,San Luis,502000,0,0,18,3
2020-07-24,Argentina,NA,San Luis,502000,1,0,19,3
2020-07-26,Argentina,NA,San Luis,502000,0,0,19,3
2020-07-27,Argentina,NA,San Luis,502000,0,0,19,3
2020-07-28,Argentina,NA,San Luis,502000,2,0,21,3
2020-07-29,Argentina,NA,San Luis,502000,1,0,22,3
2020-07-30,Argentina,NA,San Luis,502000,3,0,25,3
2020-07-31,Argentina,NA,San Luis,502000,0,0,25,3
2020-08-01,Argentina,NA,San Luis,502000,1,0,26,3
2020-08-02,Argentina,NA,San Luis,502000,0,0,26,3
2020-08-03,Argentina,NA,San Luis,502000,0,0,26,3
2020-08-04,Argentina,NA,San Luis,502000,4,0,30,3
2020-08-05,Argentina,NA,San Luis,502000,0,0,30,3
2020-08-06,Argentina,NA,San Luis,502000,0,0,30,3
2020-08-07,Argentina,NA,San Luis,502000,0,0,30,3
2020-08-08,Argentina,NA,San Luis,502000,0,0,30,3
2020-08-09,Argentina,NA,San Luis,502000,0,0,30,3
2020-08-10,Argentina,NA,San Luis,502000,1,0,31,3
2020-08-11,Argentina,NA,San Luis,502000,0,0,31,3
2020-08-12,Argentina,NA,San Luis,502000,0,0,31,3
2020-08-13,Argentina,NA,San Luis,502000,2,0,33,3
2020-08-14,Argentina,NA,San Luis,502000,0,0,33,3
2020-08-15,Argentina,NA,San Luis,502000,1,0,34,3
2020-08-16,Argentina,NA,San Luis,502000,0,0,34,3
2020-08-17,Argentina,NA,San Luis,502000,0,0,34,3
2020-08-18,Argentina,NA,San Luis,502000,2,0,36,3
2020-08-19,Argentina,NA,San Luis,502000,1,0,37,3
2020-08-20,Argentina,NA,San Luis,502000,1,0,38,3
2020-08-21,Argentina,NA,San Luis,502000,1,0,39,3
2020-08-22,Argentina,NA,San Luis,502000,1,0,40,3
2020-08-23,Argentina,NA,San Luis,502000,0,0,40,3
2020-08-24,Argentina,NA,San Luis,502000,0,0,40,3
2020-08-25,Argentina,NA,San Luis,502000,0,0,40,3
2020-08-26,Argentina,NA,San Luis,502000,4,0,44,3
2020-08-27,Argentina,NA,San Luis,502000,7,0,51,3
2020-08-28,Argentina,NA,San Luis,502000,12,0,63,3
2020-08-29,Argentina,NA,San Luis,502000,24,0,87,3
2020-08-30,Argentina,NA,San Luis,502000,40,0,127,3
2020-08-31,Argentina,NA,San Luis,502000,24,0,151,3
2020-09-01,Argentina,NA,San Luis,502000,8,0,159,3
2020-09-02,Argentina,NA,San Luis,502000,21,0,180,3
2020-09-03,Argentina,NA,San Luis,502000,19,0,199,3
2020-09-04,Argentina,NA,San Luis,502000,16,0,215,3
2020-09-05,Argentina,NA,San Luis,502000,35,0,250,3
2020-09-06,Argentina,NA,San Luis,502000,28,1,278,4
2020-09-07,Argentina,NA,San Luis,502000,37,0,315,4
2020-09-08,Argentina,NA,San Luis,502000,16,0,331,4
2020-09-09,Argentina,NA,San Luis,502000,19,0,350,4
2020-09-10,Argentina,NA,San Luis,502000,11,1,361,5
2020-09-11,Argentina,NA,San Luis,502000,23,0,384,5
2020-09-12,Argentina,NA,San Luis,502000,1,0,385,5
2020-09-13,Argentina,NA,San Luis,502000,2,0,387,5
2020-09-14,Argentina,NA,San Luis,502000,49,0,436,5
2020-09-15,Argentina,NA,San Luis,502000,50,1,486,6
2020-09-16,Argentina,NA,San Luis,502000,29,1,515,7
2020-09-17,Argentina,NA,San Luis,502000,60,0,575,7
2020-09-18,Argentina,NA,San Luis,502000,77,0,652,7
2020-09-19,Argentina,NA,San Luis,502000,24,0,676,7
2020-09-20,Argentina,NA,San Luis,502000,63,0,739,7
2020-09-21,Argentina,NA,San Luis,502000,46,0,785,7
2020-09-22,Argentina,NA,San Luis,502000,77,0,862,7
2020-09-23,Argentina,NA,San Luis,502000,64,0,926,7
2020-04-01,Argentina,NA,Santa Cruz,356647,11,0,20,0
2020-04-02,Argentina,NA,Santa Cruz,356647,0,0,20,0
2020-04-03,Argentina,NA,Santa Cruz,356647,1,0,21,0
2020-04-04,Argentina,NA,Santa Cruz,356647,1,0,22,0
2020-04-05,Argentina,NA,Santa Cruz,356647,0,0,22,0
2020-04-06,Argentina,NA,Santa Cruz,356647,0,0,22,0
2020-04-07,Argentina,NA,Santa Cruz,356647,7,0,29,0
2020-04-08,Argentina,NA,Santa Cruz,356647,0,0,29,0
2020-04-09,Argentina,NA,Santa Cruz,356647,2,0,31,0
2020-04-10,Argentina,NA,Santa Cruz,356647,6,0,37,0
2020-04-11,Argentina,NA,Santa Cruz,356647,1,0,38,0
2020-04-12,Argentina,NA,Santa Cruz,356647,0,1,38,1
2020-04-14,Argentina,NA,Santa Cruz,356647,0,0,38,1
2020-04-15,Argentina,NA,Santa Cruz,356647,0,0,38,1
2020-04-16,Argentina,NA,Santa Cruz,356647,1,0,39,1
2020-04-17,Argentina,NA,Santa Cruz,356647,0,0,39,1
2020-04-18,Argentina,NA,Santa Cruz,356647,0,0,39,1
2020-04-19,Argentina,NA,Santa Cruz,356647,0,0,39,1
2020-04-20,Argentina,NA,Santa Cruz,356647,1,0,40,1
2020-04-21,Argentina,NA,Santa Cruz,356647,0,0,40,1
2020-04-22,Argentina,NA,Santa Cruz,356647,0,0,40,1
2020-04-23,Argentina,NA,Santa Cruz,356647,0,0,40,1
2020-04-24,Argentina,NA,Santa Cruz,356647,1,0,41,1
2020-04-25,Argentina,NA,Santa Cruz,356647,0,0,41,1
2020-04-26,Argentina,NA,Santa Cruz,356647,5,0,46,1
2020-04-27,Argentina,NA,Santa Cruz,356647,1,1,47,2
2020-04-28,Argentina,NA,Santa Cruz,356647,0,0,47,2
2020-04-29,Argentina,NA,Santa Cruz,356647,1,1,48,3
2020-05-01,Argentina,NA,Santa Cruz,356647,0,0,48,3
2020-05-02,Argentina,NA,Santa Cruz,356647,0,0,48,3
2020-05-03,Argentina,NA,Santa Cruz,356647,0,0,48,3
2020-05-04,Argentina,NA,Santa Cruz,356647,0,0,48,3
2020-05-05,Argentina,NA,Santa Cruz,356647,0,0,48,3
2020-05-07,Argentina,NA,Santa Cruz,356647,0,0,48,3
2020-05-08,Argentina,NA,Santa Cruz,356647,0,0,48,3
2020-05-11,Argentina,NA,Santa Cruz,356647,0,0,48,3
2020-05-12,Argentina,NA,Santa Cruz,356647,0,0,48,3
2020-05-13,Argentina,NA,Santa Cruz,356647,0,0,48,3
2020-05-14,Argentina,NA,Santa Cruz,356647,0,0,48,3
2020-05-15,Argentina,NA,Santa Cruz,356647,0,0,48,3
2020-05-16,Argentina,NA,Santa Cruz,356647,0,0,48,3
2020-05-18,Argentina,NA,Santa Cruz,356647,0,0,48,3
2020-05-19,Argentina,NA,Santa Cruz,356647,0,0,48,3
2020-05-20,Argentina,NA,Santa Cruz,356647,0,1,48,4
2020-05-21,Argentina,NA,Santa Cruz,356647,0,0,48,4
2020-05-22,Argentina,NA,Santa Cruz,356647,0,0,48,4
2020-05-23,Argentina,NA,Santa Cruz,356647,0,0,48,4
2020-05-24,Argentina,NA,Santa Cruz,356647,0,0,48,4
2020-05-25,Argentina,NA,Santa Cruz,356647,0,0,48,4
2020-05-26,Argentina,NA,Santa Cruz,356647,0,0,48,4
2020-05-27,Argentina,NA,Santa Cruz,356647,0,0,48,4
2020-05-28,Argentina,NA,Santa Cruz,356647,0,0,48,4
2020-05-29,Argentina,NA,Santa Cruz,356647,0,0,48,4
2020-05-30,Argentina,NA,Santa Cruz,356647,1,0,49,4
2020-05-31,Argentina,NA,Santa Cruz,356647,0,0,49,4
2020-06-01,Argentina,NA,Santa Cruz,356647,1,1,50,5
2020-06-02,Argentina,NA,Santa Cruz,356647,0,0,50,5
2020-06-03,Argentina,NA,Santa Cruz,356647,0,0,50,5
2020-06-04,Argentina,NA,Santa Cruz,356647,0,1,50,6
2020-06-05,Argentina,NA,Santa Cruz,356647,0,1,50,7
2020-06-06,Argentina,NA,Santa Cruz,356647,0,0,50,7
2020-06-07,Argentina,NA,Santa Cruz,356647,0,0,50,7
2020-06-08,Argentina,NA,Santa Cruz,356647,0,0,50,7
2020-06-09,Argentina,NA,Santa Cruz,356647,0,0,50,7
2020-06-10,Argentina,NA,Santa Cruz,356647,0,0,50,7
2020-06-11,Argentina,NA,Santa Cruz,356647,0,0,50,7
2020-06-12,Argentina,NA,Santa Cruz,356647,0,0,50,7
2020-06-13,Argentina,NA,Santa Cruz,356647,0,0,50,7
2020-06-14,Argentina,NA,Santa Cruz,356647,0,0,50,7
2020-06-15,Argentina,NA,Santa Cruz,356647,0,0,50,7
2020-06-16,Argentina,NA,Santa Cruz,356647,0,0,50,7
2020-06-17,Argentina,NA,Santa Cruz,356647,0,0,50,7
2020-06-18,Argentina,NA,Santa Cruz,356647,0,1,50,8
2020-06-20,Argentina,NA,Santa Cruz,356647,0,0,50,8
2020-06-21,Argentina,NA,Santa Cruz,356647,0,0,50,8
2020-06-22,Argentina,NA,Santa Cruz,356647,0,0,50,8
2020-06-23,Argentina,NA,Santa Cruz,356647,0,0,50,8
2020-06-24,Argentina,NA,Santa Cruz,356647,0,0,50,8
2020-06-25,Argentina,NA,Santa Cruz,356647,1,0,51,8
2020-06-26,Argentina,NA,Santa Cruz,356647,0,0,51,8
2020-06-27,Argentina,NA,Santa Cruz,356647,0,1,51,9
2020-06-28,Argentina,NA,Santa Cruz,356647,0,0,51,9
2020-06-29,Argentina,NA,Santa Cruz,356647,0,0,51,9
2020-06-30,Argentina,NA,Santa Cruz,356647,0,0,51,9
2020-07-01,Argentina,NA,Santa Cruz,356647,0,0,51,9
2020-07-03,Argentina,NA,Santa Cruz,356647,0,0,51,9
2020-07-04,Argentina,NA,Santa Cruz,356647,5,0,56,9
2020-07-06,Argentina,NA,Santa Cruz,356647,2,0,58,9
2020-07-07,Argentina,NA,Santa Cruz,356647,0,0,58,9
2020-07-08,Argentina,NA,Santa Cruz,356647,0,0,58,9
2020-07-09,Argentina,NA,Santa Cruz,356647,5,0,63,9
2020-07-10,Argentina,NA,Santa Cruz,356647,0,0,63,9
2020-07-11,Argentina,NA,Santa Cruz,356647,0,0,63,9
2020-07-12,Argentina,NA,Santa Cruz,356647,1,0,64,9
2020-07-13,Argentina,NA,Santa Cruz,356647,0,0,64,9
2020-07-14,Argentina,NA,Santa Cruz,356647,1,0,65,9
2020-07-15,Argentina,NA,Santa Cruz,356647,12,0,77,9
2020-07-16,Argentina,NA,Santa Cruz,356647,21,0,98,9
2020-07-17,Argentina,NA,Santa Cruz,356647,24,0,122,9
2020-07-18,Argentina,NA,Santa Cruz,356647,49,0,171,9
2020-07-19,Argentina,NA,Santa Cruz,356647,46,0,217,9
2020-07-20,Argentina,NA,Santa Cruz,356647,17,0,234,9
2020-07-21,Argentina,NA,Santa Cruz,356647,8,0,242,9
2020-07-22,Argentina,NA,Santa Cruz,356647,41,0,283,9
2020-07-23,Argentina,NA,Santa Cruz,356647,10,0,293,9
2020-07-24,Argentina,NA,Santa Cruz,356647,31,1,324,10
2020-07-25,Argentina,NA,Santa Cruz,356647,27,0,351,10
2020-07-26,Argentina,NA,Santa Cruz,356647,26,1,377,11
2020-07-27,Argentina,NA,Santa Cruz,356647,15,0,392,11
2020-07-28,Argentina,NA,Santa Cruz,356647,8,1,400,12
2020-07-29,Argentina,NA,Santa Cruz,356647,42,0,442,12
2020-07-30,Argentina,NA,Santa Cruz,356647,20,1,462,13
2020-07-31,Argentina,NA,Santa Cruz,356647,22,1,484,14
2020-08-01,Argentina,NA,Santa Cruz,356647,37,0,521,14
2020-08-02,Argentina,NA,Santa Cruz,356647,23,1,544,15
2020-08-03,Argentina,NA,Santa Cruz,356647,17,0,561,15
2020-08-04,Argentina,NA,Santa Cruz,356647,50,0,611,15
2020-08-05,Argentina,NA,Santa Cruz,356647,41,0,652,15
2020-08-06,Argentina,NA,Santa Cruz,356647,55,0,707,15
2020-08-07,Argentina,NA,Santa Cruz,356647,24,1,731,16
2020-08-08,Argentina,NA,Santa Cruz,356647,40,0,771,16
2020-08-09,Argentina,NA,Santa Cruz,356647,25,0,796,16
2020-08-10,Argentina,NA,Santa Cruz,356647,23,0,819,16
2020-08-11,Argentina,NA,Santa Cruz,356647,43,0,862,16
2020-08-12,Argentina,NA,Santa Cruz,356647,46,1,908,17
2020-08-13,Argentina,NA,Santa Cruz,356647,49,0,957,17
2020-08-14,Argentina,NA,Santa Cruz,356647,30,0,987,17
2020-08-15,Argentina,NA,Santa Cruz,356647,25,2,1012,19
2020-08-16,Argentina,NA,Santa Cruz,356647,51,0,1063,19
2020-08-17,Argentina,NA,Santa Cruz,356647,12,1,1075,20
2020-08-18,Argentina,NA,Santa Cruz,356647,44,1,1119,21
2020-08-19,Argentina,NA,Santa Cruz,356647,50,0,1169,21
2020-08-20,Argentina,NA,Santa Cruz,356647,49,2,1218,23
2020-08-21,Argentina,NA,Santa Cruz,356647,85,1,1303,24
2020-08-22,Argentina,NA,Santa Cruz,356647,40,0,1343,24
2020-08-23,Argentina,NA,Santa Cruz,356647,42,0,1385,24
2020-08-24,Argentina,NA,Santa Cruz,356647,38,1,1423,25
2020-08-25,Argentina,NA,Santa Cruz,356647,59,1,1482,26
2020-08-26,Argentina,NA,Santa Cruz,356647,37,0,1519,26
2020-08-27,Argentina,NA,Santa Cruz,356647,81,1,1600,27
2020-08-28,Argentina,NA,Santa Cruz,356647,51,2,1651,29
2020-08-29,Argentina,NA,Santa Cruz,356647,64,1,1715,30
2020-08-30,Argentina,NA,Santa Cruz,356647,48,0,1763,30
2020-08-31,Argentina,NA,Santa Cruz,356647,58,0,1821,30
2020-09-01,Argentina,NA,Santa Cruz,356647,54,2,1875,32
2020-09-02,Argentina,NA,Santa Cruz,356647,104,0,1979,32
2020-09-03,Argentina,NA,Santa Cruz,356647,88,0,2067,32
2020-09-04,Argentina,NA,Santa Cruz,356647,94,1,2161,33
2020-09-05,Argentina,NA,Santa Cruz,356647,122,2,2283,35
2020-09-06,Argentina,NA,Santa Cruz,356647,53,3,2336,38
2020-09-07,Argentina,NA,Santa Cruz,356647,82,1,2418,39
2020-09-08,Argentina,NA,Santa Cruz,356647,89,2,2507,41
2020-09-09,Argentina,NA,Santa Cruz,356647,168,1,2675,42
2020-09-10,Argentina,NA,Santa Cruz,356647,142,1,2817,43
2020-09-11,Argentina,NA,Santa Cruz,356647,140,1,2957,44
2020-09-12,Argentina,NA,Santa Cruz,356647,131,0,3088,44
2020-09-13,Argentina,NA,Santa Cruz,356647,25,6,3113,50
2020-09-14,Argentina,NA,Santa Cruz,356647,60,3,3173,53
2020-09-15,Argentina,NA,Santa Cruz,356647,111,3,3284,56
2020-09-16,Argentina,NA,Santa Cruz,356647,108,0,3392,56
2020-09-17,Argentina,NA,Santa Cruz,356647,123,1,3515,57
2020-09-18,Argentina,NA,Santa Cruz,356647,125,2,3640,59
2020-09-19,Argentina,NA,Santa Cruz,356647,82,1,3722,60
2020-09-20,Argentina,NA,Santa Cruz,356647,77,1,3799,61
2020-09-21,Argentina,NA,Santa Cruz,356647,90,0,3889,61
2020-09-22,Argentina,NA,Santa Cruz,356647,71,2,3960,63
2020-09-23,Argentina,NA,Santa Cruz,356647,109,3,4069,66
2020-03-22,Argentina,NA,Santa Fe,3509113,11,0,15,2
2020-03-23,Argentina,NA,Santa Fe,3509113,2,1,17,3
2020-03-24,Argentina,NA,Santa Fe,3509113,21,0,38,3
2020-03-25,Argentina,NA,Santa Fe,3509113,9,0,47,3
2020-03-26,Argentina,NA,Santa Fe,3509113,7,1,54,4
2020-03-27,Argentina,NA,Santa Fe,3509113,8,0,62,4
2020-03-28,Argentina,NA,Santa Fe,3509113,14,0,76,4
2020-03-29,Argentina,NA,Santa Fe,3509113,25,0,101,4
2020-03-30,Argentina,NA,Santa Fe,3509113,11,0,112,4
2020-03-31,Argentina,NA,Santa Fe,3509113,22,1,134,5
2020-04-01,Argentina,NA,Santa Fe,3509113,10,2,144,7
2020-04-02,Argentina,NA,Santa Fe,3509113,10,1,154,8
2020-04-03,Argentina,NA,Santa Fe,3509113,7,1,161,9
2020-04-04,Argentina,NA,Santa Fe,3509113,11,1,172,10
2020-04-05,Argentina,NA,Santa Fe,3509113,5,0,177,10
2020-04-06,Argentina,NA,Santa Fe,3509113,5,0,182,10
2020-04-07,Argentina,NA,Santa Fe,3509113,3,1,185,11
2020-04-08,Argentina,NA,Santa Fe,3509113,7,1,192,12
2020-04-09,Argentina,NA,Santa Fe,3509113,2,3,194,15
2020-04-10,Argentina,NA,Santa Fe,3509113,2,0,196,15
2020-04-11,Argentina,NA,Santa Fe,3509113,4,0,200,15
2020-04-12,Argentina,NA,Santa Fe,3509113,2,0,202,15
2020-04-13,Argentina,NA,Santa Fe,3509113,1,0,203,15
2020-04-14,Argentina,NA,Santa Fe,3509113,3,0,206,15
2020-04-15,Argentina,NA,Santa Fe,3509113,3,1,209,16
2020-04-16,Argentina,NA,Santa Fe,3509113,3,1,212,17
2020-04-17,Argentina,NA,Santa Fe,3509113,7,0,219,17
2020-04-18,Argentina,NA,Santa Fe,3509113,1,0,220,17
2020-04-19,Argentina,NA,Santa Fe,3509113,1,3,221,20
2020-04-20,Argentina,NA,Santa Fe,3509113,2,0,223,20
2020-04-21,Argentina,NA,Santa Fe,3509113,6,0,229,20
2020-04-22,Argentina,NA,Santa Fe,3509113,5,0,234,20
2020-04-23,Argentina,NA,Santa Fe,3509113,2,1,236,21
2020-04-24,Argentina,NA,Santa Fe,3509113,2,0,238,21
2020-04-25,Argentina,NA,Santa Fe,3509113,3,3,241,24
2020-04-26,Argentina,NA,Santa Fe,3509113,0,0,241,24
2020-04-27,Argentina,NA,Santa Fe,3509113,0,1,241,25
2020-04-28,Argentina,NA,Santa Fe,3509113,1,0,242,25
2020-04-29,Argentina,NA,Santa Fe,3509113,0,2,242,27
2020-04-30,Argentina,NA,Santa Fe,3509113,0,0,242,27
2020-05-01,Argentina,NA,Santa Fe,3509113,0,0,242,27
2020-05-02,Argentina,NA,Santa Fe,3509113,0,0,242,27
2020-05-03,Argentina,NA,Santa Fe,3509113,0,0,242,27
2020-05-04,Argentina,NA,Santa Fe,3509113,0,0,242,27
2020-05-05,Argentina,NA,Santa Fe,3509113,1,1,243,28
2020-05-06,Argentina,NA,Santa Fe,3509113,0,0,243,28
2020-05-07,Argentina,NA,Santa Fe,3509113,0,1,243,29
2020-05-08,Argentina,NA,Santa Fe,3509113,0,1,243,30
2020-05-09,Argentina,NA,Santa Fe,3509113,0,1,243,31
2020-05-10,Argentina,NA,Santa Fe,3509113,0,0,243,31
2020-05-11,Argentina,NA,Santa Fe,3509113,0,1,243,32
2020-05-12,Argentina,NA,Santa Fe,3509113,0,0,243,32
2020-05-13,Argentina,NA,Santa Fe,3509113,0,1,243,33
2020-05-14,Argentina,NA,Santa Fe,3509113,0,0,243,33
2020-05-15,Argentina,NA,Santa Fe,3509113,0,0,243,33
2020-05-16,Argentina,NA,Santa Fe,3509113,1,0,244,33
2020-05-17,Argentina,NA,Santa Fe,3509113,4,0,248,33
2020-05-18,Argentina,NA,Santa Fe,3509113,0,1,248,34
2020-05-19,Argentina,NA,Santa Fe,3509113,0,0,248,34
2020-05-20,Argentina,NA,Santa Fe,3509113,4,1,252,35
2020-05-21,Argentina,NA,Santa Fe,3509113,1,0,253,35
2020-05-22,Argentina,NA,Santa Fe,3509113,4,0,257,35
2020-05-23,Argentina,NA,Santa Fe,3509113,1,0,258,35
2020-05-24,Argentina,NA,Santa Fe,3509113,0,0,258,35
2020-05-25,Argentina,NA,Santa Fe,3509113,1,1,259,36
2020-05-26,Argentina,NA,Santa Fe,3509113,0,0,259,36
2020-05-27,Argentina,NA,Santa Fe,3509113,0,2,259,38
2020-05-28,Argentina,NA,Santa Fe,3509113,0,0,259,38
2020-05-29,Argentina,NA,Santa Fe,3509113,1,0,260,38
2020-05-30,Argentina,NA,Santa Fe,3509113,1,0,261,38
2020-05-31,Argentina,NA,Santa Fe,3509113,0,0,261,38
2020-06-01,Argentina,NA,Santa Fe,3509113,3,0,264,38
2020-06-02,Argentina,NA,Santa Fe,3509113,0,1,264,39
2020-06-03,Argentina,NA,Santa Fe,3509113,3,0,267,39
2020-06-04,Argentina,NA,Santa Fe,3509113,6,0,273,39
2020-06-05,Argentina,NA,Santa Fe,3509113,0,0,273,39
2020-06-06,Argentina,NA,Santa Fe,3509113,2,0,275,39
2020-06-07,Argentina,NA,Santa Fe,3509113,0,0,275,39
2020-06-08,Argentina,NA,Santa Fe,3509113,1,0,276,39
2020-06-09,Argentina,NA,Santa Fe,3509113,4,0,280,39
2020-06-10,Argentina,NA,Santa Fe,3509113,2,0,282,39
2020-06-11,Argentina,NA,Santa Fe,3509113,1,0,283,39
2020-06-12,Argentina,NA,Santa Fe,3509113,0,0,283,39
2020-06-13,Argentina,NA,Santa Fe,3509113,1,0,284,39
2020-06-14,Argentina,NA,Santa Fe,3509113,0,0,284,39
2020-06-15,Argentina,NA,Santa Fe,3509113,0,1,284,40
2020-06-16,Argentina,NA,Santa Fe,3509113,3,0,287,40
2020-06-17,Argentina,NA,Santa Fe,3509113,7,0,294,40
2020-06-18,Argentina,NA,Santa Fe,3509113,8,1,302,41
2020-06-19,Argentina,NA,Santa Fe,3509113,24,0,326,41
2020-06-20,Argentina,NA,Santa Fe,3509113,6,0,332,41
2020-06-21,Argentina,NA,Santa Fe,3509113,4,0,336,41
2020-06-22,Argentina,NA,Santa Fe,3509113,7,0,343,41
2020-06-23,Argentina,NA,Santa Fe,3509113,24,0,367,41
2020-06-24,Argentina,NA,Santa Fe,3509113,6,0,373,41
2020-06-25,Argentina,NA,Santa Fe,3509113,23,0,396,41
2020-06-26,Argentina,NA,Santa Fe,3509113,10,0,406,41
2020-06-27,Argentina,NA,Santa Fe,3509113,5,0,411,41
2020-06-28,Argentina,NA,Santa Fe,3509113,4,0,415,41
2020-06-29,Argentina,NA,Santa Fe,3509113,1,0,416,41
2020-06-30,Argentina,NA,Santa Fe,3509113,2,0,418,41
2020-07-01,Argentina,NA,Santa Fe,3509113,3,1,421,42
2020-07-02,Argentina,NA,Santa Fe,3509113,5,0,426,42
2020-07-03,Argentina,NA,Santa Fe,3509113,2,2,428,44
2020-07-04,Argentina,NA,Santa Fe,3509113,7,1,435,45
2020-07-05,Argentina,NA,Santa Fe,3509113,4,0,439,45
2020-07-06,Argentina,NA,Santa Fe,3509113,4,0,443,45
2020-07-07,Argentina,NA,Santa Fe,3509113,14,0,457,45
2020-07-08,Argentina,NA,Santa Fe,3509113,18,1,475,46
2020-07-09,Argentina,NA,Santa Fe,3509113,8,1,483,47
2020-07-10,Argentina,NA,Santa Fe,3509113,8,0,491,47
2020-07-11,Argentina,NA,Santa Fe,3509113,24,0,515,47
2020-07-12,Argentina,NA,Santa Fe,3509113,12,0,527,47
2020-07-13,Argentina,NA,Santa Fe,3509113,19,0,546,47
2020-07-14,Argentina,NA,Santa Fe,3509113,27,0,573,47
2020-07-15,Argentina,NA,Santa Fe,3509113,20,1,593,48
2020-07-16,Argentina,NA,Santa Fe,3509113,25,0,618,48
2020-07-17,Argentina,NA,Santa Fe,3509113,39,1,657,49
2020-07-18,Argentina,NA,Santa Fe,3509113,25,1,682,50
2020-07-19,Argentina,NA,Santa Fe,3509113,19,0,701,50
2020-07-20,Argentina,NA,Santa Fe,3509113,40,0,741,50
2020-07-21,Argentina,NA,Santa Fe,3509113,37,2,778,52
2020-07-22,Argentina,NA,Santa Fe,3509113,48,1,826,53
2020-07-23,Argentina,NA,Santa Fe,3509113,24,0,850,53
2020-07-24,Argentina,NA,Santa Fe,3509113,30,0,880,53
2020-07-25,Argentina,NA,Santa Fe,3509113,42,2,922,55
2020-07-26,Argentina,NA,Santa Fe,3509113,30,0,952,55
2020-07-27,Argentina,NA,Santa Fe,3509113,60,2,1012,57
2020-07-28,Argentina,NA,Santa Fe,3509113,66,0,1078,57
2020-07-29,Argentina,NA,Santa Fe,3509113,60,1,1138,58
2020-07-30,Argentina,NA,Santa Fe,3509113,42,1,1180,59
2020-07-31,Argentina,NA,Santa Fe,3509113,80,3,1260,62
2020-08-01,Argentina,NA,Santa Fe,3509113,88,0,1348,62
2020-08-02,Argentina,NA,Santa Fe,3509113,63,1,1411,63
2020-08-03,Argentina,NA,Santa Fe,3509113,82,0,1493,63
2020-08-04,Argentina,NA,Santa Fe,3509113,115,1,1608,64
2020-08-05,Argentina,NA,Santa Fe,3509113,67,0,1675,64
2020-08-06,Argentina,NA,Santa Fe,3509113,189,4,1864,68
2020-08-07,Argentina,NA,Santa Fe,3509113,172,0,2036,68
2020-08-08,Argentina,NA,Santa Fe,3509113,71,0,2107,68
2020-08-09,Argentina,NA,Santa Fe,3509113,74,1,2181,69
2020-08-10,Argentina,NA,Santa Fe,3509113,197,2,2378,71
2020-08-11,Argentina,NA,Santa Fe,3509113,162,3,2540,74
2020-08-12,Argentina,NA,Santa Fe,3509113,164,4,2704,78
2020-08-13,Argentina,NA,Santa Fe,3509113,193,1,2897,79
2020-08-14,Argentina,NA,Santa Fe,3509113,185,0,3082,79
2020-08-15,Argentina,NA,Santa Fe,3509113,143,2,3225,81
2020-08-16,Argentina,NA,Santa Fe,3509113,131,3,3356,84
2020-08-17,Argentina,NA,Santa Fe,3509113,163,1,3519,85
2020-08-18,Argentina,NA,Santa Fe,3509113,223,4,3742,89
2020-08-19,Argentina,NA,Santa Fe,3509113,214,4,3956,93
2020-08-20,Argentina,NA,Santa Fe,3509113,310,4,4266,97
2020-08-21,Argentina,NA,Santa Fe,3509113,274,6,4540,103
2020-08-22,Argentina,NA,Santa Fe,3509113,254,5,4794,108
2020-08-23,Argentina,NA,Santa Fe,3509113,138,6,4932,114
2020-08-24,Argentina,NA,Santa Fe,3509113,387,6,5319,120
2020-08-25,Argentina,NA,Santa Fe,3509113,406,3,5725,123
2020-08-26,Argentina,NA,Santa Fe,3509113,490,4,6215,127
2020-08-27,Argentina,NA,Santa Fe,3509113,532,5,6747,132
2020-08-28,Argentina,NA,Santa Fe,3509113,726,4,7473,136
2020-08-29,Argentina,NA,Santa Fe,3509113,471,4,7944,140
2020-08-30,Argentina,NA,Santa Fe,3509113,387,8,8331,148
2020-08-31,Argentina,NA,Santa Fe,3509113,628,7,8959,155
2020-09-01,Argentina,NA,Santa Fe,3509113,907,6,9866,161
2020-09-02,Argentina,NA,Santa Fe,3509113,912,9,10778,170
2020-09-03,Argentina,NA,Santa Fe,3509113,901,8,11679,178
2020-09-04,Argentina,NA,Santa Fe,3509113,913,8,12592,186
2020-09-05,Argentina,NA,Santa Fe,3509113,588,10,13180,196
2020-09-06,Argentina,NA,Santa Fe,3509113,575,10,13755,206
2020-09-07,Argentina,NA,Santa Fe,3509113,907,12,14662,218
2020-09-08,Argentina,NA,Santa Fe,3509113,1243,9,15905,227
2020-09-09,Argentina,NA,Santa Fe,3509113,1086,9,16991,236
2020-09-10,Argentina,NA,Santa Fe,3509113,1074,14,18065,250
2020-09-11,Argentina,NA,Santa Fe,3509113,1242,12,19307,262
2020-09-12,Argentina,NA,Santa Fe,3509113,737,8,20044,270
2020-09-13,Argentina,NA,Santa Fe,3509113,798,8,20842,278
2020-09-14,Argentina,NA,Santa Fe,3509113,890,17,21732,295
2020-09-15,Argentina,NA,Santa Fe,3509113,1138,15,22870,310
2020-09-16,Argentina,NA,Santa Fe,3509113,1250,9,24120,319
2020-09-17,Argentina,NA,Santa Fe,3509113,1040,12,25160,331
2020-09-18,Argentina,NA,Santa Fe,3509113,1303,9,26463,340
2020-09-19,Argentina,NA,Santa Fe,3509113,919,10,27382,350
2020-09-20,Argentina,NA,Santa Fe,3509113,550,15,27932,365
2020-09-21,Argentina,NA,Santa Fe,3509113,947,14,28879,379
2020-09-22,Argentina,NA,Santa Fe,3509113,1369,8,30248,387
2020-09-23,Argentina,NA,Santa Fe,3509113,990,13,31238,400
2020-04-11,Argentina,NA,Santiago del Estero,968309,2,0,11,2
2020-04-12,Argentina,NA,Santiago del Estero,968309,0,0,11,2
2020-04-13,Argentina,NA,Santiago del Estero,968309,0,0,11,2
2020-04-14,Argentina,NA,Santiago del Estero,968309,0,0,11,2
2020-04-16,Argentina,NA,Santiago del Estero,968309,0,0,11,2
2020-04-19,Argentina,NA,Santiago del Estero,968309,0,0,11,2
2020-04-22,Argentina,NA,Santiago del Estero,968309,0,0,11,2
2020-04-25,Argentina,NA,Santiago del Estero,968309,1,0,12,2
2020-04-26,Argentina,NA,Santiago del Estero,968309,2,0,14,2
2020-05-02,Argentina,NA,Santiago del Estero,968309,0,0,14,2
2020-05-04,Argentina,NA,Santiago del Estero,968309,0,0,14,2
2020-05-05,Argentina,NA,Santiago del Estero,968309,0,1,14,2
2020-05-09,Argentina,NA,Santiago del Estero,968309,1,0,15,3
2020-05-18,Argentina,NA,Santiago del Estero,968309,6,0,21,4
2020-05-23,Argentina,NA,Santiago del Estero,968309,0,0,21,4
2020-05-25,Argentina,NA,Santiago del Estero,968309,0,1,21,4
2020-06-01,Argentina,NA,Santiago del Estero,968309,0,0,21,4
2020-06-02,Argentina,NA,Santiago del Estero,968309,1,1,22,4
2020-06-06,Argentina,NA,Santiago del Estero,968309,0,0,22,4
2020-06-08,Argentina,NA,Santiago del Estero,968309,0,1,22,4
2020-06-09,Argentina,NA,Santiago del Estero,968309,0,0,22,4
2020-06-12,Argentina,NA,Santiago del Estero,968309,0,0,22,4
2020-06-20,Argentina,NA,Santiago del Estero,968309,0,0,22,4
2020-06-27,Argentina,NA,Santiago del Estero,968309,2,0,24,4
2020-06-30,Argentina,NA,Santiago del Estero,968309,0,0,24,4
2020-07-01,Argentina,NA,Santiago del Estero,968309,1,0,25,5
2020-07-03,Argentina,NA,Santiago del Estero,968309,0,0,25,5
2020-07-06,Argentina,NA,Santiago del Estero,968309,0,0,25,5
2020-07-07,Argentina,NA,Santiago del Estero,968309,8,0,33,6
2020-07-08,Argentina,NA,Santiago del Estero,968309,1,0,34,6
2020-07-10,Argentina,NA,Santiago del Estero,968309,1,0,35,7
2020-07-13,Argentina,NA,Santiago del Estero,968309,1,0,36,7
2020-07-16,Argentina,NA,Santiago del Estero,968309,0,1,36,7
2020-07-19,Argentina,NA,Santiago del Estero,968309,1,0,37,7
2020-07-20,Argentina,NA,Santiago del Estero,968309,0,0,37,7
2020-07-24,Argentina,NA,Santiago del Estero,968309,1,0,38,7
2020-07-25,Argentina,NA,Santiago del Estero,968309,1,0,39,7
2020-07-26,Argentina,NA,Santiago del Estero,968309,1,0,40,8
2020-07-28,Argentina,NA,Santiago del Estero,968309,1,0,41,8
2020-07-29,Argentina,NA,Santiago del Estero,968309,1,0,42,8
2020-07-30,Argentina,NA,Santiago del Estero,968309,2,0,44,8
2020-08-03,Argentina,NA,Santiago del Estero,968309,1,0,45,9
2020-08-04,Argentina,NA,Santiago del Estero,968309,19,0,64,9
2020-08-05,Argentina,NA,Santiago del Estero,968309,9,0,73,9
2020-08-06,Argentina,NA,Santiago del Estero,968309,25,0,98,9
2020-08-07,Argentina,NA,Santiago del Estero,968309,20,0,118,9
2020-08-08,Argentina,NA,Santiago del Estero,968309,12,0,130,9
2020-08-09,Argentina,NA,Santiago del Estero,968309,9,0,139,9
2020-08-10,Argentina,NA,Santiago del Estero,968309,17,0,156,9
2020-08-11,Argentina,NA,Santiago del Estero,968309,22,0,178,9
2020-08-12,Argentina,NA,Santiago del Estero,968309,26,0,204,9
2020-08-13,Argentina,NA,Santiago del Estero,968309,24,0,228,9
2020-08-14,Argentina,NA,Santiago del Estero,968309,27,0,255,9
2020-08-15,Argentina,NA,Santiago del Estero,968309,32,0,287,9
2020-08-16,Argentina,NA,Santiago del Estero,968309,67,0,354,9
2020-08-17,Argentina,NA,Santiago del Estero,968309,1,0,355,9
2020-08-18,Argentina,NA,Santiago del Estero,968309,39,0,394,9
2020-08-19,Argentina,NA,Santiago del Estero,968309,35,0,429,9
2020-08-20,Argentina,NA,Santiago del Estero,968309,39,0,468,9
2020-08-21,Argentina,NA,Santiago del Estero,968309,42,0,510,9
2020-08-22,Argentina,NA,Santiago del Estero,968309,35,0,545,9
2020-08-23,Argentina,NA,Santiago del Estero,968309,55,2,600,11
2020-08-24,Argentina,NA,Santiago del Estero,968309,72,2,672,13
2020-08-25,Argentina,NA,Santiago del Estero,968309,39,0,711,13
2020-08-26,Argentina,NA,Santiago del Estero,968309,60,2,771,15
2020-08-27,Argentina,NA,Santiago del Estero,968309,44,1,815,16
2020-08-28,Argentina,NA,Santiago del Estero,968309,32,1,847,17
2020-08-29,Argentina,NA,Santiago del Estero,968309,56,1,903,18
2020-08-30,Argentina,NA,Santiago del Estero,968309,60,1,963,19
2020-08-31,Argentina,NA,Santiago del Estero,968309,37,1,1000,20
2020-09-01,Argentina,NA,Santiago del Estero,968309,56,1,1056,21
2020-09-02,Argentina,NA,Santiago del Estero,968309,61,0,1117,21
2020-09-03,Argentina,NA,Santiago del Estero,968309,62,0,1179,21
2020-09-04,Argentina,NA,Santiago del Estero,968309,55,2,1234,23
2020-09-05,Argentina,NA,Santiago del Estero,968309,95,2,1329,25
2020-09-06,Argentina,NA,Santiago del Estero,968309,46,4,1375,29
2020-09-07,Argentina,NA,Santiago del Estero,968309,45,1,1420,30
2020-09-08,Argentina,NA,Santiago del Estero,968309,81,2,1501,32
2020-09-09,Argentina,NA,Santiago del Estero,968309,75,0,1576,32
2020-09-10,Argentina,NA,Santiago del Estero,968309,85,1,1661,33
2020-09-11,Argentina,NA,Santiago del Estero,968309,109,1,1770,34
2020-09-12,Argentina,NA,Santiago del Estero,968309,81,0,1851,34
2020-09-13,Argentina,NA,Santiago del Estero,968309,80,1,1931,35
2020-09-14,Argentina,NA,Santiago del Estero,968309,65,1,1996,36
2020-09-15,Argentina,NA,Santiago del Estero,968309,57,0,2053,36
2020-09-16,Argentina,NA,Santiago del Estero,968309,66,2,2119,38
2020-09-17,Argentina,NA,Santiago del Estero,968309,140,1,2259,39
2020-09-18,Argentina,NA,Santiago del Estero,968309,58,0,2317,39
2020-09-19,Argentina,NA,Santiago del Estero,968309,62,6,2379,45
2020-09-20,Argentina,NA,Santiago del Estero,968309,48,2,2427,47
2020-09-21,Argentina,NA,Santiago del Estero,968309,74,1,2501,48
2020-09-22,Argentina,NA,Santiago del Estero,968309,109,2,2610,50
2020-09-23,Argentina,NA,Santiago del Estero,968309,112,3,2722,53
2020-03-24,Argentina,NA,Tierra del Fuego,169183,4,0,11,0
2020-03-25,Argentina,NA,Tierra del Fuego,169183,4,0,15,0
2020-03-27,Argentina,NA,Tierra del Fuego,169183,4,1,19,1
2020-03-28,Argentina,NA,Tierra del Fuego,169183,4,0,23,1
2020-03-29,Argentina,NA,Tierra del Fuego,169183,5,0,28,1
2020-03-30,Argentina,NA,Tierra del Fuego,169183,12,0,40,1
2020-03-31,Argentina,NA,Tierra del Fuego,169183,1,0,41,1
2020-04-01,Argentina,NA,Tierra del Fuego,169183,0,0,41,1
2020-04-02,Argentina,NA,Tierra del Fuego,169183,24,0,65,1
2020-04-03,Argentina,NA,Tierra del Fuego,169183,7,0,72,1
2020-04-04,Argentina,NA,Tierra del Fuego,169183,2,0,74,1
2020-04-05,Argentina,NA,Tierra del Fuego,169183,3,0,77,1
2020-04-06,Argentina,NA,Tierra del Fuego,169183,1,0,78,1
2020-04-07,Argentina,NA,Tierra del Fuego,169183,2,0,80,1
2020-04-08,Argentina,NA,Tierra del Fuego,169183,0,1,80,2
2020-04-09,Argentina,NA,Tierra del Fuego,169183,2,0,82,2
2020-04-10,Argentina,NA,Tierra del Fuego,169183,3,0,85,2
2020-04-11,Argentina,NA,Tierra del Fuego,169183,4,0,89,2
2020-04-12,Argentina,NA,Tierra del Fuego,169183,5,0,94,2
2020-04-13,Argentina,NA,Tierra del Fuego,169183,2,0,96,2
2020-04-14,Argentina,NA,Tierra del Fuego,169183,3,0,99,2
2020-04-15,Argentina,NA,Tierra del Fuego,169183,7,0,106,2
2020-04-17,Argentina,NA,Tierra del Fuego,169183,3,0,109,2
2020-04-18,Argentina,NA,Tierra del Fuego,169183,3,0,112,2
2020-04-19,Argentina,NA,Tierra del Fuego,169183,0,0,112,2
2020-04-20,Argentina,NA,Tierra del Fuego,169183,1,0,113,2
2020-04-21,Argentina,NA,Tierra del Fuego,169183,0,1,113,3
2020-04-22,Argentina,NA,Tierra del Fuego,169183,1,0,114,3
2020-04-24,Argentina,NA,Tierra del Fuego,169183,3,0,117,3
2020-04-25,Argentina,NA,Tierra del Fuego,169183,0,0,117,3
2020-04-26,Argentina,NA,Tierra del Fuego,169183,1,0,118,3
2020-04-27,Argentina,NA,Tierra del Fuego,169183,3,0,121,3
2020-04-28,Argentina,NA,Tierra del Fuego,169183,3,0,124,3
2020-04-29,Argentina,NA,Tierra del Fuego,169183,2,0,126,3
2020-04-30,Argentina,NA,Tierra del Fuego,169183,2,0,128,3
2020-05-01,Argentina,NA,Tierra del Fuego,169183,2,0,130,3
2020-05-02,Argentina,NA,Tierra del Fuego,169183,1,0,131,3
2020-05-03,Argentina,NA,Tierra del Fuego,169183,1,0,132,3
2020-05-05,Argentina,NA,Tierra del Fuego,169183,0,0,132,3
2020-05-06,Argentina,NA,Tierra del Fuego,169183,0,1,132,4
2020-05-08,Argentina,NA,Tierra del Fuego,169183,1,0,133,4
2020-05-09,Argentina,NA,Tierra del Fuego,169183,2,0,135,4
2020-05-11,Argentina,NA,Tierra del Fuego,169183,0,1,135,5
2020-05-12,Argentina,NA,Tierra del Fuego,169183,0,0,135,5
2020-05-14,Argentina,NA,Tierra del Fuego,169183,0,0,135,5
2020-05-18,Argentina,NA,Tierra del Fuego,169183,0,0,135,5
2020-05-21,Argentina,NA,Tierra del Fuego,169183,2,1,137,6
2020-05-25,Argentina,NA,Tierra del Fuego,169183,0,1,137,7
2020-05-26,Argentina,NA,Tierra del Fuego,169183,1,0,138,7
2020-05-29,Argentina,NA,Tierra del Fuego,169183,0,0,138,7
2020-06-01,Argentina,NA,Tierra del Fuego,169183,0,0,138,7
2020-06-02,Argentina,NA,Tierra del Fuego,169183,0,0,138,7
2020-06-04,Argentina,NA,Tierra del Fuego,169183,0,0,138,7
2020-06-06,Argentina,NA,Tierra del Fuego,169183,0,0,138,7
2020-06-10,Argentina,NA,Tierra del Fuego,169183,0,0,138,7
2020-06-12,Argentina,NA,Tierra del Fuego,169183,0,0,138,7
2020-06-13,Argentina,NA,Tierra del Fuego,169183,0,0,138,7
2020-06-14,Argentina,NA,Tierra del Fuego,169183,0,0,138,7
2020-06-15,Argentina,NA,Tierra del Fuego,169183,0,0,138,7
2020-06-17,Argentina,NA,Tierra del Fuego,169183,0,1,138,8
2020-06-22,Argentina,NA,Tierra del Fuego,169183,0,0,138,8
2020-06-25,Argentina,NA,Tierra del Fuego,169183,0,0,138,8
2020-07-01,Argentina,NA,Tierra del Fuego,169183,1,0,139,8
2020-07-02,Argentina,NA,Tierra del Fuego,169183,0,0,139,8
2020-07-03,Argentina,NA,Tierra del Fuego,169183,3,0,142,8
2020-07-04,Argentina,NA,Tierra del Fuego,169183,1,0,143,8
2020-07-06,Argentina,NA,Tierra del Fuego,169183,0,0,143,8
2020-07-08,Argentina,NA,Tierra del Fuego,169183,1,0,144,8
2020-07-10,Argentina,NA,Tierra del Fuego,169183,0,1,144,9
2020-07-12,Argentina,NA,Tierra del Fuego,169183,8,0,152,9
2020-07-13,Argentina,NA,Tierra del Fuego,169183,48,0,200,9
2020-07-14,Argentina,NA,Tierra del Fuego,169183,1,0,201,9
2020-07-15,Argentina,NA,Tierra del Fuego,169183,1,0,202,9
2020-07-17,Argentina,NA,Tierra del Fuego,169183,23,0,225,9
2020-07-18,Argentina,NA,Tierra del Fuego,169183,3,0,228,9
2020-07-19,Argentina,NA,Tierra del Fuego,169183,0,0,228,9
2020-07-20,Argentina,NA,Tierra del Fuego,169183,8,0,236,9
2020-07-21,Argentina,NA,Tierra del Fuego,169183,11,0,247,9
2020-07-22,Argentina,NA,Tierra del Fuego,169183,8,0,255,9
2020-07-23,Argentina,NA,Tierra del Fuego,169183,16,0,271,9
2020-07-24,Argentina,NA,Tierra del Fuego,169183,24,0,295,9
2020-07-25,Argentina,NA,Tierra del Fuego,169183,38,0,333,9
2020-07-26,Argentina,NA,Tierra del Fuego,169183,35,1,368,10
2020-07-27,Argentina,NA,Tierra del Fuego,169183,7,1,375,11
2020-07-28,Argentina,NA,Tierra del Fuego,169183,21,0,396,11
2020-07-29,Argentina,NA,Tierra del Fuego,169183,28,0,424,11
2020-07-30,Argentina,NA,Tierra del Fuego,169183,32,0,456,11
2020-07-31,Argentina,NA,Tierra del Fuego,169183,21,1,477,12
2020-08-01,Argentina,NA,Tierra del Fuego,169183,53,1,530,13
2020-08-02,Argentina,NA,Tierra del Fuego,169183,118,0,648,13
2020-08-03,Argentina,NA,Tierra del Fuego,169183,38,0,686,13
2020-08-04,Argentina,NA,Tierra del Fuego,169183,47,1,733,14
2020-08-05,Argentina,NA,Tierra del Fuego,169183,51,1,784,15
2020-08-06,Argentina,NA,Tierra del Fuego,169183,100,0,884,15
2020-08-07,Argentina,NA,Tierra del Fuego,169183,45,2,929,17
2020-08-08,Argentina,NA,Tierra del Fuego,169183,25,0,954,17
2020-08-09,Argentina,NA,Tierra del Fuego,169183,49,1,1003,18
2020-08-10,Argentina,NA,Tierra del Fuego,169183,68,1,1071,19
2020-08-11,Argentina,NA,Tierra del Fuego,169183,47,2,1118,21
2020-08-12,Argentina,NA,Tierra del Fuego,169183,68,0,1186,21
2020-08-13,Argentina,NA,Tierra del Fuego,169183,43,2,1229,23
2020-08-14,Argentina,NA,Tierra del Fuego,169183,39,3,1268,26
2020-08-15,Argentina,NA,Tierra del Fuego,169183,70,2,1338,28
2020-08-16,Argentina,NA,Tierra del Fuego,169183,31,2,1369,30
2020-08-17,Argentina,NA,Tierra del Fuego,169183,26,0,1395,30
2020-08-18,Argentina,NA,Tierra del Fuego,169183,48,1,1443,31
2020-08-19,Argentina,NA,Tierra del Fuego,169183,35,0,1478,31
2020-08-20,Argentina,NA,Tierra del Fuego,169183,31,0,1509,31
2020-08-21,Argentina,NA,Tierra del Fuego,169183,26,0,1535,31
2020-08-22,Argentina,NA,Tierra del Fuego,169183,24,1,1559,32
2020-08-23,Argentina,NA,Tierra del Fuego,169183,29,0,1588,32
2020-08-24,Argentina,NA,Tierra del Fuego,169183,21,1,1609,33
2020-08-25,Argentina,NA,Tierra del Fuego,169183,22,2,1631,35
2020-08-26,Argentina,NA,Tierra del Fuego,169183,33,1,1664,36
2020-08-27,Argentina,NA,Tierra del Fuego,169183,50,2,1714,38
2020-08-28,Argentina,NA,Tierra del Fuego,169183,37,1,1751,39
2020-08-29,Argentina,NA,Tierra del Fuego,169183,22,4,1773,43
2020-08-30,Argentina,NA,Tierra del Fuego,169183,22,0,1795,43
2020-08-31,Argentina,NA,Tierra del Fuego,169183,17,1,1812,44
2020-09-01,Argentina,NA,Tierra del Fuego,169183,49,2,1861,46
2020-09-02,Argentina,NA,Tierra del Fuego,169183,35,1,1896,47
2020-09-03,Argentina,NA,Tierra del Fuego,169183,46,2,1942,49
2020-09-04,Argentina,NA,Tierra del Fuego,169183,23,1,1965,50
2020-09-05,Argentina,NA,Tierra del Fuego,169183,33,1,1998,51
2020-09-06,Argentina,NA,Tierra del Fuego,169183,32,0,2030,51
2020-09-07,Argentina,NA,Tierra del Fuego,169183,40,0,2070,51
2020-09-08,Argentina,NA,Tierra del Fuego,169183,38,1,2108,52
2020-09-09,Argentina,NA,Tierra del Fuego,169183,34,1,2142,53
2020-09-10,Argentina,NA,Tierra del Fuego,169183,25,2,2167,55
2020-09-11,Argentina,NA,Tierra del Fuego,169183,43,2,2210,57
2020-09-12,Argentina,NA,Tierra del Fuego,169183,32,1,2242,58
2020-09-13,Argentina,NA,Tierra del Fuego,169183,49,0,2291,58
2020-09-14,Argentina,NA,Tierra del Fuego,169183,55,1,2346,59
2020-09-15,Argentina,NA,Tierra del Fuego,169183,41,1,2387,60
2020-09-16,Argentina,NA,Tierra del Fuego,169183,33,4,2420,64
2020-09-17,Argentina,NA,Tierra del Fuego,169183,46,1,2466,65
2020-09-18,Argentina,NA,Tierra del Fuego,169183,67,0,2533,65
2020-09-19,Argentina,NA,Tierra del Fuego,169183,50,0,2583,65
2020-09-20,Argentina,NA,Tierra del Fuego,169183,41,1,2624,66
2020-09-21,Argentina,NA,Tierra del Fuego,169183,52,2,2676,68
2020-09-22,Argentina,NA,Tierra del Fuego,169183,46,2,2722,70
2020-09-23,Argentina,NA,Tierra del Fuego,169183,33,1,2755,71
2020-03-26,Argentina,NA,Tucuman,1674622,4,0,13,0
2020-03-27,Argentina,NA,Tucuman,1674622,1,0,14,0
2020-03-28,Argentina,NA,Tucuman,1674622,1,0,15,0
2020-03-29,Argentina,NA,Tucuman,1674622,0,1,15,1
2020-03-30,Argentina,NA,Tucuman,1674622,0,1,15,2
2020-03-31,Argentina,NA,Tucuman,1674622,2,0,17,2
2020-04-01,Argentina,NA,Tucuman,1674622,1,1,18,3
2020-04-02,Argentina,NA,Tucuman,1674622,2,0,20,3
2020-04-03,Argentina,NA,Tucuman,1674622,1,0,21,3
2020-04-04,Argentina,NA,Tucuman,1674622,0,0,21,3
2020-04-05,Argentina,NA,Tucuman,1674622,5,0,26,3
2020-04-06,Argentina,NA,Tucuman,1674622,1,0,27,3
2020-04-07,Argentina,NA,Tucuman,1674622,0,0,27,3
2020-04-08,Argentina,NA,Tucuman,1674622,1,1,28,4
2020-04-09,Argentina,NA,Tucuman,1674622,0,0,28,4
2020-04-10,Argentina,NA,Tucuman,1674622,1,0,29,4
2020-04-11,Argentina,NA,Tucuman,1674622,0,2,29,5
2020-04-12,Argentina,NA,Tucuman,1674622,0,0,29,5
2020-04-13,Argentina,NA,Tucuman,1674622,1,0,30,6
2020-04-14,Argentina,NA,Tucuman,1674622,0,0,30,6
2020-04-15,Argentina,NA,Tucuman,1674622,0,0,30,6
2020-04-16,Argentina,NA,Tucuman,1674622,0,0,30,6
2020-04-17,Argentina,NA,Tucuman,1674622,0,1,30,6
2020-04-18,Argentina,NA,Tucuman,1674622,0,0,30,6
2020-04-19,Argentina,NA,Tucuman,1674622,1,0,31,6
2020-04-20,Argentina,NA,Tucuman,1674622,0,0,31,6
2020-04-21,Argentina,NA,Tucuman,1674622,3,1,34,6
2020-04-22,Argentina,NA,Tucuman,1674622,0,0,34,6
2020-04-23,Argentina,NA,Tucuman,1674622,0,0,34,6
2020-04-24,Argentina,NA,Tucuman,1674622,0,0,34,6
2020-04-25,Argentina,NA,Tucuman,1674622,1,0,35,7
2020-04-26,Argentina,NA,Tucuman,1674622,0,0,35,7
2020-04-27,Argentina,NA,Tucuman,1674622,1,1,36,7
2020-04-28,Argentina,NA,Tucuman,1674622,0,0,36,7
2020-04-29,Argentina,NA,Tucuman,1674622,2,0,38,7
2020-04-30,Argentina,NA,Tucuman,1674622,0,0,38,7
2020-05-01,Argentina,NA,Tucuman,1674622,0,0,38,7
2020-05-02,Argentina,NA,Tucuman,1674622,0,0,38,7
2020-05-03,Argentina,NA,Tucuman,1674622,3,0,41,8
2020-05-04,Argentina,NA,Tucuman,1674622,0,0,41,8
2020-05-05,Argentina,NA,Tucuman,1674622,0,0,41,8
2020-05-06,Argentina,NA,Tucuman,1674622,0,0,41,8
2020-05-07,Argentina,NA,Tucuman,1674622,0,0,41,8
2020-05-08,Argentina,NA,Tucuman,1674622,0,1,41,8
2020-05-09,Argentina,NA,Tucuman,1674622,0,0,41,8
2020-05-10,Argentina,NA,Tucuman,1674622,0,0,41,8
2020-05-11,Argentina,NA,Tucuman,1674622,1,0,42,8
2020-05-12,Argentina,NA,Tucuman,1674622,0,0,42,8
2020-05-13,Argentina,NA,Tucuman,1674622,0,1,42,8
2020-05-14,Argentina,NA,Tucuman,1674622,0,0,42,8
2020-05-15,Argentina,NA,Tucuman,1674622,0,0,42,8
2020-05-16,Argentina,NA,Tucuman,1674622,0,0,42,8
2020-05-17,Argentina,NA,Tucuman,1674622,0,0,42,8
2020-05-18,Argentina,NA,Tucuman,1674622,0,0,42,8
2020-05-19,Argentina,NA,Tucuman,1674622,0,0,42,8
2020-05-20,Argentina,NA,Tucuman,1674622,1,0,43,8
2020-05-21,Argentina,NA,Tucuman,1674622,0,0,43,8
2020-05-22,Argentina,NA,Tucuman,1674622,0,0,43,8
2020-05-23,Argentina,NA,Tucuman,1674622,1,0,44,8
2020-05-24,Argentina,NA,Tucuman,1674622,2,0,46,9
2020-05-25,Argentina,NA,Tucuman,1674622,0,2,46,9
2020-05-26,Argentina,NA,Tucuman,1674622,0,0,46,9
2020-05-27,Argentina,NA,Tucuman,1674622,0,0,46,9
2020-05-28,Argentina,NA,Tucuman,1674622,0,0,46,9
2020-05-29,Argentina,NA,Tucuman,1674622,0,0,46,9
2020-05-30,Argentina,NA,Tucuman,1674622,0,2,46,9
2020-05-31,Argentina,NA,Tucuman,1674622,0,0,46,9
2020-06-01,Argentina,NA,Tucuman,1674622,0,0,46,9
2020-06-02,Argentina,NA,Tucuman,1674622,0,0,46,9
2020-06-03,Argentina,NA,Tucuman,1674622,0,0,46,9
2020-06-04,Argentina,NA,Tucuman,1674622,1,0,47,9
2020-06-05,Argentina,NA,Tucuman,1674622,0,1,47,9
2020-06-06,Argentina,NA,Tucuman,1674622,0,0,47,9
2020-06-07,Argentina,NA,Tucuman,1674622,0,0,47,9
2020-06-08,Argentina,NA,Tucuman,1674622,0,0,47,9
2020-06-09,Argentina,NA,Tucuman,1674622,0,0,47,9
2020-06-10,Argentina,NA,Tucuman,1674622,0,0,47,9
2020-06-11,Argentina,NA,Tucuman,1674622,1,0,48,9
2020-06-12,Argentina,NA,Tucuman,1674622,1,0,49,9
2020-06-13,Argentina,NA,Tucuman,1674622,2,0,51,10
2020-06-14,Argentina,NA,Tucuman,1674622,4,0,55,11
2020-06-15,Argentina,NA,Tucuman,1674622,0,0,55,11
2020-06-16,Argentina,NA,Tucuman,1674622,1,0,56,11
2020-06-17,Argentina,NA,Tucuman,1674622,1,1,57,11
2020-06-18,Argentina,NA,Tucuman,1674622,0,0,57,11
2020-06-19,Argentina,NA,Tucuman,1674622,0,0,57,11
2020-06-20,Argentina,NA,Tucuman,1674622,0,0,57,11
2020-06-21,Argentina,NA,Tucuman,1674622,0,0,57,11
2020-06-22,Argentina,NA,Tucuman,1674622,1,0,58,11
2020-06-23,Argentina,NA,Tucuman,1674622,4,0,62,12
2020-06-24,Argentina,NA,Tucuman,1674622,7,0,69,13
2020-06-25,Argentina,NA,Tucuman,1674622,1,0,70,14
2020-06-26,Argentina,NA,Tucuman,1674622,0,0,70,14
2020-06-27,Argentina,NA,Tucuman,1674622,1,0,71,14
2020-06-28,Argentina,NA,Tucuman,1674622,0,0,71,14
2020-06-29,Argentina,NA,Tucuman,1674622,0,0,71,14
2020-06-30,Argentina,NA,Tucuman,1674622,0,0,71,14
2020-07-01,Argentina,NA,Tucuman,1674622,7,0,78,15
2020-07-02,Argentina,NA,Tucuman,1674622,0,0,78,15
2020-07-03,Argentina,NA,Tucuman,1674622,3,0,81,16
2020-07-04,Argentina,NA,Tucuman,1674622,3,0,84,16
2020-07-05,Argentina,NA,Tucuman,1674622,0,0,84,16
2020-07-06,Argentina,NA,Tucuman,1674622,0,0,84,16
2020-07-07,Argentina,NA,Tucuman,1674622,0,0,84,16
2020-07-08,Argentina,NA,Tucuman,1674622,1,0,85,17
2020-07-09,Argentina,NA,Tucuman,1674622,2,0,87,17
2020-07-10,Argentina,NA,Tucuman,1674622,1,0,88,17
2020-07-11,Argentina,NA,Tucuman,1674622,2,0,90,17
2020-07-12,Argentina,NA,Tucuman,1674622,1,0,91,17
2020-07-13,Argentina,NA,Tucuman,1674622,0,0,91,17
2020-07-14,Argentina,NA,Tucuman,1674622,0,0,91,17
2020-07-15,Argentina,NA,Tucuman,1674622,2,0,93,17
2020-07-16,Argentina,NA,Tucuman,1674622,1,0,94,17
2020-07-17,Argentina,NA,Tucuman,1674622,0,0,94,17
2020-07-18,Argentina,NA,Tucuman,1674622,0,0,94,17
2020-07-19,Argentina,NA,Tucuman,1674622,1,0,95,17
2020-07-20,Argentina,NA,Tucuman,1674622,0,0,95,17
2020-07-21,Argentina,NA,Tucuman,1674622,0,0,95,17
2020-07-22,Argentina,NA,Tucuman,1674622,3,0,98,17
2020-07-23,Argentina,NA,Tucuman,1674622,1,0,99,17
2020-07-24,Argentina,NA,Tucuman,1674622,11,0,110,17
2020-07-25,Argentina,NA,Tucuman,1674622,2,0,112,17
2020-07-26,Argentina,NA,Tucuman,1674622,12,0,124,17
2020-07-27,Argentina,NA,Tucuman,1674622,23,0,147,17
2020-07-28,Argentina,NA,Tucuman,1674622,11,0,158,17
2020-07-29,Argentina,NA,Tucuman,1674622,32,0,190,17
2020-07-30,Argentina,NA,Tucuman,1674622,14,0,204,17
2020-07-31,Argentina,NA,Tucuman,1674622,15,1,219,18
2020-08-01,Argentina,NA,Tucuman,1674622,28,0,247,18
2020-08-02,Argentina,NA,Tucuman,1674622,18,0,265,18
2020-08-03,Argentina,NA,Tucuman,1674622,28,0,293,18
2020-08-04,Argentina,NA,Tucuman,1674622,23,1,316,19
2020-08-05,Argentina,NA,Tucuman,1674622,33,0,349,19
2020-08-06,Argentina,NA,Tucuman,1674622,8,0,357,19
2020-08-07,Argentina,NA,Tucuman,1674622,6,0,363,19
2020-08-08,Argentina,NA,Tucuman,1674622,10,0,373,19
2020-08-09,Argentina,NA,Tucuman,1674622,44,0,417,19
2020-08-10,Argentina,NA,Tucuman,1674622,22,0,439,19
2020-08-11,Argentina,NA,Tucuman,1674622,32,2,471,21
2020-08-12,Argentina,NA,Tucuman,1674622,24,0,495,21
2020-08-13,Argentina,NA,Tucuman,1674622,32,0,527,21
2020-08-14,Argentina,NA,Tucuman,1674622,28,2,555,23
2020-08-15,Argentina,NA,Tucuman,1674622,38,0,593,23
2020-08-16,Argentina,NA,Tucuman,1674622,18,0,611,23
2020-08-17,Argentina,NA,Tucuman,1674622,58,0,669,23
2020-08-18,Argentina,NA,Tucuman,1674622,93,1,762,24
2020-08-19,Argentina,NA,Tucuman,1674622,56,0,818,24
2020-08-20,Argentina,NA,Tucuman,1674622,64,3,882,27
2020-08-21,Argentina,NA,Tucuman,1674622,78,0,960,27
2020-08-22,Argentina,NA,Tucuman,1674622,82,2,1042,29
2020-08-23,Argentina,NA,Tucuman,1674622,82,0,1124,29
2020-08-24,Argentina,NA,Tucuman,1674622,112,1,1236,30
2020-08-25,Argentina,NA,Tucuman,1674622,97,4,1333,34
2020-08-26,Argentina,NA,Tucuman,1674622,98,2,1431,36
2020-08-27,Argentina,NA,Tucuman,1674622,149,2,1580,38
2020-08-28,Argentina,NA,Tucuman,1674622,231,0,1811,38
2020-08-29,Argentina,NA,Tucuman,1674622,142,2,1953,40
2020-08-30,Argentina,NA,Tucuman,1674622,271,2,2224,42
2020-08-31,Argentina,NA,Tucuman,1674622,225,5,2449,47
2020-09-01,Argentina,NA,Tucuman,1674622,292,3,2741,50
2020-09-02,Argentina,NA,Tucuman,1674622,276,2,3017,52
2020-09-03,Argentina,NA,Tucuman,1674622,288,4,3305,56
2020-09-04,Argentina,NA,Tucuman,1674622,401,4,3706,60
2020-09-05,Argentina,NA,Tucuman,1674622,301,1,4007,61
2020-09-06,Argentina,NA,Tucuman,1674622,351,3,4358,64
2020-09-07,Argentina,NA,Tucuman,1674622,305,7,4663,71
2020-09-08,Argentina,NA,Tucuman,1674622,439,7,5102,78
2020-09-09,Argentina,NA,Tucuman,1674622,433,3,5535,81
2020-09-10,Argentina,NA,Tucuman,1674622,418,3,5953,84
2020-09-11,Argentina,NA,Tucuman,1674622,363,4,6316,88
2020-09-12,Argentina,NA,Tucuman,1674622,514,5,6830,93
2020-09-13,Argentina,NA,Tucuman,1674622,471,4,7301,97
2020-09-14,Argentina,NA,Tucuman,1674622,541,10,7842,107
2020-09-15,Argentina,NA,Tucuman,1674622,306,2,8148,109
2020-09-16,Argentina,NA,Tucuman,1674622,537,5,8685,114
2020-09-17,Argentina,NA,Tucuman,1674622,527,1,9212,115
2020-09-18,Argentina,NA,Tucuman,1674622,272,1,9484,116
2020-09-19,Argentina,NA,Tucuman,1674622,657,1,10141,117
2020-09-20,Argentina,NA,Tucuman,1674622,264,0,10405,117
2020-09-21,Argentina,NA,Tucuman,1674622,587,0,10992,117
2020-09-22,Argentina,NA,Tucuman,1674622,282,2,11274,119
2020-09-23,Argentina,NA,Tucuman,1674622,199,0,11473,119
2020-03-03,Australia,NA,New South Wales,7480228,6,0,15,0
2020-03-04,Australia,NA,New South Wales,7480228,7,0,22,0
2020-03-05,Australia,NA,New South Wales,7480228,3,0,25,0
2020-03-06,Australia,NA,New South Wales,7480228,3,0,28,0
2020-03-07,Australia,NA,New South Wales,7480228,8,0,36,0
2020-03-08,Australia,NA,New South Wales,7480228,4,0,40,0
2020-03-09,Australia,NA,New South Wales,7480228,7,0,47,0
2020-03-10,Australia,NA,New South Wales,7480228,13,0,60,0
2020-03-11,Australia,NA,New South Wales,7480228,4,0,64,0
2020-03-12,Australia,NA,New South Wales,7480228,13,0,77,0
2020-03-13,Australia,NA,New South Wales,7480228,14,0,91,0
2020-03-14,Australia,NA,New South Wales,7480228,20,0,111,0
2020-03-15,Australia,NA,New South Wales,7480228,22,0,133,0
2020-03-16,Australia,NA,New South Wales,7480228,37,0,170,0
2020-03-17,Australia,NA,New South Wales,7480228,39,0,209,0
2020-03-18,Australia,NA,New South Wales,7480228,57,0,266,0
2020-03-19,Australia,NA,New South Wales,7480228,40,0,306,0
2020-03-20,Australia,NA,New South Wales,7480228,75,0,381,0
2020-03-21,Australia,NA,New South Wales,7480228,54,0,435,0
2020-03-22,Australia,NA,New South Wales,7480228,97,6,532,6
2020-03-23,Australia,NA,New South Wales,7480228,172,0,704,6
2020-03-24,Australia,NA,New South Wales,7480228,209,1,913,7
2020-03-25,Australia,NA,New South Wales,7480228,116,0,1029,7
2020-03-26,Australia,NA,New South Wales,7480228,190,0,1219,7
2020-03-27,Australia,NA,New South Wales,7480228,186,0,1405,7
2020-03-28,Australia,NA,New South Wales,7480228,212,1,1617,8
2020-03-29,Australia,NA,New South Wales,7480228,174,0,1791,8
2020-03-30,Australia,NA,New South Wales,7480228,127,0,1918,8
2020-03-31,Australia,NA,New South Wales,7480228,114,0,2032,8
2020-04-01,Australia,NA,New South Wales,7480228,150,2,2182,10
2020-04-02,Australia,NA,New South Wales,7480228,116,0,2298,10
2020-04-03,Australia,NA,New South Wales,7480228,91,2,2389,12
2020-04-04,Australia,NA,New South Wales,7480228,104,0,2493,12
2020-04-05,Australia,NA,New South Wales,7480228,87,4,2580,16
2020-04-06,Australia,NA,New South Wales,7480228,57,3,2637,19
2020-04-07,Australia,NA,New South Wales,7480228,49,2,2686,21
2020-04-08,Australia,NA,New South Wales,7480228,48,0,2734,21
2020-04-09,Australia,NA,New South Wales,7480228,39,0,2773,21
2020-04-10,Australia,NA,New South Wales,7480228,49,1,2822,22
2020-04-11,Australia,NA,New South Wales,7480228,35,1,2857,23
2020-04-12,Australia,NA,New South Wales,7480228,0,0,2857,23
2020-04-13,Australia,NA,New South Wales,7480228,9,2,2863,25
2020-04-14,Australia,NA,New South Wales,7480228,7,0,2870,25
2020-04-15,Australia,NA,New South Wales,7480228,16,0,2886,25
2020-04-16,Australia,NA,New South Wales,7480228,11,0,2897,25
2020-04-17,Australia,NA,New South Wales,7480228,29,0,2926,25
2020-04-18,Australia,NA,New South Wales,7480228,10,2,2936,27
2020-04-19,Australia,NA,New South Wales,7480228,21,1,2957,28
2020-04-20,Australia,NA,New South Wales,7480228,6,0,2963,28
2020-04-21,Australia,NA,New South Wales,7480228,6,1,2969,29
2020-04-22,Australia,NA,New South Wales,7480228,2,2,2971,31
2020-04-23,Australia,NA,New South Wales,7480228,5,1,2976,32
2020-04-24,Australia,NA,New South Wales,7480228,6,1,2982,33
2020-04-25,Australia,NA,New South Wales,7480228,12,1,2994,34
2020-04-26,Australia,NA,New South Wales,7480228,8,0,3002,34
2020-04-27,Australia,NA,New South Wales,7480228,2,0,3004,34
2020-04-28,Australia,NA,New South Wales,7480228,5,5,3009,39
2020-04-29,Australia,NA,New South Wales,7480228,7,1,3016,40
2020-04-30,Australia,NA,New South Wales,7480228,0,0,3016,40
2020-05-01,Australia,NA,New South Wales,7480228,9,1,3025,41
2020-05-02,Australia,NA,New South Wales,7480228,6,0,3031,41
2020-05-03,Australia,NA,New South Wales,7480228,4,1,3035,42
2020-05-04,Australia,NA,New South Wales,7480228,0,0,3035,42
2020-05-05,Australia,NA,New South Wales,7480228,2,2,3035,44
2020-05-06,Australia,NA,New South Wales,7480228,7,0,3042,44
2020-05-07,Australia,NA,New South Wales,7480228,2,0,3044,44
2020-05-08,Australia,NA,New South Wales,7480228,3,0,3047,44
2020-05-09,Australia,NA,New South Wales,7480228,4,0,3051,44
2020-05-10,Australia,NA,New South Wales,7480228,2,0,3053,44
2020-05-11,Australia,NA,New South Wales,7480228,0,0,3053,44
2020-05-12,Australia,NA,New South Wales,7480228,0,0,3053,44
2020-05-13,Australia,NA,New South Wales,7480228,6,1,3059,45
2020-05-14,Australia,NA,New South Wales,7480228,4,0,3063,45
2020-05-15,Australia,NA,New South Wales,7480228,8,0,3071,45
2020-05-16,Australia,NA,New South Wales,7480228,3,0,3074,45
2020-05-17,Australia,NA,New South Wales,7480228,1,0,3075,45
2020-05-18,Australia,NA,New South Wales,7480228,1,1,3076,46
2020-05-19,Australia,NA,New South Wales,7480228,2,1,3078,47
2020-05-20,Australia,NA,New South Wales,7480228,3,0,3081,47
2020-05-21,Australia,NA,New South Wales,7480228,1,0,3082,47
2020-05-22,Australia,NA,New South Wales,7480228,2,1,3084,48
2020-05-23,Australia,NA,New South Wales,7480228,2,0,3086,48
2020-05-24,Australia,NA,New South Wales,7480228,1,0,3087,48
2020-05-25,Australia,NA,New South Wales,7480228,3,0,3090,48
2020-05-26,Australia,NA,New South Wales,7480228,2,0,3092,48
2020-05-27,Australia,NA,New South Wales,7480228,0,0,3092,48
2020-05-28,Australia,NA,New South Wales,7480228,1,0,3092,48
2020-05-29,Australia,NA,New South Wales,7480228,2,0,3092,48
2020-05-30,Australia,NA,New South Wales,7480228,0,0,3092,48
2020-05-31,Australia,NA,New South Wales,7480228,3,0,3095,48
2020-06-01,Australia,NA,New South Wales,7480228,3,0,3098,48
2020-06-02,Australia,NA,New South Wales,7480228,6,0,3104,48
2020-06-03,Australia,NA,New South Wales,7480228,0,0,3104,48
2020-06-04,Australia,NA,New South Wales,7480228,2,0,3106,48
2020-06-05,Australia,NA,New South Wales,7480228,4,0,3110,48
2020-06-06,Australia,NA,New South Wales,7480228,0,0,3110,48
2020-06-07,Australia,NA,New South Wales,7480228,0,0,3110,48
2020-06-08,Australia,NA,New South Wales,7480228,3,0,3112,48
2020-06-09,Australia,NA,New South Wales,7480228,2,0,3114,48
2020-06-10,Australia,NA,New South Wales,7480228,3,0,3117,48
2020-06-11,Australia,NA,New South Wales,7480228,0,0,3117,48
2020-06-12,Australia,NA,New South Wales,7480228,0,0,3117,48
2020-06-13,Australia,NA,New South Wales,7480228,3,0,3119,48
2020-06-14,Australia,NA,New South Wales,7480228,9,0,3128,48
2020-06-15,Australia,NA,New South Wales,7480228,3,0,3131,48
2020-06-16,Australia,NA,New South Wales,7480228,3,0,3134,48
2020-06-17,Australia,NA,New South Wales,7480228,1,0,3135,48
2020-06-18,Australia,NA,New South Wales,7480228,2,0,3137,48
2020-06-19,Australia,NA,New South Wales,7480228,6,0,3143,48
2020-06-20,Australia,NA,New South Wales,7480228,1,0,3144,48
2020-06-21,Australia,NA,New South Wales,7480228,5,0,3149,48
2020-06-22,Australia,NA,New South Wales,7480228,2,0,3151,48
2020-06-23,Australia,NA,New South Wales,7480228,0,0,3151,48
2020-06-24,Australia,NA,New South Wales,7480228,9,0,3159,48
2020-06-25,Australia,NA,New South Wales,7480228,3,1,3162,49
2020-06-26,Australia,NA,New South Wales,7480228,6,0,3168,49
2020-06-27,Australia,NA,New South Wales,7480228,6,0,3174,49
2020-06-28,Australia,NA,New South Wales,7480228,3,0,3177,49
2020-06-29,Australia,NA,New South Wales,7480228,7,0,3184,49
2020-06-30,Australia,NA,New South Wales,7480228,5,0,3189,49
2020-07-01,Australia,NA,New South Wales,7480228,14,0,3203,49
2020-07-02,Australia,NA,New South Wales,7480228,8,0,3211,49
2020-07-03,Australia,NA,New South Wales,7480228,189,0,3400,49
2020-07-04,Australia,NA,New South Wales,7480228,5,0,3405,49
2020-07-05,Australia,NA,New South Wales,7480228,14,0,3419,49
2020-07-06,Australia,NA,New South Wales,7480228,10,0,3429,49
2020-07-07,Australia,NA,New South Wales,7480228,4,0,3433,49
2020-07-08,Australia,NA,New South Wales,7480228,7,0,3440,49
2020-07-09,Australia,NA,New South Wales,7480228,13,0,3453,49
2020-07-10,Australia,NA,New South Wales,7480228,14,0,3467,49
2020-07-11,Australia,NA,New South Wales,7480228,7,0,3474,49
2020-07-12,Australia,NA,New South Wales,7480228,4,0,3478,49
2020-07-13,Australia,NA,New South Wales,7480228,14,0,3492,49
2020-07-14,Australia,NA,New South Wales,7480228,13,0,3505,49
2020-07-15,Australia,NA,New South Wales,7480228,12,0,3517,49
2020-07-16,Australia,NA,New South Wales,7480228,10,0,3527,49
2020-07-17,Australia,NA,New South Wales,7480228,8,0,3535,49
2020-07-18,Australia,NA,New South Wales,7480228,15,0,3550,49
2020-07-19,Australia,NA,New South Wales,7480228,18,0,3568,49
2020-07-20,Australia,NA,New South Wales,7480228,20,0,3588,49
2020-07-21,Australia,NA,New South Wales,7480228,11,0,3599,49
2020-07-22,Australia,NA,New South Wales,7480228,15,0,3614,49
2020-07-23,Australia,NA,New South Wales,7480228,19,0,3633,49
2020-07-24,Australia,NA,New South Wales,7480228,7,0,3640,49
2020-07-25,Australia,NA,New South Wales,7480228,14,0,3654,49
2020-07-26,Australia,NA,New South Wales,7480228,14,0,3668,49
2020-07-27,Australia,NA,New South Wales,7480228,17,0,3685,49
2020-07-28,Australia,NA,New South Wales,7480228,14,0,3699,49
2020-07-29,Australia,NA,New South Wales,7480228,19,0,3718,49
2020-07-30,Australia,NA,New South Wales,7480228,18,0,3736,49
2020-07-31,Australia,NA,New South Wales,7480228,20,0,3756,49
2020-08-01,Australia,NA,New South Wales,7480228,17,0,3773,49
2020-08-02,Australia,NA,New South Wales,7480228,11,1,3784,50
2020-08-03,Australia,NA,New South Wales,7480228,13,0,3797,50
2020-08-04,Australia,NA,New South Wales,7480228,12,0,3809,50
2020-08-05,Australia,NA,New South Wales,7480228,11,0,3820,50
2020-08-06,Australia,NA,New South Wales,7480228,12,0,3832,50
2020-08-07,Australia,NA,New South Wales,7480228,10,0,3842,50
2020-08-08,Australia,NA,New South Wales,7480228,9,0,3851,50
2020-08-09,Australia,NA,New South Wales,7480228,10,0,3861,50
2020-08-10,Australia,NA,New South Wales,7480228,14,0,3875,50
2020-08-11,Australia,NA,New South Wales,7480228,22,0,3897,50
2020-08-12,Australia,NA,New South Wales,7480228,18,0,3915,50
2020-08-13,Australia,NA,New South Wales,7480228,12,1,3927,51
2020-08-14,Australia,NA,New South Wales,7480228,9,0,3936,51
2020-08-15,Australia,NA,New South Wales,7480228,9,0,3945,51
2020-08-16,Australia,NA,New South Wales,7480228,5,1,3950,52
2020-08-17,Australia,NA,New South Wales,7480228,7,0,3957,52
2020-08-18,Australia,NA,New South Wales,7480228,2,0,3959,52
2020-08-19,Australia,NA,New South Wales,7480228,7,0,3966,52
2020-08-20,Australia,NA,New South Wales,7480228,5,0,3971,52
2020-08-21,Australia,NA,New South Wales,7480228,1,0,3972,52
2020-08-22,Australia,NA,New South Wales,7480228,9,0,3981,52
2020-08-23,Australia,NA,New South Wales,7480228,4,0,3985,52
2020-08-24,Australia,NA,New South Wales,7480228,3,0,3988,52
2020-08-25,Australia,NA,New South Wales,7480228,3,0,3991,52
2020-08-26,Australia,NA,New South Wales,7480228,6,0,3997,52
2020-08-27,Australia,NA,New South Wales,7480228,9,0,4006,52
2020-08-28,Australia,NA,New South Wales,7480228,13,0,4019,52
2020-08-29,Australia,NA,New South Wales,7480228,14,0,4033,52
2020-08-30,Australia,NA,New South Wales,7480228,7,0,4040,52
2020-08-31,Australia,NA,New South Wales,7480228,10,0,4050,52
2020-09-01,Australia,NA,New South Wales,7480228,13,0,4063,52
2020-09-02,Australia,NA,New South Wales,7480228,16,0,4079,52
2020-09-03,Australia,NA,New South Wales,7480228,12,0,4091,52
2020-09-04,Australia,NA,New South Wales,7480228,8,0,4099,52
2020-09-05,Australia,NA,New South Wales,7480228,5,0,4104,52
2020-09-06,Australia,NA,New South Wales,7480228,10,0,4114,52
2020-09-07,Australia,NA,New South Wales,7480228,4,0,4118,52
2020-09-08,Australia,NA,New South Wales,7480228,8,0,4126,52
2020-09-09,Australia,NA,New South Wales,7480228,9,0,4135,52
2020-09-10,Australia,NA,New South Wales,7480228,7,0,4142,52
2020-09-11,Australia,NA,New South Wales,7480228,10,0,4152,52
2020-09-12,Australia,NA,New South Wales,7480228,5,0,4157,52
2020-09-13,Australia,NA,New South Wales,7480228,9,0,4166,52
2020-09-14,Australia,NA,New South Wales,7480228,4,0,4170,52
2020-09-15,Australia,NA,New South Wales,7480228,6,0,4176,52
2020-09-16,Australia,NA,New South Wales,7480228,9,0,4185,52
2020-09-17,Australia,NA,New South Wales,7480228,5,0,4190,52
2020-09-18,Australia,NA,New South Wales,7480228,6,0,4196,52
2020-09-19,Australia,NA,New South Wales,7480228,2,0,4198,52
2020-09-20,Australia,NA,New South Wales,7480228,2,1,4200,53
2020-09-21,Australia,NA,New South Wales,7480228,4,0,4204,53
2020-09-22,Australia,NA,New South Wales,7480228,2,0,4206,53
2020-09-23,Australia,NA,New South Wales,7480228,6,0,4212,53
2020-03-04,Australia,NA,Queensland,4703193,1,0,11,0
2020-03-05,Australia,NA,Queensland,4703193,2,0,13,0
2020-03-06,Australia,NA,Queensland,4703193,1,0,14,0
2020-03-07,Australia,NA,Queensland,4703193,0,0,14,0
2020-03-08,Australia,NA,Queensland,4703193,1,0,15,0
2020-03-09,Australia,NA,Queensland,4703193,0,0,15,0
2020-03-10,Australia,NA,Queensland,4703193,3,0,18,0
2020-03-11,Australia,NA,Queensland,4703193,2,0,20,0
2020-03-12,Australia,NA,Queensland,4703193,7,0,27,0
2020-03-13,Australia,NA,Queensland,4703193,8,0,35,0
2020-03-14,Australia,NA,Queensland,4703193,11,0,46,0
2020-03-15,Australia,NA,Queensland,4703193,16,0,62,0
2020-03-16,Australia,NA,Queensland,4703193,6,0,68,0
2020-03-17,Australia,NA,Queensland,4703193,10,0,78,0
2020-03-18,Australia,NA,Queensland,4703193,16,0,94,0
2020-03-19,Australia,NA,Queensland,4703193,50,0,144,0
2020-03-20,Australia,NA,Queensland,4703193,40,0,184,0
2020-03-21,Australia,NA,Queensland,4703193,37,0,221,0
2020-03-22,Australia,NA,Queensland,4703193,38,0,259,0
2020-03-23,Australia,NA,Queensland,4703193,60,0,319,0
2020-03-24,Australia,NA,Queensland,4703193,78,0,397,0
2020-03-25,Australia,NA,Queensland,4703193,46,1,443,1
2020-03-26,Australia,NA,Queensland,4703193,50,0,493,1
2020-03-27,Australia,NA,Queensland,4703193,62,0,555,1
2020-03-28,Australia,NA,Queensland,4703193,70,0,625,1
2020-03-29,Australia,NA,Queensland,4703193,31,1,656,2
2020-03-30,Australia,NA,Queensland,4703193,33,0,689,2
2020-03-31,Australia,NA,Queensland,4703193,54,0,743,2
2020-04-01,Australia,NA,Queensland,4703193,38,0,781,2
2020-04-02,Australia,NA,Queensland,4703193,54,1,835,3
2020-04-03,Australia,NA,Queensland,4703193,38,0,873,3
2020-04-04,Australia,NA,Queensland,4703193,27,0,900,3
2020-04-05,Australia,NA,Queensland,4703193,7,1,907,4
2020-04-06,Australia,NA,Queensland,4703193,14,0,921,4
2020-04-07,Australia,NA,Queensland,4703193,13,0,934,4
2020-04-08,Australia,NA,Queensland,4703193,9,0,943,4
2020-04-09,Australia,NA,Queensland,4703193,10,0,953,4
2020-04-10,Australia,NA,Queensland,4703193,12,0,965,4
2020-04-11,Australia,NA,Queensland,4703193,9,1,974,5
2020-04-12,Australia,NA,Queensland,4703193,9,0,983,5
2020-04-13,Australia,NA,Queensland,4703193,4,0,987,5
2020-04-14,Australia,NA,Queensland,4703193,11,0,998,5
2020-04-15,Australia,NA,Queensland,4703193,1,0,999,5
2020-04-16,Australia,NA,Queensland,4703193,2,0,1001,5
2020-04-17,Australia,NA,Queensland,4703193,6,0,1007,5
2020-04-18,Australia,NA,Queensland,4703193,7,1,1014,6
2020-04-19,Australia,NA,Queensland,4703193,5,0,1019,6
2020-04-20,Australia,NA,Queensland,4703193,0,0,1019,6
2020-04-21,Australia,NA,Queensland,4703193,5,0,1024,6
2020-04-22,Australia,NA,Queensland,4703193,0,0,1024,6
2020-04-23,Australia,NA,Queensland,4703193,2,0,1026,6
2020-04-24,Australia,NA,Queensland,4703193,0,0,1026,6
2020-04-25,Australia,NA,Queensland,4703193,0,0,1026,6
2020-04-26,Australia,NA,Queensland,4703193,4,0,1030,6
2020-04-27,Australia,NA,Queensland,4703193,3,0,1033,6
2020-04-28,Australia,NA,Queensland,4703193,0,0,1033,6
2020-04-29,Australia,NA,Queensland,4703193,1,0,1034,6
2020-04-30,Australia,NA,Queensland,4703193,0,0,1034,6
2020-05-01,Australia,NA,Queensland,4703193,0,0,1034,6
2020-05-02,Australia,NA,Queensland,4703193,1,0,1034,6
2020-05-03,Australia,NA,Queensland,4703193,1,0,1035,6
2020-05-04,Australia,NA,Queensland,4703193,3,0,1038,6
2020-05-05,Australia,NA,Queensland,4703193,5,0,1043,6
2020-05-06,Australia,NA,Queensland,4703193,0,0,1043,6
2020-05-07,Australia,NA,Queensland,4703193,2,0,1045,6
2020-05-08,Australia,NA,Queensland,4703193,0,0,1045,6
2020-05-09,Australia,NA,Queensland,4703193,0,0,1045,6
2020-05-10,Australia,NA,Queensland,4703193,0,0,1045,6
2020-05-11,Australia,NA,Queensland,4703193,0,0,1045,6
2020-05-12,Australia,NA,Queensland,4703193,6,0,1051,6
2020-05-13,Australia,NA,Queensland,4703193,0,0,1051,6
2020-05-14,Australia,NA,Queensland,4703193,1,0,1052,6
2020-05-15,Australia,NA,Queensland,4703193,2,0,1054,6
2020-05-16,Australia,NA,Queensland,4703193,1,0,1055,6
2020-05-17,Australia,NA,Queensland,4703193,0,0,1055,6
2020-05-18,Australia,NA,Queensland,4703193,2,0,1057,6
2020-05-19,Australia,NA,Queensland,4703193,0,0,1057,6
2020-05-20,Australia,NA,Queensland,4703193,1,0,1058,6
2020-05-21,Australia,NA,Queensland,4703193,0,0,1058,6
2020-05-22,Australia,NA,Queensland,4703193,0,0,1058,6
2020-05-23,Australia,NA,Queensland,4703193,0,0,1058,6
2020-05-24,Australia,NA,Queensland,4703193,1,0,1059,6
2020-05-25,Australia,NA,Queensland,4703193,0,0,1059,6
2020-05-26,Australia,NA,Queensland,4703193,1,0,1059,6
2020-05-27,Australia,NA,Queensland,4703193,1,1,1059,7
2020-05-28,Australia,NA,Queensland,4703193,0,0,1059,7
2020-05-29,Australia,NA,Queensland,4703193,0,0,1059,7
2020-05-30,Australia,NA,Queensland,4703193,0,0,1059,7
2020-05-31,Australia,NA,Queensland,4703193,0,0,1059,7
2020-06-01,Australia,NA,Queensland,4703193,0,0,1059,7
2020-06-02,Australia,NA,Queensland,4703193,1,0,1059,7
2020-06-03,Australia,NA,Queensland,4703193,0,0,1059,7
2020-06-04,Australia,NA,Queensland,4703193,1,0,1060,7
2020-06-05,Australia,NA,Queensland,4703193,0,0,1060,7
2020-06-06,Australia,NA,Queensland,4703193,1,0,1061,7
2020-06-07,Australia,NA,Queensland,4703193,1,0,1062,7
2020-06-08,Australia,NA,Queensland,4703193,0,0,1062,7
2020-06-09,Australia,NA,Queensland,4703193,0,0,1062,7
2020-06-10,Australia,NA,Queensland,4703193,0,0,1062,7
2020-06-11,Australia,NA,Queensland,4703193,1,0,1063,7
2020-06-12,Australia,NA,Queensland,4703193,1,0,1064,7
2020-06-13,Australia,NA,Queensland,4703193,1,0,1065,7
2020-06-14,Australia,NA,Queensland,4703193,0,0,1065,7
2020-06-15,Australia,NA,Queensland,4703193,0,0,1065,7
2020-06-16,Australia,NA,Queensland,4703193,0,0,1065,7
2020-06-17,Australia,NA,Queensland,4703193,1,0,1066,7
2020-06-18,Australia,NA,Queensland,4703193,0,0,1066,7
2020-06-19,Australia,NA,Queensland,4703193,0,0,1066,7
2020-06-20,Australia,NA,Queensland,4703193,0,0,1066,7
2020-06-21,Australia,NA,Queensland,4703193,0,0,1066,7
2020-06-22,Australia,NA,Queensland,4703193,0,0,1066,7
2020-06-23,Australia,NA,Queensland,4703193,0,0,1066,7
2020-06-24,Australia,NA,Queensland,4703193,0,0,1066,7
2020-06-25,Australia,NA,Queensland,4703193,0,0,1066,7
2020-06-26,Australia,NA,Queensland,4703193,1,0,1067,7
2020-06-27,Australia,NA,Queensland,4703193,0,0,1067,7
2020-06-28,Australia,NA,Queensland,4703193,0,0,1067,7
2020-06-29,Australia,NA,Queensland,4703193,0,0,1067,7
2020-06-30,Australia,NA,Queensland,4703193,0,0,1067,7
2020-07-01,Australia,NA,Queensland,4703193,0,0,1067,7
2020-07-02,Australia,NA,Queensland,4703193,0,0,1067,7
2020-07-03,Australia,NA,Queensland,4703193,0,0,1067,7
2020-07-04,Australia,NA,Queensland,4703193,0,0,1067,7
2020-07-05,Australia,NA,Queensland,4703193,0,0,1067,7
2020-07-06,Australia,NA,Queensland,4703193,0,0,1067,7
2020-07-07,Australia,NA,Queensland,4703193,1,0,1068,7
2020-07-08,Australia,NA,Queensland,4703193,0,0,1068,7
2020-07-09,Australia,NA,Queensland,4703193,0,0,1068,7
2020-07-10,Australia,NA,Queensland,4703193,0,0,1068,7
2020-07-11,Australia,NA,Queensland,4703193,2,0,1070,7
2020-07-12,Australia,NA,Queensland,4703193,0,0,1070,7
2020-07-13,Australia,NA,Queensland,4703193,1,0,1071,7
2020-07-14,Australia,NA,Queensland,4703193,0,0,1071,7
2020-07-15,Australia,NA,Queensland,4703193,0,0,1071,7
2020-07-16,Australia,NA,Queensland,4703193,0,0,1071,7
2020-07-17,Australia,NA,Queensland,4703193,0,0,1071,7
2020-07-18,Australia,NA,Queensland,4703193,0,0,1071,7
2020-07-19,Australia,NA,Queensland,4703193,0,0,1071,7
2020-07-20,Australia,NA,Queensland,4703193,1,0,1072,7
2020-07-21,Australia,NA,Queensland,4703193,0,0,1072,7
2020-07-22,Australia,NA,Queensland,4703193,1,0,1073,7
2020-07-23,Australia,NA,Queensland,4703193,1,0,1074,7
2020-07-24,Australia,NA,Queensland,4703193,2,0,1076,7
2020-07-25,Australia,NA,Queensland,4703193,0,0,1076,7
2020-07-26,Australia,NA,Queensland,4703193,0,0,1076,7
2020-07-27,Australia,NA,Queensland,4703193,0,0,1076,7
2020-07-28,Australia,NA,Queensland,4703193,0,0,1076,7
2020-07-29,Australia,NA,Queensland,4703193,2,0,1078,7
2020-07-30,Australia,NA,Queensland,4703193,4,0,1082,7
2020-07-31,Australia,NA,Queensland,4703193,1,0,1083,7
2020-08-01,Australia,NA,Queensland,4703193,1,0,1084,7
2020-08-02,Australia,NA,Queensland,4703193,1,0,1085,7
2020-08-03,Australia,NA,Queensland,4703193,0,0,1085,7
2020-08-04,Australia,NA,Queensland,4703193,0,0,1085,7
2020-08-05,Australia,NA,Queensland,4703193,3,0,1088,7
2020-08-06,Australia,NA,Queensland,4703193,0,0,1088,7
2020-08-07,Australia,NA,Queensland,4703193,0,0,1088,7
2020-08-08,Australia,NA,Queensland,4703193,1,0,1088,7
2020-08-09,Australia,NA,Queensland,4703193,0,0,1088,7
2020-08-10,Australia,NA,Queensland,4703193,1,0,1089,7
2020-08-11,Australia,NA,Queensland,4703193,0,0,1089,7
2020-08-12,Australia,NA,Queensland,4703193,0,0,1089,7
2020-08-13,Australia,NA,Queensland,4703193,0,0,1089,7
2020-08-14,Australia,NA,Queensland,4703193,3,0,1092,7
2020-08-15,Australia,NA,Queensland,4703193,0,0,1092,7
2020-08-16,Australia,NA,Queensland,4703193,0,0,1092,7
2020-08-17,Australia,NA,Queensland,4703193,0,0,1092,7
2020-08-18,Australia,NA,Queensland,4703193,0,0,1092,7
2020-08-19,Australia,NA,Queensland,4703193,1,0,1092,7
2020-08-20,Australia,NA,Queensland,4703193,1,0,1093,7
2020-08-21,Australia,NA,Queensland,4703193,1,0,1094,7
2020-08-22,Australia,NA,Queensland,4703193,9,0,1103,7
2020-08-23,Australia,NA,Queensland,4703193,2,0,1105,7
2020-08-24,Australia,NA,Queensland,4703193,1,0,1106,7
2020-08-25,Australia,NA,Queensland,4703193,0,0,1106,7
2020-08-26,Australia,NA,Queensland,4703193,2,0,1108,7
2020-08-27,Australia,NA,Queensland,4703193,2,0,1110,7
2020-08-28,Australia,NA,Queensland,4703193,3,0,1113,7
2020-08-29,Australia,NA,Queensland,4703193,4,0,1117,7
2020-08-30,Australia,NA,Queensland,4703193,4,0,1121,7
2020-08-31,Australia,NA,Queensland,4703193,1,0,1122,7
2020-09-01,Australia,NA,Queensland,4703193,2,0,1124,7
2020-09-02,Australia,NA,Queensland,4703193,2,0,1126,7
2020-09-03,Australia,NA,Queensland,4703193,2,0,1128,7
2020-09-04,Australia,NA,Queensland,4703193,0,0,1128,7
2020-09-05,Australia,NA,Queensland,4703193,1,0,1129,7
2020-09-06,Australia,NA,Queensland,4703193,2,0,1131,7
2020-09-07,Australia,NA,Queensland,4703193,2,0,1133,7
2020-09-08,Australia,NA,Queensland,4703193,1,0,1134,7
2020-09-09,Australia,NA,Queensland,4703193,9,0,1143,7
2020-09-10,Australia,NA,Queensland,4703193,0,0,1143,7
2020-09-11,Australia,NA,Queensland,4703193,2,0,1145,7
2020-09-12,Australia,NA,Queensland,4703193,4,0,1149,7
2020-09-13,Australia,NA,Queensland,4703193,0,0,1149,7
2020-09-14,Australia,NA,Queensland,4703193,0,0,1149,7
2020-09-15,Australia,NA,Queensland,4703193,1,0,1150,7
2020-09-16,Australia,NA,Queensland,4703193,0,0,1150,7
2020-09-17,Australia,NA,Queensland,4703193,1,0,1150,7
2020-09-18,Australia,NA,Queensland,4703193,0,0,1150,7
2020-09-19,Australia,NA,Queensland,4703193,0,0,1150,7
2020-09-20,Australia,NA,Queensland,4703193,2,0,1152,7
2020-09-21,Australia,NA,Queensland,4703193,1,0,1153,7
2020-03-07,Australia,NA,Victoria,5926624,1,0,11,0
2020-03-08,Australia,NA,Victoria,5926624,1,0,12,0
2020-03-09,Australia,NA,Victoria,5926624,3,0,15,0
2020-03-10,Australia,NA,Victoria,5926624,4,0,19,0
2020-03-11,Australia,NA,Victoria,5926624,3,0,22,0
2020-03-12,Australia,NA,Victoria,5926624,5,0,27,0
2020-03-13,Australia,NA,Victoria,5926624,9,0,36,0
2020-03-14,Australia,NA,Victoria,5926624,13,0,49,0
2020-03-15,Australia,NA,Victoria,5926624,8,0,57,0
2020-03-16,Australia,NA,Victoria,5926624,14,0,71,0
2020-03-17,Australia,NA,Victoria,5926624,23,0,94,0
2020-03-18,Australia,NA,Victoria,5926624,27,0,121,0
2020-03-19,Australia,NA,Victoria,5926624,29,0,150,0
2020-03-20,Australia,NA,Victoria,5926624,28,0,178,0
2020-03-21,Australia,NA,Victoria,5926624,51,0,229,0
2020-03-22,Australia,NA,Victoria,5926624,67,0,296,0
2020-03-23,Australia,NA,Victoria,5926624,59,0,355,0
2020-03-24,Australia,NA,Victoria,5926624,56,0,411,0
2020-03-25,Australia,NA,Victoria,5926624,55,0,466,0
2020-03-26,Australia,NA,Victoria,5926624,54,3,520,3
2020-03-27,Australia,NA,Victoria,5926624,54,0,574,3
2020-03-28,Australia,NA,Victoria,5926624,111,0,685,3
2020-03-29,Australia,NA,Victoria,5926624,84,1,769,4
2020-03-30,Australia,NA,Victoria,5926624,52,0,821,4
2020-03-31,Australia,NA,Victoria,5926624,96,0,917,4
2020-04-01,Australia,NA,Victoria,5926624,51,0,968,4
2020-04-02,Australia,NA,Victoria,5926624,68,2,1036,6
2020-04-03,Australia,NA,Victoria,5926624,49,1,1085,7
2020-04-04,Australia,NA,Victoria,5926624,30,1,1115,8
2020-04-05,Australia,NA,Victoria,5926624,20,0,1135,8
2020-04-06,Australia,NA,Victoria,5926624,23,2,1158,10
2020-04-07,Australia,NA,Victoria,5926624,33,1,1191,11
2020-04-08,Australia,NA,Victoria,5926624,21,1,1212,12
2020-04-09,Australia,NA,Victoria,5926624,16,0,1228,12
2020-04-10,Australia,NA,Victoria,5926624,13,1,1241,13
2020-04-11,Australia,NA,Victoria,5926624,24,1,1265,14
2020-04-12,Australia,NA,Victoria,5926624,3,0,1268,14
2020-04-13,Australia,NA,Victoria,5926624,13,0,1281,14
2020-04-14,Australia,NA,Victoria,5926624,10,0,1291,14
2020-04-15,Australia,NA,Victoria,5926624,8,0,1299,14
2020-04-16,Australia,NA,Victoria,5926624,2,0,1301,14
2020-04-17,Australia,NA,Victoria,5926624,1,0,1302,14
2020-04-18,Australia,NA,Victoria,5926624,17,0,1319,14
2020-04-19,Australia,NA,Victoria,5926624,9,1,1328,15
2020-04-20,Australia,NA,Victoria,5926624,1,0,1329,15
2020-04-21,Australia,NA,Victoria,5926624,7,0,1336,15
2020-04-22,Australia,NA,Victoria,5926624,0,0,1336,15
2020-04-23,Australia,NA,Victoria,5926624,1,1,1337,16
2020-04-24,Australia,NA,Victoria,5926624,6,0,1343,16
2020-04-25,Australia,NA,Victoria,5926624,3,0,1346,16
2020-04-26,Australia,NA,Victoria,5926624,3,1,1349,17
2020-04-27,Australia,NA,Victoria,5926624,0,0,1349,17
2020-04-28,Australia,NA,Victoria,5926624,2,0,1351,17
2020-04-29,Australia,NA,Victoria,5926624,3,1,1354,18
2020-04-30,Australia,NA,Victoria,5926624,7,0,1361,18
2020-05-01,Australia,NA,Victoria,5926624,3,0,1364,18
2020-05-02,Australia,NA,Victoria,5926624,7,0,1371,18
2020-05-03,Australia,NA,Victoria,5926624,13,0,1384,18
2020-05-04,Australia,NA,Victoria,5926624,22,0,1406,18
2020-05-05,Australia,NA,Victoria,5926624,17,0,1423,18
2020-05-06,Australia,NA,Victoria,5926624,17,0,1440,18
2020-05-07,Australia,NA,Victoria,5926624,15,0,1455,18
2020-05-08,Australia,NA,Victoria,5926624,13,0,1468,18
2020-05-09,Australia,NA,Victoria,5926624,11,0,1479,18
2020-05-10,Australia,NA,Victoria,5926624,10,0,1489,18
2020-05-11,Australia,NA,Victoria,5926624,7,0,1496,18
2020-05-12,Australia,NA,Victoria,5926624,11,0,1507,18
2020-05-13,Australia,NA,Victoria,5926624,5,0,1512,18
2020-05-14,Australia,NA,Victoria,5926624,8,0,1520,18
2020-05-15,Australia,NA,Victoria,5926624,20,0,1540,18
2020-05-16,Australia,NA,Victoria,5926624,11,0,1551,18
2020-05-17,Australia,NA,Victoria,5926624,7,0,1558,18
2020-05-18,Australia,NA,Victoria,5926624,9,0,1567,18
2020-05-19,Australia,NA,Victoria,5926624,6,0,1573,18
2020-05-20,Australia,NA,Victoria,5926624,7,0,1580,18
2020-05-21,Australia,NA,Victoria,5926624,1,0,1581,18
2020-05-22,Australia,NA,Victoria,5926624,12,0,1593,18
2020-05-23,Australia,NA,Victoria,5926624,9,1,1602,19
2020-05-24,Australia,NA,Victoria,5926624,1,0,1603,19
2020-05-25,Australia,NA,Victoria,5926624,2,0,1605,19
2020-05-26,Australia,NA,Victoria,5926624,5,0,1610,19
2020-05-27,Australia,NA,Victoria,5926624,8,0,1618,19
2020-05-28,Australia,NA,Victoria,5926624,10,0,1628,19
2020-05-29,Australia,NA,Victoria,5926624,6,0,1634,19
2020-05-30,Australia,NA,Victoria,5926624,11,0,1645,19
2020-05-31,Australia,NA,Victoria,5926624,4,0,1649,19
2020-06-01,Australia,NA,Victoria,5926624,4,0,1653,19
2020-06-02,Australia,NA,Victoria,5926624,10,0,1663,19
2020-06-03,Australia,NA,Victoria,5926624,7,0,1670,19
2020-06-04,Australia,NA,Victoria,5926624,8,0,1678,19
2020-06-05,Australia,NA,Victoria,5926624,3,0,1681,19
2020-06-06,Australia,NA,Victoria,5926624,0,0,1681,19
2020-06-07,Australia,NA,Victoria,5926624,4,0,1685,19
2020-06-08,Australia,NA,Victoria,5926624,2,0,1687,19
2020-06-09,Australia,NA,Victoria,5926624,0,0,1687,19
2020-06-10,Australia,NA,Victoria,5926624,4,0,1691,19
2020-06-11,Australia,NA,Victoria,5926624,8,0,1699,19
2020-06-12,Australia,NA,Victoria,5926624,4,0,1703,19
2020-06-13,Australia,NA,Victoria,5926624,8,0,1711,19
2020-06-14,Australia,NA,Victoria,5926624,9,0,1720,19
2020-06-15,Australia,NA,Victoria,5926624,12,0,1732,19
2020-06-16,Australia,NA,Victoria,5926624,9,0,1741,19
2020-06-17,Australia,NA,Victoria,5926624,21,0,1762,19
2020-06-18,Australia,NA,Victoria,5926624,18,0,1780,19
2020-06-19,Australia,NA,Victoria,5926624,12,0,1792,19
2020-06-20,Australia,NA,Victoria,5926624,25,0,1817,19
2020-06-21,Australia,NA,Victoria,5926624,19,0,1836,19
2020-06-22,Australia,NA,Victoria,5926624,11,0,1847,19
2020-06-23,Australia,NA,Victoria,5926624,17,0,1864,19
2020-06-24,Australia,NA,Victoria,5926624,20,1,1884,20
2020-06-25,Australia,NA,Victoria,5926624,33,0,1917,20
2020-06-26,Australia,NA,Victoria,5926624,30,0,1947,20
2020-06-27,Australia,NA,Victoria,5926624,40,0,1987,20
2020-06-28,Australia,NA,Victoria,5926624,41,0,2028,20
2020-06-29,Australia,NA,Victoria,5926624,71,0,2099,20
2020-06-30,Australia,NA,Victoria,5926624,60,0,2159,20
2020-07-01,Australia,NA,Victoria,5926624,72,0,2231,20
2020-07-02,Australia,NA,Victoria,5926624,72,0,2303,20
2020-07-03,Australia,NA,Victoria,5926624,65,0,2368,20
2020-07-04,Australia,NA,Victoria,5926624,101,0,2469,20
2020-07-05,Australia,NA,Victoria,5926624,67,0,2536,20
2020-07-06,Australia,NA,Victoria,5926624,124,2,2660,22
2020-07-07,Australia,NA,Victoria,5926624,164,0,2824,22
2020-07-08,Australia,NA,Victoria,5926624,118,0,2942,22
2020-07-09,Australia,NA,Victoria,5926624,156,0,3098,22
2020-07-10,Australia,NA,Victoria,5926624,281,0,3379,22
2020-07-11,Australia,NA,Victoria,5926624,181,1,3560,23
2020-07-12,Australia,NA,Victoria,5926624,239,1,3799,24
2020-07-13,Australia,NA,Victoria,5926624,168,0,3967,24
2020-07-14,Australia,NA,Victoria,5926624,257,2,4224,26
2020-07-15,Australia,NA,Victoria,5926624,224,1,4448,27
2020-07-16,Australia,NA,Victoria,5926624,302,2,4750,29
2020-07-17,Australia,NA,Victoria,5926624,415,3,5165,32
2020-07-18,Australia,NA,Victoria,5926624,188,3,5353,35
2020-07-19,Australia,NA,Victoria,5926624,343,3,5696,38
2020-07-20,Australia,NA,Victoria,5926624,246,1,5942,39
2020-07-21,Australia,NA,Victoria,5926624,347,3,6289,42
2020-07-22,Australia,NA,Victoria,5926624,450,2,6739,44
2020-07-23,Australia,NA,Victoria,5926624,386,5,7125,49
2020-07-24,Australia,NA,Victoria,5926624,280,7,7405,56
2020-07-25,Australia,NA,Victoria,5926624,339,5,7744,61
2020-07-26,Australia,NA,Victoria,5926624,437,10,8181,71
2020-07-27,Australia,NA,Victoria,5926624,515,6,8696,77
2020-07-28,Australia,NA,Victoria,5926624,353,6,9049,83
2020-07-29,Australia,NA,Victoria,5926624,255,9,9304,92
2020-07-30,Australia,NA,Victoria,5926624,694,14,9998,106
2020-07-31,Australia,NA,Victoria,5926624,579,7,10577,113
2020-08-01,Australia,NA,Victoria,5926624,354,3,10931,116
2020-08-02,Australia,NA,Victoria,5926624,626,7,11557,123
2020-08-03,Australia,NA,Victoria,5926624,380,13,11937,136
2020-08-04,Australia,NA,Victoria,5926624,398,11,12335,147
2020-08-05,Australia,NA,Victoria,5926624,700,15,13035,162
2020-08-06,Australia,NA,Victoria,5926624,434,8,13469,170
2020-08-07,Australia,NA,Victoria,5926624,398,11,13867,181
2020-08-08,Australia,NA,Victoria,5926624,416,12,14283,193
2020-08-09,Australia,NA,Victoria,5926624,376,17,14659,210
2020-08-10,Australia,NA,Victoria,5926624,298,18,14957,228
2020-08-11,Australia,NA,Victoria,5926624,294,18,15251,246
2020-08-12,Australia,NA,Victoria,5926624,395,21,15646,267
2020-08-13,Australia,NA,Victoria,5926624,217,8,15863,275
2020-08-14,Australia,NA,Victoria,5926624,371,14,16234,289
2020-08-15,Australia,NA,Victoria,5926624,283,4,16517,293
2020-08-16,Australia,NA,Victoria,5926624,247,16,16764,309
2020-08-17,Australia,NA,Victoria,5926624,263,25,17027,334
2020-08-18,Australia,NA,Victoria,5926624,211,17,17238,351
2020-08-19,Australia,NA,Victoria,5926624,208,12,17446,363
2020-08-20,Australia,NA,Victoria,5926624,237,13,17683,376
2020-08-21,Australia,NA,Victoria,5926624,169,9,17852,385
2020-08-22,Australia,NA,Victoria,5926624,177,3,18029,388
2020-08-23,Australia,NA,Victoria,5926624,202,27,18231,415
2020-08-24,Australia,NA,Victoria,5926624,99,15,18330,430
2020-08-25,Australia,NA,Victoria,5926624,134,8,18464,438
2020-08-26,Australia,NA,Victoria,5926624,144,24,18608,462
2020-08-27,Australia,NA,Victoria,5926624,106,23,18714,485
2020-08-28,Australia,NA,Victoria,5926624,108,12,18822,497
2020-08-29,Australia,NA,Victoria,5926624,81,16,18903,513
2020-08-30,Australia,NA,Victoria,5926624,112,11,19015,524
2020-08-31,Australia,NA,Victoria,5926624,65,41,19080,565
2020-09-01,Australia,NA,Victoria,5926624,58,5,19138,570
2020-09-02,Australia,NA,Victoria,5926624,86,6,19224,576
2020-09-03,Australia,NA,Victoria,5926624,112,15,19336,591
2020-09-04,Australia,NA,Victoria,5926624,79,59,19415,650
2020-09-05,Australia,NA,Victoria,5926624,64,11,19479,661
2020-09-06,Australia,NA,Victoria,5926624,59,5,19538,666
2020-09-07,Australia,NA,Victoria,5926624,36,9,19574,675
2020-09-08,Australia,NA,Victoria,5926624,41,8,19615,683
2020-09-09,Australia,NA,Victoria,5926624,73,11,19688,694
2020-09-10,Australia,NA,Victoria,5926624,40,7,19728,701
2020-09-11,Australia,NA,Victoria,5926624,39,9,19767,710
2020-09-12,Australia,NA,Victoria,5926624,33,6,19800,716
2020-09-13,Australia,NA,Victoria,5926624,35,7,19835,723
2020-09-14,Australia,NA,Victoria,5926624,37,6,19872,729
2020-09-15,Australia,NA,Victoria,5926624,39,0,19911,729
2020-09-16,Australia,NA,Victoria,5926624,32,8,19943,737
2020-09-17,Australia,NA,Victoria,5926624,27,8,19970,745
2020-09-18,Australia,NA,Victoria,5926624,42,5,20012,750
2020-09-19,Australia,NA,Victoria,5926624,22,7,20034,757
2020-09-20,Australia,NA,Victoria,5926624,8,4,20042,761
2020-09-21,Australia,NA,Victoria,5926624,9,2,20051,763
2020-09-22,Australia,NA,Victoria,5926624,25,3,20076,766
2020-09-23,Australia,NA,Victoria,5926624,24,5,20100,771
2020-03-13,Australia,NA,Western Australia,2474410,5,0,14,0
2020-03-14,Australia,NA,Western Australia,2474410,3,0,17,0
2020-03-15,Australia,NA,Western Australia,2474410,1,0,18,0
2020-03-16,Australia,NA,Western Australia,2474410,10,0,28,0
2020-03-17,Australia,NA,Western Australia,2474410,3,0,31,0
2020-03-18,Australia,NA,Western Australia,2474410,4,0,35,0
2020-03-19,Australia,NA,Western Australia,2474410,17,0,52,0
2020-03-20,Australia,NA,Western Australia,2474410,12,0,64,0
2020-03-21,Australia,NA,Western Australia,2474410,26,0,90,0
2020-03-22,Australia,NA,Western Australia,2474410,30,1,120,1
2020-03-23,Australia,NA,Western Australia,2474410,20,0,140,1
2020-03-24,Australia,NA,Western Australia,2474410,35,0,175,1
2020-03-25,Australia,NA,Western Australia,2474410,30,0,205,1
2020-03-26,Australia,NA,Western Australia,2474410,26,1,231,2
2020-03-27,Australia,NA,Western Australia,2474410,24,0,255,2
2020-03-28,Australia,NA,Western Australia,2474410,23,0,278,2
2020-03-29,Australia,NA,Western Australia,2474410,34,0,312,2
2020-03-30,Australia,NA,Western Australia,2474410,43,0,355,2
2020-03-31,Australia,NA,Western Australia,2474410,9,0,364,2
2020-04-01,Australia,NA,Western Australia,2474410,28,0,392,2
2020-04-02,Australia,NA,Western Australia,2474410,8,0,400,2
2020-04-03,Australia,NA,Western Australia,2474410,22,1,422,3
2020-04-04,Australia,NA,Western Australia,2474410,14,0,436,3
2020-04-05,Australia,NA,Western Australia,2474410,17,0,453,3
2020-04-06,Australia,NA,Western Australia,2474410,7,1,460,4
2020-04-07,Australia,NA,Western Australia,2474410,10,2,470,6
2020-04-08,Australia,NA,Western Australia,2474410,11,0,481,6
2020-04-09,Australia,NA,Western Australia,2474410,14,0,495,6
2020-04-10,Australia,NA,Western Australia,2474410,11,0,506,6
2020-04-11,Australia,NA,Western Australia,2474410,8,0,514,6
2020-04-12,Australia,NA,Western Australia,2474410,3,0,517,6
2020-04-13,Australia,NA,Western Australia,2474410,6,0,523,6
2020-04-14,Australia,NA,Western Australia,2474410,4,0,527,6
2020-04-15,Australia,NA,Western Australia,2474410,5,0,532,6
2020-04-16,Australia,NA,Western Australia,2474410,3,0,535,6
2020-04-17,Australia,NA,Western Australia,2474410,6,1,541,7
2020-04-18,Australia,NA,Western Australia,2474410,3,0,544,7
2020-04-19,Australia,NA,Western Australia,2474410,1,0,545,7
2020-04-20,Australia,NA,Western Australia,2474410,0,0,545,7
2020-04-21,Australia,NA,Western Australia,2474410,1,0,546,7
2020-04-22,Australia,NA,Western Australia,2474410,0,0,546,7
2020-04-23,Australia,NA,Western Australia,2474410,0,0,546,7
2020-04-24,Australia,NA,Western Australia,2474410,2,1,548,8
2020-04-25,Australia,NA,Western Australia,2474410,1,0,549,8
2020-04-26,Australia,NA,Western Australia,2474410,0,0,549,8
2020-04-27,Australia,NA,Western Australia,2474410,0,0,549,8
2020-04-28,Australia,NA,Western Australia,2474410,1,0,550,8
2020-04-29,Australia,NA,Western Australia,2474410,1,0,551,8
2020-04-30,Australia,NA,Western Australia,2474410,0,0,551,8
2020-05-01,Australia,NA,Western Australia,2474410,0,0,551,8
2020-05-02,Australia,NA,Western Australia,2474410,0,0,551,8
2020-05-03,Australia,NA,Western Australia,2474410,0,1,551,9
2020-05-04,Australia,NA,Western Australia,2474410,0,0,551,9
2020-05-05,Australia,NA,Western Australia,2474410,0,0,551,9
2020-05-06,Australia,NA,Western Australia,2474410,0,0,551,9
2020-05-07,Australia,NA,Western Australia,2474410,0,0,551,9
2020-05-08,Australia,NA,Western Australia,2474410,1,0,552,9
2020-05-09,Australia,NA,Western Australia,2474410,0,0,552,9
2020-05-10,Australia,NA,Western Australia,2474410,0,0,552,9
2020-05-11,Australia,NA,Western Australia,2474410,0,0,552,9
2020-05-12,Australia,NA,Western Australia,2474410,0,0,552,9
2020-05-13,Australia,NA,Western Australia,2474410,0,0,552,9
2020-05-14,Australia,NA,Western Australia,2474410,1,0,552,9
2020-05-15,Australia,NA,Western Australia,2474410,0,0,552,9
2020-05-16,Australia,NA,Western Australia,2474410,1,0,553,9
2020-05-17,Australia,NA,Western Australia,2474410,1,0,554,9
2020-05-18,Australia,NA,Western Australia,2474410,3,0,557,9
2020-05-19,Australia,NA,Western Australia,2474410,0,0,557,9
2020-05-20,Australia,NA,Western Australia,2474410,0,0,557,9
2020-05-21,Australia,NA,Western Australia,2474410,0,0,557,9
2020-05-22,Australia,NA,Western Australia,2474410,0,0,557,9
2020-05-23,Australia,NA,Western Australia,2474410,0,0,557,9
2020-05-24,Australia,NA,Western Australia,2474410,0,0,557,9
2020-05-25,Australia,NA,Western Australia,2474410,7,0,564,9
2020-05-26,Australia,NA,Western Australia,2474410,6,0,570,9
2020-05-27,Australia,NA,Western Australia,2474410,0,0,570,9
2020-05-28,Australia,NA,Western Australia,2474410,0,0,570,9
2020-05-29,Australia,NA,Western Australia,2474410,15,0,585,9
2020-05-30,Australia,NA,Western Australia,2474410,1,0,586,9
2020-05-31,Australia,NA,Western Australia,2474410,3,0,589,9
2020-06-01,Australia,NA,Western Australia,2474410,2,0,591,9
2020-06-02,Australia,NA,Western Australia,2474410,0,0,591,9
2020-06-03,Australia,NA,Western Australia,2474410,1,0,592,9
2020-06-04,Australia,NA,Western Australia,2474410,0,0,592,9
2020-06-05,Australia,NA,Western Australia,2474410,4,0,596,9
2020-06-06,Australia,NA,Western Australia,2474410,3,0,599,9
2020-06-07,Australia,NA,Western Australia,2474410,0,0,599,9
2020-06-08,Australia,NA,Western Australia,2474410,0,0,599,9
2020-06-09,Australia,NA,Western Australia,2474410,0,0,599,9
2020-06-10,Australia,NA,Western Australia,2474410,2,0,601,9
2020-06-11,Australia,NA,Western Australia,2474410,0,0,601,9
2020-06-12,Australia,NA,Western Australia,2474410,1,0,602,9
2020-06-13,Australia,NA,Western Australia,2474410,0,0,602,9
2020-06-14,Australia,NA,Western Australia,2474410,0,0,602,9
2020-06-15,Australia,NA,Western Australia,2474410,0,0,602,9
2020-06-16,Australia,NA,Western Australia,2474410,0,0,602,9
2020-06-17,Australia,NA,Western Australia,2474410,0,0,602,9
2020-06-18,Australia,NA,Western Australia,2474410,1,0,603,9
2020-06-19,Australia,NA,Western Australia,2474410,0,0,603,9
2020-06-20,Australia,NA,Western Australia,2474410,1,0,604,9
2020-06-21,Australia,NA,Western Australia,2474410,1,0,605,9
2020-06-22,Australia,NA,Western Australia,2474410,0,0,605,9
2020-06-23,Australia,NA,Western Australia,2474410,2,0,607,9
2020-06-24,Australia,NA,Western Australia,2474410,0,0,607,9
2020-06-25,Australia,NA,Western Australia,2474410,1,0,608,9
2020-06-26,Australia,NA,Western Australia,2474410,0,0,608,9
2020-06-27,Australia,NA,Western Australia,2474410,0,0,608,9
2020-06-28,Australia,NA,Western Australia,2474410,1,0,609,9
2020-06-29,Australia,NA,Western Australia,2474410,0,0,609,9
2020-06-30,Australia,NA,Western Australia,2474410,2,0,611,9
2020-07-01,Australia,NA,Western Australia,2474410,0,0,611,9
2020-07-02,Australia,NA,Western Australia,2474410,0,0,611,9
2020-07-03,Australia,NA,Western Australia,2474410,0,0,611,9
2020-07-04,Australia,NA,Western Australia,2474410,1,0,612,9
2020-07-05,Australia,NA,Western Australia,2474410,6,0,618,9
2020-07-06,Australia,NA,Western Australia,2474410,3,0,621,9
2020-07-07,Australia,NA,Western Australia,2474410,0,0,621,9
2020-07-08,Australia,NA,Western Australia,2474410,3,0,624,9
2020-07-09,Australia,NA,Western Australia,2474410,3,0,627,9
2020-07-10,Australia,NA,Western Australia,2474410,3,0,630,9
2020-07-11,Australia,NA,Western Australia,2474410,4,0,634,9
2020-07-12,Australia,NA,Western Australia,2474410,1,0,635,9
2020-07-13,Australia,NA,Western Australia,2474410,0,0,635,9
2020-07-14,Australia,NA,Western Australia,2474410,1,0,636,9
2020-07-15,Australia,NA,Western Australia,2474410,8,0,644,9
2020-07-16,Australia,NA,Western Australia,2474410,2,0,646,9
2020-07-17,Australia,NA,Western Australia,2474410,2,0,648,9
2020-07-18,Australia,NA,Western Australia,2474410,3,0,651,9
2020-07-19,Australia,NA,Western Australia,2474410,0,0,651,9
2020-07-20,Australia,NA,Western Australia,2474410,0,0,651,9
2020-07-21,Australia,NA,Western Australia,2474410,0,0,651,9
2020-07-22,Australia,NA,Western Australia,2474410,0,0,651,9
2020-07-23,Australia,NA,Western Australia,2474410,3,0,654,9
2020-07-24,Australia,NA,Western Australia,2474410,0,0,654,9
2020-07-25,Australia,NA,Western Australia,2474410,2,0,656,9
2020-07-26,Australia,NA,Western Australia,2474410,2,0,658,9
2020-07-27,Australia,NA,Western Australia,2474410,0,0,658,9
2020-07-28,Australia,NA,Western Australia,2474410,1,0,659,9
2020-07-29,Australia,NA,Western Australia,2474410,2,0,661,9
2020-07-30,Australia,NA,Western Australia,2474410,4,0,665,9
2020-07-31,Australia,NA,Western Australia,2474410,1,0,666,9
2020-08-01,Australia,NA,Western Australia,2474410,2,0,668,9
2020-08-02,Australia,NA,Western Australia,2474410,1,0,669,9
2020-08-03,Australia,NA,Western Australia,2474410,0,0,669,9
2020-08-04,Australia,NA,Western Australia,2474410,0,0,669,9
2020-08-05,Australia,NA,Western Australia,2474410,1,0,670,9
2020-08-06,Australia,NA,Western Australia,2474410,0,0,670,9
2020-08-07,Australia,NA,Western Australia,2474410,0,0,670,9
2020-08-08,Australia,NA,Western Australia,2474410,0,0,670,9
2020-08-09,Australia,NA,Western Australia,2474410,0,0,670,9
2020-08-10,Australia,NA,Western Australia,2474410,0,0,670,9
2020-08-11,Australia,NA,Western Australia,2474410,0,0,670,9
2020-08-12,Australia,NA,Western Australia,2474410,0,0,670,9
2020-08-13,Australia,NA,Western Australia,2474410,2,0,670,9
2020-08-14,Australia,NA,Western Australia,2474410,1,0,670,9
2020-08-15,Australia,NA,Western Australia,2474410,1,0,670,9
2020-08-16,Australia,NA,Western Australia,2474410,0,0,670,9
2020-08-17,Australia,NA,Western Australia,2474410,0,0,670,9
2020-08-18,Australia,NA,Western Australia,2474410,1,0,670,9
2020-08-19,Australia,NA,Western Australia,2474410,4,0,670,9
2020-08-20,Australia,NA,Western Australia,2474410,0,0,670,9
2020-08-21,Australia,NA,Western Australia,2474410,0,0,670,9
2020-08-22,Australia,NA,Western Australia,2474410,0,0,670,9
2020-08-23,Australia,NA,Western Australia,2474410,1,0,670,9
2020-08-24,Australia,NA,Western Australia,2474410,1,0,670,9
2020-08-25,Australia,NA,Western Australia,2474410,0,0,670,9
2020-08-26,Australia,NA,Western Australia,2474410,0,0,670,9
2020-08-27,Australia,NA,Western Australia,2474410,0,0,670,9
2020-08-28,Australia,NA,Western Australia,2474410,2,0,670,9
2020-08-29,Australia,NA,Western Australia,2474410,0,0,670,9
2020-08-30,Australia,NA,Western Australia,2474410,0,0,670,9
2020-08-31,Australia,NA,Western Australia,2474410,0,0,670,9
2020-09-01,Australia,NA,Western Australia,2474410,0,0,670,9
2020-09-02,Australia,NA,Western Australia,2474410,0,0,670,9
2020-09-03,Australia,NA,Western Australia,2474410,0,0,670,9
2020-09-04,Australia,NA,Western Australia,2474410,0,0,670,9
2020-09-05,Australia,NA,Western Australia,2474410,0,0,670,9
2020-09-06,Australia,NA,Western Australia,2474410,1,0,670,9
2020-09-07,Australia,NA,Western Australia,2474410,1,0,670,9
2020-09-08,Australia,NA,Western Australia,2474410,1,0,670,9
2020-09-09,Australia,NA,Western Australia,2474410,0,0,670,9
2020-09-10,Australia,NA,Western Australia,2474410,1,0,670,9
2020-09-11,Australia,NA,Western Australia,2474410,0,0,670,9
2020-09-12,Australia,NA,Western Australia,2474410,0,0,670,9
2020-09-13,Australia,NA,Western Australia,2474410,0,0,670,9
2020-09-14,Australia,NA,Western Australia,2474410,0,0,670,9
2020-09-15,Australia,NA,Western Australia,2474410,0,0,670,9
2020-09-16,Australia,NA,Western Australia,2474410,1,0,670,9
2020-09-17,Australia,NA,Western Australia,2474410,1,0,670,9
2020-09-18,Australia,NA,Western Australia,2474410,0,0,670,9
2020-09-19,Australia,NA,Western Australia,2474410,0,0,670,9
2020-09-20,Australia,NA,Western Australia,2474410,1,0,670,9
2020-09-21,Australia,NA,Western Australia,2474410,0,0,670,9
2020-09-22,Australia,NA,Western Australia,2474410,3,0,670,9
2020-03-04,Belgium,NA,Antwerp,1860470,6,0,13,0
2020-03-05,Belgium,NA,Antwerp,1860470,11,0,24,0
2020-03-06,Belgium,NA,Antwerp,1860470,11,0,35,0
2020-03-07,Belgium,NA,Antwerp,1860470,8,0,43,0
2020-03-08,Belgium,NA,Antwerp,1860470,9,0,52,0
2020-03-09,Belgium,NA,Antwerp,1860470,8,0,60,0
2020-03-10,Belgium,NA,Antwerp,1860470,14,0,74,0
2020-03-11,Belgium,NA,Antwerp,1860470,21,0,95,0
2020-03-12,Belgium,NA,Antwerp,1860470,33,0,128,0
2020-03-13,Belgium,NA,Antwerp,1860470,47,0,175,0
2020-03-14,Belgium,NA,Antwerp,1860470,21,0,196,0
2020-03-15,Belgium,NA,Antwerp,1860470,24,0,220,0
2020-03-16,Belgium,NA,Antwerp,1860470,46,0,266,0
2020-03-17,Belgium,NA,Antwerp,1860470,54,0,320,0
2020-03-18,Belgium,NA,Antwerp,1860470,55,0,375,0
2020-03-19,Belgium,NA,Antwerp,1860470,82,0,457,0
2020-03-20,Belgium,NA,Antwerp,1860470,67,0,524,0
2020-03-21,Belgium,NA,Antwerp,1860470,63,0,587,0
2020-03-22,Belgium,NA,Antwerp,1860470,55,0,642,0
2020-03-23,Belgium,NA,Antwerp,1860470,194,0,836,0
2020-03-24,Belgium,NA,Antwerp,1860470,172,0,1008,0
2020-03-25,Belgium,NA,Antwerp,1860470,171,0,1179,0
2020-03-26,Belgium,NA,Antwerp,1860470,183,0,1362,0
2020-03-27,Belgium,NA,Antwerp,1860470,190,0,1552,0
2020-03-28,Belgium,NA,Antwerp,1860470,100,0,1652,0
2020-03-29,Belgium,NA,Antwerp,1860470,102,0,1754,0
2020-03-30,Belgium,NA,Antwerp,1860470,231,0,1985,0
2020-03-31,Belgium,NA,Antwerp,1860470,175,0,2160,0
2020-04-01,Belgium,NA,Antwerp,1860470,178,0,2338,0
2020-04-02,Belgium,NA,Antwerp,1860470,166,0,2504,0
2020-04-03,Belgium,NA,Antwerp,1860470,186,0,2690,0
2020-04-04,Belgium,NA,Antwerp,1860470,108,0,2798,0
2020-04-05,Belgium,NA,Antwerp,1860470,79,0,2877,0
2020-04-06,Belgium,NA,Antwerp,1860470,247,0,3124,0
2020-04-07,Belgium,NA,Antwerp,1860470,179,0,3303,0
2020-04-08,Belgium,NA,Antwerp,1860470,216,0,3519,0
2020-04-09,Belgium,NA,Antwerp,1860470,302,0,3821,0
2020-04-10,Belgium,NA,Antwerp,1860470,264,0,4085,0
2020-04-11,Belgium,NA,Antwerp,1860470,93,0,4178,0
2020-04-12,Belgium,NA,Antwerp,1860470,86,0,4264,0
2020-04-13,Belgium,NA,Antwerp,1860470,65,0,4329,0
2020-04-14,Belgium,NA,Antwerp,1860470,143,0,4472,0
2020-04-15,Belgium,NA,Antwerp,1860470,175,0,4647,0
2020-04-16,Belgium,NA,Antwerp,1860470,211,0,4858,0
2020-04-17,Belgium,NA,Antwerp,1860470,110,0,4968,0
2020-04-18,Belgium,NA,Antwerp,1860470,63,0,5031,0
2020-04-19,Belgium,NA,Antwerp,1860470,51,0,5082,0
2020-04-20,Belgium,NA,Antwerp,1860470,167,0,5249,0
2020-04-21,Belgium,NA,Antwerp,1860470,184,0,5433,0
2020-04-22,Belgium,NA,Antwerp,1860470,102,0,5535,0
2020-04-23,Belgium,NA,Antwerp,1860470,132,0,5667,0
2020-04-24,Belgium,NA,Antwerp,1860470,84,0,5751,0
2020-04-25,Belgium,NA,Antwerp,1860470,38,0,5789,0
2020-04-26,Belgium,NA,Antwerp,1860470,39,0,5828,0
2020-04-27,Belgium,NA,Antwerp,1860470,152,0,5980,0
2020-04-28,Belgium,NA,Antwerp,1860470,124,0,6104,0
2020-04-29,Belgium,NA,Antwerp,1860470,121,0,6225,0
2020-04-30,Belgium,NA,Antwerp,1860470,173,0,6398,0
2020-05-01,Belgium,NA,Antwerp,1860470,71,0,6469,0
2020-05-02,Belgium,NA,Antwerp,1860470,54,0,6523,0
2020-05-03,Belgium,NA,Antwerp,1860470,39,0,6562,0
2020-05-04,Belgium,NA,Antwerp,1860470,168,0,6730,0
2020-05-05,Belgium,NA,Antwerp,1860470,139,0,6869,0
2020-05-06,Belgium,NA,Antwerp,1860470,153,0,7022,0
2020-05-07,Belgium,NA,Antwerp,1860470,94,0,7116,0
2020-05-08,Belgium,NA,Antwerp,1860470,61,0,7177,0
2020-05-09,Belgium,NA,Antwerp,1860470,41,0,7218,0
2020-05-10,Belgium,NA,Antwerp,1860470,28,0,7246,0
2020-05-11,Belgium,NA,Antwerp,1860470,85,0,7331,0
2020-05-12,Belgium,NA,Antwerp,1860470,88,0,7419,0
2020-05-13,Belgium,NA,Antwerp,1860470,56,0,7475,0
2020-05-14,Belgium,NA,Antwerp,1860470,48,0,7523,0
2020-05-15,Belgium,NA,Antwerp,1860470,69,0,7592,0
2020-05-16,Belgium,NA,Antwerp,1860470,21,0,7613,0
2020-05-17,Belgium,NA,Antwerp,1860470,17,0,7630,0
2020-05-18,Belgium,NA,Antwerp,1860470,72,0,7702,0
2020-05-19,Belgium,NA,Antwerp,1860470,36,0,7738,0
2020-05-20,Belgium,NA,Antwerp,1860470,87,0,7825,0
2020-05-21,Belgium,NA,Antwerp,1860470,10,0,7835,0
2020-05-22,Belgium,NA,Antwerp,1860470,49,0,7884,0
2020-05-23,Belgium,NA,Antwerp,1860470,17,0,7901,0
2020-05-24,Belgium,NA,Antwerp,1860470,17,0,7918,0
2020-05-25,Belgium,NA,Antwerp,1860470,50,0,7968,0
2020-05-26,Belgium,NA,Antwerp,1860470,34,0,8002,0
2020-05-27,Belgium,NA,Antwerp,1860470,28,0,8030,0
2020-05-28,Belgium,NA,Antwerp,1860470,35,0,8065,0
2020-05-29,Belgium,NA,Antwerp,1860470,29,0,8094,0
2020-05-30,Belgium,NA,Antwerp,1860470,8,0,8102,0
2020-05-31,Belgium,NA,Antwerp,1860470,7,0,8109,0
2020-06-01,Belgium,NA,Antwerp,1860470,9,0,8118,0
2020-06-02,Belgium,NA,Antwerp,1860470,25,0,8143,0
2020-06-03,Belgium,NA,Antwerp,1860470,30,0,8173,0
2020-06-04,Belgium,NA,Antwerp,1860470,29,0,8202,0
2020-06-05,Belgium,NA,Antwerp,1860470,21,0,8223,0
2020-06-06,Belgium,NA,Antwerp,1860470,10,0,8233,0
2020-06-07,Belgium,NA,Antwerp,1860470,5,0,8238,0
2020-06-08,Belgium,NA,Antwerp,1860470,23,0,8261,0
2020-06-09,Belgium,NA,Antwerp,1860470,20,0,8281,0
2020-06-10,Belgium,NA,Antwerp,1860470,14,0,8295,0
2020-06-11,Belgium,NA,Antwerp,1860470,12,0,8307,0
2020-06-12,Belgium,NA,Antwerp,1860470,15,0,8322,0
2020-06-13,Belgium,NA,Antwerp,1860470,6,0,8328,0
2020-06-14,Belgium,NA,Antwerp,1860470,7,0,8335,0
2020-06-15,Belgium,NA,Antwerp,1860470,31,0,8366,0
2020-06-16,Belgium,NA,Antwerp,1860470,16,0,8382,0
2020-06-17,Belgium,NA,Antwerp,1860470,33,0,8415,0
2020-06-18,Belgium,NA,Antwerp,1860470,13,0,8428,0
2020-06-19,Belgium,NA,Antwerp,1860470,21,0,8449,0
2020-06-20,Belgium,NA,Antwerp,1860470,9,0,8458,0
2020-06-21,Belgium,NA,Antwerp,1860470,3,0,8461,0
2020-06-22,Belgium,NA,Antwerp,1860470,26,0,8487,0
2020-06-23,Belgium,NA,Antwerp,1860470,14,0,8501,0
2020-06-24,Belgium,NA,Antwerp,1860470,20,0,8521,0
2020-06-25,Belgium,NA,Antwerp,1860470,21,0,8542,0
2020-06-26,Belgium,NA,Antwerp,1860470,16,0,8558,0
2020-06-27,Belgium,NA,Antwerp,1860470,4,0,8562,0
2020-06-28,Belgium,NA,Antwerp,1860470,8,0,8570,0
2020-06-29,Belgium,NA,Antwerp,1860470,31,0,8601,0
2020-06-30,Belgium,NA,Antwerp,1860470,14,0,8615,0
2020-07-01,Belgium,NA,Antwerp,1860470,38,0,8653,0
2020-07-02,Belgium,NA,Antwerp,1860470,21,0,8674,0
2020-07-03,Belgium,NA,Antwerp,1860470,27,0,8701,0
2020-07-04,Belgium,NA,Antwerp,1860470,12,0,8713,0
2020-07-05,Belgium,NA,Antwerp,1860470,4,0,8717,0
2020-07-06,Belgium,NA,Antwerp,1860470,33,0,8750,0
2020-07-07,Belgium,NA,Antwerp,1860470,23,0,8773,0
2020-07-08,Belgium,NA,Antwerp,1860470,41,0,8814,0
2020-07-09,Belgium,NA,Antwerp,1860470,20,0,8834,0
2020-07-10,Belgium,NA,Antwerp,1860470,38,0,8872,0
2020-07-11,Belgium,NA,Antwerp,1860470,9,0,8881,0
2020-07-12,Belgium,NA,Antwerp,1860470,8,0,8889,0
2020-07-13,Belgium,NA,Antwerp,1860470,89,0,8978,0
2020-07-14,Belgium,NA,Antwerp,1860470,47,0,9025,0
2020-07-15,Belgium,NA,Antwerp,1860470,77,0,9102,0
2020-07-16,Belgium,NA,Antwerp,1860470,82,0,9184,0
2020-07-17,Belgium,NA,Antwerp,1860470,122,0,9306,0
2020-07-18,Belgium,NA,Antwerp,1860470,54,0,9360,0
2020-07-19,Belgium,NA,Antwerp,1860470,29,0,9389,0
2020-07-20,Belgium,NA,Antwerp,1860470,200,0,9589,0
2020-07-21,Belgium,NA,Antwerp,1860470,54,0,9643,0
2020-07-22,Belgium,NA,Antwerp,1860470,272,0,9915,0
2020-07-23,Belgium,NA,Antwerp,1860470,219,0,10134,0
2020-07-24,Belgium,NA,Antwerp,1860470,256,0,10390,0
2020-07-25,Belgium,NA,Antwerp,1860470,80,0,10470,0
2020-07-26,Belgium,NA,Antwerp,1860470,96,0,10566,0
2020-07-27,Belgium,NA,Antwerp,1860470,307,0,10873,0
2020-07-28,Belgium,NA,Antwerp,1860470,235,0,11108,0
2020-07-29,Belgium,NA,Antwerp,1860470,230,0,11338,0
2020-07-30,Belgium,NA,Antwerp,1860470,232,0,11570,0
2020-07-31,Belgium,NA,Antwerp,1860470,269,0,11839,0
2020-08-01,Belgium,NA,Antwerp,1860470,113,0,11952,0
2020-08-02,Belgium,NA,Antwerp,1860470,47,0,11999,0
2020-08-03,Belgium,NA,Antwerp,1860470,287,0,12286,0
2020-08-04,Belgium,NA,Antwerp,1860470,272,0,12558,0
2020-08-05,Belgium,NA,Antwerp,1860470,233,0,12791,0
2020-08-06,Belgium,NA,Antwerp,1860470,245,0,13036,0
2020-08-07,Belgium,NA,Antwerp,1860470,266,0,13302,0
2020-08-08,Belgium,NA,Antwerp,1860470,86,0,13388,0
2020-08-09,Belgium,NA,Antwerp,1860470,33,0,13421,0
2020-08-10,Belgium,NA,Antwerp,1860470,248,0,13669,0
2020-08-11,Belgium,NA,Antwerp,1860470,191,0,13860,0
2020-08-12,Belgium,NA,Antwerp,1860470,141,0,14001,0
2020-08-13,Belgium,NA,Antwerp,1860470,156,0,14157,0
2020-08-14,Belgium,NA,Antwerp,1860470,149,0,14306,0
2020-08-15,Belgium,NA,Antwerp,1860470,42,0,14348,0
2020-08-16,Belgium,NA,Antwerp,1860470,40,0,14388,0
2020-08-17,Belgium,NA,Antwerp,1860470,156,0,14544,0
2020-08-18,Belgium,NA,Antwerp,1860470,136,0,14680,0
2020-08-19,Belgium,NA,Antwerp,1860470,127,0,14807,0
2020-08-20,Belgium,NA,Antwerp,1860470,140,0,14947,0
2020-08-21,Belgium,NA,Antwerp,1860470,102,0,15049,0
2020-08-22,Belgium,NA,Antwerp,1860470,44,0,15093,0
2020-08-23,Belgium,NA,Antwerp,1860470,27,0,15120,0
2020-08-24,Belgium,NA,Antwerp,1860470,159,0,15279,0
2020-08-25,Belgium,NA,Antwerp,1860470,98,0,15377,0
2020-08-26,Belgium,NA,Antwerp,1860470,98,0,15475,0
2020-08-27,Belgium,NA,Antwerp,1860470,81,0,15556,0
2020-08-28,Belgium,NA,Antwerp,1860470,82,0,15638,0
2020-08-29,Belgium,NA,Antwerp,1860470,42,0,15680,0
2020-08-30,Belgium,NA,Antwerp,1860470,36,0,15716,0
2020-08-31,Belgium,NA,Antwerp,1860470,138,0,15854,0
2020-09-01,Belgium,NA,Antwerp,1860470,92,0,15946,0
2020-09-02,Belgium,NA,Antwerp,1860470,102,0,16048,0
2020-09-03,Belgium,NA,Antwerp,1860470,151,0,16199,0
2020-09-04,Belgium,NA,Antwerp,1860470,144,0,16343,0
2020-09-05,Belgium,NA,Antwerp,1860470,44,0,16387,0
2020-09-06,Belgium,NA,Antwerp,1860470,35,0,16422,0
2020-09-07,Belgium,NA,Antwerp,1860470,182,0,16604,0
2020-09-08,Belgium,NA,Antwerp,1860470,166,0,16770,0
2020-09-09,Belgium,NA,Antwerp,1860470,166,0,16936,0
2020-09-10,Belgium,NA,Antwerp,1860470,228,0,17164,0
2020-09-11,Belgium,NA,Antwerp,1860470,235,0,17399,0
2020-09-12,Belgium,NA,Antwerp,1860470,114,0,17513,0
2020-09-13,Belgium,NA,Antwerp,1860470,50,0,17563,0
2020-09-14,Belgium,NA,Antwerp,1860470,298,0,17861,0
2020-09-15,Belgium,NA,Antwerp,1860470,247,0,18108,0
2020-09-16,Belgium,NA,Antwerp,1860470,318,0,18426,0
2020-09-17,Belgium,NA,Antwerp,1860470,352,0,18778,0
2020-09-18,Belgium,NA,Antwerp,1860470,289,0,19067,0
2020-09-19,Belgium,NA,Antwerp,1860470,179,0,19246,0
2020-09-20,Belgium,NA,Antwerp,1860470,116,0,19362,0
2020-09-21,Belgium,NA,Antwerp,1860470,365,0,19727,0
2020-09-22,Belgium,NA,Antwerp,1860470,188,0,19915,0
2020-09-23,Belgium,NA,Antwerp,1860470,78,0,19993,0
2020-03-03,Belgium,NA,Brussels,1215290,2,0,12,0
2020-03-04,Belgium,NA,Brussels,1215290,5,0,17,0
2020-03-05,Belgium,NA,Brussels,1215290,2,0,19,0
2020-03-06,Belgium,NA,Brussels,1215290,9,0,28,0
2020-03-07,Belgium,NA,Brussels,1215290,5,0,33,0
2020-03-08,Belgium,NA,Brussels,1215290,6,0,39,0
2020-03-09,Belgium,NA,Brussels,1215290,12,0,51,0
2020-03-10,Belgium,NA,Brussels,1215290,13,0,64,0
2020-03-11,Belgium,NA,Brussels,1215290,19,0,83,0
2020-03-12,Belgium,NA,Brussels,1215290,35,0,118,0
2020-03-13,Belgium,NA,Brussels,1215290,40,0,158,0
2020-03-14,Belgium,NA,Brussels,1215290,30,0,188,0
2020-03-15,Belgium,NA,Brussels,1215290,28,0,216,0
2020-03-16,Belgium,NA,Brussels,1215290,62,0,278,0
2020-03-17,Belgium,NA,Brussels,1215290,29,0,307,0
2020-03-18,Belgium,NA,Brussels,1215290,58,0,365,0
2020-03-19,Belgium,NA,Brussels,1215290,55,0,420,0
2020-03-20,Belgium,NA,Brussels,1215290,69,0,489,0
2020-03-21,Belgium,NA,Brussels,1215290,44,0,533,0
2020-03-22,Belgium,NA,Brussels,1215290,63,0,596,0
2020-03-23,Belgium,NA,Brussels,1215290,116,0,712,0
2020-03-24,Belgium,NA,Brussels,1215290,122,0,834,0
2020-03-25,Belgium,NA,Brussels,1215290,142,0,976,0
2020-03-26,Belgium,NA,Brussels,1215290,149,0,1125,0
2020-03-27,Belgium,NA,Brussels,1215290,185,0,1310,0
2020-03-28,Belgium,NA,Brussels,1215290,147,0,1457,0
2020-03-29,Belgium,NA,Brussels,1215290,93,0,1550,0
2020-03-30,Belgium,NA,Brussels,1215290,138,0,1688,0
2020-03-31,Belgium,NA,Brussels,1215290,178,0,1866,0
2020-04-01,Belgium,NA,Brussels,1215290,146,0,2012,0
2020-04-02,Belgium,NA,Brussels,1215290,155,0,2167,0
2020-04-03,Belgium,NA,Brussels,1215290,167,0,2334,0
2020-04-04,Belgium,NA,Brussels,1215290,102,0,2436,0
2020-04-05,Belgium,NA,Brussels,1215290,82,0,2518,0
2020-04-06,Belgium,NA,Brussels,1215290,169,0,2687,0
2020-04-07,Belgium,NA,Brussels,1215290,140,0,2827,0
2020-04-08,Belgium,NA,Brussels,1215290,174,0,3001,0
2020-04-09,Belgium,NA,Brussels,1215290,162,0,3163,0
2020-04-10,Belgium,NA,Brussels,1215290,141,0,3304,0
2020-04-11,Belgium,NA,Brussels,1215290,74,0,3378,0
2020-04-12,Belgium,NA,Brussels,1215290,60,0,3438,0
2020-04-13,Belgium,NA,Brussels,1215290,73,0,3511,0
2020-04-14,Belgium,NA,Brussels,1215290,182,0,3693,0
2020-04-15,Belgium,NA,Brussels,1215290,138,0,3831,0
2020-04-16,Belgium,NA,Brussels,1215290,191,0,4022,0
2020-04-17,Belgium,NA,Brussels,1215290,192,0,4214,0
2020-04-18,Belgium,NA,Brussels,1215290,47,0,4261,0
2020-04-19,Belgium,NA,Brussels,1215290,36,0,4297,0
2020-04-20,Belgium,NA,Brussels,1215290,151,0,4448,0
2020-04-21,Belgium,NA,Brussels,1215290,114,0,4562,0
2020-04-22,Belgium,NA,Brussels,1215290,64,0,4626,0
2020-04-23,Belgium,NA,Brussels,1215290,91,0,4717,0
2020-04-24,Belgium,NA,Brussels,1215290,164,0,4881,0
2020-04-25,Belgium,NA,Brussels,1215290,32,0,4913,0
2020-04-26,Belgium,NA,Brussels,1215290,13,0,4926,0
2020-04-27,Belgium,NA,Brussels,1215290,88,0,5014,0
2020-04-28,Belgium,NA,Brussels,1215290,41,0,5055,0
2020-04-29,Belgium,NA,Brussels,1215290,67,0,5122,0
2020-04-30,Belgium,NA,Brussels,1215290,62,0,5184,0
2020-05-01,Belgium,NA,Brussels,1215290,11,0,5195,0
2020-05-02,Belgium,NA,Brussels,1215290,18,0,5213,0
2020-05-03,Belgium,NA,Brussels,1215290,15,0,5228,0
2020-05-04,Belgium,NA,Brussels,1215290,61,0,5289,0
2020-05-05,Belgium,NA,Brussels,1215290,62,0,5351,0
2020-05-06,Belgium,NA,Brussels,1215290,48,0,5399,0
2020-05-07,Belgium,NA,Brussels,1215290,43,0,5442,0
2020-05-08,Belgium,NA,Brussels,1215290,33,0,5475,0
2020-05-09,Belgium,NA,Brussels,1215290,28,0,5503,0
2020-05-10,Belgium,NA,Brussels,1215290,12,0,5515,0
2020-05-11,Belgium,NA,Brussels,1215290,31,0,5546,0
2020-05-12,Belgium,NA,Brussels,1215290,31,0,5577,0
2020-05-13,Belgium,NA,Brussels,1215290,33,0,5610,0
2020-05-14,Belgium,NA,Brussels,1215290,41,0,5651,0
2020-05-15,Belgium,NA,Brussels,1215290,25,0,5676,0
2020-05-16,Belgium,NA,Brussels,1215290,19,0,5695,0
2020-05-17,Belgium,NA,Brussels,1215290,7,0,5702,0
2020-05-18,Belgium,NA,Brussels,1215290,32,0,5734,0
2020-05-19,Belgium,NA,Brussels,1215290,35,0,5769,0
2020-05-20,Belgium,NA,Brussels,1215290,31,0,5800,0
2020-05-21,Belgium,NA,Brussels,1215290,12,0,5812,0
2020-05-22,Belgium,NA,Brussels,1215290,27,0,5839,0
2020-05-23,Belgium,NA,Brussels,1215290,11,0,5850,0
2020-05-24,Belgium,NA,Brussels,1215290,7,0,5857,0
2020-05-25,Belgium,NA,Brussels,1215290,31,0,5888,0
2020-05-26,Belgium,NA,Brussels,1215290,18,0,5906,0
2020-05-27,Belgium,NA,Brussels,1215290,23,0,5929,0
2020-05-28,Belgium,NA,Brussels,1215290,10,0,5939,0
2020-05-29,Belgium,NA,Brussels,1215290,30,0,5969,0
2020-05-30,Belgium,NA,Brussels,1215290,7,0,5976,0
2020-05-31,Belgium,NA,Brussels,1215290,5,0,5981,0
2020-06-01,Belgium,NA,Brussels,1215290,7,0,5988,0
2020-06-02,Belgium,NA,Brussels,1215290,23,0,6011,0
2020-06-03,Belgium,NA,Brussels,1215290,23,0,6034,0
2020-06-04,Belgium,NA,Brussels,1215290,23,0,6057,0
2020-06-05,Belgium,NA,Brussels,1215290,24,0,6081,0
2020-06-06,Belgium,NA,Brussels,1215290,4,0,6085,0
2020-06-07,Belgium,NA,Brussels,1215290,5,0,6090,0
2020-06-08,Belgium,NA,Brussels,1215290,22,0,6112,0
2020-06-09,Belgium,NA,Brussels,1215290,25,0,6137,0
2020-06-10,Belgium,NA,Brussels,1215290,20,0,6157,0
2020-06-11,Belgium,NA,Brussels,1215290,15,0,6172,0
2020-06-12,Belgium,NA,Brussels,1215290,19,0,6191,0
2020-06-13,Belgium,NA,Brussels,1215290,6,0,6197,0
2020-06-14,Belgium,NA,Brussels,1215290,2,0,6199,0
2020-06-15,Belgium,NA,Brussels,1215290,18,0,6217,0
2020-06-16,Belgium,NA,Brussels,1215290,11,0,6228,0
2020-06-17,Belgium,NA,Brussels,1215290,7,0,6235,0
2020-06-18,Belgium,NA,Brussels,1215290,18,0,6253,0
2020-06-19,Belgium,NA,Brussels,1215290,19,0,6272,0
2020-06-20,Belgium,NA,Brussels,1215290,3,0,6275,0
2020-06-22,Belgium,NA,Brussels,1215290,17,0,6292,0
2020-06-23,Belgium,NA,Brussels,1215290,14,0,6306,0
2020-06-24,Belgium,NA,Brussels,1215290,8,0,6314,0
2020-06-25,Belgium,NA,Brussels,1215290,9,0,6323,0
2020-06-26,Belgium,NA,Brussels,1215290,23,0,6346,0
2020-06-27,Belgium,NA,Brussels,1215290,7,0,6353,0
2020-06-29,Belgium,NA,Brussels,1215290,29,0,6382,0
2020-06-30,Belgium,NA,Brussels,1215290,23,0,6405,0
2020-07-01,Belgium,NA,Brussels,1215290,22,0,6427,0
2020-07-02,Belgium,NA,Brussels,1215290,22,0,6449,0
2020-07-03,Belgium,NA,Brussels,1215290,10,0,6459,0
2020-07-04,Belgium,NA,Brussels,1215290,3,0,6462,0
2020-07-05,Belgium,NA,Brussels,1215290,1,0,6463,0
2020-07-06,Belgium,NA,Brussels,1215290,23,0,6486,0
2020-07-07,Belgium,NA,Brussels,1215290,8,0,6494,0
2020-07-08,Belgium,NA,Brussels,1215290,13,0,6507,0
2020-07-09,Belgium,NA,Brussels,1215290,28,0,6535,0
2020-07-10,Belgium,NA,Brussels,1215290,19,0,6554,0
2020-07-11,Belgium,NA,Brussels,1215290,2,0,6556,0
2020-07-12,Belgium,NA,Brussels,1215290,4,0,6560,0
2020-07-13,Belgium,NA,Brussels,1215290,27,0,6587,0
2020-07-14,Belgium,NA,Brussels,1215290,30,0,6617,0
2020-07-15,Belgium,NA,Brussels,1215290,25,0,6642,0
2020-07-16,Belgium,NA,Brussels,1215290,23,0,6665,0
2020-07-17,Belgium,NA,Brussels,1215290,18,0,6683,0
2020-07-18,Belgium,NA,Brussels,1215290,9,0,6692,0
2020-07-19,Belgium,NA,Brussels,1215290,2,0,6694,0
2020-07-20,Belgium,NA,Brussels,1215290,27,0,6721,0
2020-07-21,Belgium,NA,Brussels,1215290,9,0,6730,0
2020-07-22,Belgium,NA,Brussels,1215290,42,0,6772,0
2020-07-23,Belgium,NA,Brussels,1215290,43,0,6815,0
2020-07-24,Belgium,NA,Brussels,1215290,29,0,6844,0
2020-07-25,Belgium,NA,Brussels,1215290,18,0,6862,0
2020-07-26,Belgium,NA,Brussels,1215290,4,0,6866,0
2020-07-27,Belgium,NA,Brussels,1215290,48,0,6914,0
2020-07-28,Belgium,NA,Brussels,1215290,86,0,7000,0
2020-07-29,Belgium,NA,Brussels,1215290,96,0,7096,0
2020-07-30,Belgium,NA,Brussels,1215290,90,0,7186,0
2020-07-31,Belgium,NA,Brussels,1215290,68,0,7254,0
2020-08-01,Belgium,NA,Brussels,1215290,31,0,7285,0
2020-08-02,Belgium,NA,Brussels,1215290,20,0,7305,0
2020-08-03,Belgium,NA,Brussels,1215290,99,0,7404,0
2020-08-04,Belgium,NA,Brussels,1215290,137,0,7541,0
2020-08-05,Belgium,NA,Brussels,1215290,142,0,7683,0
2020-08-06,Belgium,NA,Brussels,1215290,104,0,7787,0
2020-08-07,Belgium,NA,Brussels,1215290,144,0,7931,0
2020-08-08,Belgium,NA,Brussels,1215290,61,0,7992,0
2020-08-09,Belgium,NA,Brussels,1215290,32,0,8024,0
2020-08-10,Belgium,NA,Brussels,1215290,174,0,8198,0
2020-08-11,Belgium,NA,Brussels,1215290,151,0,8349,0
2020-08-12,Belgium,NA,Brussels,1215290,157,0,8506,0
2020-08-13,Belgium,NA,Brussels,1215290,161,0,8667,0
2020-08-14,Belgium,NA,Brussels,1215290,137,0,8804,0
2020-08-15,Belgium,NA,Brussels,1215290,23,0,8827,0
2020-08-16,Belgium,NA,Brussels,1215290,20,0,8847,0
2020-08-17,Belgium,NA,Brussels,1215290,172,0,9019,0
2020-08-18,Belgium,NA,Brussels,1215290,219,0,9238,0
2020-08-19,Belgium,NA,Brussels,1215290,185,0,9423,0
2020-08-20,Belgium,NA,Brussels,1215290,142,0,9565,0
2020-08-21,Belgium,NA,Brussels,1215290,144,0,9709,0
2020-08-22,Belgium,NA,Brussels,1215290,46,0,9755,0
2020-08-23,Belgium,NA,Brussels,1215290,21,0,9776,0
2020-08-24,Belgium,NA,Brussels,1215290,141,0,9917,0
2020-08-25,Belgium,NA,Brussels,1215290,162,0,10079,0
2020-08-26,Belgium,NA,Brussels,1215290,147,0,10226,0
2020-08-27,Belgium,NA,Brussels,1215290,140,0,10366,0
2020-08-28,Belgium,NA,Brussels,1215290,165,0,10531,0
2020-08-29,Belgium,NA,Brussels,1215290,40,0,10571,0
2020-08-30,Belgium,NA,Brussels,1215290,27,0,10598,0
2020-08-31,Belgium,NA,Brussels,1215290,137,0,10735,0
2020-09-01,Belgium,NA,Brussels,1215290,162,0,10897,0
2020-09-02,Belgium,NA,Brussels,1215290,151,0,11048,0
2020-09-03,Belgium,NA,Brussels,1215290,193,0,11241,0
2020-09-04,Belgium,NA,Brussels,1215290,173,0,11414,0
2020-09-05,Belgium,NA,Brussels,1215290,97,0,11511,0
2020-09-06,Belgium,NA,Brussels,1215290,32,0,11543,0
2020-09-07,Belgium,NA,Brussels,1215290,188,0,11731,0
2020-09-08,Belgium,NA,Brussels,1215290,214,0,11945,0
2020-09-09,Belgium,NA,Brussels,1215290,234,0,12179,0
2020-09-10,Belgium,NA,Brussels,1215290,234,0,12413,0
2020-09-11,Belgium,NA,Brussels,1215290,290,0,12703,0
2020-09-12,Belgium,NA,Brussels,1215290,111,0,12814,0
2020-09-13,Belgium,NA,Brussels,1215290,58,0,12872,0
2020-09-14,Belgium,NA,Brussels,1215290,350,0,13222,0
2020-09-15,Belgium,NA,Brussels,1215290,362,0,13584,0
2020-09-16,Belgium,NA,Brussels,1215290,441,0,14025,0
2020-09-17,Belgium,NA,Brussels,1215290,429,0,14454,0
2020-09-18,Belgium,NA,Brussels,1215290,418,0,14872,0
2020-09-19,Belgium,NA,Brussels,1215290,138,0,15010,0
2020-09-20,Belgium,NA,Brussels,1215290,55,0,15065,0
2020-09-21,Belgium,NA,Brussels,1215290,372,0,15437,0
2020-09-22,Belgium,NA,Brussels,1215290,258,0,15695,0
2020-09-23,Belgium,NA,Brussels,1215290,40,0,15735,0
2020-03-05,Belgium,NA,East Flanders,1516283,9,0,17,0
2020-03-06,Belgium,NA,East Flanders,1516283,16,0,33,0
2020-03-07,Belgium,NA,East Flanders,1516283,1,0,34,0
2020-03-08,Belgium,NA,East Flanders,1516283,5,0,39,0
2020-03-09,Belgium,NA,East Flanders,1516283,6,0,45,0
2020-03-10,Belgium,NA,East Flanders,1516283,16,0,61,0
2020-03-11,Belgium,NA,East Flanders,1516283,25,0,86,0
2020-03-12,Belgium,NA,East Flanders,1516283,31,0,117,0
2020-03-13,Belgium,NA,East Flanders,1516283,29,0,146,0
2020-03-14,Belgium,NA,East Flanders,1516283,13,0,159,0
2020-03-15,Belgium,NA,East Flanders,1516283,19,0,178,0
2020-03-16,Belgium,NA,East Flanders,1516283,36,0,214,0
2020-03-17,Belgium,NA,East Flanders,1516283,39,0,253,0
2020-03-18,Belgium,NA,East Flanders,1516283,53,0,306,0
2020-03-19,Belgium,NA,East Flanders,1516283,59,0,365,0
2020-03-20,Belgium,NA,East Flanders,1516283,74,0,439,0
2020-03-21,Belgium,NA,East Flanders,1516283,39,0,478,0
2020-03-22,Belgium,NA,East Flanders,1516283,44,0,522,0
2020-03-23,Belgium,NA,East Flanders,1516283,144,0,666,0
2020-03-24,Belgium,NA,East Flanders,1516283,155,0,821,0
2020-03-25,Belgium,NA,East Flanders,1516283,145,0,966,0
2020-03-26,Belgium,NA,East Flanders,1516283,163,0,1129,0
2020-03-27,Belgium,NA,East Flanders,1516283,221,0,1350,0
2020-03-28,Belgium,NA,East Flanders,1516283,109,0,1459,0
2020-03-29,Belgium,NA,East Flanders,1516283,70,0,1529,0
2020-03-30,Belgium,NA,East Flanders,1516283,218,0,1747,0
2020-03-31,Belgium,NA,East Flanders,1516283,218,0,1965,0
2020-04-01,Belgium,NA,East Flanders,1516283,174,0,2139,0
2020-04-02,Belgium,NA,East Flanders,1516283,153,0,2292,0
2020-04-03,Belgium,NA,East Flanders,1516283,194,0,2486,0
2020-04-04,Belgium,NA,East Flanders,1516283,131,0,2617,0
2020-04-05,Belgium,NA,East Flanders,1516283,110,0,2727,0
2020-04-06,Belgium,NA,East Flanders,1516283,213,0,2940,0
2020-04-07,Belgium,NA,East Flanders,1516283,146,0,3086,0
2020-04-08,Belgium,NA,East Flanders,1516283,169,0,3255,0
2020-04-09,Belgium,NA,East Flanders,1516283,363,0,3618,0
2020-04-10,Belgium,NA,East Flanders,1516283,401,0,4019,0
2020-04-11,Belgium,NA,East Flanders,1516283,94,0,4113,0
2020-04-12,Belgium,NA,East Flanders,1516283,42,0,4155,0
2020-04-13,Belgium,NA,East Flanders,1516283,64,0,4219,0
2020-04-14,Belgium,NA,East Flanders,1516283,138,0,4357,0
2020-04-15,Belgium,NA,East Flanders,1516283,157,0,4514,0
2020-04-16,Belgium,NA,East Flanders,1516283,240,0,4754,0
2020-04-17,Belgium,NA,East Flanders,1516283,171,0,4925,0
2020-04-18,Belgium,NA,East Flanders,1516283,41,0,4966,0
2020-04-19,Belgium,NA,East Flanders,1516283,25,0,4991,0
2020-04-20,Belgium,NA,East Flanders,1516283,117,0,5108,0
2020-04-21,Belgium,NA,East Flanders,1516283,81,0,5189,0
2020-04-22,Belgium,NA,East Flanders,1516283,77,0,5266,0
2020-04-23,Belgium,NA,East Flanders,1516283,80,0,5346,0
2020-04-24,Belgium,NA,East Flanders,1516283,84,0,5430,0
2020-04-25,Belgium,NA,East Flanders,1516283,40,0,5470,0
2020-04-26,Belgium,NA,East Flanders,1516283,13,0,5483,0
2020-04-27,Belgium,NA,East Flanders,1516283,95,0,5578,0
2020-04-28,Belgium,NA,East Flanders,1516283,85,0,5663,0
2020-04-29,Belgium,NA,East Flanders,1516283,51,0,5714,0
2020-04-30,Belgium,NA,East Flanders,1516283,48,0,5762,0
2020-05-01,Belgium,NA,East Flanders,1516283,20,0,5782,0
2020-05-02,Belgium,NA,East Flanders,1516283,25,0,5807,0
2020-05-03,Belgium,NA,East Flanders,1516283,9,0,5816,0
2020-05-04,Belgium,NA,East Flanders,1516283,60,0,5876,0
2020-05-05,Belgium,NA,East Flanders,1516283,61,0,5937,0
2020-05-06,Belgium,NA,East Flanders,1516283,57,0,5994,0
2020-05-07,Belgium,NA,East Flanders,1516283,35,0,6029,0
2020-05-08,Belgium,NA,East Flanders,1516283,45,0,6074,0
2020-05-09,Belgium,NA,East Flanders,1516283,22,0,6096,0
2020-05-10,Belgium,NA,East Flanders,1516283,3,0,6099,0
2020-05-11,Belgium,NA,East Flanders,1516283,53,0,6152,0
2020-05-12,Belgium,NA,East Flanders,1516283,37,0,6189,0
2020-05-13,Belgium,NA,East Flanders,1516283,19,0,6208,0
2020-05-14,Belgium,NA,East Flanders,1516283,28,0,6236,0
2020-05-15,Belgium,NA,East Flanders,1516283,30,0,6266,0
2020-05-16,Belgium,NA,East Flanders,1516283,23,0,6289,0
2020-05-17,Belgium,NA,East Flanders,1516283,6,0,6295,0
2020-05-18,Belgium,NA,East Flanders,1516283,41,0,6336,0
2020-05-19,Belgium,NA,East Flanders,1516283,42,0,6378,0
2020-05-20,Belgium,NA,East Flanders,1516283,39,0,6417,0
2020-05-21,Belgium,NA,East Flanders,1516283,7,0,6424,0
2020-05-22,Belgium,NA,East Flanders,1516283,32,0,6456,0
2020-05-23,Belgium,NA,East Flanders,1516283,27,0,6483,0
2020-05-24,Belgium,NA,East Flanders,1516283,7,0,6490,0
2020-05-25,Belgium,NA,East Flanders,1516283,55,0,6545,0
2020-05-26,Belgium,NA,East Flanders,1516283,32,0,6577,0
2020-05-27,Belgium,NA,East Flanders,1516283,14,0,6591,0
2020-05-28,Belgium,NA,East Flanders,1516283,21,0,6612,0
2020-05-29,Belgium,NA,East Flanders,1516283,8,0,6620,0
2020-05-30,Belgium,NA,East Flanders,1516283,10,0,6630,0
2020-05-31,Belgium,NA,East Flanders,1516283,3,0,6633,0
2020-06-01,Belgium,NA,East Flanders,1516283,12,0,6645,0
2020-06-02,Belgium,NA,East Flanders,1516283,21,0,6666,0
2020-06-03,Belgium,NA,East Flanders,1516283,13,0,6679,0
2020-06-04,Belgium,NA,East Flanders,1516283,18,0,6697,0
2020-06-05,Belgium,NA,East Flanders,1516283,12,0,6709,0
2020-06-06,Belgium,NA,East Flanders,1516283,7,0,6716,0
2020-06-07,Belgium,NA,East Flanders,1516283,6,0,6722,0
2020-06-08,Belgium,NA,East Flanders,1516283,12,0,6734,0
2020-06-09,Belgium,NA,East Flanders,1516283,12,0,6746,0
2020-06-10,Belgium,NA,East Flanders,1516283,9,0,6755,0
2020-06-11,Belgium,NA,East Flanders,1516283,11,0,6766,0
2020-06-12,Belgium,NA,East Flanders,1516283,6,0,6772,0
2020-06-13,Belgium,NA,East Flanders,1516283,3,0,6775,0
2020-06-14,Belgium,NA,East Flanders,1516283,1,0,6776,0
2020-06-15,Belgium,NA,East Flanders,1516283,12,0,6788,0
2020-06-16,Belgium,NA,East Flanders,1516283,6,0,6794,0
2020-06-17,Belgium,NA,East Flanders,1516283,9,0,6803,0
2020-06-18,Belgium,NA,East Flanders,1516283,6,0,6809,0
2020-06-19,Belgium,NA,East Flanders,1516283,11,0,6820,0
2020-06-20,Belgium,NA,East Flanders,1516283,2,0,6822,0
2020-06-21,Belgium,NA,East Flanders,1516283,1,0,6823,0
2020-06-22,Belgium,NA,East Flanders,1516283,5,0,6828,0
2020-06-23,Belgium,NA,East Flanders,1516283,8,0,6836,0
2020-06-24,Belgium,NA,East Flanders,1516283,6,0,6842,0
2020-06-25,Belgium,NA,East Flanders,1516283,8,0,6850,0
2020-06-26,Belgium,NA,East Flanders,1516283,9,0,6859,0
2020-06-27,Belgium,NA,East Flanders,1516283,6,0,6865,0
2020-06-28,Belgium,NA,East Flanders,1516283,2,0,6867,0
2020-06-29,Belgium,NA,East Flanders,1516283,6,0,6873,0
2020-06-30,Belgium,NA,East Flanders,1516283,9,0,6882,0
2020-07-01,Belgium,NA,East Flanders,1516283,12,0,6894,0
2020-07-02,Belgium,NA,East Flanders,1516283,7,0,6901,0
2020-07-03,Belgium,NA,East Flanders,1516283,12,0,6913,0
2020-07-04,Belgium,NA,East Flanders,1516283,3,0,6916,0
2020-07-05,Belgium,NA,East Flanders,1516283,2,0,6918,0
2020-07-06,Belgium,NA,East Flanders,1516283,6,0,6924,0
2020-07-07,Belgium,NA,East Flanders,1516283,11,0,6935,0
2020-07-08,Belgium,NA,East Flanders,1516283,10,0,6945,0
2020-07-09,Belgium,NA,East Flanders,1516283,10,0,6955,0
2020-07-10,Belgium,NA,East Flanders,1516283,7,0,6962,0
2020-07-11,Belgium,NA,East Flanders,1516283,2,0,6964,0
2020-07-12,Belgium,NA,East Flanders,1516283,4,0,6968,0
2020-07-13,Belgium,NA,East Flanders,1516283,10,0,6978,0
2020-07-14,Belgium,NA,East Flanders,1516283,19,0,6997,0
2020-07-15,Belgium,NA,East Flanders,1516283,16,0,7013,0
2020-07-16,Belgium,NA,East Flanders,1516283,14,0,7027,0
2020-07-17,Belgium,NA,East Flanders,1516283,5,0,7032,0
2020-07-18,Belgium,NA,East Flanders,1516283,7,0,7039,0
2020-07-19,Belgium,NA,East Flanders,1516283,7,0,7046,0
2020-07-20,Belgium,NA,East Flanders,1516283,41,0,7087,0
2020-07-21,Belgium,NA,East Flanders,1516283,11,0,7098,0
2020-07-22,Belgium,NA,East Flanders,1516283,29,0,7127,0
2020-07-23,Belgium,NA,East Flanders,1516283,33,0,7160,0
2020-07-24,Belgium,NA,East Flanders,1516283,41,0,7201,0
2020-07-25,Belgium,NA,East Flanders,1516283,19,0,7220,0
2020-07-26,Belgium,NA,East Flanders,1516283,24,0,7244,0
2020-07-27,Belgium,NA,East Flanders,1516283,47,0,7291,0
2020-07-28,Belgium,NA,East Flanders,1516283,57,0,7348,0
2020-07-29,Belgium,NA,East Flanders,1516283,59,0,7407,0
2020-07-30,Belgium,NA,East Flanders,1516283,47,0,7454,0
2020-07-31,Belgium,NA,East Flanders,1516283,55,0,7509,0
2020-08-01,Belgium,NA,East Flanders,1516283,28,0,7537,0
2020-08-02,Belgium,NA,East Flanders,1516283,19,0,7556,0
2020-08-03,Belgium,NA,East Flanders,1516283,73,0,7629,0
2020-08-04,Belgium,NA,East Flanders,1516283,46,0,7675,0
2020-08-05,Belgium,NA,East Flanders,1516283,71,0,7746,0
2020-08-06,Belgium,NA,East Flanders,1516283,91,0,7837,0
2020-08-07,Belgium,NA,East Flanders,1516283,56,0,7893,0
2020-08-08,Belgium,NA,East Flanders,1516283,32,0,7925,0
2020-08-09,Belgium,NA,East Flanders,1516283,7,0,7932,0
2020-08-10,Belgium,NA,East Flanders,1516283,60,0,7992,0
2020-08-11,Belgium,NA,East Flanders,1516283,55,0,8047,0
2020-08-12,Belgium,NA,East Flanders,1516283,51,0,8098,0
2020-08-13,Belgium,NA,East Flanders,1516283,77,0,8175,0
2020-08-14,Belgium,NA,East Flanders,1516283,60,0,8235,0
2020-08-15,Belgium,NA,East Flanders,1516283,8,0,8243,0
2020-08-16,Belgium,NA,East Flanders,1516283,11,0,8254,0
2020-08-17,Belgium,NA,East Flanders,1516283,67,0,8321,0
2020-08-18,Belgium,NA,East Flanders,1516283,58,0,8379,0
2020-08-19,Belgium,NA,East Flanders,1516283,54,0,8433,0
2020-08-20,Belgium,NA,East Flanders,1516283,44,0,8477,0
2020-08-21,Belgium,NA,East Flanders,1516283,39,0,8516,0
2020-08-22,Belgium,NA,East Flanders,1516283,16,0,8532,0
2020-08-23,Belgium,NA,East Flanders,1516283,7,0,8539,0
2020-08-24,Belgium,NA,East Flanders,1516283,50,0,8589,0
2020-08-25,Belgium,NA,East Flanders,1516283,48,0,8637,0
2020-08-26,Belgium,NA,East Flanders,1516283,32,0,8669,0
2020-08-27,Belgium,NA,East Flanders,1516283,39,0,8708,0
2020-08-28,Belgium,NA,East Flanders,1516283,52,0,8760,0
2020-08-29,Belgium,NA,East Flanders,1516283,13,0,8773,0
2020-08-30,Belgium,NA,East Flanders,1516283,14,0,8787,0
2020-08-31,Belgium,NA,East Flanders,1516283,60,0,8847,0
2020-09-01,Belgium,NA,East Flanders,1516283,37,0,8884,0
2020-09-02,Belgium,NA,East Flanders,1516283,56,0,8940,0
2020-09-03,Belgium,NA,East Flanders,1516283,52,0,8992,0
2020-09-04,Belgium,NA,East Flanders,1516283,75,0,9067,0
2020-09-05,Belgium,NA,East Flanders,1516283,27,0,9094,0
2020-09-06,Belgium,NA,East Flanders,1516283,13,0,9107,0
2020-09-07,Belgium,NA,East Flanders,1516283,109,0,9216,0
2020-09-08,Belgium,NA,East Flanders,1516283,82,0,9298,0
2020-09-09,Belgium,NA,East Flanders,1516283,96,0,9394,0
2020-09-10,Belgium,NA,East Flanders,1516283,119,0,9513,0
2020-09-11,Belgium,NA,East Flanders,1516283,139,0,9652,0
2020-09-12,Belgium,NA,East Flanders,1516283,45,0,9697,0
2020-09-13,Belgium,NA,East Flanders,1516283,28,0,9725,0
2020-09-14,Belgium,NA,East Flanders,1516283,173,0,9898,0
2020-09-15,Belgium,NA,East Flanders,1516283,127,0,10025,0
2020-09-16,Belgium,NA,East Flanders,1516283,167,0,10192,0
2020-09-17,Belgium,NA,East Flanders,1516283,109,0,10301,0
2020-09-18,Belgium,NA,East Flanders,1516283,157,0,10458,0
2020-09-19,Belgium,NA,East Flanders,1516283,69,0,10527,0
2020-09-20,Belgium,NA,East Flanders,1516283,39,0,10566,0
2020-09-21,Belgium,NA,East Flanders,1516283,161,0,10727,0
2020-09-22,Belgium,NA,East Flanders,1516283,105,0,10832,0
2020-09-23,Belgium,NA,East Flanders,1516283,28,0,10860,0
2020-03-02,Belgium,NA,Flemish Brabant,1146643,8,0,15,0
2020-03-03,Belgium,NA,Flemish Brabant,1146643,6,0,21,0
2020-03-04,Belgium,NA,Flemish Brabant,1146643,11,0,32,0
2020-03-05,Belgium,NA,Flemish Brabant,1146643,17,0,49,0
2020-03-06,Belgium,NA,Flemish Brabant,1146643,17,0,66,0
2020-03-08,Belgium,NA,Flemish Brabant,1146643,6,0,72,0
2020-03-09,Belgium,NA,Flemish Brabant,1146643,14,0,86,0
2020-03-10,Belgium,NA,Flemish Brabant,1146643,12,0,98,0
2020-03-11,Belgium,NA,Flemish Brabant,1146643,27,0,125,0
2020-03-12,Belgium,NA,Flemish Brabant,1146643,31,0,156,0
2020-03-13,Belgium,NA,Flemish Brabant,1146643,37,0,193,0
2020-03-14,Belgium,NA,Flemish Brabant,1146643,12,0,205,0
2020-03-15,Belgium,NA,Flemish Brabant,1146643,27,0,232,0
2020-03-16,Belgium,NA,Flemish Brabant,1146643,43,0,275,0
2020-03-17,Belgium,NA,Flemish Brabant,1146643,41,0,316,0
2020-03-18,Belgium,NA,Flemish Brabant,1146643,61,0,377,0
2020-03-19,Belgium,NA,Flemish Brabant,1146643,70,0,447,0
2020-03-20,Belgium,NA,Flemish Brabant,1146643,77,0,524,0
2020-03-21,Belgium,NA,Flemish Brabant,1146643,47,0,571,0
2020-03-22,Belgium,NA,Flemish Brabant,1146643,43,0,614,0
2020-03-23,Belgium,NA,Flemish Brabant,1146643,132,0,746,0
2020-03-24,Belgium,NA,Flemish Brabant,1146643,105,0,851,0
2020-03-25,Belgium,NA,Flemish Brabant,1146643,128,0,979,0
2020-03-26,Belgium,NA,Flemish Brabant,1146643,140,0,1119,0
2020-03-27,Belgium,NA,Flemish Brabant,1146643,161,0,1280,0
2020-03-28,Belgium,NA,Flemish Brabant,1146643,96,0,1376,0
2020-03-29,Belgium,NA,Flemish Brabant,1146643,58,0,1434,0
2020-03-30,Belgium,NA,Flemish Brabant,1146643,149,0,1583,0
2020-03-31,Belgium,NA,Flemish Brabant,1146643,154,0,1737,0
2020-04-01,Belgium,NA,Flemish Brabant,1146643,152,0,1889,0
2020-04-02,Belgium,NA,Flemish Brabant,1146643,140,0,2029,0
2020-04-03,Belgium,NA,Flemish Brabant,1146643,170,0,2199,0
2020-04-04,Belgium,NA,Flemish Brabant,1146643,132,0,2331,0
2020-04-05,Belgium,NA,Flemish Brabant,1146643,45,0,2376,0
2020-04-06,Belgium,NA,Flemish Brabant,1146643,196,0,2572,0
2020-04-07,Belgium,NA,Flemish Brabant,1146643,131,0,2703,0
2020-04-08,Belgium,NA,Flemish Brabant,1146643,146,0,2849,0
2020-04-09,Belgium,NA,Flemish Brabant,1146643,173,0,3022,0
2020-04-10,Belgium,NA,Flemish Brabant,1146643,227,0,3249,0
2020-04-11,Belgium,NA,Flemish Brabant,1146643,192,0,3441,0
2020-04-12,Belgium,NA,Flemish Brabant,1146643,60,0,3501,0
2020-04-13,Belgium,NA,Flemish Brabant,1146643,86,0,3587,0
2020-04-14,Belgium,NA,Flemish Brabant,1146643,95,0,3682,0
2020-04-15,Belgium,NA,Flemish Brabant,1146643,110,0,3792,0
2020-04-16,Belgium,NA,Flemish Brabant,1146643,128,0,3920,0
2020-04-17,Belgium,NA,Flemish Brabant,1146643,116,0,4036,0
2020-04-18,Belgium,NA,Flemish Brabant,1146643,32,0,4068,0
2020-04-19,Belgium,NA,Flemish Brabant,1146643,23,0,4091,0
2020-04-20,Belgium,NA,Flemish Brabant,1146643,57,0,4148,0
2020-04-21,Belgium,NA,Flemish Brabant,1146643,105,0,4253,0
2020-04-22,Belgium,NA,Flemish Brabant,1146643,105,0,4358,0
2020-04-23,Belgium,NA,Flemish Brabant,1146643,61,0,4419,0
2020-04-24,Belgium,NA,Flemish Brabant,1146643,105,0,4524,0
2020-04-25,Belgium,NA,Flemish Brabant,1146643,20,0,4544,0
2020-04-26,Belgium,NA,Flemish Brabant,1146643,18,0,4562,0
2020-04-27,Belgium,NA,Flemish Brabant,1146643,73,0,4635,0
2020-04-28,Belgium,NA,Flemish Brabant,1146643,55,0,4690,0
2020-04-29,Belgium,NA,Flemish Brabant,1146643,30,0,4720,0
2020-04-30,Belgium,NA,Flemish Brabant,1146643,39,0,4759,0
2020-05-01,Belgium,NA,Flemish Brabant,1146643,20,0,4779,0
2020-05-02,Belgium,NA,Flemish Brabant,1146643,35,0,4814,0
2020-05-03,Belgium,NA,Flemish Brabant,1146643,13,0,4827,0
2020-05-04,Belgium,NA,Flemish Brabant,1146643,49,0,4876,0
2020-05-05,Belgium,NA,Flemish Brabant,1146643,37,0,4913,0
2020-05-06,Belgium,NA,Flemish Brabant,1146643,43,0,4956,0
2020-05-07,Belgium,NA,Flemish Brabant,1146643,19,0,4975,0
2020-05-08,Belgium,NA,Flemish Brabant,1146643,30,0,5005,0
2020-05-09,Belgium,NA,Flemish Brabant,1146643,11,0,5016,0
2020-05-10,Belgium,NA,Flemish Brabant,1146643,7,0,5023,0
2020-05-11,Belgium,NA,Flemish Brabant,1146643,34,0,5057,0
2020-05-12,Belgium,NA,Flemish Brabant,1146643,27,0,5084,0
2020-05-13,Belgium,NA,Flemish Brabant,1146643,25,0,5109,0
2020-05-14,Belgium,NA,Flemish Brabant,1146643,16,0,5125,0
2020-05-15,Belgium,NA,Flemish Brabant,1146643,12,0,5137,0
2020-05-16,Belgium,NA,Flemish Brabant,1146643,11,0,5148,0
2020-05-17,Belgium,NA,Flemish Brabant,1146643,7,0,5155,0
2020-05-18,Belgium,NA,Flemish Brabant,1146643,20,0,5175,0
2020-05-19,Belgium,NA,Flemish Brabant,1146643,16,0,5191,0
2020-05-20,Belgium,NA,Flemish Brabant,1146643,17,0,5208,0
2020-05-21,Belgium,NA,Flemish Brabant,1146643,3,0,5211,0
2020-05-22,Belgium,NA,Flemish Brabant,1146643,17,0,5228,0
2020-05-23,Belgium,NA,Flemish Brabant,1146643,5,0,5233,0
2020-05-24,Belgium,NA,Flemish Brabant,1146643,4,0,5237,0
2020-05-25,Belgium,NA,Flemish Brabant,1146643,14,0,5251,0
2020-05-26,Belgium,NA,Flemish Brabant,1146643,15,0,5266,0
2020-05-27,Belgium,NA,Flemish Brabant,1146643,15,0,5281,0
2020-05-28,Belgium,NA,Flemish Brabant,1146643,6,0,5287,0
2020-05-29,Belgium,NA,Flemish Brabant,1146643,11,0,5298,0
2020-05-30,Belgium,NA,Flemish Brabant,1146643,7,0,5305,0
2020-05-31,Belgium,NA,Flemish Brabant,1146643,2,0,5307,0
2020-06-01,Belgium,NA,Flemish Brabant,1146643,3,0,5310,0
2020-06-02,Belgium,NA,Flemish Brabant,1146643,12,0,5322,0
2020-06-03,Belgium,NA,Flemish Brabant,1146643,14,0,5336,0
2020-06-04,Belgium,NA,Flemish Brabant,1146643,15,0,5351,0
2020-06-05,Belgium,NA,Flemish Brabant,1146643,14,0,5365,0
2020-06-06,Belgium,NA,Flemish Brabant,1146643,6,0,5371,0
2020-06-07,Belgium,NA,Flemish Brabant,1146643,4,0,5375,0
2020-06-08,Belgium,NA,Flemish Brabant,1146643,20,0,5395,0
2020-06-09,Belgium,NA,Flemish Brabant,1146643,12,0,5407,0
2020-06-10,Belgium,NA,Flemish Brabant,1146643,14,0,5421,0
2020-06-11,Belgium,NA,Flemish Brabant,1146643,6,0,5427,0
2020-06-12,Belgium,NA,Flemish Brabant,1146643,7,0,5434,0
2020-06-13,Belgium,NA,Flemish Brabant,1146643,3,0,5437,0
2020-06-14,Belgium,NA,Flemish Brabant,1146643,2,0,5439,0
2020-06-15,Belgium,NA,Flemish Brabant,1146643,9,0,5448,0
2020-06-16,Belgium,NA,Flemish Brabant,1146643,8,0,5456,0
2020-06-17,Belgium,NA,Flemish Brabant,1146643,10,0,5466,0
2020-06-18,Belgium,NA,Flemish Brabant,1146643,8,0,5474,0
2020-06-19,Belgium,NA,Flemish Brabant,1146643,5,0,5479,0
2020-06-20,Belgium,NA,Flemish Brabant,1146643,1,0,5480,0
2020-06-21,Belgium,NA,Flemish Brabant,1146643,2,0,5482,0
2020-06-22,Belgium,NA,Flemish Brabant,1146643,6,0,5488,0
2020-06-23,Belgium,NA,Flemish Brabant,1146643,4,0,5492,0
2020-06-24,Belgium,NA,Flemish Brabant,1146643,5,0,5497,0
2020-06-25,Belgium,NA,Flemish Brabant,1146643,9,0,5506,0
2020-06-26,Belgium,NA,Flemish Brabant,1146643,5,0,5511,0
2020-06-27,Belgium,NA,Flemish Brabant,1146643,3,0,5514,0
2020-06-28,Belgium,NA,Flemish Brabant,1146643,1,0,5515,0
2020-06-29,Belgium,NA,Flemish Brabant,1146643,8,0,5523,0
2020-06-30,Belgium,NA,Flemish Brabant,1146643,5,0,5528,0
2020-07-01,Belgium,NA,Flemish Brabant,1146643,7,0,5535,0
2020-07-02,Belgium,NA,Flemish Brabant,1146643,13,0,5548,0
2020-07-03,Belgium,NA,Flemish Brabant,1146643,2,0,5550,0
2020-07-04,Belgium,NA,Flemish Brabant,1146643,3,0,5553,0
2020-07-06,Belgium,NA,Flemish Brabant,1146643,9,0,5562,0
2020-07-07,Belgium,NA,Flemish Brabant,1146643,8,0,5570,0
2020-07-08,Belgium,NA,Flemish Brabant,1146643,9,0,5579,0
2020-07-09,Belgium,NA,Flemish Brabant,1146643,7,0,5586,0
2020-07-10,Belgium,NA,Flemish Brabant,1146643,10,0,5596,0
2020-07-11,Belgium,NA,Flemish Brabant,1146643,5,0,5601,0
2020-07-12,Belgium,NA,Flemish Brabant,1146643,3,0,5604,0
2020-07-13,Belgium,NA,Flemish Brabant,1146643,9,0,5613,0
2020-07-14,Belgium,NA,Flemish Brabant,1146643,14,0,5627,0
2020-07-15,Belgium,NA,Flemish Brabant,1146643,17,0,5644,0
2020-07-16,Belgium,NA,Flemish Brabant,1146643,18,0,5662,0
2020-07-17,Belgium,NA,Flemish Brabant,1146643,10,0,5672,0
2020-07-18,Belgium,NA,Flemish Brabant,1146643,7,0,5679,0
2020-07-19,Belgium,NA,Flemish Brabant,1146643,1,0,5680,0
2020-07-20,Belgium,NA,Flemish Brabant,1146643,21,0,5701,0
2020-07-21,Belgium,NA,Flemish Brabant,1146643,1,0,5702,0
2020-07-22,Belgium,NA,Flemish Brabant,1146643,27,0,5729,0
2020-07-23,Belgium,NA,Flemish Brabant,1146643,18,0,5747,0
2020-07-24,Belgium,NA,Flemish Brabant,1146643,18,0,5765,0
2020-07-25,Belgium,NA,Flemish Brabant,1146643,7,0,5772,0
2020-07-26,Belgium,NA,Flemish Brabant,1146643,7,0,5779,0
2020-07-27,Belgium,NA,Flemish Brabant,1146643,24,0,5803,0
2020-07-28,Belgium,NA,Flemish Brabant,1146643,32,0,5835,0
2020-07-29,Belgium,NA,Flemish Brabant,1146643,37,0,5872,0
2020-07-30,Belgium,NA,Flemish Brabant,1146643,48,0,5920,0
2020-07-31,Belgium,NA,Flemish Brabant,1146643,30,0,5950,0
2020-08-01,Belgium,NA,Flemish Brabant,1146643,15,0,5965,0
2020-08-02,Belgium,NA,Flemish Brabant,1146643,3,0,5968,0
2020-08-03,Belgium,NA,Flemish Brabant,1146643,48,0,6016,0
2020-08-04,Belgium,NA,Flemish Brabant,1146643,49,0,6065,0
2020-08-05,Belgium,NA,Flemish Brabant,1146643,54,0,6119,0
2020-08-06,Belgium,NA,Flemish Brabant,1146643,36,0,6155,0
2020-08-07,Belgium,NA,Flemish Brabant,1146643,38,0,6193,0
2020-08-08,Belgium,NA,Flemish Brabant,1146643,11,0,6204,0
2020-08-09,Belgium,NA,Flemish Brabant,1146643,11,0,6215,0
2020-08-10,Belgium,NA,Flemish Brabant,1146643,56,0,6271,0
2020-08-11,Belgium,NA,Flemish Brabant,1146643,37,0,6308,0
2020-08-12,Belgium,NA,Flemish Brabant,1146643,29,0,6337,0
2020-08-13,Belgium,NA,Flemish Brabant,1146643,47,0,6384,0
2020-08-14,Belgium,NA,Flemish Brabant,1146643,44,0,6428,0
2020-08-15,Belgium,NA,Flemish Brabant,1146643,14,0,6442,0
2020-08-16,Belgium,NA,Flemish Brabant,1146643,6,0,6448,0
2020-08-17,Belgium,NA,Flemish Brabant,1146643,65,0,6513,0
2020-08-18,Belgium,NA,Flemish Brabant,1146643,58,0,6571,0
2020-08-19,Belgium,NA,Flemish Brabant,1146643,43,0,6614,0
2020-08-20,Belgium,NA,Flemish Brabant,1146643,42,0,6656,0
2020-08-21,Belgium,NA,Flemish Brabant,1146643,49,0,6705,0
2020-08-22,Belgium,NA,Flemish Brabant,1146643,13,0,6718,0
2020-08-23,Belgium,NA,Flemish Brabant,1146643,7,0,6725,0
2020-08-24,Belgium,NA,Flemish Brabant,1146643,64,0,6789,0
2020-08-25,Belgium,NA,Flemish Brabant,1146643,49,0,6838,0
2020-08-26,Belgium,NA,Flemish Brabant,1146643,53,0,6891,0
2020-08-27,Belgium,NA,Flemish Brabant,1146643,59,0,6950,0
2020-08-28,Belgium,NA,Flemish Brabant,1146643,57,0,7007,0
2020-08-29,Belgium,NA,Flemish Brabant,1146643,17,0,7024,0
2020-08-30,Belgium,NA,Flemish Brabant,1146643,10,0,7034,0
2020-08-31,Belgium,NA,Flemish Brabant,1146643,55,0,7089,0
2020-09-01,Belgium,NA,Flemish Brabant,1146643,51,0,7140,0
2020-09-02,Belgium,NA,Flemish Brabant,1146643,38,0,7178,0
2020-09-03,Belgium,NA,Flemish Brabant,1146643,58,0,7236,0
2020-09-04,Belgium,NA,Flemish Brabant,1146643,50,0,7286,0
2020-09-05,Belgium,NA,Flemish Brabant,1146643,23,0,7309,0
2020-09-06,Belgium,NA,Flemish Brabant,1146643,14,0,7323,0
2020-09-07,Belgium,NA,Flemish Brabant,1146643,86,0,7409,0
2020-09-08,Belgium,NA,Flemish Brabant,1146643,73,0,7482,0
2020-09-09,Belgium,NA,Flemish Brabant,1146643,70,0,7552,0
2020-09-10,Belgium,NA,Flemish Brabant,1146643,76,0,7628,0
2020-09-11,Belgium,NA,Flemish Brabant,1146643,81,0,7709,0
2020-09-12,Belgium,NA,Flemish Brabant,1146643,42,0,7751,0
2020-09-13,Belgium,NA,Flemish Brabant,1146643,35,0,7786,0
2020-09-14,Belgium,NA,Flemish Brabant,1146643,178,0,7964,0
2020-09-15,Belgium,NA,Flemish Brabant,1146643,145,0,8109,0
2020-09-16,Belgium,NA,Flemish Brabant,1146643,189,0,8298,0
2020-09-17,Belgium,NA,Flemish Brabant,1146643,137,0,8435,0
2020-09-18,Belgium,NA,Flemish Brabant,1146643,139,0,8574,0
2020-09-19,Belgium,NA,Flemish Brabant,1146643,64,0,8638,0
2020-09-20,Belgium,NA,Flemish Brabant,1146643,27,0,8665,0
2020-09-21,Belgium,NA,Flemish Brabant,1146643,192,0,8857,0
2020-09-22,Belgium,NA,Flemish Brabant,1146643,119,0,8976,0
2020-09-23,Belgium,NA,Flemish Brabant,1146643,14,0,8990,0
2020-03-05,Belgium,NA,Hainaut,1346082,10,0,17,0
2020-03-06,Belgium,NA,Hainaut,1346082,4,0,21,0
2020-03-07,Belgium,NA,Hainaut,1346082,1,0,22,0
2020-03-08,Belgium,NA,Hainaut,1346082,4,0,26,0
2020-03-09,Belgium,NA,Hainaut,1346082,12,0,38,0
2020-03-10,Belgium,NA,Hainaut,1346082,7,0,45,0
2020-03-11,Belgium,NA,Hainaut,1346082,13,0,58,0
2020-03-12,Belgium,NA,Hainaut,1346082,28,0,86,0
2020-03-13,Belgium,NA,Hainaut,1346082,55,0,141,0
2020-03-14,Belgium,NA,Hainaut,1346082,35,0,176,0
2020-03-15,Belgium,NA,Hainaut,1346082,30,0,206,0
2020-03-16,Belgium,NA,Hainaut,1346082,46,0,252,0
2020-03-17,Belgium,NA,Hainaut,1346082,52,0,304,0
2020-03-18,Belgium,NA,Hainaut,1346082,77,0,381,0
2020-03-19,Belgium,NA,Hainaut,1346082,72,0,453,0
2020-03-20,Belgium,NA,Hainaut,1346082,79,0,532,0
2020-03-21,Belgium,NA,Hainaut,1346082,58,0,590,0
2020-03-22,Belgium,NA,Hainaut,1346082,64,0,654,0
2020-03-23,Belgium,NA,Hainaut,1346082,121,0,775,0
2020-03-24,Belgium,NA,Hainaut,1346082,130,0,905,0
2020-03-25,Belgium,NA,Hainaut,1346082,114,0,1019,0
2020-03-26,Belgium,NA,Hainaut,1346082,112,0,1131,0
2020-03-27,Belgium,NA,Hainaut,1346082,151,0,1282,0
2020-03-28,Belgium,NA,Hainaut,1346082,104,0,1386,0
2020-03-29,Belgium,NA,Hainaut,1346082,108,0,1494,0
2020-03-30,Belgium,NA,Hainaut,1346082,154,0,1648,0
2020-03-31,Belgium,NA,Hainaut,1346082,233,0,1881,0
2020-04-01,Belgium,NA,Hainaut,1346082,134,0,2015,0
2020-04-02,Belgium,NA,Hainaut,1346082,133,0,2148,0
2020-04-03,Belgium,NA,Hainaut,1346082,198,0,2346,0
2020-04-04,Belgium,NA,Hainaut,1346082,72,0,2418,0
2020-04-05,Belgium,NA,Hainaut,1346082,78,0,2496,0
2020-04-06,Belgium,NA,Hainaut,1346082,224,0,2720,0
2020-04-07,Belgium,NA,Hainaut,1346082,153,0,2873,0
2020-04-08,Belgium,NA,Hainaut,1346082,166,0,3039,0
2020-04-09,Belgium,NA,Hainaut,1346082,272,0,3311,0
2020-04-10,Belgium,NA,Hainaut,1346082,247,0,3558,0
2020-04-11,Belgium,NA,Hainaut,1346082,59,0,3617,0
2020-04-12,Belgium,NA,Hainaut,1346082,44,0,3661,0
2020-04-13,Belgium,NA,Hainaut,1346082,55,0,3716,0
2020-04-14,Belgium,NA,Hainaut,1346082,182,0,3898,0
2020-04-15,Belgium,NA,Hainaut,1346082,145,0,4043,0
2020-04-16,Belgium,NA,Hainaut,1346082,222,0,4265,0
2020-04-17,Belgium,NA,Hainaut,1346082,174,0,4439,0
2020-04-18,Belgium,NA,Hainaut,1346082,221,0,4660,0
2020-04-19,Belgium,NA,Hainaut,1346082,62,0,4722,0
2020-04-20,Belgium,NA,Hainaut,1346082,170,0,4892,0
2020-04-21,Belgium,NA,Hainaut,1346082,307,0,5199,0
2020-04-22,Belgium,NA,Hainaut,1346082,100,0,5299,0
2020-04-23,Belgium,NA,Hainaut,1346082,163,0,5462,0
2020-04-24,Belgium,NA,Hainaut,1346082,72,0,5534,0
2020-04-25,Belgium,NA,Hainaut,1346082,43,0,5577,0
2020-04-26,Belgium,NA,Hainaut,1346082,38,0,5615,0
2020-04-27,Belgium,NA,Hainaut,1346082,90,0,5705,0
2020-04-28,Belgium,NA,Hainaut,1346082,48,0,5753,0
2020-04-29,Belgium,NA,Hainaut,1346082,36,0,5789,0
2020-04-30,Belgium,NA,Hainaut,1346082,66,0,5855,0
2020-05-01,Belgium,NA,Hainaut,1346082,16,0,5871,0
2020-05-02,Belgium,NA,Hainaut,1346082,47,0,5918,0
2020-05-03,Belgium,NA,Hainaut,1346082,8,0,5926,0
2020-05-04,Belgium,NA,Hainaut,1346082,44,0,5970,0
2020-05-05,Belgium,NA,Hainaut,1346082,49,0,6019,0
2020-05-06,Belgium,NA,Hainaut,1346082,63,0,6082,0
2020-05-07,Belgium,NA,Hainaut,1346082,36,0,6118,0
2020-05-08,Belgium,NA,Hainaut,1346082,63,0,6181,0
2020-05-09,Belgium,NA,Hainaut,1346082,28,0,6209,0
2020-05-10,Belgium,NA,Hainaut,1346082,10,0,6219,0
2020-05-11,Belgium,NA,Hainaut,1346082,40,0,6259,0
2020-05-12,Belgium,NA,Hainaut,1346082,54,0,6313,0
2020-05-13,Belgium,NA,Hainaut,1346082,32,0,6345,0
2020-05-14,Belgium,NA,Hainaut,1346082,34,0,6379,0
2020-05-15,Belgium,NA,Hainaut,1346082,47,0,6426,0
2020-05-16,Belgium,NA,Hainaut,1346082,10,0,6436,0
2020-05-17,Belgium,NA,Hainaut,1346082,6,0,6442,0
2020-05-18,Belgium,NA,Hainaut,1346082,30,0,6472,0
2020-05-19,Belgium,NA,Hainaut,1346082,19,0,6491,0
2020-05-20,Belgium,NA,Hainaut,1346082,54,0,6545,0
2020-05-21,Belgium,NA,Hainaut,1346082,7,0,6552,0
2020-05-22,Belgium,NA,Hainaut,1346082,20,0,6572,0
2020-05-23,Belgium,NA,Hainaut,1346082,13,0,6585,0
2020-05-24,Belgium,NA,Hainaut,1346082,8,0,6593,0
2020-05-25,Belgium,NA,Hainaut,1346082,65,0,6658,0
2020-05-26,Belgium,NA,Hainaut,1346082,15,0,6673,0
2020-05-27,Belgium,NA,Hainaut,1346082,24,0,6697,0
2020-05-28,Belgium,NA,Hainaut,1346082,25,0,6722,0
2020-05-29,Belgium,NA,Hainaut,1346082,6,0,6728,0
2020-05-30,Belgium,NA,Hainaut,1346082,3,0,6731,0
2020-05-31,Belgium,NA,Hainaut,1346082,4,0,6735,0
2020-06-01,Belgium,NA,Hainaut,1346082,6,0,6741,0
2020-06-02,Belgium,NA,Hainaut,1346082,21,0,6762,0
2020-06-03,Belgium,NA,Hainaut,1346082,15,0,6777,0
2020-06-04,Belgium,NA,Hainaut,1346082,11,0,6788,0
2020-06-05,Belgium,NA,Hainaut,1346082,19,0,6807,0
2020-06-06,Belgium,NA,Hainaut,1346082,5,0,6812,0
2020-06-07,Belgium,NA,Hainaut,1346082,7,0,6819,0
2020-06-08,Belgium,NA,Hainaut,1346082,13,0,6832,0
2020-06-09,Belgium,NA,Hainaut,1346082,18,0,6850,0
2020-06-10,Belgium,NA,Hainaut,1346082,21,0,6871,0
2020-06-11,Belgium,NA,Hainaut,1346082,18,0,6889,0
2020-06-12,Belgium,NA,Hainaut,1346082,11,0,6900,0
2020-06-13,Belgium,NA,Hainaut,1346082,4,0,6904,0
2020-06-14,Belgium,NA,Hainaut,1346082,1,0,6905,0
2020-06-15,Belgium,NA,Hainaut,1346082,20,0,6925,0
2020-06-16,Belgium,NA,Hainaut,1346082,10,0,6935,0
2020-06-17,Belgium,NA,Hainaut,1346082,13,0,6948,0
2020-06-18,Belgium,NA,Hainaut,1346082,5,0,6953,0
2020-06-19,Belgium,NA,Hainaut,1346082,8,0,6961,0
2020-06-20,Belgium,NA,Hainaut,1346082,9,0,6970,0
2020-06-21,Belgium,NA,Hainaut,1346082,1,0,6971,0
2020-06-22,Belgium,NA,Hainaut,1346082,33,0,7004,0
2020-06-23,Belgium,NA,Hainaut,1346082,11,0,7015,0
2020-06-24,Belgium,NA,Hainaut,1346082,12,0,7027,0
2020-06-25,Belgium,NA,Hainaut,1346082,12,0,7039,0
2020-06-26,Belgium,NA,Hainaut,1346082,15,0,7054,0
2020-06-27,Belgium,NA,Hainaut,1346082,5,0,7059,0
2020-06-28,Belgium,NA,Hainaut,1346082,5,0,7064,0
2020-06-29,Belgium,NA,Hainaut,1346082,5,0,7069,0
2020-06-30,Belgium,NA,Hainaut,1346082,13,0,7082,0
2020-07-01,Belgium,NA,Hainaut,1346082,15,0,7097,0
2020-07-02,Belgium,NA,Hainaut,1346082,11,0,7108,0
2020-07-03,Belgium,NA,Hainaut,1346082,13,0,7121,0
2020-07-04,Belgium,NA,Hainaut,1346082,12,0,7133,0
2020-07-06,Belgium,NA,Hainaut,1346082,6,0,7139,0
2020-07-07,Belgium,NA,Hainaut,1346082,4,0,7143,0
2020-07-08,Belgium,NA,Hainaut,1346082,7,0,7150,0
2020-07-09,Belgium,NA,Hainaut,1346082,8,0,7158,0
2020-07-10,Belgium,NA,Hainaut,1346082,10,0,7168,0
2020-07-11,Belgium,NA,Hainaut,1346082,6,0,7174,0
2020-07-12,Belgium,NA,Hainaut,1346082,3,0,7177,0
2020-07-13,Belgium,NA,Hainaut,1346082,19,0,7196,0
2020-07-14,Belgium,NA,Hainaut,1346082,18,0,7214,0
2020-07-15,Belgium,NA,Hainaut,1346082,16,0,7230,0
2020-07-16,Belgium,NA,Hainaut,1346082,26,0,7256,0
2020-07-17,Belgium,NA,Hainaut,1346082,18,0,7274,0
2020-07-18,Belgium,NA,Hainaut,1346082,9,0,7283,0
2020-07-19,Belgium,NA,Hainaut,1346082,5,0,7288,0
2020-07-20,Belgium,NA,Hainaut,1346082,25,0,7313,0
2020-07-21,Belgium,NA,Hainaut,1346082,10,0,7323,0
2020-07-22,Belgium,NA,Hainaut,1346082,33,0,7356,0
2020-07-23,Belgium,NA,Hainaut,1346082,9,0,7365,0
2020-07-24,Belgium,NA,Hainaut,1346082,40,0,7405,0
2020-07-25,Belgium,NA,Hainaut,1346082,20,0,7425,0
2020-07-26,Belgium,NA,Hainaut,1346082,8,0,7433,0
2020-07-27,Belgium,NA,Hainaut,1346082,30,0,7463,0
2020-07-28,Belgium,NA,Hainaut,1346082,38,0,7501,0
2020-07-29,Belgium,NA,Hainaut,1346082,58,0,7559,0
2020-07-30,Belgium,NA,Hainaut,1346082,37,0,7596,0
2020-07-31,Belgium,NA,Hainaut,1346082,36,0,7632,0
2020-08-01,Belgium,NA,Hainaut,1346082,28,0,7660,0
2020-08-02,Belgium,NA,Hainaut,1346082,14,0,7674,0
2020-08-03,Belgium,NA,Hainaut,1346082,62,0,7736,0
2020-08-04,Belgium,NA,Hainaut,1346082,52,0,7788,0
2020-08-05,Belgium,NA,Hainaut,1346082,61,0,7849,0
2020-08-06,Belgium,NA,Hainaut,1346082,55,0,7904,0
2020-08-07,Belgium,NA,Hainaut,1346082,44,0,7948,0
2020-08-08,Belgium,NA,Hainaut,1346082,13,0,7961,0
2020-08-09,Belgium,NA,Hainaut,1346082,8,0,7969,0
2020-08-10,Belgium,NA,Hainaut,1346082,53,0,8022,0
2020-08-11,Belgium,NA,Hainaut,1346082,58,0,8080,0
2020-08-12,Belgium,NA,Hainaut,1346082,29,0,8109,0
2020-08-13,Belgium,NA,Hainaut,1346082,47,0,8156,0
2020-08-14,Belgium,NA,Hainaut,1346082,41,0,8197,0
2020-08-15,Belgium,NA,Hainaut,1346082,6,0,8203,0
2020-08-16,Belgium,NA,Hainaut,1346082,10,0,8213,0
2020-08-17,Belgium,NA,Hainaut,1346082,70,0,8283,0
2020-08-18,Belgium,NA,Hainaut,1346082,54,0,8337,0
2020-08-19,Belgium,NA,Hainaut,1346082,65,0,8402,0
2020-08-20,Belgium,NA,Hainaut,1346082,61,0,8463,0
2020-08-21,Belgium,NA,Hainaut,1346082,54,0,8517,0
2020-08-22,Belgium,NA,Hainaut,1346082,15,0,8532,0
2020-08-23,Belgium,NA,Hainaut,1346082,6,0,8538,0
2020-08-24,Belgium,NA,Hainaut,1346082,40,0,8578,0
2020-08-25,Belgium,NA,Hainaut,1346082,37,0,8615,0
2020-08-26,Belgium,NA,Hainaut,1346082,37,0,8652,0
2020-08-27,Belgium,NA,Hainaut,1346082,61,0,8713,0
2020-08-28,Belgium,NA,Hainaut,1346082,62,0,8775,0
2020-08-29,Belgium,NA,Hainaut,1346082,19,0,8794,0
2020-08-30,Belgium,NA,Hainaut,1346082,3,0,8797,0
2020-08-31,Belgium,NA,Hainaut,1346082,40,0,8837,0
2020-09-01,Belgium,NA,Hainaut,1346082,45,0,8882,0
2020-09-02,Belgium,NA,Hainaut,1346082,69,0,8951,0
2020-09-03,Belgium,NA,Hainaut,1346082,44,0,8995,0
2020-09-04,Belgium,NA,Hainaut,1346082,73,0,9068,0
2020-09-05,Belgium,NA,Hainaut,1346082,35,0,9103,0
2020-09-06,Belgium,NA,Hainaut,1346082,8,0,9111,0
2020-09-07,Belgium,NA,Hainaut,1346082,61,0,9172,0
2020-09-08,Belgium,NA,Hainaut,1346082,75,0,9247,0
2020-09-09,Belgium,NA,Hainaut,1346082,88,0,9335,0
2020-09-10,Belgium,NA,Hainaut,1346082,78,0,9413,0
2020-09-11,Belgium,NA,Hainaut,1346082,133,0,9546,0
2020-09-12,Belgium,NA,Hainaut,1346082,63,0,9609,0
2020-09-13,Belgium,NA,Hainaut,1346082,15,0,9624,0
2020-09-14,Belgium,NA,Hainaut,1346082,144,0,9768,0
2020-09-15,Belgium,NA,Hainaut,1346082,180,0,9948,0
2020-09-16,Belgium,NA,Hainaut,1346082,165,0,10113,0
2020-09-17,Belgium,NA,Hainaut,1346082,162,0,10275,0
2020-09-18,Belgium,NA,Hainaut,1346082,153,0,10428,0
2020-09-19,Belgium,NA,Hainaut,1346082,102,0,10530,0
2020-09-20,Belgium,NA,Hainaut,1346082,53,0,10583,0
2020-09-21,Belgium,NA,Hainaut,1346082,245,0,10828,0
2020-09-22,Belgium,NA,Hainaut,1346082,150,0,10978,0
2020-09-23,Belgium,NA,Hainaut,1346082,27,0,11005,0
2020-03-04,Belgium,NA,Liege,1110068,5,0,15,0
2020-03-05,Belgium,NA,Liege,1110068,6,0,21,0
2020-03-06,Belgium,NA,Liege,1110068,8,0,29,0
2020-03-07,Belgium,NA,Liege,1110068,4,0,33,0
2020-03-08,Belgium,NA,Liege,1110068,11,0,44,0
2020-03-09,Belgium,NA,Liege,1110068,22,0,66,0
2020-03-10,Belgium,NA,Liege,1110068,10,0,76,0
2020-03-11,Belgium,NA,Liege,1110068,25,0,101,0
2020-03-12,Belgium,NA,Liege,1110068,29,0,130,0
2020-03-13,Belgium,NA,Liege,1110068,30,0,160,0
2020-03-14,Belgium,NA,Liege,1110068,22,0,182,0
2020-03-15,Belgium,NA,Liege,1110068,15,0,197,0
2020-03-16,Belgium,NA,Liege,1110068,48,0,245,0
2020-03-17,Belgium,NA,Liege,1110068,45,0,290,0
2020-03-18,Belgium,NA,Liege,1110068,47,0,337,0
2020-03-19,Belgium,NA,Liege,1110068,80,0,417,0
2020-03-20,Belgium,NA,Liege,1110068,73,0,490,0
2020-03-21,Belgium,NA,Liege,1110068,74,0,564,0
2020-03-22,Belgium,NA,Liege,1110068,60,0,624,0
2020-03-23,Belgium,NA,Liege,1110068,166,0,790,0
2020-03-24,Belgium,NA,Liege,1110068,163,0,953,0
2020-03-25,Belgium,NA,Liege,1110068,138,0,1091,0
2020-03-26,Belgium,NA,Liege,1110068,157,0,1248,0
2020-03-27,Belgium,NA,Liege,1110068,97,0,1345,0
2020-03-28,Belgium,NA,Liege,1110068,30,0,1375,0
2020-03-29,Belgium,NA,Liege,1110068,54,0,1429,0
2020-03-30,Belgium,NA,Liege,1110068,245,0,1674,0
2020-03-31,Belgium,NA,Liege,1110068,207,0,1881,0
2020-04-01,Belgium,NA,Liege,1110068,175,0,2056,0
2020-04-02,Belgium,NA,Liege,1110068,194,0,2250,0
2020-04-03,Belgium,NA,Liege,1110068,182,0,2432,0
2020-04-04,Belgium,NA,Liege,1110068,115,0,2547,0
2020-04-05,Belgium,NA,Liege,1110068,96,0,2643,0
2020-04-06,Belgium,NA,Liege,1110068,190,0,2833,0
2020-04-07,Belgium,NA,Liege,1110068,202,0,3035,0
2020-04-08,Belgium,NA,Liege,1110068,160,0,3195,0
2020-04-09,Belgium,NA,Liege,1110068,236,0,3431,0
2020-04-10,Belgium,NA,Liege,1110068,234,0,3665,0
2020-04-11,Belgium,NA,Liege,1110068,138,0,3803,0
2020-04-12,Belgium,NA,Liege,1110068,76,0,3879,0
2020-04-13,Belgium,NA,Liege,1110068,63,0,3942,0
2020-04-14,Belgium,NA,Liege,1110068,212,0,4154,0
2020-04-15,Belgium,NA,Liege,1110068,451,0,4605,0
2020-04-16,Belgium,NA,Liege,1110068,137,0,4742,0
2020-04-17,Belgium,NA,Liege,1110068,215,0,4957,0
2020-04-18,Belgium,NA,Liege,1110068,145,0,5102,0
2020-04-19,Belgium,NA,Liege,1110068,93,0,5195,0
2020-04-20,Belgium,NA,Liege,1110068,181,0,5376,0
2020-04-21,Belgium,NA,Liege,1110068,119,0,5495,0
2020-04-22,Belgium,NA,Liege,1110068,83,0,5578,0
2020-04-23,Belgium,NA,Liege,1110068,214,0,5792,0
2020-04-24,Belgium,NA,Liege,1110068,73,0,5865,0
2020-04-25,Belgium,NA,Liege,1110068,90,0,5955,0
2020-04-26,Belgium,NA,Liege,1110068,21,0,5976,0
2020-04-27,Belgium,NA,Liege,1110068,46,0,6022,0
2020-04-28,Belgium,NA,Liege,1110068,58,0,6080,0
2020-04-29,Belgium,NA,Liege,1110068,43,0,6123,0
2020-04-30,Belgium,NA,Liege,1110068,46,0,6169,0
2020-05-01,Belgium,NA,Liege,1110068,27,0,6196,0
2020-05-02,Belgium,NA,Liege,1110068,19,0,6215,0
2020-05-03,Belgium,NA,Liege,1110068,10,0,6225,0
2020-05-04,Belgium,NA,Liege,1110068,50,0,6275,0
2020-05-05,Belgium,NA,Liege,1110068,35,0,6310,0
2020-05-06,Belgium,NA,Liege,1110068,35,0,6345,0
2020-05-07,Belgium,NA,Liege,1110068,50,0,6395,0
2020-05-08,Belgium,NA,Liege,1110068,37,0,6432,0
2020-05-09,Belgium,NA,Liege,1110068,41,0,6473,0
2020-05-10,Belgium,NA,Liege,1110068,25,0,6498,0
2020-05-11,Belgium,NA,Liege,1110068,23,0,6521,0
2020-05-12,Belgium,NA,Liege,1110068,32,0,6553,0
2020-05-13,Belgium,NA,Liege,1110068,22,0,6575,0
2020-05-14,Belgium,NA,Liege,1110068,27,0,6602,0
2020-05-15,Belgium,NA,Liege,1110068,29,0,6631,0
2020-05-16,Belgium,NA,Liege,1110068,13,0,6644,0
2020-05-17,Belgium,NA,Liege,1110068,7,0,6651,0
2020-05-18,Belgium,NA,Liege,1110068,10,0,6661,0
2020-05-19,Belgium,NA,Liege,1110068,25,0,6686,0
2020-05-20,Belgium,NA,Liege,1110068,30,0,6716,0
2020-05-21,Belgium,NA,Liege,1110068,4,0,6720,0
2020-05-22,Belgium,NA,Liege,1110068,17,0,6737,0
2020-05-23,Belgium,NA,Liege,1110068,15,0,6752,0
2020-05-24,Belgium,NA,Liege,1110068,7,0,6759,0
2020-05-25,Belgium,NA,Liege,1110068,9,0,6768,0
2020-05-26,Belgium,NA,Liege,1110068,16,0,6784,0
2020-05-27,Belgium,NA,Liege,1110068,23,0,6807,0
2020-05-28,Belgium,NA,Liege,1110068,5,0,6812,0
2020-05-29,Belgium,NA,Liege,1110068,8,0,6820,0
2020-05-30,Belgium,NA,Liege,1110068,6,0,6826,0
2020-05-31,Belgium,NA,Liege,1110068,7,0,6833,0
2020-06-01,Belgium,NA,Liege,1110068,5,0,6838,0
2020-06-02,Belgium,NA,Liege,1110068,11,0,6849,0
2020-06-03,Belgium,NA,Liege,1110068,7,0,6856,0
2020-06-04,Belgium,NA,Liege,1110068,7,0,6863,0
2020-06-05,Belgium,NA,Liege,1110068,18,0,6881,0
2020-06-06,Belgium,NA,Liege,1110068,8,0,6889,0
2020-06-07,Belgium,NA,Liege,1110068,8,0,6897,0
2020-06-08,Belgium,NA,Liege,1110068,16,0,6913,0
2020-06-09,Belgium,NA,Liege,1110068,6,0,6919,0
2020-06-10,Belgium,NA,Liege,1110068,4,0,6923,0
2020-06-11,Belgium,NA,Liege,1110068,4,0,6927,0
2020-06-12,Belgium,NA,Liege,1110068,10,0,6937,0
2020-06-13,Belgium,NA,Liege,1110068,6,0,6943,0
2020-06-14,Belgium,NA,Liege,1110068,2,0,6945,0
2020-06-15,Belgium,NA,Liege,1110068,5,0,6950,0
2020-06-16,Belgium,NA,Liege,1110068,9,0,6959,0
2020-06-17,Belgium,NA,Liege,1110068,4,0,6963,0
2020-06-18,Belgium,NA,Liege,1110068,16,0,6979,0
2020-06-19,Belgium,NA,Liege,1110068,6,0,6985,0
2020-06-20,Belgium,NA,Liege,1110068,7,0,6992,0
2020-06-21,Belgium,NA,Liege,1110068,3,0,6995,0
2020-06-22,Belgium,NA,Liege,1110068,10,0,7005,0
2020-06-23,Belgium,NA,Liege,1110068,8,0,7013,0
2020-06-24,Belgium,NA,Liege,1110068,8,0,7021,0
2020-06-25,Belgium,NA,Liege,1110068,1,0,7022,0
2020-06-26,Belgium,NA,Liege,1110068,6,0,7028,0
2020-06-27,Belgium,NA,Liege,1110068,3,0,7031,0
2020-06-29,Belgium,NA,Liege,1110068,5,0,7036,0
2020-06-30,Belgium,NA,Liege,1110068,7,0,7043,0
2020-07-01,Belgium,NA,Liege,1110068,1,0,7044,0
2020-07-03,Belgium,NA,Liege,1110068,4,0,7048,0
2020-07-04,Belgium,NA,Liege,1110068,5,0,7053,0
2020-07-06,Belgium,NA,Liege,1110068,5,0,7058,0
2020-07-07,Belgium,NA,Liege,1110068,15,0,7073,0
2020-07-08,Belgium,NA,Liege,1110068,1,0,7074,0
2020-07-09,Belgium,NA,Liege,1110068,7,0,7081,0
2020-07-10,Belgium,NA,Liege,1110068,10,0,7091,0
2020-07-11,Belgium,NA,Liege,1110068,10,0,7101,0
2020-07-12,Belgium,NA,Liege,1110068,1,0,7102,0
2020-07-13,Belgium,NA,Liege,1110068,8,0,7110,0
2020-07-14,Belgium,NA,Liege,1110068,29,0,7139,0
2020-07-15,Belgium,NA,Liege,1110068,17,0,7156,0
2020-07-16,Belgium,NA,Liege,1110068,13,0,7169,0
2020-07-17,Belgium,NA,Liege,1110068,19,0,7188,0
2020-07-18,Belgium,NA,Liege,1110068,9,0,7197,0
2020-07-19,Belgium,NA,Liege,1110068,2,0,7199,0
2020-07-20,Belgium,NA,Liege,1110068,33,0,7232,0
2020-07-21,Belgium,NA,Liege,1110068,4,0,7236,0
2020-07-22,Belgium,NA,Liege,1110068,37,0,7273,0
2020-07-23,Belgium,NA,Liege,1110068,39,0,7312,0
2020-07-24,Belgium,NA,Liege,1110068,32,0,7344,0
2020-07-25,Belgium,NA,Liege,1110068,28,0,7372,0
2020-07-26,Belgium,NA,Liege,1110068,10,0,7382,0
2020-07-27,Belgium,NA,Liege,1110068,41,0,7423,0
2020-07-28,Belgium,NA,Liege,1110068,72,0,7495,0
2020-07-29,Belgium,NA,Liege,1110068,48,0,7543,0
2020-07-30,Belgium,NA,Liege,1110068,91,0,7634,0
2020-07-31,Belgium,NA,Liege,1110068,93,0,7727,0
2020-08-01,Belgium,NA,Liege,1110068,26,0,7753,0
2020-08-02,Belgium,NA,Liege,1110068,20,0,7773,0
2020-08-03,Belgium,NA,Liege,1110068,103,0,7876,0
2020-08-04,Belgium,NA,Liege,1110068,99,0,7975,0
2020-08-05,Belgium,NA,Liege,1110068,63,0,8038,0
2020-08-06,Belgium,NA,Liege,1110068,88,0,8126,0
2020-08-07,Belgium,NA,Liege,1110068,66,0,8192,0
2020-08-08,Belgium,NA,Liege,1110068,28,0,8220,0
2020-08-09,Belgium,NA,Liege,1110068,9,0,8229,0
2020-08-10,Belgium,NA,Liege,1110068,97,0,8326,0
2020-08-11,Belgium,NA,Liege,1110068,91,0,8417,0
2020-08-12,Belgium,NA,Liege,1110068,81,0,8498,0
2020-08-13,Belgium,NA,Liege,1110068,55,0,8553,0
2020-08-14,Belgium,NA,Liege,1110068,61,0,8614,0
2020-08-15,Belgium,NA,Liege,1110068,32,0,8646,0
2020-08-16,Belgium,NA,Liege,1110068,6,0,8652,0
2020-08-17,Belgium,NA,Liege,1110068,48,0,8700,0
2020-08-18,Belgium,NA,Liege,1110068,57,0,8757,0
2020-08-19,Belgium,NA,Liege,1110068,33,0,8790,0
2020-08-20,Belgium,NA,Liege,1110068,31,0,8821,0
2020-08-21,Belgium,NA,Liege,1110068,22,0,8843,0
2020-08-22,Belgium,NA,Liege,1110068,14,0,8857,0
2020-08-23,Belgium,NA,Liege,1110068,12,0,8869,0
2020-08-24,Belgium,NA,Liege,1110068,46,0,8915,0
2020-08-25,Belgium,NA,Liege,1110068,31,0,8946,0
2020-08-26,Belgium,NA,Liege,1110068,56,0,9002,0
2020-08-27,Belgium,NA,Liege,1110068,50,0,9052,0
2020-08-28,Belgium,NA,Liege,1110068,70,0,9122,0
2020-08-29,Belgium,NA,Liege,1110068,16,0,9138,0
2020-08-30,Belgium,NA,Liege,1110068,7,0,9145,0
2020-08-31,Belgium,NA,Liege,1110068,64,0,9209,0
2020-09-01,Belgium,NA,Liege,1110068,54,0,9263,0
2020-09-02,Belgium,NA,Liege,1110068,44,0,9307,0
2020-09-03,Belgium,NA,Liege,1110068,47,0,9354,0
2020-09-04,Belgium,NA,Liege,1110068,59,0,9413,0
2020-09-05,Belgium,NA,Liege,1110068,26,0,9439,0
2020-09-06,Belgium,NA,Liege,1110068,11,0,9450,0
2020-09-07,Belgium,NA,Liege,1110068,94,0,9544,0
2020-09-08,Belgium,NA,Liege,1110068,88,0,9632,0
2020-09-09,Belgium,NA,Liege,1110068,174,0,9806,0
2020-09-10,Belgium,NA,Liege,1110068,166,0,9972,0
2020-09-11,Belgium,NA,Liege,1110068,158,0,10130,0
2020-09-12,Belgium,NA,Liege,1110068,81,0,10211,0
2020-09-13,Belgium,NA,Liege,1110068,40,0,10251,0
2020-09-14,Belgium,NA,Liege,1110068,234,0,10485,0
2020-09-15,Belgium,NA,Liege,1110068,236,0,10721,0
2020-09-16,Belgium,NA,Liege,1110068,329,0,11050,0
2020-09-17,Belgium,NA,Liege,1110068,253,0,11303,0
2020-09-18,Belgium,NA,Liege,1110068,230,0,11533,0
2020-09-19,Belgium,NA,Liege,1110068,114,0,11647,0
2020-09-20,Belgium,NA,Liege,1110068,54,0,11701,0
2020-09-21,Belgium,NA,Liege,1110068,238,0,11939,0
2020-09-22,Belgium,NA,Liege,1110068,95,0,12034,0
2020-09-23,Belgium,NA,Liege,1110068,14,0,12048,0
2020-03-04,Belgium,NA,Limburg,875842,8,0,12,0
2020-03-05,Belgium,NA,Limburg,875842,8,0,20,0
2020-03-06,Belgium,NA,Limburg,875842,17,0,37,0
2020-03-07,Belgium,NA,Limburg,875842,3,0,40,0
2020-03-08,Belgium,NA,Limburg,875842,7,0,47,0
2020-03-09,Belgium,NA,Limburg,875842,6,0,53,0
2020-03-10,Belgium,NA,Limburg,875842,12,0,65,0
2020-03-11,Belgium,NA,Limburg,875842,22,0,87,0
2020-03-12,Belgium,NA,Limburg,875842,25,0,112,0
2020-03-13,Belgium,NA,Limburg,875842,30,0,142,0
2020-03-14,Belgium,NA,Limburg,875842,11,0,153,0
2020-03-15,Belgium,NA,Limburg,875842,37,0,190,0
2020-03-16,Belgium,NA,Limburg,875842,35,0,225,0
2020-03-17,Belgium,NA,Limburg,875842,66,0,291,0
2020-03-18,Belgium,NA,Limburg,875842,58,0,349,0
2020-03-19,Belgium,NA,Limburg,875842,97,0,446,0
2020-03-20,Belgium,NA,Limburg,875842,111,0,557,0
2020-03-21,Belgium,NA,Limburg,875842,62,0,619,0
2020-03-22,Belgium,NA,Limburg,875842,45,0,664,0
2020-03-23,Belgium,NA,Limburg,875842,145,0,809,0
2020-03-24,Belgium,NA,Limburg,875842,135,0,944,0
2020-03-25,Belgium,NA,Limburg,875842,125,0,1069,0
2020-03-26,Belgium,NA,Limburg,875842,179,0,1248,0
2020-03-27,Belgium,NA,Limburg,875842,181,0,1429,0
2020-03-28,Belgium,NA,Limburg,875842,96,0,1525,0
2020-03-29,Belgium,NA,Limburg,875842,72,0,1597,0
2020-03-30,Belgium,NA,Limburg,875842,231,0,1828,0
2020-03-31,Belgium,NA,Limburg,875842,166,0,1994,0
2020-04-01,Belgium,NA,Limburg,875842,170,0,2164,0
2020-04-02,Belgium,NA,Limburg,875842,167,0,2331,0
2020-04-03,Belgium,NA,Limburg,875842,257,0,2588,0
2020-04-04,Belgium,NA,Limburg,875842,86,0,2674,0
2020-04-05,Belgium,NA,Limburg,875842,47,0,2721,0
2020-04-06,Belgium,NA,Limburg,875842,258,0,2979,0
2020-04-07,Belgium,NA,Limburg,875842,221,0,3200,0
2020-04-08,Belgium,NA,Limburg,875842,214,0,3414,0
2020-04-09,Belgium,NA,Limburg,875842,255,0,3669,0
2020-04-10,Belgium,NA,Limburg,875842,324,0,3993,0
2020-04-11,Belgium,NA,Limburg,875842,93,0,4086,0
2020-04-12,Belgium,NA,Limburg,875842,53,0,4139,0
2020-04-13,Belgium,NA,Limburg,875842,40,0,4179,0
2020-04-14,Belgium,NA,Limburg,875842,188,0,4367,0
2020-04-15,Belgium,NA,Limburg,875842,96,0,4463,0
2020-04-16,Belgium,NA,Limburg,875842,126,0,4589,0
2020-04-17,Belgium,NA,Limburg,875842,134,0,4723,0
2020-04-18,Belgium,NA,Limburg,875842,49,0,4772,0
2020-04-19,Belgium,NA,Limburg,875842,29,0,4801,0
2020-04-20,Belgium,NA,Limburg,875842,129,0,4930,0
2020-04-21,Belgium,NA,Limburg,875842,77,0,5007,0
2020-04-22,Belgium,NA,Limburg,875842,56,0,5063,0
2020-04-23,Belgium,NA,Limburg,875842,64,0,5127,0
2020-04-24,Belgium,NA,Limburg,875842,76,0,5203,0
2020-04-25,Belgium,NA,Limburg,875842,20,0,5223,0
2020-04-26,Belgium,NA,Limburg,875842,23,0,5246,0
2020-04-27,Belgium,NA,Limburg,875842,59,0,5305,0
2020-04-28,Belgium,NA,Limburg,875842,44,0,5349,0
2020-04-29,Belgium,NA,Limburg,875842,59,0,5408,0
2020-04-30,Belgium,NA,Limburg,875842,46,0,5454,0
2020-05-01,Belgium,NA,Limburg,875842,24,0,5478,0
2020-05-02,Belgium,NA,Limburg,875842,27,0,5505,0
2020-05-03,Belgium,NA,Limburg,875842,7,0,5512,0
2020-05-04,Belgium,NA,Limburg,875842,43,0,5555,0
2020-05-05,Belgium,NA,Limburg,875842,36,0,5591,0
2020-05-06,Belgium,NA,Limburg,875842,43,0,5634,0
2020-05-07,Belgium,NA,Limburg,875842,39,0,5673,0
2020-05-08,Belgium,NA,Limburg,875842,50,0,5723,0
2020-05-09,Belgium,NA,Limburg,875842,15,0,5738,0
2020-05-10,Belgium,NA,Limburg,875842,9,0,5747,0
2020-05-11,Belgium,NA,Limburg,875842,54,0,5801,0
2020-05-12,Belgium,NA,Limburg,875842,29,0,5830,0
2020-05-13,Belgium,NA,Limburg,875842,31,0,5861,0
2020-05-14,Belgium,NA,Limburg,875842,25,0,5886,0
2020-05-15,Belgium,NA,Limburg,875842,33,0,5919,0
2020-05-16,Belgium,NA,Limburg,875842,10,0,5929,0
2020-05-17,Belgium,NA,Limburg,875842,9,0,5938,0
2020-05-18,Belgium,NA,Limburg,875842,50,0,5988,0
2020-05-19,Belgium,NA,Limburg,875842,45,0,6033,0
2020-05-20,Belgium,NA,Limburg,875842,34,0,6067,0
2020-05-21,Belgium,NA,Limburg,875842,8,0,6075,0
2020-05-22,Belgium,NA,Limburg,875842,24,0,6099,0
2020-05-23,Belgium,NA,Limburg,875842,11,0,6110,0
2020-05-24,Belgium,NA,Limburg,875842,14,0,6124,0
2020-05-25,Belgium,NA,Limburg,875842,29,0,6153,0
2020-05-26,Belgium,NA,Limburg,875842,27,0,6180,0
2020-05-27,Belgium,NA,Limburg,875842,24,0,6204,0
2020-05-28,Belgium,NA,Limburg,875842,18,0,6222,0
2020-05-29,Belgium,NA,Limburg,875842,15,0,6237,0
2020-05-30,Belgium,NA,Limburg,875842,12,0,6249,0
2020-05-31,Belgium,NA,Limburg,875842,7,0,6256,0
2020-06-01,Belgium,NA,Limburg,875842,8,0,6264,0
2020-06-02,Belgium,NA,Limburg,875842,23,0,6287,0
2020-06-03,Belgium,NA,Limburg,875842,21,0,6308,0
2020-06-04,Belgium,NA,Limburg,875842,21,0,6329,0
2020-06-05,Belgium,NA,Limburg,875842,23,0,6352,0
2020-06-06,Belgium,NA,Limburg,875842,18,0,6370,0
2020-06-07,Belgium,NA,Limburg,875842,15,0,6385,0
2020-06-08,Belgium,NA,Limburg,875842,17,0,6402,0
2020-06-09,Belgium,NA,Limburg,875842,16,0,6418,0
2020-06-10,Belgium,NA,Limburg,875842,12,0,6430,0
2020-06-11,Belgium,NA,Limburg,875842,14,0,6444,0
2020-06-12,Belgium,NA,Limburg,875842,7,0,6451,0
2020-06-13,Belgium,NA,Limburg,875842,5,0,6456,0
2020-06-14,Belgium,NA,Limburg,875842,2,0,6458,0
2020-06-15,Belgium,NA,Limburg,875842,20,0,6478,0
2020-06-16,Belgium,NA,Limburg,875842,15,0,6493,0
2020-06-17,Belgium,NA,Limburg,875842,13,0,6506,0
2020-06-18,Belgium,NA,Limburg,875842,5,0,6511,0
2020-06-19,Belgium,NA,Limburg,875842,14,0,6525,0
2020-06-20,Belgium,NA,Limburg,875842,4,0,6529,0
2020-06-21,Belgium,NA,Limburg,875842,4,0,6533,0
2020-06-22,Belgium,NA,Limburg,875842,8,0,6541,0
2020-06-23,Belgium,NA,Limburg,875842,16,0,6557,0
2020-06-24,Belgium,NA,Limburg,875842,16,0,6573,0
2020-06-25,Belgium,NA,Limburg,875842,5,0,6578,0
2020-06-26,Belgium,NA,Limburg,875842,10,0,6588,0
2020-06-27,Belgium,NA,Limburg,875842,1,0,6589,0
2020-06-29,Belgium,NA,Limburg,875842,9,0,6598,0
2020-06-30,Belgium,NA,Limburg,875842,6,0,6604,0
2020-07-01,Belgium,NA,Limburg,875842,9,0,6613,0
2020-07-02,Belgium,NA,Limburg,875842,6,0,6619,0
2020-07-03,Belgium,NA,Limburg,875842,4,0,6623,0
2020-07-04,Belgium,NA,Limburg,875842,7,0,6630,0
2020-07-05,Belgium,NA,Limburg,875842,1,0,6631,0
2020-07-06,Belgium,NA,Limburg,875842,7,0,6638,0
2020-07-07,Belgium,NA,Limburg,875842,7,0,6645,0
2020-07-08,Belgium,NA,Limburg,875842,22,0,6667,0
2020-07-09,Belgium,NA,Limburg,875842,14,0,6681,0
2020-07-10,Belgium,NA,Limburg,875842,10,0,6691,0
2020-07-11,Belgium,NA,Limburg,875842,10,0,6701,0
2020-07-12,Belgium,NA,Limburg,875842,4,0,6705,0
2020-07-13,Belgium,NA,Limburg,875842,19,0,6724,0
2020-07-14,Belgium,NA,Limburg,875842,12,0,6736,0
2020-07-15,Belgium,NA,Limburg,875842,23,0,6759,0
2020-07-16,Belgium,NA,Limburg,875842,11,0,6770,0
2020-07-17,Belgium,NA,Limburg,875842,21,0,6791,0
2020-07-18,Belgium,NA,Limburg,875842,5,0,6796,0
2020-07-19,Belgium,NA,Limburg,875842,12,0,6808,0
2020-07-20,Belgium,NA,Limburg,875842,22,0,6830,0
2020-07-21,Belgium,NA,Limburg,875842,23,0,6853,0
2020-07-22,Belgium,NA,Limburg,875842,46,0,6899,0
2020-07-23,Belgium,NA,Limburg,875842,25,0,6924,0
2020-07-24,Belgium,NA,Limburg,875842,28,0,6952,0
2020-07-25,Belgium,NA,Limburg,875842,19,0,6971,0
2020-07-26,Belgium,NA,Limburg,875842,5,0,6976,0
2020-07-27,Belgium,NA,Limburg,875842,38,0,7014,0
2020-07-28,Belgium,NA,Limburg,875842,31,0,7045,0
2020-07-29,Belgium,NA,Limburg,875842,38,0,7083,0
2020-07-30,Belgium,NA,Limburg,875842,27,0,7110,0
2020-07-31,Belgium,NA,Limburg,875842,22,0,7132,0
2020-08-01,Belgium,NA,Limburg,875842,22,0,7154,0
2020-08-02,Belgium,NA,Limburg,875842,9,0,7163,0
2020-08-03,Belgium,NA,Limburg,875842,26,0,7189,0
2020-08-04,Belgium,NA,Limburg,875842,45,0,7234,0
2020-08-05,Belgium,NA,Limburg,875842,27,0,7261,0
2020-08-06,Belgium,NA,Limburg,875842,27,0,7288,0
2020-08-07,Belgium,NA,Limburg,875842,28,0,7316,0
2020-08-08,Belgium,NA,Limburg,875842,19,0,7335,0
2020-08-09,Belgium,NA,Limburg,875842,2,0,7337,0
2020-08-10,Belgium,NA,Limburg,875842,50,0,7387,0
2020-08-11,Belgium,NA,Limburg,875842,31,0,7418,0
2020-08-12,Belgium,NA,Limburg,875842,9,0,7427,0
2020-08-13,Belgium,NA,Limburg,875842,26,0,7453,0
2020-08-14,Belgium,NA,Limburg,875842,17,0,7470,0
2020-08-15,Belgium,NA,Limburg,875842,12,0,7482,0
2020-08-16,Belgium,NA,Limburg,875842,9,0,7491,0
2020-08-17,Belgium,NA,Limburg,875842,32,0,7523,0
2020-08-18,Belgium,NA,Limburg,875842,31,0,7554,0
2020-08-19,Belgium,NA,Limburg,875842,25,0,7579,0
2020-08-20,Belgium,NA,Limburg,875842,40,0,7619,0
2020-08-21,Belgium,NA,Limburg,875842,25,0,7644,0
2020-08-22,Belgium,NA,Limburg,875842,7,0,7651,0
2020-08-23,Belgium,NA,Limburg,875842,8,0,7659,0
2020-08-24,Belgium,NA,Limburg,875842,32,0,7691,0
2020-08-25,Belgium,NA,Limburg,875842,33,0,7724,0
2020-08-26,Belgium,NA,Limburg,875842,25,0,7749,0
2020-08-27,Belgium,NA,Limburg,875842,31,0,7780,0
2020-08-28,Belgium,NA,Limburg,875842,19,0,7799,0
2020-08-29,Belgium,NA,Limburg,875842,16,0,7815,0
2020-08-30,Belgium,NA,Limburg,875842,7,0,7822,0
2020-08-31,Belgium,NA,Limburg,875842,52,0,7874,0
2020-09-01,Belgium,NA,Limburg,875842,45,0,7919,0
2020-09-02,Belgium,NA,Limburg,875842,25,0,7944,0
2020-09-03,Belgium,NA,Limburg,875842,27,0,7971,0
2020-09-04,Belgium,NA,Limburg,875842,27,0,7998,0
2020-09-05,Belgium,NA,Limburg,875842,6,0,8004,0
2020-09-06,Belgium,NA,Limburg,875842,17,0,8021,0
2020-09-07,Belgium,NA,Limburg,875842,36,0,8057,0
2020-09-08,Belgium,NA,Limburg,875842,44,0,8101,0
2020-09-09,Belgium,NA,Limburg,875842,51,0,8152,0
2020-09-10,Belgium,NA,Limburg,875842,40,0,8192,0
2020-09-11,Belgium,NA,Limburg,875842,49,0,8241,0
2020-09-12,Belgium,NA,Limburg,875842,26,0,8267,0
2020-09-13,Belgium,NA,Limburg,875842,14,0,8281,0
2020-09-14,Belgium,NA,Limburg,875842,67,0,8348,0
2020-09-15,Belgium,NA,Limburg,875842,29,0,8377,0
2020-09-16,Belgium,NA,Limburg,875842,36,0,8413,0
2020-09-17,Belgium,NA,Limburg,875842,47,0,8460,0
2020-09-18,Belgium,NA,Limburg,875842,40,0,8500,0
2020-09-19,Belgium,NA,Limburg,875842,39,0,8539,0
2020-09-20,Belgium,NA,Limburg,875842,15,0,8554,0
2020-09-21,Belgium,NA,Limburg,875842,69,0,8623,0
2020-09-22,Belgium,NA,Limburg,875842,35,0,8658,0
2020-09-23,Belgium,NA,Limburg,875842,21,0,8679,0
2020-03-13,Belgium,NA,Luxembourg,286685,7,0,16,0
2020-03-14,Belgium,NA,Luxembourg,286685,1,0,17,0
2020-03-15,Belgium,NA,Luxembourg,286685,1,0,18,0
2020-03-16,Belgium,NA,Luxembourg,286685,5,0,23,0
2020-03-17,Belgium,NA,Luxembourg,286685,3,0,26,0
2020-03-18,Belgium,NA,Luxembourg,286685,15,0,41,0
2020-03-19,Belgium,NA,Luxembourg,286685,46,0,87,0
2020-03-20,Belgium,NA,Luxembourg,286685,3,0,90,0
2020-03-21,Belgium,NA,Luxembourg,286685,8,0,98,0
2020-03-22,Belgium,NA,Luxembourg,286685,12,0,110,0
2020-03-23,Belgium,NA,Luxembourg,286685,44,0,154,0
2020-03-24,Belgium,NA,Luxembourg,286685,23,0,177,0
2020-03-25,Belgium,NA,Luxembourg,286685,17,0,194,0
2020-03-26,Belgium,NA,Luxembourg,286685,45,0,239,0
2020-03-27,Belgium,NA,Luxembourg,286685,34,0,273,0
2020-03-28,Belgium,NA,Luxembourg,286685,26,0,299,0
2020-03-29,Belgium,NA,Luxembourg,286685,14,0,313,0
2020-03-30,Belgium,NA,Luxembourg,286685,56,0,369,0
2020-03-31,Belgium,NA,Luxembourg,286685,89,0,458,0
2020-04-01,Belgium,NA,Luxembourg,286685,99,0,557,0
2020-04-02,Belgium,NA,Luxembourg,286685,62,0,619,0
2020-04-03,Belgium,NA,Luxembourg,286685,57,0,676,0
2020-04-04,Belgium,NA,Luxembourg,286685,14,0,690,0
2020-04-05,Belgium,NA,Luxembourg,286685,12,0,702,0
2020-04-06,Belgium,NA,Luxembourg,286685,51,0,753,0
2020-04-07,Belgium,NA,Luxembourg,286685,48,0,801,0
2020-04-08,Belgium,NA,Luxembourg,286685,37,0,838,0
2020-04-09,Belgium,NA,Luxembourg,286685,39,0,877,0
2020-04-10,Belgium,NA,Luxembourg,286685,25,0,902,0
2020-04-11,Belgium,NA,Luxembourg,286685,17,0,919,0
2020-04-12,Belgium,NA,Luxembourg,286685,5,0,924,0
2020-04-13,Belgium,NA,Luxembourg,286685,4,0,928,0
2020-04-14,Belgium,NA,Luxembourg,286685,58,0,986,0
2020-04-15,Belgium,NA,Luxembourg,286685,38,0,1024,0
2020-04-16,Belgium,NA,Luxembourg,286685,102,0,1126,0
2020-04-17,Belgium,NA,Luxembourg,286685,23,0,1149,0
2020-04-18,Belgium,NA,Luxembourg,286685,6,0,1155,0
2020-04-19,Belgium,NA,Luxembourg,286685,8,0,1163,0
2020-04-20,Belgium,NA,Luxembourg,286685,11,0,1174,0
2020-04-21,Belgium,NA,Luxembourg,286685,25,0,1199,0
2020-04-22,Belgium,NA,Luxembourg,286685,15,0,1214,0
2020-04-23,Belgium,NA,Luxembourg,286685,16,0,1230,0
2020-04-24,Belgium,NA,Luxembourg,286685,7,0,1237,0
2020-04-25,Belgium,NA,Luxembourg,286685,4,0,1241,0
2020-04-26,Belgium,NA,Luxembourg,286685,2,0,1243,0
2020-04-27,Belgium,NA,Luxembourg,286685,12,0,1255,0
2020-04-28,Belgium,NA,Luxembourg,286685,5,0,1260,0
2020-04-29,Belgium,NA,Luxembourg,286685,10,0,1270,0
2020-04-30,Belgium,NA,Luxembourg,286685,2,0,1272,0
2020-05-01,Belgium,NA,Luxembourg,286685,9,0,1281,0
2020-05-02,Belgium,NA,Luxembourg,286685,4,0,1285,0
2020-05-04,Belgium,NA,Luxembourg,286685,7,0,1292,0
2020-05-05,Belgium,NA,Luxembourg,286685,5,0,1297,0
2020-05-06,Belgium,NA,Luxembourg,286685,8,0,1305,0
2020-05-07,Belgium,NA,Luxembourg,286685,8,0,1313,0
2020-05-08,Belgium,NA,Luxembourg,286685,13,0,1326,0
2020-05-09,Belgium,NA,Luxembourg,286685,4,0,1330,0
2020-05-11,Belgium,NA,Luxembourg,286685,7,0,1337,0
2020-05-12,Belgium,NA,Luxembourg,286685,6,0,1343,0
2020-05-13,Belgium,NA,Luxembourg,286685,5,0,1348,0
2020-05-14,Belgium,NA,Luxembourg,286685,4,0,1352,0
2020-05-15,Belgium,NA,Luxembourg,286685,3,0,1355,0
2020-05-16,Belgium,NA,Luxembourg,286685,2,0,1357,0
2020-05-18,Belgium,NA,Luxembourg,286685,3,0,1360,0
2020-05-19,Belgium,NA,Luxembourg,286685,6,0,1366,0
2020-05-20,Belgium,NA,Luxembourg,286685,6,0,1372,0
2020-05-22,Belgium,NA,Luxembourg,286685,1,0,1373,0
2020-05-24,Belgium,NA,Luxembourg,286685,1,0,1374,0
2020-05-26,Belgium,NA,Luxembourg,286685,8,0,1382,0
2020-05-27,Belgium,NA,Luxembourg,286685,1,0,1383,0
2020-05-28,Belgium,NA,Luxembourg,286685,2,0,1385,0
2020-05-29,Belgium,NA,Luxembourg,286685,7,0,1392,0
2020-05-30,Belgium,NA,Luxembourg,286685,1,0,1393,0
2020-05-31,Belgium,NA,Luxembourg,286685,3,0,1396,0
2020-06-01,Belgium,NA,Luxembourg,286685,1,0,1397,0
2020-06-02,Belgium,NA,Luxembourg,286685,5,0,1402,0
2020-06-03,Belgium,NA,Luxembourg,286685,1,0,1403,0
2020-06-04,Belgium,NA,Luxembourg,286685,1,0,1404,0
2020-06-05,Belgium,NA,Luxembourg,286685,2,0,1406,0
2020-06-06,Belgium,NA,Luxembourg,286685,1,0,1407,0
2020-06-08,Belgium,NA,Luxembourg,286685,3,0,1410,0
2020-06-09,Belgium,NA,Luxembourg,286685,8,0,1418,0
2020-06-10,Belgium,NA,Luxembourg,286685,1,0,1419,0
2020-06-11,Belgium,NA,Luxembourg,286685,1,0,1420,0
2020-06-12,Belgium,NA,Luxembourg,286685,1,0,1421,0
2020-06-13,Belgium,NA,Luxembourg,286685,2,0,1423,0
2020-06-15,Belgium,NA,Luxembourg,286685,2,0,1425,0
2020-06-16,Belgium,NA,Luxembourg,286685,2,0,1427,0
2020-06-18,Belgium,NA,Luxembourg,286685,3,0,1430,0
2020-06-19,Belgium,NA,Luxembourg,286685,5,0,1435,0
2020-06-20,Belgium,NA,Luxembourg,286685,3,0,1438,0
2020-06-21,Belgium,NA,Luxembourg,286685,2,0,1440,0
2020-06-22,Belgium,NA,Luxembourg,286685,6,0,1446,0
2020-06-23,Belgium,NA,Luxembourg,286685,5,0,1451,0
2020-06-24,Belgium,NA,Luxembourg,286685,3,0,1454,0
2020-06-25,Belgium,NA,Luxembourg,286685,3,0,1457,0
2020-06-27,Belgium,NA,Luxembourg,286685,2,0,1459,0
2020-06-28,Belgium,NA,Luxembourg,286685,1,0,1460,0
2020-06-29,Belgium,NA,Luxembourg,286685,3,0,1463,0
2020-06-30,Belgium,NA,Luxembourg,286685,2,0,1465,0
2020-07-01,Belgium,NA,Luxembourg,286685,1,0,1466,0
2020-07-02,Belgium,NA,Luxembourg,286685,2,0,1468,0
2020-07-04,Belgium,NA,Luxembourg,286685,3,0,1471,0
2020-07-05,Belgium,NA,Luxembourg,286685,1,0,1472,0
2020-07-06,Belgium,NA,Luxembourg,286685,3,0,1475,0
2020-07-07,Belgium,NA,Luxembourg,286685,6,0,1481,0
2020-07-08,Belgium,NA,Luxembourg,286685,3,0,1484,0
2020-07-09,Belgium,NA,Luxembourg,286685,3,0,1487,0
2020-07-10,Belgium,NA,Luxembourg,286685,6,0,1493,0
2020-07-11,Belgium,NA,Luxembourg,286685,1,0,1494,0
2020-07-12,Belgium,NA,Luxembourg,286685,1,0,1495,0
2020-07-13,Belgium,NA,Luxembourg,286685,2,0,1497,0
2020-07-14,Belgium,NA,Luxembourg,286685,5,0,1502,0
2020-07-15,Belgium,NA,Luxembourg,286685,20,0,1522,0
2020-07-16,Belgium,NA,Luxembourg,286685,10,0,1532,0
2020-07-17,Belgium,NA,Luxembourg,286685,12,0,1544,0
2020-07-18,Belgium,NA,Luxembourg,286685,4,0,1548,0
2020-07-19,Belgium,NA,Luxembourg,286685,1,0,1549,0
2020-07-20,Belgium,NA,Luxembourg,286685,8,0,1557,0
2020-07-21,Belgium,NA,Luxembourg,286685,2,0,1559,0
2020-07-22,Belgium,NA,Luxembourg,286685,5,0,1564,0
2020-07-23,Belgium,NA,Luxembourg,286685,4,0,1568,0
2020-07-24,Belgium,NA,Luxembourg,286685,7,0,1575,0
2020-07-25,Belgium,NA,Luxembourg,286685,6,0,1581,0
2020-07-26,Belgium,NA,Luxembourg,286685,1,0,1582,0
2020-07-27,Belgium,NA,Luxembourg,286685,2,0,1584,0
2020-07-28,Belgium,NA,Luxembourg,286685,14,0,1598,0
2020-07-29,Belgium,NA,Luxembourg,286685,9,0,1607,0
2020-07-30,Belgium,NA,Luxembourg,286685,9,0,1616,0
2020-07-31,Belgium,NA,Luxembourg,286685,13,0,1629,0
2020-08-01,Belgium,NA,Luxembourg,286685,4,0,1633,0
2020-08-02,Belgium,NA,Luxembourg,286685,3,0,1636,0
2020-08-03,Belgium,NA,Luxembourg,286685,7,0,1643,0
2020-08-04,Belgium,NA,Luxembourg,286685,9,0,1652,0
2020-08-05,Belgium,NA,Luxembourg,286685,8,0,1660,0
2020-08-06,Belgium,NA,Luxembourg,286685,8,0,1668,0
2020-08-07,Belgium,NA,Luxembourg,286685,8,0,1676,0
2020-08-08,Belgium,NA,Luxembourg,286685,12,0,1688,0
2020-08-09,Belgium,NA,Luxembourg,286685,5,0,1693,0
2020-08-10,Belgium,NA,Luxembourg,286685,7,0,1700,0
2020-08-11,Belgium,NA,Luxembourg,286685,23,0,1723,0
2020-08-12,Belgium,NA,Luxembourg,286685,9,0,1732,0
2020-08-13,Belgium,NA,Luxembourg,286685,8,0,1740,0
2020-08-14,Belgium,NA,Luxembourg,286685,5,0,1745,0
2020-08-16,Belgium,NA,Luxembourg,286685,1,0,1746,0
2020-08-17,Belgium,NA,Luxembourg,286685,9,0,1755,0
2020-08-18,Belgium,NA,Luxembourg,286685,13,0,1768,0
2020-08-19,Belgium,NA,Luxembourg,286685,11,0,1779,0
2020-08-20,Belgium,NA,Luxembourg,286685,9,0,1788,0
2020-08-21,Belgium,NA,Luxembourg,286685,4,0,1792,0
2020-08-22,Belgium,NA,Luxembourg,286685,5,0,1797,0
2020-08-24,Belgium,NA,Luxembourg,286685,2,0,1799,0
2020-08-25,Belgium,NA,Luxembourg,286685,8,0,1807,0
2020-08-26,Belgium,NA,Luxembourg,286685,2,0,1809,0
2020-08-27,Belgium,NA,Luxembourg,286685,9,0,1818,0
2020-08-28,Belgium,NA,Luxembourg,286685,19,0,1837,0
2020-08-29,Belgium,NA,Luxembourg,286685,3,0,1840,0
2020-08-30,Belgium,NA,Luxembourg,286685,2,0,1842,0
2020-08-31,Belgium,NA,Luxembourg,286685,3,0,1845,0
2020-09-01,Belgium,NA,Luxembourg,286685,11,0,1856,0
2020-09-02,Belgium,NA,Luxembourg,286685,4,0,1860,0
2020-09-03,Belgium,NA,Luxembourg,286685,8,0,1868,0
2020-09-04,Belgium,NA,Luxembourg,286685,12,0,1880,0
2020-09-05,Belgium,NA,Luxembourg,286685,6,0,1886,0
2020-09-06,Belgium,NA,Luxembourg,286685,3,0,1889,0
2020-09-07,Belgium,NA,Luxembourg,286685,9,0,1898,0
2020-09-08,Belgium,NA,Luxembourg,286685,14,0,1912,0
2020-09-09,Belgium,NA,Luxembourg,286685,14,0,1926,0
2020-09-10,Belgium,NA,Luxembourg,286685,19,0,1945,0
2020-09-11,Belgium,NA,Luxembourg,286685,20,0,1965,0
2020-09-12,Belgium,NA,Luxembourg,286685,13,0,1978,0
2020-09-13,Belgium,NA,Luxembourg,286685,3,0,1981,0
2020-09-14,Belgium,NA,Luxembourg,286685,32,0,2013,0
2020-09-15,Belgium,NA,Luxembourg,286685,23,0,2036,0
2020-09-16,Belgium,NA,Luxembourg,286685,31,0,2067,0
2020-09-17,Belgium,NA,Luxembourg,286685,27,0,2094,0
2020-09-18,Belgium,NA,Luxembourg,286685,31,0,2125,0
2020-09-19,Belgium,NA,Luxembourg,286685,24,0,2149,0
2020-09-20,Belgium,NA,Luxembourg,286685,1,0,2150,0
2020-09-21,Belgium,NA,Luxembourg,286685,24,0,2174,0
2020-09-22,Belgium,NA,Luxembourg,286685,25,0,2199,0
2020-09-23,Belgium,NA,Luxembourg,286685,3,0,2202,0
2020-03-09,Belgium,NA,Namur,496891,3,0,13,0
2020-03-11,Belgium,NA,Namur,496891,5,0,18,0
2020-03-12,Belgium,NA,Namur,496891,2,0,20,0
2020-03-13,Belgium,NA,Namur,496891,7,0,27,0
2020-03-14,Belgium,NA,Namur,496891,4,0,31,0
2020-03-15,Belgium,NA,Namur,496891,1,0,32,0
2020-03-17,Belgium,NA,Namur,496891,9,0,41,0
2020-03-18,Belgium,NA,Namur,496891,21,0,62,0
2020-03-19,Belgium,NA,Namur,496891,21,0,83,0
2020-03-20,Belgium,NA,Namur,496891,15,0,98,0
2020-03-21,Belgium,NA,Namur,496891,10,0,108,0
2020-03-22,Belgium,NA,Namur,496891,16,0,124,0
2020-03-23,Belgium,NA,Namur,496891,32,0,156,0
2020-03-24,Belgium,NA,Namur,496891,29,0,185,0
2020-03-25,Belgium,NA,Namur,496891,38,0,223,0
2020-03-26,Belgium,NA,Namur,496891,33,0,256,0
2020-03-27,Belgium,NA,Namur,496891,46,0,302,0
2020-03-28,Belgium,NA,Namur,496891,31,0,333,0
2020-03-29,Belgium,NA,Namur,496891,23,0,356,0
2020-03-30,Belgium,NA,Namur,496891,48,0,404,0
2020-03-31,Belgium,NA,Namur,496891,49,0,453,0
2020-04-01,Belgium,NA,Namur,496891,58,0,511,0
2020-04-02,Belgium,NA,Namur,496891,78,0,589,0
2020-04-03,Belgium,NA,Namur,496891,68,0,657,0
2020-04-04,Belgium,NA,Namur,496891,38,0,695,0
2020-04-05,Belgium,NA,Namur,496891,37,0,732,0
2020-04-06,Belgium,NA,Namur,496891,76,0,808,0
2020-04-07,Belgium,NA,Namur,496891,77,0,885,0
2020-04-08,Belgium,NA,Namur,496891,70,0,955,0
2020-04-09,Belgium,NA,Namur,496891,55,0,1010,0
2020-04-10,Belgium,NA,Namur,496891,48,0,1058,0
2020-04-11,Belgium,NA,Namur,496891,41,0,1099,0
2020-04-12,Belgium,NA,Namur,496891,24,0,1123,0
2020-04-13,Belgium,NA,Namur,496891,19,0,1142,0
2020-04-14,Belgium,NA,Namur,496891,60,0,1202,0
2020-04-15,Belgium,NA,Namur,496891,120,0,1322,0
2020-04-16,Belgium,NA,Namur,496891,58,0,1380,0
2020-04-17,Belgium,NA,Namur,496891,43,0,1423,0
2020-04-18,Belgium,NA,Namur,496891,22,0,1445,0
2020-04-19,Belgium,NA,Namur,496891,59,0,1504,0
2020-04-20,Belgium,NA,Namur,496891,78,0,1582,0
2020-04-21,Belgium,NA,Namur,496891,53,0,1635,0
2020-04-22,Belgium,NA,Namur,496891,31,0,1666,0
2020-04-23,Belgium,NA,Namur,496891,26,0,1692,0
2020-04-24,Belgium,NA,Namur,496891,61,0,1753,0
2020-04-25,Belgium,NA,Namur,496891,42,0,1795,0
2020-04-26,Belgium,NA,Namur,496891,11,0,1806,0
2020-04-27,Belgium,NA,Namur,496891,45,0,1851,0
2020-04-28,Belgium,NA,Namur,496891,30,0,1881,0
2020-04-29,Belgium,NA,Namur,496891,35,0,1916,0
2020-04-30,Belgium,NA,Namur,496891,21,0,1937,0
2020-05-01,Belgium,NA,Namur,496891,8,0,1945,0
2020-05-02,Belgium,NA,Namur,496891,13,0,1958,0
2020-05-03,Belgium,NA,Namur,496891,14,0,1972,0
2020-05-04,Belgium,NA,Namur,496891,36,0,2008,0
2020-05-05,Belgium,NA,Namur,496891,35,0,2043,0
2020-05-06,Belgium,NA,Namur,496891,21,0,2064,0
2020-05-07,Belgium,NA,Namur,496891,32,0,2096,0
2020-05-08,Belgium,NA,Namur,496891,33,0,2129,0
2020-05-09,Belgium,NA,Namur,496891,11,0,2140,0
2020-05-10,Belgium,NA,Namur,496891,3,0,2143,0
2020-05-11,Belgium,NA,Namur,496891,27,0,2170,0
2020-05-12,Belgium,NA,Namur,496891,18,0,2188,0
2020-05-13,Belgium,NA,Namur,496891,20,0,2208,0
2020-05-14,Belgium,NA,Namur,496891,11,0,2219,0
2020-05-15,Belgium,NA,Namur,496891,9,0,2228,0
2020-05-16,Belgium,NA,Namur,496891,6,0,2234,0
2020-05-17,Belgium,NA,Namur,496891,1,0,2235,0
2020-05-18,Belgium,NA,Namur,496891,10,0,2245,0
2020-05-19,Belgium,NA,Namur,496891,7,0,2252,0
2020-05-20,Belgium,NA,Namur,496891,16,0,2268,0
2020-05-21,Belgium,NA,Namur,496891,2,0,2270,0
2020-05-22,Belgium,NA,Namur,496891,5,0,2275,0
2020-05-23,Belgium,NA,Namur,496891,1,0,2276,0
2020-05-24,Belgium,NA,Namur,496891,4,0,2280,0
2020-05-25,Belgium,NA,Namur,496891,11,0,2291,0
2020-05-26,Belgium,NA,Namur,496891,2,0,2293,0
2020-05-27,Belgium,NA,Namur,496891,5,0,2298,0
2020-05-28,Belgium,NA,Namur,496891,1,0,2299,0
2020-05-29,Belgium,NA,Namur,496891,13,0,2312,0
2020-05-30,Belgium,NA,Namur,496891,2,0,2314,0
2020-05-31,Belgium,NA,Namur,496891,4,0,2318,0
2020-06-01,Belgium,NA,Namur,496891,1,0,2319,0
2020-06-02,Belgium,NA,Namur,496891,6,0,2325,0
2020-06-03,Belgium,NA,Namur,496891,2,0,2327,0
2020-06-04,Belgium,NA,Namur,496891,7,0,2334,0
2020-06-05,Belgium,NA,Namur,496891,6,0,2340,0
2020-06-08,Belgium,NA,Namur,496891,3,0,2343,0
2020-06-09,Belgium,NA,Namur,496891,5,0,2348,0
2020-06-10,Belgium,NA,Namur,496891,3,0,2351,0
2020-06-11,Belgium,NA,Namur,496891,1,0,2352,0
2020-06-12,Belgium,NA,Namur,496891,1,0,2353,0
2020-06-13,Belgium,NA,Namur,496891,2,0,2355,0
2020-06-15,Belgium,NA,Namur,496891,3,0,2358,0
2020-06-16,Belgium,NA,Namur,496891,1,0,2359,0
2020-06-17,Belgium,NA,Namur,496891,2,0,2361,0
2020-06-18,Belgium,NA,Namur,496891,2,0,2363,0
2020-06-19,Belgium,NA,Namur,496891,2,0,2365,0
2020-06-20,Belgium,NA,Namur,496891,2,0,2367,0
2020-06-22,Belgium,NA,Namur,496891,2,0,2369,0
2020-06-23,Belgium,NA,Namur,496891,3,0,2372,0
2020-06-24,Belgium,NA,Namur,496891,2,0,2374,0
2020-06-25,Belgium,NA,Namur,496891,1,0,2375,0
2020-06-26,Belgium,NA,Namur,496891,1,0,2376,0
2020-06-27,Belgium,NA,Namur,496891,1,0,2377,0
2020-06-29,Belgium,NA,Namur,496891,3,0,2380,0
2020-06-30,Belgium,NA,Namur,496891,4,0,2384,0
2020-07-02,Belgium,NA,Namur,496891,1,0,2385,0
2020-07-03,Belgium,NA,Namur,496891,2,0,2387,0
2020-07-04,Belgium,NA,Namur,496891,1,0,2388,0
2020-07-06,Belgium,NA,Namur,496891,1,0,2389,0
2020-07-07,Belgium,NA,Namur,496891,2,0,2391,0
2020-07-11,Belgium,NA,Namur,496891,4,0,2395,0
2020-07-13,Belgium,NA,Namur,496891,1,0,2396,0
2020-07-14,Belgium,NA,Namur,496891,2,0,2398,0
2020-07-15,Belgium,NA,Namur,496891,5,0,2403,0
2020-07-16,Belgium,NA,Namur,496891,5,0,2408,0
2020-07-17,Belgium,NA,Namur,496891,4,0,2412,0
2020-07-18,Belgium,NA,Namur,496891,5,0,2417,0
2020-07-20,Belgium,NA,Namur,496891,9,0,2426,0
2020-07-21,Belgium,NA,Namur,496891,2,0,2428,0
2020-07-22,Belgium,NA,Namur,496891,12,0,2440,0
2020-07-23,Belgium,NA,Namur,496891,7,0,2447,0
2020-07-24,Belgium,NA,Namur,496891,9,0,2456,0
2020-07-25,Belgium,NA,Namur,496891,2,0,2458,0
2020-07-26,Belgium,NA,Namur,496891,6,0,2464,0
2020-07-27,Belgium,NA,Namur,496891,11,0,2475,0
2020-07-28,Belgium,NA,Namur,496891,25,0,2500,0
2020-07-29,Belgium,NA,Namur,496891,33,0,2533,0
2020-07-30,Belgium,NA,Namur,496891,10,0,2543,0
2020-07-31,Belgium,NA,Namur,496891,25,0,2568,0
2020-08-01,Belgium,NA,Namur,496891,5,0,2573,0
2020-08-02,Belgium,NA,Namur,496891,2,0,2575,0
2020-08-03,Belgium,NA,Namur,496891,24,0,2599,0
2020-08-04,Belgium,NA,Namur,496891,31,0,2630,0
2020-08-05,Belgium,NA,Namur,496891,23,0,2653,0
2020-08-06,Belgium,NA,Namur,496891,33,0,2686,0
2020-08-07,Belgium,NA,Namur,496891,25,0,2711,0
2020-08-08,Belgium,NA,Namur,496891,6,0,2717,0
2020-08-09,Belgium,NA,Namur,496891,2,0,2719,0
2020-08-10,Belgium,NA,Namur,496891,45,0,2764,0
2020-08-11,Belgium,NA,Namur,496891,25,0,2789,0
2020-08-12,Belgium,NA,Namur,496891,27,0,2816,0
2020-08-13,Belgium,NA,Namur,496891,16,0,2832,0
2020-08-14,Belgium,NA,Namur,496891,26,0,2858,0
2020-08-15,Belgium,NA,Namur,496891,5,0,2863,0
2020-08-16,Belgium,NA,Namur,496891,9,0,2872,0
2020-08-17,Belgium,NA,Namur,496891,25,0,2897,0
2020-08-18,Belgium,NA,Namur,496891,45,0,2942,0
2020-08-19,Belgium,NA,Namur,496891,13,0,2955,0
2020-08-20,Belgium,NA,Namur,496891,12,0,2967,0
2020-08-21,Belgium,NA,Namur,496891,19,0,2986,0
2020-08-22,Belgium,NA,Namur,496891,7,0,2993,0
2020-08-24,Belgium,NA,Namur,496891,13,0,3006,0
2020-08-25,Belgium,NA,Namur,496891,11,0,3017,0
2020-08-26,Belgium,NA,Namur,496891,22,0,3039,0
2020-08-27,Belgium,NA,Namur,496891,18,0,3057,0
2020-08-28,Belgium,NA,Namur,496891,22,0,3079,0
2020-08-29,Belgium,NA,Namur,496891,7,0,3086,0
2020-08-30,Belgium,NA,Namur,496891,5,0,3091,0
2020-08-31,Belgium,NA,Namur,496891,19,0,3110,0
2020-09-01,Belgium,NA,Namur,496891,12,0,3122,0
2020-09-02,Belgium,NA,Namur,496891,18,0,3140,0
2020-09-03,Belgium,NA,Namur,496891,23,0,3163,0
2020-09-04,Belgium,NA,Namur,496891,18,0,3181,0
2020-09-05,Belgium,NA,Namur,496891,9,0,3190,0
2020-09-06,Belgium,NA,Namur,496891,5,0,3195,0
2020-09-07,Belgium,NA,Namur,496891,16,0,3211,0
2020-09-08,Belgium,NA,Namur,496891,12,0,3223,0
2020-09-09,Belgium,NA,Namur,496891,18,0,3241,0
2020-09-10,Belgium,NA,Namur,496891,39,0,3280,0
2020-09-11,Belgium,NA,Namur,496891,35,0,3315,0
2020-09-12,Belgium,NA,Namur,496891,23,0,3338,0
2020-09-13,Belgium,NA,Namur,496891,3,0,3341,0
2020-09-14,Belgium,NA,Namur,496891,44,0,3385,0
2020-09-15,Belgium,NA,Namur,496891,50,0,3435,0
2020-09-16,Belgium,NA,Namur,496891,55,0,3490,0
2020-09-17,Belgium,NA,Namur,496891,45,0,3535,0
2020-09-18,Belgium,NA,Namur,496891,42,0,3577,0
2020-09-19,Belgium,NA,Namur,496891,31,0,3608,0
2020-09-20,Belgium,NA,Namur,496891,26,0,3634,0
2020-09-21,Belgium,NA,Namur,496891,62,0,3696,0
2020-09-22,Belgium,NA,Namur,496891,51,0,3747,0
2020-09-23,Belgium,NA,Namur,496891,5,0,3752,0
2020-03-06,Belgium,NA,Walloon Brabant,404270,4,0,13,0
2020-03-07,Belgium,NA,Walloon Brabant,404270,1,0,14,0
2020-03-08,Belgium,NA,Walloon Brabant,404270,1,0,15,0
2020-03-09,Belgium,NA,Walloon Brabant,404270,5,0,20,0
2020-03-10,Belgium,NA,Walloon Brabant,404270,3,0,23,0
2020-03-11,Belgium,NA,Walloon Brabant,404270,2,0,25,0
2020-03-12,Belgium,NA,Walloon Brabant,404270,7,0,32,0
2020-03-13,Belgium,NA,Walloon Brabant,404270,13,0,45,0
2020-03-14,Belgium,NA,Walloon Brabant,404270,4,0,49,0
2020-03-15,Belgium,NA,Walloon Brabant,404270,6,0,55,0
2020-03-16,Belgium,NA,Walloon Brabant,404270,17,0,72,0
2020-03-17,Belgium,NA,Walloon Brabant,404270,18,0,90,0
2020-03-18,Belgium,NA,Walloon Brabant,404270,25,0,115,0
2020-03-19,Belgium,NA,Walloon Brabant,404270,26,0,141,0
2020-03-20,Belgium,NA,Walloon Brabant,404270,19,0,160,0
2020-03-21,Belgium,NA,Walloon Brabant,404270,14,0,174,0
2020-03-22,Belgium,NA,Walloon Brabant,404270,23,0,197,0
2020-03-23,Belgium,NA,Walloon Brabant,404270,31,0,228,0
2020-03-24,Belgium,NA,Walloon Brabant,404270,34,0,262,0
2020-03-25,Belgium,NA,Walloon Brabant,404270,21,0,283,0
2020-03-26,Belgium,NA,Walloon Brabant,404270,29,0,312,0
2020-03-27,Belgium,NA,Walloon Brabant,404270,43,0,355,0
2020-03-28,Belgium,NA,Walloon Brabant,404270,15,0,370,0
2020-03-29,Belgium,NA,Walloon Brabant,404270,14,0,384,0
2020-03-30,Belgium,NA,Walloon Brabant,404270,36,0,420,0
2020-03-31,Belgium,NA,Walloon Brabant,404270,28,0,448,0
2020-04-01,Belgium,NA,Walloon Brabant,404270,40,0,488,0
2020-04-02,Belgium,NA,Walloon Brabant,404270,29,0,517,0
2020-04-03,Belgium,NA,Walloon Brabant,404270,45,0,562,0
2020-04-04,Belgium,NA,Walloon Brabant,404270,14,0,576,0
2020-04-05,Belgium,NA,Walloon Brabant,404270,16,0,592,0
2020-04-06,Belgium,NA,Walloon Brabant,404270,48,0,640,0
2020-04-07,Belgium,NA,Walloon Brabant,404270,33,0,673,0
2020-04-08,Belgium,NA,Walloon Brabant,404270,40,0,713,0
2020-04-09,Belgium,NA,Walloon Brabant,404270,53,0,766,0
2020-04-10,Belgium,NA,Walloon Brabant,404270,34,0,800,0
2020-04-11,Belgium,NA,Walloon Brabant,404270,13,0,813,0
2020-04-12,Belgium,NA,Walloon Brabant,404270,5,0,818,0
2020-04-13,Belgium,NA,Walloon Brabant,404270,6,0,824,0
2020-04-14,Belgium,NA,Walloon Brabant,404270,63,0,887,0
2020-04-15,Belgium,NA,Walloon Brabant,404270,38,0,925,0
2020-04-16,Belgium,NA,Walloon Brabant,404270,42,0,967,0
2020-04-17,Belgium,NA,Walloon Brabant,404270,34,0,1001,0
2020-04-18,Belgium,NA,Walloon Brabant,404270,30,0,1031,0
2020-04-19,Belgium,NA,Walloon Brabant,404270,17,0,1048,0
2020-04-20,Belgium,NA,Walloon Brabant,404270,48,0,1096,0
2020-04-21,Belgium,NA,Walloon Brabant,404270,32,0,1128,0
2020-04-22,Belgium,NA,Walloon Brabant,404270,52,0,1180,0
2020-04-23,Belgium,NA,Walloon Brabant,404270,16,0,1196,0
2020-04-24,Belgium,NA,Walloon Brabant,404270,14,0,1210,0
2020-04-25,Belgium,NA,Walloon Brabant,404270,36,0,1246,0
2020-04-26,Belgium,NA,Walloon Brabant,404270,6,0,1252,0
2020-04-27,Belgium,NA,Walloon Brabant,404270,13,0,1265,0
2020-04-28,Belgium,NA,Walloon Brabant,404270,9,0,1274,0
2020-04-29,Belgium,NA,Walloon Brabant,404270,8,0,1282,0
2020-04-30,Belgium,NA,Walloon Brabant,404270,5,0,1287,0
2020-05-01,Belgium,NA,Walloon Brabant,404270,1,0,1288,0
2020-05-02,Belgium,NA,Walloon Brabant,404270,8,0,1296,0
2020-05-03,Belgium,NA,Walloon Brabant,404270,5,0,1301,0
2020-05-04,Belgium,NA,Walloon Brabant,404270,8,0,1309,0
2020-05-05,Belgium,NA,Walloon Brabant,404270,11,0,1320,0
2020-05-06,Belgium,NA,Walloon Brabant,404270,13,0,1333,0
2020-05-07,Belgium,NA,Walloon Brabant,404270,9,0,1342,0
2020-05-08,Belgium,NA,Walloon Brabant,404270,13,0,1355,0
2020-05-09,Belgium,NA,Walloon Brabant,404270,7,0,1362,0
2020-05-10,Belgium,NA,Walloon Brabant,404270,6,0,1368,0
2020-05-11,Belgium,NA,Walloon Brabant,404270,8,0,1376,0
2020-05-12,Belgium,NA,Walloon Brabant,404270,3,0,1379,0
2020-05-13,Belgium,NA,Walloon Brabant,404270,8,0,1387,0
2020-05-14,Belgium,NA,Walloon Brabant,404270,9,0,1396,0
2020-05-15,Belgium,NA,Walloon Brabant,404270,5,0,1401,0
2020-05-16,Belgium,NA,Walloon Brabant,404270,4,0,1405,0
2020-05-17,Belgium,NA,Walloon Brabant,404270,3,0,1408,0
2020-05-18,Belgium,NA,Walloon Brabant,404270,6,0,1414,0
2020-05-19,Belgium,NA,Walloon Brabant,404270,9,0,1423,0
2020-05-20,Belgium,NA,Walloon Brabant,404270,9,0,1432,0
2020-05-21,Belgium,NA,Walloon Brabant,404270,2,0,1434,0
2020-05-22,Belgium,NA,Walloon Brabant,404270,4,0,1438,0
2020-05-23,Belgium,NA,Walloon Brabant,404270,5,0,1443,0
2020-05-24,Belgium,NA,Walloon Brabant,404270,4,0,1447,0
2020-05-25,Belgium,NA,Walloon Brabant,404270,5,0,1452,0
2020-05-26,Belgium,NA,Walloon Brabant,404270,4,0,1456,0
2020-05-27,Belgium,NA,Walloon Brabant,404270,1,0,1457,0
2020-05-28,Belgium,NA,Walloon Brabant,404270,3,0,1460,0
2020-05-29,Belgium,NA,Walloon Brabant,404270,5,0,1465,0
2020-05-30,Belgium,NA,Walloon Brabant,404270,3,0,1468,0
2020-05-31,Belgium,NA,Walloon Brabant,404270,2,0,1470,0
2020-06-01,Belgium,NA,Walloon Brabant,404270,2,0,1472,0
2020-06-02,Belgium,NA,Walloon Brabant,404270,1,0,1473,0
2020-06-03,Belgium,NA,Walloon Brabant,404270,7,0,1480,0
2020-06-04,Belgium,NA,Walloon Brabant,404270,7,0,1487,0
2020-06-05,Belgium,NA,Walloon Brabant,404270,3,0,1490,0
2020-06-06,Belgium,NA,Walloon Brabant,404270,4,0,1494,0
2020-06-07,Belgium,NA,Walloon Brabant,404270,1,0,1495,0
2020-06-08,Belgium,NA,Walloon Brabant,404270,1,0,1496,0
2020-06-09,Belgium,NA,Walloon Brabant,404270,3,0,1499,0
2020-06-10,Belgium,NA,Walloon Brabant,404270,4,0,1503,0
2020-06-11,Belgium,NA,Walloon Brabant,404270,4,0,1507,0
2020-06-12,Belgium,NA,Walloon Brabant,404270,2,0,1509,0
2020-06-13,Belgium,NA,Walloon Brabant,404270,5,0,1514,0
2020-06-15,Belgium,NA,Walloon Brabant,404270,3,0,1517,0
2020-06-16,Belgium,NA,Walloon Brabant,404270,2,0,1519,0
2020-06-18,Belgium,NA,Walloon Brabant,404270,8,0,1527,0
2020-06-20,Belgium,NA,Walloon Brabant,404270,3,0,1530,0
2020-06-22,Belgium,NA,Walloon Brabant,404270,6,0,1536,0
2020-06-23,Belgium,NA,Walloon Brabant,404270,4,0,1540,0
2020-06-24,Belgium,NA,Walloon Brabant,404270,1,0,1541,0
2020-06-25,Belgium,NA,Walloon Brabant,404270,3,0,1544,0
2020-06-26,Belgium,NA,Walloon Brabant,404270,2,0,1546,0
2020-06-27,Belgium,NA,Walloon Brabant,404270,1,0,1547,0
2020-06-29,Belgium,NA,Walloon Brabant,404270,3,0,1550,0
2020-06-30,Belgium,NA,Walloon Brabant,404270,1,0,1551,0
2020-07-01,Belgium,NA,Walloon Brabant,404270,1,0,1552,0
2020-07-02,Belgium,NA,Walloon Brabant,404270,1,0,1553,0
2020-07-03,Belgium,NA,Walloon Brabant,404270,3,0,1556,0
2020-07-04,Belgium,NA,Walloon Brabant,404270,1,0,1557,0
2020-07-05,Belgium,NA,Walloon Brabant,404270,1,0,1558,0
2020-07-06,Belgium,NA,Walloon Brabant,404270,4,0,1562,0
2020-07-07,Belgium,NA,Walloon Brabant,404270,2,0,1564,0
2020-07-08,Belgium,NA,Walloon Brabant,404270,5,0,1569,0
2020-07-09,Belgium,NA,Walloon Brabant,404270,5,0,1574,0
2020-07-11,Belgium,NA,Walloon Brabant,404270,1,0,1575,0
2020-07-12,Belgium,NA,Walloon Brabant,404270,2,0,1577,0
2020-07-13,Belgium,NA,Walloon Brabant,404270,2,0,1579,0
2020-07-14,Belgium,NA,Walloon Brabant,404270,4,0,1583,0
2020-07-15,Belgium,NA,Walloon Brabant,404270,5,0,1588,0
2020-07-17,Belgium,NA,Walloon Brabant,404270,3,0,1591,0
2020-07-18,Belgium,NA,Walloon Brabant,404270,1,0,1592,0
2020-07-19,Belgium,NA,Walloon Brabant,404270,2,0,1594,0
2020-07-20,Belgium,NA,Walloon Brabant,404270,5,0,1599,0
2020-07-21,Belgium,NA,Walloon Brabant,404270,1,0,1600,0
2020-07-22,Belgium,NA,Walloon Brabant,404270,6,0,1606,0
2020-07-23,Belgium,NA,Walloon Brabant,404270,9,0,1615,0
2020-07-24,Belgium,NA,Walloon Brabant,404270,8,0,1623,0
2020-07-25,Belgium,NA,Walloon Brabant,404270,1,0,1624,0
2020-07-26,Belgium,NA,Walloon Brabant,404270,1,0,1625,0
2020-07-27,Belgium,NA,Walloon Brabant,404270,5,0,1630,0
2020-07-28,Belgium,NA,Walloon Brabant,404270,16,0,1646,0
2020-07-29,Belgium,NA,Walloon Brabant,404270,10,0,1656,0
2020-07-30,Belgium,NA,Walloon Brabant,404270,8,0,1664,0
2020-07-31,Belgium,NA,Walloon Brabant,404270,18,0,1682,0
2020-08-01,Belgium,NA,Walloon Brabant,404270,12,0,1694,0
2020-08-02,Belgium,NA,Walloon Brabant,404270,4,0,1698,0
2020-08-03,Belgium,NA,Walloon Brabant,404270,15,0,1713,0
2020-08-04,Belgium,NA,Walloon Brabant,404270,22,0,1735,0
2020-08-05,Belgium,NA,Walloon Brabant,404270,15,0,1750,0
2020-08-06,Belgium,NA,Walloon Brabant,404270,15,0,1765,0
2020-08-07,Belgium,NA,Walloon Brabant,404270,24,0,1789,0
2020-08-08,Belgium,NA,Walloon Brabant,404270,10,0,1799,0
2020-08-09,Belgium,NA,Walloon Brabant,404270,1,0,1800,0
2020-08-10,Belgium,NA,Walloon Brabant,404270,24,0,1824,0
2020-08-11,Belgium,NA,Walloon Brabant,404270,20,0,1844,0
2020-08-12,Belgium,NA,Walloon Brabant,404270,16,0,1860,0
2020-08-13,Belgium,NA,Walloon Brabant,404270,21,0,1881,0
2020-08-14,Belgium,NA,Walloon Brabant,404270,5,0,1886,0
2020-08-15,Belgium,NA,Walloon Brabant,404270,5,0,1891,0
2020-08-16,Belgium,NA,Walloon Brabant,404270,5,0,1896,0
2020-08-17,Belgium,NA,Walloon Brabant,404270,13,0,1909,0
2020-08-18,Belgium,NA,Walloon Brabant,404270,22,0,1931,0
2020-08-19,Belgium,NA,Walloon Brabant,404270,11,0,1942,0
2020-08-20,Belgium,NA,Walloon Brabant,404270,14,0,1956,0
2020-08-21,Belgium,NA,Walloon Brabant,404270,18,0,1974,0
2020-08-22,Belgium,NA,Walloon Brabant,404270,7,0,1981,0
2020-08-23,Belgium,NA,Walloon Brabant,404270,6,0,1987,0
2020-08-24,Belgium,NA,Walloon Brabant,404270,29,0,2016,0
2020-08-25,Belgium,NA,Walloon Brabant,404270,16,0,2032,0
2020-08-26,Belgium,NA,Walloon Brabant,404270,14,0,2046,0
2020-08-27,Belgium,NA,Walloon Brabant,404270,17,0,2063,0
2020-08-28,Belgium,NA,Walloon Brabant,404270,17,0,2080,0
2020-08-29,Belgium,NA,Walloon Brabant,404270,8,0,2088,0
2020-08-30,Belgium,NA,Walloon Brabant,404270,4,0,2092,0
2020-08-31,Belgium,NA,Walloon Brabant,404270,21,0,2113,0
2020-09-01,Belgium,NA,Walloon Brabant,404270,19,0,2132,0
2020-09-02,Belgium,NA,Walloon Brabant,404270,24,0,2156,0
2020-09-03,Belgium,NA,Walloon Brabant,404270,26,0,2182,0
2020-09-04,Belgium,NA,Walloon Brabant,404270,33,0,2215,0
2020-09-05,Belgium,NA,Walloon Brabant,404270,15,0,2230,0
2020-09-06,Belgium,NA,Walloon Brabant,404270,8,0,2238,0
2020-09-07,Belgium,NA,Walloon Brabant,404270,31,0,2269,0
2020-09-08,Belgium,NA,Walloon Brabant,404270,33,0,2302,0
2020-09-09,Belgium,NA,Walloon Brabant,404270,40,0,2342,0
2020-09-10,Belgium,NA,Walloon Brabant,404270,39,0,2381,0
2020-09-11,Belgium,NA,Walloon Brabant,404270,38,0,2419,0
2020-09-12,Belgium,NA,Walloon Brabant,404270,23,0,2442,0
2020-09-13,Belgium,NA,Walloon Brabant,404270,15,0,2457,0
2020-09-14,Belgium,NA,Walloon Brabant,404270,72,0,2529,0
2020-09-15,Belgium,NA,Walloon Brabant,404270,114,0,2643,0
2020-09-16,Belgium,NA,Walloon Brabant,404270,87,0,2730,0
2020-09-17,Belgium,NA,Walloon Brabant,404270,83,0,2813,0
2020-09-18,Belgium,NA,Walloon Brabant,404270,84,0,2897,0
2020-09-19,Belgium,NA,Walloon Brabant,404270,54,0,2951,0
2020-09-20,Belgium,NA,Walloon Brabant,404270,31,0,2982,0
2020-09-21,Belgium,NA,Walloon Brabant,404270,88,0,3070,0
2020-09-22,Belgium,NA,Walloon Brabant,404270,65,0,3135,0
2020-09-23,Belgium,NA,Walloon Brabant,404270,7,0,3142,0
2020-03-05,Belgium,NA,West Flanders,1196995,14,0,21,0
2020-03-06,Belgium,NA,West Flanders,1196995,17,0,38,0
2020-03-07,Belgium,NA,West Flanders,1196995,4,0,42,0
2020-03-08,Belgium,NA,West Flanders,1196995,11,0,53,0
2020-03-09,Belgium,NA,West Flanders,1196995,3,0,56,0
2020-03-10,Belgium,NA,West Flanders,1196995,3,0,59,0
2020-03-11,Belgium,NA,West Flanders,1196995,12,0,71,0
2020-03-12,Belgium,NA,West Flanders,1196995,21,0,92,0
2020-03-13,Belgium,NA,West Flanders,1196995,24,0,116,0
2020-03-14,Belgium,NA,West Flanders,1196995,19,0,135,0
2020-03-15,Belgium,NA,West Flanders,1196995,16,0,151,0
2020-03-16,Belgium,NA,West Flanders,1196995,40,0,191,0
2020-03-17,Belgium,NA,West Flanders,1196995,56,0,247,0
2020-03-18,Belgium,NA,West Flanders,1196995,58,0,305,0
2020-03-19,Belgium,NA,West Flanders,1196995,73,0,378,0
2020-03-20,Belgium,NA,West Flanders,1196995,64,0,442,0
2020-03-21,Belgium,NA,West Flanders,1196995,37,0,479,0
2020-03-22,Belgium,NA,West Flanders,1196995,46,0,525,0
2020-03-23,Belgium,NA,West Flanders,1196995,191,0,716,0
2020-03-24,Belgium,NA,West Flanders,1196995,119,0,835,0
2020-03-25,Belgium,NA,West Flanders,1196995,148,0,983,0
2020-03-26,Belgium,NA,West Flanders,1196995,156,0,1139,0
2020-03-27,Belgium,NA,West Flanders,1196995,185,0,1324,0
2020-03-28,Belgium,NA,West Flanders,1196995,77,0,1401,0
2020-03-29,Belgium,NA,West Flanders,1196995,62,0,1463,0
2020-03-30,Belgium,NA,West Flanders,1196995,204,0,1667,0
2020-03-31,Belgium,NA,West Flanders,1196995,166,0,1833,0
2020-04-01,Belgium,NA,West Flanders,1196995,166,0,1999,0
2020-04-02,Belgium,NA,West Flanders,1196995,173,0,2172,0
2020-04-03,Belgium,NA,West Flanders,1196995,144,0,2316,0
2020-04-04,Belgium,NA,West Flanders,1196995,86,0,2402,0
2020-04-05,Belgium,NA,West Flanders,1196995,40,0,2442,0
2020-04-06,Belgium,NA,West Flanders,1196995,223,0,2665,0
2020-04-07,Belgium,NA,West Flanders,1196995,153,0,2818,0
2020-04-08,Belgium,NA,West Flanders,1196995,172,0,2990,0
2020-04-09,Belgium,NA,West Flanders,1196995,286,0,3276,0
2020-04-10,Belgium,NA,West Flanders,1196995,343,0,3619,0
2020-04-11,Belgium,NA,West Flanders,1196995,197,0,3816,0
2020-04-12,Belgium,NA,West Flanders,1196995,51,0,3867,0
2020-04-13,Belgium,NA,West Flanders,1196995,53,0,3920,0
2020-04-14,Belgium,NA,West Flanders,1196995,140,0,4060,0
2020-04-15,Belgium,NA,West Flanders,1196995,113,0,4173,0
2020-04-16,Belgium,NA,West Flanders,1196995,183,0,4356,0
2020-04-17,Belgium,NA,West Flanders,1196995,151,0,4507,0
2020-04-18,Belgium,NA,West Flanders,1196995,56,0,4563,0
2020-04-19,Belgium,NA,West Flanders,1196995,33,0,4596,0
2020-04-20,Belgium,NA,West Flanders,1196995,132,0,4728,0
2020-04-21,Belgium,NA,West Flanders,1196995,150,0,4878,0
2020-04-22,Belgium,NA,West Flanders,1196995,79,0,4957,0
2020-04-23,Belgium,NA,West Flanders,1196995,101,0,5058,0
2020-04-24,Belgium,NA,West Flanders,1196995,55,0,5113,0
2020-04-25,Belgium,NA,West Flanders,1196995,18,0,5131,0
2020-04-26,Belgium,NA,West Flanders,1196995,18,0,5149,0
2020-04-27,Belgium,NA,West Flanders,1196995,71,0,5220,0
2020-04-28,Belgium,NA,West Flanders,1196995,55,0,5275,0
2020-04-29,Belgium,NA,West Flanders,1196995,55,0,5330,0
2020-04-30,Belgium,NA,West Flanders,1196995,55,0,5385,0
2020-05-01,Belgium,NA,West Flanders,1196995,25,0,5410,0
2020-05-02,Belgium,NA,West Flanders,1196995,31,0,5441,0
2020-05-03,Belgium,NA,West Flanders,1196995,15,0,5456,0
2020-05-04,Belgium,NA,West Flanders,1196995,134,0,5590,0
2020-05-05,Belgium,NA,West Flanders,1196995,71,0,5661,0
2020-05-06,Belgium,NA,West Flanders,1196995,49,0,5710,0
2020-05-07,Belgium,NA,West Flanders,1196995,69,0,5779,0
2020-05-08,Belgium,NA,West Flanders,1196995,63,0,5842,0
2020-05-09,Belgium,NA,West Flanders,1196995,27,0,5869,0
2020-05-10,Belgium,NA,West Flanders,1196995,10,0,5879,0
2020-05-11,Belgium,NA,West Flanders,1196995,97,0,5976,0
2020-05-12,Belgium,NA,West Flanders,1196995,66,0,6042,0
2020-05-13,Belgium,NA,West Flanders,1196995,56,0,6098,0
2020-05-14,Belgium,NA,West Flanders,1196995,53,0,6151,0
2020-05-15,Belgium,NA,West Flanders,1196995,65,0,6216,0
2020-05-16,Belgium,NA,West Flanders,1196995,28,0,6244,0
2020-05-17,Belgium,NA,West Flanders,1196995,18,0,6262,0
2020-05-18,Belgium,NA,West Flanders,1196995,32,0,6294,0
2020-05-19,Belgium,NA,West Flanders,1196995,44,0,6338,0
2020-05-20,Belgium,NA,West Flanders,1196995,43,0,6381,0
2020-05-21,Belgium,NA,West Flanders,1196995,13,0,6394,0
2020-05-22,Belgium,NA,West Flanders,1196995,44,0,6438,0
2020-05-23,Belgium,NA,West Flanders,1196995,18,0,6456,0
2020-05-24,Belgium,NA,West Flanders,1196995,2,0,6458,0
2020-05-25,Belgium,NA,West Flanders,1196995,36,0,6494,0
2020-05-26,Belgium,NA,West Flanders,1196995,29,0,6523,0
2020-05-27,Belgium,NA,West Flanders,1196995,20,0,6543,0
2020-05-28,Belgium,NA,West Flanders,1196995,27,0,6570,0
2020-05-29,Belgium,NA,West Flanders,1196995,25,0,6595,0
2020-05-30,Belgium,NA,West Flanders,1196995,2,0,6597,0
2020-05-31,Belgium,NA,West Flanders,1196995,4,0,6601,0
2020-06-01,Belgium,NA,West Flanders,1196995,5,0,6606,0
2020-06-02,Belgium,NA,West Flanders,1196995,14,0,6620,0
2020-06-03,Belgium,NA,West Flanders,1196995,16,0,6636,0
2020-06-04,Belgium,NA,West Flanders,1196995,24,0,6660,0
2020-06-05,Belgium,NA,West Flanders,1196995,8,0,6668,0
2020-06-06,Belgium,NA,West Flanders,1196995,6,0,6674,0
2020-06-07,Belgium,NA,West Flanders,1196995,2,0,6676,0
2020-06-08,Belgium,NA,West Flanders,1196995,17,0,6693,0
2020-06-09,Belgium,NA,West Flanders,1196995,16,0,6709,0
2020-06-10,Belgium,NA,West Flanders,1196995,8,0,6717,0
2020-06-11,Belgium,NA,West Flanders,1196995,8,0,6725,0
2020-06-12,Belgium,NA,West Flanders,1196995,5,0,6730,0
2020-06-13,Belgium,NA,West Flanders,1196995,5,0,6735,0
2020-06-14,Belgium,NA,West Flanders,1196995,4,0,6739,0
2020-06-15,Belgium,NA,West Flanders,1196995,23,0,6762,0
2020-06-16,Belgium,NA,West Flanders,1196995,18,0,6780,0
2020-06-17,Belgium,NA,West Flanders,1196995,29,0,6809,0
2020-06-18,Belgium,NA,West Flanders,1196995,20,0,6829,0
2020-06-19,Belgium,NA,West Flanders,1196995,25,0,6854,0
2020-06-20,Belgium,NA,West Flanders,1196995,6,0,6860,0
2020-06-21,Belgium,NA,West Flanders,1196995,4,0,6864,0
2020-06-22,Belgium,NA,West Flanders,1196995,20,0,6884,0
2020-06-23,Belgium,NA,West Flanders,1196995,16,0,6900,0
2020-06-24,Belgium,NA,West Flanders,1196995,17,0,6917,0
2020-06-25,Belgium,NA,West Flanders,1196995,3,0,6920,0
2020-06-26,Belgium,NA,West Flanders,1196995,19,0,6939,0
2020-06-27,Belgium,NA,West Flanders,1196995,7,0,6946,0
2020-06-28,Belgium,NA,West Flanders,1196995,6,0,6952,0
2020-06-29,Belgium,NA,West Flanders,1196995,23,0,6975,0
2020-06-30,Belgium,NA,West Flanders,1196995,12,0,6987,0
2020-07-01,Belgium,NA,West Flanders,1196995,20,0,7007,0
2020-07-02,Belgium,NA,West Flanders,1196995,9,0,7016,0
2020-07-03,Belgium,NA,West Flanders,1196995,14,0,7030,0
2020-07-04,Belgium,NA,West Flanders,1196995,6,0,7036,0
2020-07-05,Belgium,NA,West Flanders,1196995,13,0,7049,0
2020-07-06,Belgium,NA,West Flanders,1196995,13,0,7062,0
2020-07-07,Belgium,NA,West Flanders,1196995,12,0,7074,0
2020-07-08,Belgium,NA,West Flanders,1196995,25,0,7099,0
2020-07-09,Belgium,NA,West Flanders,1196995,20,0,7119,0
2020-07-10,Belgium,NA,West Flanders,1196995,13,0,7132,0
2020-07-11,Belgium,NA,West Flanders,1196995,11,0,7143,0
2020-07-12,Belgium,NA,West Flanders,1196995,13,0,7156,0
2020-07-13,Belgium,NA,West Flanders,1196995,36,0,7192,0
2020-07-14,Belgium,NA,West Flanders,1196995,20,0,7212,0
2020-07-15,Belgium,NA,West Flanders,1196995,35,0,7247,0
2020-07-16,Belgium,NA,West Flanders,1196995,21,0,7268,0
2020-07-17,Belgium,NA,West Flanders,1196995,40,0,7308,0
2020-07-18,Belgium,NA,West Flanders,1196995,14,0,7322,0
2020-07-19,Belgium,NA,West Flanders,1196995,3,0,7325,0
2020-07-20,Belgium,NA,West Flanders,1196995,47,0,7372,0
2020-07-21,Belgium,NA,West Flanders,1196995,25,0,7397,0
2020-07-22,Belgium,NA,West Flanders,1196995,34,0,7431,0
2020-07-23,Belgium,NA,West Flanders,1196995,26,0,7457,0
2020-07-24,Belgium,NA,West Flanders,1196995,19,0,7476,0
2020-07-25,Belgium,NA,West Flanders,1196995,24,0,7500,0
2020-07-26,Belgium,NA,West Flanders,1196995,19,0,7519,0
2020-07-27,Belgium,NA,West Flanders,1196995,33,0,7552,0
2020-07-28,Belgium,NA,West Flanders,1196995,19,0,7571,0
2020-07-29,Belgium,NA,West Flanders,1196995,24,0,7595,0
2020-07-30,Belgium,NA,West Flanders,1196995,27,0,7622,0
2020-07-31,Belgium,NA,West Flanders,1196995,32,0,7654,0
2020-08-01,Belgium,NA,West Flanders,1196995,13,0,7667,0
2020-08-02,Belgium,NA,West Flanders,1196995,5,0,7672,0
2020-08-03,Belgium,NA,West Flanders,1196995,41,0,7713,0
2020-08-04,Belgium,NA,West Flanders,1196995,33,0,7746,0
2020-08-05,Belgium,NA,West Flanders,1196995,56,0,7802,0
2020-08-06,Belgium,NA,West Flanders,1196995,52,0,7854,0
2020-08-07,Belgium,NA,West Flanders,1196995,52,0,7906,0
2020-08-08,Belgium,NA,West Flanders,1196995,8,0,7914,0
2020-08-09,Belgium,NA,West Flanders,1196995,9,0,7923,0
2020-08-10,Belgium,NA,West Flanders,1196995,32,0,7955,0
2020-08-11,Belgium,NA,West Flanders,1196995,23,0,7978,0
2020-08-12,Belgium,NA,West Flanders,1196995,32,0,8010,0
2020-08-13,Belgium,NA,West Flanders,1196995,36,0,8046,0
2020-08-14,Belgium,NA,West Flanders,1196995,24,0,8070,0
2020-08-15,Belgium,NA,West Flanders,1196995,2,0,8072,0
2020-08-16,Belgium,NA,West Flanders,1196995,13,0,8085,0
2020-08-17,Belgium,NA,West Flanders,1196995,33,0,8118,0
2020-08-18,Belgium,NA,West Flanders,1196995,18,0,8136,0
2020-08-19,Belgium,NA,West Flanders,1196995,15,0,8151,0
2020-08-20,Belgium,NA,West Flanders,1196995,26,0,8177,0
2020-08-21,Belgium,NA,West Flanders,1196995,20,0,8197,0
2020-08-22,Belgium,NA,West Flanders,1196995,13,0,8210,0
2020-08-23,Belgium,NA,West Flanders,1196995,1,0,8211,0
2020-08-24,Belgium,NA,West Flanders,1196995,19,0,8230,0
2020-08-25,Belgium,NA,West Flanders,1196995,26,0,8256,0
2020-08-26,Belgium,NA,West Flanders,1196995,21,0,8277,0
2020-08-27,Belgium,NA,West Flanders,1196995,19,0,8296,0
2020-08-28,Belgium,NA,West Flanders,1196995,36,0,8332,0
2020-08-29,Belgium,NA,West Flanders,1196995,9,0,8341,0
2020-08-30,Belgium,NA,West Flanders,1196995,1,0,8342,0
2020-08-31,Belgium,NA,West Flanders,1196995,32,0,8374,0
2020-09-01,Belgium,NA,West Flanders,1196995,22,0,8396,0
2020-09-02,Belgium,NA,West Flanders,1196995,27,0,8423,0
2020-09-03,Belgium,NA,West Flanders,1196995,26,0,8449,0
2020-09-04,Belgium,NA,West Flanders,1196995,38,0,8487,0
2020-09-05,Belgium,NA,West Flanders,1196995,27,0,8514,0
2020-09-06,Belgium,NA,West Flanders,1196995,5,0,8519,0
2020-09-07,Belgium,NA,West Flanders,1196995,84,0,8603,0
2020-09-08,Belgium,NA,West Flanders,1196995,51,0,8654,0
2020-09-09,Belgium,NA,West Flanders,1196995,51,0,8705,0
2020-09-10,Belgium,NA,West Flanders,1196995,72,0,8777,0
2020-09-11,Belgium,NA,West Flanders,1196995,72,0,8849,0
2020-09-12,Belgium,NA,West Flanders,1196995,46,0,8895,0
2020-09-13,Belgium,NA,West Flanders,1196995,28,0,8923,0
2020-09-14,Belgium,NA,West Flanders,1196995,103,0,9026,0
2020-09-15,Belgium,NA,West Flanders,1196995,66,0,9092,0
2020-09-16,Belgium,NA,West Flanders,1196995,77,0,9169,0
2020-09-17,Belgium,NA,West Flanders,1196995,68,0,9237,0
2020-09-18,Belgium,NA,West Flanders,1196995,100,0,9337,0
2020-09-19,Belgium,NA,West Flanders,1196995,42,0,9379,0
2020-09-20,Belgium,NA,West Flanders,1196995,26,0,9405,0
2020-09-21,Belgium,NA,West Flanders,1196995,104,0,9509,0
2020-09-22,Belgium,NA,West Flanders,1196995,38,0,9547,0
2020-09-23,Belgium,NA,West Flanders,1196995,5,0,9552,0
2020-03-22,Brazil,NA,Acre,881935,2,0,11,0
2020-03-23,Brazil,NA,Acre,881935,0,0,11,0
2020-03-24,Brazil,NA,Acre,881935,6,0,17,0
2020-03-25,Brazil,NA,Acre,881935,6,0,23,0
2020-03-26,Brazil,NA,Acre,881935,1,0,24,0
2020-03-27,Brazil,NA,Acre,881935,1,0,25,0
2020-03-28,Brazil,NA,Acre,881935,0,0,25,0
2020-03-29,Brazil,NA,Acre,881935,9,0,34,0
2020-03-30,Brazil,NA,Acre,881935,8,0,42,0
2020-03-31,Brazil,NA,Acre,881935,0,0,42,0
2020-04-01,Brazil,NA,Acre,881935,1,0,43,0
2020-04-02,Brazil,NA,Acre,881935,0,0,43,0
2020-04-03,Brazil,NA,Acre,881935,3,0,46,0
2020-04-04,Brazil,NA,Acre,881935,0,0,46,0
2020-04-05,Brazil,NA,Acre,881935,2,0,48,0
2020-04-06,Brazil,NA,Acre,881935,2,0,50,0
2020-04-07,Brazil,NA,Acre,881935,0,1,50,1
2020-04-08,Brazil,NA,Acre,881935,4,1,54,2
2020-04-09,Brazil,NA,Acre,881935,8,0,62,2
2020-04-10,Brazil,NA,Acre,881935,8,0,70,2
2020-04-11,Brazil,NA,Acre,881935,2,0,72,2
2020-04-12,Brazil,NA,Acre,881935,5,0,77,2
2020-04-13,Brazil,NA,Acre,881935,13,1,90,3
2020-04-14,Brazil,NA,Acre,881935,9,0,99,3
2020-04-15,Brazil,NA,Acre,881935,2,0,101,3
2020-04-16,Brazil,NA,Acre,881935,9,2,110,5
2020-04-17,Brazil,NA,Acre,881935,25,0,135,5
2020-04-18,Brazil,NA,Acre,881935,7,0,142,5
2020-04-19,Brazil,NA,Acre,881935,21,1,163,6
2020-04-20,Brazil,NA,Acre,881935,13,2,176,8
2020-04-21,Brazil,NA,Acre,881935,19,0,195,8
2020-04-22,Brazil,NA,Acre,881935,19,0,214,8
2020-04-23,Brazil,NA,Acre,881935,13,2,227,10
2020-04-24,Brazil,NA,Acre,881935,7,1,234,11
2020-04-25,Brazil,NA,Acre,881935,24,0,258,11
2020-04-26,Brazil,NA,Acre,881935,21,0,279,11
2020-04-27,Brazil,NA,Acre,881935,0,3,279,14
2020-04-28,Brazil,NA,Acre,881935,32,2,311,16
2020-04-29,Brazil,NA,Acre,881935,43,1,354,17
2020-04-30,Brazil,NA,Acre,881935,50,2,404,19
2020-05-01,Brazil,NA,Acre,881935,82,0,486,19
2020-05-02,Brazil,NA,Acre,881935,67,2,553,21
2020-05-03,Brazil,NA,Acre,881935,104,3,657,24
2020-05-04,Brazil,NA,Acre,881935,76,4,733,28
2020-05-05,Brazil,NA,Acre,881935,84,1,817,29
2020-05-06,Brazil,NA,Acre,881935,126,4,943,33
2020-05-07,Brazil,NA,Acre,881935,71,3,1014,36
2020-05-08,Brazil,NA,Acre,881935,163,2,1177,38
2020-05-09,Brazil,NA,Acre,881935,158,1,1335,39
2020-05-10,Brazil,NA,Acre,881935,112,2,1447,41
2020-05-11,Brazil,NA,Acre,881935,13,4,1460,45
2020-05-12,Brazil,NA,Acre,881935,130,6,1590,51
2020-05-13,Brazil,NA,Acre,881935,104,1,1694,52
2020-05-14,Brazil,NA,Acre,881935,46,3,1740,55
2020-05-15,Brazil,NA,Acre,881935,45,2,1785,57
2020-05-16,Brazil,NA,Acre,881935,82,2,1867,59
2020-05-17,Brazil,NA,Acre,881935,130,1,1997,60
2020-05-18,Brazil,NA,Acre,881935,237,7,2234,67
2020-05-19,Brazil,NA,Acre,881935,248,5,2482,72
2020-05-20,Brazil,NA,Acre,881935,335,4,2817,76
2020-05-21,Brazil,NA,Acre,881935,286,2,3103,78
2020-05-22,Brazil,NA,Acre,881935,240,2,3343,80
2020-05-23,Brazil,NA,Acre,881935,524,7,3867,87
2020-05-24,Brazil,NA,Acre,881935,293,5,4160,92
2020-05-25,Brazil,NA,Acre,881935,341,5,4501,97
2020-05-26,Brazil,NA,Acre,881935,280,8,4781,105
2020-05-27,Brazil,NA,Acre,881935,470,8,5251,113
2020-05-28,Brazil,NA,Acre,881935,349,9,5600,122
2020-05-29,Brazil,NA,Acre,881935,241,13,5841,135
2020-05-30,Brazil,NA,Acre,881935,231,7,6072,142
2020-05-31,Brazil,NA,Acre,881935,147,6,6219,148
2020-06-01,Brazil,NA,Acre,881935,107,13,6326,161
2020-06-02,Brazil,NA,Acre,881935,139,4,6465,165
2020-06-03,Brazil,NA,Acre,881935,214,6,6679,171
2020-06-04,Brazil,NA,Acre,881935,342,10,7021,181
2020-06-05,Brazil,NA,Acre,881935,263,9,7284,190
2020-06-06,Brazil,NA,Acre,881935,241,11,7525,201
2020-06-07,Brazil,NA,Acre,881935,458,6,7983,207
2020-06-08,Brazil,NA,Acre,881935,145,4,8128,211
2020-06-09,Brazil,NA,Acre,881935,329,12,8457,223
2020-06-10,Brazil,NA,Acre,881935,289,14,8746,237
2020-06-11,Brazil,NA,Acre,881935,345,8,9091,245
2020-06-12,Brazil,NA,Acre,881935,204,9,9295,254
2020-06-13,Brazil,NA,Acre,881935,239,2,9534,256
2020-06-14,Brazil,NA,Acre,881935,108,3,9642,259
2020-06-15,Brazil,NA,Acre,881935,129,6,9771,265
2020-06-16,Brazil,NA,Acre,881935,232,6,10003,271
2020-06-17,Brazil,NA,Acre,881935,336,10,10339,281
2020-06-18,Brazil,NA,Acre,881935,325,6,10664,287
2020-06-19,Brazil,NA,Acre,881935,323,5,10987,292
2020-06-20,Brazil,NA,Acre,881935,276,5,11263,297
2020-06-21,Brazil,NA,Acre,881935,118,3,11381,300
2020-06-22,Brazil,NA,Acre,881935,158,5,11539,305
2020-06-23,Brazil,NA,Acre,881935,271,16,11810,321
2020-06-24,Brazil,NA,Acre,881935,212,5,12022,326
2020-06-25,Brazil,NA,Acre,881935,282,9,12304,335
2020-06-26,Brazil,NA,Acre,881935,340,8,12644,343
2020-06-27,Brazil,NA,Acre,881935,269,8,12913,351
2020-06-28,Brazil,NA,Acre,881935,145,2,13058,353
2020-06-29,Brazil,NA,Acre,881935,88,8,13146,361
2020-06-30,Brazil,NA,Acre,881935,107,4,13253,365
2020-07-01,Brazil,NA,Acre,881935,462,5,13715,370
2020-07-02,Brazil,NA,Acre,881935,333,8,14048,378
2020-07-03,Brazil,NA,Acre,881935,64,9,14112,387
2020-07-04,Brazil,NA,Acre,881935,375,4,14487,391
2020-07-05,Brazil,NA,Acre,881935,135,0,14622,391
2020-07-06,Brazil,NA,Acre,881935,66,3,14688,394
2020-07-07,Brazil,NA,Acre,881935,253,5,14941,399
2020-07-08,Brazil,NA,Acre,881935,226,5,15167,404
2020-07-09,Brazil,NA,Acre,881935,298,7,15465,411
2020-07-10,Brazil,NA,Acre,881935,303,6,15768,417
2020-07-11,Brazil,NA,Acre,881935,312,2,16080,419
2020-07-12,Brazil,NA,Acre,881935,110,7,16190,426
2020-07-13,Brazil,NA,Acre,881935,70,4,16260,430
2020-07-14,Brazil,NA,Acre,881935,219,6,16479,436
2020-07-15,Brazil,NA,Acre,881935,193,10,16672,446
2020-07-16,Brazil,NA,Acre,881935,193,1,16865,447
2020-07-17,Brazil,NA,Acre,881935,100,5,16965,452
2020-07-18,Brazil,NA,Acre,881935,237,5,17202,457
2020-07-19,Brazil,NA,Acre,881935,93,3,17295,460
2020-07-20,Brazil,NA,Acre,881935,167,5,17462,465
2020-07-21,Brazil,NA,Acre,881935,238,4,17700,469
2020-07-22,Brazil,NA,Acre,881935,279,1,17979,470
2020-07-23,Brazil,NA,Acre,881935,178,4,18157,474
2020-07-24,Brazil,NA,Acre,881935,236,6,18393,480
2020-07-25,Brazil,NA,Acre,881935,264,3,18657,483
2020-07-26,Brazil,NA,Acre,881935,88,3,18745,486
2020-07-27,Brazil,NA,Acre,881935,38,7,18783,493
2020-07-28,Brazil,NA,Acre,881935,349,7,19132,500
2020-07-29,Brazil,NA,Acre,881935,234,10,19366,510
2020-07-30,Brazil,NA,Acre,881935,207,11,19573,521
2020-07-31,Brazil,NA,Acre,881935,52,10,19625,531
2020-08-01,Brazil,NA,Acre,881935,305,4,19930,535
2020-08-02,Brazil,NA,Acre,881935,36,2,19966,537
2020-08-03,Brazil,NA,Acre,881935,373,2,20339,539
2020-08-04,Brazil,NA,Acre,881935,369,6,20708,545
2020-08-05,Brazil,NA,Acre,881935,325,2,21033,547
2020-08-06,Brazil,NA,Acre,881935,230,5,21263,552
2020-08-07,Brazil,NA,Acre,881935,113,4,21376,556
2020-08-08,Brazil,NA,Acre,881935,122,3,21498,559
2020-08-09,Brazil,NA,Acre,881935,89,2,21587,561
2020-08-10,Brazil,NA,Acre,881935,32,1,21619,562
2020-08-11,Brazil,NA,Acre,881935,138,3,21757,565
2020-08-12,Brazil,NA,Acre,881935,236,4,21993,569
2020-08-13,Brazil,NA,Acre,881935,249,5,22242,574
2020-08-14,Brazil,NA,Acre,881935,193,2,22435,576
2020-08-15,Brazil,NA,Acre,881935,81,0,22516,576
2020-08-16,Brazil,NA,Acre,881935,32,0,22548,576
2020-08-17,Brazil,NA,Acre,881935,57,6,22605,582
2020-08-18,Brazil,NA,Acre,881935,328,8,22933,590
2020-08-19,Brazil,NA,Acre,881935,213,1,23146,591
2020-08-20,Brazil,NA,Acre,881935,176,4,23322,595
2020-08-21,Brazil,NA,Acre,881935,15,3,23337,598
2020-08-22,Brazil,NA,Acre,881935,328,0,23665,598
2020-08-23,Brazil,NA,Acre,881935,54,2,23719,600
2020-08-24,Brazil,NA,Acre,881935,10,4,23729,604
2020-08-25,Brazil,NA,Acre,881935,207,3,23936,607
2020-08-26,Brazil,NA,Acre,881935,183,0,24119,607
2020-08-27,Brazil,NA,Acre,881935,150,0,24269,607
2020-08-28,Brazil,NA,Acre,881935,193,1,24462,608
2020-08-29,Brazil,NA,Acre,881935,139,0,24601,608
2020-08-30,Brazil,NA,Acre,881935,37,1,24638,609
2020-08-31,Brazil,NA,Acre,881935,9,3,24647,612
2020-09-01,Brazil,NA,Acre,881935,193,4,24840,616
2020-09-02,Brazil,NA,Acre,881935,187,2,25027,618
2020-09-03,Brazil,NA,Acre,881935,108,4,25135,622
2020-09-04,Brazil,NA,Acre,881935,114,1,25249,623
2020-09-05,Brazil,NA,Acre,881935,159,1,25408,624
2020-09-06,Brazil,NA,Acre,881935,35,0,25443,624
2020-09-07,Brazil,NA,Acre,881935,26,0,25469,624
2020-09-08,Brazil,NA,Acre,881935,25,6,25494,630
2020-09-09,Brazil,NA,Acre,881935,174,1,25668,631
2020-09-10,Brazil,NA,Acre,881935,209,4,25877,635
2020-09-11,Brazil,NA,Acre,881935,127,1,26004,636
2020-09-12,Brazil,NA,Acre,881935,144,1,26148,637
2020-09-13,Brazil,NA,Acre,881935,18,3,26166,640
2020-09-14,Brazil,NA,Acre,881935,10,0,26176,640
2020-09-15,Brazil,NA,Acre,881935,111,2,26287,642
2020-09-16,Brazil,NA,Acre,881935,176,1,26463,643
2020-09-17,Brazil,NA,Acre,881935,253,3,26716,646
2020-09-18,Brazil,NA,Acre,881935,226,1,26942,647
2020-09-19,Brazil,NA,Acre,881935,119,1,27061,648
2020-09-20,Brazil,NA,Acre,881935,18,1,27079,649
2020-09-21,Brazil,NA,Acre,881935,27,0,27106,649
2020-09-22,Brazil,NA,Acre,881935,140,2,27246,651
2020-09-23,Brazil,NA,Acre,881935,151,1,27397,652
2020-03-25,Brazil,NA,Alagoas,3375823,2,0,11,0
2020-03-26,Brazil,NA,Alagoas,3375823,0,0,11,0
2020-03-27,Brazil,NA,Alagoas,3375823,0,0,11,0
2020-03-28,Brazil,NA,Alagoas,3375823,3,0,14,0
2020-03-29,Brazil,NA,Alagoas,3375823,3,0,17,0
2020-03-30,Brazil,NA,Alagoas,3375823,0,0,17,0
2020-03-31,Brazil,NA,Alagoas,3375823,1,1,18,1
2020-04-01,Brazil,NA,Alagoas,3375823,0,0,18,1
2020-04-02,Brazil,NA,Alagoas,3375823,0,0,18,1
2020-04-03,Brazil,NA,Alagoas,3375823,4,1,22,2
2020-04-04,Brazil,NA,Alagoas,3375823,1,0,23,2
2020-04-05,Brazil,NA,Alagoas,3375823,5,0,28,2
2020-04-06,Brazil,NA,Alagoas,3375823,3,0,31,2
2020-04-07,Brazil,NA,Alagoas,3375823,1,0,32,2
2020-04-08,Brazil,NA,Alagoas,3375823,5,0,37,2
2020-04-09,Brazil,NA,Alagoas,3375823,0,1,37,3
2020-04-10,Brazil,NA,Alagoas,3375823,8,0,45,3
2020-04-11,Brazil,NA,Alagoas,3375823,3,0,48,3
2020-04-12,Brazil,NA,Alagoas,3375823,0,0,48,3
2020-04-13,Brazil,NA,Alagoas,3375823,2,0,50,3
2020-04-14,Brazil,NA,Alagoas,3375823,22,1,72,4
2020-04-15,Brazil,NA,Alagoas,3375823,10,1,82,5
2020-04-16,Brazil,NA,Alagoas,3375823,7,0,89,5
2020-04-17,Brazil,NA,Alagoas,3375823,21,2,110,7
2020-04-18,Brazil,NA,Alagoas,3375823,22,0,132,7
2020-04-19,Brazil,NA,Alagoas,3375823,27,8,159,15
2020-04-20,Brazil,NA,Alagoas,3375823,12,3,171,18
2020-04-21,Brazil,NA,Alagoas,3375823,39,1,210,19
2020-04-22,Brazil,NA,Alagoas,3375823,33,1,243,20
2020-04-23,Brazil,NA,Alagoas,3375823,81,2,324,22
2020-04-24,Brazil,NA,Alagoas,3375823,89,5,413,27
2020-04-25,Brazil,NA,Alagoas,3375823,88,2,501,29
2020-04-26,Brazil,NA,Alagoas,3375823,53,3,554,32
2020-04-27,Brazil,NA,Alagoas,3375823,89,2,643,34
2020-04-28,Brazil,NA,Alagoas,3375823,134,2,777,36
2020-04-29,Brazil,NA,Alagoas,3375823,180,5,957,41
2020-04-30,Brazil,NA,Alagoas,3375823,87,6,1044,47
2020-05-01,Brazil,NA,Alagoas,3375823,182,6,1226,53
2020-05-02,Brazil,NA,Alagoas,3375823,146,5,1372,58
2020-05-03,Brazil,NA,Alagoas,3375823,69,6,1441,64
2020-05-04,Brazil,NA,Alagoas,3375823,97,8,1538,72
2020-05-05,Brazil,NA,Alagoas,3375823,68,8,1606,80
2020-05-06,Brazil,NA,Alagoas,3375823,97,9,1703,89
2020-05-07,Brazil,NA,Alagoas,3375823,164,9,1867,98
2020-05-08,Brazil,NA,Alagoas,3375823,166,10,2033,108
2020-05-09,Brazil,NA,Alagoas,3375823,139,6,2172,114
2020-05-10,Brazil,NA,Alagoas,3375823,86,12,2258,126
2020-05-11,Brazil,NA,Alagoas,3375823,85,12,2343,138
2020-05-12,Brazil,NA,Alagoas,3375823,237,12,2580,150
2020-05-13,Brazil,NA,Alagoas,3375823,181,14,2761,164
2020-05-14,Brazil,NA,Alagoas,3375823,211,13,2972,177
2020-05-15,Brazil,NA,Alagoas,3375823,240,10,3212,187
2020-05-16,Brazil,NA,Alagoas,3375823,381,12,3593,199
2020-05-17,Brazil,NA,Alagoas,3375823,223,11,3816,210
2020-05-18,Brazil,NA,Alagoas,3375823,215,11,4031,221
2020-05-19,Brazil,NA,Alagoas,3375823,285,10,4316,231
2020-05-20,Brazil,NA,Alagoas,3375823,121,20,4437,251
2020-05-21,Brazil,NA,Alagoas,3375823,479,11,4916,262
2020-05-22,Brazil,NA,Alagoas,3375823,386,18,5302,280
2020-05-23,Brazil,NA,Alagoas,3375823,328,21,5630,301
2020-05-24,Brazil,NA,Alagoas,3375823,584,15,6214,316
2020-05-25,Brazil,NA,Alagoas,3375823,468,21,6682,337
2020-05-26,Brazil,NA,Alagoas,3375823,376,17,7058,354
2020-05-27,Brazil,NA,Alagoas,3375823,522,14,7580,368
2020-05-28,Brazil,NA,Alagoas,3375823,475,17,8055,385
2020-05-29,Brazil,NA,Alagoas,3375823,563,21,8618,406
2020-05-30,Brazil,NA,Alagoas,3375823,605,18,9223,424
2020-05-31,Brazil,NA,Alagoas,3375823,1065,19,10288,443
2020-06-01,Brazil,NA,Alagoas,3375823,549,18,10837,461
2020-06-02,Brazil,NA,Alagoas,3375823,722,21,11559,482
2020-06-03,Brazil,NA,Alagoas,3375823,848,24,12407,506
2020-06-04,Brazil,NA,Alagoas,3375823,690,25,13097,531
2020-06-05,Brazil,NA,Alagoas,3375823,840,26,13937,557
2020-06-06,Brazil,NA,Alagoas,3375823,881,25,14818,582
2020-06-07,Brazil,NA,Alagoas,3375823,888,19,15706,601
2020-06-08,Brazil,NA,Alagoas,3375823,0,0,15706,601
2020-06-09,Brazil,NA,Alagoas,3375823,1487,39,17193,640
2020-06-10,Brazil,NA,Alagoas,3375823,983,20,18176,660
2020-06-11,Brazil,NA,Alagoas,3375823,1024,21,19200,681
2020-06-12,Brazil,NA,Alagoas,3375823,831,20,20031,701
2020-06-13,Brazil,NA,Alagoas,3375823,856,22,20887,723
2020-06-14,Brazil,NA,Alagoas,3375823,1312,21,22199,744
2020-06-15,Brazil,NA,Alagoas,3375823,763,24,22962,768
2020-06-16,Brazil,NA,Alagoas,3375823,670,25,23632,793
2020-06-17,Brazil,NA,Alagoas,3375823,1235,18,24867,811
2020-06-18,Brazil,NA,Alagoas,3375823,766,20,25633,831
2020-06-19,Brazil,NA,Alagoas,3375823,1273,17,26906,848
2020-06-20,Brazil,NA,Alagoas,3375823,792,18,27698,866
2020-06-21,Brazil,NA,Alagoas,3375823,959,18,28657,884
2020-06-22,Brazil,NA,Alagoas,3375823,738,19,29395,903
2020-06-23,Brazil,NA,Alagoas,3375823,853,17,30248,920
2020-06-24,Brazil,NA,Alagoas,3375823,982,18,31230,938
2020-06-25,Brazil,NA,Alagoas,3375823,835,20,32065,958
2020-06-26,Brazil,NA,Alagoas,3375823,799,17,32864,975
2020-06-27,Brazil,NA,Alagoas,3375823,657,18,33521,993
2020-06-28,Brazil,NA,Alagoas,3375823,791,19,34312,1012
2020-06-29,Brazil,NA,Alagoas,3375823,805,20,35117,1032
2020-06-30,Brazil,NA,Alagoas,3375823,845,20,35962,1052
2020-07-01,Brazil,NA,Alagoas,3375823,857,20,36819,1072
2020-07-02,Brazil,NA,Alagoas,3375823,509,19,37328,1091
2020-07-03,Brazil,NA,Alagoas,3375823,1076,22,38404,1113
2020-07-04,Brazil,NA,Alagoas,3375823,851,21,39255,1134
2020-07-05,Brazil,NA,Alagoas,3375823,680,19,39935,1153
2020-07-06,Brazil,NA,Alagoas,3375823,634,19,40569,1172
2020-07-07,Brazil,NA,Alagoas,3375823,955,20,41524,1192
2020-07-08,Brazil,NA,Alagoas,3375823,798,21,42322,1213
2020-07-09,Brazil,NA,Alagoas,3375823,869,17,43191,1230
2020-07-10,Brazil,NA,Alagoas,3375823,768,16,43959,1246
2020-07-11,Brazil,NA,Alagoas,3375823,674,18,44633,1264
2020-07-12,Brazil,NA,Alagoas,3375823,697,17,45330,1281
2020-07-13,Brazil,NA,Alagoas,3375823,966,16,46296,1297
2020-07-14,Brazil,NA,Alagoas,3375823,709,17,47005,1314
2020-07-15,Brazil,NA,Alagoas,3375823,859,17,47864,1331
2020-07-16,Brazil,NA,Alagoas,3375823,870,17,48734,1348
2020-07-17,Brazil,NA,Alagoas,3375823,519,17,49253,1365
2020-07-18,Brazil,NA,Alagoas,3375823,330,16,49583,1381
2020-07-19,Brazil,NA,Alagoas,3375823,495,16,50078,1397
2020-07-20,Brazil,NA,Alagoas,3375823,229,16,50307,1413
2020-07-21,Brazil,NA,Alagoas,3375823,644,15,50951,1428
2020-07-22,Brazil,NA,Alagoas,3375823,729,15,51680,1443
2020-07-23,Brazil,NA,Alagoas,3375823,849,14,52529,1457
2020-07-24,Brazil,NA,Alagoas,3375823,1184,14,53713,1471
2020-07-25,Brazil,NA,Alagoas,3375823,1017,15,54730,1486
2020-07-26,Brazil,NA,Alagoas,3375823,646,14,55376,1500
2020-07-27,Brazil,NA,Alagoas,3375823,828,14,56204,1514
2020-07-28,Brazil,NA,Alagoas,3375823,938,13,57142,1527
2020-07-29,Brazil,NA,Alagoas,3375823,982,13,58124,1540
2020-07-30,Brazil,NA,Alagoas,3375823,855,14,58979,1554
2020-07-31,Brazil,NA,Alagoas,3375823,746,13,59725,1567
2020-08-01,Brazil,NA,Alagoas,3375823,1267,14,60992,1581
2020-08-02,Brazil,NA,Alagoas,3375823,1248,13,62240,1594
2020-08-03,Brazil,NA,Alagoas,3375823,538,13,62778,1607
2020-08-04,Brazil,NA,Alagoas,3375823,573,14,63351,1621
2020-08-05,Brazil,NA,Alagoas,3375823,843,12,64194,1633
2020-08-06,Brazil,NA,Alagoas,3375823,899,10,65093,1643
2020-08-07,Brazil,NA,Alagoas,3375823,823,11,65916,1654
2020-08-08,Brazil,NA,Alagoas,3375823,832,11,66748,1665
2020-08-09,Brazil,NA,Alagoas,3375823,865,12,67613,1677
2020-08-10,Brazil,NA,Alagoas,3375823,624,11,68237,1688
2020-08-11,Brazil,NA,Alagoas,3375823,698,12,68935,1700
2020-08-12,Brazil,NA,Alagoas,3375823,816,11,69751,1711
2020-08-13,Brazil,NA,Alagoas,3375823,878,10,70629,1721
2020-08-14,Brazil,NA,Alagoas,3375823,603,11,71232,1732
2020-08-15,Brazil,NA,Alagoas,3375823,844,10,72076,1742
2020-08-16,Brazil,NA,Alagoas,3375823,658,11,72734,1753
2020-08-17,Brazil,NA,Alagoas,3375823,204,10,72938,1763
2020-08-18,Brazil,NA,Alagoas,3375823,763,11,73701,1774
2020-08-19,Brazil,NA,Alagoas,3375823,439,10,74140,1784
2020-08-20,Brazil,NA,Alagoas,3375823,482,9,74622,1793
2020-08-21,Brazil,NA,Alagoas,3375823,217,9,74839,1802
2020-08-22,Brazil,NA,Alagoas,3375823,631,8,75470,1810
2020-08-23,Brazil,NA,Alagoas,3375823,387,8,75857,1818
2020-08-24,Brazil,NA,Alagoas,3375823,638,9,76495,1827
2020-08-25,Brazil,NA,Alagoas,3375823,399,9,76894,1836
2020-08-26,Brazil,NA,Alagoas,3375823,423,8,77317,1844
2020-08-27,Brazil,NA,Alagoas,3375823,438,9,77755,1853
2020-08-28,Brazil,NA,Alagoas,3375823,419,8,78174,1861
2020-08-29,Brazil,NA,Alagoas,3375823,309,9,78483,1870
2020-08-30,Brazil,NA,Alagoas,3375823,154,8,78637,1878
2020-08-31,Brazil,NA,Alagoas,3375823,167,9,78804,1887
2020-09-01,Brazil,NA,Alagoas,3375823,454,8,79258,1895
2020-09-02,Brazil,NA,Alagoas,3375823,292,7,79550,1902
2020-09-03,Brazil,NA,Alagoas,3375823,247,8,79797,1910
2020-09-04,Brazil,NA,Alagoas,3375823,306,7,80103,1917
2020-09-05,Brazil,NA,Alagoas,3375823,359,7,80462,1924
2020-09-06,Brazil,NA,Alagoas,3375823,255,6,80717,1930
2020-09-07,Brazil,NA,Alagoas,3375823,69,6,80786,1936
2020-09-08,Brazil,NA,Alagoas,3375823,80,7,80866,1943
2020-09-09,Brazil,NA,Alagoas,3375823,226,6,81092,1949
2020-09-10,Brazil,NA,Alagoas,3375823,238,8,81330,1957
2020-09-11,Brazil,NA,Alagoas,3375823,110,8,81440,1965
2020-09-12,Brazil,NA,Alagoas,3375823,588,7,82028,1972
2020-09-13,Brazil,NA,Alagoas,3375823,202,7,82230,1979
2020-09-14,Brazil,NA,Alagoas,3375823,102,6,82332,1985
2020-09-15,Brazil,NA,Alagoas,3375823,263,6,82595,1991
2020-09-16,Brazil,NA,Alagoas,3375823,388,5,82983,1996
2020-09-17,Brazil,NA,Alagoas,3375823,52,6,83035,2002
2020-09-18,Brazil,NA,Alagoas,3375823,263,6,83298,2008
2020-09-19,Brazil,NA,Alagoas,3375823,652,6,83950,2014
2020-09-20,Brazil,NA,Alagoas,3375823,558,5,84508,2019
2020-09-21,Brazil,NA,Alagoas,3375823,212,5,84720,2024
2020-09-22,Brazil,NA,Alagoas,3375823,288,5,85008,2029
2020-09-23,Brazil,NA,Alagoas,3375823,551,5,85559,2034
2020-04-01,Brazil,NA,Amapa,797722,1,0,11,0
2020-04-02,Brazil,NA,Amapa,797722,0,0,11,0
2020-04-03,Brazil,NA,Amapa,797722,8,0,19,0
2020-04-04,Brazil,NA,Amapa,797722,9,1,28,1
2020-04-05,Brazil,NA,Amapa,797722,1,1,29,2
2020-04-06,Brazil,NA,Amapa,797722,5,0,34,2
2020-04-07,Brazil,NA,Amapa,797722,14,0,48,2
2020-04-08,Brazil,NA,Amapa,797722,59,0,107,2
2020-04-09,Brazil,NA,Amapa,797722,21,0,128,2
2020-04-10,Brazil,NA,Amapa,797722,38,0,166,2
2020-04-11,Brazil,NA,Amapa,797722,27,1,193,3
2020-04-12,Brazil,NA,Amapa,797722,37,2,230,5
2020-04-13,Brazil,NA,Amapa,797722,12,0,242,5
2020-04-14,Brazil,NA,Amapa,797722,65,1,307,6
2020-04-15,Brazil,NA,Amapa,797722,27,1,334,7
2020-04-16,Brazil,NA,Amapa,797722,28,2,362,9
2020-04-17,Brazil,NA,Amapa,797722,8,1,370,10
2020-04-18,Brazil,NA,Amapa,797722,23,0,393,10
2020-04-19,Brazil,NA,Amapa,797722,23,1,416,11
2020-04-20,Brazil,NA,Amapa,797722,17,2,433,13
2020-04-21,Brazil,NA,Amapa,797722,24,0,457,13
2020-04-22,Brazil,NA,Amapa,797722,22,1,479,14
2020-04-23,Brazil,NA,Amapa,797722,69,2,548,16
2020-04-24,Brazil,NA,Amapa,797722,85,2,633,18
2020-04-25,Brazil,NA,Amapa,797722,52,1,685,19
2020-04-26,Brazil,NA,Amapa,797722,113,2,798,21
2020-04-27,Brazil,NA,Amapa,797722,44,5,842,26
2020-04-28,Brazil,NA,Amapa,797722,76,2,918,28
2020-04-29,Brazil,NA,Amapa,797722,98,3,1016,31
2020-04-30,Brazil,NA,Amapa,797722,64,3,1080,34
2020-05-01,Brazil,NA,Amapa,797722,41,3,1121,37
2020-05-02,Brazil,NA,Amapa,797722,66,3,1187,40
2020-05-03,Brazil,NA,Amapa,797722,295,3,1482,43
2020-05-04,Brazil,NA,Amapa,797722,251,6,1733,49
2020-05-05,Brazil,NA,Amapa,797722,198,6,1931,55
2020-05-06,Brazil,NA,Amapa,797722,115,1,2046,56
2020-05-07,Brazil,NA,Amapa,797722,153,5,2199,61
2020-05-08,Brazil,NA,Amapa,797722,123,5,2322,66
2020-05-09,Brazil,NA,Amapa,797722,171,3,2493,69
2020-05-10,Brazil,NA,Amapa,797722,120,3,2613,72
2020-05-11,Brazil,NA,Amapa,797722,58,1,2671,73
2020-05-12,Brazil,NA,Amapa,797722,239,13,2910,86
2020-05-13,Brazil,NA,Amapa,797722,95,8,3005,94
2020-05-14,Brazil,NA,Amapa,797722,423,7,3428,101
2020-05-15,Brazil,NA,Amapa,797722,202,2,3630,103
2020-05-16,Brazil,NA,Amapa,797722,204,5,3834,108
2020-05-17,Brazil,NA,Amapa,797722,118,11,3952,119
2020-05-18,Brazil,NA,Amapa,797722,71,8,4023,127
2020-05-19,Brazil,NA,Amapa,797722,287,9,4310,136
2020-05-20,Brazil,NA,Amapa,797722,239,6,4549,142
2020-05-21,Brazil,NA,Amapa,797722,639,9,5188,151
2020-05-22,Brazil,NA,Amapa,797722,467,6,5655,157
2020-05-23,Brazil,NA,Amapa,797722,436,5,6091,162
2020-05-24,Brazil,NA,Amapa,797722,262,1,6353,163
2020-05-25,Brazil,NA,Amapa,797722,231,5,6584,168
2020-05-26,Brazil,NA,Amapa,797722,383,5,6967,173
2020-05-27,Brazil,NA,Amapa,797722,652,10,7619,183
2020-05-28,Brazil,NA,Amapa,797722,533,15,8152,198
2020-05-29,Brazil,NA,Amapa,797722,317,9,8469,207
2020-05-30,Brazil,NA,Amapa,797722,844,8,9313,215
2020-05-31,Brazil,NA,Amapa,797722,289,7,9602,222
2020-06-01,Brazil,NA,Amapa,797722,288,6,9890,228
2020-06-02,Brazil,NA,Amapa,797722,621,9,10511,237
2020-06-03,Brazil,NA,Amapa,797722,596,10,11107,247
2020-06-04,Brazil,NA,Amapa,797722,444,7,11551,254
2020-06-05,Brazil,NA,Amapa,797722,776,6,12327,260
2020-06-06,Brazil,NA,Amapa,797722,446,9,12773,269
2020-06-07,Brazil,NA,Amapa,797722,272,3,13045,272
2020-06-08,Brazil,NA,Amapa,797722,249,6,13294,278
2020-06-09,Brazil,NA,Amapa,797722,477,7,13771,285
2020-06-10,Brazil,NA,Amapa,797722,852,4,14623,289
2020-06-11,Brazil,NA,Amapa,797722,543,14,15166,303
2020-06-12,Brazil,NA,Amapa,797722,517,9,15683,312
2020-06-13,Brazil,NA,Amapa,797722,639,7,16322,319
2020-06-14,Brazil,NA,Amapa,797722,190,5,16512,324
2020-06-15,Brazil,NA,Amapa,797722,301,5,16813,329
2020-06-16,Brazil,NA,Amapa,797722,1211,8,18024,337
2020-06-17,Brazil,NA,Amapa,797722,594,1,18618,338
2020-06-18,Brazil,NA,Amapa,797722,769,4,19387,342
2020-06-19,Brazil,NA,Amapa,797722,535,6,19922,348
2020-06-20,Brazil,NA,Amapa,797722,1652,5,21574,353
2020-06-21,Brazil,NA,Amapa,797722,266,6,21840,359
2020-06-22,Brazil,NA,Amapa,797722,2842,13,24682,372
2020-06-23,Brazil,NA,Amapa,797722,1755,8,26437,380
2020-06-24,Brazil,NA,Amapa,797722,482,7,26919,387
2020-06-25,Brazil,NA,Amapa,797722,496,7,27415,394
2020-06-26,Brazil,NA,Amapa,797722,247,7,27662,401
2020-06-27,Brazil,NA,Amapa,797722,239,5,27901,406
2020-06-28,Brazil,NA,Amapa,797722,84,1,27985,407
2020-06-29,Brazil,NA,Amapa,797722,268,6,28253,413
2020-06-30,Brazil,NA,Amapa,797722,239,4,28492,417
2020-07-01,Brazil,NA,Amapa,797722,435,3,28927,420
2020-07-02,Brazil,NA,Amapa,797722,226,7,29153,427
2020-07-03,Brazil,NA,Amapa,797722,421,11,29574,438
2020-07-04,Brazil,NA,Amapa,797722,235,3,29809,441
2020-07-05,Brazil,NA,Amapa,797722,74,1,29883,442
2020-07-06,Brazil,NA,Amapa,797722,121,7,30004,449
2020-07-07,Brazil,NA,Amapa,797722,290,6,30294,455
2020-07-08,Brazil,NA,Amapa,797722,230,7,30524,462
2020-07-09,Brazil,NA,Amapa,797722,239,5,30763,467
2020-07-10,Brazil,NA,Amapa,797722,317,3,31080,470
2020-07-11,Brazil,NA,Amapa,797722,199,3,31279,473
2020-07-12,Brazil,NA,Amapa,797722,85,1,31364,474
2020-07-13,Brazil,NA,Amapa,797722,188,4,31552,478
2020-07-14,Brazil,NA,Amapa,797722,333,5,31885,483
2020-07-15,Brazil,NA,Amapa,797722,523,5,32408,488
2020-07-16,Brazil,NA,Amapa,797722,596,5,33004,493
2020-07-17,Brazil,NA,Amapa,797722,432,6,33436,499
2020-07-18,Brazil,NA,Amapa,797722,149,6,33585,505
2020-07-19,Brazil,NA,Amapa,797722,120,2,33705,507
2020-07-20,Brazil,NA,Amapa,797722,440,8,34145,515
2020-07-21,Brazil,NA,Amapa,797722,260,18,34405,533
2020-07-22,Brazil,NA,Amapa,797722,255,11,34660,544
2020-07-23,Brazil,NA,Amapa,797722,178,4,34838,548
2020-07-24,Brazil,NA,Amapa,797722,188,4,35026,552
2020-07-25,Brazil,NA,Amapa,797722,136,2,35162,554
2020-07-26,Brazil,NA,Amapa,797722,58,0,35220,554
2020-07-27,Brazil,NA,Amapa,797722,144,2,35364,556
2020-07-28,Brazil,NA,Amapa,797722,333,2,35697,558
2020-07-29,Brazil,NA,Amapa,797722,276,1,35973,559
2020-07-30,Brazil,NA,Amapa,797722,299,2,36272,561
2020-07-31,Brazil,NA,Amapa,797722,196,4,36468,565
2020-08-01,Brazil,NA,Amapa,797722,127,3,36595,568
2020-08-02,Brazil,NA,Amapa,797722,44,3,36639,571
2020-08-03,Brazil,NA,Amapa,797722,165,5,36804,576
2020-08-04,Brazil,NA,Amapa,797722,195,5,36999,581
2020-08-05,Brazil,NA,Amapa,797722,319,7,37318,588
2020-08-06,Brazil,NA,Amapa,797722,417,6,37735,594
2020-08-07,Brazil,NA,Amapa,797722,229,5,37964,599
2020-08-08,Brazil,NA,Amapa,797722,175,2,38139,601
2020-08-09,Brazil,NA,Amapa,797722,69,1,38208,602
2020-08-10,Brazil,NA,Amapa,797722,191,1,38399,603
2020-08-11,Brazil,NA,Amapa,797722,237,1,38636,604
2020-08-12,Brazil,NA,Amapa,797722,165,2,38801,606
2020-08-13,Brazil,NA,Amapa,797722,214,3,39015,609
2020-08-14,Brazil,NA,Amapa,797722,229,3,39244,612
2020-08-15,Brazil,NA,Amapa,797722,187,1,39431,613
2020-08-16,Brazil,NA,Amapa,797722,87,0,39518,613
2020-08-17,Brazil,NA,Amapa,797722,185,4,39703,617
2020-08-18,Brazil,NA,Amapa,797722,254,2,39957,619
2020-08-19,Brazil,NA,Amapa,797722,254,3,40211,622
2020-08-20,Brazil,NA,Amapa,797722,392,4,40603,626
2020-08-21,Brazil,NA,Amapa,797722,272,1,40875,627
2020-08-22,Brazil,NA,Amapa,797722,156,3,41031,630
2020-08-23,Brazil,NA,Amapa,797722,89,1,41120,631
2020-08-24,Brazil,NA,Amapa,797722,134,6,41254,637
2020-08-25,Brazil,NA,Amapa,797722,299,5,41553,642
2020-08-26,Brazil,NA,Amapa,797722,428,5,41981,647
2020-08-27,Brazil,NA,Amapa,797722,304,5,42285,652
2020-08-28,Brazil,NA,Amapa,797722,340,5,42625,657
2020-08-29,Brazil,NA,Amapa,797722,146,2,42771,659
2020-08-30,Brazil,NA,Amapa,797722,121,1,42892,660
2020-08-31,Brazil,NA,Amapa,797722,301,1,43193,661
2020-09-01,Brazil,NA,Amapa,797722,321,2,43514,663
2020-09-02,Brazil,NA,Amapa,797722,286,5,43800,668
2020-09-03,Brazil,NA,Amapa,797722,264,1,44064,669
2020-09-04,Brazil,NA,Amapa,797722,390,1,44454,670
2020-09-05,Brazil,NA,Amapa,797722,228,1,44682,671
2020-09-06,Brazil,NA,Amapa,797722,88,1,44770,672
2020-09-07,Brazil,NA,Amapa,797722,93,1,44863,673
2020-09-08,Brazil,NA,Amapa,797722,136,2,44999,675
2020-09-09,Brazil,NA,Amapa,797722,252,0,45251,675
2020-09-10,Brazil,NA,Amapa,797722,278,1,45529,676
2020-09-11,Brazil,NA,Amapa,797722,136,1,45665,677
2020-09-12,Brazil,NA,Amapa,797722,124,1,45789,678
2020-09-13,Brazil,NA,Amapa,797722,64,0,45853,678
2020-09-14,Brazil,NA,Amapa,797722,102,2,45955,680
2020-09-15,Brazil,NA,Amapa,797722,162,2,46117,682
2020-09-16,Brazil,NA,Amapa,797722,149,3,46266,685
2020-09-17,Brazil,NA,Amapa,797722,106,3,46372,688
2020-09-18,Brazil,NA,Amapa,797722,229,2,46601,690
2020-09-19,Brazil,NA,Amapa,797722,137,1,46738,691
2020-09-20,Brazil,NA,Amapa,797722,125,0,46863,691
2020-09-21,Brazil,NA,Amapa,797722,83,2,46946,693
2020-09-22,Brazil,NA,Amapa,797722,189,2,47135,695
2020-09-23,Brazil,NA,Amapa,797722,229,2,47364,697
2020-03-21,Brazil,NA,Amazonas,4063614,8,0,11,0
2020-03-22,Brazil,NA,Amazonas,4063614,15,0,26,0
2020-03-23,Brazil,NA,Amazonas,4063614,6,0,32,0
2020-03-24,Brazil,NA,Amazonas,4063614,15,0,47,0
2020-03-25,Brazil,NA,Amazonas,4063614,7,1,54,1
2020-03-26,Brazil,NA,Amazonas,4063614,13,0,67,1
2020-03-27,Brazil,NA,Amazonas,4063614,14,0,81,1
2020-03-28,Brazil,NA,Amazonas,4063614,30,0,111,1
2020-03-29,Brazil,NA,Amazonas,4063614,29,0,140,1
2020-03-30,Brazil,NA,Amazonas,4063614,11,0,151,1
2020-03-31,Brazil,NA,Amazonas,4063614,24,2,175,3
2020-04-01,Brazil,NA,Amazonas,4063614,25,0,200,3
2020-04-02,Brazil,NA,Amazonas,4063614,29,0,229,3
2020-04-03,Brazil,NA,Amazonas,4063614,31,4,260,7
2020-04-04,Brazil,NA,Amazonas,4063614,51,5,311,12
2020-04-05,Brazil,NA,Amazonas,4063614,106,2,417,14
2020-04-06,Brazil,NA,Amazonas,4063614,115,5,532,19
2020-04-07,Brazil,NA,Amazonas,4063614,104,4,636,23
2020-04-08,Brazil,NA,Amazonas,4063614,168,7,804,30
2020-04-09,Brazil,NA,Amazonas,4063614,95,10,899,40
2020-04-10,Brazil,NA,Amazonas,4063614,82,10,981,50
2020-04-11,Brazil,NA,Amazonas,4063614,69,3,1050,53
2020-04-12,Brazil,NA,Amazonas,4063614,156,9,1206,62
2020-04-13,Brazil,NA,Amazonas,4063614,69,9,1275,71
2020-04-14,Brazil,NA,Amazonas,4063614,209,19,1484,90
2020-04-15,Brazil,NA,Amazonas,4063614,70,16,1554,106
2020-04-16,Brazil,NA,Amazonas,4063614,165,18,1719,124
2020-04-17,Brazil,NA,Amazonas,4063614,90,21,1809,145
2020-04-18,Brazil,NA,Amazonas,4063614,88,16,1897,161
2020-04-19,Brazil,NA,Amazonas,4063614,147,21,2044,182
2020-04-20,Brazil,NA,Amazonas,4063614,116,3,2160,185
2020-04-21,Brazil,NA,Amazonas,4063614,110,8,2270,193
2020-04-22,Brazil,NA,Amazonas,4063614,209,14,2479,207
2020-04-23,Brazil,NA,Amazonas,4063614,409,27,2888,234
2020-04-24,Brazil,NA,Amazonas,4063614,306,21,3194,255
2020-04-25,Brazil,NA,Amazonas,4063614,441,32,3635,287
2020-04-26,Brazil,NA,Amazonas,4063614,198,17,3833,304
2020-04-27,Brazil,NA,Amazonas,4063614,95,16,3928,320
2020-04-28,Brazil,NA,Amazonas,4063614,409,31,4337,351
2020-04-29,Brazil,NA,Amazonas,4063614,464,29,4801,380
2020-04-30,Brazil,NA,Amazonas,4063614,453,45,5254,425
2020-05-01,Brazil,NA,Amazonas,4063614,469,51,5723,476
2020-05-02,Brazil,NA,Amazonas,4063614,339,25,6062,501
2020-05-03,Brazil,NA,Amazonas,4063614,621,47,6683,548
2020-05-04,Brazil,NA,Amazonas,4063614,559,36,7242,584
2020-05-05,Brazil,NA,Amazonas,4063614,867,65,8109,649
2020-05-06,Brazil,NA,Amazonas,4063614,1134,102,9243,751
2020-05-07,Brazil,NA,Amazonas,4063614,856,55,10099,806
2020-05-08,Brazil,NA,Amazonas,4063614,628,68,10727,874
2020-05-09,Brazil,NA,Amazonas,4063614,1198,88,11925,962
2020-05-10,Brazil,NA,Amazonas,4063614,674,42,12599,1004
2020-05-11,Brazil,NA,Amazonas,4063614,320,31,12919,1035
2020-05-12,Brazil,NA,Amazonas,4063614,1249,63,14168,1098
2020-05-13,Brazil,NA,Amazonas,4063614,1648,62,15816,1160
2020-05-14,Brazil,NA,Amazonas,4063614,1365,75,17181,1235
2020-05-15,Brazil,NA,Amazonas,4063614,1211,96,18392,1331
2020-05-16,Brazil,NA,Amazonas,4063614,1285,44,19677,1375
2020-05-17,Brazil,NA,Amazonas,4063614,651,38,20328,1413
2020-05-18,Brazil,NA,Amazonas,4063614,585,20,20913,1433
2020-05-19,Brazil,NA,Amazonas,4063614,1219,58,22132,1491
2020-05-20,Brazil,NA,Amazonas,4063614,1572,70,23704,1561
2020-05-21,Brazil,NA,Amazonas,4063614,1663,59,25367,1620
2020-05-22,Brazil,NA,Amazonas,4063614,1671,49,27038,1669
2020-05-23,Brazil,NA,Amazonas,4063614,1764,75,28802,1744
2020-05-24,Brazil,NA,Amazonas,4063614,1065,14,29867,1758
2020-05-25,Brazil,NA,Amazonas,4063614,415,23,30282,1781
2020-05-26,Brazil,NA,Amazonas,4063614,1667,71,31949,1852
2020-05-27,Brazil,NA,Amazonas,4063614,1559,39,33508,1891
2020-05-28,Brazil,NA,Amazonas,4063614,2638,73,36146,1964
2020-05-29,Brazil,NA,Amazonas,4063614,2763,47,38909,2011
2020-05-30,Brazil,NA,Amazonas,4063614,1651,36,40560,2047
2020-05-31,Brazil,NA,Amazonas,4063614,818,5,41378,2052
2020-06-01,Brazil,NA,Amazonas,4063614,396,19,41774,2071
2020-06-02,Brazil,NA,Amazonas,4063614,1421,31,43195,2102
2020-06-03,Brazil,NA,Amazonas,4063614,1152,36,44347,2138
2020-06-04,Brazil,NA,Amazonas,4063614,2126,45,46473,2183
2020-06-05,Brazil,NA,Amazonas,4063614,1193,16,47666,2199
2020-06-06,Brazil,NA,Amazonas,4063614,1119,33,48785,2232
2020-06-07,Brazil,NA,Amazonas,4063614,484,18,49269,2250
2020-06-08,Brazil,NA,Amazonas,4063614,542,21,49811,2271
2020-06-09,Brazil,NA,Amazonas,4063614,1423,44,51234,2315
2020-06-10,Brazil,NA,Amazonas,4063614,1615,48,52849,2363
2020-06-11,Brazil,NA,Amazonas,4063614,1140,37,53989,2400
2020-06-12,Brazil,NA,Amazonas,4063614,1122,29,55111,2429
2020-06-13,Brazil,NA,Amazonas,4063614,915,36,56026,2465
2020-06-14,Brazil,NA,Amazonas,4063614,480,27,56506,2492
2020-06-15,Brazil,NA,Amazonas,4063614,271,20,56777,2512
2020-06-16,Brazil,NA,Amazonas,4063614,1241,37,58018,2549
2020-06-17,Brazil,NA,Amazonas,4063614,1529,30,59547,2579
2020-06-18,Brazil,NA,Amazonas,4063614,1189,26,60736,2605
2020-06-19,Brazil,NA,Amazonas,4063614,947,19,61683,2624
2020-06-20,Brazil,NA,Amazonas,4063614,1219,26,62902,2650
2020-06-21,Brazil,NA,Amazonas,4063614,508,7,63410,2657
2020-06-22,Brazil,NA,Amazonas,4063614,321,14,63731,2671
2020-06-23,Brazil,NA,Amazonas,4063614,1342,15,65073,2686
2020-06-24,Brazil,NA,Amazonas,4063614,1691,24,66764,2710
2020-06-25,Brazil,NA,Amazonas,4063614,503,21,67267,2731
2020-06-26,Brazil,NA,Amazonas,4063614,953,8,68220,2739
2020-06-27,Brazil,NA,Amazonas,4063614,802,33,69022,2772
2020-06-28,Brazil,NA,Amazonas,4063614,627,8,69649,2780
2020-06-29,Brazil,NA,Amazonas,4063614,244,12,69893,2792
2020-06-30,Brazil,NA,Amazonas,4063614,930,31,70823,2823
2020-07-01,Brazil,NA,Amazonas,4063614,1461,20,72284,2843
2020-07-02,Brazil,NA,Amazonas,4063614,1246,19,73530,2862
2020-07-03,Brazil,NA,Amazonas,4063614,1007,25,74537,2887
2020-07-04,Brazil,NA,Amazonas,4063614,1408,31,75945,2918
2020-07-05,Brazil,NA,Amazonas,4063614,69,11,76014,2929
2020-07-06,Brazil,NA,Amazonas,4063614,410,9,76424,2938
2020-07-07,Brazil,NA,Amazonas,4063614,2743,14,79167,2952
2020-07-08,Brazil,NA,Amazonas,4063614,915,15,80082,2967
2020-07-09,Brazil,NA,Amazonas,4063614,1236,18,81318,2985
2020-07-10,Brazil,NA,Amazonas,4063614,1189,23,82507,3008
2020-07-11,Brazil,NA,Amazonas,4063614,723,15,83230,3023
2020-07-12,Brazil,NA,Amazonas,4063614,296,16,83526,3039
2020-07-13,Brazil,NA,Amazonas,4063614,886,9,84412,3048
2020-07-14,Brazil,NA,Amazonas,4063614,1229,15,85641,3063
2020-07-15,Brazil,NA,Amazonas,4063614,1303,17,86944,3080
2020-07-16,Brazil,NA,Amazonas,4063614,1081,15,88025,3095
2020-07-17,Brazil,NA,Amazonas,4063614,797,23,88822,3118
2020-07-18,Brazil,NA,Amazonas,4063614,1712,11,90534,3129
2020-07-19,Brazil,NA,Amazonas,4063614,379,20,90913,3149
2020-07-20,Brazil,NA,Amazonas,4063614,476,0,91389,3149
2020-07-21,Brazil,NA,Amazonas,4063614,775,23,92164,3169
2020-07-22,Brazil,NA,Amazonas,4063614,557,14,92721,3183
2020-07-23,Brazil,NA,Amazonas,4063614,1498,10,94219,3193
2020-07-24,Brazil,NA,Amazonas,4063614,1205,6,95424,3199
2020-07-25,Brazil,NA,Amazonas,4063614,670,11,96094,3210
2020-07-26,Brazil,NA,Amazonas,4063614,369,7,96463,3217
2020-07-27,Brazil,NA,Amazonas,4063614,616,7,97079,3224
2020-07-28,Brazil,NA,Amazonas,4063614,1039,12,98118,3236
2020-07-29,Brazil,NA,Amazonas,4063614,975,10,99093,3246
2020-07-30,Brazil,NA,Amazonas,4063614,1047,6,100140,3252
2020-07-31,Brazil,NA,Amazonas,4063614,800,16,100940,3268
2020-08-01,Brazil,NA,Amazonas,4063614,837,10,101777,3278
2020-08-02,Brazil,NA,Amazonas,4063614,347,5,102124,3283
2020-08-03,Brazil,NA,Amazonas,4063614,262,5,102386,3288
2020-08-04,Brazil,NA,Amazonas,4063614,883,11,103269,3299
2020-08-05,Brazil,NA,Amazonas,4063614,981,18,104250,3317
2020-08-06,Brazil,NA,Amazonas,4063614,804,18,105054,3335
2020-08-07,Brazil,NA,Amazonas,4063614,803,10,105857,3345
2020-08-08,Brazil,NA,Amazonas,4063614,571,19,106428,3364
2020-08-09,Brazil,NA,Amazonas,4063614,522,0,106950,3364
2020-08-10,Brazil,NA,Amazonas,4063614,247,25,107197,3384
2020-08-11,Brazil,NA,Amazonas,4063614,908,21,108105,3405
2020-08-12,Brazil,NA,Amazonas,4063614,815,12,108920,3417
2020-08-13,Brazil,NA,Amazonas,4063614,882,18,109802,3435
2020-08-14,Brazil,NA,Amazonas,4063614,975,20,110777,3455
2020-08-15,Brazil,NA,Amazonas,4063614,464,8,111241,3463
2020-08-16,Brazil,NA,Amazonas,4063614,671,20,111912,3483
2020-08-17,Brazil,NA,Amazonas,4063614,351,22,112263,3505
2020-08-18,Brazil,NA,Amazonas,4063614,618,19,112881,3524
2020-08-19,Brazil,NA,Amazonas,4063614,711,13,113592,3537
2020-08-20,Brazil,NA,Amazonas,4063614,743,14,114335,3551
2020-08-21,Brazil,NA,Amazonas,4063614,457,5,114792,3556
2020-08-22,Brazil,NA,Amazonas,4063614,577,1,115369,3557
2020-08-23,Brazil,NA,Amazonas,4063614,246,6,115615,3563
2020-08-24,Brazil,NA,Amazonas,4063614,177,15,115792,3578
2020-08-25,Brazil,NA,Amazonas,4063614,787,10,116579,3588
2020-08-26,Brazil,NA,Amazonas,4063614,833,12,117412,3600
2020-08-27,Brazil,NA,Amazonas,4063614,671,16,118083,3616
2020-08-28,Brazil,NA,Amazonas,4063614,761,13,118844,3629
2020-08-29,Brazil,NA,Amazonas,4063614,1015,5,119859,3634
2020-08-30,Brazil,NA,Amazonas,4063614,201,5,120060,3639
2020-08-31,Brazil,NA,Amazonas,4063614,236,10,120296,3649
2020-09-01,Brazil,NA,Amazonas,4063614,623,12,120919,3661
2020-09-02,Brazil,NA,Amazonas,4063614,874,137,121793,3798
2020-09-03,Brazil,NA,Amazonas,4063614,727,30,122520,3828
2020-09-04,Brazil,NA,Amazonas,4063614,667,6,123187,3834
2020-09-05,Brazil,NA,Amazonas,4063614,539,7,123726,3841
2020-09-06,Brazil,NA,Amazonas,4063614,85,6,123811,3847
2020-09-07,Brazil,NA,Amazonas,4063614,94,2,123905,3849
2020-09-08,Brazil,NA,Amazonas,4063614,318,6,124223,3855
2020-09-09,Brazil,NA,Amazonas,4063614,736,7,124959,3862
2020-09-10,Brazil,NA,Amazonas,4063614,701,12,125660,3874
2020-09-11,Brazil,NA,Amazonas,4063614,763,9,126423,3883
2020-09-12,Brazil,NA,Amazonas,4063614,516,5,126939,3888
2020-09-13,Brazil,NA,Amazonas,4063614,193,4,127132,3892
2020-09-14,Brazil,NA,Amazonas,4063614,275,6,127407,3898
2020-09-15,Brazil,NA,Amazonas,4063614,743,9,128150,3907
2020-09-16,Brazil,NA,Amazonas,4063614,701,13,128851,3920
2020-09-17,Brazil,NA,Amazonas,4063614,650,11,129501,3931
2020-09-18,Brazil,NA,Amazonas,4063614,858,19,130359,3950
2020-09-19,Brazil,NA,Amazonas,4063614,1214,6,131573,3956
2020-09-20,Brazil,NA,Amazonas,4063614,184,3,131757,3959
2020-09-21,Brazil,NA,Amazonas,4063614,163,5,131920,3964
2020-09-22,Brazil,NA,Amazonas,4063614,767,3,132687,3967
2020-09-23,Brazil,NA,Amazonas,4063614,726,17,133413,3984
2020-03-19,Brazil,NA,Bahia,15344447,27,0,30,0
2020-03-20,Brazil,NA,Bahia,15344447,3,0,33,0
2020-03-21,Brazil,NA,Bahia,15344447,8,0,41,0
2020-03-22,Brazil,NA,Bahia,15344447,8,0,49,0
2020-03-23,Brazil,NA,Bahia,15344447,14,0,63,0
2020-03-24,Brazil,NA,Bahia,15344447,13,0,76,0
2020-03-25,Brazil,NA,Bahia,15344447,8,0,84,0
2020-03-26,Brazil,NA,Bahia,15344447,20,0,104,0
2020-03-27,Brazil,NA,Bahia,15344447,11,0,115,0
2020-03-28,Brazil,NA,Bahia,15344447,12,0,127,0
2020-03-29,Brazil,NA,Bahia,15344447,27,1,154,1
2020-03-30,Brazil,NA,Bahia,15344447,22,0,176,1
2020-03-31,Brazil,NA,Bahia,15344447,37,1,213,2
2020-04-01,Brazil,NA,Bahia,15344447,33,0,246,2
2020-04-02,Brazil,NA,Bahia,15344447,21,1,267,3
2020-04-03,Brazil,NA,Bahia,15344447,15,2,282,5
2020-04-04,Brazil,NA,Bahia,15344447,50,2,332,7
2020-04-05,Brazil,NA,Bahia,15344447,69,2,401,9
2020-04-06,Brazil,NA,Bahia,15344447,30,1,431,10
2020-04-07,Brazil,NA,Bahia,15344447,25,2,456,12
2020-04-08,Brazil,NA,Bahia,15344447,41,3,497,15
2020-04-09,Brazil,NA,Bahia,15344447,62,4,559,19
2020-04-10,Brazil,NA,Bahia,15344447,45,0,604,19
2020-04-11,Brazil,NA,Bahia,15344447,31,2,635,21
2020-04-12,Brazil,NA,Bahia,15344447,38,0,673,21
2020-04-13,Brazil,NA,Bahia,15344447,50,1,723,22
2020-04-14,Brazil,NA,Bahia,15344447,36,0,759,22
2020-04-15,Brazil,NA,Bahia,15344447,48,5,807,27
2020-04-16,Brazil,NA,Bahia,15344447,144,3,951,30
2020-04-17,Brazil,NA,Bahia,15344447,108,6,1059,36
2020-04-18,Brazil,NA,Bahia,15344447,134,1,1193,37
2020-04-19,Brazil,NA,Bahia,15344447,37,8,1230,45
2020-04-20,Brazil,NA,Bahia,15344447,111,1,1341,46
2020-04-21,Brazil,NA,Bahia,15344447,148,1,1489,47
2020-04-22,Brazil,NA,Bahia,15344447,155,3,1644,50
2020-04-23,Brazil,NA,Bahia,15344447,145,9,1789,59
2020-04-24,Brazil,NA,Bahia,15344447,173,5,1962,64
2020-04-25,Brazil,NA,Bahia,15344447,119,6,2081,70
2020-04-26,Brazil,NA,Bahia,15344447,128,3,2209,73
2020-04-27,Brazil,NA,Bahia,15344447,145,3,2354,76
2020-04-28,Brazil,NA,Bahia,15344447,186,10,2540,86
2020-04-29,Brazil,NA,Bahia,15344447,106,10,2646,96
2020-04-30,Brazil,NA,Bahia,15344447,205,8,2851,104
2020-05-01,Brazil,NA,Bahia,15344447,234,13,3085,117
2020-05-02,Brazil,NA,Bahia,15344447,182,6,3267,123
2020-05-03,Brazil,NA,Bahia,15344447,228,0,3495,123
2020-05-04,Brazil,NA,Bahia,15344447,239,18,3734,141
2020-05-05,Brazil,NA,Bahia,15344447,306,5,4040,146
2020-05-06,Brazil,NA,Bahia,15344447,261,14,4301,160
2020-05-07,Brazil,NA,Bahia,15344447,227,5,4528,165
2020-05-08,Brazil,NA,Bahia,15344447,290,18,4818,183
2020-05-09,Brazil,NA,Bahia,15344447,356,13,5174,196
2020-05-10,Brazil,NA,Bahia,15344447,384,6,5558,202
2020-05-11,Brazil,NA,Bahia,15344447,250,9,5808,211
2020-05-12,Brazil,NA,Bahia,15344447,396,14,6204,225
2020-05-13,Brazil,NA,Bahia,15344447,343,11,6547,236
2020-05-14,Brazil,NA,Bahia,15344447,408,26,6955,262
2020-05-15,Brazil,NA,Bahia,15344447,1173,19,8128,281
2020-05-16,Brazil,NA,Bahia,15344447,186,5,8314,286
2020-05-17,Brazil,NA,Bahia,15344447,129,9,8443,295
2020-05-18,Brazil,NA,Bahia,15344447,138,17,8581,312
2020-05-19,Brazil,NA,Bahia,15344447,2432,14,11013,326
2020-05-20,Brazil,NA,Bahia,15344447,184,36,11197,362
2020-05-21,Brazil,NA,Bahia,15344447,744,14,11941,376
2020-05-22,Brazil,NA,Bahia,15344447,616,23,12557,399
2020-05-23,Brazil,NA,Bahia,15344447,443,14,13000,413
2020-05-24,Brazil,NA,Bahia,15344447,899,47,13899,460
2020-05-25,Brazil,NA,Bahia,15344447,305,17,14204,477
2020-05-26,Brazil,NA,Bahia,15344447,362,18,14566,495
2020-05-27,Brazil,NA,Bahia,15344447,504,36,15070,531
2020-05-28,Brazil,NA,Bahia,15344447,893,39,15963,570
2020-05-29,Brazil,NA,Bahia,15344447,954,39,16917,609
2020-05-30,Brazil,NA,Bahia,15344447,709,29,17626,638
2020-05-31,Brazil,NA,Bahia,15344447,766,29,18392,667
2020-06-01,Brazil,NA,Bahia,15344447,506,34,18898,701
2020-06-02,Brazil,NA,Bahia,15344447,2532,35,21430,736
2020-06-03,Brazil,NA,Bahia,15344447,1021,26,22451,762
2020-06-04,Brazil,NA,Bahia,15344447,1012,28,23463,790
2020-06-05,Brazil,NA,Bahia,15344447,2956,29,26419,819
2020-06-06,Brazil,NA,Bahia,15344447,977,27,27396,846
2020-06-07,Brazil,NA,Bahia,15344447,854,33,28250,879
2020-06-08,Brazil,NA,Bahia,15344447,465,31,28715,910
2020-06-09,Brazil,NA,Bahia,15344447,1766,27,30481,937
2020-06-10,Brazil,NA,Bahia,15344447,2204,38,32685,975
2020-06-11,Brazil,NA,Bahia,15344447,1206,38,33891,1013
2020-06-12,Brazil,NA,Bahia,15344447,774,26,34665,1039
2020-06-13,Brazil,NA,Bahia,15344447,1123,30,35788,1069
2020-06-14,Brazil,NA,Bahia,15344447,613,36,36401,1105
2020-06-15,Brazil,NA,Bahia,15344447,1219,40,37620,1145
2020-06-16,Brazil,NA,Bahia,15344447,1586,36,39206,1181
2020-06-17,Brazil,NA,Bahia,15344447,1720,41,40926,1222
2020-06-18,Brazil,NA,Bahia,15344447,651,41,41577,1263
2020-06-19,Brazil,NA,Bahia,15344447,2345,42,43922,1305
2020-06-20,Brazil,NA,Bahia,15344447,1382,45,45304,1350
2020-06-21,Brazil,NA,Bahia,15344447,975,41,46279,1391
2020-06-22,Brazil,NA,Bahia,15344447,807,50,47086,1441
2020-06-23,Brazil,NA,Bahia,15344447,1998,50,49084,1491
2020-06-24,Brazil,NA,Bahia,15344447,2847,50,51931,1541
2020-06-25,Brazil,NA,Bahia,15344447,2360,60,54291,1601
2020-06-26,Brazil,NA,Bahia,15344447,2131,41,56422,1642
2020-06-27,Brazil,NA,Bahia,15344447,8822,55,65244,1697
2020-06-28,Brazil,NA,Bahia,15344447,3251,51,68495,1748
2020-06-29,Brazil,NA,Bahia,15344447,972,52,69467,1800
2020-06-30,Brazil,NA,Bahia,15344447,3840,53,73307,1853
2020-07-01,Brazil,NA,Bahia,15344447,3178,49,76485,1902
2020-07-02,Brazil,NA,Bahia,15344447,2864,45,79349,1947
2020-07-03,Brazil,NA,Bahia,15344447,2965,54,82314,2001
2020-07-04,Brazil,NA,Bahia,15344447,3171,49,85485,2050
2020-07-05,Brazil,NA,Bahia,15344447,1563,57,87048,2107
2020-07-06,Brazil,NA,Bahia,15344447,1231,61,88279,2168
2020-07-07,Brazil,NA,Bahia,15344447,3675,48,91954,2216
2020-07-08,Brazil,NA,Bahia,15344447,3582,61,95536,2277
2020-07-09,Brazil,NA,Bahia,15344447,2783,51,98319,2328
2020-07-10,Brazil,NA,Bahia,15344447,2867,55,101186,2383
2020-07-11,Brazil,NA,Bahia,15344447,3002,53,104188,2436
2020-07-12,Brazil,NA,Bahia,15344447,1575,47,105763,2483
2020-07-13,Brazil,NA,Bahia,15344447,1128,52,106891,2535
2020-07-14,Brazil,NA,Bahia,15344447,3138,49,110029,2584
2020-07-15,Brazil,NA,Bahia,15344447,2964,54,112993,2638
2020-07-16,Brazil,NA,Bahia,15344447,3380,55,116373,2693
2020-07-17,Brazil,NA,Bahia,15344447,2284,45,118657,2738
2020-07-18,Brazil,NA,Bahia,15344447,1581,55,120238,2793
2020-07-19,Brazil,NA,Bahia,15344447,1931,47,122169,2840
2020-07-20,Brazil,NA,Bahia,15344447,1123,51,123292,2891
2020-07-21,Brazil,NA,Bahia,15344447,3552,45,126844,2936
2020-07-22,Brazil,NA,Bahia,15344447,6401,52,133245,2988
2020-07-23,Brazil,NA,Bahia,15344447,5113,56,138358,3044
2020-07-24,Brazil,NA,Bahia,15344447,4409,52,142767,3096
2020-07-25,Brazil,NA,Bahia,15344447,3632,44,146399,3140
2020-07-26,Brazil,NA,Bahia,15344447,1780,42,148179,3182
2020-07-27,Brazil,NA,Bahia,15344447,930,45,149109,3227
2020-07-28,Brazil,NA,Bahia,15344447,4204,43,153313,3270
2020-07-29,Brazil,NA,Bahia,15344447,4021,51,157334,3321
2020-07-30,Brazil,NA,Bahia,15344447,4296,70,161630,3391
2020-07-31,Brazil,NA,Bahia,15344447,4524,72,166154,3463
2020-08-01,Brazil,NA,Bahia,15344447,2772,54,168926,3517
2020-08-02,Brazil,NA,Bahia,15344447,1550,55,170476,3572
2020-08-03,Brazil,NA,Bahia,15344447,915,52,171391,3624
2020-08-04,Brazil,NA,Bahia,15344447,3998,54,175389,3678
2020-08-05,Brazil,NA,Bahia,15344447,4348,58,179737,3736
2020-08-06,Brazil,NA,Bahia,15344447,3953,53,183690,3789
2020-08-07,Brazil,NA,Bahia,15344447,4202,54,187892,3843
2020-08-08,Brazil,NA,Bahia,15344447,3509,56,191401,3899
2020-08-09,Brazil,NA,Bahia,15344447,1628,54,193029,3953
2020-08-10,Brazil,NA,Bahia,15344447,1068,58,194097,4011
2020-08-11,Brazil,NA,Bahia,15344447,4670,56,198767,4067
2020-08-12,Brazil,NA,Bahia,15344447,4253,68,203020,4135
2020-08-13,Brazil,NA,Bahia,15344447,3935,67,206955,4202
2020-08-14,Brazil,NA,Bahia,15344447,4038,69,210993,4271
2020-08-15,Brazil,NA,Bahia,15344447,3386,67,214379,4338
2020-08-16,Brazil,NA,Bahia,15344447,1651,68,216030,4406
2020-08-17,Brazil,NA,Bahia,15344447,1085,69,217115,4475
2020-08-18,Brazil,NA,Bahia,15344447,3926,67,221041,4542
2020-08-19,Brazil,NA,Bahia,15344447,3618,69,224659,4611
2020-08-20,Brazil,NA,Bahia,15344447,3937,74,228596,4685
2020-08-21,Brazil,NA,Bahia,15344447,1147,72,229743,4757
2020-08-22,Brazil,NA,Bahia,15344447,4461,75,234204,4832
2020-08-23,Brazil,NA,Bahia,15344447,1846,73,236050,4905
2020-08-24,Brazil,NA,Bahia,15344447,1158,76,237208,4981
2020-08-25,Brazil,NA,Bahia,15344447,3731,70,240939,5051
2020-08-26,Brazil,NA,Bahia,15344447,4082,65,245021,5116
2020-08-27,Brazil,NA,Bahia,15344447,2832,62,247853,5178
2020-08-28,Brazil,NA,Bahia,15344447,3124,65,250977,5243
2020-08-29,Brazil,NA,Bahia,15344447,3813,59,254790,5302
2020-08-30,Brazil,NA,Bahia,15344447,1272,42,256062,5344
2020-08-31,Brazil,NA,Bahia,15344447,665,53,256727,5397
2020-09-01,Brazil,NA,Bahia,15344447,2691,51,259418,5448
2020-09-02,Brazil,NA,Bahia,15344447,2881,54,262299,5502
2020-09-03,Brazil,NA,Bahia,15344447,3440,47,265739,5549
2020-09-04,Brazil,NA,Bahia,15344447,2398,41,268137,5590
2020-09-05,Brazil,NA,Bahia,15344447,2040,37,270177,5627
2020-09-06,Brazil,NA,Bahia,15344447,1048,31,271225,5658
2020-09-07,Brazil,NA,Bahia,15344447,738,35,271963,5693
2020-09-08,Brazil,NA,Bahia,15344447,851,41,272814,5734
2020-09-09,Brazil,NA,Bahia,15344447,2274,40,275088,5774
2020-09-10,Brazil,NA,Bahia,15344447,2239,44,277327,5818
2020-09-11,Brazil,NA,Bahia,15344447,2182,48,279509,5866
2020-09-12,Brazil,NA,Bahia,15344447,2156,46,281665,5912
2020-09-13,Brazil,NA,Bahia,15344447,852,49,282517,5961
2020-09-14,Brazil,NA,Bahia,15344447,718,38,283235,5999
2020-09-15,Brazil,NA,Bahia,15344447,2213,41,285448,6040
2020-09-16,Brazil,NA,Bahia,15344447,2237,45,287685,6085
2020-09-17,Brazil,NA,Bahia,15344447,1970,47,289655,6132
2020-09-18,Brazil,NA,Bahia,15344447,2364,49,292019,6181
2020-09-19,Brazil,NA,Bahia,15344447,2191,40,294210,6221
2020-09-20,Brazil,NA,Bahia,15344447,1093,44,295303,6265
2020-09-21,Brazil,NA,Bahia,15344447,693,48,295996,6313
2020-09-22,Brazil,NA,Bahia,15344447,1809,46,297805,6359
2020-09-23,Brazil,NA,Bahia,15344447,1610,49,299415,6408
2020-03-19,Brazil,NA,Ceara,9020460,11,0,20,0
2020-03-20,Brazil,NA,Ceara,9020460,35,0,55,0
2020-03-21,Brazil,NA,Ceara,9020460,13,0,68,0
2020-03-22,Brazil,NA,Ceara,9020460,44,0,112,0
2020-03-23,Brazil,NA,Ceara,9020460,51,0,163,0
2020-03-24,Brazil,NA,Ceara,9020460,19,0,182,0
2020-03-25,Brazil,NA,Ceara,9020460,18,0,200,0
2020-03-26,Brazil,NA,Ceara,9020460,35,3,235,3
2020-03-27,Brazil,NA,Ceara,9020460,47,0,282,3
2020-03-28,Brazil,NA,Ceara,9020460,32,1,314,4
2020-03-29,Brazil,NA,Ceara,9020460,34,1,348,5
2020-03-30,Brazil,NA,Ceara,9020460,24,0,372,5
2020-03-31,Brazil,NA,Ceara,9020460,18,2,390,7
2020-04-01,Brazil,NA,Ceara,9020460,54,1,444,8
2020-04-02,Brazil,NA,Ceara,9020460,106,12,550,20
2020-04-03,Brazil,NA,Ceara,9020460,77,2,627,22
2020-04-04,Brazil,NA,Ceara,9020460,103,0,730,22
2020-04-05,Brazil,NA,Ceara,9020460,93,4,823,26
2020-04-06,Brazil,NA,Ceara,9020460,190,3,1013,29
2020-04-07,Brazil,NA,Ceara,9020460,38,2,1051,31
2020-04-08,Brazil,NA,Ceara,9020460,240,12,1291,43
2020-04-09,Brazil,NA,Ceara,9020460,134,12,1425,55
2020-04-10,Brazil,NA,Ceara,9020460,53,3,1478,58
2020-04-11,Brazil,NA,Ceara,9020460,104,9,1582,67
2020-04-12,Brazil,NA,Ceara,9020460,94,7,1676,74
2020-04-13,Brazil,NA,Ceara,9020460,124,17,1800,91
2020-04-14,Brazil,NA,Ceara,9020460,205,16,2005,107
2020-04-15,Brazil,NA,Ceara,9020460,152,9,2157,116
2020-04-16,Brazil,NA,Ceara,9020460,229,8,2386,124
2020-04-17,Brazil,NA,Ceara,9020460,298,25,2684,149
2020-04-18,Brazil,NA,Ceara,9020460,350,27,3034,176
2020-04-19,Brazil,NA,Ceara,9020460,218,10,3252,186
2020-04-20,Brazil,NA,Ceara,9020460,230,12,3482,198
2020-04-21,Brazil,NA,Ceara,9020460,234,17,3716,215
2020-04-22,Brazil,NA,Ceara,9020460,194,18,3910,233
2020-04-23,Brazil,NA,Ceara,9020460,688,33,4598,266
2020-04-24,Brazil,NA,Ceara,9020460,202,18,4800,284
2020-04-25,Brazil,NA,Ceara,9020460,621,26,5421,310
2020-04-26,Brazil,NA,Ceara,9020460,412,17,5833,327
2020-04-27,Brazil,NA,Ceara,9020460,893,63,6726,390
2020-04-28,Brazil,NA,Ceara,9020460,192,13,6918,403
2020-04-29,Brazil,NA,Ceara,9020460,349,38,7267,441
2020-04-30,Brazil,NA,Ceara,9020460,339,41,7606,482
2020-05-01,Brazil,NA,Ceara,9020460,273,23,7879,505
2020-05-02,Brazil,NA,Ceara,9020460,352,109,8231,614
2020-05-03,Brazil,NA,Ceara,9020460,139,49,8370,663
2020-05-04,Brazil,NA,Ceara,9020460,2670,49,11040,712
2020-05-05,Brazil,NA,Ceara,9020460,430,83,11470,795
2020-05-06,Brazil,NA,Ceara,9020460,834,53,12304,848
2020-05-07,Brazil,NA,Ceara,9020460,1584,55,13888,903
2020-05-08,Brazil,NA,Ceara,9020460,1068,63,14956,966
2020-05-09,Brazil,NA,Ceara,9020460,923,96,15879,1062
2020-05-10,Brazil,NA,Ceara,9020460,813,52,16692,1114
2020-05-11,Brazil,NA,Ceara,9020460,907,75,17599,1189
2020-05-12,Brazil,NA,Ceara,9020460,813,91,18412,1280
2020-05-13,Brazil,NA,Ceara,9020460,744,109,19156,1389
2020-05-14,Brazil,NA,Ceara,9020460,1921,24,21077,1413
2020-05-15,Brazil,NA,Ceara,9020460,1413,63,22490,1476
2020-05-16,Brazil,NA,Ceara,9020460,1305,138,23795,1614
2020-05-17,Brazil,NA,Ceara,9020460,460,27,24255,1641
2020-05-18,Brazil,NA,Ceara,9020460,2108,107,26363,1748
2020-05-19,Brazil,NA,Ceara,9020460,1749,108,28112,1856
2020-05-20,Brazil,NA,Ceara,9020460,2448,44,30560,1900
2020-05-21,Brazil,NA,Ceara,9020460,853,261,31413,2161
2020-05-22,Brazil,NA,Ceara,9020460,3160,90,34573,2251
2020-05-23,Brazil,NA,Ceara,9020460,549,57,35122,2308
2020-05-24,Brazil,NA,Ceara,9020460,473,16,35595,2324
2020-05-25,Brazil,NA,Ceara,9020460,590,169,36185,2493
2020-05-26,Brazil,NA,Ceara,9020460,836,110,37021,2603
2020-05-27,Brazil,NA,Ceara,9020460,254,68,37275,2671
2020-05-28,Brazil,NA,Ceara,9020460,546,62,37821,2733
2020-05-29,Brazil,NA,Ceara,9020460,574,126,38395,2859
2020-05-30,Brazil,NA,Ceara,9020460,8111,97,46506,2956
2020-05-31,Brazil,NA,Ceara,9020460,1983,54,48489,3010
2020-06-01,Brazil,NA,Ceara,9020460,2015,178,50504,3188
2020-06-02,Brazil,NA,Ceara,9020460,2569,233,53073,3421
2020-06-03,Brazil,NA,Ceara,9020460,2983,184,56056,3605
2020-06-04,Brazil,NA,Ceara,9020460,3739,208,59795,3813
2020-06-05,Brazil,NA,Ceara,9020460,1800,77,61595,3890
2020-06-06,Brazil,NA,Ceara,9020460,1980,75,63575,3965
2020-06-07,Brazil,NA,Ceara,9020460,696,17,64271,3982
2020-06-08,Brazil,NA,Ceara,9020460,1334,138,65605,4120
2020-06-09,Brazil,NA,Ceara,9020460,2779,189,68384,4309
2020-06-10,Brazil,NA,Ceara,9020460,3018,171,71402,4480
2020-06-11,Brazil,NA,Ceara,9020460,2477,183,73879,4663
2020-06-12,Brazil,NA,Ceara,9020460,1826,125,75705,4788
2020-06-13,Brazil,NA,Ceara,9020460,724,41,76429,4829
2020-06-14,Brazil,NA,Ceara,9020460,319,32,76748,4861
2020-06-15,Brazil,NA,Ceara,9020460,2714,138,79462,4999
2020-06-16,Brazil,NA,Ceara,9020460,1827,71,81289,5070
2020-06-17,Brazil,NA,Ceara,9020460,3678,212,84967,5282
2020-06-18,Brazil,NA,Ceara,9020460,2306,95,87273,5377
2020-06-19,Brazil,NA,Ceara,9020460,2590,83,89863,5460
2020-06-20,Brazil,NA,Ceara,9020460,2293,58,92156,5518
2020-06-21,Brazil,NA,Ceara,9020460,710,5,92866,5523
2020-06-22,Brazil,NA,Ceara,9020460,1292,81,94158,5604
2020-06-23,Brazil,NA,Ceara,9020460,3370,113,97528,5717
2020-06-24,Brazil,NA,Ceara,9020460,2050,98,99578,5815
2020-06-25,Brazil,NA,Ceara,9020460,2548,60,102126,5875
2020-06-26,Brazil,NA,Ceara,9020460,2296,45,104422,5920
2020-06-27,Brazil,NA,Ceara,9020460,2206,61,106628,5981
2020-06-28,Brazil,NA,Ceara,9020460,940,9,107568,5990
2020-06-29,Brazil,NA,Ceara,9020460,657,86,108225,6076
2020-06-30,Brazil,NA,Ceara,9020460,474,70,108699,6146
2020-07-01,Brazil,NA,Ceara,9020460,4318,34,113017,6180
2020-07-02,Brazil,NA,Ceara,9020460,2507,104,115524,6284
2020-07-03,Brazil,NA,Ceara,9020460,2517,67,118041,6351
2020-07-04,Brazil,NA,Ceara,9020460,2911,60,120952,6411
2020-07-05,Brazil,NA,Ceara,9020460,512,30,121464,6441
2020-07-06,Brazil,NA,Ceara,9020460,1013,40,122477,6481
2020-07-07,Brazil,NA,Ceara,9020460,2475,75,124952,6556
2020-07-08,Brazil,NA,Ceara,9020460,3519,109,128471,6665
2020-07-09,Brazil,NA,Ceara,9020460,2529,76,131000,6741
2020-07-10,Brazil,NA,Ceara,9020460,2546,36,133546,6777
2020-07-11,Brazil,NA,Ceara,9020460,2399,76,135945,6853
2020-07-12,Brazil,NA,Ceara,9020460,840,15,136785,6868
2020-07-13,Brazil,NA,Ceara,9020460,421,79,137206,6947
2020-07-14,Brazil,NA,Ceara,9020460,2231,30,139437,6977
2020-07-15,Brazil,NA,Ceara,9020460,1811,53,141248,7030
2020-07-16,Brazil,NA,Ceara,9020460,2752,97,144000,7127
2020-07-17,Brazil,NA,Ceara,9020460,1938,38,145938,7165
2020-07-18,Brazil,NA,Ceara,9020460,606,8,146544,7173
2020-07-19,Brazil,NA,Ceara,9020460,428,5,146972,7178
2020-07-20,Brazil,NA,Ceara,9020460,594,7,147566,7185
2020-07-21,Brazil,NA,Ceara,9020460,1420,99,148986,7284
2020-07-22,Brazil,NA,Ceara,9020460,4122,33,153108,7317
2020-07-23,Brazil,NA,Ceara,9020460,3134,57,156242,7374
2020-07-24,Brazil,NA,Ceara,9020460,2582,52,158824,7426
2020-07-25,Brazil,NA,Ceara,9020460,2773,50,161597,7476
2020-07-26,Brazil,NA,Ceara,9020460,488,17,162085,7493
2020-07-27,Brazil,NA,Ceara,9020460,344,16,162429,7509
2020-07-28,Brazil,NA,Ceara,9020460,3121,104,165550,7613
2020-07-29,Brazil,NA,Ceara,9020460,3522,30,169072,7643
2020-07-30,Brazil,NA,Ceara,9020460,2396,18,171468,7661
2020-07-31,Brazil,NA,Ceara,9020460,2414,7,173882,7668
2020-08-01,Brazil,NA,Ceara,9020460,2046,30,175928,7698
2020-08-02,Brazil,NA,Ceara,9020460,652,11,176580,7709
2020-08-03,Brazil,NA,Ceara,9020460,381,43,176961,7752
2020-08-04,Brazil,NA,Ceara,9020460,2380,54,179341,7806
2020-08-05,Brazil,NA,Ceara,9020460,2102,61,181443,7867
2020-08-06,Brazil,NA,Ceara,9020460,1858,26,183301,7893
2020-08-07,Brazil,NA,Ceara,9020460,2108,28,185409,7921
2020-08-08,Brazil,NA,Ceara,9020460,2835,30,188244,7951
2020-08-09,Brazil,NA,Ceara,9020460,298,3,188542,7954
2020-08-10,Brazil,NA,Ceara,9020460,115,25,188657,7979
2020-08-11,Brazil,NA,Ceara,9020460,1893,32,190550,8011
2020-08-12,Brazil,NA,Ceara,9020460,1872,41,192422,8052
2020-08-13,Brazil,NA,Ceara,9020460,1659,36,194081,8088
2020-08-14,Brazil,NA,Ceara,9020460,2063,35,196144,8123
2020-08-15,Brazil,NA,Ceara,9020460,1237,6,197381,8129
2020-08-16,Brazil,NA,Ceara,9020460,238,4,197619,8133
2020-08-17,Brazil,NA,Ceara,9020460,583,30,198202,8163
2020-08-18,Brazil,NA,Ceara,9020460,1056,33,199258,8196
2020-08-19,Brazil,NA,Ceara,9020460,1943,45,201201,8241
2020-08-20,Brazil,NA,Ceara,9020460,1221,4,202422,8245
2020-08-21,Brazil,NA,Ceara,9020460,577,23,202999,8268
2020-08-22,Brazil,NA,Ceara,9020460,1588,18,204587,8286
2020-08-23,Brazil,NA,Ceara,9020460,854,3,205441,8289
2020-08-24,Brazil,NA,Ceara,9020460,123,3,205564,8292
2020-08-25,Brazil,NA,Ceara,9020460,1822,47,207386,8339
2020-08-26,Brazil,NA,Ceara,9020460,1396,12,208782,8351
2020-08-27,Brazil,NA,Ceara,9020460,1945,14,210727,8365
2020-08-28,Brazil,NA,Ceara,9020460,1757,11,212484,8376
2020-08-29,Brazil,NA,Ceara,9020460,1610,6,214094,8382
2020-08-30,Brazil,NA,Ceara,9020460,363,2,214457,8384
2020-08-31,Brazil,NA,Ceara,9020460,496,25,214953,8409
2020-09-01,Brazil,NA,Ceara,9020460,1380,38,216333,8447
2020-09-02,Brazil,NA,Ceara,9020460,2063,33,218396,8480
2020-09-03,Brazil,NA,Ceara,9020460,1276,13,219672,8493
2020-09-04,Brazil,NA,Ceara,9020460,10433,62,230105,8555
2020-09-05,Brazil,NA,Ceara,9020460,0,10,230105,8565
2020-09-06,Brazil,NA,Ceara,9020460,193,0,230105,8565
2020-09-07,Brazil,NA,Ceara,9020460,73,1,230105,8566
2020-09-08,Brazil,NA,Ceara,9020460,132,1,230105,8567
2020-09-09,Brazil,NA,Ceara,9020460,1045,37,230105,8604
2020-09-10,Brazil,NA,Ceara,9020460,1137,35,230105,8639
2020-09-11,Brazil,NA,Ceara,9020460,1119,27,230105,8666
2020-09-12,Brazil,NA,Ceara,9020460,1197,19,230105,8685
2020-09-13,Brazil,NA,Ceara,9020460,374,1,230105,8686
2020-09-14,Brazil,NA,Ceara,9020460,350,12,230105,8698
2020-09-15,Brazil,NA,Ceara,9020460,1273,41,230105,8739
2020-09-16,Brazil,NA,Ceara,9020460,1334,25,230406,8764
2020-09-17,Brazil,NA,Ceara,9020460,1032,10,231438,8774
2020-09-18,Brazil,NA,Ceara,9020460,1164,16,232602,8790
2020-09-19,Brazil,NA,Ceara,9020460,998,11,233600,8801
2020-09-20,Brazil,NA,Ceara,9020460,218,12,233818,8813
2020-09-21,Brazil,NA,Ceara,9020460,302,21,234120,8834
2020-09-22,Brazil,NA,Ceara,9020460,1102,16,235222,8850
2020-09-23,Brazil,NA,Ceara,9020460,878,11,236100,8861
2020-03-16,Brazil,NA,Distrito Federal,3039444,5,0,13,0
2020-03-17,Brazil,NA,Distrito Federal,3039444,9,0,22,0
2020-03-18,Brazil,NA,Distrito Federal,3039444,4,0,26,0
2020-03-19,Brazil,NA,Distrito Federal,3039444,16,0,42,0
2020-03-20,Brazil,NA,Distrito Federal,3039444,45,0,87,0
2020-03-21,Brazil,NA,Distrito Federal,3039444,13,0,100,0
2020-03-22,Brazil,NA,Distrito Federal,3039444,17,0,117,0
2020-03-23,Brazil,NA,Distrito Federal,3039444,16,0,133,0
2020-03-24,Brazil,NA,Distrito Federal,3039444,27,0,160,0
2020-03-25,Brazil,NA,Distrito Federal,3039444,0,0,160,0
2020-03-26,Brazil,NA,Distrito Federal,3039444,40,0,200,0
2020-03-27,Brazil,NA,Distrito Federal,3039444,30,0,230,0
2020-03-28,Brazil,NA,Distrito Federal,3039444,30,0,260,0
2020-03-29,Brazil,NA,Distrito Federal,3039444,29,1,289,1
2020-03-30,Brazil,NA,Distrito Federal,3039444,23,0,312,1
2020-03-31,Brazil,NA,Distrito Federal,3039444,20,2,332,3
2020-04-01,Brazil,NA,Distrito Federal,3039444,23,0,355,3
2020-04-02,Brazil,NA,Distrito Federal,3039444,15,1,370,4
2020-04-03,Brazil,NA,Distrito Federal,3039444,32,1,402,5
2020-04-04,Brazil,NA,Distrito Federal,3039444,52,2,454,7
2020-04-05,Brazil,NA,Distrito Federal,3039444,14,0,468,7
2020-04-06,Brazil,NA,Distrito Federal,3039444,5,3,473,10
2020-04-07,Brazil,NA,Distrito Federal,3039444,19,2,492,12
2020-04-08,Brazil,NA,Distrito Federal,3039444,17,0,509,12
2020-04-09,Brazil,NA,Distrito Federal,3039444,18,1,527,13
2020-04-10,Brazil,NA,Distrito Federal,3039444,28,1,555,14
2020-04-11,Brazil,NA,Distrito Federal,3039444,24,0,579,14
2020-04-12,Brazil,NA,Distrito Federal,3039444,35,0,614,14
2020-04-13,Brazil,NA,Distrito Federal,3039444,24,1,638,15
2020-04-14,Brazil,NA,Distrito Federal,3039444,13,2,651,17
2020-04-15,Brazil,NA,Distrito Federal,3039444,31,0,682,17
2020-04-16,Brazil,NA,Distrito Federal,3039444,34,3,716,20
2020-04-17,Brazil,NA,Distrito Federal,3039444,30,0,746,20
2020-04-18,Brazil,NA,Distrito Federal,3039444,16,4,762,24
2020-04-19,Brazil,NA,Distrito Federal,3039444,65,0,827,24
2020-04-20,Brazil,NA,Distrito Federal,3039444,45,0,872,24
2020-04-21,Brazil,NA,Distrito Federal,3039444,9,0,881,24
2020-04-22,Brazil,NA,Distrito Federal,3039444,65,1,946,25
2020-04-23,Brazil,NA,Distrito Federal,3039444,17,0,963,25
2020-04-24,Brazil,NA,Distrito Federal,3039444,26,1,989,26
2020-04-25,Brazil,NA,Distrito Federal,3039444,24,0,1013,26
2020-04-26,Brazil,NA,Distrito Federal,3039444,53,1,1066,27
2020-04-27,Brazil,NA,Distrito Federal,3039444,80,0,1146,27
2020-04-28,Brazil,NA,Distrito Federal,3039444,67,1,1213,28
2020-04-29,Brazil,NA,Distrito Federal,3039444,62,0,1275,28
2020-04-30,Brazil,NA,Distrito Federal,3039444,81,2,1356,30
2020-05-01,Brazil,NA,Distrito Federal,3039444,110,0,1466,30
2020-05-02,Brazil,NA,Distrito Federal,3039444,100,1,1566,31
2020-05-03,Brazil,NA,Distrito Federal,3039444,83,2,1649,33
2020-05-04,Brazil,NA,Distrito Federal,3039444,119,0,1768,33
2020-05-05,Brazil,NA,Distrito Federal,3039444,50,0,1818,33
2020-05-06,Brazil,NA,Distrito Federal,3039444,88,1,1906,34
2020-05-07,Brazil,NA,Distrito Federal,3039444,352,1,2258,35
2020-05-08,Brazil,NA,Distrito Federal,3039444,184,2,2442,37
2020-05-09,Brazil,NA,Distrito Federal,3039444,134,2,2576,39
2020-05-10,Brazil,NA,Distrito Federal,3039444,106,3,2682,42
2020-05-11,Brazil,NA,Distrito Federal,3039444,101,2,2783,44
2020-05-12,Brazil,NA,Distrito Federal,3039444,196,2,2979,46
2020-05-13,Brazil,NA,Distrito Federal,3039444,213,2,3192,48
2020-05-14,Brazil,NA,Distrito Federal,3039444,224,3,3416,51
2020-05-15,Brazil,NA,Distrito Federal,3039444,371,4,3787,55
2020-05-16,Brazil,NA,Distrito Federal,3039444,353,1,4140,56
2020-05-17,Brazil,NA,Distrito Federal,3039444,228,3,4368,59
2020-05-18,Brazil,NA,Distrito Federal,3039444,251,7,4619,66
2020-05-19,Brazil,NA,Distrito Federal,3039444,234,6,4853,72
2020-05-20,Brazil,NA,Distrito Federal,3039444,308,5,5161,77
2020-05-21,Brazil,NA,Distrito Federal,3039444,381,7,5542,84
2020-05-22,Brazil,NA,Distrito Federal,3039444,406,6,5948,90
2020-05-23,Brazil,NA,Distrito Federal,3039444,303,5,6251,95
2020-05-24,Brazil,NA,Distrito Federal,3039444,387,9,6638,104
2020-05-25,Brazil,NA,Distrito Federal,3039444,292,10,6930,114
2020-05-26,Brazil,NA,Distrito Federal,3039444,280,10,7210,124
2020-05-27,Brazil,NA,Distrito Federal,3039444,551,9,7761,133
2020-05-28,Brazil,NA,Distrito Federal,3039444,539,9,8300,142
2020-05-29,Brazil,NA,Distrito Federal,3039444,422,12,8722,154
2020-05-30,Brazil,NA,Distrito Federal,3039444,752,8,9474,162
2020-05-31,Brazil,NA,Distrito Federal,3039444,306,8,9780,170
2020-06-01,Brazil,NA,Distrito Federal,3039444,730,1,10510,171
2020-06-02,Brazil,NA,Distrito Federal,3039444,746,6,11256,177
2020-06-03,Brazil,NA,Distrito Federal,3039444,764,14,12020,191
2020-06-04,Brazil,NA,Distrito Federal,3039444,903,5,12923,196
2020-06-05,Brazil,NA,Distrito Federal,3039444,1285,6,14208,202
2020-06-06,Brazil,NA,Distrito Federal,3039444,1642,6,15850,208
2020-06-07,Brazil,NA,Distrito Federal,3039444,773,6,16623,214
2020-06-08,Brazil,NA,Distrito Federal,3039444,6,0,16629,214
2020-06-09,Brazil,NA,Distrito Federal,3039444,1461,22,18090,236
2020-06-10,Brazil,NA,Distrito Federal,3039444,1343,20,19433,256
2020-06-11,Brazil,NA,Distrito Federal,3039444,1074,18,20507,274
2020-06-12,Brazil,NA,Distrito Federal,3039444,889,8,21396,282
2020-06-13,Brazil,NA,Distrito Federal,3039444,563,11,21959,293
2020-06-14,Brazil,NA,Distrito Federal,3039444,912,11,22871,304
2020-06-15,Brazil,NA,Distrito Federal,3039444,813,15,23684,319
2020-06-16,Brazil,NA,Distrito Federal,3039444,1696,29,25380,348
2020-06-17,Brazil,NA,Distrito Federal,3039444,1760,17,27140,365
2020-06-18,Brazil,NA,Distrito Federal,3039444,1381,14,28521,379
2020-06-19,Brazil,NA,Distrito Federal,3039444,2381,17,30902,396
2020-06-20,Brazil,NA,Distrito Federal,3039444,1336,8,32238,404
2020-06-21,Brazil,NA,Distrito Federal,3039444,989,19,33227,423
2020-06-22,Brazil,NA,Distrito Federal,3039444,921,26,34148,449
2020-06-23,Brazil,NA,Distrito Federal,3039444,1220,26,35368,475
2020-06-24,Brazil,NA,Distrito Federal,3039444,1886,20,37254,495
2020-06-25,Brazil,NA,Distrito Federal,3039444,1617,14,38871,509
2020-06-26,Brazil,NA,Distrito Federal,3039444,2455,23,41326,532
2020-06-27,Brazil,NA,Distrito Federal,3039444,1440,5,42766,537
2020-06-28,Brazil,NA,Distrito Federal,3039444,2139,11,44905,548
2020-06-29,Brazil,NA,Distrito Federal,3039444,2166,11,47071,559
2020-06-30,Brazil,NA,Distrito Federal,3039444,2147,28,49218,587
2020-07-01,Brazil,NA,Distrito Federal,3039444,1458,33,50676,620
2020-07-02,Brazil,NA,Distrito Federal,3039444,1605,11,52281,631
2020-07-03,Brazil,NA,Distrito Federal,3039444,1715,12,53996,643
2020-07-04,Brazil,NA,Distrito Federal,3039444,1764,28,55760,671
2020-07-05,Brazil,NA,Distrito Federal,3039444,2094,28,57854,699
2020-07-06,Brazil,NA,Distrito Federal,3039444,2529,27,60383,726
2020-07-07,Brazil,NA,Distrito Federal,3039444,2311,41,62694,767
2020-07-08,Brazil,NA,Distrito Federal,3039444,1620,34,64314,801
2020-07-09,Brazil,NA,Distrito Federal,3039444,1363,22,65677,823
2020-07-10,Brazil,NA,Distrito Federal,3039444,1620,33,67297,856
2020-07-11,Brazil,NA,Distrito Federal,3039444,1109,15,68406,871
2020-07-12,Brazil,NA,Distrito Federal,3039444,2306,31,70712,902
2020-07-13,Brazil,NA,Distrito Federal,3039444,1572,28,72284,930
2020-07-14,Brazil,NA,Distrito Federal,3039444,1370,30,73654,960
2020-07-15,Brazil,NA,Distrito Federal,3039444,1725,41,75379,1001
2020-07-16,Brazil,NA,Distrito Federal,3039444,2242,36,77621,1037
2020-07-17,Brazil,NA,Distrito Federal,3039444,1779,23,79400,1060
2020-07-18,Brazil,NA,Distrito Federal,3039444,1763,15,81163,1075
2020-07-19,Brazil,NA,Distrito Federal,3039444,1249,10,82412,1085
2020-07-20,Brazil,NA,Distrito Federal,3039444,1875,27,84287,1112
2020-07-21,Brazil,NA,Distrito Federal,3039444,1789,46,86076,1158
2020-07-22,Brazil,NA,Distrito Federal,3039444,1725,18,87801,1176
2020-07-23,Brazil,NA,Distrito Federal,3039444,2222,42,90023,1218
2020-07-24,Brazil,NA,Distrito Federal,3039444,2391,26,92414,1244
2020-07-25,Brazil,NA,Distrito Federal,3039444,1773,31,94187,1275
2020-07-26,Brazil,NA,Distrito Federal,3039444,2145,33,96332,1308
2020-07-27,Brazil,NA,Distrito Federal,3039444,2148,31,98480,1339
2020-07-28,Brazil,NA,Distrito Federal,3039444,2246,52,100726,1391
2020-07-29,Brazil,NA,Distrito Federal,3039444,1616,28,102342,1419
2020-07-30,Brazil,NA,Distrito Federal,3039444,2100,25,104442,1444
2020-07-31,Brazil,NA,Distrito Federal,3039444,1850,25,106292,1469
2020-08-01,Brazil,NA,Distrito Federal,3039444,1630,21,107922,1490
2020-08-02,Brazil,NA,Distrito Federal,3039444,2106,33,110028,1523
2020-08-03,Brazil,NA,Distrito Federal,3039444,2016,23,112044,1546
2020-08-04,Brazil,NA,Distrito Federal,3039444,1880,26,113924,1572
2020-08-05,Brazil,NA,Distrito Federal,3039444,2042,0,115966,1572
2020-08-06,Brazil,NA,Distrito Federal,3039444,2034,79,118000,1651
2020-08-07,Brazil,NA,Distrito Federal,3039444,1903,31,119903,1682
2020-08-08,Brazil,NA,Distrito Federal,3039444,1921,30,121824,1712
2020-08-09,Brazil,NA,Distrito Federal,3039444,1233,19,123057,1731
2020-08-10,Brazil,NA,Distrito Federal,3039444,3012,31,126069,1762
2020-08-11,Brazil,NA,Distrito Federal,3039444,1415,53,127484,1815
2020-08-12,Brazil,NA,Distrito Federal,3039444,1700,55,129184,1870
2020-08-13,Brazil,NA,Distrito Federal,3039444,1986,35,131170,1905
2020-08-14,Brazil,NA,Distrito Federal,3039444,1996,30,133166,1935
2020-08-15,Brazil,NA,Distrito Federal,3039444,1848,23,135014,1958
2020-08-16,Brazil,NA,Distrito Federal,3039444,1453,18,136467,1976
2020-08-17,Brazil,NA,Distrito Federal,3039444,2268,66,138735,2042
2020-08-18,Brazil,NA,Distrito Federal,3039444,1435,55,140170,2097
2020-08-19,Brazil,NA,Distrito Federal,3039444,1592,51,141762,2148
2020-08-20,Brazil,NA,Distrito Federal,3039444,1997,52,143759,2200
2020-08-21,Brazil,NA,Distrito Federal,3039444,1693,42,145452,2242
2020-08-22,Brazil,NA,Distrito Federal,3039444,1675,15,147127,2257
2020-08-23,Brazil,NA,Distrito Federal,3039444,1871,17,148998,2274
2020-08-24,Brazil,NA,Distrito Federal,3039444,1521,42,150519,2316
2020-08-25,Brazil,NA,Distrito Federal,3039444,3171,28,153690,2344
2020-08-26,Brazil,NA,Distrito Federal,3039444,1563,55,155253,2399
2020-08-27,Brazil,NA,Distrito Federal,3039444,1610,26,156863,2425
2020-08-28,Brazil,NA,Distrito Federal,3039444,1317,15,158180,2440
2020-08-29,Brazil,NA,Distrito Federal,3039444,1346,10,159526,2450
2020-08-30,Brazil,NA,Distrito Federal,3039444,1270,19,160796,2469
2020-08-31,Brazil,NA,Distrito Federal,3039444,1246,52,162042,2521
2020-09-01,Brazil,NA,Distrito Federal,3039444,1456,52,163498,2573
2020-09-02,Brazil,NA,Distrito Federal,3039444,1151,36,164649,2609
2020-09-03,Brazil,NA,Distrito Federal,3039444,1254,32,165903,2641
2020-09-04,Brazil,NA,Distrito Federal,3039444,1297,40,167200,2681
2020-09-05,Brazil,NA,Distrito Federal,3039444,1405,19,168605,2700
2020-09-06,Brazil,NA,Distrito Federal,3039444,1012,10,169617,2710
2020-09-07,Brazil,NA,Distrito Federal,3039444,1189,10,170806,2720
2020-09-08,Brazil,NA,Distrito Federal,3039444,933,43,171739,2763
2020-09-09,Brazil,NA,Distrito Federal,3039444,969,50,172708,2813
2020-09-10,Brazil,NA,Distrito Federal,3039444,923,30,173631,2843
2020-09-11,Brazil,NA,Distrito Federal,3039444,918,24,174549,2867
2020-09-12,Brazil,NA,Distrito Federal,3039444,1097,16,175646,2883
2020-09-13,Brazil,NA,Distrito Federal,3039444,1191,16,176837,2899
2020-09-14,Brazil,NA,Distrito Federal,3039444,1084,31,177921,2930
2020-09-15,Brazil,NA,Distrito Federal,3039444,826,40,178747,2970
2020-09-16,Brazil,NA,Distrito Federal,3039444,1076,30,179823,3000
2020-09-17,Brazil,NA,Distrito Federal,3039444,1021,22,180844,3022
2020-09-18,Brazil,NA,Distrito Federal,3039444,1075,15,181919,3037
2020-09-19,Brazil,NA,Distrito Federal,3039444,1177,11,183096,3048
2020-09-20,Brazil,NA,Distrito Federal,3039444,653,14,183749,3062
2020-09-21,Brazil,NA,Distrito Federal,3039444,806,35,184555,3097
2020-09-22,Brazil,NA,Distrito Federal,3039444,794,34,185349,3131
2020-09-23,Brazil,NA,Distrito Federal,3039444,703,17,186052,3148
2020-03-19,Brazil,NA,Espirito Santo,3885049,2,0,11,0
2020-03-20,Brazil,NA,Espirito Santo,3885049,2,0,13,0
2020-03-21,Brazil,NA,Espirito Santo,3885049,13,0,26,0
2020-03-22,Brazil,NA,Espirito Santo,3885049,0,0,26,0
2020-03-23,Brazil,NA,Espirito Santo,3885049,3,0,29,0
2020-03-24,Brazil,NA,Espirito Santo,3885049,4,0,33,0
2020-03-25,Brazil,NA,Espirito Santo,3885049,6,0,39,0
2020-03-26,Brazil,NA,Espirito Santo,3885049,0,0,39,0
2020-03-27,Brazil,NA,Espirito Santo,3885049,8,0,47,0
2020-03-28,Brazil,NA,Espirito Santo,3885049,6,0,53,0
2020-03-29,Brazil,NA,Espirito Santo,3885049,7,0,60,0
2020-03-30,Brazil,NA,Espirito Santo,3885049,12,0,72,0
2020-03-31,Brazil,NA,Espirito Santo,3885049,12,0,84,0
2020-04-01,Brazil,NA,Espirito Santo,3885049,12,0,96,0
2020-04-02,Brazil,NA,Espirito Santo,3885049,24,1,120,1
2020-04-03,Brazil,NA,Espirito Santo,3885049,19,3,139,4
2020-04-04,Brazil,NA,Espirito Santo,3885049,14,1,153,5
2020-04-05,Brazil,NA,Espirito Santo,3885049,13,1,166,6
2020-04-06,Brazil,NA,Espirito Santo,3885049,28,0,194,6
2020-04-07,Brazil,NA,Espirito Santo,3885049,15,0,209,6
2020-04-08,Brazil,NA,Espirito Santo,3885049,18,0,227,6
2020-04-09,Brazil,NA,Espirito Santo,3885049,46,0,273,6
2020-04-10,Brazil,NA,Espirito Santo,3885049,27,1,300,7
2020-04-11,Brazil,NA,Espirito Santo,3885049,49,2,349,9
2020-04-12,Brazil,NA,Espirito Santo,3885049,34,0,383,9
2020-04-13,Brazil,NA,Espirito Santo,3885049,47,5,430,14
2020-04-14,Brazil,NA,Espirito Santo,3885049,33,3,463,17
2020-04-15,Brazil,NA,Espirito Santo,3885049,94,1,557,18
2020-04-16,Brazil,NA,Espirito Santo,3885049,197,4,754,22
2020-04-17,Brazil,NA,Espirito Santo,3885049,102,3,856,25
2020-04-18,Brazil,NA,Espirito Santo,3885049,96,3,952,28
2020-04-19,Brazil,NA,Espirito Santo,3885049,147,2,1099,30
2020-04-20,Brazil,NA,Espirito Santo,3885049,69,3,1168,33
2020-04-21,Brazil,NA,Espirito Santo,3885049,44,1,1212,34
2020-04-22,Brazil,NA,Espirito Santo,3885049,101,0,1313,34
2020-04-23,Brazil,NA,Espirito Santo,3885049,50,8,1363,42
2020-04-24,Brazil,NA,Espirito Santo,3885049,18,0,1381,42
2020-04-25,Brazil,NA,Espirito Santo,3885049,214,5,1595,47
2020-04-26,Brazil,NA,Espirito Santo,3885049,108,4,1703,51
2020-04-27,Brazil,NA,Espirito Santo,3885049,93,6,1796,57
2020-04-28,Brazil,NA,Espirito Santo,3885049,78,7,1874,64
2020-04-29,Brazil,NA,Espirito Santo,3885049,233,12,2107,76
2020-04-30,Brazil,NA,Espirito Santo,3885049,358,7,2465,83
2020-05-01,Brazil,NA,Espirito Santo,3885049,197,13,2662,96
2020-05-02,Brazil,NA,Espirito Santo,3885049,286,6,2948,102
2020-05-03,Brazil,NA,Espirito Santo,3885049,138,12,3086,114
2020-05-04,Brazil,NA,Espirito Santo,3885049,140,8,3226,122
2020-05-05,Brazil,NA,Espirito Santo,3885049,176,11,3402,133
2020-05-06,Brazil,NA,Espirito Santo,3885049,166,12,3568,145
2020-05-07,Brazil,NA,Espirito Santo,3885049,270,10,3838,155
2020-05-08,Brazil,NA,Espirito Santo,3885049,404,10,4242,165
2020-05-09,Brazil,NA,Espirito Santo,3885049,170,7,4412,172
2020-05-10,Brazil,NA,Espirito Santo,3885049,187,9,4599,181
2020-05-11,Brazil,NA,Espirito Santo,3885049,220,15,4819,196
2020-05-12,Brazil,NA,Espirito Santo,3885049,268,16,5087,212
2020-05-13,Brazil,NA,Espirito Santo,3885049,314,21,5401,233
2020-05-14,Brazil,NA,Espirito Santo,3885049,412,16,5813,249
2020-05-15,Brazil,NA,Espirito Santo,3885049,385,11,6198,260
2020-05-16,Brazil,NA,Espirito Santo,3885049,397,11,6595,271
2020-05-17,Brazil,NA,Espirito Santo,3885049,149,14,6744,285
2020-05-18,Brazil,NA,Espirito Santo,3885049,413,17,7157,302
2020-05-19,Brazil,NA,Espirito Santo,3885049,536,23,7693,325
2020-05-20,Brazil,NA,Espirito Santo,3885049,399,16,8092,341
2020-05-21,Brazil,NA,Espirito Santo,3885049,786,22,8878,363
2020-05-22,Brazil,NA,Espirito Santo,3885049,642,34,9520,397
2020-05-23,Brazil,NA,Espirito Santo,3885049,398,20,9918,417
2020-05-24,Brazil,NA,Espirito Santo,3885049,89,29,10007,446
2020-05-25,Brazil,NA,Espirito Santo,3885049,358,19,10365,465
2020-05-26,Brazil,NA,Espirito Santo,3885049,524,22,10889,487
2020-05-27,Brazil,NA,Espirito Santo,3885049,595,24,11484,511
2020-05-28,Brazil,NA,Espirito Santo,3885049,719,27,12203,538
2020-05-29,Brazil,NA,Espirito Santo,3885049,700,22,12903,560
2020-05-30,Brazil,NA,Espirito Santo,3885049,534,23,13437,583
2020-05-31,Brazil,NA,Espirito Santo,3885049,253,21,13690,604
2020-06-01,Brazil,NA,Espirito Santo,3885049,379,10,14069,614
2020-06-02,Brazil,NA,Espirito Santo,3885049,1082,50,15151,664
2020-06-03,Brazil,NA,Espirito Santo,3885049,970,34,16121,698
2020-06-04,Brazil,NA,Espirito Santo,3885049,773,39,16894,737
2020-06-05,Brazil,NA,Espirito Santo,3885049,1215,43,18109,780
2020-06-06,Brazil,NA,Espirito Santo,3885049,841,26,18950,806
2020-06-07,Brazil,NA,Espirito Santo,3885049,669,26,19619,832
2020-06-08,Brazil,NA,Espirito Santo,3885049,1040,39,20659,871
2020-06-09,Brazil,NA,Espirito Santo,3885049,1305,33,21964,904
2020-06-10,Brazil,NA,Espirito Santo,3885049,1380,32,23344,936
2020-06-11,Brazil,NA,Espirito Santo,3885049,885,26,24229,962
2020-06-12,Brazil,NA,Espirito Santo,3885049,1028,24,25257,986
2020-06-13,Brazil,NA,Espirito Santo,3885049,675,36,25932,1022
2020-06-14,Brazil,NA,Espirito Santo,3885049,509,32,26441,1054
2020-06-15,Brazil,NA,Espirito Santo,3885049,1140,32,27581,1086
2020-06-16,Brazil,NA,Espirito Santo,3885049,1371,45,28952,1131
2020-06-17,Brazil,NA,Espirito Santo,3885049,1489,38,30441,1169
2020-06-18,Brazil,NA,Espirito Santo,3885049,1230,48,31671,1217
2020-06-19,Brazil,NA,Espirito Santo,3885049,1471,48,33142,1265
2020-06-20,Brazil,NA,Espirito Santo,3885049,1074,32,34216,1297
2020-06-21,Brazil,NA,Espirito Santo,3885049,642,29,34858,1326
2020-06-22,Brazil,NA,Espirito Santo,3885049,926,36,35784,1362
2020-06-23,Brazil,NA,Espirito Santo,3885049,1043,63,36827,1425
2020-06-24,Brazil,NA,Espirito Santo,3885049,1654,38,38481,1463
2020-06-25,Brazil,NA,Espirito Santo,3885049,1765,27,40246,1490
2020-06-26,Brazil,NA,Espirito Santo,3885049,1406,17,41652,1507
2020-06-27,Brazil,NA,Espirito Santo,3885049,0,0,41652,1507
2020-06-28,Brazil,NA,Espirito Santo,3885049,2031,61,43683,1568
2020-06-29,Brazil,NA,Espirito Santo,3885049,1414,53,45097,1621
2020-06-30,Brazil,NA,Espirito Santo,3885049,1796,27,46893,1648
2020-07-01,Brazil,NA,Espirito Santo,3885049,1928,45,48821,1693
2020-07-02,Brazil,NA,Espirito Santo,3885049,1419,35,50240,1728
2020-07-03,Brazil,NA,Espirito Santo,3885049,1449,30,51689,1758
2020-07-04,Brazil,NA,Espirito Santo,3885049,1134,23,52823,1781
2020-07-05,Brazil,NA,Espirito Santo,3885049,570,23,53393,1804
2020-07-06,Brazil,NA,Espirito Santo,3885049,1154,34,54547,1838
2020-07-07,Brazil,NA,Espirito Santo,3885049,2151,42,56698,1880
2020-07-08,Brazil,NA,Espirito Santo,3885049,1839,31,58537,1911
2020-07-09,Brazil,NA,Espirito Santo,3885049,1472,19,60009,1930
2020-07-10,Brazil,NA,Espirito Santo,3885049,1347,37,61356,1967
2020-07-11,Brazil,NA,Espirito Santo,3885049,880,17,62236,1984
2020-07-12,Brazil,NA,Espirito Santo,3885049,563,19,62799,2003
2020-07-13,Brazil,NA,Espirito Santo,3885049,1080,37,63879,2040
2020-07-14,Brazil,NA,Espirito Santo,3885049,1334,42,65213,2082
2020-07-15,Brazil,NA,Espirito Santo,3885049,1139,15,66352,2097
2020-07-16,Brazil,NA,Espirito Santo,3885049,1766,39,68118,2136
2020-07-17,Brazil,NA,Espirito Santo,3885049,1343,38,69461,2174
2020-07-18,Brazil,NA,Espirito Santo,3885049,670,28,70131,2202
2020-07-19,Brazil,NA,Espirito Santo,3885049,478,20,70609,2222
2020-07-20,Brazil,NA,Espirito Santo,3885049,1094,34,71703,2256
2020-07-21,Brazil,NA,Espirito Santo,3885049,898,24,72601,2280
2020-07-22,Brazil,NA,Espirito Santo,3885049,1087,25,73688,2305
2020-07-23,Brazil,NA,Espirito Santo,3885049,920,36,74608,2341
2020-07-24,Brazil,NA,Espirito Santo,3885049,1246,32,75854,2373
2020-07-25,Brazil,NA,Espirito Santo,3885049,744,13,76598,2386
2020-07-26,Brazil,NA,Espirito Santo,3885049,602,25,77200,2411
2020-07-27,Brazil,NA,Espirito Santo,3885049,837,25,78037,2436
2020-07-28,Brazil,NA,Espirito Santo,3885049,1427,27,79464,2463
2020-07-29,Brazil,NA,Espirito Santo,3885049,1105,23,80569,2486
2020-07-30,Brazil,NA,Espirito Santo,3885049,1316,28,81885,2514
2020-07-31,Brazil,NA,Espirito Santo,3885049,1407,31,83292,2545
2020-08-01,Brazil,NA,Espirito Santo,3885049,522,21,83814,2566
2020-08-02,Brazil,NA,Espirito Santo,3885049,424,12,84238,2578
2020-08-03,Brazil,NA,Espirito Santo,3885049,977,23,85215,2601
2020-08-04,Brazil,NA,Espirito Santo,3885049,994,27,86209,2628
2020-08-05,Brazil,NA,Espirito Santo,3885049,1033,18,87242,2646
2020-08-06,Brazil,NA,Espirito Santo,3885049,1301,21,88543,2667
2020-08-07,Brazil,NA,Espirito Santo,3885049,1380,31,89923,2698
2020-08-08,Brazil,NA,Espirito Santo,3885049,1223,22,91146,2720
2020-08-09,Brazil,NA,Espirito Santo,3885049,645,15,91791,2735
2020-08-10,Brazil,NA,Espirito Santo,3885049,1278,29,93069,2764
2020-08-11,Brazil,NA,Espirito Santo,3885049,1407,19,94476,2783
2020-08-12,Brazil,NA,Espirito Santo,3885049,1277,22,95753,2805
2020-08-13,Brazil,NA,Espirito Santo,3885049,1196,18,96949,2823
2020-08-14,Brazil,NA,Espirito Santo,3885049,1157,26,98106,2849
2020-08-15,Brazil,NA,Espirito Santo,3885049,659,15,98765,2864
2020-08-16,Brazil,NA,Espirito Santo,3885049,815,11,99580,2875
2020-08-17,Brazil,NA,Espirito Santo,3885049,1279,33,100859,2908
2020-08-18,Brazil,NA,Espirito Santo,3885049,1015,30,101874,2938
2020-08-19,Brazil,NA,Espirito Santo,3885049,1216,25,103090,2963
2020-08-20,Brazil,NA,Espirito Santo,3885049,947,17,104037,2980
2020-08-21,Brazil,NA,Espirito Santo,3885049,874,20,104911,3000
2020-08-22,Brazil,NA,Espirito Santo,3885049,702,16,105613,3016
2020-08-23,Brazil,NA,Espirito Santo,3885049,279,10,105892,3026
2020-08-24,Brazil,NA,Espirito Santo,3885049,601,19,106493,3045
2020-08-25,Brazil,NA,Espirito Santo,3885049,698,23,107191,3068
2020-08-26,Brazil,NA,Espirito Santo,3885049,718,18,107909,3086
2020-08-27,Brazil,NA,Espirito Santo,3885049,753,19,108662,3105
2020-08-28,Brazil,NA,Espirito Santo,3885049,831,12,109493,3117
2020-08-29,Brazil,NA,Espirito Santo,3885049,532,12,110025,3129
2020-08-30,Brazil,NA,Espirito Santo,3885049,326,6,110351,3135
2020-08-31,Brazil,NA,Espirito Santo,3885049,910,23,111261,3158
2020-09-01,Brazil,NA,Espirito Santo,3885049,718,23,111979,3181
2020-09-02,Brazil,NA,Espirito Santo,3885049,846,23,112825,3204
2020-09-03,Brazil,NA,Espirito Santo,3885049,934,17,113759,3221
2020-09-04,Brazil,NA,Espirito Santo,3885049,941,14,114700,3235
2020-09-05,Brazil,NA,Espirito Santo,3885049,472,7,115172,3242
2020-09-06,Brazil,NA,Espirito Santo,3885049,333,14,115505,3256
2020-09-07,Brazil,NA,Espirito Santo,3885049,288,12,115793,3268
2020-09-08,Brazil,NA,Espirito Santo,3885049,785,18,116578,3286
2020-09-09,Brazil,NA,Espirito Santo,3885049,692,12,117270,3298
2020-09-10,Brazil,NA,Espirito Santo,3885049,868,16,118138,3314
2020-09-11,Brazil,NA,Espirito Santo,3885049,675,18,118813,3332
2020-09-12,Brazil,NA,Espirito Santo,3885049,541,6,119354,3338
2020-09-13,Brazil,NA,Espirito Santo,3885049,194,8,119548,3346
2020-09-14,Brazil,NA,Espirito Santo,3885049,703,13,120251,3359
2020-09-15,Brazil,NA,Espirito Santo,3885049,665,13,120916,3372
2020-09-16,Brazil,NA,Espirito Santo,3885049,792,16,121708,3388
2020-09-17,Brazil,NA,Espirito Santo,3885049,763,11,122471,3399
2020-09-18,Brazil,NA,Espirito Santo,3885049,801,5,123272,3404
2020-09-19,Brazil,NA,Espirito Santo,3885049,448,4,123720,3408
2020-09-20,Brazil,NA,Espirito Santo,3885049,571,14,124291,3422
2020-09-21,Brazil,NA,Espirito Santo,3885049,807,10,125098,3432
2020-09-22,Brazil,NA,Espirito Santo,3885049,769,11,125867,3443
2020-09-23,Brazil,NA,Espirito Santo,3885049,739,9,126606,3452
2020-03-19,Brazil,NA,Goias,6778772,4,0,12,0
2020-03-20,Brazil,NA,Goias,6778772,3,0,15,0
2020-03-21,Brazil,NA,Goias,6778772,5,0,20,0
2020-03-22,Brazil,NA,Goias,6778772,1,0,21,0
2020-03-23,Brazil,NA,Goias,6778772,2,0,23,0
2020-03-24,Brazil,NA,Goias,6778772,4,0,27,0
2020-03-25,Brazil,NA,Goias,6778772,2,0,29,0
2020-03-26,Brazil,NA,Goias,6778772,10,1,39,1
2020-03-27,Brazil,NA,Goias,6778772,10,0,49,1
2020-03-28,Brazil,NA,Goias,6778772,7,0,56,1
2020-03-29,Brazil,NA,Goias,6778772,2,0,58,1
2020-03-30,Brazil,NA,Goias,6778772,3,0,61,1
2020-03-31,Brazil,NA,Goias,6778772,4,0,65,1
2020-04-01,Brazil,NA,Goias,6778772,6,0,71,1
2020-04-02,Brazil,NA,Goias,6778772,2,0,73,1
2020-04-03,Brazil,NA,Goias,6778772,15,1,88,2
2020-04-04,Brazil,NA,Goias,6778772,15,0,103,2
2020-04-05,Brazil,NA,Goias,6778772,12,1,115,3
2020-04-06,Brazil,NA,Goias,6778772,4,2,119,5
2020-04-07,Brazil,NA,Goias,6778772,14,0,133,5
2020-04-08,Brazil,NA,Goias,6778772,25,2,158,7
2020-04-09,Brazil,NA,Goias,6778772,21,0,179,7
2020-04-10,Brazil,NA,Goias,6778772,12,1,191,8
2020-04-11,Brazil,NA,Goias,6778772,18,2,209,10
2020-04-12,Brazil,NA,Goias,6778772,20,4,229,14
2020-04-13,Brazil,NA,Goias,6778772,4,1,233,15
2020-04-14,Brazil,NA,Goias,6778772,51,0,284,15
2020-04-15,Brazil,NA,Goias,6778772,20,0,304,15
2020-04-16,Brazil,NA,Goias,6778772,14,1,318,16
2020-04-17,Brazil,NA,Goias,6778772,17,0,335,16
2020-04-18,Brazil,NA,Goias,6778772,43,2,378,18
2020-04-19,Brazil,NA,Goias,6778772,15,0,393,18
2020-04-20,Brazil,NA,Goias,6778772,10,1,403,19
2020-04-21,Brazil,NA,Goias,6778772,18,0,421,19
2020-04-22,Brazil,NA,Goias,6778772,17,2,438,21
2020-04-23,Brazil,NA,Goias,6778772,15,2,453,23
2020-04-24,Brazil,NA,Goias,6778772,33,1,486,24
2020-04-25,Brazil,NA,Goias,6778772,20,1,506,25
2020-04-26,Brazil,NA,Goias,6778772,67,0,573,25
2020-04-27,Brazil,NA,Goias,6778772,43,1,616,26
2020-04-28,Brazil,NA,Goias,6778772,45,1,661,27
2020-04-29,Brazil,NA,Goias,6778772,44,0,705,27
2020-04-30,Brazil,NA,Goias,6778772,76,2,781,29
2020-05-01,Brazil,NA,Goias,6778772,27,0,808,29
2020-05-02,Brazil,NA,Goias,6778772,17,1,825,30
2020-05-03,Brazil,NA,Goias,6778772,25,0,850,30
2020-05-04,Brazil,NA,Goias,6778772,11,0,861,30
2020-05-05,Brazil,NA,Goias,6778772,61,8,922,38
2020-05-06,Brazil,NA,Goias,6778772,102,6,1024,44
2020-05-07,Brazil,NA,Goias,6778772,3,0,1027,44
2020-05-08,Brazil,NA,Goias,6778772,26,3,1053,47
2020-05-09,Brazil,NA,Goias,6778772,16,0,1069,47
2020-05-10,Brazil,NA,Goias,6778772,24,0,1093,47
2020-05-11,Brazil,NA,Goias,6778772,7,2,1100,49
2020-05-12,Brazil,NA,Goias,6778772,15,3,1115,52
2020-05-13,Brazil,NA,Goias,6778772,19,9,1134,61
2020-05-14,Brazil,NA,Goias,6778772,289,3,1423,64
2020-05-15,Brazil,NA,Goias,6778772,149,3,1572,67
2020-05-16,Brazil,NA,Goias,6778772,68,2,1640,69
2020-05-17,Brazil,NA,Goias,6778772,52,1,1692,70
2020-05-18,Brazil,NA,Goias,6778772,57,3,1749,73
2020-05-19,Brazil,NA,Goias,6778772,97,0,1846,73
2020-05-20,Brazil,NA,Goias,6778772,132,5,1978,78
2020-05-21,Brazil,NA,Goias,6778772,136,7,2114,85
2020-05-22,Brazil,NA,Goias,6778772,190,8,2304,93
2020-05-23,Brazil,NA,Goias,6778772,73,2,2377,95
2020-05-24,Brazil,NA,Goias,6778772,66,0,2443,95
2020-05-25,Brazil,NA,Goias,6778772,69,1,2512,96
2020-05-26,Brazil,NA,Goias,6778772,159,8,2671,104
2020-05-27,Brazil,NA,Goias,6778772,172,4,2843,108
2020-05-28,Brazil,NA,Goias,6778772,247,7,3090,115
2020-05-29,Brazil,NA,Goias,6778772,229,4,3319,119
2020-05-30,Brazil,NA,Goias,6778772,266,3,3585,122
2020-05-31,Brazil,NA,Goias,6778772,117,2,3702,124
2020-06-01,Brazil,NA,Goias,6778772,204,3,3906,127
2020-06-02,Brazil,NA,Goias,6778772,471,24,4377,151
2020-06-03,Brazil,NA,Goias,6778772,193,4,4570,155
2020-06-04,Brazil,NA,Goias,6778772,374,9,4944,164
2020-06-05,Brazil,NA,Goias,6778772,429,3,5373,167
2020-06-06,Brazil,NA,Goias,6778772,296,5,5669,172
2020-06-07,Brazil,NA,Goias,6778772,144,1,5813,173
2020-06-08,Brazil,NA,Goias,6778772,311,0,6124,173
2020-06-09,Brazil,NA,Goias,6778772,397,7,6521,180
2020-06-10,Brazil,NA,Goias,6778772,638,8,7159,188
2020-06-11,Brazil,NA,Goias,6778772,498,1,7657,189
2020-06-12,Brazil,NA,Goias,6778772,189,5,7846,194
2020-06-13,Brazil,NA,Goias,6778772,94,14,7940,208
2020-06-14,Brazil,NA,Goias,6778772,4,3,7944,211
2020-06-15,Brazil,NA,Goias,6778772,2238,15,10182,226
2020-06-16,Brazil,NA,Goias,6778772,1082,20,11264,246
2020-06-17,Brazil,NA,Goias,6778772,972,6,12236,252
2020-06-18,Brazil,NA,Goias,6778772,1068,12,13304,264
2020-06-19,Brazil,NA,Goias,6778772,723,17,14027,281
2020-06-20,Brazil,NA,Goias,6778772,853,14,14880,295
2020-06-21,Brazil,NA,Goias,6778772,739,8,15619,303
2020-06-22,Brazil,NA,Goias,6778772,917,8,16536,311
2020-06-23,Brazil,NA,Goias,6778772,1032,18,17568,329
2020-06-24,Brazil,NA,Goias,6778772,1054,34,18622,363
2020-06-25,Brazil,NA,Goias,6778772,925,21,19547,384
2020-06-26,Brazil,NA,Goias,6778772,1316,25,20863,409
2020-06-27,Brazil,NA,Goias,6778772,757,20,21620,429
2020-06-28,Brazil,NA,Goias,6778772,364,6,21984,435
2020-06-29,Brazil,NA,Goias,6778772,1023,2,23007,437
2020-06-30,Brazil,NA,Goias,6778772,1374,37,24381,474
2020-07-01,Brazil,NA,Goias,6778772,1160,29,25541,503
2020-07-02,Brazil,NA,Goias,6778772,722,42,26263,545
2020-07-03,Brazil,NA,Goias,6778772,67,41,26330,586
2020-07-04,Brazil,NA,Goias,6778772,2164,25,28494,611
2020-07-05,Brazil,NA,Goias,6778772,32,10,28526,621
2020-07-06,Brazil,NA,Goias,6778772,770,33,29296,654
2020-07-07,Brazil,NA,Goias,6778772,2012,47,31308,701
2020-07-08,Brazil,NA,Goias,6778772,1356,32,32664,733
2020-07-09,Brazil,NA,Goias,6778772,1212,36,33876,769
2020-07-10,Brazil,NA,Goias,6778772,1262,38,35138,807
2020-07-11,Brazil,NA,Goias,6778772,655,37,35793,844
2020-07-12,Brazil,NA,Goias,6778772,451,5,36244,849
2020-07-13,Brazil,NA,Goias,6778772,452,3,36696,852
2020-07-14,Brazil,NA,Goias,6778772,1136,28,37832,880
2020-07-15,Brazil,NA,Goias,6778772,1063,47,38895,927
2020-07-16,Brazil,NA,Goias,6778772,1306,59,40201,986
2020-07-17,Brazil,NA,Goias,6778772,480,43,40681,1029
2020-07-18,Brazil,NA,Goias,6778772,114,50,40795,1079
2020-07-19,Brazil,NA,Goias,6778772,0,13,40795,1092
2020-07-20,Brazil,NA,Goias,6778772,3,14,40795,1106
2020-07-21,Brazil,NA,Goias,6778772,3022,48,43794,1154
2020-07-22,Brazil,NA,Goias,6778772,3490,39,47284,1193
2020-07-23,Brazil,NA,Goias,6778772,3174,69,50458,1262
2020-07-24,Brazil,NA,Goias,6778772,2389,70,52847,1332
2020-07-25,Brazil,NA,Goias,6778772,1954,46,54801,1378
2020-07-26,Brazil,NA,Goias,6778772,1113,14,55914,1392
2020-07-27,Brazil,NA,Goias,6778772,2071,8,57985,1400
2020-07-28,Brazil,NA,Goias,6778772,2652,73,60637,1473
2020-07-29,Brazil,NA,Goias,6778772,3021,81,63658,1554
2020-07-30,Brazil,NA,Goias,6778772,1611,10,65269,1564
2020-07-31,Brazil,NA,Goias,6778772,2672,92,67941,1656
2020-08-01,Brazil,NA,Goias,6778772,1546,30,69487,1686
2020-08-02,Brazil,NA,Goias,6778772,628,11,70115,1697
2020-08-03,Brazil,NA,Goias,6778772,137,19,70252,1716
2020-08-04,Brazil,NA,Goias,6778772,2979,75,73231,1791
2020-08-05,Brazil,NA,Goias,6778772,3374,39,76605,1830
2020-08-06,Brazil,NA,Goias,6778772,3292,58,79897,1888
2020-08-07,Brazil,NA,Goias,6778772,2910,58,82807,1946
2020-08-08,Brazil,NA,Goias,6778772,1724,62,84531,2008
2020-08-09,Brazil,NA,Goias,6778772,540,12,85071,2020
2020-08-10,Brazil,NA,Goias,6778772,1380,3,86451,2023
2020-08-11,Brazil,NA,Goias,6778772,3775,76,90226,2099
2020-08-12,Brazil,NA,Goias,6778772,3048,36,93274,2135
2020-08-13,Brazil,NA,Goias,6778772,3475,78,96749,2213
2020-08-14,Brazil,NA,Goias,6778772,2485,73,99234,2286
2020-08-15,Brazil,NA,Goias,6778772,1704,0,100938,2286
2020-08-16,Brazil,NA,Goias,6778772,654,36,101592,2322
2020-08-17,Brazil,NA,Goias,6778772,1073,14,102665,2336
2020-08-18,Brazil,NA,Goias,6778772,3297,78,105962,2414
2020-08-19,Brazil,NA,Goias,6778772,3291,61,109253,2475
2020-08-20,Brazil,NA,Goias,6778772,2583,83,111836,2558
2020-08-21,Brazil,NA,Goias,6778772,1215,89,113051,2647
2020-08-22,Brazil,NA,Goias,6778772,2479,66,115530,2713
2020-08-23,Brazil,NA,Goias,6778772,1134,30,116664,2743
2020-08-24,Brazil,NA,Goias,6778772,1905,15,118569,2758
2020-08-25,Brazil,NA,Goias,6778772,3561,81,122130,2839
2020-08-26,Brazil,NA,Goias,6778772,2463,49,124593,2888
2020-08-27,Brazil,NA,Goias,6778772,2768,74,127361,2962
2020-08-28,Brazil,NA,Goias,6778772,1604,41,128965,3003
2020-08-29,Brazil,NA,Goias,6778772,1351,57,130316,3060
2020-08-30,Brazil,NA,Goias,6778772,547,15,130863,3075
2020-08-31,Brazil,NA,Goias,6778772,1643,19,132506,3094
2020-09-01,Brazil,NA,Goias,6778772,2954,118,135460,3212
2020-09-02,Brazil,NA,Goias,6778772,2948,50,138408,3262
2020-09-03,Brazil,NA,Goias,6778772,2008,83,140416,3345
2020-09-04,Brazil,NA,Goias,6778772,4834,55,145250,3400
2020-09-05,Brazil,NA,Goias,6778772,2107,50,147357,3450
2020-09-06,Brazil,NA,Goias,6778772,258,7,147615,3457
2020-09-07,Brazil,NA,Goias,6778772,113,18,147728,3475
2020-09-08,Brazil,NA,Goias,6778772,1562,9,149290,3484
2020-09-09,Brazil,NA,Goias,6778772,3350,47,152640,3531
2020-09-10,Brazil,NA,Goias,6778772,4252,96,156892,3627
2020-09-11,Brazil,NA,Goias,6778772,3877,90,160769,3717
2020-09-12,Brazil,NA,Goias,6778772,1785,66,162554,3783
2020-09-13,Brazil,NA,Goias,6778772,544,17,163098,3800
2020-09-14,Brazil,NA,Goias,6778772,2338,10,165436,3810
2020-09-15,Brazil,NA,Goias,6778772,4628,75,170064,3885
2020-09-16,Brazil,NA,Goias,6778772,2683,50,172747,3935
2020-09-17,Brazil,NA,Goias,6778772,4054,60,176801,3995
2020-09-18,Brazil,NA,Goias,6778772,4125,97,180926,4092
2020-09-19,Brazil,NA,Goias,6778772,1930,43,182856,4135
2020-09-20,Brazil,NA,Goias,6778772,959,17,183815,4152
2020-09-21,Brazil,NA,Goias,6778772,1544,12,185359,4164
2020-09-22,Brazil,NA,Goias,6778772,2160,64,187519,4228
2020-09-23,Brazil,NA,Goias,6778772,4638,37,192157,4265
2020-03-27,Brazil,NA,Maranhao,7000229,3,0,13,0
2020-03-28,Brazil,NA,Maranhao,7000229,1,0,14,0
2020-03-29,Brazil,NA,Maranhao,7000229,2,0,16,0
2020-03-30,Brazil,NA,Maranhao,7000229,7,1,23,1
2020-03-31,Brazil,NA,Maranhao,7000229,8,0,31,1
2020-04-01,Brazil,NA,Maranhao,7000229,21,0,52,1
2020-04-02,Brazil,NA,Maranhao,7000229,19,0,71,1
2020-04-03,Brazil,NA,Maranhao,7000229,10,0,81,1
2020-04-04,Brazil,NA,Maranhao,7000229,7,0,88,1
2020-04-05,Brazil,NA,Maranhao,7000229,8,1,96,2
2020-04-06,Brazil,NA,Maranhao,7000229,37,0,133,2
2020-04-07,Brazil,NA,Maranhao,7000229,39,2,172,4
2020-04-08,Brazil,NA,Maranhao,7000229,58,7,230,11
2020-04-09,Brazil,NA,Maranhao,7000229,43,1,273,12
2020-04-10,Brazil,NA,Maranhao,7000229,20,4,293,16
2020-04-11,Brazil,NA,Maranhao,7000229,51,5,344,21
2020-04-12,Brazil,NA,Maranhao,7000229,54,3,398,24
2020-04-13,Brazil,NA,Maranhao,7000229,47,3,445,27
2020-04-14,Brazil,NA,Maranhao,7000229,33,5,478,32
2020-04-15,Brazil,NA,Maranhao,7000229,152,2,630,34
2020-04-16,Brazil,NA,Maranhao,7000229,65,3,695,37
2020-04-17,Brazil,NA,Maranhao,7000229,102,3,797,40
2020-04-18,Brazil,NA,Maranhao,7000229,243,4,1040,44
2020-04-19,Brazil,NA,Maranhao,7000229,165,4,1205,48
2020-04-20,Brazil,NA,Maranhao,7000229,115,6,1320,54
2020-04-21,Brazil,NA,Maranhao,7000229,76,6,1396,60
2020-04-22,Brazil,NA,Maranhao,7000229,208,6,1604,66
2020-04-23,Brazil,NA,Maranhao,7000229,153,10,1757,76
2020-04-24,Brazil,NA,Maranhao,7000229,194,12,1951,88
2020-04-25,Brazil,NA,Maranhao,7000229,154,12,2105,100
2020-04-26,Brazil,NA,Maranhao,7000229,118,12,2223,112
2020-04-27,Brazil,NA,Maranhao,7000229,187,13,2410,125
2020-04-28,Brazil,NA,Maranhao,7000229,118,20,2528,145
2020-04-29,Brazil,NA,Maranhao,7000229,276,21,2804,166
2020-04-30,Brazil,NA,Maranhao,7000229,386,18,3190,184
2020-05-01,Brazil,NA,Maranhao,7000229,316,20,3506,204
2020-05-02,Brazil,NA,Maranhao,7000229,299,20,3805,224
2020-05-03,Brazil,NA,Maranhao,7000229,235,13,4040,237
2020-05-04,Brazil,NA,Maranhao,7000229,187,12,4227,249
2020-05-05,Brazil,NA,Maranhao,7000229,303,22,4530,271
2020-05-06,Brazil,NA,Maranhao,7000229,498,20,5028,291
2020-05-07,Brazil,NA,Maranhao,7000229,361,14,5389,305
2020-05-08,Brazil,NA,Maranhao,7000229,520,25,5909,330
2020-05-09,Brazil,NA,Maranhao,7000229,856,25,6765,355
2020-05-10,Brazil,NA,Maranhao,7000229,834,24,7599,379
2020-05-11,Brazil,NA,Maranhao,7000229,545,20,8144,399
2020-05-12,Brazil,NA,Maranhao,7000229,382,24,8526,423
2020-05-13,Brazil,NA,Maranhao,7000229,586,21,9112,444
2020-05-14,Brazil,NA,Maranhao,7000229,689,26,9801,470
2020-05-15,Brazil,NA,Maranhao,7000229,938,26,10739,496
2020-05-16,Brazil,NA,Maranhao,7000229,853,28,11592,524
2020-05-17,Brazil,NA,Maranhao,7000229,900,25,12492,549
2020-05-18,Brazil,NA,Maranhao,7000229,746,27,13238,576
2020-05-19,Brazil,NA,Maranhao,7000229,960,28,14198,604
2020-05-20,Brazil,NA,Maranhao,7000229,916,30,15114,634
2020-05-21,Brazil,NA,Maranhao,7000229,944,29,16058,663
2020-05-22,Brazil,NA,Maranhao,7000229,1154,30,17212,693
2020-05-23,Brazil,NA,Maranhao,7000229,1555,29,18767,722
2020-05-24,Brazil,NA,Maranhao,7000229,2424,32,21191,754
2020-05-25,Brazil,NA,Maranhao,7000229,1595,30,22786,784
2020-05-26,Brazil,NA,Maranhao,7000229,1492,33,24278,817
2020-05-27,Brazil,NA,Maranhao,7000229,1867,36,26145,853
2020-05-28,Brazil,NA,Maranhao,7000229,1834,34,27979,887
2020-05-29,Brazil,NA,Maranhao,7000229,2503,24,30482,911
2020-05-30,Brazil,NA,Maranhao,7000229,2138,21,32620,932
2020-05-31,Brazil,NA,Maranhao,7000229,2019,23,34639,955
2020-06-01,Brazil,NA,Maranhao,7000229,658,21,35297,976
2020-06-02,Brazil,NA,Maranhao,7000229,1328,21,36625,997
2020-06-03,Brazil,NA,Maranhao,7000229,1549,31,38174,1028
2020-06-04,Brazil,NA,Maranhao,7000229,2455,34,40629,1062
2020-06-05,Brazil,NA,Maranhao,7000229,2684,33,43313,1095
2020-06-06,Brazil,NA,Maranhao,7000229,2157,37,45470,1132
2020-06-07,Brazil,NA,Maranhao,7000229,2123,38,47593,1170
2020-06-08,Brazil,NA,Maranhao,7000229,1778,77,49371,1247
2020-06-09,Brazil,NA,Maranhao,7000229,2698,38,52069,1285
2020-06-10,Brazil,NA,Maranhao,7000229,1439,37,53508,1322
2020-06-11,Brazil,NA,Maranhao,7000229,2172,38,55680,1360
2020-06-12,Brazil,NA,Maranhao,7000229,1925,39,57605,1399
2020-06-13,Brazil,NA,Maranhao,7000229,1254,37,58859,1436
2020-06-14,Brazil,NA,Maranhao,7000229,991,31,59850,1467
2020-06-15,Brazil,NA,Maranhao,7000229,742,32,60592,1499
2020-06-16,Brazil,NA,Maranhao,7000229,2119,38,62711,1537
2020-06-17,Brazil,NA,Maranhao,7000229,2024,33,64735,1570
2020-06-18,Brazil,NA,Maranhao,7000229,1356,37,66091,1607
2020-06-19,Brazil,NA,Maranhao,7000229,2409,38,68500,1645
2020-06-20,Brazil,NA,Maranhao,7000229,1173,39,69673,1684
2020-06-21,Brazil,NA,Maranhao,7000229,386,37,70059,1721
2020-06-22,Brazil,NA,Maranhao,7000229,630,39,70689,1760
2020-06-23,Brazil,NA,Maranhao,7000229,1332,37,72021,1797
2020-06-24,Brazil,NA,Maranhao,7000229,1293,39,73314,1836
2020-06-25,Brazil,NA,Maranhao,7000229,1611,35,74925,1871
2020-06-26,Brazil,NA,Maranhao,7000229,1773,35,76698,1906
2020-06-27,Brazil,NA,Maranhao,7000229,1417,37,78115,1943
2020-06-28,Brazil,NA,Maranhao,7000229,397,39,78512,1982
2020-06-29,Brazil,NA,Maranhao,7000229,457,30,78969,2012
2020-06-30,Brazil,NA,Maranhao,7000229,1482,36,80451,2048
2020-07-01,Brazil,NA,Maranhao,7000229,2805,33,83256,2081
2020-07-02,Brazil,NA,Maranhao,7000229,2769,38,86025,2119
2020-07-03,Brazil,NA,Maranhao,7000229,2189,34,88214,2153
2020-07-04,Brazil,NA,Maranhao,7000229,843,32,89057,2185
2020-07-05,Brazil,NA,Maranhao,7000229,657,34,89714,2219
2020-07-06,Brazil,NA,Maranhao,7000229,537,31,90251,2250
2020-07-07,Brazil,NA,Maranhao,7000229,1837,36,92088,2286
2020-07-08,Brazil,NA,Maranhao,7000229,851,38,92939,2324
2020-07-09,Brazil,NA,Maranhao,7000229,2384,33,95323,2357
2020-07-10,Brazil,NA,Maranhao,7000229,1395,35,96718,2392
2020-07-11,Brazil,NA,Maranhao,7000229,1680,34,98398,2426
2020-07-12,Brazil,NA,Maranhao,7000229,554,37,98952,2463
2020-07-13,Brazil,NA,Maranhao,7000229,878,38,99830,2501
2020-07-14,Brazil,NA,Maranhao,7000229,1637,35,101467,2536
2020-07-15,Brazil,NA,Maranhao,7000229,1002,36,102469,2572
2020-07-16,Brazil,NA,Maranhao,7000229,1657,36,104126,2608
2020-07-17,Brazil,NA,Maranhao,7000229,1057,32,105183,2640
2020-07-18,Brazil,NA,Maranhao,7000229,909,36,106092,2676
2020-07-19,Brazil,NA,Maranhao,7000229,233,32,106325,2708
2020-07-20,Brazil,NA,Maranhao,7000229,581,32,106906,2740
2020-07-21,Brazil,NA,Maranhao,7000229,1248,38,108154,2778
2020-07-22,Brazil,NA,Maranhao,7000229,1577,32,109731,2810
2020-07-23,Brazil,NA,Maranhao,7000229,1757,30,111488,2840
2020-07-24,Brazil,NA,Maranhao,7000229,1195,31,112683,2871
2020-07-25,Brazil,NA,Maranhao,7000229,880,27,113563,2898
2020-07-26,Brazil,NA,Maranhao,7000229,328,25,113891,2923
2020-07-27,Brazil,NA,Maranhao,7000229,694,20,114585,2943
2020-07-28,Brazil,NA,Maranhao,7000229,1403,16,115988,2959
2020-07-29,Brazil,NA,Maranhao,7000229,1706,19,117694,2978
2020-07-30,Brazil,NA,Maranhao,7000229,1568,18,119262,2996
2020-07-31,Brazil,NA,Maranhao,7000229,1399,17,120661,3013
2020-08-01,Brazil,NA,Maranhao,7000229,920,19,121581,3032
2020-08-02,Brazil,NA,Maranhao,7000229,372,18,121953,3050
2020-08-03,Brazil,NA,Maranhao,7000229,529,19,122482,3069
2020-08-04,Brazil,NA,Maranhao,7000229,1405,16,123887,3085
2020-08-05,Brazil,NA,Maranhao,7000229,1572,18,125459,3103
2020-08-06,Brazil,NA,Maranhao,7000229,1606,17,127065,3120
2020-08-07,Brazil,NA,Maranhao,7000229,1781,18,128846,3138
2020-08-08,Brazil,NA,Maranhao,7000229,854,16,129700,3154
2020-08-09,Brazil,NA,Maranhao,7000229,436,15,130136,3169
2020-08-10,Brazil,NA,Maranhao,7000229,430,18,130566,3187
2020-08-11,Brazil,NA,Maranhao,7000229,1494,17,132060,3204
2020-08-12,Brazil,NA,Maranhao,7000229,1205,11,133265,3215
2020-08-13,Brazil,NA,Maranhao,7000229,928,13,134193,3228
2020-08-14,Brazil,NA,Maranhao,7000229,1131,12,135324,3240
2020-08-15,Brazil,NA,Maranhao,7000229,956,13,136280,3253
2020-08-16,Brazil,NA,Maranhao,7000229,573,11,136853,3264
2020-08-17,Brazil,NA,Maranhao,7000229,555,13,137408,3277
2020-08-18,Brazil,NA,Maranhao,7000229,1777,12,139185,3289
2020-08-19,Brazil,NA,Maranhao,7000229,1386,13,140571,3302
2020-08-20,Brazil,NA,Maranhao,7000229,1289,13,141860,3315
2020-08-21,Brazil,NA,Maranhao,7000229,1243,13,143103,3328
2020-08-22,Brazil,NA,Maranhao,7000229,770,12,143873,3340
2020-08-23,Brazil,NA,Maranhao,7000229,527,12,144400,3352
2020-08-24,Brazil,NA,Maranhao,7000229,495,13,144895,3365
2020-08-25,Brazil,NA,Maranhao,7000229,1026,12,145921,3377
2020-08-26,Brazil,NA,Maranhao,7000229,1755,13,147676,3390
2020-08-27,Brazil,NA,Maranhao,7000229,1247,12,148923,3402
2020-08-28,Brazil,NA,Maranhao,7000229,1221,10,150144,3412
2020-08-29,Brazil,NA,Maranhao,7000229,751,12,150895,3424
2020-08-30,Brazil,NA,Maranhao,7000229,317,12,151212,3436
2020-08-31,Brazil,NA,Maranhao,7000229,403,10,151615,3446
2020-09-01,Brazil,NA,Maranhao,7000229,1066,11,152681,3457
2020-09-02,Brazil,NA,Maranhao,7000229,1787,10,154468,3467
2020-09-03,Brazil,NA,Maranhao,7000229,1249,11,155717,3478
2020-09-04,Brazil,NA,Maranhao,7000229,1335,10,157052,3488
2020-09-05,Brazil,NA,Maranhao,7000229,792,11,157844,3499
2020-09-06,Brazil,NA,Maranhao,7000229,206,9,158050,3508
2020-09-07,Brazil,NA,Maranhao,7000229,260,10,158310,3518
2020-09-08,Brazil,NA,Maranhao,7000229,853,11,159163,3529
2020-09-09,Brazil,NA,Maranhao,7000229,1076,10,160239,3539
2020-09-10,Brazil,NA,Maranhao,7000229,729,11,160968,3550
2020-09-11,Brazil,NA,Maranhao,7000229,1026,10,161994,3560
2020-09-12,Brazil,NA,Maranhao,7000229,482,9,162476,3569
2020-09-13,Brazil,NA,Maranhao,7000229,107,11,162583,3580
2020-09-14,Brazil,NA,Maranhao,7000229,415,10,162998,3590
2020-09-15,Brazil,NA,Maranhao,7000229,804,11,163802,3601
2020-09-16,Brazil,NA,Maranhao,7000229,968,10,164770,3611
2020-09-17,Brazil,NA,Maranhao,7000229,729,11,165499,3622
2020-09-18,Brazil,NA,Maranhao,7000229,1081,10,166580,3632
2020-09-19,Brazil,NA,Maranhao,7000229,753,11,167333,3643
2020-09-20,Brazil,NA,Maranhao,7000229,324,10,167657,3653
2020-09-21,Brazil,NA,Maranhao,7000229,291,11,167948,3664
2020-09-22,Brazil,NA,Maranhao,7000229,965,10,168913,3674
2020-09-23,Brazil,NA,Maranhao,7000229,777,9,169690,3683
2020-03-26,Brazil,NA,MatoGrosso,3344544,3,0,11,0
2020-03-27,Brazil,NA,MatoGrosso,3344544,0,0,11,0
2020-03-28,Brazil,NA,MatoGrosso,3344544,2,0,13,0
2020-03-29,Brazil,NA,MatoGrosso,3344544,3,0,16,0
2020-03-30,Brazil,NA,MatoGrosso,3344544,2,0,18,0
2020-03-31,Brazil,NA,MatoGrosso,3344544,7,0,25,0
2020-04-01,Brazil,NA,MatoGrosso,3344544,2,0,27,0
2020-04-02,Brazil,NA,MatoGrosso,3344544,9,0,36,0
2020-04-03,Brazil,NA,MatoGrosso,3344544,8,1,44,1
2020-04-04,Brazil,NA,MatoGrosso,3344544,12,0,56,1
2020-04-05,Brazil,NA,MatoGrosso,3344544,4,0,60,1
2020-04-06,Brazil,NA,MatoGrosso,3344544,16,0,76,1
2020-04-07,Brazil,NA,MatoGrosso,3344544,2,0,78,1
2020-04-08,Brazil,NA,MatoGrosso,3344544,12,0,90,1
2020-04-09,Brazil,NA,MatoGrosso,3344544,18,1,108,2
2020-04-10,Brazil,NA,MatoGrosso,3344544,4,0,112,2
2020-04-11,Brazil,NA,MatoGrosso,3344544,9,1,121,3
2020-04-12,Brazil,NA,MatoGrosso,3344544,2,0,123,3
2020-04-13,Brazil,NA,MatoGrosso,3344544,11,1,134,4
2020-04-14,Brazil,NA,MatoGrosso,3344544,4,0,138,4
2020-04-15,Brazil,NA,MatoGrosso,3344544,13,0,151,4
2020-04-16,Brazil,NA,MatoGrosso,3344544,5,1,156,5
2020-04-17,Brazil,NA,MatoGrosso,3344544,6,0,162,5
2020-04-18,Brazil,NA,MatoGrosso,3344544,9,0,171,5
2020-04-19,Brazil,NA,MatoGrosso,3344544,3,0,174,5
2020-04-20,Brazil,NA,MatoGrosso,3344544,7,1,181,6
2020-04-21,Brazil,NA,MatoGrosso,3344544,0,0,181,6
2020-04-22,Brazil,NA,MatoGrosso,3344544,2,0,183,6
2020-04-23,Brazil,NA,MatoGrosso,3344544,38,1,221,7
2020-04-24,Brazil,NA,MatoGrosso,3344544,19,1,240,8
2020-04-25,Brazil,NA,MatoGrosso,3344544,7,1,247,9
2020-04-26,Brazil,NA,MatoGrosso,3344544,3,0,250,9
2020-04-27,Brazil,NA,MatoGrosso,3344544,7,1,257,10
2020-04-28,Brazil,NA,MatoGrosso,3344544,4,1,261,11
2020-04-29,Brazil,NA,MatoGrosso,3344544,31,0,292,11
2020-04-30,Brazil,NA,MatoGrosso,3344544,5,0,297,11
2020-05-01,Brazil,NA,MatoGrosso,3344544,23,0,320,11
2020-05-02,Brazil,NA,MatoGrosso,3344544,11,1,331,12
2020-05-03,Brazil,NA,MatoGrosso,3344544,6,0,337,12
2020-05-04,Brazil,NA,MatoGrosso,3344544,7,1,344,13
2020-05-05,Brazil,NA,MatoGrosso,3344544,21,0,365,13
2020-05-06,Brazil,NA,MatoGrosso,3344544,14,0,379,13
2020-05-07,Brazil,NA,MatoGrosso,3344544,38,0,417,13
2020-05-08,Brazil,NA,MatoGrosso,3344544,40,1,457,14
2020-05-09,Brazil,NA,MatoGrosso,3344544,45,2,502,16
2020-05-10,Brazil,NA,MatoGrosso,3344544,17,2,519,18
2020-05-11,Brazil,NA,MatoGrosso,3344544,22,1,541,19
2020-05-12,Brazil,NA,MatoGrosso,3344544,50,0,591,19
2020-05-13,Brazil,NA,MatoGrosso,3344544,70,1,661,20
2020-05-14,Brazil,NA,MatoGrosso,3344544,58,3,719,23
2020-05-15,Brazil,NA,MatoGrosso,3344544,60,3,779,26
2020-05-16,Brazil,NA,MatoGrosso,3344544,72,1,851,27
2020-05-17,Brazil,NA,MatoGrosso,3344544,50,0,901,27
2020-05-18,Brazil,NA,MatoGrosso,3344544,36,2,937,29
2020-05-19,Brazil,NA,MatoGrosso,3344544,58,3,995,32
2020-05-20,Brazil,NA,MatoGrosso,3344544,59,0,1054,32
2020-05-21,Brazil,NA,MatoGrosso,3344544,118,2,1172,34
2020-05-22,Brazil,NA,MatoGrosso,3344544,48,3,1220,37
2020-05-23,Brazil,NA,MatoGrosso,3344544,132,0,1352,37
2020-05-24,Brazil,NA,MatoGrosso,3344544,110,3,1462,40
2020-05-25,Brazil,NA,MatoGrosso,3344544,38,1,1500,41
2020-05-26,Brazil,NA,MatoGrosso,3344544,128,2,1628,43
2020-05-27,Brazil,NA,MatoGrosso,3344544,211,3,1839,46
2020-05-28,Brazil,NA,MatoGrosso,3344544,112,5,1951,51
2020-05-29,Brazil,NA,MatoGrosso,3344544,152,5,2103,56
2020-05-30,Brazil,NA,MatoGrosso,3344544,258,1,2361,57
2020-05-31,Brazil,NA,MatoGrosso,3344544,68,4,2429,61
2020-06-01,Brazil,NA,MatoGrosso,3344544,112,5,2541,66
2020-06-02,Brazil,NA,MatoGrosso,3344544,168,4,2709,70
2020-06-03,Brazil,NA,MatoGrosso,3344544,139,6,2848,76
2020-06-04,Brazil,NA,MatoGrosso,3344544,346,6,3194,82
2020-06-05,Brazil,NA,MatoGrosso,3344544,287,6,3481,88
2020-06-06,Brazil,NA,MatoGrosso,3344544,181,8,3662,96
2020-06-07,Brazil,NA,MatoGrosso,3344544,216,13,3878,109
2020-06-08,Brazil,NA,MatoGrosso,3344544,222,7,4100,116
2020-06-09,Brazil,NA,MatoGrosso,3344544,239,19,4339,135
2020-06-10,Brazil,NA,MatoGrosso,3344544,263,11,4602,146
2020-06-11,Brazil,NA,MatoGrosso,3344544,490,14,5092,160
2020-06-12,Brazil,NA,MatoGrosso,3344544,271,15,5363,175
2020-06-13,Brazil,NA,MatoGrosso,3344544,161,17,5524,192
2020-06-14,Brazil,NA,MatoGrosso,3344544,337,17,5861,209
2020-06-15,Brazil,NA,MatoGrosso,3344544,324,7,6185,216
2020-06-16,Brazil,NA,MatoGrosso,3344544,203,10,6388,226
2020-06-17,Brazil,NA,MatoGrosso,3344544,736,40,7124,266
2020-06-18,Brazil,NA,MatoGrosso,3344544,388,15,7512,281
2020-06-19,Brazil,NA,MatoGrosso,3344544,841,28,8353,309
2020-06-20,Brazil,NA,MatoGrosso,3344544,609,26,8962,335
2020-06-21,Brazil,NA,MatoGrosso,3344544,508,25,9470,360
2020-06-22,Brazil,NA,MatoGrosso,3344544,551,24,10021,384
2020-06-23,Brazil,NA,MatoGrosso,3344544,638,17,10659,401
2020-06-24,Brazil,NA,MatoGrosso,3344544,784,42,11443,443
2020-06-25,Brazil,NA,MatoGrosso,3344544,714,19,12157,462
2020-06-26,Brazil,NA,MatoGrosso,3344544,869,18,13026,480
2020-06-27,Brazil,NA,MatoGrosso,3344544,779,47,13805,527
2020-06-28,Brazil,NA,MatoGrosso,3344544,882,36,14687,563
2020-06-29,Brazil,NA,MatoGrosso,3344544,399,19,15086,582
2020-06-30,Brazil,NA,MatoGrosso,3344544,550,11,15636,593
2020-07-01,Brazil,NA,MatoGrosso,3344544,985,41,16621,634
2020-07-02,Brazil,NA,MatoGrosso,3344544,1106,40,17727,674
2020-07-03,Brazil,NA,MatoGrosso,3344544,1127,35,18854,709
2020-07-04,Brazil,NA,MatoGrosso,3344544,1244,46,20098,755
2020-07-05,Brazil,NA,MatoGrosso,3344544,793,52,20891,807
2020-07-06,Brazil,NA,MatoGrosso,3344544,605,19,21496,826
2020-07-07,Brazil,NA,MatoGrosso,3344544,910,20,22406,846
2020-07-08,Brazil,NA,MatoGrosso,3344544,1429,36,23835,882
2020-07-09,Brazil,NA,MatoGrosso,3344544,1429,46,25264,928
2020-07-10,Brazil,NA,MatoGrosso,3344544,1132,58,26396,986
2020-07-11,Brazil,NA,MatoGrosso,3344544,1240,43,27636,1029
2020-07-12,Brazil,NA,MatoGrosso,3344544,775,18,28411,1047
2020-07-13,Brazil,NA,MatoGrosso,3344544,381,38,28792,1085
2020-07-14,Brazil,NA,MatoGrosso,3344544,487,20,29279,1105
2020-07-15,Brazil,NA,MatoGrosso,3344544,1040,69,30319,1174
2020-07-16,Brazil,NA,MatoGrosso,3344544,792,33,31111,1207
2020-07-17,Brazil,NA,MatoGrosso,3344544,1860,61,32971,1268
2020-07-18,Brazil,NA,MatoGrosso,3344544,0,37,32971,1305
2020-07-19,Brazil,NA,MatoGrosso,3344544,1429,27,34136,1332
2020-07-20,Brazil,NA,MatoGrosso,3344544,1503,52,35639,1384
2020-07-21,Brazil,NA,MatoGrosso,3344544,1438,16,37077,1400
2020-07-22,Brazil,NA,MatoGrosso,3344544,1695,53,38772,1453
2020-07-23,Brazil,NA,MatoGrosso,3344544,1983,38,40755,1491
2020-07-24,Brazil,NA,MatoGrosso,3344544,1451,10,42206,1501
2020-07-25,Brazil,NA,MatoGrosso,3344544,729,65,42935,1566
2020-07-26,Brazil,NA,MatoGrosso,3344544,396,14,43331,1580
2020-07-27,Brazil,NA,MatoGrosso,3344544,1507,45,44838,1625
2020-07-28,Brazil,NA,MatoGrosso,3344544,1707,44,46545,1669
2020-07-29,Brazil,NA,MatoGrosso,3344544,1772,33,48317,1702
2020-07-30,Brazil,NA,MatoGrosso,3344544,2130,61,50447,1763
2020-07-31,Brazil,NA,MatoGrosso,3344544,1418,56,51865,1819
2020-08-01,Brazil,NA,MatoGrosso,3344544,925,30,52790,1849
2020-08-02,Brazil,NA,MatoGrosso,3344544,573,37,53363,1886
2020-08-03,Brazil,NA,MatoGrosso,3344544,1348,21,54711,1907
2020-08-04,Brazil,NA,MatoGrosso,3344544,1458,14,56169,1921
2020-08-05,Brazil,NA,MatoGrosso,3344544,2337,24,58506,1945
2020-08-06,Brazil,NA,MatoGrosso,3344544,1335,29,59841,1974
2020-08-07,Brazil,NA,MatoGrosso,3344544,2944,63,62785,2037
2020-08-08,Brazil,NA,MatoGrosso,3344544,41,24,62826,2061
2020-08-09,Brazil,NA,MatoGrosso,3344544,590,29,63416,2090
2020-08-10,Brazil,NA,MatoGrosso,3344544,1782,32,65198,2122
2020-08-11,Brazil,NA,MatoGrosso,3344544,1863,67,67061,2189
2020-08-12,Brazil,NA,MatoGrosso,3344544,1863,32,68924,2221
2020-08-13,Brazil,NA,MatoGrosso,3344544,1734,24,70658,2245
2020-08-14,Brazil,NA,MatoGrosso,3344544,1611,40,72269,2285
2020-08-15,Brazil,NA,MatoGrosso,3344544,492,34,72761,2319
2020-08-16,Brazil,NA,MatoGrosso,3344544,508,21,73269,2340
2020-08-17,Brazil,NA,MatoGrosso,3344544,1240,28,74509,2368
2020-08-18,Brazil,NA,MatoGrosso,3344544,1368,16,75877,2384
2020-08-19,Brazil,NA,MatoGrosso,3344544,1399,37,77276,2421
2020-08-20,Brazil,NA,MatoGrosso,3344544,1457,36,78733,2457
2020-08-21,Brazil,NA,MatoGrosso,3344544,1401,35,80134,2492
2020-08-22,Brazil,NA,MatoGrosso,3344544,804,18,80938,2510
2020-08-23,Brazil,NA,MatoGrosso,3344544,315,15,81253,2525
2020-08-24,Brazil,NA,MatoGrosso,3344544,1279,26,82532,2551
2020-08-25,Brazil,NA,MatoGrosso,3344544,1745,40,84277,2591
2020-08-26,Brazil,NA,MatoGrosso,3344544,1432,20,85709,2611
2020-08-27,Brazil,NA,MatoGrosso,3344544,1775,38,87484,2649
2020-08-28,Brazil,NA,MatoGrosso,3344544,1656,28,89140,2677
2020-08-29,Brazil,NA,MatoGrosso,3344544,822,29,89962,2706
2020-08-30,Brazil,NA,MatoGrosso,3344544,375,19,90337,2725
2020-08-31,Brazil,NA,MatoGrosso,3344544,1009,26,91346,2751
2020-09-01,Brazil,NA,MatoGrosso,3344544,1510,35,92856,2786
2020-09-02,Brazil,NA,MatoGrosso,3344544,1446,30,94302,2816
2020-09-03,Brazil,NA,MatoGrosso,3344544,1128,29,95430,2845
2020-09-04,Brazil,NA,MatoGrosso,3344544,1550,28,96980,2873
2020-09-05,Brazil,NA,MatoGrosso,3344544,656,20,97636,2893
2020-09-06,Brazil,NA,MatoGrosso,3344544,183,14,97819,2907
2020-09-07,Brazil,NA,MatoGrosso,3344544,387,25,98206,2932
2020-09-08,Brazil,NA,MatoGrosso,3344544,1278,28,99484,2960
2020-09-09,Brazil,NA,MatoGrosso,3344544,1411,32,100895,2992
2020-09-10,Brazil,NA,MatoGrosso,3344544,1433,33,102328,3025
2020-09-11,Brazil,NA,MatoGrosso,3344544,1601,19,103929,3044
2020-09-12,Brazil,NA,MatoGrosso,3344544,742,19,104671,3063
2020-09-13,Brazil,NA,MatoGrosso,3344544,242,19,104913,3082
2020-09-14,Brazil,NA,MatoGrosso,3344544,1164,25,106077,3107
2020-09-15,Brazil,NA,MatoGrosso,3344544,1409,17,107486,3124
2020-09-16,Brazil,NA,MatoGrosso,3344544,1404,32,108890,3156
2020-09-17,Brazil,NA,MatoGrosso,3344544,1257,22,110147,3178
2020-09-18,Brazil,NA,MatoGrosso,3344544,1481,22,111628,3200
2020-09-19,Brazil,NA,MatoGrosso,3344544,614,14,112242,3214
2020-09-20,Brazil,NA,MatoGrosso,3344544,365,17,112607,3231
2020-09-21,Brazil,NA,MatoGrosso,3344544,1434,14,114041,3245
2020-09-22,Brazil,NA,MatoGrosso,3344544,1362,24,115403,3269
2020-09-23,Brazil,NA,MatoGrosso,3344544,1297,18,116700,3287
2020-03-21,Brazil,NA,MatoGrosso do Sul,2713147,7,0,16,0
2020-03-22,Brazil,NA,MatoGrosso do Sul,2713147,5,0,21,0
2020-03-23,Brazil,NA,MatoGrosso do Sul,2713147,0,0,21,0
2020-03-24,Brazil,NA,MatoGrosso do Sul,2713147,2,0,23,0
2020-03-25,Brazil,NA,MatoGrosso do Sul,2713147,1,0,24,0
2020-03-26,Brazil,NA,MatoGrosso do Sul,2713147,1,0,25,0
2020-03-27,Brazil,NA,MatoGrosso do Sul,2713147,3,0,28,0
2020-03-28,Brazil,NA,MatoGrosso do Sul,2713147,3,0,31,0
2020-03-29,Brazil,NA,MatoGrosso do Sul,2713147,5,0,36,0
2020-03-30,Brazil,NA,MatoGrosso do Sul,2713147,8,0,44,0
2020-03-31,Brazil,NA,MatoGrosso do Sul,2713147,4,1,48,1
2020-04-01,Brazil,NA,MatoGrosso do Sul,2713147,3,0,51,1
2020-04-02,Brazil,NA,MatoGrosso do Sul,2713147,2,0,53,1
2020-04-03,Brazil,NA,MatoGrosso do Sul,2713147,7,0,60,1
2020-04-04,Brazil,NA,MatoGrosso do Sul,2713147,2,0,62,1
2020-04-05,Brazil,NA,MatoGrosso do Sul,2713147,3,0,65,1
2020-04-06,Brazil,NA,MatoGrosso do Sul,2713147,1,0,66,1
2020-04-07,Brazil,NA,MatoGrosso do Sul,2713147,14,1,80,2
2020-04-08,Brazil,NA,MatoGrosso do Sul,2713147,5,0,85,2
2020-04-09,Brazil,NA,MatoGrosso do Sul,2713147,4,0,89,2
2020-04-10,Brazil,NA,MatoGrosso do Sul,2713147,8,0,97,2
2020-04-11,Brazil,NA,MatoGrosso do Sul,2713147,3,0,100,2
2020-04-12,Brazil,NA,MatoGrosso do Sul,2713147,1,0,101,2
2020-04-13,Brazil,NA,MatoGrosso do Sul,2713147,12,2,113,4
2020-04-14,Brazil,NA,MatoGrosso do Sul,2713147,2,0,115,4
2020-04-15,Brazil,NA,MatoGrosso do Sul,2713147,6,0,121,4
2020-04-16,Brazil,NA,MatoGrosso do Sul,2713147,10,1,131,5
2020-04-17,Brazil,NA,MatoGrosso do Sul,2713147,12,0,143,5
2020-04-18,Brazil,NA,MatoGrosso do Sul,2713147,18,0,161,5
2020-04-19,Brazil,NA,MatoGrosso do Sul,2713147,7,0,168,5
2020-04-20,Brazil,NA,MatoGrosso do Sul,2713147,3,0,171,5
2020-04-21,Brazil,NA,MatoGrosso do Sul,2713147,2,1,173,6
2020-04-22,Brazil,NA,MatoGrosso do Sul,2713147,2,0,175,6
2020-04-23,Brazil,NA,MatoGrosso do Sul,2713147,11,1,186,7
2020-04-24,Brazil,NA,MatoGrosso do Sul,2713147,27,0,213,7
2020-04-25,Brazil,NA,MatoGrosso do Sul,2713147,4,0,217,7
2020-04-26,Brazil,NA,MatoGrosso do Sul,2713147,17,0,234,7
2020-04-27,Brazil,NA,MatoGrosso do Sul,2713147,4,2,238,9
2020-04-28,Brazil,NA,MatoGrosso do Sul,2713147,2,0,240,9
2020-04-29,Brazil,NA,MatoGrosso do Sul,2713147,9,0,249,9
2020-04-30,Brazil,NA,MatoGrosso do Sul,2713147,6,0,255,9
2020-05-01,Brazil,NA,MatoGrosso do Sul,2713147,6,0,261,9
2020-05-02,Brazil,NA,MatoGrosso do Sul,2713147,5,0,266,9
2020-05-03,Brazil,NA,MatoGrosso do Sul,2713147,6,1,272,10
2020-05-04,Brazil,NA,MatoGrosso do Sul,2713147,2,0,274,10
2020-05-05,Brazil,NA,MatoGrosso do Sul,2713147,9,0,283,10
2020-05-06,Brazil,NA,MatoGrosso do Sul,2713147,5,0,288,10
2020-05-07,Brazil,NA,MatoGrosso do Sul,2713147,23,0,311,10
2020-05-08,Brazil,NA,MatoGrosso do Sul,2713147,15,1,326,11
2020-05-09,Brazil,NA,MatoGrosso do Sul,2713147,20,0,346,11
2020-05-10,Brazil,NA,MatoGrosso do Sul,2713147,16,0,362,11
2020-05-11,Brazil,NA,MatoGrosso do Sul,2713147,23,0,385,11
2020-05-12,Brazil,NA,MatoGrosso do Sul,2713147,20,1,405,12
2020-05-13,Brazil,NA,MatoGrosso do Sul,2713147,25,1,430,13
2020-05-14,Brazil,NA,MatoGrosso do Sul,2713147,22,1,452,14
2020-05-15,Brazil,NA,MatoGrosso do Sul,2713147,27,0,479,14
2020-05-16,Brazil,NA,MatoGrosso do Sul,2713147,29,1,508,15
2020-05-17,Brazil,NA,MatoGrosso do Sul,2713147,62,0,570,15
2020-05-18,Brazil,NA,MatoGrosso do Sul,2713147,43,1,613,16
2020-05-19,Brazil,NA,MatoGrosso do Sul,2713147,29,0,642,16
2020-05-20,Brazil,NA,MatoGrosso do Sul,2713147,51,1,693,17
2020-05-21,Brazil,NA,MatoGrosso do Sul,2713147,53,0,746,17
2020-05-22,Brazil,NA,MatoGrosso do Sul,2713147,59,0,805,17
2020-05-23,Brazil,NA,MatoGrosso do Sul,2713147,53,0,858,17
2020-05-24,Brazil,NA,MatoGrosso do Sul,2713147,66,0,924,17
2020-05-25,Brazil,NA,MatoGrosso do Sul,2713147,99,0,1023,17
2020-05-26,Brazil,NA,MatoGrosso do Sul,2713147,77,0,1100,17
2020-05-27,Brazil,NA,MatoGrosso do Sul,2713147,86,1,1186,18
2020-05-28,Brazil,NA,MatoGrosso do Sul,2713147,76,0,1262,18
2020-05-29,Brazil,NA,MatoGrosso do Sul,2713147,94,0,1356,18
2020-05-30,Brazil,NA,MatoGrosso do Sul,2713147,62,1,1418,19
2020-05-31,Brazil,NA,MatoGrosso do Sul,2713147,71,1,1489,20
2020-06-01,Brazil,NA,MatoGrosso do Sul,2713147,79,0,1568,20
2020-06-02,Brazil,NA,MatoGrosso do Sul,2713147,78,0,1646,20
2020-06-03,Brazil,NA,MatoGrosso do Sul,2713147,156,0,1802,20
2020-06-04,Brazil,NA,MatoGrosso do Sul,2713147,123,0,1925,20
2020-06-05,Brazil,NA,MatoGrosso do Sul,2713147,72,1,1997,21
2020-06-06,Brazil,NA,MatoGrosso do Sul,2713147,135,0,2132,21
2020-06-07,Brazil,NA,MatoGrosso do Sul,2713147,121,0,2253,21
2020-06-08,Brazil,NA,MatoGrosso do Sul,2713147,71,1,2324,22
2020-06-09,Brazil,NA,MatoGrosso do Sul,2713147,131,0,2455,22
2020-06-10,Brazil,NA,MatoGrosso do Sul,2713147,142,2,2597,24
2020-06-11,Brazil,NA,MatoGrosso do Sul,2713147,256,1,2853,25
2020-06-12,Brazil,NA,MatoGrosso do Sul,2713147,148,3,3001,28
2020-06-13,Brazil,NA,MatoGrosso do Sul,2713147,234,0,3235,28
2020-06-14,Brazil,NA,MatoGrosso do Sul,2713147,198,3,3433,31
2020-06-15,Brazil,NA,MatoGrosso do Sul,2713147,118,2,3551,33
2020-06-16,Brazil,NA,MatoGrosso do Sul,2713147,234,3,3785,36
2020-06-17,Brazil,NA,MatoGrosso do Sul,2713147,379,0,4164,36
2020-06-18,Brazil,NA,MatoGrosso do Sul,2713147,110,3,4274,39
2020-06-19,Brazil,NA,MatoGrosso do Sul,2713147,392,1,4666,40
2020-06-20,Brazil,NA,MatoGrosso do Sul,2713147,324,3,4990,43
2020-06-21,Brazil,NA,MatoGrosso do Sul,2713147,247,2,5237,45
2020-06-22,Brazil,NA,MatoGrosso do Sul,2713147,154,2,5391,47
2020-06-23,Brazil,NA,MatoGrosso do Sul,2713147,393,8,5784,55
2020-06-24,Brazil,NA,MatoGrosso do Sul,2713147,417,1,6201,56
2020-06-25,Brazil,NA,MatoGrosso do Sul,2713147,322,5,6523,61
2020-06-26,Brazil,NA,MatoGrosso do Sul,2713147,390,4,6913,65
2020-06-27,Brazil,NA,MatoGrosso do Sul,2713147,394,3,7307,68
2020-06-28,Brazil,NA,MatoGrosso do Sul,2713147,220,4,7527,72
2020-06-29,Brazil,NA,MatoGrosso do Sul,2713147,149,3,7676,75
2020-06-30,Brazil,NA,MatoGrosso do Sul,2713147,289,1,7965,76
2020-07-01,Brazil,NA,MatoGrosso do Sul,2713147,711,9,8676,85
2020-07-02,Brazil,NA,MatoGrosso do Sul,2713147,386,6,9062,91
2020-07-03,Brazil,NA,MatoGrosso do Sul,2713147,326,16,9388,107
2020-07-04,Brazil,NA,MatoGrosso do Sul,2713147,522,7,9910,114
2020-07-05,Brazil,NA,MatoGrosso do Sul,2713147,179,3,10089,117
2020-07-06,Brazil,NA,MatoGrosso do Sul,2713147,164,5,10253,122
2020-07-07,Brazil,NA,MatoGrosso do Sul,2713147,434,6,10687,128
2020-07-08,Brazil,NA,MatoGrosso do Sul,2713147,376,6,11063,134
2020-07-09,Brazil,NA,MatoGrosso do Sul,2713147,608,2,11671,136
2020-07-10,Brazil,NA,MatoGrosso do Sul,2713147,590,10,12261,146
2020-07-11,Brazil,NA,MatoGrosso do Sul,2713147,708,7,12969,153
2020-07-12,Brazil,NA,MatoGrosso do Sul,2713147,228,8,13197,161
2020-07-13,Brazil,NA,MatoGrosso do Sul,2713147,264,6,13461,167
2020-07-14,Brazil,NA,MatoGrosso do Sul,2713147,473,10,13934,177
2020-07-15,Brazil,NA,MatoGrosso do Sul,2713147,697,6,14631,183
2020-07-16,Brazil,NA,MatoGrosso do Sul,2713147,699,8,15330,191
2020-07-17,Brazil,NA,MatoGrosso do Sul,2713147,475,12,15805,203
2020-07-18,Brazil,NA,MatoGrosso do Sul,2713147,201,13,16006,216
2020-07-19,Brazil,NA,MatoGrosso do Sul,2713147,397,6,16403,222
2020-07-20,Brazil,NA,MatoGrosso do Sul,2713147,234,6,16637,228
2020-07-21,Brazil,NA,MatoGrosso do Sul,2713147,749,20,17386,248
2020-07-22,Brazil,NA,MatoGrosso do Sul,2713147,1503,9,18889,257
2020-07-23,Brazil,NA,MatoGrosso do Sul,2713147,782,9,19671,266
2020-07-24,Brazil,NA,MatoGrosso do Sul,2713147,632,15,20303,281
2020-07-25,Brazil,NA,MatoGrosso do Sul,2713147,712,11,21015,292
2020-07-26,Brazil,NA,MatoGrosso do Sul,2713147,499,13,21514,305
2020-07-27,Brazil,NA,MatoGrosso do Sul,2713147,288,14,21802,319
2020-07-28,Brazil,NA,MatoGrosso do Sul,2713147,641,9,22443,328
2020-07-29,Brazil,NA,MatoGrosso do Sul,2713147,968,14,23411,342
2020-07-30,Brazil,NA,MatoGrosso do Sul,2713147,876,15,24287,357
2020-07-31,Brazil,NA,MatoGrosso do Sul,2713147,649,19,24936,376
2020-08-01,Brazil,NA,MatoGrosso do Sul,2713147,803,13,25739,389
2020-08-02,Brazil,NA,MatoGrosso do Sul,2713147,264,15,26003,404
2020-08-03,Brazil,NA,MatoGrosso do Sul,2713147,642,17,26645,421
2020-08-04,Brazil,NA,MatoGrosso do Sul,2713147,1033,11,27678,432
2020-08-05,Brazil,NA,MatoGrosso do Sul,2713147,637,10,28315,442
2020-08-06,Brazil,NA,MatoGrosso do Sul,2713147,786,16,29101,458
2020-08-07,Brazil,NA,MatoGrosso do Sul,2713147,887,23,29988,481
2020-08-08,Brazil,NA,MatoGrosso do Sul,2713147,719,11,30707,492
2020-08-09,Brazil,NA,MatoGrosso do Sul,2713147,637,17,31344,509
2020-08-10,Brazil,NA,MatoGrosso do Sul,2713147,395,14,31739,523
2020-08-11,Brazil,NA,MatoGrosso do Sul,2713147,823,21,32562,544
2020-08-12,Brazil,NA,MatoGrosso do Sul,2713147,947,14,33509,558
2020-08-13,Brazil,NA,MatoGrosso do Sul,2713147,1050,12,34559,570
2020-08-14,Brazil,NA,MatoGrosso do Sul,2713147,875,21,35434,591
2020-08-15,Brazil,NA,MatoGrosso do Sul,2713147,1108,7,36542,598
2020-08-16,Brazil,NA,MatoGrosso do Sul,2713147,294,28,36836,626
2020-08-17,Brazil,NA,MatoGrosso do Sul,2713147,589,14,37425,640
2020-08-18,Brazil,NA,MatoGrosso do Sul,2713147,968,17,38393,657
2020-08-19,Brazil,NA,MatoGrosso do Sul,2713147,988,11,39381,668
2020-08-20,Brazil,NA,MatoGrosso do Sul,2713147,820,18,40201,686
2020-08-21,Brazil,NA,MatoGrosso do Sul,2713147,510,10,40711,696
2020-08-22,Brazil,NA,MatoGrosso do Sul,2713147,1177,26,41888,722
2020-08-23,Brazil,NA,MatoGrosso do Sul,2713147,610,16,42498,738
2020-08-24,Brazil,NA,MatoGrosso do Sul,2713147,567,11,43065,749
2020-08-25,Brazil,NA,MatoGrosso do Sul,2713147,1259,18,44324,767
2020-08-26,Brazil,NA,MatoGrosso do Sul,2713147,1035,16,45359,783
2020-08-27,Brazil,NA,MatoGrosso do Sul,2713147,902,17,46261,800
2020-08-28,Brazil,NA,MatoGrosso do Sul,2713147,891,23,47152,823
2020-08-29,Brazil,NA,MatoGrosso do Sul,2713147,871,17,48023,840
2020-08-30,Brazil,NA,MatoGrosso do Sul,2713147,499,11,48522,851
2020-08-31,Brazil,NA,MatoGrosso do Sul,2713147,415,11,48937,862
2020-09-01,Brazil,NA,MatoGrosso do Sul,2713147,883,27,49820,889
2020-09-02,Brazil,NA,MatoGrosso do Sul,2713147,825,14,50645,903
2020-09-03,Brazil,NA,MatoGrosso do Sul,2713147,930,11,51575,914
2020-09-04,Brazil,NA,MatoGrosso do Sul,2713147,831,25,52406,939
2020-09-05,Brazil,NA,MatoGrosso do Sul,2713147,922,14,53328,953
2020-09-06,Brazil,NA,MatoGrosso do Sul,2713147,163,13,53491,966
2020-09-07,Brazil,NA,MatoGrosso do Sul,2713147,634,4,54125,970
2020-09-08,Brazil,NA,MatoGrosso do Sul,2713147,238,17,54363,987
2020-09-09,Brazil,NA,MatoGrosso do Sul,2713147,982,20,55345,1007
2020-09-10,Brazil,NA,MatoGrosso do Sul,2713147,701,17,56046,1024
2020-09-11,Brazil,NA,MatoGrosso do Sul,2713147,2258,11,58304,1035
2020-09-12,Brazil,NA,MatoGrosso do Sul,2713147,367,20,58671,1055
2020-09-13,Brazil,NA,MatoGrosso do Sul,2713147,406,10,59077,1065
2020-09-14,Brazil,NA,MatoGrosso do Sul,2713147,331,20,59408,1085
2020-09-15,Brazil,NA,MatoGrosso do Sul,2713147,889,21,60297,1106
2020-09-16,Brazil,NA,MatoGrosso do Sul,2713147,666,16,60963,1122
2020-09-17,Brazil,NA,MatoGrosso do Sul,2713147,831,11,61794,1133
2020-09-18,Brazil,NA,MatoGrosso do Sul,2713147,1023,15,62817,1148
2020-09-19,Brazil,NA,MatoGrosso do Sul,2713147,649,14,63466,1162
2020-09-20,Brazil,NA,MatoGrosso do Sul,2713147,382,10,63848,1172
2020-09-21,Brazil,NA,MatoGrosso do Sul,2713147,185,7,64033,1179
2020-09-22,Brazil,NA,MatoGrosso do Sul,2713147,926,12,64959,1191
2020-09-23,Brazil,NA,MatoGrosso do Sul,2713147,652,13,65611,1204
2020-03-18,Brazil,NA,Minas Gerais,21119536,8,0,15,0
2020-03-19,Brazil,NA,Minas Gerais,21119536,14,0,29,0
2020-03-20,Brazil,NA,Minas Gerais,21119536,6,0,35,0
2020-03-21,Brazil,NA,Minas Gerais,21119536,3,0,38,0
2020-03-22,Brazil,NA,Minas Gerais,21119536,45,0,83,0
2020-03-23,Brazil,NA,Minas Gerais,21119536,45,0,128,0
2020-03-24,Brazil,NA,Minas Gerais,21119536,2,0,130,0
2020-03-25,Brazil,NA,Minas Gerais,21119536,3,0,133,0
2020-03-26,Brazil,NA,Minas Gerais,21119536,20,0,153,0
2020-03-27,Brazil,NA,Minas Gerais,21119536,36,0,189,0
2020-03-28,Brazil,NA,Minas Gerais,21119536,16,0,205,0
2020-03-29,Brazil,NA,Minas Gerais,21119536,26,0,231,0
2020-03-30,Brazil,NA,Minas Gerais,21119536,30,1,261,1
2020-03-31,Brazil,NA,Minas Gerais,21119536,14,1,275,2
2020-04-01,Brazil,NA,Minas Gerais,21119536,39,1,314,3
2020-04-02,Brazil,NA,Minas Gerais,21119536,56,1,370,4
2020-04-03,Brazil,NA,Minas Gerais,21119536,27,2,397,6
2020-04-04,Brazil,NA,Minas Gerais,21119536,33,0,430,6
2020-04-05,Brazil,NA,Minas Gerais,21119536,68,0,498,6
2020-04-06,Brazil,NA,Minas Gerais,21119536,27,3,525,9
2020-04-07,Brazil,NA,Minas Gerais,21119536,34,2,559,11
2020-04-08,Brazil,NA,Minas Gerais,21119536,55,3,614,14
2020-04-09,Brazil,NA,Minas Gerais,21119536,41,1,655,15
2020-04-10,Brazil,NA,Minas Gerais,21119536,43,2,698,17
2020-04-11,Brazil,NA,Minas Gerais,21119536,52,0,750,17
2020-04-12,Brazil,NA,Minas Gerais,21119536,56,3,806,20
2020-04-13,Brazil,NA,Minas Gerais,21119536,9,3,815,23
2020-04-14,Brazil,NA,Minas Gerais,21119536,69,4,884,27
2020-04-15,Brazil,NA,Minas Gerais,21119536,19,3,903,30
2020-04-16,Brazil,NA,Minas Gerais,21119536,55,3,958,33
2020-04-17,Brazil,NA,Minas Gerais,21119536,63,2,1021,35
2020-04-18,Brazil,NA,Minas Gerais,21119536,56,4,1077,39
2020-04-19,Brazil,NA,Minas Gerais,21119536,77,0,1154,39
2020-04-20,Brazil,NA,Minas Gerais,21119536,35,2,1189,41
2020-04-21,Brazil,NA,Minas Gerais,21119536,41,3,1230,44
2020-04-22,Brazil,NA,Minas Gerais,21119536,53,3,1283,47
2020-04-23,Brazil,NA,Minas Gerais,21119536,25,4,1308,51
2020-04-24,Brazil,NA,Minas Gerais,21119536,111,3,1419,54
2020-04-25,Brazil,NA,Minas Gerais,21119536,62,4,1481,58
2020-04-26,Brazil,NA,Minas Gerais,21119536,67,3,1548,61
2020-04-27,Brazil,NA,Minas Gerais,21119536,38,1,1586,62
2020-04-28,Brazil,NA,Minas Gerais,21119536,63,9,1649,71
2020-04-29,Brazil,NA,Minas Gerais,21119536,109,9,1758,80
2020-04-30,Brazil,NA,Minas Gerais,21119536,69,2,1827,82
2020-05-01,Brazil,NA,Minas Gerais,21119536,108,6,1935,88
2020-05-02,Brazil,NA,Minas Gerais,21119536,88,0,2023,88
2020-05-03,Brazil,NA,Minas Gerais,21119536,95,1,2118,89
2020-05-04,Brazil,NA,Minas Gerais,21119536,229,1,2347,90
2020-05-05,Brazil,NA,Minas Gerais,21119536,105,4,2452,94
2020-05-06,Brazil,NA,Minas Gerais,21119536,153,3,2605,97
2020-05-07,Brazil,NA,Minas Gerais,21119536,165,9,2770,106
2020-05-08,Brazil,NA,Minas Gerais,21119536,173,5,2943,111
2020-05-09,Brazil,NA,Minas Gerais,21119536,180,7,3123,118
2020-05-10,Brazil,NA,Minas Gerais,21119536,114,1,3237,119
2020-05-11,Brazil,NA,Minas Gerais,21119536,83,2,3320,121
2020-05-12,Brazil,NA,Minas Gerais,21119536,115,6,3435,127
2020-05-13,Brazil,NA,Minas Gerais,21119536,298,8,3733,135
2020-05-14,Brazil,NA,Minas Gerais,21119536,217,4,3950,139
2020-05-15,Brazil,NA,Minas Gerais,21119536,246,7,4196,146
2020-05-16,Brazil,NA,Minas Gerais,21119536,278,4,4474,150
2020-05-17,Brazil,NA,Minas Gerais,21119536,137,6,4611,156
2020-05-18,Brazil,NA,Minas Gerais,21119536,84,5,4695,161
2020-05-19,Brazil,NA,Minas Gerais,21119536,282,6,4977,167
2020-05-20,Brazil,NA,Minas Gerais,21119536,309,10,5286,177
2020-05-21,Brazil,NA,Minas Gerais,21119536,310,14,5596,191
2020-05-22,Brazil,NA,Minas Gerais,21119536,399,10,5995,201
2020-05-23,Brazil,NA,Minas Gerais,21119536,343,16,6338,217
2020-05-24,Brazil,NA,Minas Gerais,21119536,330,9,6668,226
2020-05-25,Brazil,NA,Minas Gerais,21119536,294,4,6962,230
2020-05-26,Brazil,NA,Minas Gerais,21119536,554,4,7516,234
2020-05-27,Brazil,NA,Minas Gerais,21119536,495,6,8011,240
2020-05-28,Brazil,NA,Minas Gerais,21119536,675,15,8686,255
2020-05-29,Brazil,NA,Minas Gerais,21119536,546,2,9232,257
2020-05-30,Brazil,NA,Minas Gerais,21119536,398,6,9630,263
2020-05-31,Brazil,NA,Minas Gerais,21119536,834,8,10464,271
2020-06-01,Brazil,NA,Minas Gerais,21119536,206,7,10670,278
2020-06-02,Brazil,NA,Minas Gerais,21119536,269,11,10939,289
2020-06-03,Brazil,NA,Minas Gerais,21119536,1071,17,12010,306
2020-06-04,Brazil,NA,Minas Gerais,21119536,1024,17,13034,323
2020-06-05,Brazil,NA,Minas Gerais,21119536,961,21,13995,344
2020-06-06,Brazil,NA,Minas Gerais,21119536,944,24,14939,368
2020-06-07,Brazil,NA,Minas Gerais,21119536,764,8,15703,376
2020-06-08,Brazil,NA,Minas Gerais,21119536,180,4,15883,380
2020-06-09,Brazil,NA,Minas Gerais,21119536,219,19,16102,399
2020-06-10,Brazil,NA,Minas Gerais,21119536,1399,10,17501,409
2020-06-11,Brazil,NA,Minas Gerais,21119536,947,22,18448,431
2020-06-12,Brazil,NA,Minas Gerais,21119536,1658,15,20106,446
2020-06-13,Brazil,NA,Minas Gerais,21119536,508,8,20614,454
2020-06-14,Brazil,NA,Minas Gerais,21119536,767,21,21381,475
2020-06-15,Brazil,NA,Minas Gerais,21119536,347,6,21728,481
2020-06-16,Brazil,NA,Minas Gerais,21119536,296,21,22024,502
2020-06-17,Brazil,NA,Minas Gerais,21119536,1323,35,23347,537
2020-06-18,Brazil,NA,Minas Gerais,21119536,1559,33,24906,570
2020-06-19,Brazil,NA,Minas Gerais,21119536,1146,30,26052,600
2020-06-20,Brazil,NA,Minas Gerais,21119536,1253,36,27305,636
2020-06-21,Brazil,NA,Minas Gerais,21119536,336,25,27641,661
2020-06-22,Brazil,NA,Minas Gerais,21119536,1277,27,28918,688
2020-06-23,Brazil,NA,Minas Gerais,21119536,979,32,29897,720
2020-06-24,Brazil,NA,Minas Gerais,21119536,1446,51,31343,771
2020-06-25,Brazil,NA,Minas Gerais,21119536,1426,35,32769,806
2020-06-26,Brazil,NA,Minas Gerais,21119536,6122,27,38891,833
2020-06-27,Brazil,NA,Minas Gerais,21119536,2075,49,40966,882
2020-06-28,Brazil,NA,Minas Gerais,21119536,1775,17,42741,899
2020-06-29,Brazil,NA,Minas Gerais,21119536,1123,41,43864,940
2020-06-30,Brazil,NA,Minas Gerais,21119536,1137,25,45001,965
2020-07-01,Brazil,NA,Minas Gerais,21119536,2583,42,47584,1007
2020-07-02,Brazil,NA,Minas Gerais,21119536,3123,52,50707,1059
2020-07-03,Brazil,NA,Minas Gerais,21119536,2644,51,53351,1110
2020-07-04,Brazil,NA,Minas Gerais,21119536,2607,73,55958,1183
2020-07-05,Brazil,NA,Minas Gerais,21119536,2325,18,58283,1201
2020-07-06,Brazil,NA,Minas Gerais,21119536,1343,29,59626,1230
2020-07-07,Brazil,NA,Minas Gerais,21119536,1271,52,60897,1282
2020-07-08,Brazil,NA,Minas Gerais,21119536,3138,73,64035,1355
2020-07-09,Brazil,NA,Minas Gerais,21119536,2829,90,66864,1445
2020-07-10,Brazil,NA,Minas Gerais,21119536,3222,59,70086,1504
2020-07-11,Brazil,NA,Minas Gerais,21119536,3727,46,73813,1550
2020-07-12,Brazil,NA,Minas Gerais,21119536,2038,26,75851,1576
2020-07-13,Brazil,NA,Minas Gerais,21119536,971,39,76822,1615
2020-07-14,Brazil,NA,Minas Gerais,21119536,1821,73,78643,1688
2020-07-15,Brazil,NA,Minas Gerais,21119536,3367,64,82010,1752
2020-07-16,Brazil,NA,Minas Gerais,21119536,2460,82,84470,1834
2020-07-17,Brazil,NA,Minas Gerais,21119536,2801,70,87271,1904
2020-07-18,Brazil,NA,Minas Gerais,21119536,3604,60,90875,1964
2020-07-19,Brazil,NA,Minas Gerais,21119536,2097,18,92972,1982
2020-07-20,Brazil,NA,Minas Gerais,21119536,1160,22,94132,2004
2020-07-21,Brazil,NA,Minas Gerais,21119536,1434,67,95566,2071
2020-07-22,Brazil,NA,Minas Gerais,21119536,3175,95,98741,2166
2020-07-23,Brazil,NA,Minas Gerais,21119536,3827,72,102568,2238
2020-07-24,Brazil,NA,Minas Gerais,21119536,4244,77,106812,2315
2020-07-25,Brazil,NA,Minas Gerais,21119536,3281,89,110093,2404
2020-07-26,Brazil,NA,Minas Gerais,21119536,2478,25,112571,2429
2020-07-27,Brazil,NA,Minas Gerais,21119536,1147,32,113718,2461
2020-07-28,Brazil,NA,Minas Gerais,21119536,2927,90,116645,2551
2020-07-29,Brazil,NA,Minas Gerais,21119536,2749,57,119394,2608
2020-07-30,Brazil,NA,Minas Gerais,21119536,4021,84,123415,2692
2020-07-31,Brazil,NA,Minas Gerais,21119536,3691,77,127106,2769
2020-08-01,Brazil,NA,Minas Gerais,21119536,2879,92,129985,2861
2020-08-02,Brazil,NA,Minas Gerais,21119536,2816,30,132801,2891
2020-08-03,Brazil,NA,Minas Gerais,21119536,942,3,133743,2894
2020-08-04,Brazil,NA,Minas Gerais,21119536,1985,0,135728,2894
2020-08-05,Brazil,NA,Minas Gerais,21119536,3933,301,139661,3195
2020-08-06,Brazil,NA,Minas Gerais,21119536,3167,109,142828,3304
2020-08-07,Brazil,NA,Minas Gerais,21119536,4495,77,147323,3381
2020-08-08,Brazil,NA,Minas Gerais,21119536,3400,68,150723,3449
2020-08-09,Brazil,NA,Minas Gerais,21119536,3204,88,153927,3537
2020-08-10,Brazil,NA,Minas Gerais,21119536,1148,60,155075,3597
2020-08-11,Brazil,NA,Minas Gerais,21119536,1476,16,156551,3613
2020-08-12,Brazil,NA,Minas Gerais,21119536,3934,170,160485,3783
2020-08-13,Brazil,NA,Minas Gerais,21119536,4430,63,164915,3846
2020-08-14,Brazil,NA,Minas Gerais,21119536,3513,97,168428,3943
2020-08-15,Brazil,NA,Minas Gerais,21119536,3086,101,171514,4044
2020-08-16,Brazil,NA,Minas Gerais,21119536,2888,88,174402,4132
2020-08-17,Brazil,NA,Minas Gerais,21119536,1313,91,175715,4223
2020-08-18,Brazil,NA,Minas Gerais,21119536,2072,83,177787,4306
2020-08-19,Brazil,NA,Minas Gerais,21119536,3371,130,181158,4436
2020-08-20,Brazil,NA,Minas Gerais,21119536,3904,107,185062,4543
2020-08-21,Brazil,NA,Minas Gerais,21119536,3561,120,188623,4663
2020-08-22,Brazil,NA,Minas Gerais,21119536,2884,74,191507,4737
2020-08-23,Brazil,NA,Minas Gerais,21119536,3107,53,194614,4790
2020-08-24,Brazil,NA,Minas Gerais,21119536,1306,15,195920,4805
2020-08-25,Brazil,NA,Minas Gerais,21119536,2816,42,198736,4847
2020-08-26,Brazil,NA,Minas Gerais,21119536,3237,101,201973,4948
2020-08-27,Brazil,NA,Minas Gerais,21119536,3969,101,205942,5049
2020-08-28,Brazil,NA,Minas Gerais,21119536,3523,118,209465,5167
2020-08-29,Brazil,NA,Minas Gerais,21119536,3100,103,212565,5270
2020-08-30,Brazil,NA,Minas Gerais,21119536,2485,56,215050,5326
2020-08-31,Brazil,NA,Minas Gerais,21119536,1507,9,216557,5335
2020-09-01,Brazil,NA,Minas Gerais,21119536,2224,29,218781,5364
2020-09-02,Brazil,NA,Minas Gerais,21119536,3267,141,222048,5505
2020-09-03,Brazil,NA,Minas Gerais,21119536,2939,86,224987,5591
2020-09-04,Brazil,NA,Minas Gerais,21119536,3026,117,228013,5708
2020-09-05,Brazil,NA,Minas Gerais,21119536,3865,0,231878,5708
2020-09-06,Brazil,NA,Minas Gerais,21119536,2926,129,234804,5837
2020-09-07,Brazil,NA,Minas Gerais,21119536,1208,14,236012,5851
2020-09-08,Brazil,NA,Minas Gerais,21119536,651,26,236663,5877
2020-09-09,Brazil,NA,Minas Gerais,21119536,1852,58,238515,5935
2020-09-10,Brazil,NA,Minas Gerais,21119536,4018,74,242533,6009
2020-09-11,Brazil,NA,Minas Gerais,21119536,3616,105,246149,6114
2020-09-12,Brazil,NA,Minas Gerais,21119536,4041,86,250190,6200
2020-09-13,Brazil,NA,Minas Gerais,21119536,2073,76,252263,6276
2020-09-14,Brazil,NA,Minas Gerais,21119536,1734,10,253997,6286
2020-09-15,Brazil,NA,Minas Gerais,21119536,1609,42,255606,6328
2020-09-16,Brazil,NA,Minas Gerais,21119536,2989,91,258595,6419
2020-09-17,Brazil,NA,Minas Gerais,21119536,3406,81,262001,6500
2020-09-18,Brazil,NA,Minas Gerais,21119536,3184,74,265185,6574
2020-09-19,Brazil,NA,Minas Gerais,21119536,2824,82,268009,6656
2020-09-20,Brazil,NA,Minas Gerais,21119536,2044,58,270053,6714
2020-09-21,Brazil,NA,Minas Gerais,21119536,1141,13,271194,6727
2020-09-22,Brazil,NA,Minas Gerais,21119536,2039,37,273233,6764
2020-09-23,Brazil,NA,Minas Gerais,21119536,3081,133,276314,6897
2020-03-26,Brazil,NA,Para,8366628,6,0,13,0
2020-03-27,Brazil,NA,Para,8366628,0,0,13,0
2020-03-28,Brazil,NA,Para,8366628,4,0,17,0
2020-03-29,Brazil,NA,Para,8366628,1,0,18,0
2020-03-30,Brazil,NA,Para,8366628,3,0,21,0
2020-03-31,Brazil,NA,Para,8366628,11,0,32,0
2020-04-01,Brazil,NA,Para,8366628,8,1,40,1
2020-04-02,Brazil,NA,Para,8366628,6,0,46,1
2020-04-03,Brazil,NA,Para,8366628,4,0,50,1
2020-04-04,Brazil,NA,Para,8366628,30,0,80,1
2020-04-05,Brazil,NA,Para,8366628,6,0,86,1
2020-04-06,Brazil,NA,Para,8366628,16,2,102,3
2020-04-07,Brazil,NA,Para,8366628,36,2,138,5
2020-04-08,Brazil,NA,Para,8366628,29,1,167,6
2020-04-09,Brazil,NA,Para,8366628,1,1,168,7
2020-04-10,Brazil,NA,Para,8366628,2,2,170,9
2020-04-11,Brazil,NA,Para,8366628,47,1,217,10
2020-04-12,Brazil,NA,Para,8366628,29,3,246,13
2020-04-13,Brazil,NA,Para,8366628,24,2,270,15
2020-04-14,Brazil,NA,Para,8366628,53,4,323,19
2020-04-15,Brazil,NA,Para,8366628,61,2,384,21
2020-04-16,Brazil,NA,Para,8366628,54,3,438,24
2020-04-17,Brazil,NA,Para,8366628,119,2,557,26
2020-04-18,Brazil,NA,Para,8366628,83,7,640,33
2020-04-19,Brazil,NA,Para,8366628,45,1,685,34
2020-04-20,Brazil,NA,Para,8366628,217,1,902,35
2020-04-21,Brazil,NA,Para,8366628,124,3,1026,38
2020-04-22,Brazil,NA,Para,8366628,169,5,1195,43
2020-04-23,Brazil,NA,Para,8366628,72,10,1267,53
2020-04-24,Brazil,NA,Para,8366628,179,22,1446,75
2020-04-25,Brazil,NA,Para,8366628,133,11,1579,86
2020-04-26,Brazil,NA,Para,8366628,288,14,1867,100
2020-04-27,Brazil,NA,Para,8366628,261,14,2128,114
2020-04-28,Brazil,NA,Para,8366628,134,15,2262,129
2020-04-29,Brazil,NA,Para,8366628,160,8,2422,137
2020-04-30,Brazil,NA,Para,8366628,454,71,2876,208
2020-05-01,Brazil,NA,Para,8366628,300,27,3176,235
2020-05-02,Brazil,NA,Para,8366628,284,38,3460,273
2020-05-03,Brazil,NA,Para,8366628,403,36,3863,309
2020-05-04,Brazil,NA,Para,8366628,262,21,4125,330
2020-05-05,Brazil,NA,Para,8366628,347,39,4472,369
2020-05-06,Brazil,NA,Para,8366628,545,23,5017,392
2020-05-07,Brazil,NA,Para,8366628,507,18,5524,410
2020-05-08,Brazil,NA,Para,8366628,617,105,6141,515
2020-05-09,Brazil,NA,Para,8366628,634,63,6775,578
2020-05-10,Brazil,NA,Para,8366628,481,74,7256,652
2020-05-11,Brazil,NA,Para,8366628,307,56,7563,708
2020-05-12,Brazil,NA,Para,8366628,1053,156,8616,864
2020-05-13,Brazil,NA,Para,8366628,1002,82,9618,946
2020-05-14,Brazil,NA,Para,8366628,1249,117,10867,1063
2020-05-15,Brazil,NA,Para,8366628,1242,82,12109,1145
2020-05-16,Brazil,NA,Para,8366628,1075,54,13184,1199
2020-05-17,Brazil,NA,Para,8366628,680,40,13864,1239
2020-05-18,Brazil,NA,Para,8366628,870,90,14734,1329
2020-05-19,Brazil,NA,Para,8366628,1561,190,16295,1519
2020-05-20,Brazil,NA,Para,8366628,1840,114,18135,1633
2020-05-21,Brazil,NA,Para,8366628,1621,219,19756,1852
2020-05-22,Brazil,NA,Para,8366628,1713,85,21469,1937
2020-05-23,Brazil,NA,Para,8366628,1228,64,22697,2001
2020-05-24,Brazil,NA,Para,8366628,1428,147,24125,2148
2020-05-25,Brazil,NA,Para,8366628,1952,224,26077,2372
2020-05-26,Brazil,NA,Para,8366628,2523,97,28600,2469
2020-05-27,Brazil,NA,Para,8366628,2433,76,31033,2545
2020-05-28,Brazil,NA,Para,8366628,2666,159,33699,2704
2020-05-29,Brazil,NA,Para,8366628,2787,123,36486,2827
2020-05-30,Brazil,NA,Para,8366628,810,73,37296,2900
2020-05-31,Brazil,NA,Para,8366628,665,23,37961,2923
2020-06-01,Brazil,NA,Para,8366628,85,2,38046,2925
2020-06-02,Brazil,NA,Para,8366628,3161,115,41207,3040
2020-06-03,Brazil,NA,Para,8366628,3567,153,44774,3193
2020-06-04,Brazil,NA,Para,8366628,3275,223,48049,3416
2020-06-05,Brazil,NA,Para,8366628,2911,122,50960,3538
2020-06-06,Brazil,NA,Para,8366628,2216,74,53176,3612
2020-06-07,Brazil,NA,Para,8366628,1095,66,54271,3678
2020-06-08,Brazil,NA,Para,8366628,1761,94,56032,3772
2020-06-09,Brazil,NA,Para,8366628,3116,81,59148,3853
2020-06-10,Brazil,NA,Para,8366628,2947,74,62095,3927
2020-06-11,Brazil,NA,Para,8366628,2031,103,64126,4030
2020-06-12,Brazil,NA,Para,8366628,2202,102,66328,4132
2020-06-13,Brazil,NA,Para,8366628,2182,45,68510,4177
2020-06-14,Brazil,NA,Para,8366628,669,14,69179,4191
2020-06-15,Brazil,NA,Para,8366628,45,10,69224,4201
2020-06-16,Brazil,NA,Para,8366628,2019,90,71243,4291
2020-06-17,Brazil,NA,Para,8366628,2949,59,74192,4350
2020-06-18,Brazil,NA,Para,8366628,2431,45,76623,4395
2020-06-19,Brazil,NA,Para,8366628,3449,74,80072,4469
2020-06-20,Brazil,NA,Para,8366628,2809,50,82881,4519
2020-06-21,Brazil,NA,Para,8366628,1773,64,84654,4583
2020-06-22,Brazil,NA,Para,8366628,1366,22,86020,4605
2020-06-23,Brazil,NA,Para,8366628,2616,67,88636,4672
2020-06-24,Brazil,NA,Para,8366628,3072,54,91708,4726
2020-06-25,Brazil,NA,Para,8366628,2328,22,94036,4748
2020-06-26,Brazil,NA,Para,8366628,2436,55,96472,4803
2020-06-27,Brazil,NA,Para,8366628,2841,31,99313,4834
2020-06-28,Brazil,NA,Para,8366628,1130,11,100443,4845
2020-06-29,Brazil,NA,Para,8366628,764,25,101207,4870
2020-06-30,Brazil,NA,Para,8366628,1999,50,103206,4920
2020-07-01,Brazil,NA,Para,8366628,2647,40,105853,4960
2020-07-02,Brazil,NA,Para,8366628,2214,44,108067,5004
2020-07-03,Brazil,NA,Para,8366628,2344,46,110411,5050
2020-07-04,Brazil,NA,Para,8366628,2120,19,112531,5069
2020-07-05,Brazil,NA,Para,8366628,1280,27,113811,5096
2020-07-06,Brazil,NA,Para,8366628,724,9,114535,5105
2020-07-07,Brazil,NA,Para,8366628,1617,23,116152,5128
2020-07-08,Brazil,NA,Para,8366628,2592,41,118744,5169
2020-07-09,Brazil,NA,Para,8366628,1987,27,120731,5196
2020-07-10,Brazil,NA,Para,8366628,1943,28,122674,5224
2020-07-11,Brazil,NA,Para,8366628,2260,50,124934,5274
2020-07-12,Brazil,NA,Para,8366628,780,15,125714,5289
2020-07-13,Brazil,NA,Para,8366628,795,4,126509,5293
2020-07-14,Brazil,NA,Para,8366628,2061,25,128570,5318
2020-07-15,Brazil,NA,Para,8366628,2264,19,130834,5337
2020-07-16,Brazil,NA,Para,8366628,2205,48,133039,5385
2020-07-17,Brazil,NA,Para,8366628,2125,63,135164,5448
2020-07-18,Brazil,NA,Para,8366628,1783,30,136947,5478
2020-07-19,Brazil,NA,Para,8366628,537,45,137484,5523
2020-07-20,Brazil,NA,Para,8366628,912,15,138396,5538
2020-07-21,Brazil,NA,Para,8366628,1992,15,140388,5553
2020-07-22,Brazil,NA,Para,8366628,1970,28,142358,5581
2020-07-23,Brazil,NA,Para,8366628,2109,35,144467,5616
2020-07-24,Brazil,NA,Para,8366628,1785,30,146252,5646
2020-07-25,Brazil,NA,Para,8366628,1671,43,147923,5689
2020-07-26,Brazil,NA,Para,8366628,540,27,148463,5716
2020-07-27,Brazil,NA,Para,8366628,360,13,148823,5729
2020-07-28,Brazil,NA,Para,8366628,1362,0,150185,5729
2020-07-29,Brazil,NA,Para,8366628,1664,0,151849,5729
2020-07-30,Brazil,NA,Para,8366628,1501,5,153350,5729
2020-07-31,Brazil,NA,Para,8366628,1335,29,154685,5729
2020-08-01,Brazil,NA,Para,8366628,1368,22,156053,5750
2020-08-02,Brazil,NA,Para,8366628,232,23,156285,5773
2020-08-03,Brazil,NA,Para,8366628,220,11,156505,5784
2020-08-04,Brazil,NA,Para,8366628,1772,15,158277,5799
2020-08-05,Brazil,NA,Para,8366628,2418,19,160695,5818
2020-08-06,Brazil,NA,Para,8366628,2127,17,162822,5835
2020-08-07,Brazil,NA,Para,8366628,1937,19,164759,5854
2020-08-08,Brazil,NA,Para,8366628,2340,17,167099,5871
2020-08-09,Brazil,NA,Para,8366628,543,14,167642,5885
2020-08-10,Brazil,NA,Para,8366628,509,8,168151,5893
2020-08-11,Brazil,NA,Para,8366628,1462,8,169613,5901
2020-08-12,Brazil,NA,Para,8366628,2265,8,171878,5909
2020-08-13,Brazil,NA,Para,8366628,1747,8,173625,5917
2020-08-14,Brazil,NA,Para,8366628,1983,7,175608,5924
2020-08-15,Brazil,NA,Para,8366628,1402,8,177010,5932
2020-08-16,Brazil,NA,Para,8366628,959,8,177969,5940
2020-08-17,Brazil,NA,Para,8366628,406,5,178375,5945
2020-08-18,Brazil,NA,Para,8366628,1715,30,180090,5975
2020-08-19,Brazil,NA,Para,8366628,2141,40,182231,6015
2020-08-20,Brazil,NA,Para,8366628,2022,12,184253,6027
2020-08-21,Brazil,NA,Para,8366628,2393,10,186646,6037
2020-08-22,Brazil,NA,Para,8366628,1998,10,188644,6047
2020-08-23,Brazil,NA,Para,8366628,645,10,189289,6057
2020-08-24,Brazil,NA,Para,8366628,293,5,189582,6062
2020-08-25,Brazil,NA,Para,8366628,2027,16,191609,6078
2020-08-26,Brazil,NA,Para,8366628,1955,19,193564,6097
2020-08-27,Brazil,NA,Para,8366628,1733,5,195297,6102
2020-08-28,Brazil,NA,Para,8366628,1577,4,196874,6106
2020-08-29,Brazil,NA,Para,8366628,1372,3,198246,6109
2020-08-30,Brazil,NA,Para,8366628,925,6,199171,6115
2020-08-31,Brazil,NA,Para,8366628,385,31,199556,6146
2020-09-01,Brazil,NA,Para,8366628,1429,30,200985,6176
2020-09-02,Brazil,NA,Para,8366628,1451,25,202436,6201
2020-09-03,Brazil,NA,Para,8366628,1533,14,203969,6215
2020-09-04,Brazil,NA,Para,8366628,1322,13,205291,6228
2020-09-05,Brazil,NA,Para,8366628,1573,12,206864,6240
2020-09-06,Brazil,NA,Para,8366628,774,9,207638,6249
2020-09-07,Brazil,NA,Para,8366628,621,8,208259,6257
2020-09-08,Brazil,NA,Para,8366628,301,12,208560,6269
2020-09-09,Brazil,NA,Para,8366628,1248,11,209808,6280
2020-09-10,Brazil,NA,Para,8366628,1253,9,211061,6289
2020-09-11,Brazil,NA,Para,8366628,1367,10,212428,6299
2020-09-12,Brazil,NA,Para,8366628,1227,8,213655,6307
2020-09-13,Brazil,NA,Para,8366628,721,37,214376,6344
2020-09-14,Brazil,NA,Para,8366628,430,24,214806,6368
2020-09-15,Brazil,NA,Para,8366628,1512,19,216318,6387
2020-09-16,Brazil,NA,Para,8366628,1182,18,217500,6405
2020-09-17,Brazil,NA,Para,8366628,958,16,218458,6421
2020-09-18,Brazil,NA,Para,8366628,762,17,219220,6438
2020-09-19,Brazil,NA,Para,8366628,985,13,220205,6451
2020-09-20,Brazil,NA,Para,8366628,314,9,220519,6460
2020-09-21,Brazil,NA,Para,8366628,256,8,220775,6468
2020-09-22,Brazil,NA,Para,8366628,864,9,221639,6477
2020-09-23,Brazil,NA,Para,8366628,1382,12,223021,6489
2020-03-28,Brazil,NA,Paraiba,4025558,5,0,14,0
2020-03-29,Brazil,NA,Paraiba,4025558,0,0,14,0
2020-03-30,Brazil,NA,Paraiba,4025558,1,0,15,0
2020-03-31,Brazil,NA,Paraiba,4025558,2,0,17,0
2020-04-01,Brazil,NA,Paraiba,4025558,3,1,20,1
2020-04-02,Brazil,NA,Paraiba,4025558,1,0,21,1
2020-04-03,Brazil,NA,Paraiba,4025558,8,0,29,1
2020-04-04,Brazil,NA,Paraiba,4025558,3,1,32,2
2020-04-05,Brazil,NA,Paraiba,4025558,2,2,34,4
2020-04-06,Brazil,NA,Paraiba,4025558,1,0,35,4
2020-04-07,Brazil,NA,Paraiba,4025558,1,0,36,4
2020-04-08,Brazil,NA,Paraiba,4025558,5,0,41,4
2020-04-09,Brazil,NA,Paraiba,4025558,14,3,55,7
2020-04-10,Brazil,NA,Paraiba,4025558,24,4,79,11
2020-04-11,Brazil,NA,Paraiba,4025558,6,0,85,11
2020-04-12,Brazil,NA,Paraiba,4025558,16,2,101,13
2020-04-13,Brazil,NA,Paraiba,4025558,10,0,111,13
2020-04-14,Brazil,NA,Paraiba,4025558,25,3,136,16
2020-04-15,Brazil,NA,Paraiba,4025558,15,5,151,21
2020-04-16,Brazil,NA,Paraiba,4025558,14,3,165,24
2020-04-17,Brazil,NA,Paraiba,4025558,30,2,195,26
2020-04-18,Brazil,NA,Paraiba,4025558,10,0,205,26
2020-04-19,Brazil,NA,Paraiba,4025558,31,3,236,29
2020-04-20,Brazil,NA,Paraiba,4025558,9,3,245,32
2020-04-21,Brazil,NA,Paraiba,4025558,18,1,263,33
2020-04-22,Brazil,NA,Paraiba,4025558,38,6,301,39
2020-04-23,Brazil,NA,Paraiba,4025558,44,1,345,40
2020-04-24,Brazil,NA,Paraiba,4025558,41,4,386,44
2020-04-25,Brazil,NA,Paraiba,4025558,61,2,447,46
2020-04-26,Brazil,NA,Paraiba,4025558,52,3,499,49
2020-04-27,Brazil,NA,Paraiba,4025558,44,1,543,50
2020-04-28,Brazil,NA,Paraiba,4025558,90,3,633,53
2020-04-29,Brazil,NA,Paraiba,4025558,66,5,699,58
2020-04-30,Brazil,NA,Paraiba,4025558,115,4,814,62
2020-05-01,Brazil,NA,Paraiba,4025558,112,5,926,67
2020-05-02,Brazil,NA,Paraiba,4025558,108,7,1034,74
2020-05-03,Brazil,NA,Paraiba,4025558,135,2,1169,76
2020-05-04,Brazil,NA,Paraiba,4025558,50,3,1219,79
2020-05-05,Brazil,NA,Paraiba,4025558,142,6,1361,85
2020-05-06,Brazil,NA,Paraiba,4025558,132,7,1493,92
2020-05-07,Brazil,NA,Paraiba,4025558,164,9,1657,101
2020-05-08,Brazil,NA,Paraiba,4025558,374,13,2031,114
2020-05-09,Brazil,NA,Paraiba,4025558,125,10,2156,124
2020-05-10,Brazil,NA,Paraiba,4025558,185,11,2341,135
2020-05-11,Brazil,NA,Paraiba,4025558,184,4,2525,139
2020-05-12,Brazil,NA,Paraiba,4025558,252,15,2777,154
2020-05-13,Brazil,NA,Paraiba,4025558,268,3,3045,157
2020-05-14,Brazil,NA,Paraiba,4025558,316,3,3361,160
2020-05-15,Brazil,NA,Paraiba,4025558,378,10,3739,170
2020-05-16,Brazil,NA,Paraiba,4025558,324,13,4063,183
2020-05-17,Brazil,NA,Paraiba,4025558,284,11,4347,194
2020-05-18,Brazil,NA,Paraiba,4025558,439,13,4786,207
2020-05-19,Brazil,NA,Paraiba,4025558,514,12,5300,219
2020-05-20,Brazil,NA,Paraiba,4025558,538,11,5838,230
2020-05-21,Brazil,NA,Paraiba,4025558,400,15,6238,245
2020-05-22,Brazil,NA,Paraiba,4025558,644,3,6882,248
2020-05-23,Brazil,NA,Paraiba,4025558,626,10,7508,258
2020-05-24,Brazil,NA,Paraiba,4025558,315,14,7823,272
2020-05-25,Brazil,NA,Paraiba,4025558,193,7,8016,279
2020-05-26,Brazil,NA,Paraiba,4025558,903,7,8919,286
2020-05-27,Brazil,NA,Paraiba,4025558,1290,12,10209,298
2020-05-28,Brazil,NA,Paraiba,4025558,923,20,11132,318
2020-05-29,Brazil,NA,Paraiba,4025558,879,9,12011,327
2020-05-30,Brazil,NA,Paraiba,4025558,851,20,12862,347
2020-05-31,Brazil,NA,Paraiba,4025558,300,13,13162,360
2020-06-01,Brazil,NA,Paraiba,4025558,533,10,13695,370
2020-06-02,Brazil,NA,Paraiba,4025558,1164,9,14859,379
2020-06-03,Brazil,NA,Paraiba,4025558,1159,35,16018,414
2020-06-04,Brazil,NA,Paraiba,4025558,1561,24,17579,438
2020-06-05,Brazil,NA,Paraiba,4025558,1000,13,18579,451
2020-06-06,Brazil,NA,Paraiba,4025558,1208,16,19787,467
2020-06-07,Brazil,NA,Paraiba,4025558,523,17,20310,484
2020-06-08,Brazil,NA,Paraiba,4025558,641,23,20951,507
2020-06-09,Brazil,NA,Paraiba,4025558,1501,27,22452,534
2020-06-10,Brazil,NA,Paraiba,4025558,1580,25,24032,559
2020-06-11,Brazil,NA,Paraiba,4025558,1338,11,25370,570
2020-06-12,Brazil,NA,Paraiba,4025558,1186,40,26556,610
2020-06-13,Brazil,NA,Paraiba,4025558,898,13,27454,623
2020-06-14,Brazil,NA,Paraiba,4025558,559,10,28013,633
2020-06-15,Brazil,NA,Paraiba,4025558,655,23,28668,656
2020-06-16,Brazil,NA,Paraiba,4025558,1460,15,30128,671
2020-06-17,Brazil,NA,Paraiba,4025558,1584,25,31712,696
2020-06-18,Brazil,NA,Paraiba,4025558,48,13,31760,709
2020-06-19,Brazil,NA,Paraiba,4025558,3333,15,35093,724
2020-06-20,Brazil,NA,Paraiba,4025558,1428,19,36521,743
2020-06-21,Brazil,NA,Paraiba,4025558,263,23,36784,766
2020-06-22,Brazil,NA,Paraiba,4025558,469,18,37253,784
2020-06-23,Brazil,NA,Paraiba,4025558,1746,23,38999,807
2020-06-24,Brazil,NA,Paraiba,4025558,913,21,39912,828
2020-06-25,Brazil,NA,Paraiba,4025558,912,14,40824,842
2020-06-26,Brazil,NA,Paraiba,4025558,2008,22,42832,864
2020-06-27,Brazil,NA,Paraiba,4025558,1410,32,44242,896
2020-06-28,Brazil,NA,Paraiba,4025558,437,15,44679,911
2020-06-29,Brazil,NA,Paraiba,4025558,378,20,45057,931
2020-06-30,Brazil,NA,Paraiba,4025558,1900,46,46957,977
2020-07-01,Brazil,NA,Paraiba,4025558,1218,25,48175,1002
2020-07-02,Brazil,NA,Paraiba,4025558,1361,42,49536,1044
2020-07-03,Brazil,NA,Paraiba,4025558,1229,18,50765,1062
2020-07-04,Brazil,NA,Paraiba,4025558,1541,20,52306,1082
2020-07-05,Brazil,NA,Paraiba,4025558,422,17,52728,1099
2020-07-06,Brazil,NA,Paraiba,4025558,423,19,53151,1118
2020-07-07,Brazil,NA,Paraiba,4025558,1651,27,54802,1145
2020-07-08,Brazil,NA,Paraiba,4025558,1542,26,56344,1171
2020-07-09,Brazil,NA,Paraiba,4025558,1270,25,57614,1196
2020-07-10,Brazil,NA,Paraiba,4025558,1504,33,59118,1229
2020-07-11,Brazil,NA,Paraiba,4025558,1303,21,60421,1250
2020-07-12,Brazil,NA,Paraiba,4025558,363,34,60784,1284
2020-07-13,Brazil,NA,Paraiba,4025558,324,18,61108,1302
2020-07-14,Brazil,NA,Paraiba,4025558,1354,40,62462,1342
2020-07-15,Brazil,NA,Paraiba,4025558,1477,41,63939,1383
2020-07-16,Brazil,NA,Paraiba,4025558,1484,35,65423,1418
2020-07-17,Brazil,NA,Paraiba,4025558,924,28,66347,1446
2020-07-18,Brazil,NA,Paraiba,4025558,624,31,66971,1477
2020-07-19,Brazil,NA,Paraiba,4025558,411,9,67382,1486
2020-07-20,Brazil,NA,Paraiba,4025558,298,31,67680,1517
2020-07-21,Brazil,NA,Paraiba,4025558,1164,41,68844,1558
2020-07-22,Brazil,NA,Paraiba,4025558,2128,23,70972,1581
2020-07-23,Brazil,NA,Paraiba,4025558,2132,37,73104,1618
2020-07-24,Brazil,NA,Paraiba,4025558,1446,35,74550,1653
2020-07-25,Brazil,NA,Paraiba,4025558,1173,22,75723,1675
2020-07-26,Brazil,NA,Paraiba,4025558,430,23,76153,1698
2020-07-27,Brazil,NA,Paraiba,4025558,540,29,76693,1727
2020-07-28,Brazil,NA,Paraiba,4025558,1482,18,78175,1745
2020-07-29,Brazil,NA,Paraiba,4025558,1723,21,79898,1766
2020-07-30,Brazil,NA,Paraiba,4025558,1210,19,81108,1785
2020-07-31,Brazil,NA,Paraiba,4025558,1686,26,82794,1811
2020-08-01,Brazil,NA,Paraiba,4025558,667,22,83461,1833
2020-08-02,Brazil,NA,Paraiba,4025558,547,17,84008,1850
2020-08-03,Brazil,NA,Paraiba,4025558,203,20,84211,1870
2020-08-04,Brazil,NA,Paraiba,4025558,1549,31,85760,1901
2020-08-05,Brazil,NA,Paraiba,4025558,1311,21,87071,1922
2020-08-06,Brazil,NA,Paraiba,4025558,796,23,87867,1945
2020-08-07,Brazil,NA,Paraiba,4025558,1250,20,89117,1965
2020-08-08,Brazil,NA,Paraiba,4025558,776,18,89893,1983
2020-08-09,Brazil,NA,Paraiba,4025558,189,17,90082,2000
2020-08-10,Brazil,NA,Paraiba,4025558,284,23,90366,2023
2020-08-11,Brazil,NA,Paraiba,4025558,1453,23,91819,2046
2020-08-12,Brazil,NA,Paraiba,4025558,1078,25,92897,2071
2020-08-13,Brazil,NA,Paraiba,4025558,897,21,93794,2092
2020-08-14,Brazil,NA,Paraiba,4025558,866,21,94660,2113
2020-08-15,Brazil,NA,Paraiba,4025558,928,25,95588,2138
2020-08-16,Brazil,NA,Paraiba,4025558,445,24,96033,2162
2020-08-17,Brazil,NA,Paraiba,4025558,190,21,96223,2183
2020-08-18,Brazil,NA,Paraiba,4025558,1274,20,97497,2203
2020-08-19,Brazil,NA,Paraiba,4025558,997,20,98494,2223
2020-08-20,Brazil,NA,Paraiba,4025558,951,21,99445,2244
2020-08-21,Brazil,NA,Paraiba,4025558,845,24,100290,2268
2020-08-22,Brazil,NA,Paraiba,4025558,680,20,100970,2288
2020-08-23,Brazil,NA,Paraiba,4025558,162,20,101132,2308
2020-08-24,Brazil,NA,Paraiba,4025558,171,22,101303,2330
2020-08-25,Brazil,NA,Paraiba,4025558,905,20,102208,2350
2020-08-26,Brazil,NA,Paraiba,4025558,1005,21,103213,2371
2020-08-27,Brazil,NA,Paraiba,4025558,883,17,104096,2388
2020-08-28,Brazil,NA,Paraiba,4025558,707,16,104803,2404
2020-08-29,Brazil,NA,Paraiba,4025558,728,16,105531,2420
2020-08-30,Brazil,NA,Paraiba,4025558,130,15,105661,2435
2020-08-31,Brazil,NA,Paraiba,4025558,117,15,105778,2450
2020-09-01,Brazil,NA,Paraiba,4025558,827,15,106605,2465
2020-09-02,Brazil,NA,Paraiba,4025558,779,18,107384,2483
2020-09-03,Brazil,NA,Paraiba,4025558,798,18,108182,2501
2020-09-04,Brazil,NA,Paraiba,4025558,743,16,108925,2517
2020-09-05,Brazil,NA,Paraiba,4025558,605,12,109530,2529
2020-09-06,Brazil,NA,Paraiba,4025558,143,14,109673,2543
2020-09-07,Brazil,NA,Paraiba,4025558,33,7,109706,2550
2020-09-08,Brazil,NA,Paraiba,4025558,154,13,109860,2563
2020-09-09,Brazil,NA,Paraiba,4025558,867,15,110727,2578
2020-09-10,Brazil,NA,Paraiba,4025558,768,12,111495,2590
2020-09-11,Brazil,NA,Paraiba,4025558,523,14,112018,2604
2020-09-12,Brazil,NA,Paraiba,4025558,688,12,112706,2616
2020-09-13,Brazil,NA,Paraiba,4025558,255,11,112961,2627
2020-09-14,Brazil,NA,Paraiba,4025558,202,12,113163,2639
2020-09-15,Brazil,NA,Paraiba,4025558,740,10,113903,2649
2020-09-16,Brazil,NA,Paraiba,4025558,679,10,114582,2659
2020-09-17,Brazil,NA,Paraiba,4025558,777,11,115359,2670
2020-09-18,Brazil,NA,Paraiba,4025558,607,14,115966,2684
2020-09-19,Brazil,NA,Paraiba,4025558,622,11,116588,2695
2020-09-20,Brazil,NA,Paraiba,4025558,148,12,116736,2707
2020-09-21,Brazil,NA,Paraiba,4025558,143,12,116879,2719
2020-09-22,Brazil,NA,Paraiba,4025558,616,10,117495,2729
2020-09-23,Brazil,NA,Paraiba,4025558,553,12,118048,2741
2020-03-18,Brazil,NA,Parana,11320892,7,0,13,0
2020-03-19,Brazil,NA,Parana,11320892,10,0,23,0
2020-03-20,Brazil,NA,Parana,11320892,9,0,32,0
2020-03-21,Brazil,NA,Parana,11320892,11,0,43,0
2020-03-22,Brazil,NA,Parana,11320892,7,0,50,0
2020-03-23,Brazil,NA,Parana,11320892,6,0,56,0
2020-03-24,Brazil,NA,Parana,11320892,9,0,65,0
2020-03-25,Brazil,NA,Parana,11320892,16,0,81,0
2020-03-26,Brazil,NA,Parana,11320892,21,0,102,0
2020-03-27,Brazil,NA,Parana,11320892,17,2,119,2
2020-03-28,Brazil,NA,Parana,11320892,14,0,133,2
2020-03-29,Brazil,NA,Parana,11320892,15,0,148,2
2020-03-30,Brazil,NA,Parana,11320892,7,1,155,3
2020-03-31,Brazil,NA,Parana,11320892,24,0,179,3
2020-04-01,Brazil,NA,Parana,11320892,45,0,224,3
2020-04-02,Brazil,NA,Parana,11320892,28,1,252,4
2020-04-03,Brazil,NA,Parana,11320892,49,0,301,4
2020-04-04,Brazil,NA,Parana,11320892,94,2,395,6
2020-04-05,Brazil,NA,Parana,11320892,43,3,438,9
2020-04-06,Brazil,NA,Parana,11320892,20,2,458,11
2020-04-07,Brazil,NA,Parana,11320892,45,4,503,15
2020-04-08,Brazil,NA,Parana,11320892,36,2,539,17
2020-04-09,Brazil,NA,Parana,11320892,70,5,609,22
2020-04-10,Brazil,NA,Parana,11320892,34,3,643,25
2020-04-11,Brazil,NA,Parana,11320892,33,1,676,26
2020-04-12,Brazil,NA,Parana,11320892,62,4,738,30
2020-04-13,Brazil,NA,Parana,11320892,18,1,756,31
2020-04-14,Brazil,NA,Parana,11320892,35,5,791,36
2020-04-15,Brazil,NA,Parana,11320892,12,2,803,38
2020-04-16,Brazil,NA,Parana,11320892,29,3,832,41
2020-04-17,Brazil,NA,Parana,11320892,42,1,874,42
2020-04-18,Brazil,NA,Parana,11320892,71,4,945,46
2020-04-19,Brazil,NA,Parana,11320892,42,2,987,48
2020-04-20,Brazil,NA,Parana,11320892,20,3,1007,51
2020-04-21,Brazil,NA,Parana,11320892,17,0,1024,51
2020-04-22,Brazil,NA,Parana,11320892,39,6,1063,57
2020-04-23,Brazil,NA,Parana,11320892,19,3,1082,60
2020-04-24,Brazil,NA,Parana,11320892,37,4,1119,64
2020-04-25,Brazil,NA,Parana,11320892,21,5,1140,69
2020-04-26,Brazil,NA,Parana,11320892,16,3,1156,72
2020-04-27,Brazil,NA,Parana,11320892,30,3,1186,75
2020-04-28,Brazil,NA,Parana,11320892,85,2,1271,77
2020-04-29,Brazil,NA,Parana,11320892,77,5,1348,82
2020-04-30,Brazil,NA,Parana,11320892,59,1,1407,83
2020-05-01,Brazil,NA,Parana,11320892,40,6,1447,89
2020-05-02,Brazil,NA,Parana,11320892,45,1,1492,90
2020-05-03,Brazil,NA,Parana,11320892,22,3,1514,93
2020-05-04,Brazil,NA,Parana,11320892,48,1,1562,94
2020-05-05,Brazil,NA,Parana,11320892,26,5,1588,99
2020-05-06,Brazil,NA,Parana,11320892,39,2,1627,101
2020-05-07,Brazil,NA,Parana,11320892,29,3,1656,104
2020-05-08,Brazil,NA,Parana,11320892,55,2,1711,106
2020-05-09,Brazil,NA,Parana,11320892,74,1,1785,107
2020-05-10,Brazil,NA,Parana,11320892,50,2,1835,109
2020-05-11,Brazil,NA,Parana,11320892,14,2,1849,111
2020-05-12,Brazil,NA,Parana,11320892,57,2,1906,113
2020-05-13,Brazil,NA,Parana,11320892,90,4,1996,117
2020-05-14,Brazil,NA,Parana,11320892,67,2,2063,119
2020-05-15,Brazil,NA,Parana,11320892,76,1,2139,120
2020-05-16,Brazil,NA,Parana,11320892,103,3,2242,123
2020-05-17,Brazil,NA,Parana,11320892,44,1,2286,124
2020-05-18,Brazil,NA,Parana,11320892,74,3,2360,127
2020-05-19,Brazil,NA,Parana,11320892,121,2,2481,129
2020-05-20,Brazil,NA,Parana,11320892,135,8,2616,137
2020-05-21,Brazil,NA,Parana,11320892,194,4,2810,141
2020-05-22,Brazil,NA,Parana,11320892,129,5,2939,146
2020-05-23,Brazil,NA,Parana,11320892,160,4,3099,150
2020-05-24,Brazil,NA,Parana,11320892,113,3,3212,153
2020-05-25,Brazil,NA,Parana,11320892,119,3,3331,156
2020-05-26,Brazil,NA,Parana,11320892,181,3,3512,159
2020-05-27,Brazil,NA,Parana,11320892,200,3,3712,162
2020-05-28,Brazil,NA,Parana,11320892,272,7,3984,169
2020-05-29,Brazil,NA,Parana,11320892,252,4,4236,173
2020-05-30,Brazil,NA,Parana,11320892,237,8,4473,181
2020-05-31,Brazil,NA,Parana,11320892,214,1,4687,182
2020-06-01,Brazil,NA,Parana,11320892,148,8,4835,190
2020-06-02,Brazil,NA,Parana,11320892,328,9,5163,199
2020-06-03,Brazil,NA,Parana,11320892,331,6,5494,205
2020-06-04,Brazil,NA,Parana,11320892,326,10,5820,215
2020-06-05,Brazil,NA,Parana,11320892,528,12,6348,227
2020-06-06,Brazil,NA,Parana,11320892,257,5,6605,232
2020-06-07,Brazil,NA,Parana,11320892,292,5,6897,237
2020-06-08,Brazil,NA,Parana,11320892,134,6,7031,243
2020-06-09,Brazil,NA,Parana,11320892,283,10,7314,253
2020-06-10,Brazil,NA,Parana,11320892,517,22,7831,275
2020-06-11,Brazil,NA,Parana,11320892,626,5,8457,280
2020-06-12,Brazil,NA,Parana,11320892,248,14,8705,294
2020-06-13,Brazil,NA,Parana,11320892,528,18,9233,312
2020-06-14,Brazil,NA,Parana,11320892,350,14,9583,326
2020-06-15,Brazil,NA,Parana,11320892,133,8,9716,334
2020-06-16,Brazil,NA,Parana,11320892,841,30,10557,364
2020-06-17,Brazil,NA,Parana,11320892,528,22,11085,386
2020-06-18,Brazil,NA,Parana,11320892,834,20,11919,406
2020-06-19,Brazil,NA,Parana,11320892,866,13,12785,419
2020-06-20,Brazil,NA,Parana,11320892,877,9,13662,428
2020-06-21,Brazil,NA,Parana,11320892,839,23,14501,451
2020-06-22,Brazil,NA,Parana,11320892,623,18,15124,469
2020-06-23,Brazil,NA,Parana,11320892,729,29,15853,498
2020-06-24,Brazil,NA,Parana,11320892,1110,23,16963,521
2020-06-25,Brazil,NA,Parana,11320892,858,18,17821,539
2020-06-26,Brazil,NA,Parana,11320892,851,25,18672,564
2020-06-27,Brazil,NA,Parana,11320892,1147,11,19819,575
2020-06-28,Brazil,NA,Parana,11320892,923,24,20742,599
2020-06-29,Brazil,NA,Parana,11320892,584,14,21326,613
2020-06-30,Brazil,NA,Parana,11320892,1551,36,22877,649
2020-07-01,Brazil,NA,Parana,11320892,1348,14,24225,663
2020-07-02,Brazil,NA,Parana,11320892,2079,43,26304,706
2020-07-03,Brazil,NA,Parana,11320892,1862,22,28166,728
2020-07-04,Brazil,NA,Parana,11320892,2404,35,30570,763
2020-07-05,Brazil,NA,Parana,11320892,889,32,31459,795
2020-07-06,Brazil,NA,Parana,11320892,1310,25,32769,820
2020-07-07,Brazil,NA,Parana,11320892,1539,31,34308,851
2020-07-08,Brazil,NA,Parana,11320892,1407,44,35715,895
2020-07-09,Brazil,NA,Parana,11320892,1709,36,37424,931
2020-07-10,Brazil,NA,Parana,11320892,2088,47,39512,978
2020-07-11,Brazil,NA,Parana,11320892,1285,38,40797,1016
2020-07-12,Brazil,NA,Parana,11320892,1740,29,42537,1045
2020-07-13,Brazil,NA,Parana,11320892,1045,44,43582,1089
2020-07-14,Brazil,NA,Parana,11320892,1781,57,45363,1146
2020-07-15,Brazil,NA,Parana,11320892,1761,54,47124,1200
2020-07-16,Brazil,NA,Parana,11320892,2281,46,49405,1246
2020-07-17,Brazil,NA,Parana,11320892,1916,46,51321,1292
2020-07-18,Brazil,NA,Parana,11320892,2232,16,53553,1308
2020-07-19,Brazil,NA,Parana,11320892,1076,19,54629,1327
2020-07-20,Brazil,NA,Parana,11320892,1280,30,55909,1357
2020-07-21,Brazil,NA,Parana,11320892,1629,58,57538,1415
2020-07-22,Brazil,NA,Parana,11320892,2389,71,59927,1486
2020-07-23,Brazil,NA,Parana,11320892,2077,59,62004,1545
2020-07-24,Brazil,NA,Parana,11320892,2255,53,64259,1598
2020-07-25,Brazil,NA,Parana,11320892,1334,55,65593,1653
2020-07-26,Brazil,NA,Parana,11320892,1627,18,67220,1671
2020-07-27,Brazil,NA,Parana,11320892,781,32,68001,1703
2020-07-28,Brazil,NA,Parana,11320892,1391,40,69392,1743
2020-07-29,Brazil,NA,Parana,11320892,1528,71,70920,1814
2020-07-30,Brazil,NA,Parana,11320892,2568,47,73488,1861
2020-07-31,Brazil,NA,Parana,11320892,2624,59,76112,1920
2020-08-01,Brazil,NA,Parana,11320892,1818,55,77930,1975
2020-08-02,Brazil,NA,Parana,11320892,1675,30,79605,2005
2020-08-03,Brazil,NA,Parana,11320892,1260,45,80865,2050
2020-08-04,Brazil,NA,Parana,11320892,1853,78,82718,2128
2020-08-05,Brazil,NA,Parana,11320892,2599,36,85317,2164
2020-08-06,Brazil,NA,Parana,11320892,1952,60,87269,2224
2020-08-07,Brazil,NA,Parana,11320892,1630,46,88899,2270
2020-08-08,Brazil,NA,Parana,11320892,0,0,88899,2270
2020-08-09,Brazil,NA,Parana,11320892,1067,75,89966,2345
2020-08-10,Brazil,NA,Parana,11320892,4158,53,94124,2398
2020-08-11,Brazil,NA,Parana,11320892,1819,47,95943,2445
2020-08-12,Brazil,NA,Parana,11320892,1842,71,97785,2516
2020-08-13,Brazil,NA,Parana,11320892,1882,60,99667,2576
2020-08-14,Brazil,NA,Parana,11320892,2177,36,101844,2612
2020-08-15,Brazil,NA,Parana,11320892,1927,53,103771,2665
2020-08-16,Brazil,NA,Parana,11320892,1333,26,105104,2691
2020-08-17,Brazil,NA,Parana,11320892,1275,42,106379,2733
2020-08-18,Brazil,NA,Parana,11320892,1858,48,108237,2781
2020-08-19,Brazil,NA,Parana,11320892,1659,27,109896,2808
2020-08-20,Brazil,NA,Parana,11320892,2349,83,112245,2891
2020-08-21,Brazil,NA,Parana,11320892,2343,37,114588,2928
2020-08-22,Brazil,NA,Parana,11320892,2260,33,116848,2961
2020-08-23,Brazil,NA,Parana,11320892,1111,16,117959,2977
2020-08-24,Brazil,NA,Parana,11320892,1045,33,119004,3010
2020-08-25,Brazil,NA,Parana,11320892,1533,52,120537,3062
2020-08-26,Brazil,NA,Parana,11320892,1704,40,122241,3102
2020-08-27,Brazil,NA,Parana,11320892,1833,51,124074,3153
2020-08-28,Brazil,NA,Parana,11320892,2890,41,126964,3194
2020-08-29,Brazil,NA,Parana,11320892,2003,40,128967,3234
2020-08-30,Brazil,NA,Parana,11320892,1636,17,130603,3251
2020-08-31,Brazil,NA,Parana,11320892,1303,39,131906,3290
2020-09-01,Brazil,NA,Parana,11320892,1668,55,133574,3345
2020-09-02,Brazil,NA,Parana,11320892,2035,54,135609,3399
2020-09-03,Brazil,NA,Parana,11320892,2256,50,137865,3449
2020-09-04,Brazil,NA,Parana,11320892,1915,56,139780,3505
2020-09-05,Brazil,NA,Parana,11320892,1868,32,141648,3537
2020-09-06,Brazil,NA,Parana,11320892,1426,14,143074,3551
2020-09-07,Brazil,NA,Parana,11320892,779,26,143853,3577
2020-09-08,Brazil,NA,Parana,11320892,1404,38,145257,3615
2020-09-09,Brazil,NA,Parana,11320892,1076,45,146333,3660
2020-09-10,Brazil,NA,Parana,11320892,2000,50,148333,3710
2020-09-11,Brazil,NA,Parana,11320892,2335,71,150668,3781
2020-09-12,Brazil,NA,Parana,11320892,2245,20,152913,3801
2020-09-13,Brazil,NA,Parana,11320892,1258,22,154171,3823
2020-09-14,Brazil,NA,Parana,11320892,649,30,154820,3853
2020-09-15,Brazil,NA,Parana,11320892,1000,65,155820,3918
2020-09-16,Brazil,NA,Parana,11320892,1510,53,157330,3971
2020-09-17,Brazil,NA,Parana,11320892,2469,47,159799,4018
2020-09-18,Brazil,NA,Parana,11320892,2123,49,161922,4067
2020-09-19,Brazil,NA,Parana,11320892,1557,26,163479,4093
2020-09-20,Brazil,NA,Parana,11320892,1409,17,164888,4110
2020-09-21,Brazil,NA,Parana,11320892,606,36,165494,4146
2020-09-22,Brazil,NA,Parana,11320892,2184,39,167678,4185
2020-09-23,Brazil,NA,Parana,11320892,1245,59,168923,4244
2020-03-17,Brazil,NA,Pernambuco,9473266,14,0,16,0
2020-03-18,Brazil,NA,Pernambuco,9473266,0,0,16,0
2020-03-19,Brazil,NA,Pernambuco,9473266,12,0,28,0
2020-03-20,Brazil,NA,Pernambuco,9473266,2,0,30,0
2020-03-21,Brazil,NA,Pernambuco,9473266,0,0,30,0
2020-03-22,Brazil,NA,Pernambuco,9473266,7,0,37,0
2020-03-23,Brazil,NA,Pernambuco,9473266,5,0,42,0
2020-03-24,Brazil,NA,Pernambuco,9473266,0,0,42,0
2020-03-25,Brazil,NA,Pernambuco,9473266,4,1,46,1
2020-03-26,Brazil,NA,Pernambuco,9473266,2,2,48,3
2020-03-27,Brazil,NA,Pernambuco,9473266,8,1,56,4
2020-03-28,Brazil,NA,Pernambuco,9473266,12,1,68,5
2020-03-29,Brazil,NA,Pernambuco,9473266,5,0,73,5
2020-03-30,Brazil,NA,Pernambuco,9473266,5,1,78,6
2020-03-31,Brazil,NA,Pernambuco,9473266,9,0,87,6
2020-04-01,Brazil,NA,Pernambuco,9473266,8,2,95,8
2020-04-02,Brazil,NA,Pernambuco,9473266,11,1,106,9
2020-04-03,Brazil,NA,Pernambuco,9473266,30,1,136,10
2020-04-04,Brazil,NA,Pernambuco,9473266,40,4,176,14
2020-04-05,Brazil,NA,Pernambuco,9473266,25,7,201,21
2020-04-06,Brazil,NA,Pernambuco,9473266,22,9,223,30
2020-04-07,Brazil,NA,Pernambuco,9473266,129,4,352,34
2020-04-08,Brazil,NA,Pernambuco,9473266,49,12,401,46
2020-04-09,Brazil,NA,Pernambuco,9473266,154,10,555,56
2020-04-10,Brazil,NA,Pernambuco,9473266,129,9,684,65
2020-04-11,Brazil,NA,Pernambuco,9473266,132,7,816,72
2020-04-12,Brazil,NA,Pernambuco,9473266,144,13,960,85
2020-04-13,Brazil,NA,Pernambuco,9473266,194,17,1154,102
2020-04-14,Brazil,NA,Pernambuco,9473266,130,13,1284,115
2020-04-15,Brazil,NA,Pernambuco,9473266,200,28,1484,143
2020-04-16,Brazil,NA,Pernambuco,9473266,199,17,1683,160
2020-04-17,Brazil,NA,Pernambuco,9473266,323,26,2006,186
2020-04-18,Brazil,NA,Pernambuco,9473266,187,19,2193,205
2020-04-19,Brazil,NA,Pernambuco,9473266,266,11,2459,216
2020-04-20,Brazil,NA,Pernambuco,9473266,231,18,2690,234
2020-04-21,Brazil,NA,Pernambuco,9473266,218,26,2908,260
2020-04-22,Brazil,NA,Pernambuco,9473266,390,22,3298,282
2020-04-23,Brazil,NA,Pernambuco,9473266,221,30,3519,312
2020-04-24,Brazil,NA,Pernambuco,9473266,480,40,3999,352
2020-04-25,Brazil,NA,Pernambuco,9473266,508,29,4507,381
2020-04-26,Brazil,NA,Pernambuco,9473266,391,34,4898,415
2020-04-27,Brazil,NA,Pernambuco,9473266,460,35,5358,450
2020-04-28,Brazil,NA,Pernambuco,9473266,366,58,5724,508
2020-04-29,Brazil,NA,Pernambuco,9473266,470,30,6194,538
2020-04-30,Brazil,NA,Pernambuco,9473266,682,27,6876,565
2020-05-01,Brazil,NA,Pernambuco,9473266,458,38,7334,603
2020-05-02,Brazil,NA,Pernambuco,9473266,811,25,8145,628
2020-05-03,Brazil,NA,Pernambuco,9473266,498,24,8643,652
2020-05-04,Brazil,NA,Pernambuco,9473266,220,39,8863,691
2020-05-05,Brazil,NA,Pernambuco,9473266,462,58,9325,749
2020-05-06,Brazil,NA,Pernambuco,9473266,556,54,9881,803
2020-05-07,Brazil,NA,Pernambuco,9473266,943,42,10824,845
2020-05-08,Brazil,NA,Pernambuco,9473266,763,82,11587,927
2020-05-09,Brazil,NA,Pernambuco,9473266,883,45,12470,972
2020-05-10,Brazil,NA,Pernambuco,9473266,805,75,13275,1047
2020-05-11,Brazil,NA,Pernambuco,9473266,493,40,13768,1087
2020-05-12,Brazil,NA,Pernambuco,9473266,541,70,14309,1157
2020-05-13,Brazil,NA,Pernambuco,9473266,592,67,14901,1224
2020-05-14,Brazil,NA,Pernambuco,9473266,687,74,15588,1298
2020-05-15,Brazil,NA,Pernambuco,9473266,621,83,16209,1381
2020-05-16,Brazil,NA,Pernambuco,9473266,2279,80,18488,1461
2020-05-17,Brazil,NA,Pernambuco,9473266,964,55,19452,1516
2020-05-18,Brazil,NA,Pernambuco,9473266,642,124,20094,1640
2020-05-19,Brazil,NA,Pernambuco,9473266,1148,101,21242,1741
2020-05-20,Brazil,NA,Pernambuco,9473266,1318,93,22560,1834
2020-05-21,Brazil,NA,Pernambuco,9473266,1351,91,23911,1925
2020-05-22,Brazil,NA,Pernambuco,9473266,1849,132,25760,2057
2020-05-23,Brazil,NA,Pernambuco,9473266,1026,87,26786,2144
2020-05-24,Brazil,NA,Pernambuco,9473266,973,56,27759,2200
2020-05-25,Brazil,NA,Pernambuco,9473266,607,48,28366,2248
2020-05-26,Brazil,NA,Pernambuco,9473266,488,80,28854,2328
2020-05-27,Brazil,NA,Pernambuco,9473266,1065,140,29919,2468
2020-05-28,Brazil,NA,Pernambuco,9473266,794,98,30713,2566
2020-05-29,Brazil,NA,Pernambuco,9473266,1542,103,32255,2669
2020-05-30,Brazil,NA,Pernambuco,9473266,1172,71,33427,2740
2020-05-31,Brazil,NA,Pernambuco,9473266,1023,67,34450,2807
2020-06-01,Brazil,NA,Pernambuco,9473266,450,68,34900,2875
2020-06-02,Brazil,NA,Pernambuco,9473266,608,58,35508,2933
2020-06-03,Brazil,NA,Pernambuco,9473266,955,79,36463,3012
2020-06-04,Brazil,NA,Pernambuco,9473266,1044,122,37507,3134
2020-06-05,Brazil,NA,Pernambuco,9473266,1004,71,38511,3205
2020-06-06,Brazil,NA,Pernambuco,9473266,850,65,39361,3270
2020-06-07,Brazil,NA,Pernambuco,9473266,881,35,40242,3305
2020-06-08,Brazil,NA,Pernambuco,9473266,463,45,40705,3350
2020-06-09,Brazil,NA,Pernambuco,9473266,305,103,41010,3453
2020-06-10,Brazil,NA,Pernambuco,9473266,925,78,41935,3531
2020-06-11,Brazil,NA,Pernambuco,9473266,1059,102,42994,3633
2020-06-12,Brazil,NA,Pernambuco,9473266,878,61,43872,3694
2020-06-13,Brazil,NA,Pernambuco,9473266,799,90,44671,3784
2020-06-14,Brazil,NA,Pernambuco,9473266,590,71,45261,3855
2020-06-15,Brazil,NA,Pernambuco,9473266,246,31,45507,3886
2020-06-16,Brazil,NA,Pernambuco,9473266,920,73,46427,3959
2020-06-17,Brazil,NA,Pernambuco,9473266,1019,50,47446,4009
2020-06-18,Brazil,NA,Pernambuco,9473266,1180,48,48626,4057
2020-06-19,Brazil,NA,Pernambuco,9473266,1094,45,49720,4102
2020-06-20,Brazil,NA,Pernambuco,9473266,1398,46,51118,4148
2020-06-21,Brazil,NA,Pernambuco,9473266,995,86,52113,4234
2020-06-22,Brazil,NA,Pernambuco,9473266,381,18,52494,4252
2020-06-23,Brazil,NA,Pernambuco,9473266,337,87,52831,4339
2020-06-24,Brazil,NA,Pernambuco,9473266,1191,86,54022,4425
2020-06-25,Brazil,NA,Pernambuco,9473266,1114,63,55136,4488
2020-06-26,Brazil,NA,Pernambuco,9473266,668,122,55804,4610
2020-06-27,Brazil,NA,Pernambuco,9473266,1285,98,57089,4708
2020-06-28,Brazil,NA,Pernambuco,9473266,1018,43,58107,4751
2020-06-29,Brazil,NA,Pernambuco,9473266,369,31,58476,4782
2020-06-30,Brazil,NA,Pernambuco,9473266,382,47,58858,4829
2020-07-01,Brazil,NA,Pernambuco,9473266,847,65,59705,4894
2020-07-02,Brazil,NA,Pernambuco,9473266,1414,74,61119,4968
2020-07-03,Brazil,NA,Pernambuco,9473266,1243,100,62362,5068
2020-07-04,Brazil,NA,Pernambuco,9473266,1095,48,63457,5116
2020-07-05,Brazil,NA,Pernambuco,9473266,1672,27,65129,5143
2020-07-06,Brazil,NA,Pernambuco,9473266,513,20,65642,5163
2020-07-07,Brazil,NA,Pernambuco,9473266,509,71,66151,5234
2020-07-08,Brazil,NA,Pernambuco,9473266,1453,89,67604,5323
2020-07-09,Brazil,NA,Pernambuco,9473266,1163,86,68767,5409
2020-07-10,Brazil,NA,Pernambuco,9473266,1333,73,70100,5482
2020-07-11,Brazil,NA,Pernambuco,9473266,1270,74,71370,5556
2020-07-12,Brazil,NA,Pernambuco,9473266,1100,39,72470,5595
2020-07-13,Brazil,NA,Pernambuco,9473266,431,57,72901,5652
2020-07-14,Brazil,NA,Pernambuco,9473266,675,63,73576,5715
2020-07-15,Brazil,NA,Pernambuco,9473266,1384,57,74960,5772
2020-07-16,Brazil,NA,Pernambuco,9473266,1131,64,76091,5836
2020-07-17,Brazil,NA,Pernambuco,9473266,1332,33,77423,5869
2020-07-18,Brazil,NA,Pernambuco,9473266,1086,59,78509,5928
2020-07-19,Brazil,NA,Pernambuco,9473266,943,56,79452,5984
2020-07-20,Brazil,NA,Pernambuco,9473266,663,52,80115,6036
2020-07-21,Brazil,NA,Pernambuco,9473266,326,53,80441,6089
2020-07-22,Brazil,NA,Pernambuco,9473266,941,63,81382,6152
2020-07-23,Brazil,NA,Pernambuco,9473266,1858,59,83240,6211
2020-07-24,Brazil,NA,Pernambuco,9473266,1802,26,85042,6237
2020-07-25,Brazil,NA,Pernambuco,9473266,1710,62,86752,6299
2020-07-26,Brazil,NA,Pernambuco,9473266,1714,53,88466,6352
2020-07-27,Brazil,NA,Pernambuco,9473266,666,24,89132,6376
2020-07-28,Brazil,NA,Pernambuco,9473266,546,45,89678,6421
2020-07-29,Brazil,NA,Pernambuco,9473266,1858,63,91536,6484
2020-07-30,Brazil,NA,Pernambuco,9473266,1837,42,93373,6526
2020-07-31,Brazil,NA,Pernambuco,9473266,1632,31,95005,6557
2020-08-01,Brazil,NA,Pernambuco,9473266,1741,40,96746,6597
2020-08-02,Brazil,NA,Pernambuco,9473266,1224,37,97970,6634
2020-08-03,Brazil,NA,Pernambuco,9473266,431,35,98401,6669
2020-08-04,Brazil,NA,Pernambuco,9473266,432,48,98833,6717
2020-08-05,Brazil,NA,Pernambuco,9473266,1488,41,100321,6758
2020-08-06,Brazil,NA,Pernambuco,9473266,1074,70,101395,6828
2020-08-07,Brazil,NA,Pernambuco,9473266,1477,39,102872,6867
2020-08-08,Brazil,NA,Pernambuco,9473266,1241,53,104113,6920
2020-08-09,Brazil,NA,Pernambuco,9473266,1021,21,105134,6941
2020-08-10,Brazil,NA,Pernambuco,9473266,247,29,105381,6970
2020-08-11,Brazil,NA,Pernambuco,9473266,601,38,105982,7008
2020-08-12,Brazil,NA,Pernambuco,9473266,1393,41,107375,7049
2020-08-13,Brazil,NA,Pernambuco,9473266,1467,35,108842,7084
2020-08-14,Brazil,NA,Pernambuco,9473266,1567,27,110409,7111
2020-08-15,Brazil,NA,Pernambuco,9473266,1364,45,111773,7156
2020-08-16,Brazil,NA,Pernambuco,9473266,1185,32,112958,7188
2020-08-17,Brazil,NA,Pernambuco,9473266,225,22,113183,7210
2020-08-18,Brazil,NA,Pernambuco,9473266,605,42,113788,7252
2020-08-19,Brazil,NA,Pernambuco,9473266,1429,28,115217,7280
2020-08-20,Brazil,NA,Pernambuco,9473266,1142,23,116359,7303
2020-08-21,Brazil,NA,Pernambuco,9473266,1072,32,117431,7335
2020-08-22,Brazil,NA,Pernambuco,9473266,596,29,118027,7364
2020-08-23,Brazil,NA,Pernambuco,9473266,1113,26,119140,7390
2020-08-24,Brazil,NA,Pernambuco,9473266,217,9,119357,7399
2020-08-25,Brazil,NA,Pernambuco,9473266,601,26,119958,7425
2020-08-26,Brazil,NA,Pernambuco,9473266,1120,35,121078,7460
2020-08-27,Brazil,NA,Pernambuco,9473266,1069,20,122147,7480
2020-08-28,Brazil,NA,Pernambuco,9473266,999,32,123146,7512
2020-08-29,Brazil,NA,Pernambuco,9473266,1005,35,124151,7547
2020-08-30,Brazil,NA,Pernambuco,9473266,943,27,125094,7574
2020-08-31,Brazil,NA,Pernambuco,9473266,445,19,125539,7593
2020-09-01,Brazil,NA,Pernambuco,9473266,1748,21,127287,7614
2020-09-02,Brazil,NA,Pernambuco,9473266,1437,42,128724,7656
2020-09-03,Brazil,NA,Pernambuco,9473266,1475,0,130199,7656
2020-09-04,Brazil,NA,Pernambuco,9473266,1031,26,131230,7656
2020-09-05,Brazil,NA,Pernambuco,9473266,731,25,131961,7670
2020-09-06,Brazil,NA,Pernambuco,9473266,191,32,132152,7702
2020-09-07,Brazil,NA,Pernambuco,9473266,268,19,132420,7721
2020-09-08,Brazil,NA,Pernambuco,9473266,170,20,132590,7741
2020-09-09,Brazil,NA,Pernambuco,9473266,989,23,133579,7764
2020-09-10,Brazil,NA,Pernambuco,9473266,1040,28,134619,7792
2020-09-11,Brazil,NA,Pernambuco,9473266,1024,25,135643,7817
2020-09-12,Brazil,NA,Pernambuco,9473266,770,35,136413,7852
2020-09-13,Brazil,NA,Pernambuco,9473266,259,22,136672,7874
2020-09-14,Brazil,NA,Pernambuco,9473266,181,14,136853,7888
2020-09-15,Brazil,NA,Pernambuco,9473266,1016,26,137869,7914
2020-09-16,Brazil,NA,Pernambuco,9473266,699,19,138568,7933
2020-09-17,Brazil,NA,Pernambuco,9473266,757,21,139325,7954
2020-09-18,Brazil,NA,Pernambuco,9473266,910,17,140235,7971
2020-09-19,Brazil,NA,Pernambuco,9473266,807,33,141042,8004
2020-09-20,Brazil,NA,Pernambuco,9473266,475,12,141517,8016
2020-09-21,Brazil,NA,Pernambuco,9473266,260,0,141777,8016
2020-09-22,Brazil,NA,Pernambuco,9473266,711,39,142488,8055
2020-09-23,Brazil,NA,Pernambuco,9473266,677,30,143165,8085
2020-03-28,Brazil,NA,Piaui,3219257,2,1,11,1
2020-03-29,Brazil,NA,Piaui,3219257,3,0,14,1
2020-03-30,Brazil,NA,Piaui,3219257,2,2,16,3
2020-03-31,Brazil,NA,Piaui,3219257,2,1,18,3
2020-04-01,Brazil,NA,Piaui,3219257,0,0,18,3
2020-04-02,Brazil,NA,Piaui,3219257,1,0,19,3
2020-04-03,Brazil,NA,Piaui,3219257,2,0,21,4
2020-04-04,Brazil,NA,Piaui,3219257,1,0,22,4
2020-04-05,Brazil,NA,Piaui,3219257,1,0,23,4
2020-04-06,Brazil,NA,Piaui,3219257,0,0,23,4
2020-04-07,Brazil,NA,Piaui,3219257,5,0,28,4
2020-04-08,Brazil,NA,Piaui,3219257,3,1,31,5
2020-04-09,Brazil,NA,Piaui,3219257,7,1,38,6
2020-04-10,Brazil,NA,Piaui,3219257,2,1,40,7
2020-04-11,Brazil,NA,Piaui,3219257,1,0,41,7
2020-04-12,Brazil,NA,Piaui,3219257,3,0,44,7
2020-04-13,Brazil,NA,Piaui,3219257,6,1,50,8
2020-04-14,Brazil,NA,Piaui,3219257,8,0,58,8
2020-04-15,Brazil,NA,Piaui,3219257,17,0,75,8
2020-04-16,Brazil,NA,Piaui,3219257,16,0,91,8
2020-04-17,Brazil,NA,Piaui,3219257,11,0,102,8
2020-04-18,Brazil,NA,Piaui,3219257,21,1,123,9
2020-04-19,Brazil,NA,Piaui,3219257,22,1,145,10
2020-04-20,Brazil,NA,Piaui,3219257,13,2,158,12
2020-04-21,Brazil,NA,Piaui,3219257,28,2,186,14
2020-04-22,Brazil,NA,Piaui,3219257,20,1,206,15
2020-04-23,Brazil,NA,Piaui,3219257,11,0,217,15
2020-04-24,Brazil,NA,Piaui,3219257,39,1,256,16
2020-04-25,Brazil,NA,Piaui,3219257,41,1,297,17
2020-04-26,Brazil,NA,Piaui,3219257,34,1,331,18
2020-04-27,Brazil,NA,Piaui,3219257,33,2,364,20
2020-04-28,Brazil,NA,Piaui,3219257,44,1,408,21
2020-04-29,Brazil,NA,Piaui,3219257,46,3,454,24
2020-04-30,Brazil,NA,Piaui,3219257,59,0,513,24
2020-05-01,Brazil,NA,Piaui,3219257,87,0,600,24
2020-05-02,Brazil,NA,Piaui,3219257,65,2,665,26
2020-05-03,Brazil,NA,Piaui,3219257,77,2,742,28
2020-05-04,Brazil,NA,Piaui,3219257,42,0,784,28
2020-05-05,Brazil,NA,Piaui,3219257,91,1,875,29
2020-05-06,Brazil,NA,Piaui,3219257,74,1,949,30
2020-05-07,Brazil,NA,Piaui,3219257,102,5,1051,35
2020-05-08,Brazil,NA,Piaui,3219257,80,2,1131,37
2020-05-09,Brazil,NA,Piaui,3219257,102,1,1233,38
2020-05-10,Brazil,NA,Piaui,3219257,45,4,1278,42
2020-05-11,Brazil,NA,Piaui,3219257,54,3,1332,45
2020-05-12,Brazil,NA,Piaui,3219257,111,4,1443,49
2020-05-13,Brazil,NA,Piaui,3219257,169,8,1612,57
2020-05-14,Brazil,NA,Piaui,3219257,172,3,1784,60
2020-05-15,Brazil,NA,Piaui,3219257,121,0,1905,60
2020-05-16,Brazil,NA,Piaui,3219257,180,5,2085,65
2020-05-17,Brazil,NA,Piaui,3219257,167,7,2252,72
2020-05-18,Brazil,NA,Piaui,3219257,35,8,2287,80
2020-05-19,Brazil,NA,Piaui,3219257,153,5,2440,85
2020-05-20,Brazil,NA,Piaui,3219257,197,2,2637,87
2020-05-21,Brazil,NA,Piaui,3219257,215,4,2852,91
2020-05-22,Brazil,NA,Piaui,3219257,222,2,3074,93
2020-05-23,Brazil,NA,Piaui,3219257,184,6,3258,99
2020-05-24,Brazil,NA,Piaui,3219257,132,8,3390,107
2020-05-25,Brazil,NA,Piaui,3219257,160,3,3550,110
2020-05-26,Brazil,NA,Piaui,3219257,170,9,3720,119
2020-05-27,Brazil,NA,Piaui,3219257,246,15,3966,134
2020-05-28,Brazil,NA,Piaui,3219257,277,4,4243,138
2020-05-29,Brazil,NA,Piaui,3219257,260,8,4503,146
2020-05-30,Brazil,NA,Piaui,3219257,242,11,4745,157
2020-05-31,Brazil,NA,Piaui,3219257,186,4,4931,161
2020-06-01,Brazil,NA,Piaui,3219257,188,7,5119,168
2020-06-02,Brazil,NA,Piaui,3219257,387,12,5506,180
2020-06-03,Brazil,NA,Piaui,3219257,322,12,5828,192
2020-06-04,Brazil,NA,Piaui,3219257,236,10,6064,202
2020-06-05,Brazil,NA,Piaui,3219257,653,15,6717,217
2020-06-06,Brazil,NA,Piaui,3219257,388,7,7105,224
2020-06-07,Brazil,NA,Piaui,3219257,373,15,7478,239
2020-06-08,Brazil,NA,Piaui,3219257,143,15,7621,254
2020-06-09,Brazil,NA,Piaui,3219257,306,11,7927,265
2020-06-10,Brazil,NA,Piaui,3219257,432,18,8359,283
2020-06-11,Brazil,NA,Piaui,3219257,464,16,8823,299
2020-06-12,Brazil,NA,Piaui,3219257,514,18,9337,317
2020-06-13,Brazil,NA,Piaui,3219257,488,18,9825,335
2020-06-14,Brazil,NA,Piaui,3219257,328,25,10153,360
2020-06-15,Brazil,NA,Piaui,3219257,204,14,10357,374
2020-06-16,Brazil,NA,Piaui,3219257,524,19,10881,393
2020-06-17,Brazil,NA,Piaui,3219257,678,5,11559,398
2020-06-18,Brazil,NA,Piaui,3219257,540,23,12099,421
2020-06-19,Brazil,NA,Piaui,3219257,468,14,12567,435
2020-06-20,Brazil,NA,Piaui,3219257,1246,24,13813,459
2020-06-21,Brazil,NA,Piaui,3219257,451,26,14264,485
2020-06-22,Brazil,NA,Piaui,3219257,212,17,14476,502
2020-06-23,Brazil,NA,Piaui,3219257,793,15,15269,517
2020-06-24,Brazil,NA,Piaui,3219257,958,17,16227,534
2020-06-25,Brazil,NA,Piaui,3219257,853,12,17080,546
2020-06-26,Brazil,NA,Piaui,3219257,943,28,18023,574
2020-06-27,Brazil,NA,Piaui,3219257,642,18,18665,592
2020-06-28,Brazil,NA,Piaui,3219257,493,23,19158,615
2020-06-29,Brazil,NA,Piaui,3219257,595,28,19753,643
2020-06-30,Brazil,NA,Piaui,3219257,669,20,20422,663
2020-07-01,Brazil,NA,Piaui,3219257,1637,23,22059,686
2020-07-02,Brazil,NA,Piaui,3219257,1248,11,23307,697
2020-07-03,Brazil,NA,Piaui,3219257,1069,29,24376,726
2020-07-04,Brazil,NA,Piaui,3219257,1185,36,25561,762
2020-07-05,Brazil,NA,Piaui,3219257,518,22,26079,784
2020-07-06,Brazil,NA,Piaui,3219257,432,25,26511,809
2020-07-07,Brazil,NA,Piaui,3219257,1003,25,27514,834
2020-07-08,Brazil,NA,Piaui,3219257,897,24,28411,858
2020-07-09,Brazil,NA,Piaui,3219257,1334,26,29745,884
2020-07-10,Brazil,NA,Piaui,3219257,1524,12,31269,896
2020-07-11,Brazil,NA,Piaui,3219257,1196,18,32465,914
2020-07-12,Brazil,NA,Piaui,3219257,498,22,32963,936
2020-07-13,Brazil,NA,Piaui,3219257,396,24,33359,960
2020-07-14,Brazil,NA,Piaui,3219257,797,32,34156,992
2020-07-15,Brazil,NA,Piaui,3219257,1289,27,35445,1019
2020-07-16,Brazil,NA,Piaui,3219257,1097,24,36542,1043
2020-07-17,Brazil,NA,Piaui,3219257,515,22,37057,1065
2020-07-18,Brazil,NA,Piaui,3219257,1511,18,38568,1083
2020-07-19,Brazil,NA,Piaui,3219257,728,17,39296,1100
2020-07-20,Brazil,NA,Piaui,3219257,310,18,39606,1118
2020-07-21,Brazil,NA,Piaui,3219257,670,22,40276,1140
2020-07-22,Brazil,NA,Piaui,3219257,1539,18,41815,1158
2020-07-23,Brazil,NA,Piaui,3219257,1364,26,43179,1184
2020-07-24,Brazil,NA,Piaui,3219257,1170,31,44349,1215
2020-07-25,Brazil,NA,Piaui,3219257,1040,13,45389,1228
2020-07-26,Brazil,NA,Piaui,3219257,655,15,46044,1243
2020-07-27,Brazil,NA,Piaui,3219257,540,16,46584,1259
2020-07-28,Brazil,NA,Piaui,3219257,967,19,47551,1278
2020-07-29,Brazil,NA,Piaui,3219257,1411,14,48962,1292
2020-07-30,Brazil,NA,Piaui,3219257,1236,12,50198,1304
2020-07-31,Brazil,NA,Piaui,3219257,1279,25,51477,1329
2020-08-01,Brazil,NA,Piaui,3219257,981,25,52458,1354
2020-08-02,Brazil,NA,Piaui,3219257,535,15,52993,1369
2020-08-03,Brazil,NA,Piaui,3219257,231,16,53224,1385
2020-08-04,Brazil,NA,Piaui,3219257,1219,16,54443,1401
2020-08-05,Brazil,NA,Piaui,3219257,0,0,54443,1401
2020-08-06,Brazil,NA,Piaui,3219257,2657,35,57100,1436
2020-08-07,Brazil,NA,Piaui,3219257,1290,16,58390,1452
2020-08-08,Brazil,NA,Piaui,3219257,1181,17,59571,1469
2020-08-09,Brazil,NA,Piaui,3219257,411,11,59982,1480
2020-08-10,Brazil,NA,Piaui,3219257,196,23,60178,1503
2020-08-11,Brazil,NA,Piaui,3219257,966,23,61144,1526
2020-08-12,Brazil,NA,Piaui,3219257,1321,22,62465,1548
2020-08-13,Brazil,NA,Piaui,3219257,1197,18,63662,1566
2020-08-14,Brazil,NA,Piaui,3219257,933,15,64595,1581
2020-08-15,Brazil,NA,Piaui,3219257,1043,13,65638,1594
2020-08-16,Brazil,NA,Piaui,3219257,440,14,66078,1608
2020-08-17,Brazil,NA,Piaui,3219257,237,11,66315,1619
2020-08-18,Brazil,NA,Piaui,3219257,911,18,67226,1637
2020-08-19,Brazil,NA,Piaui,3219257,1249,16,68475,1653
2020-08-20,Brazil,NA,Piaui,3219257,1364,7,69839,1660
2020-08-21,Brazil,NA,Piaui,3219257,697,12,70536,1672
2020-08-22,Brazil,NA,Piaui,3219257,974,29,71510,1701
2020-08-23,Brazil,NA,Piaui,3219257,389,13,71899,1714
2020-08-24,Brazil,NA,Piaui,3219257,266,10,72165,1724
2020-08-25,Brazil,NA,Piaui,3219257,791,17,72956,1741
2020-08-26,Brazil,NA,Piaui,3219257,1140,13,74096,1754
2020-08-27,Brazil,NA,Piaui,3219257,1064,11,75160,1765
2020-08-28,Brazil,NA,Piaui,3219257,873,20,76033,1785
2020-08-29,Brazil,NA,Piaui,3219257,883,19,76916,1804
2020-08-30,Brazil,NA,Piaui,3219257,349,11,77265,1815
2020-08-31,Brazil,NA,Piaui,3219257,140,10,77405,1825
2020-09-01,Brazil,NA,Piaui,3219257,454,18,77859,1843
2020-09-02,Brazil,NA,Piaui,3219257,1063,3,78922,1846
2020-09-03,Brazil,NA,Piaui,3219257,797,9,79719,1855
2020-09-04,Brazil,NA,Piaui,3219257,1031,13,80750,1868
2020-09-05,Brazil,NA,Piaui,3219257,876,16,81626,1884
2020-09-06,Brazil,NA,Piaui,3219257,380,9,82006,1893
2020-09-07,Brazil,NA,Piaui,3219257,276,8,82282,1901
2020-09-08,Brazil,NA,Piaui,3219257,282,14,82564,1915
2020-09-09,Brazil,NA,Piaui,3219257,938,9,83502,1924
2020-09-10,Brazil,NA,Piaui,3219257,1006,7,84508,1931
2020-09-11,Brazil,NA,Piaui,3219257,717,16,85225,1947
2020-09-12,Brazil,NA,Piaui,3219257,860,11,86085,1958
2020-09-13,Brazil,NA,Piaui,3219257,311,9,86396,1967
2020-09-14,Brazil,NA,Piaui,3219257,142,6,86538,1973
2020-09-15,Brazil,NA,Piaui,3219257,675,15,87213,1988
2020-09-16,Brazil,NA,Piaui,3219257,746,8,87959,1996
2020-09-17,Brazil,NA,Piaui,3219257,712,11,88671,2007
2020-09-18,Brazil,NA,Piaui,3219257,772,5,89443,2012
2020-09-19,Brazil,NA,Piaui,3219257,618,13,90061,2025
2020-09-20,Brazil,NA,Piaui,3219257,309,12,90370,2037
2020-09-21,Brazil,NA,Piaui,3219257,247,1,90617,2038
2020-09-22,Brazil,NA,Piaui,3219257,738,13,91355,2051
2020-09-23,Brazil,NA,Piaui,3219257,675,10,92030,2061
2020-03-11,Brazil,NA,Rio de Janeiro,16718956,5,0,13,0
2020-03-12,Brazil,NA,Rio de Janeiro,16718956,3,0,16,0
2020-03-13,Brazil,NA,Rio de Janeiro,16718956,0,0,16,0
2020-03-14,Brazil,NA,Rio de Janeiro,16718956,6,0,22,0
2020-03-15,Brazil,NA,Rio de Janeiro,16718956,2,0,24,0
2020-03-16,Brazil,NA,Rio de Janeiro,16718956,7,0,31,0
2020-03-17,Brazil,NA,Rio de Janeiro,16718956,2,0,33,0
2020-03-18,Brazil,NA,Rio de Janeiro,16718956,12,0,45,0
2020-03-19,Brazil,NA,Rio de Janeiro,16718956,20,2,65,2
2020-03-20,Brazil,NA,Rio de Janeiro,16718956,44,0,109,2
2020-03-21,Brazil,NA,Rio de Janeiro,16718956,10,1,119,3
2020-03-22,Brazil,NA,Rio de Janeiro,16718956,67,0,186,3
2020-03-23,Brazil,NA,Rio de Janeiro,16718956,47,1,233,4
2020-03-24,Brazil,NA,Rio de Janeiro,16718956,72,2,305,6
2020-03-25,Brazil,NA,Rio de Janeiro,16718956,65,0,370,6
2020-03-26,Brazil,NA,Rio de Janeiro,16718956,51,3,421,9
2020-03-27,Brazil,NA,Rio de Janeiro,16718956,72,1,493,10
2020-03-28,Brazil,NA,Rio de Janeiro,16718956,65,3,558,13
2020-03-29,Brazil,NA,Rio de Janeiro,16718956,42,4,600,17
2020-03-30,Brazil,NA,Rio de Janeiro,16718956,57,1,657,18
2020-03-31,Brazil,NA,Rio de Janeiro,16718956,51,5,708,23
2020-04-01,Brazil,NA,Rio de Janeiro,16718956,124,5,832,28
2020-04-02,Brazil,NA,Rio de Janeiro,16718956,160,13,992,41
2020-04-03,Brazil,NA,Rio de Janeiro,16718956,82,6,1074,47
2020-04-04,Brazil,NA,Rio de Janeiro,16718956,172,11,1246,58
2020-04-05,Brazil,NA,Rio de Janeiro,16718956,148,6,1394,64
2020-04-06,Brazil,NA,Rio de Janeiro,16718956,67,7,1461,71
2020-04-07,Brazil,NA,Rio de Janeiro,16718956,227,18,1688,89
2020-04-08,Brazil,NA,Rio de Janeiro,16718956,250,17,1938,106
2020-04-09,Brazil,NA,Rio de Janeiro,16718956,278,16,2216,122
2020-04-10,Brazil,NA,Rio de Janeiro,16718956,248,25,2464,147
2020-04-11,Brazil,NA,Rio de Janeiro,16718956,143,8,2607,155
2020-04-12,Brazil,NA,Rio de Janeiro,16718956,248,15,2855,170
2020-04-13,Brazil,NA,Rio de Janeiro,16718956,376,18,3231,188
2020-04-14,Brazil,NA,Rio de Janeiro,16718956,179,36,3410,224
2020-04-15,Brazil,NA,Rio de Janeiro,16718956,333,41,3743,265
2020-04-16,Brazil,NA,Rio de Janeiro,16718956,201,35,3944,300
2020-04-17,Brazil,NA,Rio de Janeiro,16718956,405,41,4349,341
2020-04-18,Brazil,NA,Rio de Janeiro,16718956,194,46,4543,387
2020-04-19,Brazil,NA,Rio de Janeiro,16718956,222,15,4765,402
2020-04-20,Brazil,NA,Rio de Janeiro,16718956,134,20,4899,422
2020-04-21,Brazil,NA,Rio de Janeiro,16718956,407,39,5306,461
2020-04-22,Brazil,NA,Rio de Janeiro,16718956,246,29,5552,490
2020-04-23,Brazil,NA,Rio de Janeiro,16718956,620,40,6172,530
2020-04-24,Brazil,NA,Rio de Janeiro,16718956,110,40,6282,570
2020-04-25,Brazil,NA,Rio de Janeiro,16718956,546,45,6828,615
2020-04-26,Brazil,NA,Rio de Janeiro,16718956,283,30,7111,645
2020-04-27,Brazil,NA,Rio de Janeiro,16718956,833,32,7944,677
2020-04-28,Brazil,NA,Rio de Janeiro,16718956,560,61,8504,738
2020-04-29,Brazil,NA,Rio de Janeiro,16718956,365,56,8869,794
2020-04-30,Brazil,NA,Rio de Janeiro,16718956,584,60,9453,854
2020-05-01,Brazil,NA,Rio de Janeiro,16718956,713,67,10166,921
2020-05-02,Brazil,NA,Rio de Janeiro,16718956,380,50,10546,971
2020-05-03,Brazil,NA,Rio de Janeiro,16718956,593,48,11139,1019
2020-05-04,Brazil,NA,Rio de Janeiro,16718956,582,46,11721,1065
2020-05-05,Brazil,NA,Rio de Janeiro,16718956,670,58,12391,1123
2020-05-06,Brazil,NA,Rio de Janeiro,16718956,904,82,13295,1205
2020-05-07,Brazil,NA,Rio de Janeiro,16718956,861,189,14156,1394
2020-05-08,Brazil,NA,Rio de Janeiro,16718956,1585,109,15741,1503
2020-05-09,Brazil,NA,Rio de Janeiro,16718956,1188,150,16929,1653
2020-05-10,Brazil,NA,Rio de Janeiro,16718956,133,61,17062,1714
2020-05-11,Brazil,NA,Rio de Janeiro,16718956,877,56,17939,1770
2020-05-12,Brazil,NA,Rio de Janeiro,16718956,547,158,18486,1928
2020-05-13,Brazil,NA,Rio de Janeiro,16718956,242,122,18728,2050
2020-05-14,Brazil,NA,Rio de Janeiro,16718956,739,197,19467,2247
2020-05-15,Brazil,NA,Rio de Janeiro,16718956,520,191,19987,2438
2020-05-16,Brazil,NA,Rio de Janeiro,16718956,1614,176,21601,2614
2020-05-17,Brazil,NA,Rio de Janeiro,16718956,637,101,22238,2715
2020-05-18,Brazil,NA,Rio de Janeiro,16718956,4427,137,26665,2852
2020-05-19,Brazil,NA,Rio de Janeiro,16718956,1140,227,27805,3079
2020-05-20,Brazil,NA,Rio de Janeiro,16718956,2567,158,30372,3237
2020-05-21,Brazil,NA,Rio de Janeiro,16718956,1717,175,32089,3412
2020-05-22,Brazil,NA,Rio de Janeiro,16718956,1500,245,33589,3657
2020-05-23,Brazil,NA,Rio de Janeiro,16718956,944,248,34533,3905
2020-05-24,Brazil,NA,Rio de Janeiro,16718956,3379,88,37912,3993
2020-05-25,Brazil,NA,Rio de Janeiro,16718956,1386,112,39298,4105
2020-05-26,Brazil,NA,Rio de Janeiro,16718956,726,256,40024,4361
2020-05-27,Brazil,NA,Rio de Janeiro,16718956,2374,244,42398,4605
2020-05-28,Brazil,NA,Rio de Janeiro,16718956,2488,251,44886,4856
2020-05-29,Brazil,NA,Rio de Janeiro,16718956,3067,223,47953,5079
2020-05-30,Brazil,NA,Rio de Janeiro,16718956,4467,198,52420,5277
2020-05-31,Brazil,NA,Rio de Janeiro,16718956,968,67,53388,5344
2020-06-01,Brazil,NA,Rio de Janeiro,16718956,1142,118,54530,5462
2020-06-02,Brazil,NA,Rio de Janeiro,16718956,2202,224,56732,5686
2020-06-03,Brazil,NA,Rio de Janeiro,16718956,2508,324,59240,6010
2020-06-04,Brazil,NA,Rio de Janeiro,16718956,1692,317,60932,6327
2020-06-05,Brazil,NA,Rio de Janeiro,16718956,2134,146,63066,6473
2020-06-06,Brazil,NA,Rio de Janeiro,16718956,1467,166,64533,6639
2020-06-07,Brazil,NA,Rio de Janeiro,16718956,3223,68,67756,6707
2020-06-08,Brazil,NA,Rio de Janeiro,16718956,1743,74,69499,6781
2020-06-09,Brazil,NA,Rio de Janeiro,16718956,3480,147,72979,6928
2020-06-10,Brazil,NA,Rio de Janeiro,16718956,1394,210,74373,7138
2020-06-11,Brazil,NA,Rio de Janeiro,16718956,1402,225,75775,7363
2020-06-12,Brazil,NA,Rio de Janeiro,16718956,2009,54,77784,7417
2020-06-13,Brazil,NA,Rio de Janeiro,16718956,1052,175,78836,7592
2020-06-14,Brazil,NA,Rio de Janeiro,16718956,736,80,79572,7672
2020-06-15,Brazil,NA,Rio de Janeiro,16718956,1374,56,80946,7728
2020-06-16,Brazil,NA,Rio de Janeiro,16718956,2397,239,83343,7967
2020-06-17,Brazil,NA,Rio de Janeiro,16718956,3620,171,86963,8138
2020-06-18,Brazil,NA,Rio de Janeiro,16718956,354,274,87317,8412
2020-06-19,Brazil,NA,Rio de Janeiro,16718956,6061,183,93378,8595
2020-06-20,Brazil,NA,Rio de Janeiro,16718956,2159,229,95537,8824
2020-06-21,Brazil,NA,Rio de Janeiro,16718956,596,51,96133,8875
2020-06-22,Brazil,NA,Rio de Janeiro,16718956,1439,58,97572,8933
2020-06-23,Brazil,NA,Rio de Janeiro,16718956,3297,220,100869,9153
2020-06-24,Brazil,NA,Rio de Janeiro,16718956,2624,142,103493,9295
2020-06-25,Brazil,NA,Rio de Janeiro,16718956,2404,155,105897,9450
2020-06-26,Brazil,NA,Rio de Janeiro,16718956,2600,137,108497,9587
2020-06-27,Brazil,NA,Rio de Janeiro,16718956,306,202,108803,9789
2020-06-28,Brazil,NA,Rio de Janeiro,16718956,2495,30,111298,9819
2020-06-29,Brazil,NA,Rio de Janeiro,16718956,585,29,111883,9848
2020-06-30,Brazil,NA,Rio de Janeiro,16718956,728,232,112611,10080
2020-07-01,Brazil,NA,Rio de Janeiro,16718956,2667,118,115278,10198
2020-07-02,Brazil,NA,Rio de Janeiro,16718956,1545,134,116823,10332
2020-07-03,Brazil,NA,Rio de Janeiro,16718956,2133,168,118956,10500
2020-07-04,Brazil,NA,Rio de Janeiro,16718956,1484,124,120440,10624
2020-07-05,Brazil,NA,Rio de Janeiro,16718956,852,43,121292,10667
2020-07-06,Brazil,NA,Rio de Janeiro,16718956,587,31,121879,10698
2020-07-07,Brazil,NA,Rio de Janeiro,16718956,2207,183,124086,10881
2020-07-08,Brazil,NA,Rio de Janeiro,16718956,2243,89,126329,10970
2020-07-09,Brazil,NA,Rio de Janeiro,16718956,1995,145,128324,11115
2020-07-10,Brazil,NA,Rio de Janeiro,16718956,1119,165,129443,11280
2020-07-11,Brazil,NA,Rio de Janeiro,16718956,232,126,129675,11406
2020-07-12,Brazil,NA,Rio de Janeiro,16718956,9,9,129684,11415
2020-07-13,Brazil,NA,Rio de Janeiro,16718956,2360,59,132044,11474
2020-07-14,Brazil,NA,Rio de Janeiro,16718956,778,150,132822,11624
2020-07-15,Brazil,NA,Rio de Janeiro,16718956,1627,133,134449,11757
2020-07-16,Brazil,NA,Rio de Janeiro,16718956,124,92,134573,11849
2020-07-17,Brazil,NA,Rio de Janeiro,16718956,657,70,135230,11919
2020-07-18,Brazil,NA,Rio de Janeiro,16718956,0,0,135230,11919
2020-07-19,Brazil,NA,Rio de Janeiro,16718956,3294,195,138524,12114
2020-07-20,Brazil,NA,Rio de Janeiro,16718956,2481,47,141005,12161
2020-07-21,Brazil,NA,Rio de Janeiro,16718956,4116,132,145121,12293
2020-07-22,Brazil,NA,Rio de Janeiro,16718956,3502,150,148623,12443
2020-07-23,Brazil,NA,Rio de Janeiro,16718956,2926,92,151549,12535
2020-07-24,Brazil,NA,Rio de Janeiro,16718956,3330,119,154879,12654
2020-07-25,Brazil,NA,Rio de Janeiro,16718956,1414,154,156293,12808
2020-07-26,Brazil,NA,Rio de Janeiro,16718956,32,27,156325,12835
2020-07-27,Brazil,NA,Rio de Janeiro,16718956,1509,41,157834,12876
2020-07-28,Brazil,NA,Rio de Janeiro,16718956,1805,157,159639,13033
2020-07-29,Brazil,NA,Rio de Janeiro,16718956,2008,165,161647,13198
2020-07-30,Brazil,NA,Rio de Janeiro,16718956,1995,150,163642,13348
2020-07-31,Brazil,NA,Rio de Janeiro,16718956,1853,129,165495,13477
2020-08-01,Brazil,NA,Rio de Janeiro,16718956,1718,79,167213,13556
2020-08-02,Brazil,NA,Rio de Janeiro,16718956,12,16,167225,13572
2020-08-03,Brazil,NA,Rio de Janeiro,16718956,839,32,168064,13604
2020-08-04,Brazil,NA,Rio de Janeiro,16718956,847,111,168911,13715
2020-08-05,Brazil,NA,Rio de Janeiro,16718956,3768,140,172679,13855
2020-08-06,Brazil,NA,Rio de Janeiro,16718956,1385,86,174064,13941
2020-08-07,Brazil,NA,Rio de Janeiro,16718956,1632,87,175696,14028
2020-08-08,Brazil,NA,Rio de Janeiro,16718956,2828,42,178524,14070
2020-08-09,Brazil,NA,Rio de Janeiro,16718956,326,10,178850,14080
2020-08-10,Brazil,NA,Rio de Janeiro,16718956,1166,28,180016,14108
2020-08-11,Brazil,NA,Rio de Janeiro,16718956,2547,104,182563,14212
2020-08-12,Brazil,NA,Rio de Janeiro,16718956,3047,83,185610,14295
2020-08-13,Brazil,NA,Rio de Janeiro,16718956,2475,117,188085,14412
2020-08-14,Brazil,NA,Rio de Janeiro,16718956,1806,95,189891,14507
2020-08-15,Brazil,NA,Rio de Janeiro,16718956,723,19,190614,14526
2020-08-16,Brazil,NA,Rio de Janeiro,16718956,3665,36,194279,14562
2020-08-17,Brazil,NA,Rio de Janeiro,16718956,372,4,194651,14566
2020-08-18,Brazil,NA,Rio de Janeiro,16718956,4829,162,199480,14728
2020-08-19,Brazil,NA,Rio de Janeiro,16718956,3513,185,202993,14913
2020-08-20,Brazil,NA,Rio de Janeiro,16718956,2923,161,205916,15074
2020-08-21,Brazil,NA,Rio de Janeiro,16718956,1120,128,207036,15202
2020-08-22,Brazil,NA,Rio de Janeiro,16718956,3428,65,210464,15267
2020-08-23,Brazil,NA,Rio de Janeiro,16718956,484,25,210948,15292
2020-08-24,Brazil,NA,Rio de Janeiro,16718956,412,100,211360,15392
2020-08-25,Brazil,NA,Rio de Janeiro,16718956,2643,168,214003,15560
2020-08-26,Brazil,NA,Rio de Janeiro,16718956,2672,140,216675,15700
2020-08-27,Brazil,NA,Rio de Janeiro,16718956,2523,159,219198,15859
2020-08-28,Brazil,NA,Rio de Janeiro,16718956,0,0,219198,15859
2020-08-29,Brazil,NA,Rio de Janeiro,16718956,3759,157,222957,16016
2020-08-30,Brazil,NA,Rio de Janeiro,16718956,345,11,223302,16027
2020-08-31,Brazil,NA,Rio de Janeiro,16718956,329,38,223631,16065
2020-09-01,Brazil,NA,Rio de Janeiro,16718956,3169,152,226800,16217
2020-09-02,Brazil,NA,Rio de Janeiro,16718956,1532,98,228332,16315
2020-09-03,Brazil,NA,Rio de Janeiro,16718956,1939,79,230271,16394
2020-09-04,Brazil,NA,Rio de Janeiro,16718956,2218,73,232489,16467
2020-09-05,Brazil,NA,Rio de Janeiro,16718956,258,59,232747,16526
2020-09-06,Brazil,NA,Rio de Janeiro,16718956,71,42,232818,16568
2020-09-07,Brazil,NA,Rio de Janeiro,16718956,234,25,233052,16593
2020-09-08,Brazil,NA,Rio de Janeiro,16718956,321,53,233373,16646
2020-09-09,Brazil,NA,Rio de Janeiro,16718956,500,124,233873,16770
2020-09-10,Brazil,NA,Rio de Janeiro,16718956,940,101,234813,16871
2020-09-11,Brazil,NA,Rio de Janeiro,16718956,5640,12,240453,16883
2020-09-12,Brazil,NA,Rio de Janeiro,16718956,323,102,240776,16985
2020-09-13,Brazil,NA,Rio de Janeiro,16718956,1715,5,242491,16990
2020-09-14,Brazil,NA,Rio de Janeiro,16718956,319,13,242810,17003
2020-09-15,Brazil,NA,Rio de Janeiro,16718956,1608,177,244418,17180
2020-09-16,Brazil,NA,Rio de Janeiro,16718956,1764,162,246182,17342
2020-09-17,Brazil,NA,Rio de Janeiro,16718956,661,111,246843,17453
2020-09-18,Brazil,NA,Rio de Janeiro,16718956,2955,122,249798,17575
2020-09-19,Brazil,NA,Rio de Janeiro,16718956,1463,59,251261,17634
2020-09-20,Brazil,NA,Rio de Janeiro,16718956,648,43,251909,17677
2020-09-21,Brazil,NA,Rio de Janeiro,16718956,137,50,252046,17727
2020-09-22,Brazil,NA,Rio de Janeiro,16718956,1710,71,253756,17798
2020-09-23,Brazil,NA,Rio de Janeiro,16718956,1129,113,254885,17911
2020-03-23,Brazil,NA,Rio Grande do Norte,3507003,4,0,13,0
2020-03-24,Brazil,NA,Rio Grande do Norte,3507003,0,0,13,0
2020-03-25,Brazil,NA,Rio Grande do Norte,3507003,1,0,14,0
2020-03-26,Brazil,NA,Rio Grande do Norte,3507003,5,0,19,0
2020-03-27,Brazil,NA,Rio Grande do Norte,3507003,9,0,28,0
2020-03-28,Brazil,NA,Rio Grande do Norte,3507003,17,0,45,0
2020-03-29,Brazil,NA,Rio Grande do Norte,3507003,23,1,68,1
2020-03-30,Brazil,NA,Rio Grande do Norte,3507003,9,0,77,1
2020-03-31,Brazil,NA,Rio Grande do Norte,3507003,5,0,82,1
2020-04-01,Brazil,NA,Rio Grande do Norte,3507003,10,1,92,2
2020-04-02,Brazil,NA,Rio Grande do Norte,3507003,13,0,105,2
2020-04-03,Brazil,NA,Rio Grande do Norte,3507003,71,2,176,4
2020-04-04,Brazil,NA,Rio Grande do Norte,3507003,36,1,212,5
2020-04-05,Brazil,NA,Rio Grande do Norte,3507003,30,2,242,7
2020-04-06,Brazil,NA,Rio Grande do Norte,3507003,4,0,246,7
2020-04-07,Brazil,NA,Rio Grande do Norte,3507003,8,1,254,8
2020-04-08,Brazil,NA,Rio Grande do Norte,3507003,7,3,261,11
2020-04-09,Brazil,NA,Rio Grande do Norte,3507003,0,0,261,11
2020-04-10,Brazil,NA,Rio Grande do Norte,3507003,2,0,263,11
2020-04-11,Brazil,NA,Rio Grande do Norte,3507003,26,2,289,13
2020-04-12,Brazil,NA,Rio Grande do Norte,3507003,13,2,302,15
2020-04-13,Brazil,NA,Rio Grande do Norte,3507003,37,2,339,17
2020-04-14,Brazil,NA,Rio Grande do Norte,3507003,37,1,376,18
2020-04-15,Brazil,NA,Rio Grande do Norte,3507003,23,1,399,19
2020-04-16,Brazil,NA,Rio Grande do Norte,3507003,1,1,400,20
2020-04-17,Brazil,NA,Rio Grande do Norte,3507003,63,3,463,23
2020-04-18,Brazil,NA,Rio Grande do Norte,3507003,53,1,516,24
2020-04-19,Brazil,NA,Rio Grande do Norte,3507003,15,1,531,25
2020-04-20,Brazil,NA,Rio Grande do Norte,3507003,64,2,595,27
2020-04-21,Brazil,NA,Rio Grande do Norte,3507003,13,1,608,28
2020-04-22,Brazil,NA,Rio Grande do Norte,3507003,38,1,646,29
2020-04-23,Brazil,NA,Rio Grande do Norte,3507003,62,5,708,34
2020-04-24,Brazil,NA,Rio Grande do Norte,3507003,46,4,754,38
2020-04-25,Brazil,NA,Rio Grande do Norte,3507003,27,2,781,40
2020-04-26,Brazil,NA,Rio Grande do Norte,3507003,44,4,825,44
2020-04-27,Brazil,NA,Rio Grande do Norte,3507003,7,1,832,45
2020-04-28,Brazil,NA,Rio Grande do Norte,3507003,25,3,857,48
2020-04-29,Brazil,NA,Rio Grande do Norte,3507003,229,5,1086,53
2020-04-30,Brazil,NA,Rio Grande do Norte,3507003,91,3,1177,56
2020-05-01,Brazil,NA,Rio Grande do Norte,3507003,120,0,1297,56
2020-05-02,Brazil,NA,Rio Grande do Norte,3507003,69,3,1366,59
2020-05-03,Brazil,NA,Rio Grande do Norte,3507003,26,2,1392,61
2020-05-04,Brazil,NA,Rio Grande do Norte,3507003,29,1,1421,62
2020-05-05,Brazil,NA,Rio Grande do Norte,3507003,115,6,1536,68
2020-05-06,Brazil,NA,Rio Grande do Norte,3507003,38,4,1574,72
2020-05-07,Brazil,NA,Rio Grande do Norte,3507003,165,4,1739,76
2020-05-08,Brazil,NA,Rio Grande do Norte,3507003,82,5,1821,81
2020-05-09,Brazil,NA,Rio Grande do Norte,3507003,98,6,1919,87
2020-05-10,Brazil,NA,Rio Grande do Norte,3507003,9,1,1928,88
2020-05-11,Brazil,NA,Rio Grande do Norte,3507003,61,4,1989,92
2020-05-12,Brazil,NA,Rio Grande do Norte,3507003,44,1,2033,93
2020-05-13,Brazil,NA,Rio Grande do Norte,3507003,334,12,2367,105
2020-05-14,Brazil,NA,Rio Grande do Norte,3507003,170,12,2537,117
2020-05-15,Brazil,NA,Rio Grande do Norte,3507003,249,5,2786,122
2020-05-16,Brazil,NA,Rio Grande do Norte,3507003,218,14,3004,136
2020-05-17,Brazil,NA,Rio Grande do Norte,3507003,133,3,3137,139
2020-05-18,Brazil,NA,Rio Grande do Norte,3507003,47,7,3184,146
2020-05-19,Brazil,NA,Rio Grande do Norte,3507003,299,14,3483,160
2020-05-20,Brazil,NA,Rio Grande do Norte,3507003,313,10,3796,170
2020-05-21,Brazil,NA,Rio Grande do Norte,3507003,264,8,4060,178
2020-05-22,Brazil,NA,Rio Grande do Norte,3507003,191,3,4251,181
2020-05-23,Brazil,NA,Rio Grande do Norte,3507003,348,3,4599,184
2020-05-24,Brazil,NA,Rio Grande do Norte,3507003,98,16,4697,200
2020-05-25,Brazil,NA,Rio Grande do Norte,3507003,62,9,4759,209
2020-05-26,Brazil,NA,Rio Grande do Norte,3507003,713,11,5472,220
2020-05-27,Brazil,NA,Rio Grande do Norte,3507003,158,22,5630,242
2020-05-28,Brazil,NA,Rio Grande do Norte,3507003,0,12,5630,254
2020-05-29,Brazil,NA,Rio Grande do Norte,3507003,833,14,6463,268
2020-05-30,Brazil,NA,Rio Grande do Norte,3507003,939,37,7402,305
2020-05-31,Brazil,NA,Rio Grande do Norte,3507003,0,0,7402,305
2020-06-01,Brazil,NA,Rio Grande do Norte,3507003,562,18,7964,323
2020-06-02,Brazil,NA,Rio Grande do Norte,3507003,269,18,8233,341
2020-06-03,Brazil,NA,Rio Grande do Norte,3507003,916,26,9149,367
2020-06-04,Brazil,NA,Rio Grande do Norte,3507003,133,11,9282,378
2020-06-05,Brazil,NA,Rio Grande do Norte,3507003,158,9,9440,387
2020-06-06,Brazil,NA,Rio Grande do Norte,3507003,9,23,9449,410
2020-06-07,Brazil,NA,Rio Grande do Norte,3507003,3,14,9452,424
2020-06-08,Brazil,NA,Rio Grande do Norte,3507003,1436,7,10888,431
2020-06-09,Brazil,NA,Rio Grande do Norte,3507003,139,28,11027,459
2020-06-10,Brazil,NA,Rio Grande do Norte,3507003,541,28,11568,487
2020-06-11,Brazil,NA,Rio Grande do Norte,3507003,1666,9,13234,496
2020-06-12,Brazil,NA,Rio Grande do Norte,3507003,267,18,13501,514
2020-06-13,Brazil,NA,Rio Grande do Norte,3507003,288,19,13789,533
2020-06-14,Brazil,NA,Rio Grande do Norte,3507003,382,1,14171,534
2020-06-15,Brazil,NA,Rio Grande do Norte,3507003,43,19,14214,553
2020-06-16,Brazil,NA,Rio Grande do Norte,3507003,998,32,15212,585
2020-06-17,Brazil,NA,Rio Grande do Norte,3507003,0,0,15212,585
2020-06-18,Brazil,NA,Rio Grande do Norte,3507003,677,70,15889,655
2020-06-19,Brazil,NA,Rio Grande do Norte,3507003,150,38,16039,693
2020-06-20,Brazil,NA,Rio Grande do Norte,3507003,3167,4,19206,697
2020-06-21,Brazil,NA,Rio Grande do Norte,3507003,84,0,19290,697
2020-06-22,Brazil,NA,Rio Grande do Norte,3507003,667,33,19957,730
2020-06-23,Brazil,NA,Rio Grande do Norte,3507003,118,20,20075,750
2020-06-24,Brazil,NA,Rio Grande do Norte,3507003,1699,57,21774,807
2020-06-25,Brazil,NA,Rio Grande do Norte,3507003,891,51,22665,858
2020-06-26,Brazil,NA,Rio Grande do Norte,3507003,1066,31,23731,889
2020-06-27,Brazil,NA,Rio Grande do Norte,3507003,522,20,24253,909
2020-06-28,Brazil,NA,Rio Grande do Norte,3507003,203,28,24456,937
2020-06-29,Brazil,NA,Rio Grande do Norte,3507003,5265,57,29721,994
2020-06-30,Brazil,NA,Rio Grande do Norte,3507003,566,40,30287,1034
2020-07-01,Brazil,NA,Rio Grande do Norte,3507003,1612,33,31899,1067
2020-07-02,Brazil,NA,Rio Grande do Norte,3507003,998,36,32897,1103
2020-07-03,Brazil,NA,Rio Grande do Norte,3507003,524,68,33421,1171
2020-07-04,Brazil,NA,Rio Grande do Norte,3507003,836,29,34257,1200
2020-07-05,Brazil,NA,Rio Grande do Norte,3507003,388,13,34645,1213
2020-07-06,Brazil,NA,Rio Grande do Norte,3507003,339,35,34984,1248
2020-07-07,Brazil,NA,Rio Grande do Norte,3507003,836,43,35820,1291
2020-07-08,Brazil,NA,Rio Grande do Norte,3507003,691,35,36511,1326
2020-07-09,Brazil,NA,Rio Grande do Norte,3507003,549,19,37060,1345
2020-07-10,Brazil,NA,Rio Grande do Norte,3507003,1205,11,38265,1356
2020-07-11,Brazil,NA,Rio Grande do Norte,3507003,351,24,38616,1380
2020-07-12,Brazil,NA,Rio Grande do Norte,3507003,805,14,39421,1394
2020-07-13,Brazil,NA,Rio Grande do Norte,3507003,379,10,39800,1404
2020-07-14,Brazil,NA,Rio Grande do Norte,3507003,541,28,40341,1432
2020-07-15,Brazil,NA,Rio Grande do Norte,3507003,313,41,40654,1473
2020-07-16,Brazil,NA,Rio Grande do Norte,3507003,324,28,40978,1501
2020-07-17,Brazil,NA,Rio Grande do Norte,3507003,325,25,41303,1526
2020-07-18,Brazil,NA,Rio Grande do Norte,3507003,2148,46,43451,1572
2020-07-19,Brazil,NA,Rio Grande do Norte,3507003,315,5,43766,1577
2020-07-20,Brazil,NA,Rio Grande do Norte,3507003,191,8,43957,1585
2020-07-21,Brazil,NA,Rio Grande do Norte,3507003,310,36,44267,1621
2020-07-22,Brazil,NA,Rio Grande do Norte,3507003,917,15,45184,1636
2020-07-23,Brazil,NA,Rio Grande do Norte,3507003,872,14,46056,1650
2020-07-24,Brazil,NA,Rio Grande do Norte,3507003,627,16,46683,1666
2020-07-25,Brazil,NA,Rio Grande do Norte,3507003,243,6,46926,1672
2020-07-26,Brazil,NA,Rio Grande do Norte,3507003,173,6,47099,1678
2020-07-27,Brazil,NA,Rio Grande do Norte,3507003,192,19,47291,1697
2020-07-28,Brazil,NA,Rio Grande do Norte,3507003,1083,17,48374,1714
2020-07-29,Brazil,NA,Rio Grande do Norte,3507003,677,21,49051,1735
2020-07-30,Brazil,NA,Rio Grande do Norte,3507003,616,16,49667,1751
2020-07-31,Brazil,NA,Rio Grande do Norte,3507003,749,26,50416,1777
2020-08-01,Brazil,NA,Rio Grande do Norte,3507003,1141,102,51557,1879
2020-08-02,Brazil,NA,Rio Grande do Norte,3507003,288,4,51845,1883
2020-08-03,Brazil,NA,Rio Grande do Norte,3507003,185,11,52030,1894
2020-08-04,Brazil,NA,Rio Grande do Norte,3507003,536,32,52566,1926
2020-08-05,Brazil,NA,Rio Grande do Norte,3507003,924,7,53490,1933
2020-08-06,Brazil,NA,Rio Grande do Norte,3507003,616,21,54106,1954
2020-08-07,Brazil,NA,Rio Grande do Norte,3507003,611,11,54717,1965
2020-08-08,Brazil,NA,Rio Grande do Norte,3507003,433,5,55150,1970
2020-08-09,Brazil,NA,Rio Grande do Norte,3507003,140,2,55290,1972
2020-08-10,Brazil,NA,Rio Grande do Norte,3507003,130,5,55420,1977
2020-08-11,Brazil,NA,Rio Grande do Norte,3507003,2501,26,57921,2003
2020-08-12,Brazil,NA,Rio Grande do Norte,3507003,0,16,57921,2019
2020-08-13,Brazil,NA,Rio Grande do Norte,3507003,500,17,57921,2036
2020-08-14,Brazil,NA,Rio Grande do Norte,3507003,395,5,57921,2041
2020-08-15,Brazil,NA,Rio Grande do Norte,3507003,193,21,57921,2062
2020-08-16,Brazil,NA,Rio Grande do Norte,3507003,60,5,57921,2067
2020-08-17,Brazil,NA,Rio Grande do Norte,3507003,178,14,57921,2081
2020-08-18,Brazil,NA,Rio Grande do Norte,3507003,409,21,58307,2102
2020-08-19,Brazil,NA,Rio Grande do Norte,3507003,360,24,58667,2126
2020-08-20,Brazil,NA,Rio Grande do Norte,3507003,471,7,59138,2133
2020-08-21,Brazil,NA,Rio Grande do Norte,3507003,53,21,59191,2154
2020-08-22,Brazil,NA,Rio Grande do Norte,3507003,202,11,59393,2165
2020-08-23,Brazil,NA,Rio Grande do Norte,3507003,189,5,59582,2170
2020-08-24,Brazil,NA,Rio Grande do Norte,3507003,67,3,59649,2173
2020-08-25,Brazil,NA,Rio Grande do Norte,3507003,512,19,60161,2192
2020-08-26,Brazil,NA,Rio Grande do Norte,3507003,281,23,60442,2215
2020-08-27,Brazil,NA,Rio Grande do Norte,3507003,451,4,60893,2219
2020-08-28,Brazil,NA,Rio Grande do Norte,3507003,326,15,61219,2234
2020-08-29,Brazil,NA,Rio Grande do Norte,3507003,288,8,61507,2242
2020-08-30,Brazil,NA,Rio Grande do Norte,3507003,142,6,61649,2248
2020-08-31,Brazil,NA,Rio Grande do Norte,3507003,99,8,61748,2256
2020-09-01,Brazil,NA,Rio Grande do Norte,3507003,243,9,61991,2265
2020-09-02,Brazil,NA,Rio Grande do Norte,3507003,441,10,62432,2275
2020-09-03,Brazil,NA,Rio Grande do Norte,3507003,423,3,62855,2278
2020-09-04,Brazil,NA,Rio Grande do Norte,3507003,434,3,63289,2281
2020-09-05,Brazil,NA,Rio Grande do Norte,3507003,404,4,63693,2285
2020-09-06,Brazil,NA,Rio Grande do Norte,3507003,108,1,63801,2286
2020-09-07,Brazil,NA,Rio Grande do Norte,3507003,9,8,63810,2294
2020-09-08,Brazil,NA,Rio Grande do Norte,3507003,69,1,63879,2295
2020-09-09,Brazil,NA,Rio Grande do Norte,3507003,256,1,64135,2296
2020-09-10,Brazil,NA,Rio Grande do Norte,3507003,384,6,64519,2302
2020-09-11,Brazil,NA,Rio Grande do Norte,3507003,359,6,64878,2308
2020-09-12,Brazil,NA,Rio Grande do Norte,3507003,167,5,65045,2313
2020-09-13,Brazil,NA,Rio Grande do Norte,3507003,255,2,65300,2315
2020-09-14,Brazil,NA,Rio Grande do Norte,3507003,60,2,65360,2317
2020-09-15,Brazil,NA,Rio Grande do Norte,3507003,287,9,65647,2326
2020-09-16,Brazil,NA,Rio Grande do Norte,3507003,286,4,65933,2330
2020-09-17,Brazil,NA,Rio Grande do Norte,3507003,389,3,66322,2333
2020-09-18,Brazil,NA,Rio Grande do Norte,3507003,333,8,66655,2341
2020-09-19,Brazil,NA,Rio Grande do Norte,3507003,308,7,66963,2348
2020-09-20,Brazil,NA,Rio Grande do Norte,3507003,221,3,67184,2351
2020-09-21,Brazil,NA,Rio Grande do Norte,3507003,33,1,67217,2352
2020-09-22,Brazil,NA,Rio Grande do Norte,3507003,242,3,67459,2355
2020-09-23,Brazil,NA,Rio Grande do Norte,3507003,302,1,67761,2356
2020-03-18,Brazil,NA,Rio Grande do Sul,11322895,9,0,19,0
2020-03-19,Brazil,NA,Rio Grande do Sul,11322895,9,0,28,0
2020-03-20,Brazil,NA,Rio Grande do Sul,11322895,9,0,37,0
2020-03-21,Brazil,NA,Rio Grande do Sul,11322895,23,0,60,0
2020-03-22,Brazil,NA,Rio Grande do Sul,11322895,12,0,72,0
2020-03-23,Brazil,NA,Rio Grande do Sul,11322895,14,0,86,0
2020-03-24,Brazil,NA,Rio Grande do Sul,11322895,12,0,98,0
2020-03-25,Brazil,NA,Rio Grande do Sul,11322895,25,1,123,1
2020-03-26,Brazil,NA,Rio Grande do Sul,11322895,45,0,168,1
2020-03-27,Brazil,NA,Rio Grande do Sul,11322895,27,1,195,2
2020-03-28,Brazil,NA,Rio Grande do Sul,11322895,2,0,197,2
2020-03-29,Brazil,NA,Rio Grande do Sul,11322895,29,0,226,2
2020-03-30,Brazil,NA,Rio Grande do Sul,11322895,15,1,241,3
2020-03-31,Brazil,NA,Rio Grande do Sul,11322895,33,1,274,4
2020-04-01,Brazil,NA,Rio Grande do Sul,11322895,32,0,306,4
2020-04-02,Brazil,NA,Rio Grande do Sul,11322895,28,1,334,5
2020-04-03,Brazil,NA,Rio Grande do Sul,11322895,62,0,396,5
2020-04-04,Brazil,NA,Rio Grande do Sul,11322895,14,1,410,6
2020-04-05,Brazil,NA,Rio Grande do Sul,11322895,8,1,418,7
2020-04-06,Brazil,NA,Rio Grande do Sul,11322895,63,0,481,7
2020-04-07,Brazil,NA,Rio Grande do Sul,11322895,27,1,508,8
2020-04-08,Brazil,NA,Rio Grande do Sul,11322895,47,1,555,9
2020-04-09,Brazil,NA,Rio Grande do Sul,11322895,63,3,618,12
2020-04-10,Brazil,NA,Rio Grande do Sul,11322895,18,2,636,14
2020-04-11,Brazil,NA,Rio Grande do Sul,11322895,4,1,640,15
2020-04-12,Brazil,NA,Rio Grande do Sul,11322895,13,1,653,16
2020-04-13,Brazil,NA,Rio Grande do Sul,11322895,11,0,664,16
2020-04-14,Brazil,NA,Rio Grande do Sul,11322895,36,2,700,18
2020-04-15,Brazil,NA,Rio Grande do Sul,11322895,47,1,747,19
2020-04-16,Brazil,NA,Rio Grande do Sul,11322895,33,0,780,19
2020-04-17,Brazil,NA,Rio Grande do Sul,11322895,22,3,802,22
2020-04-18,Brazil,NA,Rio Grande do Sul,11322895,29,2,831,24
2020-04-19,Brazil,NA,Rio Grande do Sul,11322895,23,0,854,24
2020-04-20,Brazil,NA,Rio Grande do Sul,11322895,35,3,889,27
2020-04-21,Brazil,NA,Rio Grande do Sul,11322895,15,0,904,27
2020-04-22,Brazil,NA,Rio Grande do Sul,11322895,19,0,923,27
2020-04-23,Brazil,NA,Rio Grande do Sul,11322895,71,2,994,29
2020-04-24,Brazil,NA,Rio Grande do Sul,11322895,67,2,1061,31
2020-04-25,Brazil,NA,Rio Grande do Sul,11322895,35,3,1096,34
2020-04-26,Brazil,NA,Rio Grande do Sul,11322895,70,1,1166,35
2020-04-27,Brazil,NA,Rio Grande do Sul,11322895,62,7,1228,42
2020-04-28,Brazil,NA,Rio Grande do Sul,11322895,58,3,1286,45
2020-04-29,Brazil,NA,Rio Grande do Sul,11322895,82,5,1368,50
2020-04-30,Brazil,NA,Rio Grande do Sul,11322895,98,1,1466,51
2020-05-01,Brazil,NA,Rio Grande do Sul,11322895,63,7,1529,58
2020-05-02,Brazil,NA,Rio Grande do Sul,11322895,90,4,1619,62
2020-05-03,Brazil,NA,Rio Grande do Sul,11322895,47,3,1666,65
2020-05-04,Brazil,NA,Rio Grande do Sul,11322895,45,9,1711,74
2020-05-05,Brazil,NA,Rio Grande do Sul,11322895,104,5,1815,79
2020-05-06,Brazil,NA,Rio Grande do Sul,11322895,235,8,2050,87
2020-05-07,Brazil,NA,Rio Grande do Sul,11322895,79,3,2129,90
2020-05-08,Brazil,NA,Rio Grande do Sul,11322895,318,1,2447,91
2020-05-09,Brazil,NA,Rio Grande do Sul,11322895,46,4,2493,95
2020-05-10,Brazil,NA,Rio Grande do Sul,11322895,49,2,2542,97
2020-05-11,Brazil,NA,Rio Grande do Sul,11322895,34,8,2576,105
2020-05-12,Brazil,NA,Rio Grande do Sul,11322895,341,6,2917,111
2020-05-13,Brazil,NA,Rio Grande do Sul,11322895,0,0,2917,111
2020-05-14,Brazil,NA,Rio Grande do Sul,11322895,80,9,2997,120
2020-05-15,Brazil,NA,Rio Grande do Sul,11322895,600,6,3597,126
2020-05-16,Brazil,NA,Rio Grande do Sul,11322895,98,6,3695,132
2020-05-17,Brazil,NA,Rio Grande do Sul,11322895,40,10,3735,142
2020-05-18,Brazil,NA,Rio Grande do Sul,11322895,0,2,3735,144
2020-05-19,Brazil,NA,Rio Grande do Sul,11322895,15,7,3750,151
2020-05-20,Brazil,NA,Rio Grande do Sul,11322895,1223,10,4973,161
2020-05-21,Brazil,NA,Rio Grande do Sul,11322895,500,5,5473,166
2020-05-22,Brazil,NA,Rio Grande do Sul,11322895,445,6,5918,172
2020-05-23,Brazil,NA,Rio Grande do Sul,11322895,418,4,6336,176
2020-05-24,Brazil,NA,Rio Grande do Sul,11322895,134,4,6470,180
2020-05-25,Brazil,NA,Rio Grande do Sul,11322895,89,17,6559,197
2020-05-26,Brazil,NA,Rio Grande do Sul,11322895,226,6,6785,203
2020-05-27,Brazil,NA,Rio Grande do Sul,11322895,263,6,7048,209
2020-05-28,Brazil,NA,Rio Grande do Sul,11322895,1186,4,8234,213
2020-05-29,Brazil,NA,Rio Grande do Sul,11322895,0,0,8234,213
2020-05-30,Brazil,NA,Rio Grande do Sul,11322895,1008,5,9242,218
2020-05-31,Brazil,NA,Rio Grande do Sul,11322895,90,6,9332,224
2020-06-01,Brazil,NA,Rio Grande do Sul,11322895,0,8,9332,232
2020-06-02,Brazil,NA,Rio Grande do Sul,11322895,587,13,9919,245
2020-06-03,Brazil,NA,Rio Grande do Sul,11322895,479,13,10398,258
2020-06-04,Brazil,NA,Rio Grande do Sul,11322895,612,7,11010,265
2020-06-05,Brazil,NA,Rio Grande do Sul,11322895,573,11,11583,276
2020-06-06,Brazil,NA,Rio Grande do Sul,11322895,454,7,12037,283
2020-06-07,Brazil,NA,Rio Grande do Sul,11322895,98,3,12135,286
2020-06-08,Brazil,NA,Rio Grande do Sul,11322895,115,5,12250,291
2020-06-09,Brazil,NA,Rio Grande do Sul,11322895,552,10,12802,301
2020-06-10,Brazil,NA,Rio Grande do Sul,11322895,817,15,13619,316
2020-06-11,Brazil,NA,Rio Grande do Sul,11322895,549,7,14168,323
2020-06-12,Brazil,NA,Rio Grande do Sul,11322895,216,14,14384,337
2020-06-13,Brazil,NA,Rio Grande do Sul,11322895,243,7,14627,344
2020-06-14,Brazil,NA,Rio Grande do Sul,11322895,34,6,14661,350
2020-06-15,Brazil,NA,Rio Grande do Sul,11322895,777,10,15438,360
2020-06-16,Brazil,NA,Rio Grande do Sul,11322895,1033,14,16471,374
2020-06-17,Brazil,NA,Rio Grande do Sul,11322895,657,13,17128,387
2020-06-18,Brazil,NA,Rio Grande do Sul,11322895,694,19,17822,406
2020-06-19,Brazil,NA,Rio Grande do Sul,11322895,765,17,18587,423
2020-06-20,Brazil,NA,Rio Grande do Sul,11322895,551,7,19138,430
2020-06-21,Brazil,NA,Rio Grande do Sul,11322895,210,4,19348,434
2020-06-22,Brazil,NA,Rio Grande do Sul,11322895,362,24,19710,458
2020-06-23,Brazil,NA,Rio Grande do Sul,11322895,1154,19,20864,477
2020-06-24,Brazil,NA,Rio Grande do Sul,11322895,1145,23,22009,500
2020-06-25,Brazil,NA,Rio Grande do Sul,11322895,1051,0,23060,500
2020-06-26,Brazil,NA,Rio Grande do Sul,11322895,1054,40,24114,540
2020-06-27,Brazil,NA,Rio Grande do Sul,11322895,886,14,25000,554
2020-06-28,Brazil,NA,Rio Grande do Sul,11322895,243,5,25243,559
2020-06-29,Brazil,NA,Rio Grande do Sul,11322895,416,23,25659,582
2020-06-30,Brazil,NA,Rio Grande do Sul,11322895,1282,32,26941,614
2020-07-01,Brazil,NA,Rio Grande do Sul,11322895,1230,22,28171,636
2020-07-02,Brazil,NA,Rio Grande do Sul,11322895,1024,27,29195,663
2020-07-03,Brazil,NA,Rio Grande do Sul,11322895,1176,27,30371,690
2020-07-04,Brazil,NA,Rio Grande do Sul,11322895,1248,25,31619,715
2020-07-05,Brazil,NA,Rio Grande do Sul,11322895,336,12,31955,727
2020-07-06,Brazil,NA,Rio Grande do Sul,11322895,446,32,32401,759
2020-07-07,Brazil,NA,Rio Grande do Sul,11322895,1399,32,33800,791
2020-07-08,Brazil,NA,Rio Grande do Sul,11322895,1757,34,35557,825
2020-07-09,Brazil,NA,Rio Grande do Sul,11322895,877,45,36434,870
2020-07-10,Brazil,NA,Rio Grande do Sul,11322895,1056,49,37490,919
2020-07-11,Brazil,NA,Rio Grande do Sul,11322895,1230,24,38720,943
2020-07-12,Brazil,NA,Rio Grande do Sul,11322895,520,19,39240,962
2020-07-13,Brazil,NA,Rio Grande do Sul,11322895,416,33,39656,995
2020-07-14,Brazil,NA,Rio Grande do Sul,11322895,1337,65,40993,1060
2020-07-15,Brazil,NA,Rio Grande do Sul,11322895,1246,41,42239,1101
2020-07-16,Brazil,NA,Rio Grande do Sul,11322895,3105,40,45344,1141
2020-07-17,Brazil,NA,Rio Grande do Sul,11322895,1366,25,46710,1166
2020-07-18,Brazil,NA,Rio Grande do Sul,11322895,137,63,46847,1229
2020-07-19,Brazil,NA,Rio Grande do Sul,11322895,266,23,47113,1252
2020-07-20,Brazil,NA,Rio Grande do Sul,11322895,336,33,47449,1285
2020-07-21,Brazil,NA,Rio Grande do Sul,11322895,2391,64,49840,1349
2020-07-22,Brazil,NA,Rio Grande do Sul,11322895,3233,48,53073,1397
2020-07-23,Brazil,NA,Rio Grande do Sul,11322895,1768,59,54841,1456
2020-07-24,Brazil,NA,Rio Grande do Sul,11322895,2166,38,57007,1494
2020-07-25,Brazil,NA,Rio Grande do Sul,11322895,2111,60,59118,1554
2020-07-26,Brazil,NA,Rio Grande do Sul,11322895,661,17,59779,1571
2020-07-27,Brazil,NA,Rio Grande do Sul,11322895,265,40,60044,1611
2020-07-28,Brazil,NA,Rio Grande do Sul,11322895,2303,69,62347,1680
2020-07-29,Brazil,NA,Rio Grande do Sul,11322895,2149,70,64496,1750
2020-07-30,Brazil,NA,Rio Grande do Sul,11322895,1977,75,66473,1825
2020-07-31,Brazil,NA,Rio Grande do Sul,11322895,219,51,66692,1876
2020-08-01,Brazil,NA,Rio Grande do Sul,11322895,3764,71,70456,1947
2020-08-02,Brazil,NA,Rio Grande do Sul,11322895,584,27,71040,1974
2020-08-03,Brazil,NA,Rio Grande do Sul,11322895,439,42,71479,2016
2020-08-04,Brazil,NA,Rio Grande do Sul,11322895,2139,83,73618,2099
2020-08-05,Brazil,NA,Rio Grande do Sul,11322895,2945,64,76563,2163
2020-08-06,Brazil,NA,Rio Grande do Sul,11322895,2274,68,78837,2231
2020-08-07,Brazil,NA,Rio Grande do Sul,11322895,189,51,79026,2282
2020-08-08,Brazil,NA,Rio Grande do Sul,11322895,4569,64,83595,2346
2020-08-09,Brazil,NA,Rio Grande do Sul,11322895,396,14,83991,2360
2020-08-10,Brazil,NA,Rio Grande do Sul,11322895,43,57,84034,2417
2020-08-11,Brazil,NA,Rio Grande do Sul,11322895,3381,55,87415,2472
2020-08-12,Brazil,NA,Rio Grande do Sul,11322895,2634,68,90049,2540
2020-08-13,Brazil,NA,Rio Grande do Sul,11322895,2511,44,92560,2584
2020-08-14,Brazil,NA,Rio Grande do Sul,11322895,2582,47,95142,2631
2020-08-15,Brazil,NA,Rio Grande do Sul,11322895,2303,16,97445,2647
2020-08-16,Brazil,NA,Rio Grande do Sul,11322895,432,42,97877,2689
2020-08-17,Brazil,NA,Rio Grande do Sul,11322895,130,55,98007,2744
2020-08-18,Brazil,NA,Rio Grande do Sul,11322895,3210,78,101217,2822
2020-08-19,Brazil,NA,Rio Grande do Sul,11322895,2674,59,103891,2881
2020-08-20,Brazil,NA,Rio Grande do Sul,11322895,177,67,104068,2948
2020-08-21,Brazil,NA,Rio Grande do Sul,11322895,267,45,104335,2993
2020-08-22,Brazil,NA,Rio Grande do Sul,11322895,4504,53,108839,3046
2020-08-23,Brazil,NA,Rio Grande do Sul,11322895,1034,16,109873,3062
2020-08-24,Brazil,NA,Rio Grande do Sul,11322895,80,40,109953,3102
2020-08-25,Brazil,NA,Rio Grande do Sul,11322895,2810,59,112763,3161
2020-08-26,Brazil,NA,Rio Grande do Sul,11322895,3221,74,115984,3235
2020-08-27,Brazil,NA,Rio Grande do Sul,11322895,2331,40,118315,3275
2020-08-28,Brazil,NA,Rio Grande do Sul,11322895,2424,48,120739,3323
2020-08-29,Brazil,NA,Rio Grande do Sul,11322895,3677,62,124416,3385
2020-08-30,Brazil,NA,Rio Grande do Sul,11322895,66,10,124482,3395
2020-08-31,Brazil,NA,Rio Grande do Sul,11322895,1331,40,125813,3435
2020-09-01,Brazil,NA,Rio Grande do Sul,11322895,1986,66,127799,3501
2020-09-02,Brazil,NA,Rio Grande do Sul,11322895,3662,42,131461,3543
2020-09-03,Brazil,NA,Rio Grande do Sul,11322895,3149,47,134610,3590
2020-09-04,Brazil,NA,Rio Grande do Sul,11322895,2607,60,137217,3650
2020-09-05,Brazil,NA,Rio Grande do Sul,11322895,6268,64,143485,3714
2020-09-06,Brazil,NA,Rio Grande do Sul,11322895,429,25,143914,3739
2020-09-07,Brazil,NA,Rio Grande do Sul,11322895,38,17,143952,3756
2020-09-08,Brazil,NA,Rio Grande do Sul,11322895,550,44,144502,3800
2020-09-09,Brazil,NA,Rio Grande do Sul,11322895,3074,82,147576,3882
2020-09-10,Brazil,NA,Rio Grande do Sul,11322895,3816,47,151392,3929
2020-09-11,Brazil,NA,Rio Grande do Sul,11322895,2083,68,153475,3997
2020-09-12,Brazil,NA,Rio Grande do Sul,11322895,2789,42,156264,4039
2020-09-13,Brazil,NA,Rio Grande do Sul,11322895,639,16,156903,4055
2020-09-14,Brazil,NA,Rio Grande do Sul,11322895,1004,25,157907,4080
2020-09-15,Brazil,NA,Rio Grande do Sul,11322895,3033,94,160940,4174
2020-09-16,Brazil,NA,Rio Grande do Sul,11322895,3433,42,164373,4216
2020-09-17,Brazil,NA,Rio Grande do Sul,11322895,3408,52,167781,4268
2020-09-18,Brazil,NA,Rio Grande do Sul,11322895,2968,50,170749,4318
2020-09-19,Brazil,NA,Rio Grande do Sul,11322895,3391,53,174140,4371
2020-09-20,Brazil,NA,Rio Grande do Sul,11322895,637,13,174777,4384
2020-09-21,Brazil,NA,Rio Grande do Sul,11322895,572,25,175349,4409
2020-09-22,Brazil,NA,Rio Grande do Sul,11322895,2136,63,177485,4472
2020-09-23,Brazil,NA,Rio Grande do Sul,11322895,1951,43,179436,4515
2020-04-04,Brazil,NA,Rondonia,1590011,1,0,11,1
2020-04-05,Brazil,NA,Rondonia,1590011,1,0,12,1
2020-04-06,Brazil,NA,Rondonia,1590011,2,0,14,1
2020-04-07,Brazil,NA,Rondonia,1590011,4,0,18,1
2020-04-08,Brazil,NA,Rondonia,1590011,0,0,18,1
2020-04-09,Brazil,NA,Rondonia,1590011,10,1,28,2
2020-04-10,Brazil,NA,Rondonia,1590011,4,0,32,2
2020-04-11,Brazil,NA,Rondonia,1590011,1,0,33,2
2020-04-12,Brazil,NA,Rondonia,1590011,2,0,35,2
2020-04-13,Brazil,NA,Rondonia,1590011,7,0,42,2
2020-04-14,Brazil,NA,Rondonia,1590011,22,0,64,2
2020-04-15,Brazil,NA,Rondonia,1590011,5,0,69,2
2020-04-16,Brazil,NA,Rondonia,1590011,7,1,76,3
2020-04-17,Brazil,NA,Rondonia,1590011,16,0,92,3
2020-04-18,Brazil,NA,Rondonia,1590011,18,0,110,3
2020-04-19,Brazil,NA,Rondonia,1590011,18,1,128,4
2020-04-20,Brazil,NA,Rondonia,1590011,32,0,160,4
2020-04-21,Brazil,NA,Rondonia,1590011,39,0,199,4
2020-04-22,Brazil,NA,Rondonia,1590011,24,1,223,5
2020-04-23,Brazil,NA,Rondonia,1590011,27,0,250,5
2020-04-24,Brazil,NA,Rondonia,1590011,40,0,290,5
2020-04-25,Brazil,NA,Rondonia,1590011,38,2,328,7
2020-04-26,Brazil,NA,Rondonia,1590011,36,3,364,10
2020-04-27,Brazil,NA,Rondonia,1590011,29,0,393,10
2020-04-28,Brazil,NA,Rondonia,1590011,20,1,413,11
2020-04-29,Brazil,NA,Rondonia,1590011,20,4,433,15
2020-04-30,Brazil,NA,Rondonia,1590011,69,1,502,16
2020-05-01,Brazil,NA,Rondonia,1590011,83,2,585,18
2020-05-02,Brazil,NA,Rondonia,1590011,68,5,653,23
2020-05-03,Brazil,NA,Rondonia,1590011,52,1,705,24
2020-05-04,Brazil,NA,Rondonia,1590011,51,1,756,25
2020-05-05,Brazil,NA,Rondonia,1590011,105,4,861,29
2020-05-06,Brazil,NA,Rondonia,1590011,82,4,943,33
2020-05-07,Brazil,NA,Rondonia,1590011,155,4,1098,37
2020-05-08,Brazil,NA,Rondonia,1590011,124,2,1222,39
2020-05-09,Brazil,NA,Rondonia,1590011,41,2,1263,41
2020-05-10,Brazil,NA,Rondonia,1590011,39,2,1302,43
2020-05-11,Brazil,NA,Rondonia,1590011,94,4,1396,47
2020-05-12,Brazil,NA,Rondonia,1590011,64,3,1460,50
2020-05-13,Brazil,NA,Rondonia,1590011,152,0,1612,50
2020-05-14,Brazil,NA,Rondonia,1590011,74,6,1686,56
2020-05-15,Brazil,NA,Rondonia,1590011,103,6,1789,62
2020-05-16,Brazil,NA,Rondonia,1590011,130,7,1919,69
2020-05-17,Brazil,NA,Rondonia,1590011,44,5,1963,74
2020-05-18,Brazil,NA,Rondonia,1590011,80,3,2043,77
2020-05-19,Brazil,NA,Rondonia,1590011,214,10,2257,87
2020-05-20,Brazil,NA,Rondonia,1590011,242,3,2499,90
2020-05-21,Brazil,NA,Rondonia,1590011,160,11,2659,101
2020-05-22,Brazil,NA,Rondonia,1590011,115,5,2774,106
2020-05-23,Brazil,NA,Rondonia,1590011,335,9,3109,115
2020-05-24,Brazil,NA,Rondonia,1590011,92,6,3201,121
2020-05-25,Brazil,NA,Rondonia,1590011,67,0,3268,121
2020-05-26,Brazil,NA,Rondonia,1590011,225,12,3493,133
2020-05-27,Brazil,NA,Rondonia,1590011,369,4,3862,137
2020-05-28,Brazil,NA,Rondonia,1590011,390,5,4252,142
2020-05-29,Brazil,NA,Rondonia,1590011,250,3,4502,145
2020-05-30,Brazil,NA,Rondonia,1590011,241,6,4743,151
2020-05-31,Brazil,NA,Rondonia,1590011,199,5,4942,156
2020-06-01,Brazil,NA,Rondonia,1590011,230,3,5172,159
2020-06-02,Brazil,NA,Rondonia,1590011,305,13,5477,172
2020-06-03,Brazil,NA,Rondonia,1590011,236,8,5713,180
2020-06-04,Brazil,NA,Rondonia,1590011,746,14,6459,194
2020-06-05,Brazil,NA,Rondonia,1590011,403,19,6862,213
2020-06-06,Brazil,NA,Rondonia,1590011,838,15,7700,228
2020-06-07,Brazil,NA,Rondonia,1590011,410,7,8110,235
2020-06-08,Brazil,NA,Rondonia,1590011,516,10,8626,245
2020-06-09,Brazil,NA,Rondonia,1590011,594,10,9220,255
2020-06-10,Brazil,NA,Rondonia,1590011,630,12,9850,267
2020-06-11,Brazil,NA,Rondonia,1590011,697,26,10547,293
2020-06-12,Brazil,NA,Rondonia,1590011,677,3,11224,296
2020-06-13,Brazil,NA,Rondonia,1590011,486,13,11710,309
2020-06-14,Brazil,NA,Rondonia,1590011,155,15,11865,324
2020-06-15,Brazil,NA,Rondonia,1590011,315,8,12180,332
2020-06-16,Brazil,NA,Rondonia,1590011,830,14,13010,346
2020-06-17,Brazil,NA,Rondonia,1590011,557,14,13567,360
2020-06-18,Brazil,NA,Rondonia,1590011,237,14,13804,374
2020-06-19,Brazil,NA,Rondonia,1590011,549,17,14353,391
2020-06-20,Brazil,NA,Rondonia,1590011,599,18,14952,409
2020-06-21,Brazil,NA,Rondonia,1590011,229,8,15181,417
2020-06-22,Brazil,NA,Rondonia,1590011,646,14,15827,431
2020-06-23,Brazil,NA,Rondonia,1590011,671,13,16498,444
2020-06-24,Brazil,NA,Rondonia,1590011,926,11,17424,455
2020-06-25,Brazil,NA,Rondonia,1590011,749,12,18173,467
2020-06-26,Brazil,NA,Rondonia,1590011,1098,9,19271,476
2020-06-27,Brazil,NA,Rondonia,1590011,0,0,19271,476
2020-06-28,Brazil,NA,Rondonia,1590011,549,10,19820,486
2020-06-29,Brazil,NA,Rondonia,1590011,586,14,20406,500
2020-06-30,Brazil,NA,Rondonia,1590011,845,18,21251,518
2020-07-01,Brazil,NA,Rondonia,1590011,211,2,21462,520
2020-07-02,Brazil,NA,Rondonia,1590011,508,10,21970,530
2020-07-03,Brazil,NA,Rondonia,1590011,271,3,22241,533
2020-07-04,Brazil,NA,Rondonia,1590011,716,15,22957,548
2020-07-05,Brazil,NA,Rondonia,1590011,522,7,23479,555
2020-07-06,Brazil,NA,Rondonia,1590011,442,3,23921,558
2020-07-07,Brazil,NA,Rondonia,1590011,643,19,24564,577
2020-07-08,Brazil,NA,Rondonia,1590011,503,8,25067,585
2020-07-09,Brazil,NA,Rondonia,1590011,335,4,25402,589
2020-07-10,Brazil,NA,Rondonia,1590011,598,16,26000,605
2020-07-11,Brazil,NA,Rondonia,1590011,496,12,26496,617
2020-07-12,Brazil,NA,Rondonia,1590011,232,11,26728,628
2020-07-13,Brazil,NA,Rondonia,1590011,322,19,27050,647
2020-07-14,Brazil,NA,Rondonia,1590011,478,16,27528,663
2020-07-15,Brazil,NA,Rondonia,1590011,389,5,27917,668
2020-07-16,Brazil,NA,Rondonia,1590011,737,9,28654,677
2020-07-17,Brazil,NA,Rondonia,1590011,463,9,29117,686
2020-07-18,Brazil,NA,Rondonia,1590011,0,0,29117,686
2020-07-19,Brazil,NA,Rondonia,1590011,0,0,29117,686
2020-07-20,Brazil,NA,Rondonia,1590011,684,24,29801,710
2020-07-21,Brazil,NA,Rondonia,1590011,841,17,30642,727
2020-07-22,Brazil,NA,Rondonia,1590011,2293,31,32935,758
2020-07-23,Brazil,NA,Rondonia,1590011,1145,26,34080,784
2020-07-24,Brazil,NA,Rondonia,1590011,793,17,34873,801
2020-07-25,Brazil,NA,Rondonia,1590011,700,9,35573,810
2020-07-26,Brazil,NA,Rondonia,1590011,237,4,35810,814
2020-07-27,Brazil,NA,Rondonia,1590011,338,16,36148,830
2020-07-28,Brazil,NA,Rondonia,1590011,701,10,36849,840
2020-07-29,Brazil,NA,Rondonia,1590011,785,15,37634,855
2020-07-30,Brazil,NA,Rondonia,1590011,773,9,38407,864
2020-07-31,Brazil,NA,Rondonia,1590011,585,8,38992,872
2020-08-01,Brazil,NA,Rondonia,1590011,512,9,39504,881
2020-08-02,Brazil,NA,Rondonia,1590011,389,3,39893,884
2020-08-03,Brazil,NA,Rondonia,1590011,123,4,40016,888
2020-08-04,Brazil,NA,Rondonia,1590011,1223,10,41239,898
2020-08-05,Brazil,NA,Rondonia,1590011,781,20,42020,918
2020-08-06,Brazil,NA,Rondonia,1590011,705,5,42725,923
2020-08-07,Brazil,NA,Rondonia,1590011,665,11,43390,934
2020-08-08,Brazil,NA,Rondonia,1590011,476,6,43866,940
2020-08-09,Brazil,NA,Rondonia,1590011,144,3,44010,943
2020-08-10,Brazil,NA,Rondonia,1590011,362,1,44372,944
2020-08-11,Brazil,NA,Rondonia,1590011,1096,22,45468,966
2020-08-12,Brazil,NA,Rondonia,1590011,593,15,46061,981
2020-08-13,Brazil,NA,Rondonia,1590011,615,12,46676,993
2020-08-14,Brazil,NA,Rondonia,1590011,612,8,47288,1001
2020-08-15,Brazil,NA,Rondonia,1590011,364,11,47652,1012
2020-08-16,Brazil,NA,Rondonia,1590011,185,1,47837,1013
2020-08-17,Brazil,NA,Rondonia,1590011,395,4,48232,1017
2020-08-18,Brazil,NA,Rondonia,1590011,691,9,48923,1026
2020-08-19,Brazil,NA,Rondonia,1590011,798,11,49721,1037
2020-08-20,Brazil,NA,Rondonia,1590011,426,8,50147,1045
2020-08-21,Brazil,NA,Rondonia,1590011,367,5,50514,1050
2020-08-22,Brazil,NA,Rondonia,1590011,481,11,50995,1061
2020-08-23,Brazil,NA,Rondonia,1590011,426,4,51421,1065
2020-08-24,Brazil,NA,Rondonia,1590011,370,8,51791,1073
2020-08-25,Brazil,NA,Rondonia,1590011,723,14,52514,1087
2020-08-26,Brazil,NA,Rondonia,1590011,605,13,53119,1100
2020-08-27,Brazil,NA,Rondonia,1590011,686,9,53805,1109
2020-08-28,Brazil,NA,Rondonia,1590011,400,5,54205,1114
2020-08-29,Brazil,NA,Rondonia,1590011,291,11,54496,1125
2020-08-30,Brazil,NA,Rondonia,1590011,183,4,54679,1129
2020-08-31,Brazil,NA,Rondonia,1590011,474,19,55153,1148
2020-09-01,Brazil,NA,Rondonia,1590011,615,7,55768,1155
2020-09-02,Brazil,NA,Rondonia,1590011,643,6,56411,1161
2020-09-03,Brazil,NA,Rondonia,1590011,207,4,56618,1165
2020-09-04,Brazil,NA,Rondonia,1590011,734,7,57352,1172
2020-09-05,Brazil,NA,Rondonia,1590011,513,8,57865,1180
2020-09-06,Brazil,NA,Rondonia,1590011,201,5,58066,1185
2020-09-07,Brazil,NA,Rondonia,1590011,171,2,58237,1187
2020-09-08,Brazil,NA,Rondonia,1590011,322,6,58559,1193
2020-09-09,Brazil,NA,Rondonia,1590011,637,14,59196,1207
2020-09-10,Brazil,NA,Rondonia,1590011,424,10,59620,1217
2020-09-11,Brazil,NA,Rondonia,1590011,418,14,60038,1231
2020-09-12,Brazil,NA,Rondonia,1590011,324,9,60362,1240
2020-09-13,Brazil,NA,Rondonia,1590011,122,6,60484,1246
2020-09-14,Brazil,NA,Rondonia,1590011,262,7,60746,1253
2020-09-15,Brazil,NA,Rondonia,1590011,514,16,61260,1269
2020-09-16,Brazil,NA,Rondonia,1590011,359,8,61619,1277
2020-09-17,Brazil,NA,Rondonia,1590011,539,12,62158,1289
2020-09-18,Brazil,NA,Rondonia,1590011,337,5,62495,1294
2020-09-19,Brazil,NA,Rondonia,1590011,202,3,62697,1297
2020-09-20,Brazil,NA,Rondonia,1590011,166,3,62863,1300
2020-09-21,Brazil,NA,Rondonia,1590011,404,5,63267,1305
2020-09-22,Brazil,NA,Rondonia,1590011,514,7,63781,1312
2020-09-23,Brazil,NA,Rondonia,1590011,525,8,64306,1320
2020-03-28,Brazil,NA,Roraima,1805788,2,0,12,0
2020-03-29,Brazil,NA,Roraima,1805788,4,0,16,0
2020-03-30,Brazil,NA,Roraima,1805788,0,0,16,0
2020-03-31,Brazil,NA,Roraima,1805788,0,0,16,0
2020-04-01,Brazil,NA,Roraima,1805788,6,0,22,0
2020-04-02,Brazil,NA,Roraima,1805788,4,0,26,0
2020-04-03,Brazil,NA,Roraima,1805788,4,0,30,0
2020-04-04,Brazil,NA,Roraima,1805788,7,1,37,1
2020-04-05,Brazil,NA,Roraima,1805788,5,0,42,1
2020-04-06,Brazil,NA,Roraima,1805788,0,0,42,1
2020-04-07,Brazil,NA,Roraima,1805788,0,0,42,1
2020-04-08,Brazil,NA,Roraima,1805788,7,0,49,1
2020-04-09,Brazil,NA,Roraima,1805788,3,0,52,1
2020-04-10,Brazil,NA,Roraima,1805788,11,2,63,3
2020-04-11,Brazil,NA,Roraima,1805788,12,0,75,3
2020-04-12,Brazil,NA,Roraima,1805788,4,0,79,3
2020-04-13,Brazil,NA,Roraima,1805788,4,0,83,3
2020-04-14,Brazil,NA,Roraima,1805788,30,0,113,3
2020-04-15,Brazil,NA,Roraima,1805788,1,0,114,3
2020-04-16,Brazil,NA,Roraima,1805788,28,0,142,3
2020-04-17,Brazil,NA,Roraima,1805788,22,0,164,3
2020-04-18,Brazil,NA,Roraima,1805788,37,0,201,3
2020-04-19,Brazil,NA,Roraima,1805788,21,0,222,3
2020-04-20,Brazil,NA,Roraima,1805788,22,0,244,3
2020-04-21,Brazil,NA,Roraima,1805788,3,0,247,3
2020-04-22,Brazil,NA,Roraima,1805788,33,0,280,3
2020-04-23,Brazil,NA,Roraima,1805788,17,0,297,3
2020-04-24,Brazil,NA,Roraima,1805788,7,0,304,3
2020-04-25,Brazil,NA,Roraima,1805788,41,0,345,3
2020-04-26,Brazil,NA,Roraima,1805788,56,1,401,4
2020-04-27,Brazil,NA,Roraima,1805788,6,0,407,4
2020-04-28,Brazil,NA,Roraima,1805788,18,2,425,6
2020-04-29,Brazil,NA,Roraima,1805788,27,0,452,6
2020-04-30,Brazil,NA,Roraima,1805788,67,1,519,7
2020-05-01,Brazil,NA,Roraima,1805788,83,1,602,8
2020-05-02,Brazil,NA,Roraima,1805788,66,1,668,9
2020-05-03,Brazil,NA,Roraima,1805788,72,2,740,11
2020-05-04,Brazil,NA,Roraima,1805788,66,0,806,11
2020-05-05,Brazil,NA,Roraima,1805788,63,0,869,11
2020-05-06,Brazil,NA,Roraima,1805788,63,2,932,13
2020-05-07,Brazil,NA,Roraima,1805788,88,1,1020,14
2020-05-08,Brazil,NA,Roraima,1805788,104,2,1124,16
2020-05-09,Brazil,NA,Roraima,1805788,78,2,1202,18
2020-05-10,Brazil,NA,Roraima,1805788,88,3,1290,21
2020-05-11,Brazil,NA,Roraima,1805788,5,3,1295,24
2020-05-12,Brazil,NA,Roraima,1805788,33,3,1328,27
2020-05-13,Brazil,NA,Roraima,1805788,83,2,1411,29
2020-05-14,Brazil,NA,Roraima,1805788,89,8,1500,37
2020-05-15,Brazil,NA,Roraima,1805788,89,3,1589,40
2020-05-16,Brazil,NA,Roraima,1805788,117,9,1706,49
2020-05-17,Brazil,NA,Roraima,1805788,85,2,1791,51
2020-05-18,Brazil,NA,Roraima,1805788,85,9,1876,60
2020-05-19,Brazil,NA,Roraima,1805788,109,1,1985,61
2020-05-20,Brazil,NA,Roraima,1805788,82,3,2067,64
2020-05-21,Brazil,NA,Roraima,1805788,79,8,2146,72
2020-05-22,Brazil,NA,Roraima,1805788,160,9,2306,81
2020-05-23,Brazil,NA,Roraima,1805788,68,0,2374,81
2020-05-24,Brazil,NA,Roraima,1805788,65,3,2439,84
2020-05-25,Brazil,NA,Roraima,1805788,75,2,2514,86
2020-05-26,Brazil,NA,Roraima,1805788,69,16,2583,102
2020-05-27,Brazil,NA,Roraima,1805788,99,0,2682,102
2020-05-28,Brazil,NA,Roraima,1805788,277,0,2959,102
2020-05-29,Brazil,NA,Roraima,1805788,139,6,3098,108
2020-05-30,Brazil,NA,Roraima,1805788,201,2,3299,110
2020-05-31,Brazil,NA,Roraima,1805788,175,6,3474,116
2020-06-01,Brazil,NA,Roraima,1805788,218,0,3692,116
2020-06-02,Brazil,NA,Roraima,1805788,158,4,3850,120
2020-06-03,Brazil,NA,Roraima,1805788,293,4,4143,124
2020-06-04,Brazil,NA,Roraima,1805788,340,3,4483,127
2020-06-05,Brazil,NA,Roraima,1805788,348,12,4831,139
2020-06-06,Brazil,NA,Roraima,1805788,407,0,5238,139
2020-06-07,Brazil,NA,Roraima,1805788,291,3,5529,142
2020-06-08,Brazil,NA,Roraima,1805788,239,3,5768,145
2020-06-09,Brazil,NA,Roraima,1805788,288,23,6056,168
2020-06-10,Brazil,NA,Roraima,1805788,291,14,6347,182
2020-06-11,Brazil,NA,Roraima,1805788,247,6,6594,188
2020-06-12,Brazil,NA,Roraima,1805788,118,4,6712,192
2020-06-13,Brazil,NA,Roraima,1805788,130,5,6842,197
2020-06-14,Brazil,NA,Roraima,1805788,33,3,6875,200
2020-06-15,Brazil,NA,Roraima,1805788,6,3,6881,203
2020-06-16,Brazil,NA,Roraima,1805788,54,13,6935,216
2020-06-17,Brazil,NA,Roraima,1805788,215,8,7150,224
2020-06-18,Brazil,NA,Roraima,1805788,271,7,7421,231
2020-06-19,Brazil,NA,Roraima,1805788,229,8,7650,239
2020-06-20,Brazil,NA,Roraima,1805788,387,6,8037,245
2020-06-21,Brazil,NA,Roraima,1805788,83,6,8120,251
2020-06-22,Brazil,NA,Roraima,1805788,68,0,8188,251
2020-06-23,Brazil,NA,Roraima,1805788,2152,0,10340,251
2020-06-24,Brazil,NA,Roraima,1805788,463,9,10803,259
2020-06-25,Brazil,NA,Roraima,1805788,1069,12,11872,271
2020-06-26,Brazil,NA,Roraima,1805788,1039,2,12911,273
2020-06-27,Brazil,NA,Roraima,1805788,167,8,13078,281
2020-06-28,Brazil,NA,Roraima,1805788,1263,0,14341,281
2020-06-29,Brazil,NA,Roraima,1805788,118,0,14459,281
2020-06-30,Brazil,NA,Roraima,1805788,182,2,14641,283
2020-07-01,Brazil,NA,Roraima,1805788,512,31,15153,314
2020-07-02,Brazil,NA,Roraima,1805788,2430,40,17583,354
2020-07-03,Brazil,NA,Roraima,1805788,740,4,18323,358
2020-07-04,Brazil,NA,Roraima,1805788,446,6,18769,364
2020-07-05,Brazil,NA,Roraima,1805788,153,4,18922,368
2020-07-06,Brazil,NA,Roraima,1805788,26,3,18948,371
2020-07-07,Brazil,NA,Roraima,1805788,140,5,19088,376
2020-07-08,Brazil,NA,Roraima,1805788,196,10,19284,386
2020-07-09,Brazil,NA,Roraima,1805788,870,7,20154,393
2020-07-10,Brazil,NA,Roraima,1805788,1066,0,21220,393
2020-07-11,Brazil,NA,Roraima,1805788,629,3,21849,396
2020-07-12,Brazil,NA,Roraima,1805788,376,0,22225,396
2020-07-13,Brazil,NA,Roraima,1805788,402,1,22627,397
2020-07-14,Brazil,NA,Roraima,1805788,341,1,22968,398
2020-07-15,Brazil,NA,Roraima,1805788,713,5,23681,403
2020-07-16,Brazil,NA,Roraima,1805788,716,12,24397,415
2020-07-17,Brazil,NA,Roraima,1805788,610,10,25007,425
2020-07-18,Brazil,NA,Roraima,1805788,366,4,25373,429
2020-07-19,Brazil,NA,Roraima,1805788,94,0,25467,429
2020-07-20,Brazil,NA,Roraima,1805788,219,2,25686,431
2020-07-21,Brazil,NA,Roraima,1805788,299,4,25985,435
2020-07-22,Brazil,NA,Roraima,1805788,969,16,26954,451
2020-07-23,Brazil,NA,Roraima,1805788,978,7,27932,458
2020-07-24,Brazil,NA,Roraima,1805788,942,7,28874,465
2020-07-25,Brazil,NA,Roraima,1805788,520,8,29394,473
2020-07-26,Brazil,NA,Roraima,1805788,435,0,29829,473
2020-07-27,Brazil,NA,Roraima,1805788,73,1,29902,474
2020-07-28,Brazil,NA,Roraima,1805788,414,5,30316,479
2020-07-29,Brazil,NA,Roraima,1805788,680,14,30996,493
2020-07-30,Brazil,NA,Roraima,1805788,459,8,31455,501
2020-07-31,Brazil,NA,Roraima,1805788,561,4,32016,505
2020-08-01,Brazil,NA,Roraima,1805788,707,8,32723,513
2020-08-02,Brazil,NA,Roraima,1805788,428,0,33151,513
2020-08-03,Brazil,NA,Roraima,1805788,37,0,33188,513
2020-08-04,Brazil,NA,Roraima,1805788,6,15,33194,528
2020-08-05,Brazil,NA,Roraima,1805788,1102,4,34296,532
2020-08-06,Brazil,NA,Roraima,1805788,633,6,34929,538
2020-08-07,Brazil,NA,Roraima,1805788,611,6,35540,544
2020-08-08,Brazil,NA,Roraima,1805788,393,3,35933,547
2020-08-09,Brazil,NA,Roraima,1805788,454,0,36387,547
2020-08-10,Brazil,NA,Roraima,1805788,62,0,36449,547
2020-08-11,Brazil,NA,Roraima,1805788,557,4,37006,551
2020-08-12,Brazil,NA,Roraima,1805788,573,4,37579,555
2020-08-13,Brazil,NA,Roraima,1805788,691,6,38270,561
2020-08-14,Brazil,NA,Roraima,1805788,627,4,38897,565
2020-08-15,Brazil,NA,Roraima,1805788,500,3,39397,568
2020-08-16,Brazil,NA,Roraima,1805788,226,0,39623,568
2020-08-17,Brazil,NA,Roraima,1805788,42,0,39665,568
2020-08-18,Brazil,NA,Roraima,1805788,518,6,40183,574
2020-08-19,Brazil,NA,Roraima,1805788,318,1,40501,575
2020-08-20,Brazil,NA,Roraima,1805788,488,1,40989,576
2020-08-21,Brazil,NA,Roraima,1805788,202,0,41191,576
2020-08-22,Brazil,NA,Roraima,1805788,336,3,41527,579
2020-08-23,Brazil,NA,Roraima,1805788,203,0,41730,579
2020-08-24,Brazil,NA,Roraima,1805788,40,0,41770,579
2020-08-25,Brazil,NA,Roraima,1805788,274,3,42044,582
2020-08-26,Brazil,NA,Roraima,1805788,315,0,42359,582
2020-08-27,Brazil,NA,Roraima,1805788,331,4,42690,586
2020-08-28,Brazil,NA,Roraima,1805788,307,1,42997,587
2020-08-29,Brazil,NA,Roraima,1805788,302,0,43299,587
2020-08-30,Brazil,NA,Roraima,1805788,171,0,43470,587
2020-08-31,Brazil,NA,Roraima,1805788,48,0,43518,587
2020-09-01,Brazil,NA,Roraima,1805788,189,6,43707,593
2020-09-02,Brazil,NA,Roraima,1805788,329,2,44036,595
2020-09-03,Brazil,NA,Roraima,1805788,298,1,44334,596
2020-09-04,Brazil,NA,Roraima,1805788,331,2,44665,598
2020-09-05,Brazil,NA,Roraima,1805788,310,0,44975,598
2020-09-06,Brazil,NA,Roraima,1805788,162,0,45137,598
2020-09-07,Brazil,NA,Roraima,1805788,116,0,45253,598
2020-09-08,Brazil,NA,Roraima,1805788,49,0,45302,598
2020-09-09,Brazil,NA,Roraima,1805788,203,7,45505,605
2020-09-10,Brazil,NA,Roraima,1805788,350,2,45855,607
2020-09-11,Brazil,NA,Roraima,1805788,247,2,46102,609
2020-09-12,Brazil,NA,Roraima,1805788,246,1,46348,610
2020-09-13,Brazil,NA,Roraima,1805788,130,0,46478,610
2020-09-14,Brazil,NA,Roraima,1805788,67,0,46545,610
2020-09-15,Brazil,NA,Roraima,1805788,303,1,46848,611
2020-09-16,Brazil,NA,Roraima,1805788,316,0,47164,611
2020-09-17,Brazil,NA,Roraima,1805788,234,0,47398,611
2020-09-18,Brazil,NA,Roraima,1805788,294,2,47692,613
2020-09-19,Brazil,NA,Roraima,1805788,396,0,48088,613
2020-09-20,Brazil,NA,Roraima,1805788,214,0,48302,613
2020-09-21,Brazil,NA,Roraima,1805788,28,0,48330,613
2020-09-22,Brazil,NA,Roraima,1805788,212,3,48542,616
2020-09-23,Brazil,NA,Roraima,1805788,377,0,48919,616
2020-03-19,Brazil,NA,Santa Catarina,7001161,10,0,20,0
2020-03-20,Brazil,NA,Santa Catarina,7001161,1,0,21,0
2020-03-21,Brazil,NA,Santa Catarina,7001161,30,0,51,0
2020-03-22,Brazil,NA,Santa Catarina,7001161,6,0,57,0
2020-03-23,Brazil,NA,Santa Catarina,7001161,11,0,68,0
2020-03-24,Brazil,NA,Santa Catarina,7001161,39,0,107,0
2020-03-25,Brazil,NA,Santa Catarina,7001161,2,0,109,0
2020-03-26,Brazil,NA,Santa Catarina,7001161,13,1,122,1
2020-03-27,Brazil,NA,Santa Catarina,7001161,27,0,149,1
2020-03-28,Brazil,NA,Santa Catarina,7001161,35,0,184,1
2020-03-29,Brazil,NA,Santa Catarina,7001161,10,0,194,1
2020-03-30,Brazil,NA,Santa Catarina,7001161,3,0,197,1
2020-03-31,Brazil,NA,Santa Catarina,7001161,22,1,219,2
2020-04-01,Brazil,NA,Santa Catarina,7001161,16,0,235,2
2020-04-02,Brazil,NA,Santa Catarina,7001161,12,0,247,2
2020-04-03,Brazil,NA,Santa Catarina,7001161,34,3,281,5
2020-04-04,Brazil,NA,Santa Catarina,7001161,53,0,334,5
2020-04-05,Brazil,NA,Santa Catarina,7001161,23,5,357,10
2020-04-06,Brazil,NA,Santa Catarina,7001161,22,0,379,10
2020-04-07,Brazil,NA,Santa Catarina,7001161,38,1,417,11
2020-04-08,Brazil,NA,Santa Catarina,7001161,40,4,457,15
2020-04-09,Brazil,NA,Santa Catarina,7001161,44,2,501,17
2020-04-10,Brazil,NA,Santa Catarina,7001161,192,1,693,18
2020-04-11,Brazil,NA,Santa Catarina,7001161,39,3,732,21
2020-04-12,Brazil,NA,Santa Catarina,7001161,36,3,768,24
2020-04-13,Brazil,NA,Santa Catarina,7001161,9,0,777,24
2020-04-14,Brazil,NA,Santa Catarina,7001161,49,2,826,26
2020-04-15,Brazil,NA,Santa Catarina,7001161,27,2,853,28
2020-04-16,Brazil,NA,Santa Catarina,7001161,31,1,884,29
2020-04-17,Brazil,NA,Santa Catarina,7001161,42,1,926,30
2020-04-18,Brazil,NA,Santa Catarina,7001161,36,1,962,31
2020-04-19,Brazil,NA,Santa Catarina,7001161,13,1,975,32
2020-04-20,Brazil,NA,Santa Catarina,7001161,50,3,1025,35
2020-04-21,Brazil,NA,Santa Catarina,7001161,38,0,1063,35
2020-04-22,Brazil,NA,Santa Catarina,7001161,28,2,1091,37
2020-04-23,Brazil,NA,Santa Catarina,7001161,24,2,1115,39
2020-04-24,Brazil,NA,Santa Catarina,7001161,55,3,1170,42
2020-04-25,Brazil,NA,Santa Catarina,7001161,39,0,1209,42
2020-04-26,Brazil,NA,Santa Catarina,7001161,26,0,1235,42
2020-04-27,Brazil,NA,Santa Catarina,7001161,102,1,1337,43
2020-04-28,Brazil,NA,Santa Catarina,7001161,139,1,1476,44
2020-04-29,Brazil,NA,Santa Catarina,7001161,519,0,1995,44
2020-04-30,Brazil,NA,Santa Catarina,7001161,90,2,2085,46
2020-05-01,Brazil,NA,Santa Catarina,7001161,19,2,2104,48
2020-05-02,Brazil,NA,Santa Catarina,7001161,242,4,2346,52
2020-05-03,Brazil,NA,Santa Catarina,7001161,0,0,2346,52
2020-05-04,Brazil,NA,Santa Catarina,7001161,173,0,2519,52
2020-05-05,Brazil,NA,Santa Catarina,7001161,104,3,2623,55
2020-05-06,Brazil,NA,Santa Catarina,7001161,294,4,2917,59
2020-05-07,Brazil,NA,Santa Catarina,7001161,165,4,3082,63
2020-05-08,Brazil,NA,Santa Catarina,7001161,123,0,3205,63
2020-05-09,Brazil,NA,Santa Catarina,7001161,167,1,3372,64
2020-05-10,Brazil,NA,Santa Catarina,7001161,57,1,3429,65
2020-05-11,Brazil,NA,Santa Catarina,7001161,100,4,3529,69
2020-05-12,Brazil,NA,Santa Catarina,7001161,204,4,3733,73
2020-05-13,Brazil,NA,Santa Catarina,7001161,95,0,3828,73
2020-05-14,Brazil,NA,Santa Catarina,7001161,504,5,4332,78
2020-05-15,Brazil,NA,Santa Catarina,7001161,230,1,4562,79
2020-05-16,Brazil,NA,Santa Catarina,7001161,116,2,4678,81
2020-05-17,Brazil,NA,Santa Catarina,7001161,98,2,4776,83
2020-05-18,Brazil,NA,Santa Catarina,7001161,399,2,5175,85
2020-05-19,Brazil,NA,Santa Catarina,7001161,238,6,5413,91
2020-05-20,Brazil,NA,Santa Catarina,7001161,86,3,5499,94
2020-05-21,Brazil,NA,Santa Catarina,7001161,111,4,5610,98
2020-05-22,Brazil,NA,Santa Catarina,7001161,848,2,6458,100
2020-05-23,Brazil,NA,Santa Catarina,7001161,149,3,6607,103
2020-05-24,Brazil,NA,Santa Catarina,7001161,89,2,6696,105
2020-05-25,Brazil,NA,Santa Catarina,7001161,179,4,6875,109
2020-05-26,Brazil,NA,Santa Catarina,7001161,141,12,7016,121
2020-05-27,Brazil,NA,Santa Catarina,7001161,356,5,7372,126
2020-05-28,Brazil,NA,Santa Catarina,7001161,628,5,8000,131
2020-05-29,Brazil,NA,Santa Catarina,7001161,530,3,8530,134
2020-05-30,Brazil,NA,Santa Catarina,7001161,248,2,8778,136
2020-05-31,Brazil,NA,Santa Catarina,7001161,259,7,9037,143
2020-06-01,Brazil,NA,Santa Catarina,7001161,461,3,9498,146
2020-06-02,Brazil,NA,Santa Catarina,7001161,162,2,9660,148
2020-06-03,Brazil,NA,Santa Catarina,7001161,374,4,10034,152
2020-06-04,Brazil,NA,Santa Catarina,7001161,498,4,10532,156
2020-06-05,Brazil,NA,Santa Catarina,7001161,314,3,10846,159
2020-06-06,Brazil,NA,Santa Catarina,7001161,439,7,11285,166
2020-06-07,Brazil,NA,Santa Catarina,7001161,280,5,11565,171
2020-06-08,Brazil,NA,Santa Catarina,7001161,0,0,11565,171
2020-06-09,Brazil,NA,Santa Catarina,7001161,627,8,12192,179
2020-06-10,Brazil,NA,Santa Catarina,7001161,402,5,12594,184
2020-06-11,Brazil,NA,Santa Catarina,7001161,359,2,12953,186
2020-06-12,Brazil,NA,Santa Catarina,7001161,212,5,13165,191
2020-06-13,Brazil,NA,Santa Catarina,7001161,131,2,13296,193
2020-06-14,Brazil,NA,Santa Catarina,7001161,64,2,13360,195
2020-06-15,Brazil,NA,Santa Catarina,7001161,600,4,13960,199
2020-06-16,Brazil,NA,Santa Catarina,7001161,442,13,14402,212
2020-06-17,Brazil,NA,Santa Catarina,7001161,613,4,15015,216
2020-06-18,Brazil,NA,Santa Catarina,7001161,558,6,15573,222
2020-06-19,Brazil,NA,Santa Catarina,7001161,749,12,16322,234
2020-06-20,Brazil,NA,Santa Catarina,7001161,786,3,17108,237
2020-06-21,Brazil,NA,Santa Catarina,7001161,474,9,17582,246
2020-06-22,Brazil,NA,Santa Catarina,7001161,355,10,17937,256
2020-06-23,Brazil,NA,Santa Catarina,7001161,1307,7,19244,263
2020-06-24,Brazil,NA,Santa Catarina,7001161,1677,16,20921,279
2020-06-25,Brazil,NA,Santa Catarina,7001161,1030,10,21951,289
2020-06-26,Brazil,NA,Santa Catarina,7001161,996,9,22947,298
2020-06-27,Brazil,NA,Santa Catarina,7001161,861,6,23808,304
2020-06-28,Brazil,NA,Santa Catarina,7001161,556,8,24364,312
2020-06-29,Brazil,NA,Santa Catarina,7001161,692,12,25056,324
2020-06-30,Brazil,NA,Santa Catarina,7001161,1298,17,26354,341
2020-07-01,Brazil,NA,Santa Catarina,7001161,925,6,27279,347
2020-07-02,Brazil,NA,Santa Catarina,7001161,1296,15,28575,362
2020-07-03,Brazil,NA,Santa Catarina,7001161,1686,14,30261,376
2020-07-04,Brazil,NA,Santa Catarina,7001161,1670,7,31931,383
2020-07-05,Brazil,NA,Santa Catarina,7001161,1038,10,32969,393
2020-07-06,Brazil,NA,Santa Catarina,7001161,853,13,33822,406
2020-07-07,Brazil,NA,Santa Catarina,7001161,1520,13,35342,419
2020-07-08,Brazil,NA,Santa Catarina,7001161,1468,13,36810,432
2020-07-09,Brazil,NA,Santa Catarina,7001161,1598,15,38408,447
2020-07-10,Brazil,NA,Santa Catarina,7001161,1698,12,40106,459
2020-07-11,Brazil,NA,Santa Catarina,7001161,1920,26,42026,485
2020-07-12,Brazil,NA,Santa Catarina,7001161,1005,12,43031,497
2020-07-13,Brazil,NA,Santa Catarina,7001161,784,20,43815,517
2020-07-14,Brazil,NA,Santa Catarina,7001161,2235,17,46050,534
2020-07-15,Brazil,NA,Santa Catarina,7001161,1926,35,47976,569
2020-07-16,Brazil,NA,Santa Catarina,7001161,1805,19,49781,588
2020-07-17,Brazil,NA,Santa Catarina,7001161,1768,58,51549,646
2020-07-18,Brazil,NA,Santa Catarina,7001161,982,16,52531,662
2020-07-19,Brazil,NA,Santa Catarina,7001161,805,23,53336,685
2020-07-20,Brazil,NA,Santa Catarina,7001161,1078,9,54414,694
2020-07-21,Brazil,NA,Santa Catarina,7001161,2061,44,56475,738
2020-07-22,Brazil,NA,Santa Catarina,7001161,3081,27,59556,765
2020-07-23,Brazil,NA,Santa Catarina,7001161,2726,47,62282,812
2020-07-24,Brazil,NA,Santa Catarina,7001161,2735,32,65017,844
2020-07-25,Brazil,NA,Santa Catarina,7001161,2316,36,67333,880
2020-07-26,Brazil,NA,Santa Catarina,7001161,1397,27,68730,907
2020-07-27,Brazil,NA,Santa Catarina,7001161,1408,17,70138,924
2020-07-28,Brazil,NA,Santa Catarina,7001161,3633,36,73771,960
2020-07-29,Brazil,NA,Santa Catarina,7001161,3230,42,77001,1002
2020-07-30,Brazil,NA,Santa Catarina,7001161,3903,41,80904,1043
2020-07-31,Brazil,NA,Santa Catarina,7001161,3169,59,84073,1102
2020-08-01,Brazil,NA,Santa Catarina,7001161,2849,52,86922,1154
2020-08-02,Brazil,NA,Santa Catarina,7001161,1060,21,87982,1175
2020-08-03,Brazil,NA,Santa Catarina,7001161,907,21,88889,1196
2020-08-04,Brazil,NA,Santa Catarina,7001161,3268,39,92157,1235
2020-08-05,Brazil,NA,Santa Catarina,7001161,3253,71,95410,1306
2020-08-06,Brazil,NA,Santa Catarina,7001161,3224,51,98634,1357
2020-08-07,Brazil,NA,Santa Catarina,7001161,2948,43,101582,1400
2020-08-08,Brazil,NA,Santa Catarina,7001161,3167,19,104749,1419
2020-08-09,Brazil,NA,Santa Catarina,7001161,1186,26,105935,1445
2020-08-10,Brazil,NA,Santa Catarina,7001161,993,96,106928,1541
2020-08-11,Brazil,NA,Santa Catarina,7001161,2594,78,109522,1619
2020-08-12,Brazil,NA,Santa Catarina,7001161,2879,18,112401,1637
2020-08-13,Brazil,NA,Santa Catarina,7001161,2631,59,115032,1696
2020-08-14,Brazil,NA,Santa Catarina,7001161,3151,46,118183,1742
2020-08-15,Brazil,NA,Santa Catarina,7001161,1818,25,120001,1767
2020-08-16,Brazil,NA,Santa Catarina,7001161,879,30,120880,1797
2020-08-17,Brazil,NA,Santa Catarina,7001161,786,42,121666,1839
2020-08-18,Brazil,NA,Santa Catarina,7001161,2647,44,124313,1883
2020-08-19,Brazil,NA,Santa Catarina,7001161,2537,35,126850,1918
2020-08-20,Brazil,NA,Santa Catarina,7001161,2222,42,129072,1960
2020-08-21,Brazil,NA,Santa Catarina,7001161,1277,35,130349,1995
2020-08-22,Brazil,NA,Santa Catarina,7001161,1659,32,132008,2027
2020-08-23,Brazil,NA,Santa Catarina,7001161,484,15,132492,2042
2020-08-24,Brazil,NA,Santa Catarina,7001161,1041,24,133533,2066
2020-08-25,Brazil,NA,Santa Catarina,7001161,2157,50,135690,2116
2020-08-26,Brazil,NA,Santa Catarina,7001161,1870,26,137560,2142
2020-08-27,Brazil,NA,Santa Catarina,7001161,2078,28,139638,2170
2020-08-28,Brazil,NA,Santa Catarina,7001161,2054,23,141692,2193
2020-08-29,Brazil,NA,Santa Catarina,7001161,4712,25,146404,2218
2020-08-30,Brazil,NA,Santa Catarina,7001161,460,17,146864,2235
2020-08-31,Brazil,NA,Santa Catarina,7001161,30913,25,177777,2260
2020-09-01,Brazil,NA,Santa Catarina,7001161,2697,41,180474,2301
2020-09-02,Brazil,NA,Santa Catarina,7001161,2048,24,182522,2325
2020-09-03,Brazil,NA,Santa Catarina,7001161,1682,27,184204,2352
2020-09-04,Brazil,NA,Santa Catarina,7001161,2392,24,186596,2376
2020-09-05,Brazil,NA,Santa Catarina,7001161,1765,24,188361,2400
2020-09-06,Brazil,NA,Santa Catarina,7001161,667,5,189028,2405
2020-09-07,Brazil,NA,Santa Catarina,7001161,449,17,189477,2422
2020-09-08,Brazil,NA,Santa Catarina,7001161,920,20,190397,2442
2020-09-09,Brazil,NA,Santa Catarina,7001161,2585,18,192982,2460
2020-09-10,Brazil,NA,Santa Catarina,7001161,1194,23,194176,2483
2020-09-11,Brazil,NA,Santa Catarina,7001161,1525,14,195701,2497
2020-09-12,Brazil,NA,Santa Catarina,7001161,1363,18,197064,2515
2020-09-13,Brazil,NA,Santa Catarina,7001161,681,14,197745,2529
2020-09-14,Brazil,NA,Santa Catarina,7001161,895,14,198640,2543
2020-09-15,Brazil,NA,Santa Catarina,7001161,1601,26,200241,2569
2020-09-16,Brazil,NA,Santa Catarina,7001161,1441,24,201682,2593
2020-09-17,Brazil,NA,Santa Catarina,7001161,1252,16,202934,2609
2020-09-18,Brazil,NA,Santa Catarina,7001161,1232,18,204166,2627
2020-09-19,Brazil,NA,Santa Catarina,7001161,1084,8,205250,2635
2020-09-20,Brazil,NA,Santa Catarina,7001161,370,4,205620,2639
2020-09-21,Brazil,NA,Santa Catarina,7001161,712,17,206332,2656
2020-09-22,Brazil,NA,Santa Catarina,7001161,1360,15,207692,2671
2020-09-23,Brazil,NA,Santa Catarina,7001161,1208,15,208900,2686
2020-03-07,Brazil,NA,Sao Paulo,45094866,3,0,13,0
2020-03-08,Brazil,NA,Sao Paulo,45094866,3,0,16,0
2020-03-09,Brazil,NA,Sao Paulo,45094866,0,0,16,0
2020-03-10,Brazil,NA,Sao Paulo,45094866,3,0,19,0
2020-03-11,Brazil,NA,Sao Paulo,45094866,11,0,30,0
2020-03-12,Brazil,NA,Sao Paulo,45094866,12,0,42,0
2020-03-13,Brazil,NA,Sao Paulo,45094866,14,0,56,0
2020-03-14,Brazil,NA,Sao Paulo,45094866,9,0,65,0
2020-03-15,Brazil,NA,Sao Paulo,45094866,71,0,136,0
2020-03-16,Brazil,NA,Sao Paulo,45094866,16,0,152,0
2020-03-17,Brazil,NA,Sao Paulo,45094866,12,1,164,1
2020-03-18,Brazil,NA,Sao Paulo,45094866,76,3,240,4
2020-03-19,Brazil,NA,Sao Paulo,45094866,46,0,286,4
2020-03-20,Brazil,NA,Sao Paulo,45094866,110,5,396,9
2020-03-21,Brazil,NA,Sao Paulo,45094866,63,6,459,15
2020-03-22,Brazil,NA,Sao Paulo,45094866,172,7,631,22
2020-03-23,Brazil,NA,Sao Paulo,45094866,114,8,745,30
2020-03-24,Brazil,NA,Sao Paulo,45094866,65,10,810,40
2020-03-25,Brazil,NA,Sao Paulo,45094866,52,8,862,48
2020-03-26,Brazil,NA,Sao Paulo,45094866,190,10,1052,58
2020-03-27,Brazil,NA,Sao Paulo,45094866,171,10,1223,68
2020-03-28,Brazil,NA,Sao Paulo,45094866,183,16,1406,84
2020-03-29,Brazil,NA,Sao Paulo,45094866,45,14,1451,98
2020-03-30,Brazil,NA,Sao Paulo,45094866,66,15,1517,113
2020-03-31,Brazil,NA,Sao Paulo,45094866,822,23,2339,136
2020-04-01,Brazil,NA,Sao Paulo,45094866,642,28,2981,164
2020-04-02,Brazil,NA,Sao Paulo,45094866,525,24,3506,188
2020-04-03,Brazil,NA,Sao Paulo,45094866,542,31,4048,219
2020-04-04,Brazil,NA,Sao Paulo,45094866,418,41,4466,260
2020-04-05,Brazil,NA,Sao Paulo,45094866,154,15,4620,275
2020-04-06,Brazil,NA,Sao Paulo,45094866,246,29,4866,304
2020-04-07,Brazil,NA,Sao Paulo,45094866,816,67,5682,371
2020-04-08,Brazil,NA,Sao Paulo,45094866,1026,57,6708,428
2020-04-09,Brazil,NA,Sao Paulo,45094866,772,68,7480,496
2020-04-10,Brazil,NA,Sao Paulo,45094866,736,44,8216,540
2020-04-11,Brazil,NA,Sao Paulo,45094866,203,20,8419,560
2020-04-12,Brazil,NA,Sao Paulo,45094866,336,28,8755,588
2020-04-13,Brazil,NA,Sao Paulo,45094866,140,20,8895,608
2020-04-14,Brazil,NA,Sao Paulo,45094866,476,87,9371,695
2020-04-15,Brazil,NA,Sao Paulo,45094866,1672,83,11043,778
2020-04-16,Brazil,NA,Sao Paulo,45094866,525,75,11568,853
2020-04-17,Brazil,NA,Sao Paulo,45094866,1273,75,12841,928
2020-04-18,Brazil,NA,Sao Paulo,45094866,1053,63,13894,991
2020-04-19,Brazil,NA,Sao Paulo,45094866,373,24,14267,1015
2020-04-20,Brazil,NA,Sao Paulo,45094866,313,22,14580,1037
2020-04-21,Brazil,NA,Sao Paulo,45094866,805,56,15385,1093
2020-04-22,Brazil,NA,Sao Paulo,45094866,529,41,15914,1134
2020-04-23,Brazil,NA,Sao Paulo,45094866,826,211,16740,1345
2020-04-24,Brazil,NA,Sao Paulo,45094866,1086,167,17826,1512
2020-04-25,Brazil,NA,Sao Paulo,45094866,2178,155,20004,1667
2020-04-26,Brazil,NA,Sao Paulo,45094866,711,33,20715,1700
2020-04-27,Brazil,NA,Sao Paulo,45094866,981,125,21696,1825
2020-04-28,Brazil,NA,Sao Paulo,45094866,2345,224,24041,2049
2020-04-29,Brazil,NA,Sao Paulo,45094866,2117,198,26158,2247
2020-04-30,Brazil,NA,Sao Paulo,45094866,2540,128,28698,2375
2020-05-01,Brazil,NA,Sao Paulo,45094866,1676,136,30374,2511
2020-05-02,Brazil,NA,Sao Paulo,45094866,800,75,31174,2586
2020-05-03,Brazil,NA,Sao Paulo,45094866,598,41,31772,2627
2020-05-04,Brazil,NA,Sao Paulo,45094866,415,27,32187,2654
2020-05-05,Brazil,NA,Sao Paulo,45094866,1866,197,34053,2851
2020-05-06,Brazil,NA,Sao Paulo,45094866,3800,194,37853,3045
2020-05-07,Brazil,NA,Sao Paulo,45094866,2075,161,39928,3206
2020-05-08,Brazil,NA,Sao Paulo,45094866,1902,210,41830,3416
2020-05-09,Brazil,NA,Sao Paulo,45094866,2581,192,44411,3608
2020-05-10,Brazil,NA,Sao Paulo,45094866,1033,101,45444,3709
2020-05-11,Brazil,NA,Sao Paulo,45094866,687,34,46131,3743
2020-05-12,Brazil,NA,Sao Paulo,45094866,1588,206,47719,3949
2020-05-13,Brazil,NA,Sao Paulo,45094866,3378,169,51097,4118
2020-05-14,Brazil,NA,Sao Paulo,45094866,3189,197,54286,4315
2020-05-15,Brazil,NA,Sao Paulo,45094866,4092,186,58378,4501
2020-05-16,Brazil,NA,Sao Paulo,45094866,2805,187,61183,4688
2020-05-17,Brazil,NA,Sao Paulo,45094866,1162,94,62345,4782
2020-05-18,Brazil,NA,Sao Paulo,45094866,721,41,63066,4823
2020-05-19,Brazil,NA,Sao Paulo,45094866,2929,324,65995,5147
2020-05-20,Brazil,NA,Sao Paulo,45094866,3864,216,69859,5363
2020-05-21,Brazil,NA,Sao Paulo,45094866,3880,195,73739,5558
2020-05-22,Brazil,NA,Sao Paulo,45094866,3132,215,76871,5773
2020-05-23,Brazil,NA,Sao Paulo,45094866,3687,272,80558,6045
2020-05-24,Brazil,NA,Sao Paulo,45094866,1603,118,82161,6163
2020-05-25,Brazil,NA,Sao Paulo,45094866,1464,57,83625,6220
2020-05-26,Brazil,NA,Sao Paulo,45094866,2392,203,86017,6423
2020-05-27,Brazil,NA,Sao Paulo,45094866,3466,289,89483,6712
2020-05-28,Brazil,NA,Sao Paulo,45094866,6382,268,95865,6980
2020-05-29,Brazil,NA,Sao Paulo,45094866,5691,295,101556,7275
2020-05-30,Brazil,NA,Sao Paulo,45094866,5586,257,107142,7532
2020-05-31,Brazil,NA,Sao Paulo,45094866,2556,83,109698,7615
2020-06-01,Brazil,NA,Sao Paulo,45094866,1598,52,111296,7667
2020-06-02,Brazil,NA,Sao Paulo,45094866,6999,327,118295,7994
2020-06-03,Brazil,NA,Sao Paulo,45094866,5188,282,123483,8276
2020-06-04,Brazil,NA,Sao Paulo,45094866,5717,284,129200,8560
2020-06-05,Brazil,NA,Sao Paulo,45094866,5365,282,134565,8842
2020-06-06,Brazil,NA,Sao Paulo,45094866,5984,216,140549,9058
2020-06-07,Brazil,NA,Sao Paulo,45094866,2524,87,143073,9145
2020-06-08,Brazil,NA,Sao Paulo,45094866,1520,43,144593,9188
2020-06-09,Brazil,NA,Sao Paulo,45094866,5545,334,150138,9522
2020-06-10,Brazil,NA,Sao Paulo,45094866,6178,340,156316,9862
2020-06-11,Brazil,NA,Sao Paulo,45094866,6204,283,162520,10145
2020-06-12,Brazil,NA,Sao Paulo,45094866,5380,223,167900,10368
2020-06-13,Brazil,NA,Sao Paulo,45094866,4975,213,172875,10581
2020-06-14,Brazil,NA,Sao Paulo,45094866,5327,113,178202,10694
2020-06-15,Brazil,NA,Sao Paulo,45094866,3258,73,181460,10767
2020-06-16,Brazil,NA,Sao Paulo,45094866,8825,365,190285,11132
2020-06-17,Brazil,NA,Sao Paulo,45094866,1232,389,191517,11521
2020-06-18,Brazil,NA,Sao Paulo,45094866,1111,325,192628,11846
2020-06-19,Brazil,NA,Sao Paulo,45094866,19030,386,211658,12232
2020-06-20,Brazil,NA,Sao Paulo,45094866,4135,262,215793,12494
2020-06-21,Brazil,NA,Sao Paulo,45094866,3392,94,219185,12588
2020-06-22,Brazil,NA,Sao Paulo,45094866,2788,46,221973,12634
2020-06-23,Brazil,NA,Sao Paulo,45094866,7502,434,229475,13068
2020-06-24,Brazil,NA,Sao Paulo,45094866,9347,284,238822,13352
2020-06-25,Brazil,NA,Sao Paulo,45094866,9765,407,248587,13759
2020-06-26,Brazil,NA,Sao Paulo,45094866,9921,207,258508,13966
2020-06-27,Brazil,NA,Sao Paulo,45094866,7073,297,265581,14263
2020-06-28,Brazil,NA,Sao Paulo,45094866,6156,75,271737,14338
2020-06-29,Brazil,NA,Sao Paulo,45094866,3408,60,275145,14398
2020-06-30,Brazil,NA,Sao Paulo,45094866,6235,365,281380,14763
2020-07-01,Brazil,NA,Sao Paulo,45094866,8555,267,289935,15030
2020-07-02,Brazil,NA,Sao Paulo,45094866,12244,321,302179,15351
2020-07-03,Brazil,NA,Sao Paulo,45094866,8523,343,310702,15694
2020-07-04,Brazil,NA,Sao Paulo,45094866,1828,302,312530,15996
2020-07-05,Brazil,NA,Sao Paulo,45094866,7649,82,320179,16078
2020-07-06,Brazil,NA,Sao Paulo,45094866,2891,56,323070,16134
2020-07-07,Brazil,NA,Sao Paulo,45094866,9638,341,332708,16475
2020-07-08,Brazil,NA,Sao Paulo,45094866,8657,313,341365,16788
2020-07-09,Brazil,NA,Sao Paulo,45094866,8350,330,349715,17118
2020-07-10,Brazil,NA,Sao Paulo,45094866,9395,324,359110,17442
2020-07-11,Brazil,NA,Sao Paulo,45094866,7780,260,366890,17702
2020-07-12,Brazil,NA,Sao Paulo,45094866,5107,146,371997,17848
2020-07-13,Brazil,NA,Sao Paulo,45094866,2610,59,374607,17907
2020-07-14,Brazil,NA,Sao Paulo,45094866,12000,417,386607,18324
2020-07-15,Brazil,NA,Sao Paulo,45094866,6569,316,393176,18640
2020-07-16,Brazil,NA,Sao Paulo,45094866,8872,398,402048,19038
2020-07-17,Brazil,NA,Sao Paulo,45094866,5367,339,407415,19377
2020-07-18,Brazil,NA,Sao Paulo,45094866,4612,270,412027,19647
2020-07-19,Brazil,NA,Sao Paulo,45094866,3022,85,415049,19732
2020-07-20,Brazil,NA,Sao Paulo,45094866,1385,56,416434,19788
2020-07-21,Brazil,NA,Sao Paulo,45094866,6235,383,422669,20171
2020-07-22,Brazil,NA,Sao Paulo,45094866,16777,361,439446,20532
2020-07-23,Brazil,NA,Sao Paulo,45094866,12561,362,452007,20894
2020-07-24,Brazil,NA,Sao Paulo,45094866,11211,312,463218,21206
2020-07-25,Brazil,NA,Sao Paulo,45094866,16263,311,479481,21517
2020-07-26,Brazil,NA,Sao Paulo,45094866,4501,89,483982,21606
2020-07-27,Brazil,NA,Sao Paulo,45094866,3672,70,487654,21676
2020-07-28,Brazil,NA,Sao Paulo,45094866,0,0,487654,21676
2020-07-29,Brazil,NA,Sao Paulo,45094866,26543,713,514197,22389
2020-07-30,Brazil,NA,Sao Paulo,45094866,14809,321,529006,22710
2020-07-31,Brazil,NA,Sao Paulo,45094866,13298,287,542304,22997
2020-08-01,Brazil,NA,Sao Paulo,45094866,10014,239,552318,23236
2020-08-02,Brazil,NA,Sao Paulo,45094866,6367,81,558685,23317
2020-08-03,Brazil,NA,Sao Paulo,45094866,1533,48,560218,23365
2020-08-04,Brazil,NA,Sao Paulo,45094866,15371,337,575589,23702
2020-08-05,Brazil,NA,Sao Paulo,45094866,9676,407,585265,24109
2020-08-06,Brazil,NA,Sao Paulo,45094866,13405,339,598670,24448
2020-08-07,Brazil,NA,Sao Paulo,45094866,9709,287,608379,24735
2020-08-08,Brazil,NA,Sao Paulo,45094866,13352,281,621731,25016
2020-08-09,Brazil,NA,Sao Paulo,45094866,5395,98,627126,25114
2020-08-10,Brazil,NA,Sao Paulo,45094866,1289,37,628415,25151
2020-08-11,Brazil,NA,Sao Paulo,45094866,11147,420,639562,25571
2020-08-12,Brazil,NA,Sao Paulo,45094866,15619,298,655181,25869
2020-08-13,Brazil,NA,Sao Paulo,45094866,19274,455,674455,26324
2020-08-14,Brazil,NA,Sao Paulo,45094866,11667,289,686122,26613
2020-08-15,Brazil,NA,Sao Paulo,45094866,11408,167,697530,26780
2020-08-16,Brazil,NA,Sao Paulo,45094866,1963,72,699493,26852
2020-08-17,Brazil,NA,Sao Paulo,45094866,3172,47,702665,26899
2020-08-18,Brazil,NA,Sao Paulo,45094866,8865,416,711530,27315
2020-08-19,Brazil,NA,Sao Paulo,45094866,9847,276,721377,27591
2020-08-20,Brazil,NA,Sao Paulo,45094866,9451,314,730828,27905
2020-08-21,Brazil,NA,Sao Paulo,45094866,5132,250,735960,28155
2020-08-22,Brazil,NA,Sao Paulo,45094866,13284,237,749244,28392
2020-08-23,Brazil,NA,Sao Paulo,45094866,4885,75,754129,28467
2020-08-24,Brazil,NA,Sao Paulo,45094866,2351,38,756480,28505
2020-08-25,Brazil,NA,Sao Paulo,45094866,9190,407,765670,28912
2020-08-26,Brazil,NA,Sao Paulo,45094866,10465,282,776135,29194
2020-08-27,Brazil,NA,Sao Paulo,45094866,8318,221,784453,29415
2020-08-28,Brazil,NA,Sao Paulo,45094866,11756,279,796209,29694
2020-08-29,Brazil,NA,Sao Paulo,45094866,5213,250,801422,29944
2020-08-30,Brazil,NA,Sao Paulo,45094866,1982,34,803404,29978
2020-08-31,Brazil,NA,Sao Paulo,45094866,938,36,804342,30014
2020-09-01,Brazil,NA,Sao Paulo,45094866,10033,361,814375,30375
2020-09-02,Brazil,NA,Sao Paulo,45094866,11956,298,826331,30673
2020-09-03,Brazil,NA,Sao Paulo,45094866,11647,232,837978,30905
2020-09-04,Brazil,NA,Sao Paulo,45094866,7038,186,845016,31091
2020-09-05,Brazil,NA,Sao Paulo,45094866,8069,222,853085,31313
2020-09-06,Brazil,NA,Sao Paulo,45094866,2637,40,855722,31353
2020-09-07,Brazil,NA,Sao Paulo,45094866,1608,24,857330,31377
2020-09-08,Brazil,NA,Sao Paulo,45094866,1453,53,858783,31430
2020-09-09,Brazil,NA,Sao Paulo,45094866,7793,391,866576,31821
2020-09-10,Brazil,NA,Sao Paulo,45094866,8178,283,874754,32104
2020-09-11,Brazil,NA,Sao Paulo,45094866,8055,234,882809,32338
2020-09-12,Brazil,NA,Sao Paulo,45094866,7881,229,890690,32567
2020-09-13,Brazil,NA,Sao Paulo,45094866,1567,39,892257,32606
2020-09-14,Brazil,NA,Sao Paulo,45094866,1092,36,893349,32642
2020-09-15,Brazil,NA,Sao Paulo,45094866,7922,321,901271,32963
2020-09-16,Brazil,NA,Sao Paulo,45094866,8157,290,909428,33253
2020-09-17,Brazil,NA,Sao Paulo,45094866,7393,219,916821,33472
2020-09-18,Brazil,NA,Sao Paulo,45094866,7711,206,924532,33678
2020-09-19,Brazil,NA,Sao Paulo,45094866,7141,249,931673,33927
2020-09-20,Brazil,NA,Sao Paulo,45094866,3627,25,935300,33952
2020-09-21,Brazil,NA,Sao Paulo,45094866,2032,32,937332,33984
2020-09-22,Brazil,NA,Sao Paulo,45094866,8090,282,945422,34266
2020-09-23,Brazil,NA,Sao Paulo,45094866,6551,226,951973,34492
2020-03-24,Brazil,NA,Sergipe,2288116,5,0,15,0
2020-03-25,Brazil,NA,Sergipe,2288116,1,0,16,0
2020-03-26,Brazil,NA,Sergipe,2288116,0,0,16,0
2020-03-27,Brazil,NA,Sergipe,2288116,0,0,16,0
2020-03-28,Brazil,NA,Sergipe,2288116,0,0,16,0
2020-03-29,Brazil,NA,Sergipe,2288116,0,0,16,0
2020-03-30,Brazil,NA,Sergipe,2288116,0,0,16,0
2020-03-31,Brazil,NA,Sergipe,2288116,3,0,19,0
2020-04-01,Brazil,NA,Sergipe,2288116,1,0,20,0
2020-04-02,Brazil,NA,Sergipe,2288116,3,2,23,2
2020-04-03,Brazil,NA,Sergipe,2288116,2,0,25,2
2020-04-04,Brazil,NA,Sergipe,2288116,2,0,27,2
2020-04-05,Brazil,NA,Sergipe,2288116,5,1,32,3
2020-04-06,Brazil,NA,Sergipe,2288116,0,1,32,4
2020-04-07,Brazil,NA,Sergipe,2288116,4,0,36,4
2020-04-08,Brazil,NA,Sergipe,2288116,0,0,36,4
2020-04-09,Brazil,NA,Sergipe,2288116,3,0,39,4
2020-04-10,Brazil,NA,Sergipe,2288116,3,0,42,4
2020-04-11,Brazil,NA,Sergipe,2288116,0,0,42,4
2020-04-12,Brazil,NA,Sergipe,2288116,2,0,44,4
2020-04-13,Brazil,NA,Sergipe,2288116,0,0,44,4
2020-04-14,Brazil,NA,Sergipe,2288116,1,0,45,4
2020-04-15,Brazil,NA,Sergipe,2288116,1,0,46,4
2020-04-16,Brazil,NA,Sergipe,2288116,2,0,48,4
2020-04-17,Brazil,NA,Sergipe,2288116,5,0,53,4
2020-04-18,Brazil,NA,Sergipe,2288116,18,1,71,5
2020-04-19,Brazil,NA,Sergipe,2288116,12,0,83,5
2020-04-20,Brazil,NA,Sergipe,2288116,3,0,86,5
2020-04-21,Brazil,NA,Sergipe,2288116,6,0,92,5
2020-04-22,Brazil,NA,Sergipe,2288116,25,2,117,7
2020-04-23,Brazil,NA,Sergipe,2288116,7,1,124,8
2020-04-24,Brazil,NA,Sergipe,2288116,20,0,144,8
2020-04-25,Brazil,NA,Sergipe,2288116,9,1,153,9
2020-04-26,Brazil,NA,Sergipe,2288116,6,0,159,9
2020-04-27,Brazil,NA,Sergipe,2288116,38,1,197,10
2020-04-28,Brazil,NA,Sergipe,2288116,83,1,280,11
2020-04-29,Brazil,NA,Sergipe,2288116,57,1,337,12
2020-04-30,Brazil,NA,Sergipe,2288116,110,0,447,12
2020-05-01,Brazil,NA,Sergipe,2288116,70,2,517,14
2020-05-02,Brazil,NA,Sergipe,2288116,84,0,601,14
2020-05-03,Brazil,NA,Sergipe,2288116,129,0,730,14
2020-05-04,Brazil,NA,Sergipe,2288116,42,3,772,17
2020-05-05,Brazil,NA,Sergipe,2288116,126,4,898,21
2020-05-06,Brazil,NA,Sergipe,2288116,100,2,998,23
2020-05-07,Brazil,NA,Sergipe,2288116,216,2,1214,25
2020-05-08,Brazil,NA,Sergipe,2288116,224,3,1438,28
2020-05-09,Brazil,NA,Sergipe,2288116,150,5,1588,33
2020-05-10,Brazil,NA,Sergipe,2288116,183,1,1771,34
2020-05-11,Brazil,NA,Sergipe,2288116,29,3,1800,37
2020-05-12,Brazil,NA,Sergipe,2288116,232,0,2032,37
2020-05-13,Brazil,NA,Sergipe,2288116,236,5,2268,42
2020-05-14,Brazil,NA,Sergipe,2288116,226,5,2494,47
2020-05-15,Brazil,NA,Sergipe,2288116,374,3,2868,50
2020-05-16,Brazil,NA,Sergipe,2288116,267,3,3135,53
2020-05-17,Brazil,NA,Sergipe,2288116,208,4,3343,57
2020-05-18,Brazil,NA,Sergipe,2288116,223,2,3566,59
2020-05-19,Brazil,NA,Sergipe,2288116,401,4,3967,63
2020-05-20,Brazil,NA,Sergipe,2288116,310,6,4277,69
2020-05-21,Brazil,NA,Sergipe,2288116,457,7,4734,76
2020-05-22,Brazil,NA,Sergipe,2288116,188,6,4922,82
2020-05-23,Brazil,NA,Sergipe,2288116,209,4,5131,86
2020-05-24,Brazil,NA,Sergipe,2288116,183,7,5314,93
2020-05-25,Brazil,NA,Sergipe,2288116,134,10,5448,103
2020-05-26,Brazil,NA,Sergipe,2288116,287,13,5735,116
2020-05-27,Brazil,NA,Sergipe,2288116,177,11,5912,127
2020-05-28,Brazil,NA,Sergipe,2288116,244,8,6156,135
2020-05-29,Brazil,NA,Sergipe,2288116,306,7,6462,142
2020-05-30,Brazil,NA,Sergipe,2288116,343,7,6805,149
2020-05-31,Brazil,NA,Sergipe,2288116,194,9,6999,158
2020-06-01,Brazil,NA,Sergipe,2288116,234,8,7233,166
2020-06-02,Brazil,NA,Sergipe,2288116,322,6,7555,172
2020-06-03,Brazil,NA,Sergipe,2288116,434,8,7989,180
2020-06-04,Brazil,NA,Sergipe,2288116,211,6,8200,186
2020-06-05,Brazil,NA,Sergipe,2288116,377,12,8577,198
2020-06-06,Brazil,NA,Sergipe,2288116,395,10,8972,208
2020-06-07,Brazil,NA,Sergipe,2288116,318,9,9290,217
2020-06-08,Brazil,NA,Sergipe,2288116,437,17,9727,234
2020-06-09,Brazil,NA,Sergipe,2288116,399,18,10126,252
2020-06-10,Brazil,NA,Sergipe,2288116,489,12,10615,264
2020-06-11,Brazil,NA,Sergipe,2288116,441,19,11056,283
2020-06-12,Brazil,NA,Sergipe,2288116,478,22,11534,305
2020-06-13,Brazil,NA,Sergipe,2288116,1332,11,12866,316
2020-06-14,Brazil,NA,Sergipe,2288116,1102,14,13968,330
2020-06-15,Brazil,NA,Sergipe,2288116,1707,22,15675,352
2020-06-16,Brazil,NA,Sergipe,2288116,635,12,16310,364
2020-06-17,Brazil,NA,Sergipe,2288116,497,19,16807,383
2020-06-18,Brazil,NA,Sergipe,2288116,531,17,17338,400
2020-06-19,Brazil,NA,Sergipe,2288116,470,26,17808,426
2020-06-20,Brazil,NA,Sergipe,2288116,641,22,18449,448
2020-06-21,Brazil,NA,Sergipe,2288116,536,14,18985,462
2020-06-22,Brazil,NA,Sergipe,2288116,399,29,19384,491
2020-06-23,Brazil,NA,Sergipe,2288116,499,20,19883,511
2020-06-24,Brazil,NA,Sergipe,2288116,470,13,20353,524
2020-06-25,Brazil,NA,Sergipe,2288116,728,30,21081,554
2020-06-26,Brazil,NA,Sergipe,2288116,827,25,21908,579
2020-06-27,Brazil,NA,Sergipe,2288116,1411,26,23319,605
2020-06-28,Brazil,NA,Sergipe,2288116,1102,15,24421,620
2020-06-29,Brazil,NA,Sergipe,2288116,396,33,24817,653
2020-06-30,Brazil,NA,Sergipe,2288116,594,23,25411,676
2020-07-01,Brazil,NA,Sergipe,2288116,504,25,25915,701
2020-07-02,Brazil,NA,Sergipe,2288116,697,24,26612,725
2020-07-03,Brazil,NA,Sergipe,2288116,1574,39,28186,764
2020-07-04,Brazil,NA,Sergipe,2288116,1575,19,29761,783
2020-07-05,Brazil,NA,Sergipe,2288116,456,15,30217,798
2020-07-06,Brazil,NA,Sergipe,2288116,501,28,30718,826
2020-07-07,Brazil,NA,Sergipe,2288116,922,25,31640,851
2020-07-08,Brazil,NA,Sergipe,2288116,850,24,32490,875
2020-07-09,Brazil,NA,Sergipe,2288116,926,26,33416,901
2020-07-10,Brazil,NA,Sergipe,2288116,1297,30,34713,931
2020-07-11,Brazil,NA,Sergipe,2288116,1333,23,36046,954
2020-07-12,Brazil,NA,Sergipe,2288116,1585,30,37631,984
2020-07-13,Brazil,NA,Sergipe,2288116,590,28,38221,1012
2020-07-14,Brazil,NA,Sergipe,2288116,946,21,39167,1033
2020-07-15,Brazil,NA,Sergipe,2288116,972,21,40139,1054
2020-07-16,Brazil,NA,Sergipe,2288116,1087,17,41226,1071
2020-07-17,Brazil,NA,Sergipe,2288116,662,17,41888,1088
2020-07-18,Brazil,NA,Sergipe,2288116,1184,23,43072,1111
2020-07-19,Brazil,NA,Sergipe,2288116,2171,14,45243,1125
2020-07-20,Brazil,NA,Sergipe,2288116,816,31,46059,1156
2020-07-21,Brazil,NA,Sergipe,2288116,1051,26,47110,1182
2020-07-22,Brazil,NA,Sergipe,2288116,1030,29,48140,1211
2020-07-23,Brazil,NA,Sergipe,2288116,1257,36,49397,1247
2020-07-24,Brazil,NA,Sergipe,2288116,1735,37,51132,1284
2020-07-25,Brazil,NA,Sergipe,2288116,1132,19,52264,1303
2020-07-26,Brazil,NA,Sergipe,2288116,339,11,52603,1314
2020-07-27,Brazil,NA,Sergipe,2288116,1009,26,53612,1340
2020-07-28,Brazil,NA,Sergipe,2288116,1397,19,55009,1359
2020-07-29,Brazil,NA,Sergipe,2288116,1205,31,56214,1390
2020-07-30,Brazil,NA,Sergipe,2288116,1470,18,57684,1408
2020-07-31,Brazil,NA,Sergipe,2288116,1029,26,58713,1434
2020-08-01,Brazil,NA,Sergipe,2288116,1011,14,59724,1448
2020-08-02,Brazil,NA,Sergipe,2288116,311,17,60035,1465
2020-08-03,Brazil,NA,Sergipe,2288116,444,24,60479,1489
2020-08-04,Brazil,NA,Sergipe,2288116,590,20,61069,1509
2020-08-05,Brazil,NA,Sergipe,2288116,917,16,61986,1525
2020-08-06,Brazil,NA,Sergipe,2288116,858,12,62844,1537
2020-08-07,Brazil,NA,Sergipe,2288116,884,21,63728,1558
2020-08-08,Brazil,NA,Sergipe,2288116,543,19,64271,1577
2020-08-09,Brazil,NA,Sergipe,2288116,422,12,64693,1589
2020-08-10,Brazil,NA,Sergipe,2288116,281,25,64974,1614
2020-08-11,Brazil,NA,Sergipe,2288116,481,19,65455,1633
2020-08-12,Brazil,NA,Sergipe,2288116,410,20,65865,1653
2020-08-13,Brazil,NA,Sergipe,2288116,945,17,66810,1670
2020-08-14,Brazil,NA,Sergipe,2288116,415,14,67225,1684
2020-08-15,Brazil,NA,Sergipe,2288116,476,12,67701,1696
2020-08-16,Brazil,NA,Sergipe,2288116,296,9,67997,1705
2020-08-17,Brazil,NA,Sergipe,2288116,316,12,68313,1717
2020-08-18,Brazil,NA,Sergipe,2288116,386,12,68699,1729
2020-08-19,Brazil,NA,Sergipe,2288116,368,16,69067,1745
2020-08-20,Brazil,NA,Sergipe,2288116,435,12,69502,1757
2020-08-21,Brazil,NA,Sergipe,2288116,343,4,69845,1761
2020-08-22,Brazil,NA,Sergipe,2288116,407,10,70252,1771
2020-08-23,Brazil,NA,Sergipe,2288116,220,11,70472,1782
2020-08-24,Brazil,NA,Sergipe,2288116,134,11,70606,1793
2020-08-25,Brazil,NA,Sergipe,2288116,320,15,70926,1808
2020-08-26,Brazil,NA,Sergipe,2288116,296,14,71222,1822
2020-08-27,Brazil,NA,Sergipe,2288116,377,8,71599,1830
2020-08-28,Brazil,NA,Sergipe,2288116,440,7,72039,1837
2020-08-29,Brazil,NA,Sergipe,2288116,241,2,72280,1839
2020-08-30,Brazil,NA,Sergipe,2288116,137,5,72417,1844
2020-08-31,Brazil,NA,Sergipe,2288116,111,13,72528,1857
2020-09-01,Brazil,NA,Sergipe,2288116,193,10,72721,1867
2020-09-02,Brazil,NA,Sergipe,2288116,210,6,72931,1873
2020-09-03,Brazil,NA,Sergipe,2288116,251,4,73182,1877
2020-09-04,Brazil,NA,Sergipe,2288116,201,3,73383,1880
2020-09-05,Brazil,NA,Sergipe,2288116,248,5,73631,1885
2020-09-06,Brazil,NA,Sergipe,2288116,109,8,73740,1893
2020-09-07,Brazil,NA,Sergipe,2288116,106,5,73846,1898
2020-09-08,Brazil,NA,Sergipe,2288116,125,11,73971,1909
2020-09-09,Brazil,NA,Sergipe,2288116,150,11,74121,1920
2020-09-10,Brazil,NA,Sergipe,2288116,265,13,74386,1933
2020-09-11,Brazil,NA,Sergipe,2288116,259,6,74645,1939
2020-09-12,Brazil,NA,Sergipe,2288116,120,6,74765,1945
2020-09-13,Brazil,NA,Sergipe,2288116,68,4,74833,1949
2020-09-14,Brazil,NA,Sergipe,2288116,213,7,75046,1956
2020-09-15,Brazil,NA,Sergipe,2288116,157,6,75203,1962
2020-09-16,Brazil,NA,Sergipe,2288116,139,3,75342,1965
2020-09-17,Brazil,NA,Sergipe,2288116,218,3,75560,1968
2020-09-18,Brazil,NA,Sergipe,2288116,104,4,75664,1972
2020-09-19,Brazil,NA,Sergipe,2288116,108,4,75772,1976
2020-09-20,Brazil,NA,Sergipe,2288116,101,5,75873,1981
2020-09-21,Brazil,NA,Sergipe,2288116,200,6,76073,1987
2020-09-22,Brazil,NA,Sergipe,2288116,120,6,76193,1993
2020-09-23,Brazil,NA,Sergipe,2288116,160,6,76353,1999
2020-03-31,Brazil,NA,Tocantins,1550194,1,0,11,0
2020-04-01,Brazil,NA,Tocantins,1550194,1,0,12,0
2020-04-02,Brazil,NA,Tocantins,1550194,0,0,12,0
2020-04-03,Brazil,NA,Tocantins,1550194,0,0,12,0
2020-04-04,Brazil,NA,Tocantins,1550194,2,0,14,0
2020-04-05,Brazil,NA,Tocantins,1550194,3,0,17,0
2020-04-06,Brazil,NA,Tocantins,1550194,0,0,17,0
2020-04-07,Brazil,NA,Tocantins,1550194,2,0,19,0
2020-04-08,Brazil,NA,Tocantins,1550194,4,0,23,0
2020-04-09,Brazil,NA,Tocantins,1550194,0,0,23,0
2020-04-10,Brazil,NA,Tocantins,1550194,0,0,23,0
2020-04-11,Brazil,NA,Tocantins,1550194,0,0,23,0
2020-04-12,Brazil,NA,Tocantins,1550194,2,0,25,0
2020-04-13,Brazil,NA,Tocantins,1550194,1,0,26,0
2020-04-14,Brazil,NA,Tocantins,1550194,0,0,26,0
2020-04-15,Brazil,NA,Tocantins,1550194,0,1,26,1
2020-04-16,Brazil,NA,Tocantins,1550194,3,0,29,1
2020-04-17,Brazil,NA,Tocantins,1550194,2,0,31,1
2020-04-18,Brazil,NA,Tocantins,1550194,2,0,33,1
2020-04-19,Brazil,NA,Tocantins,1550194,0,0,33,1
2020-04-20,Brazil,NA,Tocantins,1550194,1,0,34,1
2020-04-21,Brazil,NA,Tocantins,1550194,3,0,37,1
2020-04-22,Brazil,NA,Tocantins,1550194,0,0,37,1
2020-04-23,Brazil,NA,Tocantins,1550194,0,1,37,2
2020-04-24,Brazil,NA,Tocantins,1550194,6,0,43,2
2020-04-25,Brazil,NA,Tocantins,1550194,7,0,50,2
2020-04-26,Brazil,NA,Tocantins,1550194,8,0,58,2
2020-04-27,Brazil,NA,Tocantins,1550194,9,0,67,2
2020-04-28,Brazil,NA,Tocantins,1550194,12,0,79,2
2020-04-29,Brazil,NA,Tocantins,1550194,37,1,116,3
2020-04-30,Brazil,NA,Tocantins,1550194,21,0,137,3
2020-05-01,Brazil,NA,Tocantins,1550194,27,0,164,3
2020-05-02,Brazil,NA,Tocantins,1550194,27,1,191,4
2020-05-03,Brazil,NA,Tocantins,1550194,55,0,246,4
2020-05-04,Brazil,NA,Tocantins,1550194,21,2,267,6
2020-05-05,Brazil,NA,Tocantins,1550194,36,1,303,7
2020-05-06,Brazil,NA,Tocantins,1550194,48,2,351,9
2020-05-07,Brazil,NA,Tocantins,1550194,72,0,423,9
2020-05-08,Brazil,NA,Tocantins,1550194,71,0,494,9
2020-05-09,Brazil,NA,Tocantins,1550194,78,0,572,9
2020-05-10,Brazil,NA,Tocantins,1550194,116,2,688,11
2020-05-11,Brazil,NA,Tocantins,1550194,59,1,747,12
2020-05-12,Brazil,NA,Tocantins,1550194,81,2,828,14
2020-05-13,Brazil,NA,Tocantins,1550194,104,7,932,21
2020-05-14,Brazil,NA,Tocantins,1550194,97,2,1029,23
2020-05-15,Brazil,NA,Tocantins,1550194,150,1,1179,24
2020-05-16,Brazil,NA,Tocantins,1550194,100,3,1279,27
2020-05-17,Brazil,NA,Tocantins,1550194,103,4,1382,31
2020-05-18,Brazil,NA,Tocantins,1550194,114,1,1496,32
2020-05-19,Brazil,NA,Tocantins,1550194,150,6,1646,38
2020-05-20,Brazil,NA,Tocantins,1550194,163,4,1809,42
2020-05-21,Brazil,NA,Tocantins,1550194,167,5,1976,47
2020-05-22,Brazil,NA,Tocantins,1550194,229,2,2205,49
2020-05-23,Brazil,NA,Tocantins,1550194,225,2,2430,51
2020-05-24,Brazil,NA,Tocantins,1550194,161,1,2591,52
2020-05-25,Brazil,NA,Tocantins,1550194,105,6,2696,58
2020-05-26,Brazil,NA,Tocantins,1550194,162,6,2858,64
2020-05-27,Brazil,NA,Tocantins,1550194,165,1,3023,65
2020-05-28,Brazil,NA,Tocantins,1550194,254,3,3277,68
2020-05-29,Brazil,NA,Tocantins,1550194,334,2,3611,70
2020-05-30,Brazil,NA,Tocantins,1550194,370,1,3981,71
2020-05-31,Brazil,NA,Tocantins,1550194,195,2,4176,73
2020-06-01,Brazil,NA,Tocantins,1550194,169,3,4345,76
2020-06-02,Brazil,NA,Tocantins,1550194,138,3,4483,79
2020-06-03,Brazil,NA,Tocantins,1550194,215,3,4698,82
2020-06-04,Brazil,NA,Tocantins,1550194,183,5,4881,87
2020-06-05,Brazil,NA,Tocantins,1550194,301,2,5182,89
2020-06-06,Brazil,NA,Tocantins,1550194,323,7,5505,96
2020-06-07,Brazil,NA,Tocantins,1550194,139,3,5644,99
2020-06-08,Brazil,NA,Tocantins,1550194,163,9,5807,108
2020-06-09,Brazil,NA,Tocantins,1550194,245,6,6052,114
2020-06-10,Brazil,NA,Tocantins,1550194,205,6,6257,120
2020-06-11,Brazil,NA,Tocantins,1550194,272,4,6529,124
2020-06-12,Brazil,NA,Tocantins,1550194,215,4,6744,128
2020-06-13,Brazil,NA,Tocantins,1550194,187,2,6931,130
2020-06-14,Brazil,NA,Tocantins,1550194,41,2,6972,132
2020-06-15,Brazil,NA,Tocantins,1550194,165,4,7137,136
2020-06-16,Brazil,NA,Tocantins,1550194,172,4,7309,140
2020-06-17,Brazil,NA,Tocantins,1550194,264,9,7573,149
2020-06-18,Brazil,NA,Tocantins,1550194,201,3,7774,152
2020-06-19,Brazil,NA,Tocantins,1550194,182,7,7956,159
2020-06-20,Brazil,NA,Tocantins,1550194,247,8,8203,167
2020-06-21,Brazil,NA,Tocantins,1550194,151,8,8354,175
2020-06-22,Brazil,NA,Tocantins,1550194,123,3,8477,178
2020-06-23,Brazil,NA,Tocantins,1550194,289,1,8766,179
2020-06-24,Brazil,NA,Tocantins,1550194,332,2,9098,181
2020-06-25,Brazil,NA,Tocantins,1550194,327,2,9425,183
2020-06-26,Brazil,NA,Tocantins,1550194,256,3,9681,186
2020-06-27,Brazil,NA,Tocantins,1550194,285,5,9966,191
2020-06-28,Brazil,NA,Tocantins,1550194,262,1,10228,192
2020-06-29,Brazil,NA,Tocantins,1550194,131,3,10359,195
2020-06-30,Brazil,NA,Tocantins,1550194,405,5,10764,200
2020-07-01,Brazil,NA,Tocantins,1550194,458,4,11222,204
2020-07-02,Brazil,NA,Tocantins,1550194,232,5,11454,209
2020-07-03,Brazil,NA,Tocantins,1550194,282,2,11736,211
2020-07-04,Brazil,NA,Tocantins,1550194,546,4,12282,215
2020-07-05,Brazil,NA,Tocantins,1550194,193,5,12475,220
2020-07-06,Brazil,NA,Tocantins,1550194,165,4,12640,224
2020-07-07,Brazil,NA,Tocantins,1550194,364,4,13004,228
2020-07-08,Brazil,NA,Tocantins,1550194,436,5,13440,233
2020-07-09,Brazil,NA,Tocantins,1550194,405,7,13845,240
2020-07-10,Brazil,NA,Tocantins,1550194,664,5,14509,245
2020-07-11,Brazil,NA,Tocantins,1550194,430,6,14939,251
2020-07-12,Brazil,NA,Tocantins,1550194,193,4,15132,255
2020-07-13,Brazil,NA,Tocantins,1550194,175,4,15307,259
2020-07-14,Brazil,NA,Tocantins,1550194,416,8,15723,267
2020-07-15,Brazil,NA,Tocantins,1550194,308,4,16031,271
2020-07-16,Brazil,NA,Tocantins,1550194,641,7,16672,278
2020-07-17,Brazil,NA,Tocantins,1550194,282,5,16954,283
2020-07-18,Brazil,NA,Tocantins,1550194,255,5,17209,288
2020-07-19,Brazil,NA,Tocantins,1550194,564,6,17773,294
2020-07-20,Brazil,NA,Tocantins,1550194,125,5,17898,299
2020-07-21,Brazil,NA,Tocantins,1550194,456,9,18354,308
2020-07-22,Brazil,NA,Tocantins,1550194,496,7,18850,315
2020-07-23,Brazil,NA,Tocantins,1550194,573,11,19423,326
2020-07-24,Brazil,NA,Tocantins,1550194,542,8,19965,334
2020-07-25,Brazil,NA,Tocantins,1550194,955,6,20920,340
2020-07-26,Brazil,NA,Tocantins,1550194,847,6,21767,346
2020-07-27,Brazil,NA,Tocantins,1550194,339,4,22106,350
2020-07-28,Brazil,NA,Tocantins,1550194,745,7,22851,357
2020-07-29,Brazil,NA,Tocantins,1550194,666,7,23517,364
2020-07-30,Brazil,NA,Tocantins,1550194,761,4,24278,368
2020-07-31,Brazil,NA,Tocantins,1550194,546,13,24824,381
2020-08-01,Brazil,NA,Tocantins,1550194,522,9,25346,390
2020-08-02,Brazil,NA,Tocantins,1550194,1088,5,26434,395
2020-08-03,Brazil,NA,Tocantins,1550194,564,7,26998,402
2020-08-04,Brazil,NA,Tocantins,1550194,666,6,27664,408
2020-08-05,Brazil,NA,Tocantins,1550194,648,7,28312,415
2020-08-06,Brazil,NA,Tocantins,1550194,1227,13,29539,428
2020-08-07,Brazil,NA,Tocantins,1550194,819,9,30358,437
2020-08-08,Brazil,NA,Tocantins,1550194,745,7,31103,444
2020-08-09,Brazil,NA,Tocantins,1550194,560,7,31663,451
2020-08-10,Brazil,NA,Tocantins,1550194,626,10,32289,461
2020-08-11,Brazil,NA,Tocantins,1550194,758,13,33047,474
2020-08-12,Brazil,NA,Tocantins,1550194,719,8,33766,482
2020-08-13,Brazil,NA,Tocantins,1550194,643,11,34409,493
2020-08-14,Brazil,NA,Tocantins,1550194,994,7,35403,500
2020-08-15,Brazil,NA,Tocantins,1550194,1075,6,36478,506
2020-08-16,Brazil,NA,Tocantins,1550194,511,5,36989,511
2020-08-17,Brazil,NA,Tocantins,1550194,867,5,37856,516
2020-08-18,Brazil,NA,Tocantins,1550194,989,15,38845,531
2020-08-19,Brazil,NA,Tocantins,1550194,987,5,39832,536
2020-08-20,Brazil,NA,Tocantins,1550194,954,11,40786,547
2020-08-21,Brazil,NA,Tocantins,1550194,1062,9,41848,556
2020-08-22,Brazil,NA,Tocantins,1550194,991,17,42839,573
2020-08-23,Brazil,NA,Tocantins,1550194,757,12,43596,585
2020-08-24,Brazil,NA,Tocantins,1550194,677,8,44273,593
2020-08-25,Brazil,NA,Tocantins,1550194,1127,17,45400,610
2020-08-26,Brazil,NA,Tocantins,1550194,964,11,46364,621
2020-08-27,Brazil,NA,Tocantins,1550194,1194,14,47558,635
2020-08-28,Brazil,NA,Tocantins,1550194,1022,14,48580,649
2020-08-29,Brazil,NA,Tocantins,1550194,1071,9,49651,658
2020-08-30,Brazil,NA,Tocantins,1550194,722,6,50373,664
2020-08-31,Brazil,NA,Tocantins,1550194,321,9,50694,673
2020-09-01,Brazil,NA,Tocantins,1550194,935,14,51629,687
2020-09-02,Brazil,NA,Tocantins,1550194,495,14,52124,701
2020-09-03,Brazil,NA,Tocantins,1550194,814,11,52938,712
2020-09-04,Brazil,NA,Tocantins,1550194,1075,18,54013,730
2020-09-05,Brazil,NA,Tocantins,1550194,1062,15,55075,745
2020-09-06,Brazil,NA,Tocantins,1550194,438,3,55513,748
2020-09-07,Brazil,NA,Tocantins,1550194,393,6,55906,754
2020-09-08,Brazil,NA,Tocantins,1550194,317,4,56223,758
2020-09-09,Brazil,NA,Tocantins,1550194,461,4,56684,762
2020-09-10,Brazil,NA,Tocantins,1550194,1213,11,57897,773
2020-09-11,Brazil,NA,Tocantins,1550194,758,11,58655,784
2020-09-12,Brazil,NA,Tocantins,1550194,740,15,59395,799
2020-09-13,Brazil,NA,Tocantins,1550194,327,7,59722,806
2020-09-14,Brazil,NA,Tocantins,1550194,313,8,60035,814
2020-09-15,Brazil,NA,Tocantins,1550194,690,8,60725,822
2020-09-16,Brazil,NA,Tocantins,1550194,546,9,61271,831
2020-09-17,Brazil,NA,Tocantins,1550194,412,9,61683,840
2020-09-18,Brazil,NA,Tocantins,1550194,815,10,62498,850
2020-09-19,Brazil,NA,Tocantins,1550194,669,16,63167,866
2020-09-20,Brazil,NA,Tocantins,1550194,256,0,63423,866
2020-09-21,Brazil,NA,Tocantins,1550194,121,1,63544,867
2020-09-22,Brazil,NA,Tocantins,1550194,729,10,64273,877
2020-09-23,Brazil,NA,Tocantins,1550194,514,13,64787,890
2020-03-10,Canada,NA,Alberta,4067175,0,0,14,0
2020-03-11,Canada,NA,Alberta,4067175,0,0,14,0
2020-03-12,Canada,NA,Alberta,4067175,5,0,19,0
2020-03-13,Canada,NA,Alberta,4067175,4,0,23,0
2020-03-14,Canada,NA,Alberta,4067175,6,0,29,0
2020-03-15,Canada,NA,Alberta,4067175,10,0,39,0
2020-03-16,Canada,NA,Alberta,4067175,17,0,56,0
2020-03-17,Canada,NA,Alberta,4067175,18,0,74,0
2020-03-18,Canada,NA,Alberta,4067175,23,0,97,0
2020-03-19,Canada,NA,Alberta,4067175,49,1,146,1
2020-03-20,Canada,NA,Alberta,4067175,49,0,195,1
2020-03-21,Canada,NA,Alberta,4067175,31,0,226,1
2020-03-22,Canada,NA,Alberta,4067175,33,0,259,1
2020-03-23,Canada,NA,Alberta,4067175,42,0,301,1
2020-03-24,Canada,NA,Alberta,4067175,57,1,358,2
2020-03-25,Canada,NA,Alberta,4067175,61,0,419,2
2020-03-26,Canada,NA,Alberta,4067175,67,0,486,2
2020-03-27,Canada,NA,Alberta,4067175,56,0,542,2
2020-03-28,Canada,NA,Alberta,4067175,0,0,542,2
2020-03-29,Canada,NA,Alberta,4067175,79,0,621,2
2020-03-30,Canada,NA,Alberta,4067175,69,6,690,8
2020-03-31,Canada,NA,Alberta,4067175,64,1,754,9
2020-04-01,Canada,NA,Alberta,4067175,0,0,754,9
2020-04-02,Canada,NA,Alberta,4067175,214,4,968,13
2020-04-03,Canada,NA,Alberta,4067175,107,5,1075,18
2020-04-04,Canada,NA,Alberta,4067175,0,0,1075,18
2020-04-05,Canada,NA,Alberta,4067175,175,5,1250,23
2020-04-06,Canada,NA,Alberta,4067175,98,1,1348,24
2020-04-07,Canada,NA,Alberta,4067175,25,2,1373,26
2020-04-08,Canada,NA,Alberta,4067175,50,3,1423,29
2020-04-09,Canada,NA,Alberta,4067175,28,3,1451,32
2020-04-10,Canada,NA,Alberta,4067175,49,7,1500,39
2020-04-11,Canada,NA,Alberta,4067175,69,1,1569,40
2020-04-12,Canada,NA,Alberta,4067175,82,4,1651,44
2020-04-13,Canada,NA,Alberta,4067175,81,2,1732,46
2020-04-14,Canada,NA,Alberta,4067175,138,2,1870,48
2020-04-15,Canada,NA,Alberta,4067175,126,0,1996,48
2020-04-16,Canada,NA,Alberta,4067175,162,2,2158,50
2020-04-17,Canada,NA,Alberta,4067175,239,0,2397,50
2020-04-18,Canada,NA,Alberta,4067175,165,1,2562,51
2020-04-19,Canada,NA,Alberta,4067175,0,0,2562,51
2020-04-20,Canada,NA,Alberta,4067175,346,8,2908,59
2020-04-21,Canada,NA,Alberta,4067175,187,2,3095,61
2020-04-22,Canada,NA,Alberta,4067175,306,5,3401,66
2020-04-23,Canada,NA,Alberta,4067175,319,1,3720,67
2020-04-24,Canada,NA,Alberta,4067175,297,5,4017,72
2020-04-25,Canada,NA,Alberta,4067175,216,1,4233,73
2020-04-26,Canada,NA,Alberta,4067175,247,0,4480,73
2020-04-27,Canada,NA,Alberta,4067175,216,2,4696,75
2020-04-28,Canada,NA,Alberta,4067175,154,5,4850,80
2020-04-29,Canada,NA,Alberta,4067175,315,7,5165,87
2020-04-30,Canada,NA,Alberta,4067175,190,2,5355,89
2020-05-01,Canada,NA,Alberta,4067175,218,3,5573,92
2020-05-02,Canada,NA,Alberta,4067175,97,2,5670,94
2020-05-03,Canada,NA,Alberta,4067175,96,1,5766,95
2020-05-04,Canada,NA,Alberta,4067175,70,9,5836,104
2020-05-05,Canada,NA,Alberta,4067175,57,2,5893,106
2020-05-06,Canada,NA,Alberta,4067175,70,6,5963,112
2020-05-07,Canada,NA,Alberta,4067175,54,2,6017,114
2020-05-08,Canada,NA,Alberta,4067175,81,1,6098,115
2020-05-09,Canada,NA,Alberta,4067175,59,1,6157,116
2020-05-10,Canada,NA,Alberta,4067175,96,1,6253,117
2020-05-11,Canada,NA,Alberta,4067175,47,0,6300,117
2020-05-12,Canada,NA,Alberta,4067175,45,1,6345,118
2020-05-13,Canada,NA,Alberta,4067175,62,2,6407,120
2020-05-14,Canada,NA,Alberta,4067175,50,1,6457,121
2020-05-15,Canada,NA,Alberta,4067175,58,4,6515,125
2020-05-16,Canada,NA,Alberta,4067175,72,1,6587,126
2020-05-17,Canada,NA,Alberta,4067175,57,1,6644,127
2020-05-18,Canada,NA,Alberta,4067175,39,1,6683,128
2020-05-19,Canada,NA,Alberta,4067175,33,0,6716,128
2020-05-20,Canada,NA,Alberta,4067175,0,0,6716,128
2020-05-21,Canada,NA,Alberta,4067175,52,4,6768,132
2020-05-22,Canada,NA,Alberta,4067175,32,2,6800,134
2020-05-23,Canada,NA,Alberta,4067175,18,1,6818,135
2020-05-24,Canada,NA,Alberta,4067175,42,0,6860,135
2020-05-25,Canada,NA,Alberta,4067175,19,3,6879,138
2020-05-26,Canada,NA,Alberta,4067175,22,1,6901,139
2020-05-27,Canada,NA,Alberta,4067175,25,2,6926,141
2020-05-28,Canada,NA,Alberta,4067175,29,2,6955,143
2020-05-29,Canada,NA,Alberta,4067175,24,0,6979,143
2020-05-30,Canada,NA,Alberta,4067175,13,0,6992,143
2020-05-31,Canada,NA,Alberta,4067175,18,0,7010,143
2020-06-01,Canada,NA,Alberta,4067175,34,0,7044,143
2020-06-02,Canada,NA,Alberta,4067175,13,0,7057,143
2020-06-03,Canada,NA,Alberta,4067175,19,2,7076,145
2020-06-04,Canada,NA,Alberta,4067175,15,1,7091,146
2020-06-05,Canada,NA,Alberta,4067175,7,0,7098,146
2020-06-06,Canada,NA,Alberta,4067175,40,0,7138,146
2020-06-07,Canada,NA,Alberta,4067175,0,0,7138,146
2020-06-08,Canada,NA,Alberta,4067175,64,3,7202,149
2020-06-09,Canada,NA,Alberta,4067175,27,2,7229,151
2020-06-10,Canada,NA,Alberta,4067175,47,0,7276,151
2020-06-11,Canada,NA,Alberta,4067175,40,0,7316,151
2020-06-12,Canada,NA,Alberta,4067175,30,0,7346,151
2020-06-13,Canada,NA,Alberta,4067175,37,1,7383,151
2020-06-14,Canada,NA,Alberta,4067175,50,0,7433,151
2020-06-15,Canada,NA,Alberta,4067175,20,1,7453,151
2020-06-16,Canada,NA,Alberta,4067175,29,0,7482,151
2020-06-17,Canada,NA,Alberta,4067175,48,0,7530,151
2020-06-18,Canada,NA,Alberta,4067175,49,1,7579,152
2020-06-19,Canada,NA,Alberta,4067175,46,0,7625,152
2020-06-20,Canada,NA,Alberta,4067175,48,0,7673,152
2020-06-21,Canada,NA,Alberta,4067175,31,0,7704,152
2020-06-22,Canada,NA,Alberta,4067175,32,1,7736,153
2020-06-23,Canada,NA,Alberta,4067175,45,0,7781,153
2020-06-24,Canada,NA,Alberta,4067175,44,0,7825,153
2020-06-25,Canada,NA,Alberta,4067175,26,1,7851,154
2020-06-26,Canada,NA,Alberta,4067175,37,0,7888,154
2020-06-27,Canada,NA,Alberta,4067175,69,0,7957,154
2020-06-28,Canada,NA,Alberta,4067175,39,0,7996,154
2020-06-29,Canada,NA,Alberta,4067175,71,0,8067,154
2020-06-30,Canada,NA,Alberta,4067175,41,0,8108,154
2020-07-01,Canada,NA,Alberta,4067175,0,0,8108,154
2020-07-02,Canada,NA,Alberta,4067175,94,1,8202,155
2020-07-03,Canada,NA,Alberta,4067175,57,0,8259,155
2020-07-04,Canada,NA,Alberta,4067175,0,0,8259,155
2020-07-05,Canada,NA,Alberta,4067175,0,0,8259,155
2020-07-06,Canada,NA,Alberta,4067175,130,0,8389,155
2020-07-07,Canada,NA,Alberta,4067175,47,2,8436,157
2020-07-08,Canada,NA,Alberta,4067175,46,1,8482,158
2020-07-09,Canada,NA,Alberta,4067175,37,3,8519,161
2020-07-10,Canada,NA,Alberta,4067175,77,0,8596,161
2020-07-11,Canada,NA,Alberta,4067175,0,0,8596,161
2020-07-12,Canada,NA,Alberta,4067175,0,0,8596,161
2020-07-13,Canada,NA,Alberta,4067175,230,1,8826,161
2020-07-14,Canada,NA,Alberta,4067175,86,2,8912,163
2020-07-15,Canada,NA,Alberta,4067175,82,0,8994,163
2020-07-16,Canada,NA,Alberta,4067175,120,2,9114,165
2020-07-17,Canada,NA,Alberta,4067175,105,2,9219,167
2020-07-18,Canada,NA,Alberta,4067175,0,0,9219,167
2020-07-19,Canada,NA,Alberta,4067175,0,0,9219,167
2020-07-20,Canada,NA,Alberta,4067175,368,3,9587,170
2020-07-21,Canada,NA,Alberta,4067175,141,2,9728,172
2020-07-22,Canada,NA,Alberta,4067175,133,2,9861,174
2020-07-23,Canada,NA,Alberta,4067175,114,2,9975,176
2020-07-24,Canada,NA,Alberta,4067175,111,2,10086,178
2020-07-25,Canada,NA,Alberta,4067175,0,0,10086,178
2020-07-26,Canada,NA,Alberta,4067175,0,0,10086,178
2020-07-27,Canada,NA,Alberta,4067175,304,8,10390,186
2020-07-28,Canada,NA,Alberta,4067175,80,1,10470,187
2020-07-29,Canada,NA,Alberta,4067175,133,3,10603,190
2020-07-30,Canada,NA,Alberta,4067175,113,5,10716,195
2020-07-31,Canada,NA,Alberta,4067175,127,1,10843,196
2020-08-01,Canada,NA,Alberta,4067175,0,0,10843,196
2020-08-02,Canada,NA,Alberta,4067175,0,0,10843,196
2020-08-03,Canada,NA,Alberta,4067175,0,0,10843,196
2020-08-04,Canada,NA,Alberta,4067175,303,5,11146,201
2020-08-05,Canada,NA,Alberta,4067175,94,2,11240,203
2020-08-06,Canada,NA,Alberta,4067175,56,2,11296,205
2020-08-07,Canada,NA,Alberta,4067175,134,3,11430,208
2020-08-08,Canada,NA,Alberta,4067175,0,0,11430,208
2020-08-09,Canada,NA,Alberta,4067175,0,0,11430,208
2020-08-10,Canada,NA,Alberta,4067175,257,5,11687,213
2020-08-11,Canada,NA,Alberta,4067175,85,3,11772,216
2020-08-12,Canada,NA,Alberta,4067175,121,1,11893,217
2020-08-13,Canada,NA,Alberta,4067175,76,3,11969,220
2020-08-14,Canada,NA,Alberta,4067175,84,1,12053,221
2020-08-15,Canada,NA,Alberta,4067175,0,0,12053,221
2020-08-16,Canada,NA,Alberta,4067175,0,0,12053,221
2020-08-17,Canada,NA,Alberta,4067175,359,3,12412,224
2020-08-18,Canada,NA,Alberta,4067175,7,1,12419,225
2020-08-19,Canada,NA,Alberta,4067175,82,2,12501,227
2020-08-20,Canada,NA,Alberta,4067175,103,1,12604,228
2020-08-21,Canada,NA,Alberta,4067175,144,2,12748,230
2020-08-22,Canada,NA,Alberta,4067175,0,0,12748,230
2020-08-23,Canada,NA,Alberta,4067175,0,0,12748,230
2020-08-24,Canada,NA,Alberta,4067175,258,4,13006,234
2020-08-25,Canada,NA,Alberta,4067175,77,1,13083,235
2020-08-26,Canada,NA,Alberta,4067175,127,0,13210,235
2020-08-27,Canada,NA,Alberta,4067175,108,2,13318,237
2020-08-28,Canada,NA,Alberta,4067175,158,0,13476,237
2020-08-29,Canada,NA,Alberta,4067175,0,0,13476,237
2020-08-30,Canada,NA,Alberta,4067175,0,0,13476,237
2020-08-31,Canada,NA,Alberta,4067175,426,2,13902,239
2020-09-01,Canada,NA,Alberta,4067175,164,2,14066,241
2020-09-02,Canada,NA,Alberta,4067175,114,1,14180,242
2020-09-03,Canada,NA,Alberta,4067175,130,0,14310,242
2020-09-04,Canada,NA,Alberta,4067175,164,0,14474,242
2020-09-05,Canada,NA,Alberta,4067175,0,0,14474,242
2020-09-06,Canada,NA,Alberta,4067175,0,0,14474,242
2020-09-07,Canada,NA,Alberta,4067175,0,0,14474,242
2020-09-08,Canada,NA,Alberta,4067175,619,5,15093,247
2020-09-09,Canada,NA,Alberta,4067175,98,1,15191,248
2020-09-10,Canada,NA,Alberta,4067175,113,5,15304,253
2020-09-11,Canada,NA,Alberta,4067175,111,0,15415,253
2020-09-12,Canada,NA,Alberta,4067175,0,0,15415,253
2020-09-13,Canada,NA,Alberta,4067175,0,0,15415,253
2020-09-14,Canada,NA,Alberta,4067175,418,1,15833,254
2020-09-15,Canada,NA,Alberta,4067175,124,0,15957,254
2020-09-16,Canada,NA,Alberta,4067175,171,0,16128,254
2020-09-17,Canada,NA,Alberta,4067175,146,0,16274,254
2020-09-18,Canada,NA,Alberta,4067175,107,1,16381,255
2020-09-19,Canada,NA,Alberta,4067175,0,0,16381,255
2020-09-20,Canada,NA,Alberta,4067175,0,0,16381,255
2020-09-21,Canada,NA,Alberta,4067175,358,1,16739,256
2020-09-22,Canada,NA,Alberta,4067175,150,2,16889,258
2020-09-23,Canada,NA,Alberta,4067175,143,2,17032,260
2020-03-03,Canada,NA,British Columbia,4841078,4,0,12,0
2020-03-04,Canada,NA,British Columbia,4841078,1,0,13,0
2020-03-05,Canada,NA,British Columbia,4841078,9,0,21,0
2020-03-06,Canada,NA,British Columbia,4841078,0,0,21,0
2020-03-07,Canada,NA,British Columbia,4841078,6,0,27,0
2020-03-08,Canada,NA,British Columbia,4841078,0,1,27,1
2020-03-09,Canada,NA,British Columbia,4841078,5,0,32,1
2020-03-10,Canada,NA,British Columbia,4841078,7,0,39,1
2020-03-11,Canada,NA,British Columbia,4841078,0,0,39,1
2020-03-12,Canada,NA,British Columbia,4841078,7,0,46,1
2020-03-13,Canada,NA,British Columbia,4841078,7,0,53,1
2020-03-14,Canada,NA,British Columbia,4841078,11,0,64,1
2020-03-15,Canada,NA,British Columbia,4841078,9,0,73,1
2020-03-16,Canada,NA,British Columbia,4841078,0,3,73,4
2020-03-17,Canada,NA,British Columbia,4841078,30,3,103,7
2020-03-18,Canada,NA,British Columbia,4841078,83,0,186,7
2020-03-19,Canada,NA,British Columbia,4841078,85,1,271,8
2020-03-20,Canada,NA,British Columbia,4841078,0,1,271,9
2020-03-21,Canada,NA,British Columbia,4841078,153,1,424,10
2020-03-22,Canada,NA,British Columbia,4841078,0,0,424,10
2020-03-23,Canada,NA,British Columbia,4841078,48,3,472,13
2020-03-24,Canada,NA,British Columbia,4841078,145,0,617,13
2020-03-25,Canada,NA,British Columbia,4841078,42,1,659,14
2020-03-26,Canada,NA,British Columbia,4841078,66,0,725,14
2020-03-27,Canada,NA,British Columbia,4841078,0,0,725,14
2020-03-28,Canada,NA,British Columbia,4841078,159,2,884,16
2020-03-29,Canada,NA,British Columbia,4841078,0,1,884,17
2020-03-30,Canada,NA,British Columbia,4841078,76,2,960,19
2020-03-31,Canada,NA,British Columbia,4841078,10,0,970,19
2020-04-01,Canada,NA,British Columbia,4841078,96,6,1066,25
2020-04-02,Canada,NA,British Columbia,4841078,55,6,1121,31
2020-04-03,Canada,NA,British Columbia,4841078,53,4,1174,35
2020-04-04,Canada,NA,British Columbia,4841078,29,3,1203,38
2020-04-05,Canada,NA,British Columbia,4841078,0,0,1203,38
2020-04-06,Canada,NA,British Columbia,4841078,63,1,1266,39
2020-04-07,Canada,NA,British Columbia,4841078,25,4,1291,43
2020-04-08,Canada,NA,British Columbia,4841078,45,5,1336,48
2020-04-09,Canada,NA,British Columbia,4841078,34,2,1370,50
2020-04-10,Canada,NA,British Columbia,4841078,40,5,1410,55
2020-04-11,Canada,NA,British Columbia,4841078,35,3,1445,58
2020-04-12,Canada,NA,British Columbia,4841078,0,0,1445,58
2020-04-13,Canada,NA,British Columbia,4841078,45,11,1490,69
2020-04-14,Canada,NA,British Columbia,4841078,27,3,1517,72
2020-04-15,Canada,NA,British Columbia,4841078,44,3,1561,75
2020-04-16,Canada,NA,British Columbia,4841078,0,0,1561,75
2020-04-17,Canada,NA,British Columbia,4841078,14,2,1575,77
2020-04-18,Canada,NA,British Columbia,4841078,43,1,1618,78
2020-04-19,Canada,NA,British Columbia,4841078,0,0,1618,78
2020-04-20,Canada,NA,British Columbia,4841078,81,8,1699,86
2020-04-21,Canada,NA,British Columbia,4841078,25,1,1724,87
2020-04-22,Canada,NA,British Columbia,4841078,71,3,1795,90
2020-04-23,Canada,NA,British Columbia,4841078,29,4,1824,94
2020-04-24,Canada,NA,British Columbia,4841078,29,4,1853,98
2020-04-25,Canada,NA,British Columbia,4841078,95,2,1948,100
2020-04-26,Canada,NA,British Columbia,4841078,0,0,1948,100
2020-04-27,Canada,NA,British Columbia,4841078,50,3,1998,103
2020-04-28,Canada,NA,British Columbia,4841078,55,2,2053,105
2020-04-29,Canada,NA,British Columbia,4841078,34,4,2087,109
2020-04-30,Canada,NA,British Columbia,4841078,25,2,2112,111
2020-05-01,Canada,NA,British Columbia,4841078,33,1,2145,112
2020-05-02,Canada,NA,British Columbia,4841078,26,2,2171,114
2020-05-03,Canada,NA,British Columbia,4841078,0,0,2171,114
2020-05-04,Canada,NA,British Columbia,4841078,53,3,2224,117
2020-05-05,Canada,NA,British Columbia,4841078,8,4,2232,121
2020-05-06,Canada,NA,British Columbia,4841078,23,3,2255,124
2020-05-07,Canada,NA,British Columbia,4841078,33,2,2288,126
2020-05-08,Canada,NA,British Columbia,4841078,27,1,2315,127
2020-05-09,Canada,NA,British Columbia,4841078,15,2,2330,129
2020-05-10,Canada,NA,British Columbia,4841078,0,0,2330,129
2020-05-11,Canada,NA,British Columbia,4841078,23,1,2353,130
2020-05-12,Canada,NA,British Columbia,4841078,7,1,2360,131
2020-05-13,Canada,NA,British Columbia,4841078,16,1,2376,132
2020-05-14,Canada,NA,British Columbia,4841078,16,3,2392,135
2020-05-15,Canada,NA,British Columbia,4841078,15,5,2407,140
2020-05-16,Canada,NA,British Columbia,4841078,21,1,2428,141
2020-05-17,Canada,NA,British Columbia,4841078,0,0,2428,141
2020-05-18,Canada,NA,British Columbia,4841078,16,2,2444,143
2020-05-19,Canada,NA,British Columbia,4841078,2,3,2446,146
2020-05-20,Canada,NA,British Columbia,4841078,21,3,2467,149
2020-05-21,Canada,NA,British Columbia,4841078,12,3,2479,152
2020-05-22,Canada,NA,British Columbia,4841078,28,3,2507,155
2020-05-23,Canada,NA,British Columbia,4841078,10,2,2517,157
2020-05-24,Canada,NA,British Columbia,4841078,0,0,2517,157
2020-05-25,Canada,NA,British Columbia,4841078,13,4,2530,161
2020-05-26,Canada,NA,British Columbia,4841078,11,0,2541,161
2020-05-27,Canada,NA,British Columbia,4841078,9,1,2550,162
2020-05-28,Canada,NA,British Columbia,4841078,8,2,2558,164
2020-05-29,Canada,NA,British Columbia,4841078,4,0,2562,164
2020-05-30,Canada,NA,British Columbia,4841078,11,0,2573,164
2020-05-31,Canada,NA,British Columbia,4841078,0,0,2573,164
2020-06-01,Canada,NA,British Columbia,4841078,24,1,2597,165
2020-06-02,Canada,NA,British Columbia,4841078,4,0,2601,165
2020-06-03,Canada,NA,British Columbia,4841078,22,1,2623,166
2020-06-04,Canada,NA,British Columbia,4841078,9,0,2632,166
2020-06-05,Canada,NA,British Columbia,4841078,0,1,2632,167
2020-06-06,Canada,NA,British Columbia,4841078,0,0,2632,167
2020-06-07,Canada,NA,British Columbia,4841078,0,0,2632,167
2020-06-08,Canada,NA,British Columbia,4841078,27,0,2659,167
2020-06-09,Canada,NA,British Columbia,4841078,10,0,2669,167
2020-06-10,Canada,NA,British Columbia,4841078,11,0,2680,167
2020-06-11,Canada,NA,British Columbia,4841078,14,0,2694,167
2020-06-12,Canada,NA,British Columbia,4841078,15,1,2709,168
2020-06-13,Canada,NA,British Columbia,4841078,0,0,2709,168
2020-06-14,Canada,NA,British Columbia,4841078,0,0,2709,168
2020-06-15,Canada,NA,British Columbia,4841078,36,0,2745,168
2020-06-16,Canada,NA,British Columbia,4841078,11,0,2756,168
2020-06-17,Canada,NA,British Columbia,4841078,19,0,2775,168
2020-06-18,Canada,NA,British Columbia,4841078,8,0,2783,168
2020-06-19,Canada,NA,British Columbia,4841078,7,0,2790,168
2020-06-20,Canada,NA,British Columbia,4841078,0,0,2790,168
2020-06-21,Canada,NA,British Columbia,4841078,0,0,2790,168
2020-06-22,Canada,NA,British Columbia,4841078,32,1,2822,169
2020-06-23,Canada,NA,British Columbia,4841078,13,1,2835,170
2020-06-24,Canada,NA,British Columbia,4841078,14,1,2849,171
2020-06-25,Canada,NA,British Columbia,4841078,20,2,2869,173
2020-06-26,Canada,NA,British Columbia,4841078,9,1,2878,174
2020-06-27,Canada,NA,British Columbia,4841078,0,0,2878,174
2020-06-28,Canada,NA,British Columbia,4841078,0,0,2878,174
2020-06-29,Canada,NA,British Columbia,4841078,26,0,2904,174
2020-06-30,Canada,NA,British Columbia,4841078,12,0,2916,174
2020-07-01,Canada,NA,British Columbia,4841078,0,0,2916,174
2020-07-02,Canada,NA,British Columbia,4841078,24,3,2940,177
2020-07-03,Canada,NA,British Columbia,4841078,7,0,2947,177
2020-07-04,Canada,NA,British Columbia,4841078,0,0,2947,177
2020-07-05,Canada,NA,British Columbia,4841078,0,0,2947,177
2020-07-06,Canada,NA,British Columbia,4841078,31,6,2978,183
2020-07-07,Canada,NA,British Columbia,4841078,12,0,2990,183
2020-07-08,Canada,NA,British Columbia,4841078,18,3,3008,186
2020-07-09,Canada,NA,British Columbia,4841078,20,0,3028,186
2020-07-10,Canada,NA,British Columbia,4841078,25,1,3053,187
2020-07-11,Canada,NA,British Columbia,4841078,0,0,3053,187
2020-07-12,Canada,NA,British Columbia,4841078,0,0,3053,187
2020-07-13,Canada,NA,British Columbia,4841078,62,2,3115,189
2020-07-14,Canada,NA,British Columbia,4841078,13,0,3128,189
2020-07-15,Canada,NA,British Columbia,4841078,21,0,3149,189
2020-07-16,Canada,NA,British Columbia,4841078,21,0,3170,189
2020-07-17,Canada,NA,British Columbia,4841078,28,0,3198,189
2020-07-18,Canada,NA,British Columbia,4841078,0,0,3198,189
2020-07-19,Canada,NA,British Columbia,4841078,0,0,3198,189
2020-07-20,Canada,NA,British Columbia,4841078,102,0,3300,189
2020-07-21,Canada,NA,British Columbia,4841078,28,0,3328,189
2020-07-22,Canada,NA,British Columbia,4841078,34,0,3362,189
2020-07-23,Canada,NA,British Columbia,4841078,30,1,3392,190
2020-07-24,Canada,NA,British Columbia,4841078,27,1,3419,191
2020-07-25,Canada,NA,British Columbia,4841078,0,0,3419,191
2020-07-26,Canada,NA,British Columbia,4841078,0,0,3419,191
2020-07-27,Canada,NA,British Columbia,4841078,81,2,3500,193
2020-07-28,Canada,NA,British Columbia,4841078,23,1,3523,194
2020-07-29,Canada,NA,British Columbia,4841078,39,0,3562,194
2020-07-30,Canada,NA,British Columbia,4841078,29,0,3591,194
2020-07-31,Canada,NA,British Columbia,4841078,50,1,3641,195
2020-08-01,Canada,NA,British Columbia,4841078,0,0,3641,195
2020-08-02,Canada,NA,British Columbia,4841078,0,0,3641,195
2020-08-03,Canada,NA,British Columbia,4841078,0,0,3641,195
2020-08-04,Canada,NA,British Columbia,4841078,146,0,3787,195
2020-08-05,Canada,NA,British Columbia,4841078,47,0,3834,195
2020-08-06,Canada,NA,British Columbia,4841078,47,0,3881,195
2020-08-07,Canada,NA,British Columbia,4841078,53,0,3934,195
2020-08-08,Canada,NA,British Columbia,4841078,0,0,3934,195
2020-08-09,Canada,NA,British Columbia,4841078,0,0,3934,195
2020-08-10,Canada,NA,British Columbia,4841078,131,0,4065,195
2020-08-11,Canada,NA,British Columbia,4841078,46,0,4111,195
2020-08-12,Canada,NA,British Columbia,4841078,85,1,4196,196
2020-08-13,Canada,NA,British Columbia,4841078,78,0,4274,196
2020-08-14,Canada,NA,British Columbia,4841078,84,0,4358,196
2020-08-15,Canada,NA,British Columbia,4841078,0,0,4358,196
2020-08-16,Canada,NA,British Columbia,4841078,0,0,4358,196
2020-08-17,Canada,NA,British Columbia,4841078,236,2,4594,198
2020-08-18,Canada,NA,British Columbia,4841078,83,0,4677,198
2020-08-19,Canada,NA,British Columbia,4841078,68,0,4745,198
2020-08-20,Canada,NA,British Columbia,4841078,80,2,4825,200
2020-08-21,Canada,NA,British Columbia,4841078,90,2,4915,202
2020-08-22,Canada,NA,British Columbia,4841078,0,0,4915,202
2020-08-23,Canada,NA,British Columbia,4841078,0,0,4915,202
2020-08-24,Canada,NA,British Columbia,4841078,269,1,5184,203
2020-08-25,Canada,NA,British Columbia,4841078,58,0,5242,203
2020-08-26,Canada,NA,British Columbia,4841078,62,0,5304,203
2020-08-27,Canada,NA,British Columbia,4841078,68,1,5372,204
2020-08-28,Canada,NA,British Columbia,4841078,124,0,5496,204
2020-08-29,Canada,NA,British Columbia,4841078,0,0,5496,204
2020-08-30,Canada,NA,British Columbia,4841078,0,0,5496,204
2020-08-31,Canada,NA,British Columbia,4841078,294,4,5790,208
2020-09-01,Canada,NA,British Columbia,4841078,58,1,5848,209
2020-09-02,Canada,NA,British Columbia,4841078,104,0,5952,209
2020-09-03,Canada,NA,British Columbia,4841078,89,1,6041,210
2020-09-04,Canada,NA,British Columbia,4841078,121,1,6162,211
2020-09-05,Canada,NA,British Columbia,4841078,0,0,6162,211
2020-09-06,Canada,NA,British Columbia,4841078,0,0,6162,211
2020-09-07,Canada,NA,British Columbia,4841078,0,0,6162,211
2020-09-08,Canada,NA,British Columbia,4841078,429,2,6591,213
2020-09-09,Canada,NA,British Columbia,4841078,100,0,6691,213
2020-09-10,Canada,NA,British Columbia,4841078,139,0,6830,213
2020-09-11,Canada,NA,British Columbia,4841078,132,0,6962,213
2020-09-12,Canada,NA,British Columbia,4841078,0,0,6962,213
2020-09-13,Canada,NA,British Columbia,4841078,0,0,6962,213
2020-09-14,Canada,NA,British Columbia,4841078,317,6,7279,219
2020-09-15,Canada,NA,British Columbia,4841078,97,0,7376,219
2020-09-16,Canada,NA,British Columbia,4841078,122,0,7498,219
2020-09-17,Canada,NA,British Columbia,4841078,165,1,7663,220
2020-09-18,Canada,NA,British Columbia,4841078,179,3,7842,223
2020-09-19,Canada,NA,British Columbia,4841078,0,0,7842,223
2020-09-20,Canada,NA,British Columbia,4841078,0,0,7842,223
2020-09-21,Canada,NA,British Columbia,4841078,366,4,8208,227
2020-09-22,Canada,NA,British Columbia,4841078,96,0,8304,227
2020-09-23,Canada,NA,British Columbia,4841078,91,0,8395,227
2020-03-19,Canada,NA,Manitoba,1343371,2,0,17,0
2020-03-20,Canada,NA,Manitoba,1343371,0,0,17,0
2020-03-21,Canada,NA,Manitoba,1343371,2,0,17,0
2020-03-22,Canada,NA,Manitoba,1343371,0,0,17,0
2020-03-23,Canada,NA,Manitoba,1343371,1,0,17,0
2020-03-24,Canada,NA,Manitoba,1343371,1,0,17,0
2020-03-25,Canada,NA,Manitoba,1343371,14,0,17,0
2020-03-26,Canada,NA,Manitoba,1343371,1,0,17,0
2020-03-27,Canada,NA,Manitoba,1343371,3,1,25,1
2020-03-28,Canada,NA,Manitoba,1343371,25,0,25,1
2020-03-29,Canada,NA,Manitoba,1343371,8,0,69,1
2020-03-30,Canada,NA,Manitoba,1343371,24,0,83,1
2020-03-31,Canada,NA,Manitoba,1343371,7,0,91,1
2020-04-01,Canada,NA,Manitoba,1343371,24,0,109,1
2020-04-02,Canada,NA,Manitoba,1343371,40,0,152,1
2020-04-03,Canada,NA,Manitoba,1343371,15,1,164,2
2020-04-04,Canada,NA,Manitoba,1343371,12,0,172,2
2020-04-05,Canada,NA,Manitoba,1343371,9,0,187,2
2020-04-06,Canada,NA,Manitoba,1343371,1,0,190,2
2020-04-07,Canada,NA,Manitoba,1343371,13,1,203,3
2020-04-08,Canada,NA,Manitoba,1343371,4,0,206,3
2020-04-09,Canada,NA,Manitoba,1343371,3,0,207,3
2020-04-10,Canada,NA,Manitoba,1343371,6,1,215,4
2020-04-11,Canada,NA,Manitoba,1343371,13,0,226,4
2020-04-12,Canada,NA,Manitoba,1343371,0,0,226,4
2020-04-13,Canada,NA,Manitoba,1343371,4,0,229,4
2020-04-14,Canada,NA,Manitoba,1343371,0,0,229,4
2020-04-15,Canada,NA,Manitoba,1343371,0,1,231,5
2020-04-16,Canada,NA,Manitoba,1343371,4,0,239,5
2020-04-17,Canada,NA,Manitoba,1343371,0,0,239,5
2020-04-18,Canada,NA,Manitoba,1343371,3,0,243,5
2020-04-19,Canada,NA,Manitoba,1343371,0,0,245,5
2020-04-20,Canada,NA,Manitoba,1343371,1,1,246,6
2020-04-21,Canada,NA,Manitoba,1343371,1,0,246,6
2020-04-22,Canada,NA,Manitoba,1343371,2,0,246,6
2020-04-23,Canada,NA,Manitoba,1343371,5,0,251,6
2020-04-24,Canada,NA,Manitoba,1343371,1,0,252,6
2020-04-25,Canada,NA,Manitoba,1343371,4,0,256,6
2020-04-26,Canada,NA,Manitoba,1343371,4,0,260,6
2020-04-27,Canada,NA,Manitoba,1343371,1,0,261,6
2020-04-28,Canada,NA,Manitoba,1343371,0,0,261,6
2020-04-29,Canada,NA,Manitoba,1343371,1,0,263,6
2020-04-30,Canada,NA,Manitoba,1343371,2,0,264,6
2020-05-01,Canada,NA,Manitoba,1343371,4,0,268,6
2020-05-02,Canada,NA,Manitoba,1343371,1,0,269,6
2020-05-03,Canada,NA,Manitoba,1343371,1,0,270,6
2020-05-04,Canada,NA,Manitoba,1343371,0,0,270,6
2020-05-05,Canada,NA,Manitoba,1343371,1,1,271,7
2020-05-06,Canada,NA,Manitoba,1343371,2,0,273,7
2020-05-07,Canada,NA,Manitoba,1343371,0,0,273,7
2020-05-08,Canada,NA,Manitoba,1343371,1,0,273,7
2020-05-09,Canada,NA,Manitoba,1343371,0,0,273,7
2020-05-10,Canada,NA,Manitoba,1343371,3,0,276,7
2020-05-11,Canada,NA,Manitoba,1343371,2,0,278,7
2020-05-12,Canada,NA,Manitoba,1343371,1,0,279,7
2020-05-13,Canada,NA,Manitoba,1343371,0,0,279,7
2020-05-14,Canada,NA,Manitoba,1343371,0,0,279,7
2020-05-15,Canada,NA,Manitoba,1343371,0,0,279,7
2020-05-16,Canada,NA,Manitoba,1343371,0,0,279,7
2020-05-17,Canada,NA,Manitoba,1343371,0,0,279,7
2020-05-18,Canada,NA,Manitoba,1343371,1,0,279,7
2020-05-19,Canada,NA,Manitoba,1343371,0,0,279,7
2020-05-20,Canada,NA,Manitoba,1343371,0,0,279,7
2020-05-21,Canada,NA,Manitoba,1343371,0,0,279,7
2020-05-22,Canada,NA,Manitoba,1343371,2,0,281,7
2020-05-23,Canada,NA,Manitoba,1343371,0,0,281,7
2020-05-24,Canada,NA,Manitoba,1343371,0,0,281,7
2020-05-25,Canada,NA,Manitoba,1343371,0,0,281,7
2020-05-26,Canada,NA,Manitoba,1343371,0,0,281,7
2020-05-27,Canada,NA,Manitoba,1343371,0,0,281,7
2020-05-28,Canada,NA,Manitoba,1343371,2,0,283,7
2020-05-29,Canada,NA,Manitoba,1343371,0,0,283,7
2020-05-30,Canada,NA,Manitoba,1343371,0,0,283,7
2020-05-31,Canada,NA,Manitoba,1343371,1,0,284,7
2020-06-01,Canada,NA,Manitoba,1343371,0,0,284,7
2020-06-02,Canada,NA,Manitoba,1343371,2,0,286,7
2020-06-03,Canada,NA,Manitoba,1343371,1,0,287,7
2020-06-04,Canada,NA,Manitoba,1343371,0,0,287,7
2020-06-05,Canada,NA,Manitoba,1343371,2,0,289,7
2020-06-06,Canada,NA,Manitoba,1343371,0,0,289,7
2020-06-07,Canada,NA,Manitoba,1343371,0,0,289,7
2020-06-08,Canada,NA,Manitoba,1343371,0,0,289,7
2020-06-09,Canada,NA,Manitoba,1343371,0,0,289,7
2020-06-10,Canada,NA,Manitoba,1343371,0,0,289,7
2020-06-11,Canada,NA,Manitoba,1343371,0,0,289,7
2020-06-12,Canada,NA,Manitoba,1343371,1,0,290,7
2020-06-13,Canada,NA,Manitoba,1343371,2,0,292,7
2020-06-14,Canada,NA,Manitoba,1343371,1,0,293,7
2020-06-15,Canada,NA,Manitoba,1343371,0,0,293,7
2020-06-16,Canada,NA,Manitoba,1343371,0,0,293,7
2020-06-17,Canada,NA,Manitoba,1343371,2,0,295,7
2020-06-18,Canada,NA,Manitoba,1343371,2,0,297,7
2020-06-19,Canada,NA,Manitoba,1343371,3,0,300,7
2020-06-20,Canada,NA,Manitoba,1343371,2,0,302,7
2020-06-21,Canada,NA,Manitoba,1343371,0,0,302,7
2020-06-22,Canada,NA,Manitoba,1343371,1,0,303,7
2020-06-23,Canada,NA,Manitoba,1343371,0,0,303,7
2020-06-24,Canada,NA,Manitoba,1343371,1,0,304,7
2020-06-25,Canada,NA,Manitoba,1343371,1,0,305,7
2020-06-26,Canada,NA,Manitoba,1343371,2,0,307,7
2020-06-27,Canada,NA,Manitoba,1343371,4,0,311,7
2020-06-28,Canada,NA,Manitoba,1343371,0,0,311,7
2020-06-29,Canada,NA,Manitoba,1343371,2,0,313,7
2020-06-30,Canada,NA,Manitoba,1343371,1,0,314,7
2020-07-01,Canada,NA,Manitoba,1343371,0,0,314,7
2020-07-02,Canada,NA,Manitoba,1343371,0,0,314,7
2020-07-03,Canada,NA,Manitoba,1343371,0,0,314,7
2020-07-04,Canada,NA,Manitoba,1343371,0,0,314,7
2020-07-05,Canada,NA,Manitoba,1343371,0,0,314,7
2020-07-06,Canada,NA,Manitoba,1343371,0,0,314,7
2020-07-07,Canada,NA,Manitoba,1343371,0,0,314,7
2020-07-08,Canada,NA,Manitoba,1343371,0,0,314,7
2020-07-09,Canada,NA,Manitoba,1343371,0,0,314,7
2020-07-10,Canada,NA,Manitoba,1343371,0,0,314,7
2020-07-11,Canada,NA,Manitoba,1343371,0,0,314,7
2020-07-12,Canada,NA,Manitoba,1343371,0,0,314,7
2020-07-13,Canada,NA,Manitoba,1343371,0,0,314,7
2020-07-14,Canada,NA,Manitoba,1343371,5,0,319,7
2020-07-15,Canada,NA,Manitoba,1343371,0,0,319,7
2020-07-16,Canada,NA,Manitoba,1343371,1,0,320,7
2020-07-17,Canada,NA,Manitoba,1343371,5,0,325,7
2020-07-18,Canada,NA,Manitoba,1343371,1,0,326,7
2020-07-19,Canada,NA,Manitoba,1343371,6,0,332,7
2020-07-20,Canada,NA,Manitoba,1343371,11,0,343,7
2020-07-21,Canada,NA,Manitoba,1343371,12,0,353,7
2020-07-22,Canada,NA,Manitoba,1343371,8,0,361,7
2020-07-23,Canada,NA,Manitoba,1343371,1,0,362,7
2020-07-24,Canada,NA,Manitoba,1343371,9,0,371,7
2020-07-25,Canada,NA,Manitoba,1343371,4,0,375,7
2020-07-26,Canada,NA,Manitoba,1343371,6,0,381,7
2020-07-27,Canada,NA,Manitoba,1343371,6,0,387,7
2020-07-28,Canada,NA,Manitoba,1343371,5,1,391,8
2020-07-29,Canada,NA,Manitoba,1343371,2,0,393,8
2020-07-30,Canada,NA,Manitoba,1343371,2,0,395,8
2020-07-31,Canada,NA,Manitoba,1343371,6,0,401,8
2020-08-01,Canada,NA,Manitoba,1343371,2,0,403,8
2020-08-02,Canada,NA,Manitoba,1343371,18,0,421,8
2020-08-03,Canada,NA,Manitoba,1343371,7,0,428,8
2020-08-04,Canada,NA,Manitoba,1343371,1,0,428,8
2020-08-05,Canada,NA,Manitoba,1343371,1,0,429,8
2020-08-06,Canada,NA,Manitoba,1343371,30,0,459,8
2020-08-07,Canada,NA,Manitoba,1343371,17,0,476,8
2020-08-08,Canada,NA,Manitoba,1343371,16,0,492,8
2020-08-09,Canada,NA,Manitoba,1343371,35,0,527,8
2020-08-10,Canada,NA,Manitoba,1343371,16,0,543,8
2020-08-11,Canada,NA,Manitoba,1343371,4,0,547,8
2020-08-12,Canada,NA,Manitoba,1343371,16,0,563,8
2020-08-13,Canada,NA,Manitoba,1343371,25,0,603,8
2020-08-14,Canada,NA,Manitoba,1343371,40,0,643,8
2020-08-15,Canada,NA,Manitoba,1343371,20,1,663,9
2020-08-16,Canada,NA,Manitoba,1343371,34,0,697,9
2020-08-17,Canada,NA,Manitoba,1343371,34,0,731,9
2020-08-18,Canada,NA,Manitoba,1343371,17,2,748,11
2020-08-19,Canada,NA,Manitoba,1343371,15,1,763,12
2020-08-20,Canada,NA,Manitoba,1343371,33,0,796,12
2020-08-21,Canada,NA,Manitoba,1343371,34,0,830,12
2020-08-22,Canada,NA,Manitoba,1343371,42,0,872,12
2020-08-23,Canada,NA,Manitoba,1343371,72,0,944,12
2020-08-24,Canada,NA,Manitoba,1343371,49,0,993,12
2020-08-25,Canada,NA,Manitoba,1343371,25,1,1018,13
2020-08-26,Canada,NA,Manitoba,1343371,25,0,1043,13
2020-08-27,Canada,NA,Manitoba,1343371,21,1,1064,14
2020-08-28,Canada,NA,Manitoba,1343371,32,0,1096,14
2020-08-29,Canada,NA,Manitoba,1343371,55,0,1151,14
2020-08-30,Canada,NA,Manitoba,1343371,35,0,1186,14
2020-08-31,Canada,NA,Manitoba,1343371,28,0,1214,14
2020-09-01,Canada,NA,Manitoba,1343371,18,0,1232,14
2020-09-02,Canada,NA,Manitoba,1343371,12,0,1244,14
2020-09-03,Canada,NA,Manitoba,1343371,20,2,1264,16
2020-09-04,Canada,NA,Manitoba,1343371,9,0,1273,16
2020-09-05,Canada,NA,Manitoba,1343371,21,0,1294,16
2020-09-06,Canada,NA,Manitoba,1343371,29,0,1323,16
2020-09-07,Canada,NA,Manitoba,1343371,15,0,1338,16
2020-09-08,Canada,NA,Manitoba,1343371,11,0,1349,16
2020-09-09,Canada,NA,Manitoba,1343371,16,0,1365,16
2020-09-10,Canada,NA,Manitoba,1343371,13,0,1378,16
2020-09-11,Canada,NA,Manitoba,1343371,15,0,1393,16
2020-09-12,Canada,NA,Manitoba,1343371,17,0,1410,16
2020-09-13,Canada,NA,Manitoba,1343371,18,0,1428,16
2020-09-14,Canada,NA,Manitoba,1343371,21,0,1449,16
2020-09-15,Canada,NA,Manitoba,1343371,17,0,1466,16
2020-09-16,Canada,NA,Manitoba,1343371,23,0,1489,16
2020-09-17,Canada,NA,Manitoba,1343371,11,0,1500,16
2020-09-18,Canada,NA,Manitoba,1343371,40,0,1540,16
2020-09-19,Canada,NA,Manitoba,1343371,18,0,1558,16
2020-09-20,Canada,NA,Manitoba,1343371,28,0,1586,16
2020-09-21,Canada,NA,Manitoba,1343371,22,2,1608,18
2020-09-22,Canada,NA,Manitoba,1343371,24,0,1632,18
2020-09-23,Canada,NA,Manitoba,1343371,42,0,1674,18
2020-03-22,Canada,NA,Nova Scotia,957600,7,0,28,0
2020-03-23,Canada,NA,Nova Scotia,957600,13,0,41,0
2020-03-24,Canada,NA,Nova Scotia,957600,10,0,51,0
2020-03-25,Canada,NA,Nova Scotia,957600,17,0,68,0
2020-03-26,Canada,NA,Nova Scotia,957600,5,0,73,0
2020-03-27,Canada,NA,Nova Scotia,957600,17,0,90,0
2020-03-28,Canada,NA,Nova Scotia,957600,20,0,110,0
2020-03-29,Canada,NA,Nova Scotia,957600,12,0,122,0
2020-03-30,Canada,NA,Nova Scotia,957600,5,0,127,0
2020-03-31,Canada,NA,Nova Scotia,957600,20,0,147,0
2020-04-01,Canada,NA,Nova Scotia,957600,26,0,173,0
2020-04-02,Canada,NA,Nova Scotia,957600,20,0,193,0
2020-04-03,Canada,NA,Nova Scotia,957600,14,0,207,0
2020-04-04,Canada,NA,Nova Scotia,957600,29,0,236,0
2020-04-05,Canada,NA,Nova Scotia,957600,26,0,262,0
2020-04-06,Canada,NA,Nova Scotia,957600,31,0,293,0
2020-04-07,Canada,NA,Nova Scotia,957600,17,0,310,0
2020-04-08,Canada,NA,Nova Scotia,957600,32,1,342,1
2020-04-09,Canada,NA,Nova Scotia,957600,31,1,373,2
2020-04-10,Canada,NA,Nova Scotia,957600,34,0,407,2
2020-04-11,Canada,NA,Nova Scotia,957600,21,0,428,2
2020-04-12,Canada,NA,Nova Scotia,957600,17,0,445,2
2020-04-13,Canada,NA,Nova Scotia,957600,29,1,474,3
2020-04-14,Canada,NA,Nova Scotia,957600,43,0,517,3
2020-04-15,Canada,NA,Nova Scotia,957600,32,0,549,3
2020-04-16,Canada,NA,Nova Scotia,957600,30,0,579,3
2020-04-17,Canada,NA,Nova Scotia,957600,27,1,606,4
2020-04-18,Canada,NA,Nova Scotia,957600,43,3,649,7
2020-04-19,Canada,NA,Nova Scotia,957600,26,2,675,9
2020-04-20,Canada,NA,Nova Scotia,957600,46,0,721,9
2020-04-21,Canada,NA,Nova Scotia,957600,16,1,737,10
2020-04-22,Canada,NA,Nova Scotia,957600,35,2,772,12
2020-04-23,Canada,NA,Nova Scotia,957600,55,4,827,16
2020-04-24,Canada,NA,Nova Scotia,957600,23,0,850,16
2020-04-25,Canada,NA,Nova Scotia,957600,15,6,865,22
2020-04-26,Canada,NA,Nova Scotia,957600,8,2,873,24
2020-04-27,Canada,NA,Nova Scotia,957600,27,0,900,24
2020-04-28,Canada,NA,Nova Scotia,957600,15,3,915,27
2020-04-29,Canada,NA,Nova Scotia,957600,20,1,935,28
2020-04-30,Canada,NA,Nova Scotia,957600,12,0,947,28
2020-05-01,Canada,NA,Nova Scotia,957600,12,1,959,29
2020-05-02,Canada,NA,Nova Scotia,957600,4,2,963,31
2020-05-03,Canada,NA,Nova Scotia,957600,8,6,971,37
2020-05-04,Canada,NA,Nova Scotia,957600,14,1,985,38
2020-05-05,Canada,NA,Nova Scotia,957600,6,3,991,41
2020-05-06,Canada,NA,Nova Scotia,957600,7,0,998,41
2020-05-07,Canada,NA,Nova Scotia,957600,9,3,1007,44
2020-05-08,Canada,NA,Nova Scotia,957600,1,2,1008,46
2020-05-09,Canada,NA,Nova Scotia,957600,3,1,1011,47
2020-05-10,Canada,NA,Nova Scotia,957600,7,0,1018,47
2020-05-11,Canada,NA,Nova Scotia,957600,1,1,1019,48
2020-05-12,Canada,NA,Nova Scotia,957600,1,0,1020,48
2020-05-13,Canada,NA,Nova Scotia,957600,4,3,1024,51
2020-05-14,Canada,NA,Nova Scotia,957600,2,0,1026,51
2020-05-15,Canada,NA,Nova Scotia,957600,8,4,1034,55
2020-05-16,Canada,NA,Nova Scotia,957600,3,0,1037,55
2020-05-17,Canada,NA,Nova Scotia,957600,3,0,1040,55
2020-05-18,Canada,NA,Nova Scotia,957600,3,0,1043,55
2020-05-19,Canada,NA,Nova Scotia,957600,1,1,1044,56
2020-05-20,Canada,NA,Nova Scotia,957600,1,1,1045,57
2020-05-21,Canada,NA,Nova Scotia,957600,1,1,1046,58
2020-05-22,Canada,NA,Nova Scotia,957600,2,0,1048,58
2020-05-23,Canada,NA,Nova Scotia,957600,1,0,1049,58
2020-05-24,Canada,NA,Nova Scotia,957600,1,0,1050,58
2020-05-25,Canada,NA,Nova Scotia,957600,1,0,1051,58
2020-05-26,Canada,NA,Nova Scotia,957600,1,1,1052,59
2020-05-27,Canada,NA,Nova Scotia,957600,1,0,1053,59
2020-05-28,Canada,NA,Nova Scotia,957600,2,0,1055,59
2020-05-29,Canada,NA,Nova Scotia,957600,0,0,1055,59
2020-05-30,Canada,NA,Nova Scotia,957600,1,1,1056,60
2020-05-31,Canada,NA,Nova Scotia,957600,0,0,1056,60
2020-06-01,Canada,NA,Nova Scotia,957600,1,0,1057,60
2020-06-02,Canada,NA,Nova Scotia,957600,0,0,1057,60
2020-06-03,Canada,NA,Nova Scotia,957600,1,0,1058,60
2020-06-04,Canada,NA,Nova Scotia,957600,0,1,1058,61
2020-06-05,Canada,NA,Nova Scotia,957600,0,0,1058,61
2020-06-06,Canada,NA,Nova Scotia,957600,0,0,1058,61
2020-06-07,Canada,NA,Nova Scotia,957600,1,0,1059,61
2020-06-08,Canada,NA,Nova Scotia,957600,0,0,1059,61
2020-06-09,Canada,NA,Nova Scotia,957600,1,1,1060,62
2020-06-10,Canada,NA,Nova Scotia,957600,1,0,1061,62
2020-06-11,Canada,NA,Nova Scotia,957600,0,0,1061,62
2020-06-12,Canada,NA,Nova Scotia,957600,0,0,1061,62
2020-06-13,Canada,NA,Nova Scotia,957600,0,0,1061,62
2020-06-14,Canada,NA,Nova Scotia,957600,0,0,1061,62
2020-06-15,Canada,NA,Nova Scotia,957600,0,0,1061,62
2020-06-16,Canada,NA,Nova Scotia,957600,0,0,1061,62
2020-06-17,Canada,NA,Nova Scotia,957600,0,0,1061,62
2020-06-18,Canada,NA,Nova Scotia,957600,0,0,1061,62
2020-06-19,Canada,NA,Nova Scotia,957600,0,0,1061,62
2020-06-20,Canada,NA,Nova Scotia,957600,0,0,1061,62
2020-06-21,Canada,NA,Nova Scotia,957600,0,0,1061,62
2020-06-22,Canada,NA,Nova Scotia,957600,0,1,1061,63
2020-06-23,Canada,NA,Nova Scotia,957600,0,0,1061,63
2020-06-24,Canada,NA,Nova Scotia,957600,0,0,1061,63
2020-06-25,Canada,NA,Nova Scotia,957600,0,0,1061,63
2020-06-26,Canada,NA,Nova Scotia,957600,0,0,1061,63
2020-06-27,Canada,NA,Nova Scotia,957600,0,0,1061,63
2020-06-28,Canada,NA,Nova Scotia,957600,0,0,1061,63
2020-06-29,Canada,NA,Nova Scotia,957600,0,0,1061,63
2020-06-30,Canada,NA,Nova Scotia,957600,1,0,1062,63
2020-07-01,Canada,NA,Nova Scotia,957600,0,0,1062,63
2020-07-02,Canada,NA,Nova Scotia,957600,2,0,1064,63
2020-07-03,Canada,NA,Nova Scotia,957600,0,0,1064,63
2020-07-04,Canada,NA,Nova Scotia,957600,0,0,1064,63
2020-07-05,Canada,NA,Nova Scotia,957600,0,0,1064,63
2020-07-06,Canada,NA,Nova Scotia,957600,1,0,1065,63
2020-07-07,Canada,NA,Nova Scotia,957600,0,0,1065,63
2020-07-08,Canada,NA,Nova Scotia,957600,1,0,1066,63
2020-07-09,Canada,NA,Nova Scotia,957600,0,0,1066,63
2020-07-10,Canada,NA,Nova Scotia,957600,0,0,1066,63
2020-07-11,Canada,NA,Nova Scotia,957600,0,0,1066,63
2020-07-12,Canada,NA,Nova Scotia,957600,0,0,1066,63
2020-07-13,Canada,NA,Nova Scotia,957600,0,0,1066,63
2020-07-14,Canada,NA,Nova Scotia,957600,0,0,1066,63
2020-07-15,Canada,NA,Nova Scotia,957600,1,0,1067,63
2020-07-16,Canada,NA,Nova Scotia,957600,0,0,1067,63
2020-07-17,Canada,NA,Nova Scotia,957600,0,0,1067,63
2020-07-18,Canada,NA,Nova Scotia,957600,0,0,1067,63
2020-07-19,Canada,NA,Nova Scotia,957600,0,0,1067,63
2020-07-20,Canada,NA,Nova Scotia,957600,0,0,1067,63
2020-07-21,Canada,NA,Nova Scotia,957600,0,0,1067,63
2020-07-22,Canada,NA,Nova Scotia,957600,0,0,1067,63
2020-07-23,Canada,NA,Nova Scotia,957600,0,0,1067,63
2020-07-24,Canada,NA,Nova Scotia,957600,0,0,1067,63
2020-07-25,Canada,NA,Nova Scotia,957600,0,0,1067,63
2020-07-26,Canada,NA,Nova Scotia,957600,0,0,1067,63
2020-07-27,Canada,NA,Nova Scotia,957600,0,0,1067,63
2020-07-28,Canada,NA,Nova Scotia,957600,0,0,1067,63
2020-07-29,Canada,NA,Nova Scotia,957600,0,1,1067,64
2020-07-30,Canada,NA,Nova Scotia,957600,0,0,1067,64
2020-07-31,Canada,NA,Nova Scotia,957600,2,0,1069,64
2020-08-01,Canada,NA,Nova Scotia,957600,0,0,1069,64
2020-08-02,Canada,NA,Nova Scotia,957600,2,0,1071,64
2020-08-03,Canada,NA,Nova Scotia,957600,0,0,1071,64
2020-08-04,Canada,NA,Nova Scotia,957600,0,0,1071,64
2020-08-05,Canada,NA,Nova Scotia,957600,0,0,1071,64
2020-08-06,Canada,NA,Nova Scotia,957600,0,0,1071,64
2020-08-07,Canada,NA,Nova Scotia,957600,0,0,1071,64
2020-08-08,Canada,NA,Nova Scotia,957600,0,0,1071,64
2020-08-09,Canada,NA,Nova Scotia,957600,0,0,1071,64
2020-08-10,Canada,NA,Nova Scotia,957600,0,0,1071,64
2020-08-11,Canada,NA,Nova Scotia,957600,0,0,1071,64
2020-08-12,Canada,NA,Nova Scotia,957600,0,0,1071,64
2020-08-13,Canada,NA,Nova Scotia,957600,0,0,1071,64
2020-08-14,Canada,NA,Nova Scotia,957600,1,0,1072,64
2020-08-15,Canada,NA,Nova Scotia,957600,2,0,1074,64
2020-08-16,Canada,NA,Nova Scotia,957600,0,0,1074,64
2020-08-17,Canada,NA,Nova Scotia,957600,1,0,1075,64
2020-08-18,Canada,NA,Nova Scotia,957600,0,0,1075,64
2020-08-19,Canada,NA,Nova Scotia,957600,1,0,1076,64
2020-08-20,Canada,NA,Nova Scotia,957600,1,0,1077,64
2020-08-21,Canada,NA,Nova Scotia,957600,0,0,1077,64
2020-08-22,Canada,NA,Nova Scotia,957600,1,0,1078,64
2020-08-23,Canada,NA,Nova Scotia,957600,2,1,1080,65
2020-08-24,Canada,NA,Nova Scotia,957600,0,0,1080,65
2020-08-25,Canada,NA,Nova Scotia,957600,0,0,1080,65
2020-08-26,Canada,NA,Nova Scotia,957600,1,0,1081,65
2020-08-27,Canada,NA,Nova Scotia,957600,0,0,1081,65
2020-08-28,Canada,NA,Nova Scotia,957600,2,0,1083,65
2020-08-29,Canada,NA,Nova Scotia,957600,0,0,1083,65
2020-08-30,Canada,NA,Nova Scotia,957600,0,0,1083,65
2020-08-31,Canada,NA,Nova Scotia,957600,2,0,1085,65
2020-09-01,Canada,NA,Nova Scotia,957600,0,0,1085,65
2020-09-02,Canada,NA,Nova Scotia,957600,0,0,1085,65
2020-09-03,Canada,NA,Nova Scotia,957600,0,0,1085,65
2020-09-04,Canada,NA,Nova Scotia,957600,0,0,1085,65
2020-09-05,Canada,NA,Nova Scotia,957600,0,0,1085,65
2020-09-06,Canada,NA,Nova Scotia,957600,0,0,1085,65
2020-09-07,Canada,NA,Nova Scotia,957600,1,0,1086,65
2020-09-08,Canada,NA,Nova Scotia,957600,0,0,1086,65
2020-09-09,Canada,NA,Nova Scotia,957600,0,0,1086,65
2020-09-10,Canada,NA,Nova Scotia,957600,0,0,1086,65
2020-09-11,Canada,NA,Nova Scotia,957600,0,0,1086,65
2020-09-12,Canada,NA,Nova Scotia,957600,0,0,1086,65
2020-09-13,Canada,NA,Nova Scotia,957600,0,0,1086,65
2020-09-14,Canada,NA,Nova Scotia,957600,0,0,1086,65
2020-09-15,Canada,NA,Nova Scotia,957600,0,0,1086,65
2020-09-16,Canada,NA,Nova Scotia,957600,0,0,1086,65
2020-09-17,Canada,NA,Nova Scotia,957600,0,0,1086,65
2020-09-18,Canada,NA,Nova Scotia,957600,0,0,1086,65
2020-09-19,Canada,NA,Nova Scotia,957600,0,0,1086,65
2020-09-20,Canada,NA,Nova Scotia,957600,0,0,1086,65
2020-09-21,Canada,NA,Nova Scotia,957600,0,0,1086,65
2020-09-22,Canada,NA,Nova Scotia,957600,1,0,1087,65
2020-03-01,Canada,NA,Ontario,14279196,7,0,15,0
2020-03-02,Canada,NA,Ontario,14279196,0,0,15,0
2020-03-03,Canada,NA,Ontario,14279196,5,0,20,0
2020-03-04,Canada,NA,Ontario,14279196,0,0,20,0
2020-03-05,Canada,NA,Ontario,14279196,2,0,22,0
2020-03-06,Canada,NA,Ontario,14279196,6,0,28,0
2020-03-07,Canada,NA,Ontario,14279196,0,0,28,0
2020-03-08,Canada,NA,Ontario,14279196,3,0,31,0
2020-03-09,Canada,NA,Ontario,14279196,3,0,34,0
2020-03-10,Canada,NA,Ontario,14279196,2,0,37,0
2020-03-11,Canada,NA,Ontario,14279196,8,1,42,1
2020-03-12,Canada,NA,Ontario,14279196,17,0,59,1
2020-03-13,Canada,NA,Ontario,14279196,20,0,79,1
2020-03-14,Canada,NA,Ontario,14279196,0,0,79,1
2020-03-15,Canada,NA,Ontario,14279196,24,0,103,1
2020-03-16,Canada,NA,Ontario,14279196,42,0,145,1
2020-03-17,Canada,NA,Ontario,14279196,32,0,177,1
2020-03-18,Canada,NA,Ontario,14279196,12,0,189,1
2020-03-19,Canada,NA,Ontario,14279196,69,1,258,2
2020-03-20,Canada,NA,Ontario,14279196,53,0,311,2
2020-03-21,Canada,NA,Ontario,14279196,66,1,377,3
2020-03-22,Canada,NA,Ontario,14279196,48,2,425,5
2020-03-23,Canada,NA,Ontario,14279196,78,1,503,6
2020-03-24,Canada,NA,Ontario,14279196,85,2,588,8
2020-03-25,Canada,NA,Ontario,14279196,100,5,688,13
2020-03-26,Canada,NA,Ontario,14279196,170,2,858,15
2020-03-27,Canada,NA,Ontario,14279196,135,3,993,18
2020-03-28,Canada,NA,Ontario,14279196,0,0,993,18
2020-03-29,Canada,NA,Ontario,14279196,362,1,1355,19
2020-03-30,Canada,NA,Ontario,14279196,351,14,1706,33
2020-03-31,Canada,NA,Ontario,14279196,260,0,1966,33
2020-04-01,Canada,NA,Ontario,14279196,426,4,2392,37
2020-04-02,Canada,NA,Ontario,14279196,401,16,2793,53
2020-04-03,Canada,NA,Ontario,14279196,462,14,3255,67
2020-04-04,Canada,NA,Ontario,14279196,375,27,3630,94
2020-04-05,Canada,NA,Ontario,14279196,408,25,4038,119
2020-04-06,Canada,NA,Ontario,14279196,309,13,4347,132
2020-04-07,Canada,NA,Ontario,14279196,379,21,4726,153
2020-04-08,Canada,NA,Ontario,14279196,550,21,5276,174
2020-04-09,Canada,NA,Ontario,14279196,483,26,5759,200
2020-04-10,Canada,NA,Ontario,14279196,478,22,6237,222
2020-04-11,Canada,NA,Ontario,14279196,411,31,6648,253
2020-04-12,Canada,NA,Ontario,14279196,401,21,7049,274
2020-04-13,Canada,NA,Ontario,14279196,421,17,7470,291
2020-04-14,Canada,NA,Ontario,14279196,483,43,7953,334
2020-04-15,Canada,NA,Ontario,14279196,494,51,8447,385
2020-04-16,Canada,NA,Ontario,14279196,514,38,8961,423
2020-04-17,Canada,NA,Ontario,14279196,564,55,9525,478
2020-04-18,Canada,NA,Ontario,14279196,485,36,10010,514
2020-04-19,Canada,NA,Ontario,14279196,568,39,10578,553
2020-04-20,Canada,NA,Ontario,14279196,606,31,11184,584
2020-04-21,Canada,NA,Ontario,14279196,551,38,11735,622
2020-04-22,Canada,NA,Ontario,14279196,510,37,12245,659
2020-04-23,Canada,NA,Ontario,14279196,634,54,12879,713
2020-04-24,Canada,NA,Ontario,14279196,640,50,13519,763
2020-04-25,Canada,NA,Ontario,14279196,476,48,13995,811
2020-04-26,Canada,NA,Ontario,14279196,437,24,14432,835
2020-04-27,Canada,NA,Ontario,14279196,424,57,14856,892
2020-04-28,Canada,NA,Ontario,14279196,525,59,15381,951
2020-04-29,Canada,NA,Ontario,14279196,347,45,15728,996
2020-04-30,Canada,NA,Ontario,14279196,459,86,16187,1082
2020-05-01,Canada,NA,Ontario,14279196,421,39,16608,1121
2020-05-02,Canada,NA,Ontario,14279196,511,55,17119,1176
2020-05-03,Canada,NA,Ontario,14279196,434,40,17553,1216
2020-05-04,Canada,NA,Ontario,14279196,370,84,17923,1300
2020-05-05,Canada,NA,Ontario,14279196,387,61,18310,1361
2020-05-06,Canada,NA,Ontario,14279196,412,68,18722,1429
2020-05-07,Canada,NA,Ontario,14279196,399,48,19121,1477
2020-05-08,Canada,NA,Ontario,14279196,477,63,19598,1540
2020-05-09,Canada,NA,Ontario,14279196,346,59,19944,1599
2020-05-10,Canada,NA,Ontario,14279196,294,35,20238,1634
2020-05-11,Canada,NA,Ontario,14279196,308,35,20546,1669
2020-05-12,Canada,NA,Ontario,14279196,361,56,20907,1725
2020-05-13,Canada,NA,Ontario,14279196,329,40,21236,1765
2020-05-14,Canada,NA,Ontario,14279196,345,33,21581,1798
2020-05-15,Canada,NA,Ontario,14279196,341,27,21922,1825
2020-05-16,Canada,NA,Ontario,14279196,391,33,22313,1858
2020-05-17,Canada,NA,Ontario,14279196,340,23,22653,1881
2020-05-18,Canada,NA,Ontario,14279196,304,23,22957,1904
2020-05-19,Canada,NA,Ontario,14279196,427,15,23384,1919
2020-05-20,Canada,NA,Ontario,14279196,390,43,23774,1962
2020-05-21,Canada,NA,Ontario,14279196,413,31,24187,1993
2020-05-22,Canada,NA,Ontario,14279196,441,28,24628,2021
2020-05-23,Canada,NA,Ontario,14279196,412,27,25040,2048
2020-05-24,Canada,NA,Ontario,14279196,460,25,25500,2073
2020-05-25,Canada,NA,Ontario,14279196,404,29,25904,2102
2020-05-26,Canada,NA,Ontario,14279196,287,21,26191,2123
2020-05-27,Canada,NA,Ontario,14279196,292,32,26483,2155
2020-05-28,Canada,NA,Ontario,14279196,383,34,26866,2189
2020-05-29,Canada,NA,Ontario,14279196,344,41,27210,2230
2020-05-30,Canada,NA,Ontario,14279196,323,17,27533,2247
2020-05-31,Canada,NA,Ontario,14279196,326,19,27859,2266
2020-06-01,Canada,NA,Ontario,14279196,404,10,28263,2276
2020-06-02,Canada,NA,Ontario,14279196,446,17,28709,2293
2020-06-03,Canada,NA,Ontario,14279196,338,19,29047,2312
2020-06-04,Canada,NA,Ontario,14279196,356,45,29403,2357
2020-06-05,Canada,NA,Ontario,14279196,344,15,29747,2372
2020-06-06,Canada,NA,Ontario,14279196,455,35,30202,2407
2020-06-07,Canada,NA,Ontario,14279196,415,19,30617,2426
2020-06-08,Canada,NA,Ontario,14279196,243,24,30860,2450
2020-06-09,Canada,NA,Ontario,14279196,230,14,31090,2464
2020-06-10,Canada,NA,Ontario,14279196,251,11,31341,2475
2020-06-11,Canada,NA,Ontario,14279196,203,12,31544,2487
2020-06-12,Canada,NA,Ontario,14279196,182,11,31726,2498
2020-06-13,Canada,NA,Ontario,14279196,266,9,31992,2507
2020-06-14,Canada,NA,Ontario,14279196,197,12,32189,2519
2020-06-15,Canada,NA,Ontario,14279196,181,8,32370,2527
2020-06-16,Canada,NA,Ontario,14279196,184,11,32554,2538
2020-06-17,Canada,NA,Ontario,14279196,190,12,32744,2550
2020-06-18,Canada,NA,Ontario,14279196,173,3,32917,2553
2020-06-19,Canada,NA,Ontario,14279196,178,11,33095,2564
2020-06-20,Canada,NA,Ontario,14279196,206,31,33301,2595
2020-06-21,Canada,NA,Ontario,14279196,175,11,33476,2606
2020-06-22,Canada,NA,Ontario,14279196,161,3,33637,2609
2020-06-23,Canada,NA,Ontario,14279196,216,10,33853,2619
2020-06-24,Canada,NA,Ontario,14279196,163,12,34016,2631
2020-06-25,Canada,NA,Ontario,14279196,189,10,34205,2641
2020-06-26,Canada,NA,Ontario,14279196,111,3,34316,2644
2020-06-27,Canada,NA,Ontario,14279196,160,8,34476,2652
2020-06-28,Canada,NA,Ontario,14279196,178,6,34654,2658
2020-06-29,Canada,NA,Ontario,14279196,257,7,34911,2665
2020-06-30,Canada,NA,Ontario,14279196,157,7,35068,2672
2020-07-01,Canada,NA,Ontario,14279196,0,0,35068,2672
2020-07-02,Canada,NA,Ontario,14279196,302,8,35370,2680
2020-07-03,Canada,NA,Ontario,14279196,165,2,35535,2682
2020-07-04,Canada,NA,Ontario,14279196,121,5,35656,2687
2020-07-05,Canada,NA,Ontario,14279196,138,2,35794,2689
2020-07-06,Canada,NA,Ontario,14279196,154,0,35948,2689
2020-07-07,Canada,NA,Ontario,14279196,112,2,36060,2691
2020-07-08,Canada,NA,Ontario,14279196,118,9,36178,2700
2020-07-09,Canada,NA,Ontario,14279196,170,3,36348,2703
2020-07-10,Canada,NA,Ontario,14279196,116,7,36464,2710
2020-07-11,Canada,NA,Ontario,14279196,130,6,36594,2716
2020-07-12,Canada,NA,Ontario,14279196,129,3,36723,2719
2020-07-13,Canada,NA,Ontario,14279196,116,3,36839,2722
2020-07-14,Canada,NA,Ontario,14279196,111,1,36950,2723
2020-07-15,Canada,NA,Ontario,14279196,102,9,37052,2732
2020-07-16,Canada,NA,Ontario,14279196,111,5,37163,2737
2020-07-17,Canada,NA,Ontario,14279196,111,9,37274,2746
2020-07-18,Canada,NA,Ontario,14279196,166,2,37440,2748
2020-07-19,Canada,NA,Ontario,14279196,164,3,37604,2751
2020-07-20,Canada,NA,Ontario,14279196,135,1,37739,2752
2020-07-21,Canada,NA,Ontario,14279196,203,1,37942,2753
2020-07-22,Canada,NA,Ontario,14279196,165,2,38107,2755
2020-07-23,Canada,NA,Ontario,14279196,103,0,38210,2755
2020-07-24,Canada,NA,Ontario,14279196,195,3,38405,2758
2020-07-25,Canada,NA,Ontario,14279196,138,1,38543,2759
2020-07-26,Canada,NA,Ontario,14279196,137,4,38680,2763
2020-07-27,Canada,NA,Ontario,14279196,119,1,38799,2764
2020-07-28,Canada,NA,Ontario,14279196,111,4,38910,2768
2020-07-29,Canada,NA,Ontario,14279196,76,1,38986,2769
2020-07-30,Canada,NA,Ontario,14279196,89,3,39075,2772
2020-07-31,Canada,NA,Ontario,14279196,134,3,39209,2775
2020-08-01,Canada,NA,Ontario,14279196,124,2,39333,2777
2020-08-02,Canada,NA,Ontario,14279196,116,1,39449,2778
2020-08-03,Canada,NA,Ontario,14279196,0,0,39449,2778
2020-08-04,Canada,NA,Ontario,14279196,179,4,39628,2782
2020-08-05,Canada,NA,Ontario,14279196,86,0,39714,2782
2020-08-06,Canada,NA,Ontario,14279196,95,1,39809,2783
2020-08-07,Canada,NA,Ontario,14279196,88,0,39897,2783
2020-08-08,Canada,NA,Ontario,14279196,70,1,39967,2784
2020-08-09,Canada,NA,Ontario,14279196,79,2,40046,2786
2020-08-10,Canada,NA,Ontario,14279196,115,0,40161,2786
2020-08-11,Canada,NA,Ontario,14279196,33,0,40194,2786
2020-08-12,Canada,NA,Ontario,14279196,95,1,40289,2787
2020-08-13,Canada,NA,Ontario,14279196,78,0,40367,2787
2020-08-14,Canada,NA,Ontario,14279196,92,1,40459,2788
2020-08-15,Canada,NA,Ontario,14279196,106,1,40565,2789
2020-08-16,Canada,NA,Ontario,14279196,81,0,40646,2789
2020-08-17,Canada,NA,Ontario,14279196,99,0,40745,2789
2020-08-18,Canada,NA,Ontario,14279196,125,3,40870,2792
2020-08-19,Canada,NA,Ontario,14279196,102,0,40972,2792
2020-08-20,Canada,NA,Ontario,14279196,76,1,41048,2793
2020-08-21,Canada,NA,Ontario,14279196,131,3,41179,2796
2020-08-22,Canada,NA,Ontario,14279196,108,1,41287,2797
2020-08-23,Canada,NA,Ontario,14279196,115,0,41402,2797
2020-08-24,Canada,NA,Ontario,14279196,105,1,41507,2798
2020-08-25,Canada,NA,Ontario,14279196,100,2,41607,2800
2020-08-26,Canada,NA,Ontario,14279196,88,2,41695,2802
2020-08-27,Canada,NA,Ontario,14279196,118,1,41813,2803
2020-08-28,Canada,NA,Ontario,14279196,122,6,41935,2809
2020-08-29,Canada,NA,Ontario,14279196,148,0,42083,2809
2020-08-30,Canada,NA,Ontario,14279196,112,1,42195,2810
2020-08-31,Canada,NA,Ontario,14279196,114,1,42309,2811
2020-09-01,Canada,NA,Ontario,14279196,112,1,42421,2812
2020-09-02,Canada,NA,Ontario,14279196,133,0,42554,2812
2020-09-03,Canada,NA,Ontario,14279196,132,0,42686,2812
2020-09-04,Canada,NA,Ontario,14279196,148,0,42834,2812
2020-09-05,Canada,NA,Ontario,14279196,169,0,43003,2812
2020-09-06,Canada,NA,Ontario,14279196,158,2,43161,2813
2020-09-07,Canada,NA,Ontario,14279196,0,0,43161,2813
2020-09-08,Canada,NA,Ontario,14279196,375,0,43536,2813
2020-09-09,Canada,NA,Ontario,14279196,149,0,43685,2813
2020-09-10,Canada,NA,Ontario,14279196,170,1,43855,2814
2020-09-11,Canada,NA,Ontario,14279196,213,0,44068,2814
2020-09-12,Canada,NA,Ontario,14279196,232,1,44300,2814
2020-09-13,Canada,NA,Ontario,14279196,204,1,44504,2815
2020-09-14,Canada,NA,Ontario,14279196,313,1,44817,2816
2020-09-15,Canada,NA,Ontario,14279196,251,4,45068,2820
2020-09-16,Canada,NA,Ontario,14279196,315,2,45383,2822
2020-09-17,Canada,NA,Ontario,14279196,293,3,45676,2825
2020-09-18,Canada,NA,Ontario,14279196,401,0,46077,2825
2020-09-19,Canada,NA,Ontario,14279196,407,1,46484,2826
2020-09-20,Canada,NA,Ontario,14279196,365,1,46849,2827
2020-09-21,Canada,NA,Ontario,14279196,425,2,47274,2829
2020-09-22,Canada,NA,Ontario,14279196,478,3,47752,2832
2020-09-23,Canada,NA,Ontario,14279196,335,3,48087,2835
2020-03-12,Canada,NA,Quebec,8484965,6,0,13,0
2020-03-13,Canada,NA,Quebec,8484965,4,0,17,0
2020-03-14,Canada,NA,Quebec,8484965,0,0,17,0
2020-03-15,Canada,NA,Quebec,8484965,7,0,24,0
2020-03-16,Canada,NA,Quebec,8484965,15,0,39,0
2020-03-17,Canada,NA,Quebec,8484965,11,0,50,0
2020-03-18,Canada,NA,Quebec,8484965,24,1,74,1
2020-03-19,Canada,NA,Quebec,8484965,47,0,121,1
2020-03-20,Canada,NA,Quebec,8484965,18,0,139,1
2020-03-21,Canada,NA,Quebec,8484965,82,3,202,4
2020-03-22,Canada,NA,Quebec,8484965,0,0,221,4
2020-03-23,Canada,NA,Quebec,8484965,407,0,221,4
2020-03-24,Canada,NA,Quebec,8484965,385,0,221,4
2020-03-25,Canada,NA,Quebec,8484965,326,2,1339,6
2020-03-26,Canada,NA,Quebec,8484965,290,2,1629,8
2020-03-27,Canada,NA,Quebec,8484965,392,10,2021,18
2020-03-28,Canada,NA,Quebec,8484965,477,4,2498,22
2020-03-29,Canada,NA,Quebec,8484965,342,0,2840,22
2020-03-30,Canada,NA,Quebec,8484965,590,3,3430,25
2020-03-31,Canada,NA,Quebec,8484965,732,6,4162,31
2020-04-01,Canada,NA,Quebec,8484965,449,2,4611,33
2020-04-02,Canada,NA,Quebec,8484965,907,3,5518,36
2020-04-03,Canada,NA,Quebec,8484965,583,25,6101,61
2020-04-04,Canada,NA,Quebec,8484965,896,14,6997,75
2020-04-05,Canada,NA,Quebec,8484965,947,19,7944,94
2020-04-06,Canada,NA,Quebec,8484965,636,27,8580,121
2020-04-07,Canada,NA,Quebec,8484965,760,29,9340,150
2020-04-08,Canada,NA,Quebec,8484965,691,25,10031,175
2020-04-09,Canada,NA,Quebec,8484965,881,41,10912,216
2020-04-10,Canada,NA,Quebec,8484965,765,25,11677,241
2020-04-11,Canada,NA,Quebec,8484965,615,48,12292,289
2020-04-12,Canada,NA,Quebec,8484965,554,39,12846,328
2020-04-13,Canada,NA,Quebec,8484965,711,32,13557,360
2020-04-14,Canada,NA,Quebec,8484965,691,75,14248,435
2020-04-15,Canada,NA,Quebec,8484965,612,52,14860,487
2020-04-16,Canada,NA,Quebec,8484965,997,143,15857,630
2020-04-17,Canada,NA,Quebec,8484965,941,58,16798,688
2020-04-18,Canada,NA,Quebec,8484965,723,117,17521,805
2020-04-19,Canada,NA,Quebec,8484965,836,72,18357,877
2020-04-20,Canada,NA,Quebec,8484965,962,62,19319,939
2020-04-21,Canada,NA,Quebec,8484965,807,102,20126,1041
2020-04-22,Canada,NA,Quebec,8484965,839,93,20965,1134
2020-04-23,Canada,NA,Quebec,8484965,873,109,21838,1243
2020-04-24,Canada,NA,Quebec,8484965,778,97,22616,1340
2020-04-25,Canada,NA,Quebec,8484965,651,106,23267,1446
2020-04-26,Canada,NA,Quebec,8484965,840,69,24107,1515
2020-04-27,Canada,NA,Quebec,8484965,875,84,24982,1599
2020-04-28,Canada,NA,Quebec,8484965,775,83,25757,1682
2020-04-29,Canada,NA,Quebec,8484965,837,79,26594,1761
2020-04-30,Canada,NA,Quebec,8484965,944,98,27538,1859
2020-05-01,Canada,NA,Quebec,8484965,1110,163,28648,2022
2020-05-02,Canada,NA,Quebec,8484965,1008,114,29656,2136
2020-05-03,Canada,NA,Quebec,8484965,2209,69,31865,2205
2020-05-04,Canada,NA,Quebec,8484965,758,75,32623,2280
2020-05-05,Canada,NA,Quebec,8484965,794,118,33417,2398
2020-05-06,Canada,NA,Quebec,8484965,910,112,34327,2510
2020-05-07,Canada,NA,Quebec,8484965,911,121,35238,2631
2020-05-08,Canada,NA,Quebec,8484965,912,94,36150,2725
2020-05-09,Canada,NA,Quebec,8484965,836,61,36986,2786
2020-05-10,Canada,NA,Quebec,8484965,735,142,37721,2928
2020-05-11,Canada,NA,Quebec,8484965,748,85,38469,3013
2020-05-12,Canada,NA,Quebec,8484965,756,118,39225,3131
2020-05-13,Canada,NA,Quebec,8484965,706,89,39931,3220
2020-05-14,Canada,NA,Quebec,8484965,793,131,40724,3351
2020-05-15,Canada,NA,Quebec,8484965,696,50,41420,3401
2020-05-16,Canada,NA,Quebec,8484965,763,82,42183,3483
2020-05-17,Canada,NA,Quebec,8484965,737,79,42920,3562
2020-05-18,Canada,NA,Quebec,8484965,707,34,43627,3596
2020-05-19,Canada,NA,Quebec,8484965,570,51,44197,3647
2020-05-20,Canada,NA,Quebec,8484965,578,71,44775,3718
2020-05-21,Canada,NA,Quebec,8484965,720,82,45495,3800
2020-05-22,Canada,NA,Quebec,8484965,646,65,46141,3865
2020-05-23,Canada,NA,Quebec,8484965,697,75,46838,3940
2020-05-24,Canada,NA,Quebec,8484965,573,44,47411,3984
2020-05-25,Canada,NA,Quebec,8484965,573,85,47984,4069
2020-05-26,Canada,NA,Quebec,8484965,614,70,48598,4139
2020-05-27,Canada,NA,Quebec,8484965,541,89,49139,4228
2020-05-28,Canada,NA,Quebec,8484965,563,74,49702,4302
2020-05-29,Canada,NA,Quebec,8484965,530,61,50232,4363
2020-05-30,Canada,NA,Quebec,8484965,419,76,50651,4439
2020-05-31,Canada,NA,Quebec,8484965,408,202,51059,4641
2020-06-01,Canada,NA,Quebec,8484965,295,20,51354,4661
2020-06-02,Canada,NA,Quebec,8484965,239,52,51593,4713
2020-06-03,Canada,NA,Quebec,8484965,291,81,51884,4794
2020-06-04,Canada,NA,Quebec,8484965,259,91,52143,4885
2020-06-05,Canada,NA,Quebec,8484965,255,50,52398,4935
2020-06-06,Canada,NA,Quebec,8484965,226,35,52624,4970
2020-06-07,Canada,NA,Quebec,8484965,225,8,52849,4978
2020-06-08,Canada,NA,Quebec,8484965,198,6,53047,4984
2020-06-09,Canada,NA,Quebec,8484965,138,45,53185,5029
2020-06-10,Canada,NA,Quebec,8484965,156,52,53341,5081
2020-06-11,Canada,NA,Quebec,8484965,144,24,53485,5105
2020-06-12,Canada,NA,Quebec,8484965,181,43,53666,5148
2020-06-13,Canada,NA,Quebec,8484965,158,47,53824,5195
2020-06-14,Canada,NA,Quebec,8484965,128,27,53952,5222
2020-06-15,Canada,NA,Quebec,8484965,102,20,54054,5242
2020-06-16,Canada,NA,Quebec,8484965,92,27,54146,5269
2020-06-17,Canada,NA,Quebec,8484965,117,29,54263,5298
2020-06-18,Canada,NA,Quebec,8484965,120,42,54383,5340
2020-06-19,Canada,NA,Quebec,8484965,167,35,54550,5375
2020-06-20,Canada,NA,Quebec,8484965,124,33,54674,5408
2020-06-21,Canada,NA,Quebec,8484965,92,9,54766,5417
2020-06-22,Canada,NA,Quebec,8484965,69,0,54835,5417
2020-06-23,Canada,NA,Quebec,8484965,49,7,54884,5424
2020-06-24,Canada,NA,Quebec,8484965,53,17,54937,5441
2020-06-25,Canada,NA,Quebec,8484965,142,7,55079,5448
2020-06-26,Canada,NA,Quebec,8484965,0,0,55079,5448
2020-06-27,Canada,NA,Quebec,8484965,0,0,55079,5448
2020-06-28,Canada,NA,Quebec,8484965,0,0,55079,5448
2020-06-29,Canada,NA,Quebec,8484965,311,37,55390,5485
2020-06-30,Canada,NA,Quebec,8484965,68,18,55458,5503
2020-07-01,Canada,NA,Quebec,8484965,0,0,55458,5503
2020-07-02,Canada,NA,Quebec,8484965,135,38,55593,5541
2020-07-03,Canada,NA,Quebec,8484965,89,19,55682,5560
2020-07-04,Canada,NA,Quebec,8484965,102,6,55784,5566
2020-07-05,Canada,NA,Quebec,8484965,79,8,55863,5574
2020-07-06,Canada,NA,Quebec,8484965,74,3,55937,5577
2020-07-07,Canada,NA,Quebec,8484965,60,13,55997,5590
2020-07-08,Canada,NA,Quebec,8484965,82,13,56079,5603
2020-07-09,Canada,NA,Quebec,8484965,137,6,56216,5609
2020-07-10,Canada,NA,Quebec,8484965,100,3,56316,5612
2020-07-11,Canada,NA,Quebec,8484965,91,8,56407,5620
2020-07-12,Canada,NA,Quebec,8484965,114,7,56521,5627
2020-07-13,Canada,NA,Quebec,8484965,100,1,56621,5628
2020-07-14,Canada,NA,Quebec,8484965,109,5,56730,5633
2020-07-15,Canada,NA,Quebec,8484965,129,3,56859,5636
2020-07-16,Canada,NA,Quebec,8484965,142,10,57001,5646
2020-07-17,Canada,NA,Quebec,8484965,141,1,57142,5647
2020-07-18,Canada,NA,Quebec,8484965,158,7,57300,5654
2020-07-19,Canada,NA,Quebec,8484965,166,1,57466,5655
2020-07-20,Canada,NA,Quebec,8484965,150,2,57616,5657
2020-07-21,Canada,NA,Quebec,8484965,180,1,57796,5658
2020-07-22,Canada,NA,Quebec,8484965,142,4,57938,5662
2020-07-23,Canada,NA,Quebec,8484965,142,0,58080,5662
2020-07-24,Canada,NA,Quebec,8484965,163,1,58243,5663
2020-07-25,Canada,NA,Quebec,8484965,171,3,58414,5666
2020-07-26,Canada,NA,Quebec,8484965,169,1,58583,5667
2020-07-27,Canada,NA,Quebec,8484965,145,0,58728,5667
2020-07-28,Canada,NA,Quebec,8484965,169,3,58897,5670
2020-07-29,Canada,NA,Quebec,8484965,112,2,59009,5672
2020-07-30,Canada,NA,Quebec,8484965,122,1,59131,5673
2020-07-31,Canada,NA,Quebec,8484965,181,1,59312,5674
2020-08-01,Canada,NA,Quebec,8484965,146,4,59458,5678
2020-08-02,Canada,NA,Quebec,8484965,141,3,59599,5681
2020-08-03,Canada,NA,Quebec,8484965,123,2,59722,5683
2020-08-04,Canada,NA,Quebec,8484965,123,2,59845,5685
2020-08-05,Canada,NA,Quebec,8484965,155,2,60000,5687
2020-08-06,Canada,NA,Quebec,8484965,133,0,60133,5687
2020-08-07,Canada,NA,Quebec,8484965,108,0,60241,5687
2020-08-08,Canada,NA,Quebec,8484965,126,5,60367,5692
2020-08-09,Canada,NA,Quebec,8484965,104,3,60471,5695
2020-08-10,Canada,NA,Quebec,8484965,156,1,60627,5696
2020-08-11,Canada,NA,Quebec,8484965,91,1,60718,5697
2020-08-12,Canada,NA,Quebec,8484965,95,12,60813,5709
2020-08-13,Canada,NA,Quebec,8484965,104,6,60917,5715
2020-08-14,Canada,NA,Quebec,8484965,87,3,61004,5718
2020-08-15,Canada,NA,Quebec,8484965,80,1,61084,5719
2020-08-16,Canada,NA,Quebec,8484965,67,1,61151,5720
2020-08-17,Canada,NA,Quebec,8484965,55,1,61206,5721
2020-08-18,Canada,NA,Quebec,8484965,46,6,61252,5727
2020-08-19,Canada,NA,Quebec,8484965,64,2,61316,5729
2020-08-20,Canada,NA,Quebec,8484965,86,1,61402,5730
2020-08-21,Canada,NA,Quebec,8484965,93,3,61495,5733
2020-08-22,Canada,NA,Quebec,8484965,104,6,61599,5739
2020-08-23,Canada,NA,Quebec,8484965,74,1,61673,5740
2020-08-24,Canada,NA,Quebec,8484965,68,4,61741,5744
2020-08-25,Canada,NA,Quebec,8484965,62,2,61803,5746
2020-08-26,Canada,NA,Quebec,8484965,142,1,61945,5747
2020-08-27,Canada,NA,Quebec,8484965,81,3,62026,5750
2020-08-28,Canada,NA,Quebec,8484965,50,5,62076,5755
2020-08-29,Canada,NA,Quebec,8484965,156,0,62232,5755
2020-08-30,Canada,NA,Quebec,8484965,120,3,62352,5758
2020-08-31,Canada,NA,Quebec,8484965,140,2,62492,5760
2020-09-01,Canada,NA,Quebec,8484965,122,2,62614,5762
2020-09-02,Canada,NA,Quebec,8484965,132,2,62746,5764
2020-09-03,Canada,NA,Quebec,8484965,187,3,62933,5767
2020-09-04,Canada,NA,Quebec,8484965,184,0,63117,5767
2020-09-05,Canada,NA,Quebec,8484965,175,2,63292,5769
2020-09-06,Canada,NA,Quebec,8484965,205,0,63497,5769
2020-09-07,Canada,NA,Quebec,8484965,216,1,63713,5770
2020-09-08,Canada,NA,Quebec,8484965,163,0,63876,5770
2020-09-09,Canada,NA,Quebec,8484965,180,1,64056,5771
2020-09-10,Canada,NA,Quebec,8484965,188,2,64244,5773
2020-09-11,Canada,NA,Quebec,8484965,219,1,64463,5774
2020-09-12,Canada,NA,Quebec,8484965,244,6,64707,5780
2020-09-13,Canada,NA,Quebec,8484965,279,0,64986,5780
2020-09-14,Canada,NA,Quebec,8484965,276,0,65262,5780
2020-09-15,Canada,NA,Quebec,8484965,292,5,65554,5785
2020-09-16,Canada,NA,Quebec,8484965,303,3,65857,5788
2020-09-17,Canada,NA,Quebec,8484965,499,3,66356,5791
2020-09-18,Canada,NA,Quebec,8484965,297,1,66653,5792
2020-09-19,Canada,NA,Quebec,8484965,427,5,67080,5797
2020-09-20,Canada,NA,Quebec,8484965,462,5,67542,5802
2020-09-21,Canada,NA,Quebec,8484965,586,2,68128,5804
2020-09-22,Canada,NA,Quebec,8484965,489,1,68617,5805
2020-09-23,Canada,NA,Quebec,8484965,471,4,69088,5809
2020-03-21,Canada,NA,Saskatchewan,1168057,18,0,25,0
2020-03-22,Canada,NA,Saskatchewan,1168057,8,0,33,0
2020-03-23,Canada,NA,Saskatchewan,1168057,14,0,65,0
2020-03-24,Canada,NA,Saskatchewan,1168057,6,0,72,0
2020-03-25,Canada,NA,Saskatchewan,1168057,14,0,86,0
2020-03-26,Canada,NA,Saskatchewan,1168057,9,0,95,0
2020-03-27,Canada,NA,Saskatchewan,1168057,9,0,104,0
2020-03-28,Canada,NA,Saskatchewan,1168057,30,0,134,0
2020-03-29,Canada,NA,Saskatchewan,1168057,0,0,134,0
2020-03-30,Canada,NA,Saskatchewan,1168057,41,2,175,2
2020-03-31,Canada,NA,Saskatchewan,1168057,9,0,184,2
2020-04-01,Canada,NA,Saskatchewan,1168057,9,1,193,3
2020-04-02,Canada,NA,Saskatchewan,1168057,13,0,206,3
2020-04-03,Canada,NA,Saskatchewan,1168057,14,0,220,3
2020-04-04,Canada,NA,Saskatchewan,1168057,11,0,231,3
2020-04-05,Canada,NA,Saskatchewan,1168057,18,0,249,3
2020-04-06,Canada,NA,Saskatchewan,1168057,4,0,253,3
2020-04-07,Canada,NA,Saskatchewan,1168057,7,0,260,3
2020-04-08,Canada,NA,Saskatchewan,1168057,11,0,271,3
2020-04-09,Canada,NA,Saskatchewan,1168057,7,0,278,3
2020-04-10,Canada,NA,Saskatchewan,1168057,7,0,285,3
2020-04-11,Canada,NA,Saskatchewan,1168057,4,1,289,4
2020-04-12,Canada,NA,Saskatchewan,1168057,9,0,296,4
2020-04-13,Canada,NA,Saskatchewan,1168057,2,0,300,4
2020-04-14,Canada,NA,Saskatchewan,1168057,1,0,301,4
2020-04-15,Canada,NA,Saskatchewan,1168057,3,0,304,4
2020-04-16,Canada,NA,Saskatchewan,1168057,1,0,305,4
2020-04-17,Canada,NA,Saskatchewan,1168057,2,0,306,4
2020-04-18,Canada,NA,Saskatchewan,1168057,6,0,310,4
2020-04-19,Canada,NA,Saskatchewan,1168057,2,0,314,4
2020-04-20,Canada,NA,Saskatchewan,1168057,1,0,316,4
2020-04-21,Canada,NA,Saskatchewan,1168057,4,0,320,4
2020-04-22,Canada,NA,Saskatchewan,1168057,6,0,326,4
2020-04-23,Canada,NA,Saskatchewan,1168057,5,0,331,4
2020-04-24,Canada,NA,Saskatchewan,1168057,10,0,341,4
2020-04-25,Canada,NA,Saskatchewan,1168057,8,0,347,4
2020-04-26,Canada,NA,Saskatchewan,1168057,4,0,353,4
2020-04-27,Canada,NA,Saskatchewan,1168057,12,1,365,5
2020-04-28,Canada,NA,Saskatchewan,1168057,1,0,366,5
2020-04-29,Canada,NA,Saskatchewan,1168057,17,1,383,6
2020-04-30,Canada,NA,Saskatchewan,1168057,6,0,389,6
2020-05-01,Canada,NA,Saskatchewan,1168057,26,0,415,6
2020-05-02,Canada,NA,Saskatchewan,1168057,6,0,421,6
2020-05-03,Canada,NA,Saskatchewan,1168057,12,0,433,6
2020-05-04,Canada,NA,Saskatchewan,1168057,34,0,467,6
2020-05-05,Canada,NA,Saskatchewan,1168057,20,0,487,6
2020-05-06,Canada,NA,Saskatchewan,1168057,25,0,512,6
2020-05-07,Canada,NA,Saskatchewan,1168057,19,0,531,6
2020-05-08,Canada,NA,Saskatchewan,1168057,13,0,544,6
2020-05-09,Canada,NA,Saskatchewan,1168057,9,0,553,6
2020-05-10,Canada,NA,Saskatchewan,1168057,11,0,564,6
2020-05-11,Canada,NA,Saskatchewan,1168057,4,0,568,6
2020-05-12,Canada,NA,Saskatchewan,1168057,5,0,573,6
2020-05-13,Canada,NA,Saskatchewan,1168057,4,0,577,6
2020-05-14,Canada,NA,Saskatchewan,1168057,5,0,582,6
2020-05-15,Canada,NA,Saskatchewan,1168057,8,0,590,6
2020-05-16,Canada,NA,Saskatchewan,1168057,1,0,591,6
2020-05-17,Canada,NA,Saskatchewan,1168057,1,0,592,6
2020-05-18,Canada,NA,Saskatchewan,1168057,0,0,592,6
2020-05-19,Canada,NA,Saskatchewan,1168057,7,0,599,6
2020-05-20,Canada,NA,Saskatchewan,1168057,21,0,620,6
2020-05-21,Canada,NA,Saskatchewan,1168057,2,1,622,7
2020-05-22,Canada,NA,Saskatchewan,1168057,5,0,627,7
2020-05-23,Canada,NA,Saskatchewan,1168057,3,0,630,7
2020-05-24,Canada,NA,Saskatchewan,1168057,2,0,632,7
2020-05-25,Canada,NA,Saskatchewan,1168057,2,0,634,7
2020-05-26,Canada,NA,Saskatchewan,1168057,0,1,634,8
2020-05-27,Canada,NA,Saskatchewan,1168057,3,2,637,10
2020-05-28,Canada,NA,Saskatchewan,1168057,2,0,639,10
2020-05-29,Canada,NA,Saskatchewan,1168057,2,0,641,10
2020-05-30,Canada,NA,Saskatchewan,1168057,4,0,645,10
2020-05-31,Canada,NA,Saskatchewan,1168057,1,1,646,11
2020-06-01,Canada,NA,Saskatchewan,1168057,0,0,646,11
2020-06-02,Canada,NA,Saskatchewan,1168057,0,0,646,11
2020-06-03,Canada,NA,Saskatchewan,1168057,1,0,647,11
2020-06-04,Canada,NA,Saskatchewan,1168057,1,0,648,11
2020-06-05,Canada,NA,Saskatchewan,1168057,1,0,649,11
2020-06-06,Canada,NA,Saskatchewan,1168057,1,0,650,11
2020-06-07,Canada,NA,Saskatchewan,1168057,0,0,650,11
2020-06-08,Canada,NA,Saskatchewan,1168057,4,2,654,13
2020-06-09,Canada,NA,Saskatchewan,1168057,2,0,656,13
2020-06-10,Canada,NA,Saskatchewan,1168057,2,0,658,13
2020-06-11,Canada,NA,Saskatchewan,1168057,2,0,660,13
2020-06-12,Canada,NA,Saskatchewan,1168057,3,0,663,13
2020-06-13,Canada,NA,Saskatchewan,1168057,1,0,664,13
2020-06-14,Canada,NA,Saskatchewan,1168057,1,0,665,13
2020-06-15,Canada,NA,Saskatchewan,1168057,18,0,683,13
2020-06-16,Canada,NA,Saskatchewan,1168057,1,0,684,13
2020-06-17,Canada,NA,Saskatchewan,1168057,9,0,693,13
2020-06-18,Canada,NA,Saskatchewan,1168057,15,0,708,13
2020-06-19,Canada,NA,Saskatchewan,1168057,8,0,716,13
2020-06-20,Canada,NA,Saskatchewan,1168057,10,0,726,13
2020-06-21,Canada,NA,Saskatchewan,1168057,20,0,746,13
2020-06-22,Canada,NA,Saskatchewan,1168057,5,0,751,13
2020-06-23,Canada,NA,Saskatchewan,1168057,2,0,753,13
2020-06-24,Canada,NA,Saskatchewan,1168057,4,0,757,13
2020-06-25,Canada,NA,Saskatchewan,1168057,2,0,759,13
2020-06-26,Canada,NA,Saskatchewan,1168057,13,0,772,13
2020-06-27,Canada,NA,Saskatchewan,1168057,5,0,777,13
2020-06-28,Canada,NA,Saskatchewan,1168057,1,0,778,13
2020-06-29,Canada,NA,Saskatchewan,1168057,1,0,779,13
2020-06-30,Canada,NA,Saskatchewan,1168057,6,0,785,13
2020-07-01,Canada,NA,Saskatchewan,1168057,0,0,785,13
2020-07-02,Canada,NA,Saskatchewan,1168057,10,1,795,14
2020-07-03,Canada,NA,Saskatchewan,1168057,1,0,796,14
2020-07-04,Canada,NA,Saskatchewan,1168057,0,0,796,14
2020-07-05,Canada,NA,Saskatchewan,1168057,0,0,796,14
2020-07-06,Canada,NA,Saskatchewan,1168057,9,0,805,14
2020-07-07,Canada,NA,Saskatchewan,1168057,1,1,806,15
2020-07-08,Canada,NA,Saskatchewan,1168057,2,0,808,15
2020-07-09,Canada,NA,Saskatchewan,1168057,5,0,813,15
2020-07-10,Canada,NA,Saskatchewan,1168057,2,0,815,15
2020-07-11,Canada,NA,Saskatchewan,1168057,0,0,815,15
2020-07-12,Canada,NA,Saskatchewan,1168057,0,0,815,15
2020-07-13,Canada,NA,Saskatchewan,1168057,56,0,871,15
2020-07-14,Canada,NA,Saskatchewan,1168057,5,0,876,15
2020-07-15,Canada,NA,Saskatchewan,1168057,5,0,881,15
2020-07-16,Canada,NA,Saskatchewan,1168057,42,0,923,15
2020-07-17,Canada,NA,Saskatchewan,1168057,13,0,936,15
2020-07-18,Canada,NA,Saskatchewan,1168057,5,0,941,15
2020-07-19,Canada,NA,Saskatchewan,1168057,2,0,943,15
2020-07-20,Canada,NA,Saskatchewan,1168057,19,0,962,15
2020-07-21,Canada,NA,Saskatchewan,1168057,8,0,970,15
2020-07-22,Canada,NA,Saskatchewan,1168057,60,0,1030,15
2020-07-23,Canada,NA,Saskatchewan,1168057,42,1,1072,16
2020-07-24,Canada,NA,Saskatchewan,1168057,27,0,1099,16
2020-07-25,Canada,NA,Saskatchewan,1168057,37,0,1136,16
2020-07-26,Canada,NA,Saskatchewan,1168057,42,0,1178,16
2020-07-27,Canada,NA,Saskatchewan,1168057,31,0,1209,16
2020-07-28,Canada,NA,Saskatchewan,1168057,9,1,1218,17
2020-07-29,Canada,NA,Saskatchewan,1168057,50,0,1268,17
2020-07-30,Canada,NA,Saskatchewan,1168057,38,1,1306,18
2020-07-31,Canada,NA,Saskatchewan,1168057,13,0,1319,18
2020-08-01,Canada,NA,Saskatchewan,1168057,15,0,1334,18
2020-08-02,Canada,NA,Saskatchewan,1168057,8,0,1342,18
2020-08-03,Canada,NA,Saskatchewan,1168057,17,0,1359,18
2020-08-04,Canada,NA,Saskatchewan,1168057,9,0,1368,18
2020-08-05,Canada,NA,Saskatchewan,1168057,8,0,1376,18
2020-08-06,Canada,NA,Saskatchewan,1168057,11,1,1387,19
2020-08-07,Canada,NA,Saskatchewan,1168057,22,1,1409,20
2020-08-08,Canada,NA,Saskatchewan,1168057,24,0,1433,20
2020-08-09,Canada,NA,Saskatchewan,1168057,12,0,1445,20
2020-08-10,Canada,NA,Saskatchewan,1168057,5,0,1450,20
2020-08-11,Canada,NA,Saskatchewan,1168057,29,0,1479,20
2020-08-12,Canada,NA,Saskatchewan,1168057,5,0,1484,20
2020-08-13,Canada,NA,Saskatchewan,1168057,27,0,1511,20
2020-08-14,Canada,NA,Saskatchewan,1168057,30,0,1541,20
2020-08-15,Canada,NA,Saskatchewan,1168057,25,1,1566,21
2020-08-16,Canada,NA,Saskatchewan,1168057,14,1,1580,22
2020-08-17,Canada,NA,Saskatchewan,1168057,1,0,1581,22
2020-08-18,Canada,NA,Saskatchewan,1168057,1,0,1582,22
2020-08-19,Canada,NA,Saskatchewan,1168057,4,0,1586,22
2020-08-20,Canada,NA,Saskatchewan,1168057,4,0,1590,22
2020-08-21,Canada,NA,Saskatchewan,1168057,5,0,1595,22
2020-08-22,Canada,NA,Saskatchewan,1168057,2,0,1597,22
2020-08-23,Canada,NA,Saskatchewan,1168057,3,0,1600,22
2020-08-24,Canada,NA,Saskatchewan,1168057,2,0,1602,22
2020-08-25,Canada,NA,Saskatchewan,1168057,0,1,1602,23
2020-08-26,Canada,NA,Saskatchewan,1168057,3,1,1604,24
2020-08-27,Canada,NA,Saskatchewan,1168057,5,0,1609,24
2020-08-28,Canada,NA,Saskatchewan,1168057,2,0,1611,24
2020-08-29,Canada,NA,Saskatchewan,1168057,4,0,1615,24
2020-08-30,Canada,NA,Saskatchewan,1168057,0,0,1615,24
2020-08-31,Canada,NA,Saskatchewan,1168057,4,0,1619,24
2020-09-01,Canada,NA,Saskatchewan,1168057,3,0,1622,24
2020-09-02,Canada,NA,Saskatchewan,1168057,2,0,1624,24
2020-09-03,Canada,NA,Saskatchewan,1168057,10,0,1634,24
2020-09-04,Canada,NA,Saskatchewan,1168057,4,0,1638,24
2020-09-05,Canada,NA,Saskatchewan,1168057,5,0,1643,24
2020-09-06,Canada,NA,Saskatchewan,1168057,8,0,1651,24
2020-09-07,Canada,NA,Saskatchewan,1168057,11,0,1662,24
2020-09-08,Canada,NA,Saskatchewan,1168057,7,0,1669,24
2020-09-09,Canada,NA,Saskatchewan,1168057,1,0,1670,24
2020-09-10,Canada,NA,Saskatchewan,1168057,6,0,1676,24
2020-09-11,Canada,NA,Saskatchewan,1168057,12,0,1688,24
2020-09-12,Canada,NA,Saskatchewan,1168057,21,0,1709,24
2020-09-13,Canada,NA,Saskatchewan,1168057,17,0,1726,24
2020-09-14,Canada,NA,Saskatchewan,1168057,5,0,1731,24
2020-09-15,Canada,NA,Saskatchewan,1168057,10,0,1741,24
2020-09-16,Canada,NA,Saskatchewan,1168057,10,0,1751,24
2020-09-17,Canada,NA,Saskatchewan,1168057,6,0,1757,24
2020-09-18,Canada,NA,Saskatchewan,1168057,19,0,1776,24
2020-09-19,Canada,NA,Saskatchewan,1168057,11,0,1787,24
2020-09-20,Canada,NA,Saskatchewan,1168057,20,0,1807,24
2020-09-21,Canada,NA,Saskatchewan,1168057,7,0,1814,24
2020-09-22,Canada,NA,Saskatchewan,1168057,10,0,1824,24
2020-09-23,Canada,NA,Saskatchewan,1168057,6,0,1830,24
2020-03-22,Chile,NA,Antofagasta,607534,1,0,11,0
2020-03-23,Chile,NA,Antofagasta,607534,0,0,11,0
2020-03-24,Chile,NA,Antofagasta,607534,2,0,13,0
2020-03-25,Chile,NA,Antofagasta,607534,6,0,19,0
2020-03-26,Chile,NA,Antofagasta,607534,1,0,20,0
2020-03-27,Chile,NA,Antofagasta,607534,1,0,21,0
2020-03-28,Chile,NA,Antofagasta,607534,4,0,25,0
2020-03-29,Chile,NA,Antofagasta,607534,2,0,27,0
2020-03-30,Chile,NA,Antofagasta,607534,8,0,35,0
2020-03-31,Chile,NA,Antofagasta,607534,0,0,35,0
2020-04-01,Chile,NA,Antofagasta,607534,4,0,39,0
2020-04-02,Chile,NA,Antofagasta,607534,8,0,47,0
2020-04-03,Chile,NA,Antofagasta,607534,7,0,54,0
2020-04-04,Chile,NA,Antofagasta,607534,1,0,55,0
2020-04-05,Chile,NA,Antofagasta,607534,5,0,60,0
2020-04-06,Chile,NA,Antofagasta,607534,8,0,68,0
2020-04-07,Chile,NA,Antofagasta,607534,1,1,69,1
2020-04-08,Chile,NA,Antofagasta,607534,8,0,77,1
2020-04-09,Chile,NA,Antofagasta,607534,15,0,92,1
2020-04-10,Chile,NA,Antofagasta,607534,18,0,110,1
2020-04-11,Chile,NA,Antofagasta,607534,7,0,117,1
2020-04-12,Chile,NA,Antofagasta,607534,21,0,138,1
2020-04-13,Chile,NA,Antofagasta,607534,11,0,149,1
2020-04-14,Chile,NA,Antofagasta,607534,6,0,155,1
2020-04-15,Chile,NA,Antofagasta,607534,21,0,176,1
2020-04-16,Chile,NA,Antofagasta,607534,16,0,192,1
2020-04-17,Chile,NA,Antofagasta,607534,19,0,211,1
2020-04-18,Chile,NA,Antofagasta,607534,15,0,226,1
2020-04-19,Chile,NA,Antofagasta,607534,23,0,249,1
2020-04-20,Chile,NA,Antofagasta,607534,14,0,263,1
2020-04-21,Chile,NA,Antofagasta,607534,28,0,291,1
2020-04-22,Chile,NA,Antofagasta,607534,35,1,326,2
2020-04-23,Chile,NA,Antofagasta,607534,14,0,340,2
2020-04-24,Chile,NA,Antofagasta,607534,26,0,366,2
2020-04-25,Chile,NA,Antofagasta,607534,25,1,391,3
2020-04-26,Chile,NA,Antofagasta,607534,52,1,443,4
2020-04-27,Chile,NA,Antofagasta,607534,14,0,457,4
2020-04-28,Chile,NA,Antofagasta,607534,24,0,481,4
2020-04-29,Chile,NA,Antofagasta,607534,33,0,514,4
2020-04-30,Chile,NA,Antofagasta,607534,32,1,546,5
2020-05-01,Chile,NA,Antofagasta,607534,43,2,589,7
2020-05-02,Chile,NA,Antofagasta,607534,90,0,679,7
2020-05-03,Chile,NA,Antofagasta,607534,61,0,740,7
2020-05-04,Chile,NA,Antofagasta,607534,20,0,760,7
2020-05-05,Chile,NA,Antofagasta,607534,51,0,811,7
2020-05-06,Chile,NA,Antofagasta,607534,44,0,855,7
2020-05-07,Chile,NA,Antofagasta,607534,40,0,895,7
2020-05-08,Chile,NA,Antofagasta,607534,28,2,923,9
2020-05-09,Chile,NA,Antofagasta,607534,24,1,947,10
2020-05-10,Chile,NA,Antofagasta,607534,31,0,978,10
2020-05-11,Chile,NA,Antofagasta,607534,36,0,1014,10
2020-05-12,Chile,NA,Antofagasta,607534,95,0,1109,10
2020-05-13,Chile,NA,Antofagasta,607534,107,1,1216,11
2020-05-14,Chile,NA,Antofagasta,607534,61,0,1277,11
2020-05-15,Chile,NA,Antofagasta,607534,54,1,1331,12
2020-05-16,Chile,NA,Antofagasta,607534,98,0,1429,12
2020-05-17,Chile,NA,Antofagasta,607534,76,1,1505,13
2020-05-18,Chile,NA,Antofagasta,607534,84,1,1589,14
2020-05-19,Chile,NA,Antofagasta,607534,59,2,1648,16
2020-05-20,Chile,NA,Antofagasta,607534,83,1,1731,17
2020-05-21,Chile,NA,Antofagasta,607534,47,0,1778,17
2020-05-22,Chile,NA,Antofagasta,607534,63,0,1841,17
2020-05-23,Chile,NA,Antofagasta,607534,56,4,1897,21
2020-05-24,Chile,NA,Antofagasta,607534,50,0,1947,21
2020-05-25,Chile,NA,Antofagasta,607534,68,0,2015,21
2020-05-26,Chile,NA,Antofagasta,607534,48,2,2063,23
2020-05-27,Chile,NA,Antofagasta,607534,74,2,2137,25
2020-05-28,Chile,NA,Antofagasta,607534,111,3,2248,28
2020-05-29,Chile,NA,Antofagasta,607534,70,0,2318,28
2020-05-30,Chile,NA,Antofagasta,607534,111,1,2429,29
2020-05-31,Chile,NA,Antofagasta,607534,81,2,2510,31
2020-06-01,Chile,NA,Antofagasta,607534,75,1,2585,32
2020-06-02,Chile,NA,Antofagasta,607534,64,2,2649,34
2020-06-03,Chile,NA,Antofagasta,607534,67,2,2716,36
2020-06-04,Chile,NA,Antofagasta,607534,146,2,2862,38
2020-06-05,Chile,NA,Antofagasta,607534,62,4,2924,42
2020-06-06,Chile,NA,Antofagasta,607534,109,5,3033,47
2020-06-07,Chile,NA,Antofagasta,607534,121,0,3154,47
2020-06-08,Chile,NA,Antofagasta,607534,91,1,3245,47
2020-06-09,Chile,NA,Antofagasta,607534,157,0,3402,47
2020-06-10,Chile,NA,Antofagasta,607534,157,11,3559,56
2020-06-11,Chile,NA,Antofagasta,607534,194,1,3753,57
2020-06-12,Chile,NA,Antofagasta,607534,132,8,3885,65
2020-06-13,Chile,NA,Antofagasta,607534,153,2,4038,67
2020-06-14,Chile,NA,Antofagasta,607534,248,5,4286,72
2020-06-15,Chile,NA,Antofagasta,607534,270,0,4556,72
2020-06-16,Chile,NA,Antofagasta,607534,87,0,4643,72
2020-06-17,Chile,NA,Antofagasta,607534,126,9,4769,81
2020-06-18,Chile,NA,Antofagasta,607534,287,6,5056,87
2020-06-19,Chile,NA,Antofagasta,607534,300,6,5356,93
2020-06-20,Chile,NA,Antofagasta,607534,387,1,5743,94
2020-06-21,Chile,NA,Antofagasta,607534,246,6,5989,100
2020-06-22,Chile,NA,Antofagasta,607534,247,0,6236,100
2020-06-23,Chile,NA,Antofagasta,607534,283,0,6519,100
2020-06-24,Chile,NA,Antofagasta,607534,236,13,6755,113
2020-06-25,Chile,NA,Antofagasta,607534,288,9,7043,122
2020-06-26,Chile,NA,Antofagasta,607534,227,6,7270,128
2020-06-27,Chile,NA,Antofagasta,607534,285,14,7555,142
2020-06-28,Chile,NA,Antofagasta,607534,281,5,7836,147
2020-06-29,Chile,NA,Antofagasta,607534,317,0,8153,147
2020-06-30,Chile,NA,Antofagasta,607534,204,0,8357,147
2020-07-01,Chile,NA,Antofagasta,607534,254,0,8611,147
2020-07-02,Chile,NA,Antofagasta,607534,202,16,8813,163
2020-07-03,Chile,NA,Antofagasta,607534,285,8,9098,171
2020-07-04,Chile,NA,Antofagasta,607534,253,3,9351,174
2020-07-05,Chile,NA,Antofagasta,607534,296,9,9647,183
2020-07-06,Chile,NA,Antofagasta,607534,236,0,9883,183
2020-07-07,Chile,NA,Antofagasta,607534,239,0,10122,183
2020-07-08,Chile,NA,Antofagasta,607534,231,14,10353,197
2020-07-09,Chile,NA,Antofagasta,607534,252,6,10605,203
2020-07-10,Chile,NA,Antofagasta,607534,190,13,10795,216
2020-07-11,Chile,NA,Antofagasta,607534,313,2,11108,218
2020-07-12,Chile,NA,Antofagasta,607534,219,6,11327,224
2020-07-13,Chile,NA,Antofagasta,607534,235,1,11562,225
2020-07-14,Chile,NA,Antofagasta,607534,190,3,11752,228
2020-07-15,Chile,NA,Antofagasta,607534,165,4,11917,232
2020-07-16,Chile,NA,Antofagasta,607534,195,4,12112,236
2020-07-17,Chile,NA,Antofagasta,607534,216,35,12328,271
2020-07-18,Chile,NA,Antofagasta,607534,188,8,12516,279
2020-07-19,Chile,NA,Antofagasta,607534,199,1,12715,280
2020-07-20,Chile,NA,Antofagasta,607534,116,13,12831,293
2020-07-21,Chile,NA,Antofagasta,607534,80,0,12911,293
2020-07-22,Chile,NA,Antofagasta,607534,173,5,13084,298
2020-07-23,Chile,NA,Antofagasta,607534,165,7,13249,305
2020-07-24,Chile,NA,Antofagasta,607534,155,5,13404,310
2020-07-25,Chile,NA,Antofagasta,607534,131,6,13535,316
2020-07-26,Chile,NA,Antofagasta,607534,155,12,13690,328
2020-07-27,Chile,NA,Antofagasta,607534,151,4,13841,332
2020-07-28,Chile,NA,Antofagasta,607534,128,2,13969,334
2020-07-29,Chile,NA,Antofagasta,607534,140,1,14109,335
2020-07-30,Chile,NA,Antofagasta,607534,88,6,14197,341
2020-07-31,Chile,NA,Antofagasta,607534,151,6,14348,347
2020-08-01,Chile,NA,Antofagasta,607534,129,5,14477,352
2020-08-02,Chile,NA,Antofagasta,607534,140,1,14617,353
2020-08-03,Chile,NA,Antofagasta,607534,154,5,14771,358
2020-08-04,Chile,NA,Antofagasta,607534,85,0,14856,358
2020-08-05,Chile,NA,Antofagasta,607534,162,3,15018,361
2020-08-06,Chile,NA,Antofagasta,607534,132,6,15150,367
2020-08-07,Chile,NA,Antofagasta,607534,128,5,15278,372
2020-08-08,Chile,NA,Antofagasta,607534,161,4,15439,376
2020-08-09,Chile,NA,Antofagasta,607534,134,2,15573,378
2020-08-10,Chile,NA,Antofagasta,607534,150,3,15723,381
2020-08-11,Chile,NA,Antofagasta,607534,85,6,15808,387
2020-08-12,Chile,NA,Antofagasta,607534,83,1,15891,388
2020-08-13,Chile,NA,Antofagasta,607534,106,4,15997,392
2020-08-14,Chile,NA,Antofagasta,607534,134,2,16131,394
2020-08-15,Chile,NA,Antofagasta,607534,102,5,16233,399
2020-08-16,Chile,NA,Antofagasta,607534,125,4,16358,403
2020-08-17,Chile,NA,Antofagasta,607534,112,4,16470,407
2020-08-18,Chile,NA,Antofagasta,607534,63,3,16533,410
2020-08-19,Chile,NA,Antofagasta,607534,74,1,16607,411
2020-08-20,Chile,NA,Antofagasta,607534,71,4,16678,415
2020-08-21,Chile,NA,Antofagasta,607534,135,1,16813,416
2020-08-22,Chile,NA,Antofagasta,607534,85,1,16898,417
2020-08-23,Chile,NA,Antofagasta,607534,73,2,16971,419
2020-08-24,Chile,NA,Antofagasta,607534,135,3,17106,422
2020-08-25,Chile,NA,Antofagasta,607534,57,4,17163,426
2020-08-26,Chile,NA,Antofagasta,607534,86,2,17249,428
2020-08-27,Chile,NA,Antofagasta,607534,101,4,17350,432
2020-08-28,Chile,NA,Antofagasta,607534,72,5,17422,437
2020-08-29,Chile,NA,Antofagasta,607534,104,2,17526,439
2020-08-30,Chile,NA,Antofagasta,607534,108,3,17634,442
2020-08-31,Chile,NA,Antofagasta,607534,61,2,17695,444
2020-09-01,Chile,NA,Antofagasta,607534,61,2,17756,446
2020-09-02,Chile,NA,Antofagasta,607534,66,0,17822,446
2020-09-03,Chile,NA,Antofagasta,607534,89,2,17911,448
2020-09-04,Chile,NA,Antofagasta,607534,70,2,17981,450
2020-09-05,Chile,NA,Antofagasta,607534,84,3,18065,453
2020-09-06,Chile,NA,Antofagasta,607534,88,3,18153,456
2020-09-07,Chile,NA,Antofagasta,607534,84,2,18237,458
2020-09-08,Chile,NA,Antofagasta,607534,67,2,18304,460
2020-09-09,Chile,NA,Antofagasta,607534,51,0,18355,460
2020-09-10,Chile,NA,Antofagasta,607534,77,6,18432,466
2020-09-11,Chile,NA,Antofagasta,607534,62,4,18494,470
2020-09-12,Chile,NA,Antofagasta,607534,59,3,18553,473
2020-09-13,Chile,NA,Antofagasta,607534,55,0,18608,473
2020-09-14,Chile,NA,Antofagasta,607534,69,5,18677,478
2020-09-15,Chile,NA,Antofagasta,607534,54,0,18731,478
2020-09-16,Chile,NA,Antofagasta,607534,35,0,18766,478
2020-09-17,Chile,NA,Antofagasta,607534,46,5,18812,483
2020-09-18,Chile,NA,Antofagasta,607534,44,4,18856,487
2020-09-19,Chile,NA,Antofagasta,607534,48,2,18904,489
2020-09-20,Chile,NA,Antofagasta,607534,37,0,18941,489
2020-09-21,Chile,NA,Antofagasta,607534,28,0,18969,489
2020-09-22,Chile,NA,Antofagasta,607534,49,0,19018,489
2020-09-23,Chile,NA,Antofagasta,607534,44,0,19062,489
2020-03-21,Chile,NA,Araucania,957224,6,0,15,0
2020-03-22,Chile,NA,Araucania,957224,12,0,27,0
2020-03-23,Chile,NA,Araucania,957224,13,0,40,0
2020-03-24,Chile,NA,Araucania,957224,19,0,59,0
2020-03-25,Chile,NA,Araucania,957224,15,0,74,0
2020-03-26,Chile,NA,Araucania,957224,37,0,111,0
2020-03-27,Chile,NA,Araucania,957224,32,0,143,0
2020-03-28,Chile,NA,Araucania,957224,34,1,177,1
2020-03-29,Chile,NA,Araucania,957224,28,1,205,2
2020-03-30,Chile,NA,Araucania,957224,42,0,247,2
2020-03-31,Chile,NA,Araucania,957224,55,2,302,4
2020-04-01,Chile,NA,Araucania,957224,41,2,343,6
2020-04-02,Chile,NA,Araucania,957224,46,1,389,7
2020-04-03,Chile,NA,Araucania,957224,43,0,432,7
2020-04-04,Chile,NA,Araucania,957224,45,2,477,9
2020-04-05,Chile,NA,Araucania,957224,32,4,509,13
2020-04-06,Chile,NA,Araucania,957224,53,1,562,14
2020-04-07,Chile,NA,Araucania,957224,50,0,612,14
2020-04-08,Chile,NA,Araucania,957224,57,1,669,15
2020-04-09,Chile,NA,Araucania,957224,20,1,689,16
2020-04-10,Chile,NA,Araucania,957224,23,0,712,16
2020-04-11,Chile,NA,Araucania,957224,27,1,739,17
2020-04-12,Chile,NA,Araucania,957224,36,0,775,17
2020-04-13,Chile,NA,Araucania,957224,20,0,795,17
2020-04-14,Chile,NA,Araucania,957224,21,3,816,20
2020-04-15,Chile,NA,Araucania,957224,10,1,826,21
2020-04-16,Chile,NA,Araucania,957224,56,0,882,21
2020-04-17,Chile,NA,Araucania,957224,25,1,907,22
2020-04-18,Chile,NA,Araucania,957224,37,1,944,23
2020-04-19,Chile,NA,Araucania,957224,28,0,972,23
2020-04-20,Chile,NA,Araucania,957224,73,0,1045,23
2020-04-21,Chile,NA,Araucania,957224,47,2,1092,25
2020-04-22,Chile,NA,Araucania,957224,21,1,1113,26
2020-04-23,Chile,NA,Araucania,957224,29,0,1142,26
2020-04-24,Chile,NA,Araucania,957224,42,0,1184,26
2020-04-25,Chile,NA,Araucania,957224,19,1,1203,27
2020-04-26,Chile,NA,Araucania,957224,13,2,1216,29
2020-04-27,Chile,NA,Araucania,957224,20,3,1236,32
2020-04-28,Chile,NA,Araucania,957224,15,0,1251,32
2020-04-29,Chile,NA,Araucania,957224,22,0,1273,32
2020-04-30,Chile,NA,Araucania,957224,20,3,1293,35
2020-05-01,Chile,NA,Araucania,957224,2,1,1295,36
2020-05-02,Chile,NA,Araucania,957224,19,0,1314,36
2020-05-03,Chile,NA,Araucania,957224,14,0,1328,36
2020-05-04,Chile,NA,Araucania,957224,3,0,1331,36
2020-05-05,Chile,NA,Araucania,957224,21,0,1352,36
2020-05-06,Chile,NA,Araucania,957224,10,0,1362,36
2020-05-07,Chile,NA,Araucania,957224,23,0,1385,36
2020-05-08,Chile,NA,Araucania,957224,18,0,1403,36
2020-05-09,Chile,NA,Araucania,957224,15,0,1418,36
2020-05-10,Chile,NA,Araucania,957224,36,1,1454,37
2020-05-11,Chile,NA,Araucania,957224,12,1,1466,38
2020-05-12,Chile,NA,Araucania,957224,16,1,1482,39
2020-05-13,Chile,NA,Araucania,957224,13,0,1495,39
2020-05-14,Chile,NA,Araucania,957224,41,2,1536,41
2020-05-15,Chile,NA,Araucania,957224,28,2,1564,43
2020-05-16,Chile,NA,Araucania,957224,23,0,1587,43
2020-05-17,Chile,NA,Araucania,957224,19,1,1606,44
2020-05-18,Chile,NA,Araucania,957224,33,0,1639,44
2020-05-19,Chile,NA,Araucania,957224,27,0,1666,44
2020-05-20,Chile,NA,Araucania,957224,14,0,1680,44
2020-05-21,Chile,NA,Araucania,957224,35,0,1715,44
2020-05-22,Chile,NA,Araucania,957224,22,1,1737,45
2020-05-23,Chile,NA,Araucania,957224,37,0,1774,45
2020-05-24,Chile,NA,Araucania,957224,34,0,1808,45
2020-05-25,Chile,NA,Araucania,957224,49,0,1857,45
2020-05-26,Chile,NA,Araucania,957224,26,0,1883,45
2020-05-27,Chile,NA,Araucania,957224,33,0,1916,45
2020-05-28,Chile,NA,Araucania,957224,38,0,1954,45
2020-05-29,Chile,NA,Araucania,957224,35,2,1989,47
2020-05-30,Chile,NA,Araucania,957224,71,0,2060,47
2020-05-31,Chile,NA,Araucania,957224,11,0,2071,47
2020-06-01,Chile,NA,Araucania,957224,40,0,2111,47
2020-06-02,Chile,NA,Araucania,957224,30,0,2141,47
2020-06-03,Chile,NA,Araucania,957224,32,0,2173,47
2020-06-04,Chile,NA,Araucania,957224,9,0,2182,47
2020-06-05,Chile,NA,Araucania,957224,106,1,2288,48
2020-06-06,Chile,NA,Araucania,957224,33,1,2321,49
2020-06-07,Chile,NA,Araucania,957224,56,0,2377,49
2020-06-08,Chile,NA,Araucania,957224,33,1,2410,49
2020-06-09,Chile,NA,Araucania,957224,35,0,2445,49
2020-06-10,Chile,NA,Araucania,957224,43,1,2488,49
2020-06-11,Chile,NA,Araucania,957224,47,1,2535,49
2020-06-12,Chile,NA,Araucania,957224,44,1,2579,49
2020-06-13,Chile,NA,Araucania,957224,66,1,2645,49
2020-06-14,Chile,NA,Araucania,957224,30,0,2675,49
2020-06-15,Chile,NA,Araucania,957224,53,0,2728,49
2020-06-16,Chile,NA,Araucania,957224,47,0,2775,49
2020-06-17,Chile,NA,Araucania,957224,19,0,2794,49
2020-06-18,Chile,NA,Araucania,957224,49,1,2843,49
2020-06-19,Chile,NA,Araucania,957224,33,1,2876,49
2020-06-20,Chile,NA,Araucania,957224,23,1,2899,49
2020-06-21,Chile,NA,Araucania,957224,49,0,2948,49
2020-06-22,Chile,NA,Araucania,957224,40,0,2988,49
2020-06-23,Chile,NA,Araucania,957224,18,0,3006,49
2020-06-24,Chile,NA,Araucania,957224,10,1,3016,49
2020-06-25,Chile,NA,Araucania,957224,27,0,3043,49
2020-06-26,Chile,NA,Araucania,957224,41,0,3084,49
2020-06-27,Chile,NA,Araucania,957224,23,0,3107,49
2020-06-28,Chile,NA,Araucania,957224,44,1,3151,49
2020-06-29,Chile,NA,Araucania,957224,40,0,3191,49
2020-06-30,Chile,NA,Araucania,957224,19,0,3210,49
2020-07-01,Chile,NA,Araucania,957224,15,0,3225,49
2020-07-02,Chile,NA,Araucania,957224,21,0,3246,49
2020-07-03,Chile,NA,Araucania,957224,57,3,3303,49
2020-07-04,Chile,NA,Araucania,957224,45,0,3348,49
2020-07-05,Chile,NA,Araucania,957224,30,1,3378,49
2020-07-06,Chile,NA,Araucania,957224,54,0,3432,49
2020-07-07,Chile,NA,Araucania,957224,19,0,3451,49
2020-07-08,Chile,NA,Araucania,957224,10,1,3461,49
2020-07-09,Chile,NA,Araucania,957224,23,1,3484,49
2020-07-10,Chile,NA,Araucania,957224,33,0,3517,49
2020-07-11,Chile,NA,Araucania,957224,19,0,3536,49
2020-07-12,Chile,NA,Araucania,957224,38,1,3574,49
2020-07-13,Chile,NA,Araucania,957224,9,0,3583,49
2020-07-14,Chile,NA,Araucania,957224,11,0,3594,49
2020-07-15,Chile,NA,Araucania,957224,36,1,3630,49
2020-07-16,Chile,NA,Araucania,957224,25,0,3655,49
2020-07-17,Chile,NA,Araucania,957224,21,22,3676,71
2020-07-18,Chile,NA,Araucania,957224,8,0,3684,71
2020-07-19,Chile,NA,Araucania,957224,22,0,3706,71
2020-07-20,Chile,NA,Araucania,957224,23,0,3729,71
2020-07-21,Chile,NA,Araucania,957224,27,0,3756,71
2020-07-22,Chile,NA,Araucania,957224,22,0,3778,71
2020-07-23,Chile,NA,Araucania,957224,24,3,3802,74
2020-07-24,Chile,NA,Araucania,957224,46,0,3848,74
2020-07-25,Chile,NA,Araucania,957224,26,2,3874,76
2020-07-26,Chile,NA,Araucania,957224,23,1,3897,77
2020-07-27,Chile,NA,Araucania,957224,45,0,3942,77
2020-07-28,Chile,NA,Araucania,957224,31,0,3973,77
2020-07-29,Chile,NA,Araucania,957224,45,0,4018,77
2020-07-30,Chile,NA,Araucania,957224,26,0,4044,77
2020-07-31,Chile,NA,Araucania,957224,46,1,4090,78
2020-08-01,Chile,NA,Araucania,957224,28,0,4118,78
2020-08-02,Chile,NA,Araucania,957224,42,1,4160,79
2020-08-03,Chile,NA,Araucania,957224,44,0,4204,79
2020-08-04,Chile,NA,Araucania,957224,27,0,4231,79
2020-08-05,Chile,NA,Araucania,957224,19,0,4250,79
2020-08-06,Chile,NA,Araucania,957224,57,2,4307,81
2020-08-07,Chile,NA,Araucania,957224,30,1,4337,82
2020-08-08,Chile,NA,Araucania,957224,21,1,4358,83
2020-08-09,Chile,NA,Araucania,957224,32,0,4390,83
2020-08-10,Chile,NA,Araucania,957224,40,0,4430,83
2020-08-11,Chile,NA,Araucania,957224,18,0,4448,83
2020-08-12,Chile,NA,Araucania,957224,35,0,4483,83
2020-08-13,Chile,NA,Araucania,957224,38,0,4521,83
2020-08-14,Chile,NA,Araucania,957224,36,1,4557,84
2020-08-15,Chile,NA,Araucania,957224,46,1,4603,85
2020-08-16,Chile,NA,Araucania,957224,29,1,4632,86
2020-08-17,Chile,NA,Araucania,957224,23,0,4655,86
2020-08-18,Chile,NA,Araucania,957224,41,0,4696,86
2020-08-19,Chile,NA,Araucania,957224,30,0,4726,86
2020-08-20,Chile,NA,Araucania,957224,37,1,4763,87
2020-08-21,Chile,NA,Araucania,957224,62,1,4825,88
2020-08-22,Chile,NA,Araucania,957224,48,1,4873,89
2020-08-23,Chile,NA,Araucania,957224,25,1,4898,90
2020-08-24,Chile,NA,Araucania,957224,16,2,4914,92
2020-08-25,Chile,NA,Araucania,957224,40,0,4954,92
2020-08-26,Chile,NA,Araucania,957224,27,0,4981,92
2020-08-27,Chile,NA,Araucania,957224,16,1,4997,93
2020-08-28,Chile,NA,Araucania,957224,43,1,5040,94
2020-08-29,Chile,NA,Araucania,957224,40,0,5080,94
2020-08-30,Chile,NA,Araucania,957224,33,0,5113,94
2020-08-31,Chile,NA,Araucania,957224,31,0,5144,94
2020-09-01,Chile,NA,Araucania,957224,35,0,5179,94
2020-09-02,Chile,NA,Araucania,957224,43,0,5222,94
2020-09-03,Chile,NA,Araucania,957224,60,2,5282,96
2020-09-04,Chile,NA,Araucania,957224,61,0,5343,96
2020-09-05,Chile,NA,Araucania,957224,48,0,5391,96
2020-09-06,Chile,NA,Araucania,957224,45,0,5436,96
2020-09-07,Chile,NA,Araucania,957224,44,0,5480,96
2020-09-08,Chile,NA,Araucania,957224,37,0,5517,96
2020-09-09,Chile,NA,Araucania,957224,71,0,5588,96
2020-09-10,Chile,NA,Araucania,957224,72,0,5660,96
2020-09-11,Chile,NA,Araucania,957224,91,1,5751,97
2020-09-12,Chile,NA,Araucania,957224,72,1,5823,98
2020-09-13,Chile,NA,Araucania,957224,86,1,5909,99
2020-09-14,Chile,NA,Araucania,957224,51,1,5960,100
2020-09-15,Chile,NA,Araucania,957224,99,1,6059,101
2020-09-16,Chile,NA,Araucania,957224,66,0,6125,101
2020-09-17,Chile,NA,Araucania,957224,62,0,6187,101
2020-09-18,Chile,NA,Araucania,957224,72,0,6259,101
2020-09-19,Chile,NA,Araucania,957224,92,2,6351,103
2020-09-20,Chile,NA,Araucania,957224,59,1,6410,104
2020-09-21,Chile,NA,Araucania,957224,98,0,6508,104
2020-09-22,Chile,NA,Araucania,957224,87,0,6595,104
2020-09-23,Chile,NA,Araucania,957224,97,0,6692,104
2020-04-03,Chile,NA,Arica y Parinacota,226068,5,0,12,0
2020-04-04,Chile,NA,Arica y Parinacota,226068,0,0,12,0
2020-04-05,Chile,NA,Arica y Parinacota,226068,16,0,28,0
2020-04-06,Chile,NA,Arica y Parinacota,226068,13,0,41,0
2020-04-07,Chile,NA,Arica y Parinacota,226068,12,0,53,0
2020-04-08,Chile,NA,Arica y Parinacota,226068,10,0,63,0
2020-04-09,Chile,NA,Arica y Parinacota,226068,12,0,75,0
2020-04-10,Chile,NA,Arica y Parinacota,226068,12,0,87,0
2020-04-11,Chile,NA,Arica y Parinacota,226068,20,0,107,0
2020-04-12,Chile,NA,Arica y Parinacota,226068,8,1,115,1
2020-04-13,Chile,NA,Arica y Parinacota,226068,0,0,115,1
2020-04-14,Chile,NA,Arica y Parinacota,226068,5,0,120,1
2020-04-15,Chile,NA,Arica y Parinacota,226068,4,0,124,1
2020-04-16,Chile,NA,Arica y Parinacota,226068,5,0,129,1
2020-04-17,Chile,NA,Arica y Parinacota,226068,5,1,134,2
2020-04-18,Chile,NA,Arica y Parinacota,226068,8,0,142,2
2020-04-19,Chile,NA,Arica y Parinacota,226068,3,0,145,2
2020-04-20,Chile,NA,Arica y Parinacota,226068,16,0,161,2
2020-04-21,Chile,NA,Arica y Parinacota,226068,9,0,170,2
2020-04-22,Chile,NA,Arica y Parinacota,226068,10,0,180,2
2020-04-23,Chile,NA,Arica y Parinacota,226068,30,0,210,2
2020-04-24,Chile,NA,Arica y Parinacota,226068,29,1,239,3
2020-04-25,Chile,NA,Arica y Parinacota,226068,6,0,245,3
2020-04-26,Chile,NA,Arica y Parinacota,226068,7,0,252,3
2020-04-27,Chile,NA,Arica y Parinacota,226068,13,0,265,3
2020-04-28,Chile,NA,Arica y Parinacota,226068,3,0,268,3
2020-04-29,Chile,NA,Arica y Parinacota,226068,4,1,272,4
2020-04-30,Chile,NA,Arica y Parinacota,226068,7,0,279,4
2020-05-01,Chile,NA,Arica y Parinacota,226068,18,0,297,4
2020-05-02,Chile,NA,Arica y Parinacota,226068,10,0,307,4
2020-05-03,Chile,NA,Arica y Parinacota,226068,1,0,308,4
2020-05-04,Chile,NA,Arica y Parinacota,226068,0,0,308,4
2020-05-05,Chile,NA,Arica y Parinacota,226068,7,0,315,4
2020-05-06,Chile,NA,Arica y Parinacota,226068,3,1,318,5
2020-05-07,Chile,NA,Arica y Parinacota,226068,7,1,325,6
2020-05-08,Chile,NA,Arica y Parinacota,226068,2,0,327,6
2020-05-09,Chile,NA,Arica y Parinacota,226068,10,0,337,6
2020-05-10,Chile,NA,Arica y Parinacota,226068,3,0,340,6
2020-05-11,Chile,NA,Arica y Parinacota,226068,11,1,351,7
2020-05-12,Chile,NA,Arica y Parinacota,226068,0,0,351,7
2020-05-13,Chile,NA,Arica y Parinacota,226068,8,0,359,7
2020-05-14,Chile,NA,Arica y Parinacota,226068,4,0,363,7
2020-05-15,Chile,NA,Arica y Parinacota,226068,5,0,368,7
2020-05-16,Chile,NA,Arica y Parinacota,226068,9,0,377,7
2020-05-17,Chile,NA,Arica y Parinacota,226068,1,0,378,7
2020-05-18,Chile,NA,Arica y Parinacota,226068,20,0,398,7
2020-05-19,Chile,NA,Arica y Parinacota,226068,24,0,422,7
2020-05-20,Chile,NA,Arica y Parinacota,226068,2,0,424,7
2020-05-21,Chile,NA,Arica y Parinacota,226068,29,0,453,7
2020-05-22,Chile,NA,Arica y Parinacota,226068,18,0,471,7
2020-05-23,Chile,NA,Arica y Parinacota,226068,11,0,482,7
2020-05-24,Chile,NA,Arica y Parinacota,226068,16,0,498,7
2020-05-25,Chile,NA,Arica y Parinacota,226068,15,0,513,7
2020-05-26,Chile,NA,Arica y Parinacota,226068,9,0,522,7
2020-05-27,Chile,NA,Arica y Parinacota,226068,19,0,541,7
2020-05-28,Chile,NA,Arica y Parinacota,226068,21,0,562,7
2020-05-29,Chile,NA,Arica y Parinacota,226068,20,0,582,7
2020-05-30,Chile,NA,Arica y Parinacota,226068,6,0,588,7
2020-05-31,Chile,NA,Arica y Parinacota,226068,31,0,619,7
2020-06-01,Chile,NA,Arica y Parinacota,226068,17,1,636,8
2020-06-02,Chile,NA,Arica y Parinacota,226068,18,0,654,8
2020-06-03,Chile,NA,Arica y Parinacota,226068,47,0,701,8
2020-06-04,Chile,NA,Arica y Parinacota,226068,35,0,736,8
2020-06-05,Chile,NA,Arica y Parinacota,226068,46,1,782,9
2020-06-06,Chile,NA,Arica y Parinacota,226068,37,0,819,9
2020-06-07,Chile,NA,Arica y Parinacota,226068,31,0,850,9
2020-06-08,Chile,NA,Arica y Parinacota,226068,24,0,874,9
2020-06-09,Chile,NA,Arica y Parinacota,226068,40,0,914,9
2020-06-10,Chile,NA,Arica y Parinacota,226068,16,2,930,10
2020-06-11,Chile,NA,Arica y Parinacota,226068,37,0,967,10
2020-06-12,Chile,NA,Arica y Parinacota,226068,44,0,1011,10
2020-06-13,Chile,NA,Arica y Parinacota,226068,51,0,1062,10
2020-06-14,Chile,NA,Arica y Parinacota,226068,47,1,1109,11
2020-06-15,Chile,NA,Arica y Parinacota,226068,30,0,1139,11
2020-06-16,Chile,NA,Arica y Parinacota,226068,17,0,1156,11
2020-06-17,Chile,NA,Arica y Parinacota,226068,56,0,1212,11
2020-06-18,Chile,NA,Arica y Parinacota,226068,21,1,1233,12
2020-06-19,Chile,NA,Arica y Parinacota,226068,56,0,1289,12
2020-06-20,Chile,NA,Arica y Parinacota,226068,30,0,1319,12
2020-06-21,Chile,NA,Arica y Parinacota,226068,46,0,1365,12
2020-06-22,Chile,NA,Arica y Parinacota,226068,49,0,1414,12
2020-06-23,Chile,NA,Arica y Parinacota,226068,23,0,1437,12
2020-06-24,Chile,NA,Arica y Parinacota,226068,30,3,1467,15
2020-06-25,Chile,NA,Arica y Parinacota,226068,38,1,1505,16
2020-06-26,Chile,NA,Arica y Parinacota,226068,37,3,1542,19
2020-06-27,Chile,NA,Arica y Parinacota,226068,63,1,1605,20
2020-06-28,Chile,NA,Arica y Parinacota,226068,38,0,1643,20
2020-06-29,Chile,NA,Arica y Parinacota,226068,36,0,1679,20
2020-06-30,Chile,NA,Arica y Parinacota,226068,28,0,1707,20
2020-07-01,Chile,NA,Arica y Parinacota,226068,63,0,1770,20
2020-07-02,Chile,NA,Arica y Parinacota,226068,56,1,1826,21
2020-07-03,Chile,NA,Arica y Parinacota,226068,57,1,1883,22
2020-07-04,Chile,NA,Arica y Parinacota,226068,60,0,1943,22
2020-07-05,Chile,NA,Arica y Parinacota,226068,57,0,2000,22
2020-07-06,Chile,NA,Arica y Parinacota,226068,81,0,2081,22
2020-07-07,Chile,NA,Arica y Parinacota,226068,32,0,2113,22
2020-07-08,Chile,NA,Arica y Parinacota,226068,60,2,2173,24
2020-07-09,Chile,NA,Arica y Parinacota,226068,94,0,2267,24
2020-07-10,Chile,NA,Arica y Parinacota,226068,49,2,2316,26
2020-07-11,Chile,NA,Arica y Parinacota,226068,73,0,2389,26
2020-07-12,Chile,NA,Arica y Parinacota,226068,72,2,2461,28
2020-07-13,Chile,NA,Arica y Parinacota,226068,95,0,2556,28
2020-07-14,Chile,NA,Arica y Parinacota,226068,76,0,2632,28
2020-07-15,Chile,NA,Arica y Parinacota,226068,97,3,2729,31
2020-07-16,Chile,NA,Arica y Parinacota,226068,104,1,2833,32
2020-07-17,Chile,NA,Arica y Parinacota,226068,96,2,2929,34
2020-07-18,Chile,NA,Arica y Parinacota,226068,76,1,3005,35
2020-07-19,Chile,NA,Arica y Parinacota,226068,44,1,3049,36
2020-07-20,Chile,NA,Arica y Parinacota,226068,132,4,3181,40
2020-07-21,Chile,NA,Arica y Parinacota,226068,103,0,3284,40
2020-07-22,Chile,NA,Arica y Parinacota,226068,59,0,3343,40
2020-07-23,Chile,NA,Arica y Parinacota,226068,132,1,3475,41
2020-07-24,Chile,NA,Arica y Parinacota,226068,144,2,3619,43
2020-07-25,Chile,NA,Arica y Parinacota,226068,100,3,3719,46
2020-07-26,Chile,NA,Arica y Parinacota,226068,135,1,3854,47
2020-07-27,Chile,NA,Arica y Parinacota,226068,77,4,3931,51
2020-07-28,Chile,NA,Arica y Parinacota,226068,121,0,4052,51
2020-07-29,Chile,NA,Arica y Parinacota,226068,99,0,4151,51
2020-07-30,Chile,NA,Arica y Parinacota,226068,99,5,4250,56
2020-07-31,Chile,NA,Arica y Parinacota,226068,85,2,4335,58
2020-08-01,Chile,NA,Arica y Parinacota,226068,106,2,4441,60
2020-08-02,Chile,NA,Arica y Parinacota,226068,75,3,4516,63
2020-08-03,Chile,NA,Arica y Parinacota,226068,59,5,4575,68
2020-08-04,Chile,NA,Arica y Parinacota,226068,78,0,4653,68
2020-08-05,Chile,NA,Arica y Parinacota,226068,64,0,4717,68
2020-08-06,Chile,NA,Arica y Parinacota,226068,98,5,4815,73
2020-08-07,Chile,NA,Arica y Parinacota,226068,86,1,4901,74
2020-08-08,Chile,NA,Arica y Parinacota,226068,77,2,4978,76
2020-08-09,Chile,NA,Arica y Parinacota,226068,150,1,5128,77
2020-08-10,Chile,NA,Arica y Parinacota,226068,103,1,5231,78
2020-08-11,Chile,NA,Arica y Parinacota,226068,93,0,5324,78
2020-08-12,Chile,NA,Arica y Parinacota,226068,117,0,5441,78
2020-08-13,Chile,NA,Arica y Parinacota,226068,61,2,5502,80
2020-08-14,Chile,NA,Arica y Parinacota,226068,83,1,5585,81
2020-08-15,Chile,NA,Arica y Parinacota,226068,97,1,5682,82
2020-08-16,Chile,NA,Arica y Parinacota,226068,87,3,5769,85
2020-08-17,Chile,NA,Arica y Parinacota,226068,68,0,5837,85
2020-08-18,Chile,NA,Arica y Parinacota,226068,51,0,5888,85
2020-08-19,Chile,NA,Arica y Parinacota,226068,36,0,5924,85
2020-08-20,Chile,NA,Arica y Parinacota,226068,69,8,5993,93
2020-08-21,Chile,NA,Arica y Parinacota,226068,79,2,6072,95
2020-08-22,Chile,NA,Arica y Parinacota,226068,84,2,6156,97
2020-08-23,Chile,NA,Arica y Parinacota,226068,43,1,6199,98
2020-08-24,Chile,NA,Arica y Parinacota,226068,80,2,6279,100
2020-08-25,Chile,NA,Arica y Parinacota,226068,39,0,6318,100
2020-08-26,Chile,NA,Arica y Parinacota,226068,45,0,6363,100
2020-08-27,Chile,NA,Arica y Parinacota,226068,44,4,6407,104
2020-08-28,Chile,NA,Arica y Parinacota,226068,63,2,6470,106
2020-08-29,Chile,NA,Arica y Parinacota,226068,56,0,6526,106
2020-08-30,Chile,NA,Arica y Parinacota,226068,61,1,6587,107
2020-08-31,Chile,NA,Arica y Parinacota,226068,67,0,6654,107
2020-09-01,Chile,NA,Arica y Parinacota,226068,55,1,6709,108
2020-09-02,Chile,NA,Arica y Parinacota,226068,25,0,6734,108
2020-09-03,Chile,NA,Arica y Parinacota,226068,62,4,6796,112
2020-09-04,Chile,NA,Arica y Parinacota,226068,54,2,6850,114
2020-09-05,Chile,NA,Arica y Parinacota,226068,50,1,6900,115
2020-09-06,Chile,NA,Arica y Parinacota,226068,55,2,6955,117
2020-09-07,Chile,NA,Arica y Parinacota,226068,63,2,7018,119
2020-09-08,Chile,NA,Arica y Parinacota,226068,39,0,7057,119
2020-09-09,Chile,NA,Arica y Parinacota,226068,32,0,7089,119
2020-09-10,Chile,NA,Arica y Parinacota,226068,37,4,7126,123
2020-09-11,Chile,NA,Arica y Parinacota,226068,49,3,7175,126
2020-09-12,Chile,NA,Arica y Parinacota,226068,40,2,7215,128
2020-09-13,Chile,NA,Arica y Parinacota,226068,54,3,7269,131
2020-09-14,Chile,NA,Arica y Parinacota,226068,50,2,7319,133
2020-09-15,Chile,NA,Arica y Parinacota,226068,47,0,7366,133
2020-09-16,Chile,NA,Arica y Parinacota,226068,48,0,7414,133
2020-09-17,Chile,NA,Arica y Parinacota,226068,33,1,7447,134
2020-09-18,Chile,NA,Arica y Parinacota,226068,41,1,7488,135
2020-09-19,Chile,NA,Arica y Parinacota,226068,63,3,7551,138
2020-09-20,Chile,NA,Arica y Parinacota,226068,53,0,7604,138
2020-09-21,Chile,NA,Arica y Parinacota,226068,13,0,7617,138
2020-09-22,Chile,NA,Arica y Parinacota,226068,32,0,7649,138
2020-09-23,Chile,NA,Arica y Parinacota,226068,45,0,7694,138
2020-04-10,Chile,NA,Atacama,286168,3,0,13,0
2020-04-11,Chile,NA,Atacama,286168,0,0,13,0
2020-04-12,Chile,NA,Atacama,286168,0,0,13,0
2020-04-13,Chile,NA,Atacama,286168,0,0,13,0
2020-04-14,Chile,NA,Atacama,286168,0,0,13,0
2020-04-15,Chile,NA,Atacama,286168,0,0,13,0
2020-04-16,Chile,NA,Atacama,286168,0,0,13,0
2020-04-17,Chile,NA,Atacama,286168,0,0,13,0
2020-04-18,Chile,NA,Atacama,286168,0,0,13,0
2020-04-19,Chile,NA,Atacama,286168,0,0,13,0
2020-04-20,Chile,NA,Atacama,286168,0,0,13,0
2020-04-21,Chile,NA,Atacama,286168,0,0,13,0
2020-04-22,Chile,NA,Atacama,286168,0,0,13,0
2020-04-23,Chile,NA,Atacama,286168,5,0,18,0
2020-04-24,Chile,NA,Atacama,286168,3,0,21,0
2020-04-25,Chile,NA,Atacama,286168,3,0,24,0
2020-04-26,Chile,NA,Atacama,286168,5,0,29,0
2020-04-27,Chile,NA,Atacama,286168,6,0,35,0
2020-04-28,Chile,NA,Atacama,286168,0,0,35,0
2020-04-29,Chile,NA,Atacama,286168,7,0,42,0
2020-04-30,Chile,NA,Atacama,286168,1,0,43,0
2020-05-01,Chile,NA,Atacama,286168,0,0,43,0
2020-05-02,Chile,NA,Atacama,286168,16,0,59,0
2020-05-03,Chile,NA,Atacama,286168,8,0,67,0
2020-05-04,Chile,NA,Atacama,286168,3,0,70,0
2020-05-05,Chile,NA,Atacama,286168,8,0,78,0
2020-05-06,Chile,NA,Atacama,286168,2,0,80,0
2020-05-07,Chile,NA,Atacama,286168,7,0,87,0
2020-05-08,Chile,NA,Atacama,286168,1,0,88,0
2020-05-09,Chile,NA,Atacama,286168,29,0,117,0
2020-05-10,Chile,NA,Atacama,286168,7,0,124,0
2020-05-11,Chile,NA,Atacama,286168,9,0,133,0
2020-05-12,Chile,NA,Atacama,286168,1,0,134,0
2020-05-13,Chile,NA,Atacama,286168,5,0,139,0
2020-05-14,Chile,NA,Atacama,286168,1,0,140,0
2020-05-15,Chile,NA,Atacama,286168,3,0,143,0
2020-05-16,Chile,NA,Atacama,286168,3,0,146,0
2020-05-17,Chile,NA,Atacama,286168,3,0,149,0
2020-05-18,Chile,NA,Atacama,286168,8,0,157,0
2020-05-19,Chile,NA,Atacama,286168,1,0,158,0
2020-05-20,Chile,NA,Atacama,286168,5,0,163,0
2020-05-21,Chile,NA,Atacama,286168,5,0,168,0
2020-05-22,Chile,NA,Atacama,286168,7,0,175,0
2020-05-23,Chile,NA,Atacama,286168,7,0,182,0
2020-05-24,Chile,NA,Atacama,286168,0,0,182,0
2020-05-25,Chile,NA,Atacama,286168,3,0,185,0
2020-05-26,Chile,NA,Atacama,286168,3,0,188,0
2020-05-27,Chile,NA,Atacama,286168,9,0,197,0
2020-05-28,Chile,NA,Atacama,286168,5,0,202,0
2020-05-29,Chile,NA,Atacama,286168,5,0,207,0
2020-05-30,Chile,NA,Atacama,286168,8,0,215,0
2020-05-31,Chile,NA,Atacama,286168,3,0,218,0
2020-06-01,Chile,NA,Atacama,286168,14,0,232,0
2020-06-02,Chile,NA,Atacama,286168,4,0,236,0
2020-06-03,Chile,NA,Atacama,286168,6,0,242,0
2020-06-04,Chile,NA,Atacama,286168,16,0,258,0
2020-06-05,Chile,NA,Atacama,286168,11,0,269,0
2020-06-06,Chile,NA,Atacama,286168,12,0,281,0
2020-06-07,Chile,NA,Atacama,286168,25,0,306,0
2020-06-08,Chile,NA,Atacama,286168,33,0,339,0
2020-06-09,Chile,NA,Atacama,286168,9,0,348,0
2020-06-10,Chile,NA,Atacama,286168,17,0,365,0
2020-06-11,Chile,NA,Atacama,286168,24,0,389,0
2020-06-12,Chile,NA,Atacama,286168,24,0,413,0
2020-06-13,Chile,NA,Atacama,286168,23,0,436,0
2020-06-14,Chile,NA,Atacama,286168,12,0,448,0
2020-06-15,Chile,NA,Atacama,286168,36,0,484,0
2020-06-16,Chile,NA,Atacama,286168,18,0,502,0
2020-06-17,Chile,NA,Atacama,286168,49,0,551,0
2020-06-18,Chile,NA,Atacama,286168,25,0,576,0
2020-06-19,Chile,NA,Atacama,286168,37,0,613,0
2020-06-20,Chile,NA,Atacama,286168,27,1,640,1
2020-06-21,Chile,NA,Atacama,286168,33,1,673,2
2020-06-22,Chile,NA,Atacama,286168,35,0,708,2
2020-06-23,Chile,NA,Atacama,286168,29,0,737,2
2020-06-24,Chile,NA,Atacama,286168,38,0,775,2
2020-06-25,Chile,NA,Atacama,286168,52,0,827,2
2020-06-26,Chile,NA,Atacama,286168,50,0,877,2
2020-06-27,Chile,NA,Atacama,286168,38,0,915,2
2020-06-28,Chile,NA,Atacama,286168,31,0,946,2
2020-06-29,Chile,NA,Atacama,286168,50,0,996,2
2020-06-30,Chile,NA,Atacama,286168,37,0,1033,2
2020-07-01,Chile,NA,Atacama,286168,71,0,1104,2
2020-07-02,Chile,NA,Atacama,286168,21,0,1125,2
2020-07-03,Chile,NA,Atacama,286168,31,1,1156,3
2020-07-04,Chile,NA,Atacama,286168,42,2,1198,5
2020-07-05,Chile,NA,Atacama,286168,45,0,1243,5
2020-07-06,Chile,NA,Atacama,286168,48,0,1291,5
2020-07-07,Chile,NA,Atacama,286168,22,0,1313,5
2020-07-08,Chile,NA,Atacama,286168,34,2,1347,7
2020-07-09,Chile,NA,Atacama,286168,72,0,1419,7
2020-07-10,Chile,NA,Atacama,286168,38,2,1457,9
2020-07-11,Chile,NA,Atacama,286168,55,0,1512,9
2020-07-12,Chile,NA,Atacama,286168,54,0,1566,9
2020-07-13,Chile,NA,Atacama,286168,57,0,1623,9
2020-07-14,Chile,NA,Atacama,286168,41,0,1664,9
2020-07-15,Chile,NA,Atacama,286168,48,1,1712,10
2020-07-16,Chile,NA,Atacama,286168,23,0,1735,10
2020-07-17,Chile,NA,Atacama,286168,2,0,1737,10
2020-07-18,Chile,NA,Atacama,286168,43,0,1780,10
2020-07-19,Chile,NA,Atacama,286168,40,0,1820,10
2020-07-20,Chile,NA,Atacama,286168,38,0,1858,10
2020-07-21,Chile,NA,Atacama,286168,63,0,1921,10
2020-07-22,Chile,NA,Atacama,286168,31,0,1952,10
2020-07-23,Chile,NA,Atacama,286168,61,0,2013,10
2020-07-24,Chile,NA,Atacama,286168,61,1,2074,10
2020-07-25,Chile,NA,Atacama,286168,74,0,2148,10
2020-07-26,Chile,NA,Atacama,286168,156,2,2304,12
2020-07-27,Chile,NA,Atacama,286168,14,0,2318,12
2020-07-28,Chile,NA,Atacama,286168,48,0,2366,12
2020-07-29,Chile,NA,Atacama,286168,62,0,2428,12
2020-07-30,Chile,NA,Atacama,286168,114,0,2542,12
2020-07-31,Chile,NA,Atacama,286168,117,0,2659,12
2020-08-01,Chile,NA,Atacama,286168,95,0,2754,12
2020-08-02,Chile,NA,Atacama,286168,99,1,2853,13
2020-08-03,Chile,NA,Atacama,286168,133,0,2986,13
2020-08-04,Chile,NA,Atacama,286168,34,1,3020,14
2020-08-05,Chile,NA,Atacama,286168,167,0,3187,14
2020-08-06,Chile,NA,Atacama,286168,60,2,3247,16
2020-08-07,Chile,NA,Atacama,286168,129,3,3376,19
2020-08-08,Chile,NA,Atacama,286168,138,0,3514,19
2020-08-09,Chile,NA,Atacama,286168,13,0,3527,19
2020-08-10,Chile,NA,Atacama,286168,304,2,3831,21
2020-08-11,Chile,NA,Atacama,286168,130,0,3961,21
2020-08-12,Chile,NA,Atacama,286168,110,0,4071,21
2020-08-13,Chile,NA,Atacama,286168,87,2,4158,23
2020-08-14,Chile,NA,Atacama,286168,117,1,4275,24
2020-08-15,Chile,NA,Atacama,286168,125,2,4400,26
2020-08-16,Chile,NA,Atacama,286168,133,3,4533,29
2020-08-17,Chile,NA,Atacama,286168,111,0,4644,29
2020-08-18,Chile,NA,Atacama,286168,127,0,4771,29
2020-08-19,Chile,NA,Atacama,286168,63,0,4834,29
2020-08-20,Chile,NA,Atacama,286168,43,7,4877,36
2020-08-21,Chile,NA,Atacama,286168,70,1,4947,37
2020-08-22,Chile,NA,Atacama,286168,102,2,5049,39
2020-08-23,Chile,NA,Atacama,286168,67,1,5116,40
2020-08-24,Chile,NA,Atacama,286168,103,0,5219,40
2020-08-25,Chile,NA,Atacama,286168,89,0,5308,40
2020-08-26,Chile,NA,Atacama,286168,28,0,5336,40
2020-08-27,Chile,NA,Atacama,286168,38,6,5374,46
2020-08-28,Chile,NA,Atacama,286168,67,0,5441,46
2020-08-29,Chile,NA,Atacama,286168,76,0,5517,46
2020-08-30,Chile,NA,Atacama,286168,69,0,5586,46
2020-08-31,Chile,NA,Atacama,286168,45,1,5631,47
2020-09-01,Chile,NA,Atacama,286168,68,0,5699,47
2020-09-02,Chile,NA,Atacama,286168,56,0,5755,47
2020-09-03,Chile,NA,Atacama,286168,14,0,5769,47
2020-09-04,Chile,NA,Atacama,286168,36,3,5805,50
2020-09-05,Chile,NA,Atacama,286168,37,1,5842,51
2020-09-06,Chile,NA,Atacama,286168,50,0,5892,51
2020-09-07,Chile,NA,Atacama,286168,35,0,5927,51
2020-09-08,Chile,NA,Atacama,286168,51,0,5978,51
2020-09-09,Chile,NA,Atacama,286168,67,0,6045,51
2020-09-10,Chile,NA,Atacama,286168,28,0,6073,51
2020-09-11,Chile,NA,Atacama,286168,53,1,6126,52
2020-09-12,Chile,NA,Atacama,286168,44,0,6170,52
2020-09-13,Chile,NA,Atacama,286168,46,1,6216,53
2020-09-14,Chile,NA,Atacama,286168,45,0,6261,53
2020-09-15,Chile,NA,Atacama,286168,76,0,6337,53
2020-09-16,Chile,NA,Atacama,286168,24,0,6361,53
2020-09-17,Chile,NA,Atacama,286168,41,2,6402,55
2020-09-18,Chile,NA,Atacama,286168,35,0,6437,55
2020-09-19,Chile,NA,Atacama,286168,84,1,6521,56
2020-09-20,Chile,NA,Atacama,286168,33,3,6554,59
2020-09-21,Chile,NA,Atacama,286168,58,0,6612,59
2020-09-22,Chile,NA,Atacama,286168,20,0,6632,59
2020-09-23,Chile,NA,Atacama,286168,59,0,6691,59
2020-03-19,Chile,NA,Biobio,1556805,7,0,14,0
2020-03-20,Chile,NA,Biobio,1556805,5,0,19,0
2020-03-21,Chile,NA,Biobio,1556805,11,0,30,0
2020-03-22,Chile,NA,Biobio,1556805,5,0,35,0
2020-03-23,Chile,NA,Biobio,1556805,11,0,46,0
2020-03-24,Chile,NA,Biobio,1556805,27,0,73,0
2020-03-25,Chile,NA,Biobio,1556805,22,1,95,1
2020-03-26,Chile,NA,Biobio,1556805,14,0,109,1
2020-03-27,Chile,NA,Biobio,1556805,26,1,135,2
2020-03-28,Chile,NA,Biobio,1556805,16,0,151,2
2020-03-29,Chile,NA,Biobio,1556805,34,0,185,2
2020-03-30,Chile,NA,Biobio,1556805,16,0,201,2
2020-03-31,Chile,NA,Biobio,1556805,15,0,216,2
2020-04-01,Chile,NA,Biobio,1556805,24,0,240,2
2020-04-02,Chile,NA,Biobio,1556805,35,0,275,2
2020-04-03,Chile,NA,Biobio,1556805,27,0,302,2
2020-04-04,Chile,NA,Biobio,1556805,45,0,347,2
2020-04-05,Chile,NA,Biobio,1556805,18,0,365,2
2020-04-06,Chile,NA,Biobio,1556805,18,0,383,2
2020-04-07,Chile,NA,Biobio,1556805,27,0,410,2
2020-04-08,Chile,NA,Biobio,1556805,29,0,439,2
2020-04-09,Chile,NA,Biobio,1556805,21,0,460,2
2020-04-10,Chile,NA,Biobio,1556805,14,0,474,2
2020-04-11,Chile,NA,Biobio,1556805,16,0,490,2
2020-04-12,Chile,NA,Biobio,1556805,10,0,500,2
2020-04-13,Chile,NA,Biobio,1556805,12,0,512,2
2020-04-14,Chile,NA,Biobio,1556805,16,0,528,2
2020-04-15,Chile,NA,Biobio,1556805,14,0,542,2
2020-04-16,Chile,NA,Biobio,1556805,17,0,559,2
2020-04-17,Chile,NA,Biobio,1556805,19,1,578,3
2020-04-18,Chile,NA,Biobio,1556805,28,0,606,3
2020-04-19,Chile,NA,Biobio,1556805,10,0,616,3
2020-04-20,Chile,NA,Biobio,1556805,10,0,626,3
2020-04-21,Chile,NA,Biobio,1556805,10,1,636,4
2020-04-22,Chile,NA,Biobio,1556805,22,1,658,5
2020-04-23,Chile,NA,Biobio,1556805,17,0,675,5
2020-04-24,Chile,NA,Biobio,1556805,8,0,683,5
2020-04-25,Chile,NA,Biobio,1556805,13,0,696,5
2020-04-26,Chile,NA,Biobio,1556805,7,1,703,6
2020-04-27,Chile,NA,Biobio,1556805,3,0,706,6
2020-04-28,Chile,NA,Biobio,1556805,3,1,709,7
2020-04-29,Chile,NA,Biobio,1556805,10,0,719,7
2020-04-30,Chile,NA,Biobio,1556805,8,0,727,7
2020-05-01,Chile,NA,Biobio,1556805,2,0,729,7
2020-05-02,Chile,NA,Biobio,1556805,22,0,751,7
2020-05-03,Chile,NA,Biobio,1556805,8,0,759,7
2020-05-04,Chile,NA,Biobio,1556805,3,1,762,8
2020-05-05,Chile,NA,Biobio,1556805,12,0,774,8
2020-05-06,Chile,NA,Biobio,1556805,15,0,789,8
2020-05-07,Chile,NA,Biobio,1556805,25,0,814,8
2020-05-08,Chile,NA,Biobio,1556805,28,0,842,8
2020-05-09,Chile,NA,Biobio,1556805,40,0,882,8
2020-05-10,Chile,NA,Biobio,1556805,17,0,899,8
2020-05-11,Chile,NA,Biobio,1556805,33,0,932,8
2020-05-12,Chile,NA,Biobio,1556805,10,1,942,9
2020-05-13,Chile,NA,Biobio,1556805,33,0,975,9
2020-05-14,Chile,NA,Biobio,1556805,20,0,995,9
2020-05-15,Chile,NA,Biobio,1556805,41,0,1036,9
2020-05-16,Chile,NA,Biobio,1556805,38,0,1074,9
2020-05-17,Chile,NA,Biobio,1556805,25,0,1099,9
2020-05-18,Chile,NA,Biobio,1556805,45,0,1144,9
2020-05-19,Chile,NA,Biobio,1556805,28,0,1172,9
2020-05-20,Chile,NA,Biobio,1556805,52,0,1224,9
2020-05-21,Chile,NA,Biobio,1556805,39,0,1263,9
2020-05-22,Chile,NA,Biobio,1556805,48,1,1311,10
2020-05-23,Chile,NA,Biobio,1556805,43,0,1354,10
2020-05-24,Chile,NA,Biobio,1556805,60,0,1414,10
2020-05-25,Chile,NA,Biobio,1556805,44,0,1458,10
2020-05-26,Chile,NA,Biobio,1556805,44,0,1502,10
2020-05-27,Chile,NA,Biobio,1556805,63,0,1565,10
2020-05-28,Chile,NA,Biobio,1556805,112,0,1677,10
2020-05-29,Chile,NA,Biobio,1556805,101,1,1778,11
2020-05-30,Chile,NA,Biobio,1556805,110,0,1888,11
2020-05-31,Chile,NA,Biobio,1556805,91,0,1979,11
2020-06-01,Chile,NA,Biobio,1556805,91,0,2070,11
2020-06-02,Chile,NA,Biobio,1556805,12,0,2082,11
2020-06-03,Chile,NA,Biobio,1556805,133,0,2215,11
2020-06-04,Chile,NA,Biobio,1556805,86,2,2301,13
2020-06-05,Chile,NA,Biobio,1556805,78,0,2379,13
2020-06-06,Chile,NA,Biobio,1556805,111,0,2490,13
2020-06-07,Chile,NA,Biobio,1556805,105,0,2595,13
2020-06-08,Chile,NA,Biobio,1556805,56,0,2651,13
2020-06-09,Chile,NA,Biobio,1556805,43,0,2694,13
2020-06-10,Chile,NA,Biobio,1556805,152,0,2846,13
2020-06-11,Chile,NA,Biobio,1556805,128,1,2974,13
2020-06-12,Chile,NA,Biobio,1556805,129,2,3103,14
2020-06-13,Chile,NA,Biobio,1556805,166,2,3269,16
2020-06-14,Chile,NA,Biobio,1556805,132,2,3401,18
2020-06-15,Chile,NA,Biobio,1556805,59,1,3460,19
2020-06-16,Chile,NA,Biobio,1556805,55,0,3515,19
2020-06-17,Chile,NA,Biobio,1556805,171,6,3686,25
2020-06-18,Chile,NA,Biobio,1556805,168,3,3854,28
2020-06-19,Chile,NA,Biobio,1556805,218,3,4072,31
2020-06-20,Chile,NA,Biobio,1556805,257,1,4329,32
2020-06-21,Chile,NA,Biobio,1556805,253,2,4582,34
2020-06-22,Chile,NA,Biobio,1556805,247,1,4829,35
2020-06-23,Chile,NA,Biobio,1556805,170,0,4999,35
2020-06-24,Chile,NA,Biobio,1556805,136,5,5135,40
2020-06-25,Chile,NA,Biobio,1556805,238,2,5373,42
2020-06-26,Chile,NA,Biobio,1556805,256,3,5629,45
2020-06-27,Chile,NA,Biobio,1556805,181,1,5810,46
2020-06-28,Chile,NA,Biobio,1556805,259,4,6069,50
2020-06-29,Chile,NA,Biobio,1556805,197,0,6266,50
2020-06-30,Chile,NA,Biobio,1556805,102,0,6368,50
2020-07-01,Chile,NA,Biobio,1556805,148,0,6516,50
2020-07-02,Chile,NA,Biobio,1556805,106,8,6622,58
2020-07-03,Chile,NA,Biobio,1556805,180,1,6802,59
2020-07-04,Chile,NA,Biobio,1556805,131,2,6933,61
2020-07-05,Chile,NA,Biobio,1556805,194,3,7127,64
2020-07-06,Chile,NA,Biobio,1556805,155,0,7282,64
2020-07-07,Chile,NA,Biobio,1556805,102,0,7384,64
2020-07-08,Chile,NA,Biobio,1556805,103,1,7487,65
2020-07-09,Chile,NA,Biobio,1556805,164,2,7651,67
2020-07-10,Chile,NA,Biobio,1556805,171,1,7822,68
2020-07-11,Chile,NA,Biobio,1556805,144,4,7966,72
2020-07-12,Chile,NA,Biobio,1556805,164,1,8130,73
2020-07-13,Chile,NA,Biobio,1556805,130,0,8260,73
2020-07-14,Chile,NA,Biobio,1556805,91,2,8351,75
2020-07-15,Chile,NA,Biobio,1556805,112,5,8463,80
2020-07-16,Chile,NA,Biobio,1556805,188,2,8651,82
2020-07-17,Chile,NA,Biobio,1556805,156,13,8807,95
2020-07-18,Chile,NA,Biobio,1556805,150,0,8957,95
2020-07-19,Chile,NA,Biobio,1556805,141,1,9098,96
2020-07-20,Chile,NA,Biobio,1556805,148,3,9246,99
2020-07-21,Chile,NA,Biobio,1556805,105,1,9351,100
2020-07-22,Chile,NA,Biobio,1556805,116,2,9467,102
2020-07-23,Chile,NA,Biobio,1556805,170,1,9637,103
2020-07-24,Chile,NA,Biobio,1556805,181,0,9818,103
2020-07-25,Chile,NA,Biobio,1556805,183,1,10001,104
2020-07-26,Chile,NA,Biobio,1556805,182,1,10183,105
2020-07-27,Chile,NA,Biobio,1556805,145,1,10328,106
2020-07-28,Chile,NA,Biobio,1556805,139,1,10467,107
2020-07-29,Chile,NA,Biobio,1556805,143,4,10610,111
2020-07-30,Chile,NA,Biobio,1556805,153,3,10763,114
2020-07-31,Chile,NA,Biobio,1556805,177,5,10940,119
2020-08-01,Chile,NA,Biobio,1556805,174,1,11114,120
2020-08-02,Chile,NA,Biobio,1556805,182,0,11296,120
2020-08-03,Chile,NA,Biobio,1556805,145,4,11441,124
2020-08-04,Chile,NA,Biobio,1556805,121,1,11562,125
2020-08-05,Chile,NA,Biobio,1556805,152,2,11714,127
2020-08-06,Chile,NA,Biobio,1556805,179,4,11893,131
2020-08-07,Chile,NA,Biobio,1556805,227,1,12120,132
2020-08-08,Chile,NA,Biobio,1556805,175,3,12295,135
2020-08-09,Chile,NA,Biobio,1556805,211,4,12506,139
2020-08-10,Chile,NA,Biobio,1556805,130,1,12636,140
2020-08-11,Chile,NA,Biobio,1556805,153,3,12789,143
2020-08-12,Chile,NA,Biobio,1556805,87,2,12876,145
2020-08-13,Chile,NA,Biobio,1556805,222,7,13098,152
2020-08-14,Chile,NA,Biobio,1556805,200,2,13298,154
2020-08-15,Chile,NA,Biobio,1556805,158,2,13456,156
2020-08-16,Chile,NA,Biobio,1556805,209,1,13665,157
2020-08-17,Chile,NA,Biobio,1556805,197,3,13862,160
2020-08-18,Chile,NA,Biobio,1556805,115,1,13977,161
2020-08-19,Chile,NA,Biobio,1556805,136,3,14113,164
2020-08-20,Chile,NA,Biobio,1556805,249,4,14362,168
2020-08-21,Chile,NA,Biobio,1556805,246,2,14608,170
2020-08-22,Chile,NA,Biobio,1556805,218,2,14826,172
2020-08-23,Chile,NA,Biobio,1556805,282,8,15108,180
2020-08-24,Chile,NA,Biobio,1556805,260,8,15368,188
2020-08-25,Chile,NA,Biobio,1556805,148,2,15516,190
2020-08-26,Chile,NA,Biobio,1556805,140,1,15656,191
2020-08-27,Chile,NA,Biobio,1556805,335,8,15991,199
2020-08-28,Chile,NA,Biobio,1556805,253,2,16244,201
2020-08-29,Chile,NA,Biobio,1556805,359,3,16603,204
2020-08-30,Chile,NA,Biobio,1556805,225,2,16828,206
2020-08-31,Chile,NA,Biobio,1556805,260,5,17088,211
2020-09-01,Chile,NA,Biobio,1556805,155,2,17243,213
2020-09-02,Chile,NA,Biobio,1556805,153,2,17396,215
2020-09-03,Chile,NA,Biobio,1556805,251,7,17647,222
2020-09-04,Chile,NA,Biobio,1556805,296,7,17943,229
2020-09-05,Chile,NA,Biobio,1556805,234,3,18177,232
2020-09-06,Chile,NA,Biobio,1556805,291,0,18468,232
2020-09-07,Chile,NA,Biobio,1556805,212,8,18680,240
2020-09-08,Chile,NA,Biobio,1556805,152,1,18832,241
2020-09-09,Chile,NA,Biobio,1556805,165,0,18997,241
2020-09-10,Chile,NA,Biobio,1556805,246,6,19243,247
2020-09-11,Chile,NA,Biobio,1556805,229,8,19472,255
2020-09-12,Chile,NA,Biobio,1556805,238,3,19710,258
2020-09-13,Chile,NA,Biobio,1556805,244,4,19954,262
2020-09-14,Chile,NA,Biobio,1556805,189,3,20143,265
2020-09-15,Chile,NA,Biobio,1556805,176,3,20319,268
2020-09-16,Chile,NA,Biobio,1556805,140,0,20459,268
2020-09-17,Chile,NA,Biobio,1556805,264,11,20723,279
2020-09-18,Chile,NA,Biobio,1556805,235,4,20958,283
2020-09-19,Chile,NA,Biobio,1556805,209,3,21167,286
2020-09-20,Chile,NA,Biobio,1556805,153,2,21320,288
2020-09-21,Chile,NA,Biobio,1556805,110,0,21430,288
2020-09-22,Chile,NA,Biobio,1556805,146,2,21576,290
2020-09-23,Chile,NA,Biobio,1556805,164,0,21740,290
2020-03-24,Chile,NA,Coquimbo,757586,5,0,11,0
2020-03-25,Chile,NA,Coquimbo,757586,1,0,12,0
2020-03-26,Chile,NA,Coquimbo,757586,1,0,13,0
2020-03-27,Chile,NA,Coquimbo,757586,1,0,14,0
2020-03-28,Chile,NA,Coquimbo,757586,1,0,15,0
2020-03-29,Chile,NA,Coquimbo,757586,3,0,18,0
2020-03-30,Chile,NA,Coquimbo,757586,9,0,27,0
2020-03-31,Chile,NA,Coquimbo,757586,1,0,28,0
2020-04-01,Chile,NA,Coquimbo,757586,2,0,30,0
2020-04-02,Chile,NA,Coquimbo,757586,4,0,34,0
2020-04-03,Chile,NA,Coquimbo,757586,1,0,35,0
2020-04-04,Chile,NA,Coquimbo,757586,9,0,44,0
2020-04-05,Chile,NA,Coquimbo,757586,6,0,50,0
2020-04-06,Chile,NA,Coquimbo,757586,1,0,51,0
2020-04-07,Chile,NA,Coquimbo,757586,1,0,52,0
2020-04-08,Chile,NA,Coquimbo,757586,4,0,56,0
2020-04-09,Chile,NA,Coquimbo,757586,5,0,61,0
2020-04-10,Chile,NA,Coquimbo,757586,0,0,61,0
2020-04-11,Chile,NA,Coquimbo,757586,3,0,64,0
2020-04-12,Chile,NA,Coquimbo,757586,2,0,66,0
2020-04-13,Chile,NA,Coquimbo,757586,0,0,66,0
2020-04-14,Chile,NA,Coquimbo,757586,0,0,66,0
2020-04-15,Chile,NA,Coquimbo,757586,0,0,66,0
2020-04-16,Chile,NA,Coquimbo,757586,2,0,68,0
2020-04-17,Chile,NA,Coquimbo,757586,0,0,68,0
2020-04-18,Chile,NA,Coquimbo,757586,0,0,68,0
2020-04-19,Chile,NA,Coquimbo,757586,0,0,68,0
2020-04-20,Chile,NA,Coquimbo,757586,1,0,69,0
2020-04-21,Chile,NA,Coquimbo,757586,0,0,69,0
2020-04-22,Chile,NA,Coquimbo,757586,1,0,70,0
2020-04-23,Chile,NA,Coquimbo,757586,0,0,70,0
2020-04-24,Chile,NA,Coquimbo,757586,2,0,72,0
2020-04-25,Chile,NA,Coquimbo,757586,1,0,73,0
2020-04-26,Chile,NA,Coquimbo,757586,0,0,73,0
2020-04-27,Chile,NA,Coquimbo,757586,1,0,74,0
2020-04-28,Chile,NA,Coquimbo,757586,0,0,74,0
2020-04-29,Chile,NA,Coquimbo,757586,2,0,76,0
2020-04-30,Chile,NA,Coquimbo,757586,0,0,76,0
2020-05-01,Chile,NA,Coquimbo,757586,1,0,77,0
2020-05-02,Chile,NA,Coquimbo,757586,1,0,78,0
2020-05-03,Chile,NA,Coquimbo,757586,10,0,88,0
2020-05-04,Chile,NA,Coquimbo,757586,3,0,91,0
2020-05-05,Chile,NA,Coquimbo,757586,6,0,97,0
2020-05-06,Chile,NA,Coquimbo,757586,0,0,97,0
2020-05-07,Chile,NA,Coquimbo,757586,3,0,100,0
2020-05-08,Chile,NA,Coquimbo,757586,11,0,111,0
2020-05-09,Chile,NA,Coquimbo,757586,18,0,129,0
2020-05-10,Chile,NA,Coquimbo,757586,6,1,135,1
2020-05-11,Chile,NA,Coquimbo,757586,5,0,140,1
2020-05-12,Chile,NA,Coquimbo,757586,8,0,148,1
2020-05-13,Chile,NA,Coquimbo,757586,5,0,153,1
2020-05-14,Chile,NA,Coquimbo,757586,12,0,165,1
2020-05-15,Chile,NA,Coquimbo,757586,15,0,180,1
2020-05-16,Chile,NA,Coquimbo,757586,7,1,187,2
2020-05-17,Chile,NA,Coquimbo,757586,7,0,194,2
2020-05-18,Chile,NA,Coquimbo,757586,18,0,212,2
2020-05-19,Chile,NA,Coquimbo,757586,27,0,239,2
2020-05-20,Chile,NA,Coquimbo,757586,24,0,263,2
2020-05-21,Chile,NA,Coquimbo,757586,5,0,268,2
2020-05-22,Chile,NA,Coquimbo,757586,13,0,281,2
2020-05-23,Chile,NA,Coquimbo,757586,13,0,294,2
2020-05-24,Chile,NA,Coquimbo,757586,29,0,323,2
2020-05-25,Chile,NA,Coquimbo,757586,15,0,338,2
2020-05-26,Chile,NA,Coquimbo,757586,46,0,384,2
2020-05-27,Chile,NA,Coquimbo,757586,71,0,455,2
2020-05-28,Chile,NA,Coquimbo,757586,27,0,482,2
2020-05-29,Chile,NA,Coquimbo,757586,55,0,537,2
2020-05-30,Chile,NA,Coquimbo,757586,60,0,597,2
2020-05-31,Chile,NA,Coquimbo,757586,31,0,628,2
2020-06-01,Chile,NA,Coquimbo,757586,40,0,668,2
2020-06-02,Chile,NA,Coquimbo,757586,19,0,687,2
2020-06-03,Chile,NA,Coquimbo,757586,31,2,718,4
2020-06-04,Chile,NA,Coquimbo,757586,54,0,772,4
2020-06-05,Chile,NA,Coquimbo,757586,60,1,832,5
2020-06-06,Chile,NA,Coquimbo,757586,66,0,898,5
2020-06-07,Chile,NA,Coquimbo,757586,92,0,990,5
2020-06-08,Chile,NA,Coquimbo,757586,133,1,1123,5
2020-06-09,Chile,NA,Coquimbo,757586,52,0,1175,5
2020-06-10,Chile,NA,Coquimbo,757586,81,1,1256,6
2020-06-11,Chile,NA,Coquimbo,757586,89,1,1345,7
2020-06-12,Chile,NA,Coquimbo,757586,93,0,1438,7
2020-06-13,Chile,NA,Coquimbo,757586,74,1,1512,8
2020-06-14,Chile,NA,Coquimbo,757586,44,2,1556,10
2020-06-15,Chile,NA,Coquimbo,757586,120,0,1676,10
2020-06-16,Chile,NA,Coquimbo,757586,44,0,1720,10
2020-06-17,Chile,NA,Coquimbo,757586,87,2,1807,12
2020-06-18,Chile,NA,Coquimbo,757586,96,3,1903,15
2020-06-19,Chile,NA,Coquimbo,757586,119,1,2022,16
2020-06-20,Chile,NA,Coquimbo,757586,78,0,2100,16
2020-06-21,Chile,NA,Coquimbo,757586,86,1,2186,17
2020-06-22,Chile,NA,Coquimbo,757586,69,0,2255,17
2020-06-23,Chile,NA,Coquimbo,757586,57,0,2312,17
2020-06-24,Chile,NA,Coquimbo,757586,54,1,2366,18
2020-06-25,Chile,NA,Coquimbo,757586,98,4,2464,22
2020-06-26,Chile,NA,Coquimbo,757586,69,1,2533,23
2020-06-27,Chile,NA,Coquimbo,757586,75,0,2608,23
2020-06-28,Chile,NA,Coquimbo,757586,76,0,2684,23
2020-06-29,Chile,NA,Coquimbo,757586,104,0,2788,23
2020-06-30,Chile,NA,Coquimbo,757586,89,0,2877,23
2020-07-01,Chile,NA,Coquimbo,757586,69,0,2946,23
2020-07-02,Chile,NA,Coquimbo,757586,51,1,2997,24
2020-07-03,Chile,NA,Coquimbo,757586,54,0,3051,24
2020-07-04,Chile,NA,Coquimbo,757586,109,2,3160,26
2020-07-05,Chile,NA,Coquimbo,757586,101,0,3261,26
2020-07-06,Chile,NA,Coquimbo,757586,111,0,3372,26
2020-07-07,Chile,NA,Coquimbo,757586,76,0,3448,26
2020-07-08,Chile,NA,Coquimbo,757586,67,1,3515,27
2020-07-09,Chile,NA,Coquimbo,757586,91,2,3606,29
2020-07-10,Chile,NA,Coquimbo,757586,139,0,3745,29
2020-07-11,Chile,NA,Coquimbo,757586,108,2,3853,31
2020-07-12,Chile,NA,Coquimbo,757586,77,2,3930,33
2020-07-13,Chile,NA,Coquimbo,757586,63,0,3993,33
2020-07-14,Chile,NA,Coquimbo,757586,13,0,4006,33
2020-07-15,Chile,NA,Coquimbo,757586,98,9,4104,42
2020-07-16,Chile,NA,Coquimbo,757586,74,0,4178,42
2020-07-17,Chile,NA,Coquimbo,757586,125,7,4303,49
2020-07-18,Chile,NA,Coquimbo,757586,87,3,4390,52
2020-07-19,Chile,NA,Coquimbo,757586,158,1,4548,53
2020-07-20,Chile,NA,Coquimbo,757586,126,1,4674,54
2020-07-21,Chile,NA,Coquimbo,757586,71,0,4745,54
2020-07-22,Chile,NA,Coquimbo,757586,68,0,4813,54
2020-07-23,Chile,NA,Coquimbo,757586,145,5,4958,59
2020-07-24,Chile,NA,Coquimbo,757586,152,1,5110,60
2020-07-25,Chile,NA,Coquimbo,757586,161,2,5271,62
2020-07-26,Chile,NA,Coquimbo,757586,161,0,5432,62
2020-07-27,Chile,NA,Coquimbo,757586,124,1,5556,63
2020-07-28,Chile,NA,Coquimbo,757586,105,0,5661,63
2020-07-29,Chile,NA,Coquimbo,757586,141,0,5802,63
2020-07-30,Chile,NA,Coquimbo,757586,104,3,5906,66
2020-07-31,Chile,NA,Coquimbo,757586,173,3,6079,69
2020-08-01,Chile,NA,Coquimbo,757586,88,5,6167,74
2020-08-02,Chile,NA,Coquimbo,757586,128,0,6295,74
2020-08-03,Chile,NA,Coquimbo,757586,82,1,6377,75
2020-08-04,Chile,NA,Coquimbo,757586,108,0,6485,75
2020-08-05,Chile,NA,Coquimbo,757586,81,1,6566,76
2020-08-06,Chile,NA,Coquimbo,757586,129,4,6695,80
2020-08-07,Chile,NA,Coquimbo,757586,114,1,6809,81
2020-08-08,Chile,NA,Coquimbo,757586,95,2,6904,83
2020-08-09,Chile,NA,Coquimbo,757586,146,1,7050,84
2020-08-10,Chile,NA,Coquimbo,757586,134,2,7184,86
2020-08-11,Chile,NA,Coquimbo,757586,101,3,7285,89
2020-08-12,Chile,NA,Coquimbo,757586,81,0,7366,89
2020-08-13,Chile,NA,Coquimbo,757586,146,4,7512,93
2020-08-14,Chile,NA,Coquimbo,757586,111,1,7623,94
2020-08-15,Chile,NA,Coquimbo,757586,175,1,7798,95
2020-08-16,Chile,NA,Coquimbo,757586,148,3,7946,98
2020-08-17,Chile,NA,Coquimbo,757586,101,2,8047,100
2020-08-18,Chile,NA,Coquimbo,757586,119,1,8166,101
2020-08-19,Chile,NA,Coquimbo,757586,94,0,8260,101
2020-08-20,Chile,NA,Coquimbo,757586,109,5,8369,106
2020-08-21,Chile,NA,Coquimbo,757586,105,3,8474,109
2020-08-22,Chile,NA,Coquimbo,757586,157,3,8631,112
2020-08-23,Chile,NA,Coquimbo,757586,197,4,8828,116
2020-08-24,Chile,NA,Coquimbo,757586,132,3,8960,119
2020-08-25,Chile,NA,Coquimbo,757586,98,0,9058,119
2020-08-26,Chile,NA,Coquimbo,757586,121,0,9179,119
2020-08-27,Chile,NA,Coquimbo,757586,100,6,9279,125
2020-08-28,Chile,NA,Coquimbo,757586,129,1,9408,126
2020-08-29,Chile,NA,Coquimbo,757586,58,4,9466,130
2020-08-30,Chile,NA,Coquimbo,757586,80,3,9546,133
2020-08-31,Chile,NA,Coquimbo,757586,132,3,9678,136
2020-09-01,Chile,NA,Coquimbo,757586,60,3,9738,139
2020-09-02,Chile,NA,Coquimbo,757586,112,0,9850,139
2020-09-03,Chile,NA,Coquimbo,757586,91,4,9941,143
2020-09-04,Chile,NA,Coquimbo,757586,91,6,10032,149
2020-09-05,Chile,NA,Coquimbo,757586,104,3,10136,152
2020-09-06,Chile,NA,Coquimbo,757586,85,2,10221,154
2020-09-07,Chile,NA,Coquimbo,757586,96,5,10317,159
2020-09-08,Chile,NA,Coquimbo,757586,53,0,10370,159
2020-09-09,Chile,NA,Coquimbo,757586,72,0,10442,159
2020-09-10,Chile,NA,Coquimbo,757586,78,9,10520,168
2020-09-11,Chile,NA,Coquimbo,757586,95,4,10615,172
2020-09-12,Chile,NA,Coquimbo,757586,121,3,10736,175
2020-09-13,Chile,NA,Coquimbo,757586,89,2,10825,177
2020-09-14,Chile,NA,Coquimbo,757586,79,1,10904,178
2020-09-15,Chile,NA,Coquimbo,757586,88,0,10992,178
2020-09-16,Chile,NA,Coquimbo,757586,39,0,11031,178
2020-09-17,Chile,NA,Coquimbo,757586,61,8,11092,186
2020-09-18,Chile,NA,Coquimbo,757586,76,3,11168,189
2020-09-19,Chile,NA,Coquimbo,757586,54,3,11222,192
2020-09-20,Chile,NA,Coquimbo,757586,33,2,11255,194
2020-09-21,Chile,NA,Coquimbo,757586,29,0,11284,194
2020-09-22,Chile,NA,Coquimbo,757586,19,0,11303,194
2020-09-23,Chile,NA,Coquimbo,757586,22,0,11325,194
2020-03-19,Chile,NA,Los Lagos,828708,8,0,16,0
2020-03-20,Chile,NA,Los Lagos,828708,2,0,18,0
2020-03-21,Chile,NA,Los Lagos,828708,2,0,20,0
2020-03-22,Chile,NA,Los Lagos,828708,3,0,23,0
2020-03-23,Chile,NA,Los Lagos,828708,10,0,33,0
2020-03-24,Chile,NA,Los Lagos,828708,3,0,36,0
2020-03-25,Chile,NA,Los Lagos,828708,8,0,44,0
2020-03-26,Chile,NA,Los Lagos,828708,16,0,60,0
2020-03-27,Chile,NA,Los Lagos,828708,3,0,63,0
2020-03-28,Chile,NA,Los Lagos,828708,30,0,93,0
2020-03-29,Chile,NA,Los Lagos,828708,11,0,104,0
2020-03-30,Chile,NA,Los Lagos,828708,24,0,128,0
2020-03-31,Chile,NA,Los Lagos,828708,23,0,151,0
2020-04-01,Chile,NA,Los Lagos,828708,30,0,181,0
2020-04-02,Chile,NA,Los Lagos,828708,22,0,203,0
2020-04-03,Chile,NA,Los Lagos,828708,31,0,234,0
2020-04-04,Chile,NA,Los Lagos,828708,25,0,259,0
2020-04-05,Chile,NA,Los Lagos,828708,17,1,276,1
2020-04-06,Chile,NA,Los Lagos,828708,10,1,286,2
2020-04-07,Chile,NA,Los Lagos,828708,13,0,299,2
2020-04-08,Chile,NA,Los Lagos,828708,26,0,325,2
2020-04-09,Chile,NA,Los Lagos,828708,15,0,340,2
2020-04-10,Chile,NA,Los Lagos,828708,9,0,349,2
2020-04-11,Chile,NA,Los Lagos,828708,15,3,364,5
2020-04-12,Chile,NA,Los Lagos,828708,8,0,372,5
2020-04-13,Chile,NA,Los Lagos,828708,8,0,380,5
2020-04-14,Chile,NA,Los Lagos,828708,5,0,385,5
2020-04-15,Chile,NA,Los Lagos,828708,5,0,390,5
2020-04-16,Chile,NA,Los Lagos,828708,9,0,399,5
2020-04-17,Chile,NA,Los Lagos,828708,13,1,412,6
2020-04-18,Chile,NA,Los Lagos,828708,4,0,416,6
2020-04-19,Chile,NA,Los Lagos,828708,5,0,421,6
2020-04-20,Chile,NA,Los Lagos,828708,3,0,424,6
2020-04-21,Chile,NA,Los Lagos,828708,8,0,432,6
2020-04-22,Chile,NA,Los Lagos,828708,13,0,445,6
2020-04-23,Chile,NA,Los Lagos,828708,9,1,454,7
2020-04-24,Chile,NA,Los Lagos,828708,6,1,460,8
2020-04-25,Chile,NA,Los Lagos,828708,5,0,465,8
2020-04-26,Chile,NA,Los Lagos,828708,8,0,473,8
2020-04-27,Chile,NA,Los Lagos,828708,4,0,477,8
2020-04-28,Chile,NA,Los Lagos,828708,0,1,477,9
2020-04-29,Chile,NA,Los Lagos,828708,4,0,481,9
2020-04-30,Chile,NA,Los Lagos,828708,6,1,487,10
2020-05-01,Chile,NA,Los Lagos,828708,14,0,501,10
2020-05-02,Chile,NA,Los Lagos,828708,12,0,513,10
2020-05-03,Chile,NA,Los Lagos,828708,4,0,517,10
2020-05-04,Chile,NA,Los Lagos,828708,7,0,524,10
2020-05-05,Chile,NA,Los Lagos,828708,1,0,525,10
2020-05-06,Chile,NA,Los Lagos,828708,16,0,541,10
2020-05-07,Chile,NA,Los Lagos,828708,4,0,545,10
2020-05-08,Chile,NA,Los Lagos,828708,3,0,548,10
2020-05-09,Chile,NA,Los Lagos,828708,11,0,559,10
2020-05-10,Chile,NA,Los Lagos,828708,16,0,575,10
2020-05-11,Chile,NA,Los Lagos,828708,17,0,592,10
2020-05-12,Chile,NA,Los Lagos,828708,2,1,594,11
2020-05-13,Chile,NA,Los Lagos,828708,34,0,628,11
2020-05-14,Chile,NA,Los Lagos,828708,5,0,633,11
2020-05-15,Chile,NA,Los Lagos,828708,8,0,641,11
2020-05-16,Chile,NA,Los Lagos,828708,3,0,644,11
2020-05-17,Chile,NA,Los Lagos,828708,3,0,647,11
2020-05-18,Chile,NA,Los Lagos,828708,5,0,652,11
2020-05-19,Chile,NA,Los Lagos,828708,4,1,656,12
2020-05-20,Chile,NA,Los Lagos,828708,10,0,666,12
2020-05-21,Chile,NA,Los Lagos,828708,27,1,693,13
2020-05-22,Chile,NA,Los Lagos,828708,24,0,717,13
2020-05-23,Chile,NA,Los Lagos,828708,10,0,727,13
2020-05-24,Chile,NA,Los Lagos,828708,9,0,736,13
2020-05-25,Chile,NA,Los Lagos,828708,27,0,763,13
2020-05-26,Chile,NA,Los Lagos,828708,18,0,781,13
2020-05-27,Chile,NA,Los Lagos,828708,10,0,791,13
2020-05-28,Chile,NA,Los Lagos,828708,23,0,814,13
2020-05-29,Chile,NA,Los Lagos,828708,8,0,822,13
2020-05-30,Chile,NA,Los Lagos,828708,38,0,860,13
2020-05-31,Chile,NA,Los Lagos,828708,3,0,863,13
2020-06-01,Chile,NA,Los Lagos,828708,0,0,863,13
2020-06-02,Chile,NA,Los Lagos,828708,31,0,894,13
2020-06-03,Chile,NA,Los Lagos,828708,19,0,913,13
2020-06-04,Chile,NA,Los Lagos,828708,13,0,926,13
2020-06-05,Chile,NA,Los Lagos,828708,42,0,968,13
2020-06-06,Chile,NA,Los Lagos,828708,17,0,985,13
2020-06-07,Chile,NA,Los Lagos,828708,18,0,1003,13
2020-06-08,Chile,NA,Los Lagos,828708,7,0,1010,13
2020-06-09,Chile,NA,Los Lagos,828708,18,0,1028,13
2020-06-10,Chile,NA,Los Lagos,828708,13,0,1041,13
2020-06-11,Chile,NA,Los Lagos,828708,21,0,1062,13
2020-06-12,Chile,NA,Los Lagos,828708,21,0,1083,13
2020-06-13,Chile,NA,Los Lagos,828708,25,1,1108,13
2020-06-14,Chile,NA,Los Lagos,828708,33,0,1141,13
2020-06-15,Chile,NA,Los Lagos,828708,27,0,1168,13
2020-06-16,Chile,NA,Los Lagos,828708,10,0,1178,13
2020-06-17,Chile,NA,Los Lagos,828708,39,1,1217,14
2020-06-18,Chile,NA,Los Lagos,828708,14,0,1231,14
2020-06-19,Chile,NA,Los Lagos,828708,35,0,1266,14
2020-06-20,Chile,NA,Los Lagos,828708,37,1,1303,15
2020-06-21,Chile,NA,Los Lagos,828708,50,2,1353,17
2020-06-22,Chile,NA,Los Lagos,828708,52,0,1405,17
2020-06-23,Chile,NA,Los Lagos,828708,29,0,1434,17
2020-06-24,Chile,NA,Los Lagos,828708,17,1,1451,18
2020-06-25,Chile,NA,Los Lagos,828708,22,1,1473,19
2020-06-26,Chile,NA,Los Lagos,828708,36,1,1509,20
2020-06-27,Chile,NA,Los Lagos,828708,32,0,1541,20
2020-06-28,Chile,NA,Los Lagos,828708,36,1,1577,21
2020-06-29,Chile,NA,Los Lagos,828708,33,0,1610,21
2020-06-30,Chile,NA,Los Lagos,828708,14,0,1624,21
2020-07-01,Chile,NA,Los Lagos,828708,28,0,1652,21
2020-07-02,Chile,NA,Los Lagos,828708,50,0,1702,21
2020-07-03,Chile,NA,Los Lagos,828708,72,0,1774,21
2020-07-04,Chile,NA,Los Lagos,828708,50,0,1824,21
2020-07-05,Chile,NA,Los Lagos,828708,74,0,1898,21
2020-07-06,Chile,NA,Los Lagos,828708,26,0,1924,21
2020-07-07,Chile,NA,Los Lagos,828708,22,0,1946,21
2020-07-08,Chile,NA,Los Lagos,828708,69,0,2015,21
2020-07-09,Chile,NA,Los Lagos,828708,52,1,2067,22
2020-07-10,Chile,NA,Los Lagos,828708,47,0,2114,22
2020-07-11,Chile,NA,Los Lagos,828708,76,0,2190,22
2020-07-12,Chile,NA,Los Lagos,828708,64,1,2254,23
2020-07-13,Chile,NA,Los Lagos,828708,45,0,2299,23
2020-07-14,Chile,NA,Los Lagos,828708,71,0,2370,23
2020-07-15,Chile,NA,Los Lagos,828708,54,1,2424,24
2020-07-16,Chile,NA,Los Lagos,828708,65,1,2489,25
2020-07-17,Chile,NA,Los Lagos,828708,65,5,2554,30
2020-07-18,Chile,NA,Los Lagos,828708,23,2,2577,32
2020-07-19,Chile,NA,Los Lagos,828708,100,0,2677,32
2020-07-20,Chile,NA,Los Lagos,828708,23,0,2700,32
2020-07-21,Chile,NA,Los Lagos,828708,74,0,2774,32
2020-07-22,Chile,NA,Los Lagos,828708,73,0,2847,32
2020-07-23,Chile,NA,Los Lagos,828708,75,1,2922,33
2020-07-24,Chile,NA,Los Lagos,828708,115,0,3037,33
2020-07-25,Chile,NA,Los Lagos,828708,131,0,3168,33
2020-07-26,Chile,NA,Los Lagos,828708,142,1,3310,34
2020-07-27,Chile,NA,Los Lagos,828708,122,0,3432,34
2020-07-28,Chile,NA,Los Lagos,828708,111,0,3543,34
2020-07-29,Chile,NA,Los Lagos,828708,67,0,3610,34
2020-07-30,Chile,NA,Los Lagos,828708,83,2,3693,36
2020-07-31,Chile,NA,Los Lagos,828708,122,3,3815,39
2020-08-01,Chile,NA,Los Lagos,828708,142,2,3957,41
2020-08-02,Chile,NA,Los Lagos,828708,132,1,4089,42
2020-08-03,Chile,NA,Los Lagos,828708,62,0,4151,42
2020-08-04,Chile,NA,Los Lagos,828708,123,1,4274,43
2020-08-05,Chile,NA,Los Lagos,828708,92,0,4366,43
2020-08-06,Chile,NA,Los Lagos,828708,96,6,4462,49
2020-08-07,Chile,NA,Los Lagos,828708,137,2,4599,51
2020-08-08,Chile,NA,Los Lagos,828708,114,1,4713,52
2020-08-09,Chile,NA,Los Lagos,828708,128,2,4841,54
2020-08-10,Chile,NA,Los Lagos,828708,72,0,4913,54
2020-08-11,Chile,NA,Los Lagos,828708,49,0,4962,54
2020-08-12,Chile,NA,Los Lagos,828708,95,0,5057,54
2020-08-13,Chile,NA,Los Lagos,828708,75,0,5132,54
2020-08-14,Chile,NA,Los Lagos,828708,102,2,5234,56
2020-08-15,Chile,NA,Los Lagos,828708,90,0,5324,56
2020-08-16,Chile,NA,Los Lagos,828708,123,0,5447,56
2020-08-17,Chile,NA,Los Lagos,828708,48,1,5495,57
2020-08-18,Chile,NA,Los Lagos,828708,64,0,5559,57
2020-08-19,Chile,NA,Los Lagos,828708,57,0,5616,57
2020-08-20,Chile,NA,Los Lagos,828708,98,3,5714,60
2020-08-21,Chile,NA,Los Lagos,828708,84,1,5798,61
2020-08-22,Chile,NA,Los Lagos,828708,70,2,5868,63
2020-08-23,Chile,NA,Los Lagos,828708,98,0,5966,63
2020-08-24,Chile,NA,Los Lagos,828708,56,3,6022,66
2020-08-25,Chile,NA,Los Lagos,828708,38,0,6060,66
2020-08-26,Chile,NA,Los Lagos,828708,64,0,6124,66
2020-08-27,Chile,NA,Los Lagos,828708,49,0,6173,66
2020-08-28,Chile,NA,Los Lagos,828708,108,0,6281,66
2020-08-29,Chile,NA,Los Lagos,828708,69,1,6350,67
2020-08-30,Chile,NA,Los Lagos,828708,109,0,6459,67
2020-08-31,Chile,NA,Los Lagos,828708,51,1,6510,68
2020-09-01,Chile,NA,Los Lagos,828708,51,0,6561,68
2020-09-02,Chile,NA,Los Lagos,828708,84,0,6645,68
2020-09-03,Chile,NA,Los Lagos,828708,51,2,6696,70
2020-09-04,Chile,NA,Los Lagos,828708,67,2,6763,72
2020-09-05,Chile,NA,Los Lagos,828708,87,0,6850,72
2020-09-06,Chile,NA,Los Lagos,828708,141,0,6991,72
2020-09-07,Chile,NA,Los Lagos,828708,47,0,7038,72
2020-09-08,Chile,NA,Los Lagos,828708,33,0,7071,72
2020-09-09,Chile,NA,Los Lagos,828708,55,0,7126,72
2020-09-10,Chile,NA,Los Lagos,828708,37,2,7163,74
2020-09-11,Chile,NA,Los Lagos,828708,110,2,7273,76
2020-09-12,Chile,NA,Los Lagos,828708,82,1,7355,77
2020-09-13,Chile,NA,Los Lagos,828708,65,1,7420,78
2020-09-14,Chile,NA,Los Lagos,828708,64,3,7484,81
2020-09-15,Chile,NA,Los Lagos,828708,94,0,7578,81
2020-09-16,Chile,NA,Los Lagos,828708,42,0,7620,81
2020-09-17,Chile,NA,Los Lagos,828708,100,3,7720,84
2020-09-18,Chile,NA,Los Lagos,828708,70,0,7790,84
2020-09-19,Chile,NA,Los Lagos,828708,199,1,7989,85
2020-09-20,Chile,NA,Los Lagos,828708,101,2,8090,87
2020-09-21,Chile,NA,Los Lagos,828708,37,0,8127,87
2020-09-22,Chile,NA,Los Lagos,828708,54,0,8181,87
2020-09-23,Chile,NA,Los Lagos,828708,55,0,8236,87
2020-03-25,Chile,NA,Los Rios,384837,5,0,11,0
2020-03-26,Chile,NA,Los Rios,384837,3,0,14,0
2020-03-27,Chile,NA,Los Rios,384837,8,0,22,0
2020-03-28,Chile,NA,Los Rios,384837,5,0,27,0
2020-03-29,Chile,NA,Los Rios,384837,13,0,40,0
2020-03-30,Chile,NA,Los Rios,384837,7,0,47,0
2020-03-31,Chile,NA,Los Rios,384837,11,0,58,0
2020-04-01,Chile,NA,Los Rios,384837,6,1,64,1
2020-04-02,Chile,NA,Los Rios,384837,4,0,68,1
2020-04-03,Chile,NA,Los Rios,384837,10,0,78,1
2020-04-04,Chile,NA,Los Rios,384837,11,0,89,1
2020-04-05,Chile,NA,Los Rios,384837,10,0,99,1
2020-04-06,Chile,NA,Los Rios,384837,5,0,104,1
2020-04-07,Chile,NA,Los Rios,384837,5,1,109,2
2020-04-08,Chile,NA,Los Rios,384837,5,0,114,2
2020-04-09,Chile,NA,Los Rios,384837,4,0,118,2
2020-04-10,Chile,NA,Los Rios,384837,6,0,124,2
2020-04-11,Chile,NA,Los Rios,384837,6,0,130,2
2020-04-12,Chile,NA,Los Rios,384837,5,1,135,3
2020-04-13,Chile,NA,Los Rios,384837,3,0,138,3
2020-04-14,Chile,NA,Los Rios,384837,10,0,148,3
2020-04-15,Chile,NA,Los Rios,384837,2,0,150,3
2020-04-16,Chile,NA,Los Rios,384837,3,0,153,3
2020-04-17,Chile,NA,Los Rios,384837,1,0,154,3
2020-04-18,Chile,NA,Los Rios,384837,2,0,156,3
2020-04-19,Chile,NA,Los Rios,384837,1,0,157,3
2020-04-20,Chile,NA,Los Rios,384837,5,0,162,3
2020-04-21,Chile,NA,Los Rios,384837,5,0,167,3
2020-04-22,Chile,NA,Los Rios,384837,4,0,171,3
2020-04-23,Chile,NA,Los Rios,384837,2,0,173,3
2020-04-24,Chile,NA,Los Rios,384837,1,0,174,3
2020-04-25,Chile,NA,Los Rios,384837,3,0,177,3
2020-04-26,Chile,NA,Los Rios,384837,1,0,178,3
2020-04-27,Chile,NA,Los Rios,384837,2,0,180,3
2020-04-28,Chile,NA,Los Rios,384837,0,1,180,4
2020-04-29,Chile,NA,Los Rios,384837,2,0,182,4
2020-04-30,Chile,NA,Los Rios,384837,7,0,189,4
2020-05-01,Chile,NA,Los Rios,384837,0,0,189,4
2020-05-02,Chile,NA,Los Rios,384837,7,0,196,4
2020-05-03,Chile,NA,Los Rios,384837,2,0,198,4
2020-05-04,Chile,NA,Los Rios,384837,1,0,199,4
2020-05-05,Chile,NA,Los Rios,384837,0,0,199,4
2020-05-06,Chile,NA,Los Rios,384837,1,0,200,4
2020-05-07,Chile,NA,Los Rios,384837,2,0,202,4
2020-05-08,Chile,NA,Los Rios,384837,1,0,203,4
2020-05-09,Chile,NA,Los Rios,384837,3,1,206,5
2020-05-10,Chile,NA,Los Rios,384837,0,0,206,5
2020-05-11,Chile,NA,Los Rios,384837,2,0,208,5
2020-05-12,Chile,NA,Los Rios,384837,3,0,211,5
2020-05-13,Chile,NA,Los Rios,384837,1,1,212,6
2020-05-14,Chile,NA,Los Rios,384837,2,0,214,6
2020-05-15,Chile,NA,Los Rios,384837,5,0,219,6
2020-05-16,Chile,NA,Los Rios,384837,0,0,219,6
2020-05-17,Chile,NA,Los Rios,384837,1,0,220,6
2020-05-18,Chile,NA,Los Rios,384837,4,0,224,6
2020-05-19,Chile,NA,Los Rios,384837,5,0,229,6
2020-05-20,Chile,NA,Los Rios,384837,18,0,247,6
2020-05-21,Chile,NA,Los Rios,384837,11,0,258,6
2020-05-22,Chile,NA,Los Rios,384837,4,0,262,6
2020-05-23,Chile,NA,Los Rios,384837,12,0,274,6
2020-05-24,Chile,NA,Los Rios,384837,16,0,290,6
2020-05-25,Chile,NA,Los Rios,384837,7,0,297,6
2020-05-26,Chile,NA,Los Rios,384837,7,0,304,6
2020-05-27,Chile,NA,Los Rios,384837,5,0,309,6
2020-05-28,Chile,NA,Los Rios,384837,9,0,318,6
2020-05-29,Chile,NA,Los Rios,384837,12,0,330,6
2020-05-30,Chile,NA,Los Rios,384837,15,0,345,6
2020-05-31,Chile,NA,Los Rios,384837,11,0,356,6
2020-06-01,Chile,NA,Los Rios,384837,7,1,363,7
2020-06-02,Chile,NA,Los Rios,384837,5,0,368,7
2020-06-03,Chile,NA,Los Rios,384837,4,1,372,8
2020-06-04,Chile,NA,Los Rios,384837,7,0,379,8
2020-06-05,Chile,NA,Los Rios,384837,11,0,390,8
2020-06-06,Chile,NA,Los Rios,384837,10,0,400,8
2020-06-07,Chile,NA,Los Rios,384837,17,0,417,8
2020-06-08,Chile,NA,Los Rios,384837,8,0,425,8
2020-06-09,Chile,NA,Los Rios,384837,21,0,446,8
2020-06-10,Chile,NA,Los Rios,384837,6,0,452,8
2020-06-11,Chile,NA,Los Rios,384837,10,0,462,8
2020-06-12,Chile,NA,Los Rios,384837,17,1,479,9
2020-06-13,Chile,NA,Los Rios,384837,8,0,487,9
2020-06-14,Chile,NA,Los Rios,384837,10,0,497,9
2020-06-15,Chile,NA,Los Rios,384837,32,0,529,9
2020-06-16,Chile,NA,Los Rios,384837,4,0,533,9
2020-06-17,Chile,NA,Los Rios,384837,8,1,541,10
2020-06-18,Chile,NA,Los Rios,384837,12,0,553,10
2020-06-19,Chile,NA,Los Rios,384837,12,0,565,10
2020-06-20,Chile,NA,Los Rios,384837,10,0,575,10
2020-06-21,Chile,NA,Los Rios,384837,21,0,596,10
2020-06-22,Chile,NA,Los Rios,384837,11,0,607,10
2020-06-23,Chile,NA,Los Rios,384837,4,0,611,10
2020-06-24,Chile,NA,Los Rios,384837,4,0,615,10
2020-06-25,Chile,NA,Los Rios,384837,12,0,627,10
2020-06-26,Chile,NA,Los Rios,384837,11,0,638,10
2020-06-27,Chile,NA,Los Rios,384837,7,0,645,10
2020-06-28,Chile,NA,Los Rios,384837,19,0,664,10
2020-06-29,Chile,NA,Los Rios,384837,11,0,675,10
2020-06-30,Chile,NA,Los Rios,384837,12,0,687,10
2020-07-01,Chile,NA,Los Rios,384837,5,0,692,10
2020-07-02,Chile,NA,Los Rios,384837,2,0,694,10
2020-07-03,Chile,NA,Los Rios,384837,5,0,699,10
2020-07-04,Chile,NA,Los Rios,384837,7,0,706,10
2020-07-05,Chile,NA,Los Rios,384837,4,0,710,10
2020-07-06,Chile,NA,Los Rios,384837,7,0,717,10
2020-07-07,Chile,NA,Los Rios,384837,4,0,721,10
2020-07-08,Chile,NA,Los Rios,384837,5,1,726,11
2020-07-09,Chile,NA,Los Rios,384837,13,0,739,11
2020-07-10,Chile,NA,Los Rios,384837,5,0,744,11
2020-07-11,Chile,NA,Los Rios,384837,7,0,751,11
2020-07-12,Chile,NA,Los Rios,384837,1,0,752,11
2020-07-13,Chile,NA,Los Rios,384837,3,0,755,11
2020-07-14,Chile,NA,Los Rios,384837,8,0,763,11
2020-07-15,Chile,NA,Los Rios,384837,4,0,767,11
2020-07-16,Chile,NA,Los Rios,384837,17,0,784,11
2020-07-17,Chile,NA,Los Rios,384837,24,2,808,13
2020-07-18,Chile,NA,Los Rios,384837,5,0,813,13
2020-07-19,Chile,NA,Los Rios,384837,8,0,821,13
2020-07-20,Chile,NA,Los Rios,384837,10,0,831,13
2020-07-21,Chile,NA,Los Rios,384837,4,0,835,13
2020-07-22,Chile,NA,Los Rios,384837,1,0,836,13
2020-07-23,Chile,NA,Los Rios,384837,7,0,843,13
2020-07-24,Chile,NA,Los Rios,384837,4,0,847,13
2020-07-25,Chile,NA,Los Rios,384837,8,0,855,13
2020-07-26,Chile,NA,Los Rios,384837,8,0,863,13
2020-07-27,Chile,NA,Los Rios,384837,7,0,870,13
2020-07-28,Chile,NA,Los Rios,384837,5,0,875,13
2020-07-29,Chile,NA,Los Rios,384837,3,0,878,13
2020-07-30,Chile,NA,Los Rios,384837,7,0,885,13
2020-07-31,Chile,NA,Los Rios,384837,6,1,891,14
2020-08-01,Chile,NA,Los Rios,384837,1,0,892,14
2020-08-02,Chile,NA,Los Rios,384837,6,0,898,14
2020-08-03,Chile,NA,Los Rios,384837,8,0,906,14
2020-08-04,Chile,NA,Los Rios,384837,4,0,910,14
2020-08-05,Chile,NA,Los Rios,384837,5,0,915,14
2020-08-06,Chile,NA,Los Rios,384837,5,0,920,14
2020-08-07,Chile,NA,Los Rios,384837,4,1,924,15
2020-08-08,Chile,NA,Los Rios,384837,14,0,938,15
2020-08-09,Chile,NA,Los Rios,384837,4,0,942,15
2020-08-10,Chile,NA,Los Rios,384837,13,0,955,15
2020-08-11,Chile,NA,Los Rios,384837,13,0,968,15
2020-08-12,Chile,NA,Los Rios,384837,6,0,974,15
2020-08-13,Chile,NA,Los Rios,384837,9,0,983,15
2020-08-14,Chile,NA,Los Rios,384837,6,0,989,15
2020-08-15,Chile,NA,Los Rios,384837,3,0,992,15
2020-08-16,Chile,NA,Los Rios,384837,6,0,998,15
2020-08-17,Chile,NA,Los Rios,384837,2,0,1000,15
2020-08-18,Chile,NA,Los Rios,384837,2,0,1002,15
2020-08-19,Chile,NA,Los Rios,384837,2,0,1004,15
2020-08-20,Chile,NA,Los Rios,384837,4,0,1008,15
2020-08-21,Chile,NA,Los Rios,384837,8,0,1016,15
2020-08-22,Chile,NA,Los Rios,384837,10,0,1026,15
2020-08-23,Chile,NA,Los Rios,384837,17,0,1043,15
2020-08-24,Chile,NA,Los Rios,384837,5,0,1048,15
2020-08-25,Chile,NA,Los Rios,384837,4,0,1052,15
2020-08-26,Chile,NA,Los Rios,384837,3,0,1055,15
2020-08-27,Chile,NA,Los Rios,384837,11,0,1066,15
2020-08-28,Chile,NA,Los Rios,384837,6,0,1072,15
2020-08-29,Chile,NA,Los Rios,384837,5,0,1077,15
2020-08-30,Chile,NA,Los Rios,384837,7,0,1084,15
2020-08-31,Chile,NA,Los Rios,384837,17,0,1101,15
2020-09-01,Chile,NA,Los Rios,384837,10,0,1111,15
2020-09-02,Chile,NA,Los Rios,384837,4,0,1115,15
2020-09-03,Chile,NA,Los Rios,384837,27,0,1142,15
2020-09-04,Chile,NA,Los Rios,384837,11,0,1153,15
2020-09-05,Chile,NA,Los Rios,384837,15,0,1168,15
2020-09-06,Chile,NA,Los Rios,384837,16,0,1184,15
2020-09-07,Chile,NA,Los Rios,384837,17,0,1201,15
2020-09-08,Chile,NA,Los Rios,384837,11,0,1212,15
2020-09-09,Chile,NA,Los Rios,384837,28,0,1240,15
2020-09-10,Chile,NA,Los Rios,384837,22,0,1262,15
2020-09-11,Chile,NA,Los Rios,384837,30,0,1292,15
2020-09-12,Chile,NA,Los Rios,384837,39,0,1331,15
2020-09-13,Chile,NA,Los Rios,384837,47,0,1378,15
2020-09-14,Chile,NA,Los Rios,384837,27,0,1405,15
2020-09-15,Chile,NA,Los Rios,384837,20,0,1425,15
2020-09-16,Chile,NA,Los Rios,384837,16,0,1441,15
2020-09-17,Chile,NA,Los Rios,384837,18,0,1459,15
2020-09-18,Chile,NA,Los Rios,384837,17,0,1476,15
2020-09-19,Chile,NA,Los Rios,384837,9,0,1485,15
2020-09-20,Chile,NA,Los Rios,384837,14,1,1499,16
2020-09-21,Chile,NA,Los Rios,384837,40,0,1539,16
2020-09-22,Chile,NA,Los Rios,384837,12,0,1551,16
2020-09-23,Chile,NA,Los Rios,384837,26,0,1577,16
2020-03-25,Chile,NA,Magallanes,166533,5,0,13,0
2020-03-26,Chile,NA,Magallanes,166533,6,0,19,0
2020-03-27,Chile,NA,Magallanes,166533,3,0,22,0
2020-03-28,Chile,NA,Magallanes,166533,4,0,26,0
2020-03-29,Chile,NA,Magallanes,166533,13,0,39,0
2020-03-30,Chile,NA,Magallanes,166533,0,0,39,0
2020-03-31,Chile,NA,Magallanes,166533,24,0,63,0
2020-04-01,Chile,NA,Magallanes,166533,36,0,99,0
2020-04-02,Chile,NA,Magallanes,166533,15,0,114,0
2020-04-03,Chile,NA,Magallanes,166533,42,1,156,1
2020-04-04,Chile,NA,Magallanes,166533,16,1,172,2
2020-04-05,Chile,NA,Magallanes,166533,18,0,190,2
2020-04-06,Chile,NA,Magallanes,166533,31,0,221,2
2020-04-07,Chile,NA,Magallanes,166533,19,0,240,2
2020-04-08,Chile,NA,Magallanes,166533,26,1,266,3
2020-04-09,Chile,NA,Magallanes,166533,20,0,286,3
2020-04-10,Chile,NA,Magallanes,166533,45,0,331,3
2020-04-11,Chile,NA,Magallanes,166533,46,0,377,3
2020-04-12,Chile,NA,Magallanes,166533,19,1,396,4
2020-04-13,Chile,NA,Magallanes,166533,19,1,415,5
2020-04-14,Chile,NA,Magallanes,166533,14,1,429,6
2020-04-15,Chile,NA,Magallanes,166533,15,0,444,6
2020-04-16,Chile,NA,Magallanes,166533,23,0,467,6
2020-04-17,Chile,NA,Magallanes,166533,34,0,501,6
2020-04-18,Chile,NA,Magallanes,166533,21,0,522,6
2020-04-19,Chile,NA,Magallanes,166533,31,0,553,6
2020-04-20,Chile,NA,Magallanes,166533,13,0,566,6
2020-04-21,Chile,NA,Magallanes,166533,27,1,593,7
2020-04-22,Chile,NA,Magallanes,166533,12,0,605,7
2020-04-23,Chile,NA,Magallanes,166533,10,0,615,7
2020-04-24,Chile,NA,Magallanes,166533,9,1,624,8
2020-04-25,Chile,NA,Magallanes,166533,31,0,655,8
2020-04-26,Chile,NA,Magallanes,166533,13,1,668,9
2020-04-27,Chile,NA,Magallanes,166533,3,1,671,10
2020-04-28,Chile,NA,Magallanes,166533,22,0,693,10
2020-04-29,Chile,NA,Magallanes,166533,21,1,714,11
2020-04-30,Chile,NA,Magallanes,166533,11,0,725,11
2020-05-01,Chile,NA,Magallanes,166533,1,0,726,11
2020-05-02,Chile,NA,Magallanes,166533,26,0,752,11
2020-05-03,Chile,NA,Magallanes,166533,25,0,777,11
2020-05-04,Chile,NA,Magallanes,166533,18,0,795,11
2020-05-05,Chile,NA,Magallanes,166533,14,0,809,11
2020-05-06,Chile,NA,Magallanes,166533,9,0,818,11
2020-05-07,Chile,NA,Magallanes,166533,18,0,836,11
2020-05-08,Chile,NA,Magallanes,166533,31,0,867,11
2020-05-09,Chile,NA,Magallanes,166533,14,0,881,11
2020-05-10,Chile,NA,Magallanes,166533,12,2,893,13
2020-05-11,Chile,NA,Magallanes,166533,8,1,901,14
2020-05-12,Chile,NA,Magallanes,166533,9,0,910,14
2020-05-13,Chile,NA,Magallanes,166533,11,2,921,16
2020-05-14,Chile,NA,Magallanes,166533,14,0,935,16
2020-05-15,Chile,NA,Magallanes,166533,2,0,937,16
2020-05-16,Chile,NA,Magallanes,166533,15,0,952,16
2020-05-17,Chile,NA,Magallanes,166533,9,0,961,16
2020-05-18,Chile,NA,Magallanes,166533,10,0,971,16
2020-05-19,Chile,NA,Magallanes,166533,1,1,972,17
2020-05-20,Chile,NA,Magallanes,166533,5,1,977,18
2020-05-21,Chile,NA,Magallanes,166533,10,0,987,18
2020-05-22,Chile,NA,Magallanes,166533,5,0,992,18
2020-05-23,Chile,NA,Magallanes,166533,5,0,997,18
2020-05-24,Chile,NA,Magallanes,166533,13,0,1010,18
2020-05-25,Chile,NA,Magallanes,166533,6,0,1016,18
2020-05-26,Chile,NA,Magallanes,166533,15,0,1031,18
2020-05-27,Chile,NA,Magallanes,166533,6,0,1037,18
2020-05-28,Chile,NA,Magallanes,166533,3,0,1040,18
2020-05-29,Chile,NA,Magallanes,166533,7,1,1047,19
2020-05-30,Chile,NA,Magallanes,166533,7,0,1054,19
2020-05-31,Chile,NA,Magallanes,166533,2,0,1056,19
2020-06-01,Chile,NA,Magallanes,166533,1,0,1057,19
2020-06-02,Chile,NA,Magallanes,166533,3,0,1060,19
2020-06-03,Chile,NA,Magallanes,166533,3,0,1063,19
2020-06-04,Chile,NA,Magallanes,166533,6,0,1069,19
2020-06-05,Chile,NA,Magallanes,166533,3,0,1072,19
2020-06-06,Chile,NA,Magallanes,166533,9,0,1081,19
2020-06-07,Chile,NA,Magallanes,166533,1,0,1082,19
2020-06-08,Chile,NA,Magallanes,166533,6,1,1088,19
2020-06-09,Chile,NA,Magallanes,166533,0,0,1088,19
2020-06-10,Chile,NA,Magallanes,166533,1,0,1089,19
2020-06-11,Chile,NA,Magallanes,166533,13,0,1102,19
2020-06-12,Chile,NA,Magallanes,166533,5,0,1107,19
2020-06-13,Chile,NA,Magallanes,166533,16,0,1123,19
2020-06-14,Chile,NA,Magallanes,166533,30,0,1153,19
2020-06-15,Chile,NA,Magallanes,166533,32,0,1185,19
2020-06-16,Chile,NA,Magallanes,166533,25,0,1210,19
2020-06-17,Chile,NA,Magallanes,166533,0,0,1210,19
2020-06-18,Chile,NA,Magallanes,166533,9,0,1219,19
2020-06-19,Chile,NA,Magallanes,166533,9,0,1228,19
2020-06-20,Chile,NA,Magallanes,166533,13,0,1241,19
2020-06-21,Chile,NA,Magallanes,166533,20,0,1261,19
2020-06-22,Chile,NA,Magallanes,166533,17,0,1278,19
2020-06-23,Chile,NA,Magallanes,166533,11,0,1289,19
2020-06-24,Chile,NA,Magallanes,166533,0,0,1289,19
2020-06-25,Chile,NA,Magallanes,166533,22,0,1311,19
2020-06-26,Chile,NA,Magallanes,166533,12,0,1323,19
2020-06-27,Chile,NA,Magallanes,166533,26,0,1349,19
2020-06-28,Chile,NA,Magallanes,166533,12,0,1361,19
2020-06-29,Chile,NA,Magallanes,166533,5,0,1366,19
2020-06-30,Chile,NA,Magallanes,166533,12,0,1378,19
2020-07-01,Chile,NA,Magallanes,166533,9,0,1387,19
2020-07-02,Chile,NA,Magallanes,166533,4,0,1391,19
2020-07-03,Chile,NA,Magallanes,166533,11,0,1402,19
2020-07-04,Chile,NA,Magallanes,166533,3,0,1405,19
2020-07-05,Chile,NA,Magallanes,166533,7,0,1412,19
2020-07-06,Chile,NA,Magallanes,166533,15,0,1427,19
2020-07-07,Chile,NA,Magallanes,166533,3,0,1430,19
2020-07-08,Chile,NA,Magallanes,166533,3,2,1433,19
2020-07-09,Chile,NA,Magallanes,166533,13,0,1446,19
2020-07-10,Chile,NA,Magallanes,166533,13,0,1459,19
2020-07-11,Chile,NA,Magallanes,166533,12,0,1471,19
2020-07-12,Chile,NA,Magallanes,166533,10,0,1481,19
2020-07-13,Chile,NA,Magallanes,166533,8,0,1489,19
2020-07-14,Chile,NA,Magallanes,166533,15,0,1504,19
2020-07-15,Chile,NA,Magallanes,166533,9,1,1513,19
2020-07-16,Chile,NA,Magallanes,166533,0,0,1513,19
2020-07-17,Chile,NA,Magallanes,166533,3,10,1516,28
2020-07-18,Chile,NA,Magallanes,166533,8,0,1524,28
2020-07-19,Chile,NA,Magallanes,166533,6,0,1530,28
2020-07-20,Chile,NA,Magallanes,166533,3,0,1533,28
2020-07-21,Chile,NA,Magallanes,166533,3,0,1536,28
2020-07-22,Chile,NA,Magallanes,166533,8,0,1544,28
2020-07-23,Chile,NA,Magallanes,166533,7,0,1551,28
2020-07-24,Chile,NA,Magallanes,166533,4,0,1555,28
2020-07-25,Chile,NA,Magallanes,166533,3,0,1558,28
2020-07-26,Chile,NA,Magallanes,166533,9,0,1567,28
2020-07-27,Chile,NA,Magallanes,166533,14,0,1581,28
2020-07-28,Chile,NA,Magallanes,166533,26,0,1607,28
2020-07-29,Chile,NA,Magallanes,166533,4,0,1611,28
2020-07-30,Chile,NA,Magallanes,166533,56,0,1667,28
2020-07-31,Chile,NA,Magallanes,166533,19,0,1686,28
2020-08-01,Chile,NA,Magallanes,166533,20,0,1706,28
2020-08-02,Chile,NA,Magallanes,166533,24,0,1730,28
2020-08-03,Chile,NA,Magallanes,166533,23,1,1753,29
2020-08-04,Chile,NA,Magallanes,166533,36,0,1789,29
2020-08-05,Chile,NA,Magallanes,166533,27,0,1816,29
2020-08-06,Chile,NA,Magallanes,166533,43,0,1859,29
2020-08-07,Chile,NA,Magallanes,166533,8,1,1867,30
2020-08-08,Chile,NA,Magallanes,166533,49,0,1916,30
2020-08-09,Chile,NA,Magallanes,166533,27,0,1943,30
2020-08-10,Chile,NA,Magallanes,166533,55,0,1998,30
2020-08-11,Chile,NA,Magallanes,166533,36,0,2034,30
2020-08-12,Chile,NA,Magallanes,166533,19,0,2053,30
2020-08-13,Chile,NA,Magallanes,166533,18,0,2071,30
2020-08-14,Chile,NA,Magallanes,166533,50,0,2121,30
2020-08-15,Chile,NA,Magallanes,166533,54,0,2175,30
2020-08-16,Chile,NA,Magallanes,166533,67,0,2242,30
2020-08-17,Chile,NA,Magallanes,166533,22,0,2264,30
2020-08-18,Chile,NA,Magallanes,166533,68,0,2332,30
2020-08-19,Chile,NA,Magallanes,166533,36,0,2368,30
2020-08-20,Chile,NA,Magallanes,166533,65,2,2433,32
2020-08-21,Chile,NA,Magallanes,166533,92,0,2525,32
2020-08-22,Chile,NA,Magallanes,166533,80,0,2605,32
2020-08-23,Chile,NA,Magallanes,166533,115,0,2720,32
2020-08-24,Chile,NA,Magallanes,166533,120,2,2840,34
2020-08-25,Chile,NA,Magallanes,166533,95,0,2935,34
2020-08-26,Chile,NA,Magallanes,166533,59,0,2994,34
2020-08-27,Chile,NA,Magallanes,166533,147,1,3141,35
2020-08-28,Chile,NA,Magallanes,166533,58,0,3199,35
2020-08-29,Chile,NA,Magallanes,166533,106,3,3305,38
2020-08-30,Chile,NA,Magallanes,166533,104,0,3409,38
2020-08-31,Chile,NA,Magallanes,166533,113,1,3522,39
2020-09-01,Chile,NA,Magallanes,166533,113,1,3635,40
2020-09-02,Chile,NA,Magallanes,166533,132,0,3767,40
2020-09-03,Chile,NA,Magallanes,166533,116,3,3883,43
2020-09-04,Chile,NA,Magallanes,166533,107,1,3990,44
2020-09-05,Chile,NA,Magallanes,166533,206,1,4196,45
2020-09-06,Chile,NA,Magallanes,166533,139,0,4335,45
2020-09-07,Chile,NA,Magallanes,166533,225,0,4560,45
2020-09-08,Chile,NA,Magallanes,166533,102,1,4662,46
2020-09-09,Chile,NA,Magallanes,166533,65,0,4727,46
2020-09-10,Chile,NA,Magallanes,166533,59,2,4786,48
2020-09-11,Chile,NA,Magallanes,166533,112,2,4898,50
2020-09-12,Chile,NA,Magallanes,166533,262,0,5160,50
2020-09-13,Chile,NA,Magallanes,166533,234,2,5394,52
2020-09-14,Chile,NA,Magallanes,166533,113,3,5507,55
2020-09-15,Chile,NA,Magallanes,166533,84,0,5591,55
2020-09-16,Chile,NA,Magallanes,166533,168,0,5759,55
2020-09-17,Chile,NA,Magallanes,166533,230,6,5989,61
2020-09-18,Chile,NA,Magallanes,166533,108,1,6097,62
2020-09-19,Chile,NA,Magallanes,166533,165,2,6262,64
2020-09-20,Chile,NA,Magallanes,166533,203,1,6465,65
2020-09-21,Chile,NA,Magallanes,166533,248,0,6713,65
2020-09-22,Chile,NA,Magallanes,166533,137,0,6850,65
2020-09-23,Chile,NA,Magallanes,166533,128,0,6978,65
2020-03-19,Chile,NA,Maule,1044950,3,0,13,0
2020-03-20,Chile,NA,Maule,1044950,0,0,13,0
2020-03-21,Chile,NA,Maule,1044950,1,0,14,0
2020-03-22,Chile,NA,Maule,1044950,10,0,24,0
2020-03-23,Chile,NA,Maule,1044950,3,0,27,0
2020-03-24,Chile,NA,Maule,1044950,1,0,28,0
2020-03-25,Chile,NA,Maule,1044950,1,0,29,0
2020-03-26,Chile,NA,Maule,1044950,1,0,30,0
2020-03-27,Chile,NA,Maule,1044950,1,0,31,0
2020-03-28,Chile,NA,Maule,1044950,5,0,36,0
2020-03-29,Chile,NA,Maule,1044950,5,0,41,0
2020-03-30,Chile,NA,Maule,1044950,12,1,53,1
2020-03-31,Chile,NA,Maule,1044950,8,0,61,1
2020-04-01,Chile,NA,Maule,1044950,9,0,70,1
2020-04-02,Chile,NA,Maule,1044950,11,0,81,1
2020-04-03,Chile,NA,Maule,1044950,7,0,88,1
2020-04-04,Chile,NA,Maule,1044950,8,0,96,1
2020-04-05,Chile,NA,Maule,1044950,6,0,102,1
2020-04-06,Chile,NA,Maule,1044950,5,0,107,1
2020-04-07,Chile,NA,Maule,1044950,0,1,107,2
2020-04-08,Chile,NA,Maule,1044950,11,0,118,2
2020-04-09,Chile,NA,Maule,1044950,9,0,127,2
2020-04-10,Chile,NA,Maule,1044950,3,0,130,2
2020-04-11,Chile,NA,Maule,1044950,3,1,133,3
2020-04-12,Chile,NA,Maule,1044950,4,0,137,3
2020-04-13,Chile,NA,Maule,1044950,3,0,140,3
2020-04-14,Chile,NA,Maule,1044950,1,1,141,4
2020-04-15,Chile,NA,Maule,1044950,10,0,151,4
2020-04-16,Chile,NA,Maule,1044950,15,0,166,4
2020-04-17,Chile,NA,Maule,1044950,56,3,222,7
2020-04-18,Chile,NA,Maule,1044950,53,1,275,8
2020-04-19,Chile,NA,Maule,1044950,26,0,301,8
2020-04-20,Chile,NA,Maule,1044950,2,2,303,10
2020-04-21,Chile,NA,Maule,1044950,12,0,315,10
2020-04-22,Chile,NA,Maule,1044950,12,0,327,10
2020-04-23,Chile,NA,Maule,1044950,5,0,332,10
2020-04-24,Chile,NA,Maule,1044950,16,0,348,10
2020-04-25,Chile,NA,Maule,1044950,1,0,349,10
2020-04-26,Chile,NA,Maule,1044950,4,1,353,11
2020-04-27,Chile,NA,Maule,1044950,9,1,362,12
2020-04-28,Chile,NA,Maule,1044950,21,0,383,12
2020-04-29,Chile,NA,Maule,1044950,8,1,391,13
2020-04-30,Chile,NA,Maule,1044950,1,0,392,13
2020-05-01,Chile,NA,Maule,1044950,1,0,393,13
2020-05-02,Chile,NA,Maule,1044950,2,0,395,13
2020-05-03,Chile,NA,Maule,1044950,1,0,396,13
2020-05-04,Chile,NA,Maule,1044950,2,0,398,13
2020-05-05,Chile,NA,Maule,1044950,9,0,407,13
2020-05-06,Chile,NA,Maule,1044950,0,0,407,13
2020-05-07,Chile,NA,Maule,1044950,6,0,413,13
2020-05-08,Chile,NA,Maule,1044950,11,0,424,13
2020-05-09,Chile,NA,Maule,1044950,7,1,431,14
2020-05-10,Chile,NA,Maule,1044950,9,0,440,14
2020-05-11,Chile,NA,Maule,1044950,13,0,453,14
2020-05-12,Chile,NA,Maule,1044950,12,0,465,14
2020-05-13,Chile,NA,Maule,1044950,19,0,484,14
2020-05-14,Chile,NA,Maule,1044950,34,0,518,14
2020-05-15,Chile,NA,Maule,1044950,21,0,539,14
2020-05-16,Chile,NA,Maule,1044950,11,0,550,14
2020-05-17,Chile,NA,Maule,1044950,22,0,572,14
2020-05-18,Chile,NA,Maule,1044950,29,0,601,14
2020-05-19,Chile,NA,Maule,1044950,38,0,639,14
2020-05-20,Chile,NA,Maule,1044950,40,0,679,14
2020-05-21,Chile,NA,Maule,1044950,51,1,730,15
2020-05-22,Chile,NA,Maule,1044950,51,0,781,15
2020-05-23,Chile,NA,Maule,1044950,41,0,822,15
2020-05-24,Chile,NA,Maule,1044950,69,0,891,15
2020-05-25,Chile,NA,Maule,1044950,61,0,952,15
2020-05-26,Chile,NA,Maule,1044950,60,0,1012,15
2020-05-27,Chile,NA,Maule,1044950,53,0,1065,15
2020-05-28,Chile,NA,Maule,1044950,54,0,1119,15
2020-05-29,Chile,NA,Maule,1044950,60,0,1179,15
2020-05-30,Chile,NA,Maule,1044950,76,0,1255,15
2020-05-31,Chile,NA,Maule,1044950,41,0,1296,15
2020-06-01,Chile,NA,Maule,1044950,44,2,1340,17
2020-06-02,Chile,NA,Maule,1044950,40,0,1380,17
2020-06-03,Chile,NA,Maule,1044950,214,2,1594,19
2020-06-04,Chile,NA,Maule,1044950,137,2,1731,21
2020-06-05,Chile,NA,Maule,1044950,102,3,1833,24
2020-06-06,Chile,NA,Maule,1044950,135,0,1968,24
2020-06-07,Chile,NA,Maule,1044950,140,0,2108,24
2020-06-08,Chile,NA,Maule,1044950,67,0,2175,24
2020-06-09,Chile,NA,Maule,1044950,113,0,2288,24
2020-06-10,Chile,NA,Maule,1044950,151,0,2439,24
2020-06-11,Chile,NA,Maule,1044950,120,1,2559,24
2020-06-12,Chile,NA,Maule,1044950,131,0,2690,24
2020-06-13,Chile,NA,Maule,1044950,153,1,2843,24
2020-06-14,Chile,NA,Maule,1044950,153,3,2996,24
2020-06-15,Chile,NA,Maule,1044950,94,0,3090,24
2020-06-16,Chile,NA,Maule,1044950,98,0,3188,24
2020-06-17,Chile,NA,Maule,1044950,93,1,3281,24
2020-06-18,Chile,NA,Maule,1044950,206,1,3487,25
2020-06-19,Chile,NA,Maule,1044950,215,2,3702,27
2020-06-20,Chile,NA,Maule,1044950,151,5,3853,32
2020-06-21,Chile,NA,Maule,1044950,252,1,4105,33
2020-06-22,Chile,NA,Maule,1044950,145,0,4250,33
2020-06-23,Chile,NA,Maule,1044950,149,0,4399,33
2020-06-24,Chile,NA,Maule,1044950,153,3,4552,36
2020-06-25,Chile,NA,Maule,1044950,175,0,4727,36
2020-06-26,Chile,NA,Maule,1044950,181,3,4908,39
2020-06-27,Chile,NA,Maule,1044950,169,2,5077,41
2020-06-28,Chile,NA,Maule,1044950,140,7,5217,48
2020-06-29,Chile,NA,Maule,1044950,141,0,5358,48
2020-06-30,Chile,NA,Maule,1044950,86,0,5444,48
2020-07-01,Chile,NA,Maule,1044950,168,0,5612,48
2020-07-02,Chile,NA,Maule,1044950,103,5,5715,53
2020-07-03,Chile,NA,Maule,1044950,154,6,5869,59
2020-07-04,Chile,NA,Maule,1044950,170,6,6039,65
2020-07-05,Chile,NA,Maule,1044950,121,5,6160,70
2020-07-06,Chile,NA,Maule,1044950,113,3,6273,73
2020-07-07,Chile,NA,Maule,1044950,117,0,6390,73
2020-07-08,Chile,NA,Maule,1044950,86,5,6476,78
2020-07-09,Chile,NA,Maule,1044950,119,3,6595,81
2020-07-10,Chile,NA,Maule,1044950,133,5,6728,86
2020-07-11,Chile,NA,Maule,1044950,113,5,6841,91
2020-07-12,Chile,NA,Maule,1044950,107,3,6948,94
2020-07-13,Chile,NA,Maule,1044950,103,0,7051,94
2020-07-14,Chile,NA,Maule,1044950,85,0,7136,94
2020-07-15,Chile,NA,Maule,1044950,100,2,7236,96
2020-07-16,Chile,NA,Maule,1044950,144,3,7380,99
2020-07-17,Chile,NA,Maule,1044950,141,26,7521,125
2020-07-18,Chile,NA,Maule,1044950,79,2,7600,127
2020-07-19,Chile,NA,Maule,1044950,134,0,7734,127
2020-07-20,Chile,NA,Maule,1044950,67,4,7801,131
2020-07-21,Chile,NA,Maule,1044950,125,0,7926,131
2020-07-22,Chile,NA,Maule,1044950,77,0,8003,131
2020-07-23,Chile,NA,Maule,1044950,118,4,8121,135
2020-07-24,Chile,NA,Maule,1044950,112,1,8233,136
2020-07-25,Chile,NA,Maule,1044950,140,9,8373,145
2020-07-26,Chile,NA,Maule,1044950,122,9,8495,154
2020-07-27,Chile,NA,Maule,1044950,99,6,8594,160
2020-07-28,Chile,NA,Maule,1044950,44,4,8638,164
2020-07-29,Chile,NA,Maule,1044950,112,0,8750,164
2020-07-30,Chile,NA,Maule,1044950,113,10,8863,174
2020-07-31,Chile,NA,Maule,1044950,99,2,8962,176
2020-08-01,Chile,NA,Maule,1044950,60,2,9022,178
2020-08-02,Chile,NA,Maule,1044950,102,4,9124,182
2020-08-03,Chile,NA,Maule,1044950,73,11,9197,193
2020-08-04,Chile,NA,Maule,1044950,89,0,9286,193
2020-08-05,Chile,NA,Maule,1044950,61,0,9347,193
2020-08-06,Chile,NA,Maule,1044950,96,2,9443,195
2020-08-07,Chile,NA,Maule,1044950,122,2,9565,197
2020-08-08,Chile,NA,Maule,1044950,119,7,9684,204
2020-08-09,Chile,NA,Maule,1044950,97,0,9781,204
2020-08-10,Chile,NA,Maule,1044950,67,0,9848,204
2020-08-11,Chile,NA,Maule,1044950,64,0,9912,204
2020-08-12,Chile,NA,Maule,1044950,74,0,9986,204
2020-08-13,Chile,NA,Maule,1044950,84,12,10070,215
2020-08-14,Chile,NA,Maule,1044950,99,1,10169,216
2020-08-15,Chile,NA,Maule,1044950,98,2,10267,218
2020-08-16,Chile,NA,Maule,1044950,122,1,10389,219
2020-08-17,Chile,NA,Maule,1044950,70,6,10459,225
2020-08-18,Chile,NA,Maule,1044950,74,5,10533,230
2020-08-19,Chile,NA,Maule,1044950,77,0,10610,230
2020-08-20,Chile,NA,Maule,1044950,123,5,10733,235
2020-08-21,Chile,NA,Maule,1044950,107,0,10840,235
2020-08-22,Chile,NA,Maule,1044950,103,6,10943,241
2020-08-23,Chile,NA,Maule,1044950,99,5,11042,246
2020-08-24,Chile,NA,Maule,1044950,75,8,11117,254
2020-08-25,Chile,NA,Maule,1044950,71,0,11188,254
2020-08-26,Chile,NA,Maule,1044950,95,0,11283,254
2020-08-27,Chile,NA,Maule,1044950,86,2,11369,256
2020-08-28,Chile,NA,Maule,1044950,90,5,11459,261
2020-08-29,Chile,NA,Maule,1044950,101,0,11560,261
2020-08-30,Chile,NA,Maule,1044950,112,2,11672,263
2020-08-31,Chile,NA,Maule,1044950,79,0,11751,263
2020-09-01,Chile,NA,Maule,1044950,71,0,11822,263
2020-09-02,Chile,NA,Maule,1044950,76,0,11898,263
2020-09-03,Chile,NA,Maule,1044950,122,3,12020,266
2020-09-04,Chile,NA,Maule,1044950,173,4,12193,270
2020-09-05,Chile,NA,Maule,1044950,108,2,12301,272
2020-09-06,Chile,NA,Maule,1044950,133,1,12434,273
2020-09-07,Chile,NA,Maule,1044950,167,2,12601,275
2020-09-08,Chile,NA,Maule,1044950,73,2,12674,277
2020-09-09,Chile,NA,Maule,1044950,113,0,12787,277
2020-09-10,Chile,NA,Maule,1044950,180,1,12967,278
2020-09-11,Chile,NA,Maule,1044950,190,5,13157,283
2020-09-12,Chile,NA,Maule,1044950,172,3,13329,286
2020-09-13,Chile,NA,Maule,1044950,183,1,13512,287
2020-09-14,Chile,NA,Maule,1044950,133,1,13645,288
2020-09-15,Chile,NA,Maule,1044950,98,2,13743,290
2020-09-16,Chile,NA,Maule,1044950,116,0,13859,290
2020-09-17,Chile,NA,Maule,1044950,184,5,14043,295
2020-09-18,Chile,NA,Maule,1044950,159,1,14202,296
2020-09-19,Chile,NA,Maule,1044950,143,1,14345,297
2020-09-20,Chile,NA,Maule,1044950,119,4,14464,301
2020-09-21,Chile,NA,Maule,1044950,89,0,14553,301
2020-09-22,Chile,NA,Maule,1044950,106,0,14659,301
2020-09-23,Chile,NA,Maule,1044950,149,0,14808,301
2020-03-16,Chile,NA,Nuble,480609,8,0,12,0
2020-03-17,Chile,NA,Nuble,480609,14,0,26,0
2020-03-18,Chile,NA,Nuble,480609,0,0,26,0
2020-03-19,Chile,NA,Nuble,480609,2,0,28,0
2020-03-20,Chile,NA,Nuble,480609,16,0,44,0
2020-03-21,Chile,NA,Nuble,480609,14,0,58,0
2020-03-22,Chile,NA,Nuble,480609,6,0,64,0
2020-03-23,Chile,NA,Nuble,480609,17,0,81,0
2020-03-24,Chile,NA,Nuble,480609,24,0,105,0
2020-03-25,Chile,NA,Nuble,480609,6,0,111,0
2020-03-26,Chile,NA,Nuble,480609,3,0,114,0
2020-03-27,Chile,NA,Nuble,480609,30,0,144,0
2020-03-28,Chile,NA,Nuble,480609,28,0,172,0
2020-03-29,Chile,NA,Nuble,480609,25,0,197,0
2020-03-30,Chile,NA,Nuble,480609,32,0,229,0
2020-03-31,Chile,NA,Nuble,480609,16,0,245,0
2020-04-01,Chile,NA,Nuble,480609,14,0,259,0
2020-04-02,Chile,NA,Nuble,480609,82,0,341,0
2020-04-03,Chile,NA,Nuble,480609,29,1,370,1
2020-04-04,Chile,NA,Nuble,480609,31,1,401,2
2020-04-05,Chile,NA,Nuble,480609,24,1,425,3
2020-04-06,Chile,NA,Nuble,480609,49,1,474,4
2020-04-07,Chile,NA,Nuble,480609,48,1,522,5
2020-04-08,Chile,NA,Nuble,480609,39,0,561,5
2020-04-09,Chile,NA,Nuble,480609,10,1,571,6
2020-04-10,Chile,NA,Nuble,480609,18,0,589,6
2020-04-11,Chile,NA,Nuble,480609,17,0,606,6
2020-04-12,Chile,NA,Nuble,480609,7,1,613,7
2020-04-13,Chile,NA,Nuble,480609,5,0,618,7
2020-04-14,Chile,NA,Nuble,480609,4,1,622,8
2020-04-15,Chile,NA,Nuble,480609,12,0,634,8
2020-04-16,Chile,NA,Nuble,480609,5,2,639,10
2020-04-17,Chile,NA,Nuble,480609,17,1,656,11
2020-04-18,Chile,NA,Nuble,480609,11,1,667,12
2020-04-19,Chile,NA,Nuble,480609,11,1,678,13
2020-04-20,Chile,NA,Nuble,480609,9,0,687,13
2020-04-21,Chile,NA,Nuble,480609,7,0,694,13
2020-04-22,Chile,NA,Nuble,480609,9,0,703,13
2020-04-23,Chile,NA,Nuble,480609,5,0,708,13
2020-04-24,Chile,NA,Nuble,480609,7,1,715,14
2020-04-25,Chile,NA,Nuble,480609,10,0,725,14
2020-04-26,Chile,NA,Nuble,480609,6,0,731,14
2020-04-27,Chile,NA,Nuble,480609,10,0,741,14
2020-04-28,Chile,NA,Nuble,480609,6,0,747,14
2020-04-29,Chile,NA,Nuble,480609,14,0,761,14
2020-04-30,Chile,NA,Nuble,480609,7,0,768,14
2020-05-01,Chile,NA,Nuble,480609,0,0,768,14
2020-05-02,Chile,NA,Nuble,480609,8,2,776,16
2020-05-03,Chile,NA,Nuble,480609,10,0,786,16
2020-05-04,Chile,NA,Nuble,480609,1,1,787,17
2020-05-05,Chile,NA,Nuble,480609,2,0,789,17
2020-05-06,Chile,NA,Nuble,480609,2,0,791,17
2020-05-07,Chile,NA,Nuble,480609,2,0,793,17
2020-05-08,Chile,NA,Nuble,480609,1,1,794,18
2020-05-09,Chile,NA,Nuble,480609,7,0,801,18
2020-05-10,Chile,NA,Nuble,480609,11,0,812,18
2020-05-11,Chile,NA,Nuble,480609,2,0,814,18
2020-05-12,Chile,NA,Nuble,480609,12,1,826,19
2020-05-13,Chile,NA,Nuble,480609,13,0,839,19
2020-05-14,Chile,NA,Nuble,480609,10,1,849,20
2020-05-15,Chile,NA,Nuble,480609,36,0,885,20
2020-05-16,Chile,NA,Nuble,480609,36,0,921,20
2020-05-17,Chile,NA,Nuble,480609,21,0,942,20
2020-05-18,Chile,NA,Nuble,480609,43,1,985,21
2020-05-19,Chile,NA,Nuble,480609,3,0,988,21
2020-05-20,Chile,NA,Nuble,480609,23,0,1011,21
2020-05-21,Chile,NA,Nuble,480609,9,0,1020,21
2020-05-22,Chile,NA,Nuble,480609,5,0,1025,21
2020-05-23,Chile,NA,Nuble,480609,52,0,1077,21
2020-05-24,Chile,NA,Nuble,480609,25,0,1102,21
2020-05-25,Chile,NA,Nuble,480609,37,1,1139,22
2020-05-26,Chile,NA,Nuble,480609,8,0,1147,22
2020-05-27,Chile,NA,Nuble,480609,27,0,1174,22
2020-05-28,Chile,NA,Nuble,480609,31,0,1205,22
2020-05-29,Chile,NA,Nuble,480609,37,0,1242,22
2020-05-30,Chile,NA,Nuble,480609,14,1,1256,23
2020-05-31,Chile,NA,Nuble,480609,1,0,1257,23
2020-06-01,Chile,NA,Nuble,480609,33,0,1290,23
2020-06-02,Chile,NA,Nuble,480609,0,0,1290,23
2020-06-03,Chile,NA,Nuble,480609,39,1,1329,24
2020-06-04,Chile,NA,Nuble,480609,43,0,1372,24
2020-06-05,Chile,NA,Nuble,480609,57,0,1429,24
2020-06-06,Chile,NA,Nuble,480609,41,0,1470,24
2020-06-07,Chile,NA,Nuble,480609,20,0,1490,24
2020-06-08,Chile,NA,Nuble,480609,62,0,1552,24
2020-06-09,Chile,NA,Nuble,480609,32,0,1584,24
2020-06-10,Chile,NA,Nuble,480609,32,2,1616,24
2020-06-11,Chile,NA,Nuble,480609,57,0,1673,24
2020-06-12,Chile,NA,Nuble,480609,45,0,1718,24
2020-06-13,Chile,NA,Nuble,480609,19,2,1737,24
2020-06-14,Chile,NA,Nuble,480609,41,0,1778,24
2020-06-15,Chile,NA,Nuble,480609,54,0,1832,24
2020-06-16,Chile,NA,Nuble,480609,20,0,1852,24
2020-06-17,Chile,NA,Nuble,480609,53,2,1905,24
2020-06-18,Chile,NA,Nuble,480609,45,0,1950,24
2020-06-19,Chile,NA,Nuble,480609,129,1,2079,25
2020-06-20,Chile,NA,Nuble,480609,32,2,2111,27
2020-06-21,Chile,NA,Nuble,480609,24,1,2135,28
2020-06-22,Chile,NA,Nuble,480609,22,0,2157,28
2020-06-23,Chile,NA,Nuble,480609,14,0,2171,28
2020-06-24,Chile,NA,Nuble,480609,24,1,2195,29
2020-06-25,Chile,NA,Nuble,480609,14,1,2209,30
2020-06-26,Chile,NA,Nuble,480609,41,1,2250,31
2020-06-27,Chile,NA,Nuble,480609,43,0,2293,31
2020-06-28,Chile,NA,Nuble,480609,46,1,2339,32
2020-06-29,Chile,NA,Nuble,480609,21,0,2360,32
2020-06-30,Chile,NA,Nuble,480609,13,0,2373,32
2020-07-01,Chile,NA,Nuble,480609,17,0,2390,32
2020-07-02,Chile,NA,Nuble,480609,33,1,2423,33
2020-07-03,Chile,NA,Nuble,480609,43,0,2466,33
2020-07-04,Chile,NA,Nuble,480609,43,0,2509,33
2020-07-05,Chile,NA,Nuble,480609,44,0,2553,33
2020-07-06,Chile,NA,Nuble,480609,40,0,2593,33
2020-07-07,Chile,NA,Nuble,480609,23,0,2616,33
2020-07-08,Chile,NA,Nuble,480609,60,2,2676,35
2020-07-09,Chile,NA,Nuble,480609,82,1,2758,36
2020-07-10,Chile,NA,Nuble,480609,56,1,2814,37
2020-07-11,Chile,NA,Nuble,480609,71,1,2885,38
2020-07-12,Chile,NA,Nuble,480609,56,2,2941,40
2020-07-13,Chile,NA,Nuble,480609,24,0,2965,40
2020-07-14,Chile,NA,Nuble,480609,24,0,2989,40
2020-07-15,Chile,NA,Nuble,480609,19,0,3008,40
2020-07-16,Chile,NA,Nuble,480609,58,0,3066,40
2020-07-17,Chile,NA,Nuble,480609,15,12,3081,52
2020-07-18,Chile,NA,Nuble,480609,98,1,3179,53
2020-07-19,Chile,NA,Nuble,480609,29,0,3208,53
2020-07-20,Chile,NA,Nuble,480609,28,1,3236,54
2020-07-21,Chile,NA,Nuble,480609,23,0,3259,54
2020-07-22,Chile,NA,Nuble,480609,13,0,3272,54
2020-07-23,Chile,NA,Nuble,480609,37,2,3309,56
2020-07-24,Chile,NA,Nuble,480609,27,3,3336,59
2020-07-25,Chile,NA,Nuble,480609,21,1,3357,60
2020-07-26,Chile,NA,Nuble,480609,7,0,3364,60
2020-07-27,Chile,NA,Nuble,480609,59,0,3423,60
2020-07-28,Chile,NA,Nuble,480609,13,0,3436,60
2020-07-29,Chile,NA,Nuble,480609,30,0,3466,60
2020-07-30,Chile,NA,Nuble,480609,25,1,3491,61
2020-07-31,Chile,NA,Nuble,480609,25,1,3516,62
2020-08-01,Chile,NA,Nuble,480609,27,0,3543,62
2020-08-02,Chile,NA,Nuble,480609,27,0,3570,62
2020-08-03,Chile,NA,Nuble,480609,20,1,3590,63
2020-08-04,Chile,NA,Nuble,480609,13,0,3603,63
2020-08-05,Chile,NA,Nuble,480609,28,0,3631,63
2020-08-06,Chile,NA,Nuble,480609,13,2,3644,65
2020-08-07,Chile,NA,Nuble,480609,46,3,3690,68
2020-08-08,Chile,NA,Nuble,480609,49,1,3739,69
2020-08-09,Chile,NA,Nuble,480609,32,0,3771,69
2020-08-10,Chile,NA,Nuble,480609,38,0,3809,69
2020-08-11,Chile,NA,Nuble,480609,20,0,3829,69
2020-08-12,Chile,NA,Nuble,480609,36,0,3865,69
2020-08-13,Chile,NA,Nuble,480609,31,1,3896,70
2020-08-14,Chile,NA,Nuble,480609,32,1,3928,71
2020-08-15,Chile,NA,Nuble,480609,8,2,3936,73
2020-08-16,Chile,NA,Nuble,480609,11,0,3947,73
2020-08-17,Chile,NA,Nuble,480609,37,0,3984,73
2020-08-18,Chile,NA,Nuble,480609,30,0,4014,73
2020-08-19,Chile,NA,Nuble,480609,29,0,4043,73
2020-08-20,Chile,NA,Nuble,480609,44,1,4087,74
2020-08-21,Chile,NA,Nuble,480609,40,1,4127,75
2020-08-22,Chile,NA,Nuble,480609,66,0,4193,75
2020-08-23,Chile,NA,Nuble,480609,38,0,4231,75
2020-08-24,Chile,NA,Nuble,480609,60,0,4291,75
2020-08-25,Chile,NA,Nuble,480609,39,0,4330,75
2020-08-26,Chile,NA,Nuble,480609,70,0,4400,75
2020-08-27,Chile,NA,Nuble,480609,54,1,4454,76
2020-08-28,Chile,NA,Nuble,480609,88,1,4542,77
2020-08-29,Chile,NA,Nuble,480609,92,3,4634,80
2020-08-30,Chile,NA,Nuble,480609,57,0,4691,80
2020-08-31,Chile,NA,Nuble,480609,80,0,4771,80
2020-09-01,Chile,NA,Nuble,480609,25,0,4796,80
2020-09-02,Chile,NA,Nuble,480609,28,0,4824,80
2020-09-03,Chile,NA,Nuble,480609,49,2,4873,82
2020-09-04,Chile,NA,Nuble,480609,89,1,4962,83
2020-09-05,Chile,NA,Nuble,480609,53,1,5015,84
2020-09-06,Chile,NA,Nuble,480609,93,1,5108,85
2020-09-07,Chile,NA,Nuble,480609,41,1,5149,86
2020-09-08,Chile,NA,Nuble,480609,35,0,5184,86
2020-09-09,Chile,NA,Nuble,480609,30,0,5214,86
2020-09-10,Chile,NA,Nuble,480609,43,2,5257,88
2020-09-11,Chile,NA,Nuble,480609,90,4,5347,92
2020-09-12,Chile,NA,Nuble,480609,86,0,5433,92
2020-09-13,Chile,NA,Nuble,480609,103,2,5536,94
2020-09-14,Chile,NA,Nuble,480609,73,3,5609,97
2020-09-15,Chile,NA,Nuble,480609,57,0,5666,97
2020-09-16,Chile,NA,Nuble,480609,27,0,5693,97
2020-09-17,Chile,NA,Nuble,480609,63,6,5756,103
2020-09-18,Chile,NA,Nuble,480609,62,1,5818,104
2020-09-19,Chile,NA,Nuble,480609,53,1,5871,105
2020-09-20,Chile,NA,Nuble,480609,77,1,5948,106
2020-09-21,Chile,NA,Nuble,480609,32,0,5980,106
2020-09-22,Chile,NA,Nuble,480609,26,0,6006,106
2020-09-23,Chile,NA,Nuble,480609,22,1,6028,107
2020-03-25,Chile,NA,O'Higgins,914555,2,0,11,0
2020-03-26,Chile,NA,O'Higgins,914555,3,0,14,0
2020-03-27,Chile,NA,O'Higgins,914555,2,0,16,0
2020-03-28,Chile,NA,O'Higgins,914555,4,0,20,0
2020-03-29,Chile,NA,O'Higgins,914555,1,0,21,0
2020-03-30,Chile,NA,O'Higgins,914555,0,0,21,0
2020-03-31,Chile,NA,O'Higgins,914555,2,0,23,0
2020-04-01,Chile,NA,O'Higgins,914555,3,0,26,0
2020-04-02,Chile,NA,O'Higgins,914555,6,0,32,0
2020-04-03,Chile,NA,O'Higgins,914555,1,0,33,0
2020-04-04,Chile,NA,O'Higgins,914555,5,0,38,0
2020-04-05,Chile,NA,O'Higgins,914555,3,0,41,0
2020-04-06,Chile,NA,O'Higgins,914555,1,0,42,0
2020-04-07,Chile,NA,O'Higgins,914555,0,0,42,0
2020-04-08,Chile,NA,O'Higgins,914555,1,0,43,0
2020-04-09,Chile,NA,O'Higgins,914555,1,0,44,0
2020-04-10,Chile,NA,O'Higgins,914555,0,0,44,0
2020-04-11,Chile,NA,O'Higgins,914555,1,0,45,0
2020-04-12,Chile,NA,O'Higgins,914555,1,0,46,0
2020-04-13,Chile,NA,O'Higgins,914555,2,0,48,0
2020-04-14,Chile,NA,O'Higgins,914555,5,0,53,0
2020-04-15,Chile,NA,O'Higgins,914555,1,0,54,0
2020-04-16,Chile,NA,O'Higgins,914555,0,0,54,0
2020-04-17,Chile,NA,O'Higgins,914555,1,0,55,0
2020-04-18,Chile,NA,O'Higgins,914555,0,0,55,0
2020-04-19,Chile,NA,O'Higgins,914555,0,0,55,0
2020-04-20,Chile,NA,O'Higgins,914555,1,0,56,0
2020-04-21,Chile,NA,O'Higgins,914555,1,1,57,1
2020-04-22,Chile,NA,O'Higgins,914555,2,0,59,1
2020-04-23,Chile,NA,O'Higgins,914555,17,0,76,1
2020-04-24,Chile,NA,O'Higgins,914555,5,0,81,1
2020-04-25,Chile,NA,O'Higgins,914555,4,0,85,1
2020-04-26,Chile,NA,O'Higgins,914555,7,0,92,1
2020-04-27,Chile,NA,O'Higgins,914555,2,0,94,1
2020-04-28,Chile,NA,O'Higgins,914555,3,0,97,1
2020-04-29,Chile,NA,O'Higgins,914555,7,0,104,1
2020-04-30,Chile,NA,O'Higgins,914555,4,0,108,1
2020-05-01,Chile,NA,O'Higgins,914555,1,0,109,1
2020-05-02,Chile,NA,O'Higgins,914555,11,2,120,3
2020-05-03,Chile,NA,O'Higgins,914555,5,0,125,3
2020-05-04,Chile,NA,O'Higgins,914555,6,0,131,3
2020-05-05,Chile,NA,O'Higgins,914555,5,0,136,3
2020-05-06,Chile,NA,O'Higgins,914555,9,0,145,3
2020-05-07,Chile,NA,O'Higgins,914555,6,0,151,3
2020-05-08,Chile,NA,O'Higgins,914555,16,0,167,3
2020-05-09,Chile,NA,O'Higgins,914555,15,0,182,3
2020-05-10,Chile,NA,O'Higgins,914555,13,0,195,3
2020-05-11,Chile,NA,O'Higgins,914555,21,1,216,4
2020-05-12,Chile,NA,O'Higgins,914555,8,0,224,4
2020-05-13,Chile,NA,O'Higgins,914555,24,0,248,4
2020-05-14,Chile,NA,O'Higgins,914555,47,0,295,4
2020-05-15,Chile,NA,O'Higgins,914555,28,1,323,5
2020-05-16,Chile,NA,O'Higgins,914555,6,0,329,5
2020-05-17,Chile,NA,O'Higgins,914555,37,0,366,5
2020-05-18,Chile,NA,O'Higgins,914555,52,1,418,6
2020-05-19,Chile,NA,O'Higgins,914555,24,1,442,7
2020-05-20,Chile,NA,O'Higgins,914555,13,0,455,7
2020-05-21,Chile,NA,O'Higgins,914555,10,0,465,7
2020-05-22,Chile,NA,O'Higgins,914555,27,1,492,8
2020-05-23,Chile,NA,O'Higgins,914555,26,3,518,11
2020-05-24,Chile,NA,O'Higgins,914555,36,0,554,11
2020-05-25,Chile,NA,O'Higgins,914555,34,2,588,13
2020-05-26,Chile,NA,O'Higgins,914555,66,0,654,13
2020-05-27,Chile,NA,O'Higgins,914555,37,1,691,14
2020-05-28,Chile,NA,O'Higgins,914555,14,0,705,14
2020-05-29,Chile,NA,O'Higgins,914555,40,0,745,14
2020-05-30,Chile,NA,O'Higgins,914555,11,2,756,16
2020-05-31,Chile,NA,O'Higgins,914555,29,2,785,18
2020-06-01,Chile,NA,O'Higgins,914555,28,0,813,18
2020-06-02,Chile,NA,O'Higgins,914555,30,0,843,18
2020-06-03,Chile,NA,O'Higgins,914555,88,2,931,20
2020-06-04,Chile,NA,O'Higgins,914555,36,1,967,21
2020-06-05,Chile,NA,O'Higgins,914555,49,1,1016,22
2020-06-06,Chile,NA,O'Higgins,914555,95,3,1111,25
2020-06-07,Chile,NA,O'Higgins,914555,72,0,1183,25
2020-06-08,Chile,NA,O'Higgins,914555,72,2,1255,25
2020-06-09,Chile,NA,O'Higgins,914555,62,1,1317,25
2020-06-10,Chile,NA,O'Higgins,914555,125,3,1442,26
2020-06-11,Chile,NA,O'Higgins,914555,110,2,1552,28
2020-06-12,Chile,NA,O'Higgins,914555,77,2,1629,30
2020-06-13,Chile,NA,O'Higgins,914555,159,2,1788,32
2020-06-14,Chile,NA,O'Higgins,914555,139,1,1927,33
2020-06-15,Chile,NA,O'Higgins,914555,85,2,2012,35
2020-06-16,Chile,NA,O'Higgins,914555,209,0,2221,35
2020-06-17,Chile,NA,O'Higgins,914555,197,6,2418,41
2020-06-18,Chile,NA,O'Higgins,914555,220,3,2638,44
2020-06-19,Chile,NA,O'Higgins,914555,294,2,2932,46
2020-06-20,Chile,NA,O'Higgins,914555,302,4,3234,50
2020-06-21,Chile,NA,O'Higgins,914555,339,2,3573,52
2020-06-22,Chile,NA,O'Higgins,914555,234,0,3807,52
2020-06-23,Chile,NA,O'Higgins,914555,175,0,3982,52
2020-06-24,Chile,NA,O'Higgins,914555,249,7,4231,59
2020-06-25,Chile,NA,O'Higgins,914555,258,4,4489,63
2020-06-26,Chile,NA,O'Higgins,914555,268,2,4757,65
2020-06-27,Chile,NA,O'Higgins,914555,186,3,4943,68
2020-06-28,Chile,NA,O'Higgins,914555,284,1,5227,69
2020-06-29,Chile,NA,O'Higgins,914555,238,0,5465,69
2020-06-30,Chile,NA,O'Higgins,914555,237,0,5702,69
2020-07-01,Chile,NA,O'Higgins,914555,164,0,5866,69
2020-07-02,Chile,NA,O'Higgins,914555,200,8,6066,77
2020-07-03,Chile,NA,O'Higgins,914555,180,6,6246,83
2020-07-04,Chile,NA,O'Higgins,914555,234,6,6480,89
2020-07-05,Chile,NA,O'Higgins,914555,209,3,6689,92
2020-07-06,Chile,NA,O'Higgins,914555,187,0,6876,92
2020-07-07,Chile,NA,O'Higgins,914555,213,0,7089,92
2020-07-08,Chile,NA,O'Higgins,914555,99,12,7188,104
2020-07-09,Chile,NA,O'Higgins,914555,194,5,7382,109
2020-07-10,Chile,NA,O'Higgins,914555,308,4,7690,113
2020-07-11,Chile,NA,O'Higgins,914555,141,6,7831,119
2020-07-12,Chile,NA,O'Higgins,914555,128,4,7959,123
2020-07-13,Chile,NA,O'Higgins,914555,149,0,8108,123
2020-07-14,Chile,NA,O'Higgins,914555,152,0,8260,123
2020-07-15,Chile,NA,O'Higgins,914555,116,11,8376,134
2020-07-16,Chile,NA,O'Higgins,914555,149,5,8525,139
2020-07-17,Chile,NA,O'Higgins,914555,176,25,8701,164
2020-07-18,Chile,NA,O'Higgins,914555,86,8,8787,172
2020-07-19,Chile,NA,O'Higgins,914555,120,1,8907,173
2020-07-20,Chile,NA,O'Higgins,914555,103,10,9010,183
2020-07-21,Chile,NA,O'Higgins,914555,90,0,9100,183
2020-07-22,Chile,NA,O'Higgins,914555,125,0,9225,183
2020-07-23,Chile,NA,O'Higgins,914555,125,14,9350,197
2020-07-24,Chile,NA,O'Higgins,914555,162,4,9512,201
2020-07-25,Chile,NA,O'Higgins,914555,104,8,9616,209
2020-07-26,Chile,NA,O'Higgins,914555,111,9,9727,218
2020-07-27,Chile,NA,O'Higgins,914555,94,2,9821,220
2020-07-28,Chile,NA,O'Higgins,914555,39,0,9860,220
2020-07-29,Chile,NA,O'Higgins,914555,89,0,9949,220
2020-07-30,Chile,NA,O'Higgins,914555,104,8,10053,228
2020-07-31,Chile,NA,O'Higgins,914555,91,8,10144,236
2020-08-01,Chile,NA,O'Higgins,914555,89,2,10233,238
2020-08-02,Chile,NA,O'Higgins,914555,94,6,10327,244
2020-08-03,Chile,NA,O'Higgins,914555,86,8,10413,252
2020-08-04,Chile,NA,O'Higgins,914555,50,0,10463,252
2020-08-05,Chile,NA,O'Higgins,914555,67,0,10530,252
2020-08-06,Chile,NA,O'Higgins,914555,102,8,10632,260
2020-08-07,Chile,NA,O'Higgins,914555,132,3,10764,263
2020-08-08,Chile,NA,O'Higgins,914555,221,2,10985,265
2020-08-09,Chile,NA,O'Higgins,914555,100,5,11085,270
2020-08-10,Chile,NA,O'Higgins,914555,81,10,11166,280
2020-08-11,Chile,NA,O'Higgins,914555,105,1,11271,281
2020-08-12,Chile,NA,O'Higgins,914555,116,0,11387,281
2020-08-13,Chile,NA,O'Higgins,914555,106,9,11493,290
2020-08-14,Chile,NA,O'Higgins,914555,85,5,11578,295
2020-08-15,Chile,NA,O'Higgins,914555,62,4,11640,299
2020-08-16,Chile,NA,O'Higgins,914555,87,2,11727,301
2020-08-17,Chile,NA,O'Higgins,914555,47,3,11774,304
2020-08-18,Chile,NA,O'Higgins,914555,67,0,11841,304
2020-08-19,Chile,NA,O'Higgins,914555,65,0,11906,304
2020-08-20,Chile,NA,O'Higgins,914555,99,6,12005,310
2020-08-21,Chile,NA,O'Higgins,914555,82,3,12087,313
2020-08-22,Chile,NA,O'Higgins,914555,60,3,12147,316
2020-08-23,Chile,NA,O'Higgins,914555,73,4,12220,320
2020-08-24,Chile,NA,O'Higgins,914555,125,3,12345,323
2020-08-25,Chile,NA,O'Higgins,914555,76,1,12421,324
2020-08-26,Chile,NA,O'Higgins,914555,93,0,12514,324
2020-08-27,Chile,NA,O'Higgins,914555,69,5,12583,329
2020-08-28,Chile,NA,O'Higgins,914555,93,2,12676,331
2020-08-29,Chile,NA,O'Higgins,914555,102,4,12778,335
2020-08-30,Chile,NA,O'Higgins,914555,83,3,12861,338
2020-08-31,Chile,NA,O'Higgins,914555,88,2,12949,340
2020-09-01,Chile,NA,O'Higgins,914555,88,0,13037,340
2020-09-02,Chile,NA,O'Higgins,914555,85,0,13122,340
2020-09-03,Chile,NA,O'Higgins,914555,115,3,13237,343
2020-09-04,Chile,NA,O'Higgins,914555,101,4,13338,347
2020-09-05,Chile,NA,O'Higgins,914555,108,2,13446,349
2020-09-06,Chile,NA,O'Higgins,914555,83,1,13529,350
2020-09-07,Chile,NA,O'Higgins,914555,97,2,13626,352
2020-09-08,Chile,NA,O'Higgins,914555,101,0,13727,352
2020-09-09,Chile,NA,O'Higgins,914555,61,0,13788,352
2020-09-10,Chile,NA,O'Higgins,914555,88,3,13876,355
2020-09-11,Chile,NA,O'Higgins,914555,115,4,13991,359
2020-09-12,Chile,NA,O'Higgins,914555,150,3,14141,362
2020-09-13,Chile,NA,O'Higgins,914555,125,4,14266,366
2020-09-14,Chile,NA,O'Higgins,914555,84,3,14350,369
2020-09-15,Chile,NA,O'Higgins,914555,126,0,14476,369
2020-09-16,Chile,NA,O'Higgins,914555,81,0,14557,369
2020-09-17,Chile,NA,O'Higgins,914555,124,6,14681,375
2020-09-18,Chile,NA,O'Higgins,914555,116,5,14797,380
2020-09-19,Chile,NA,O'Higgins,914555,116,3,14913,383
2020-09-20,Chile,NA,O'Higgins,914555,106,1,15019,384
2020-09-21,Chile,NA,O'Higgins,914555,103,0,15122,384
2020-09-22,Chile,NA,O'Higgins,914555,51,0,15173,384
2020-09-23,Chile,NA,O'Higgins,914555,100,0,15273,384
2020-03-11,Chile,NA,Santiago Metropolitan Region,7112808,4,0,14,0
2020-03-12,Chile,NA,Santiago Metropolitan Region,7112808,9,0,23,0
2020-03-13,Chile,NA,Santiago Metropolitan Region,7112808,6,0,29,0
2020-03-14,Chile,NA,Santiago Metropolitan Region,7112808,11,0,40,0
2020-03-15,Chile,NA,Santiago Metropolitan Region,7112808,14,0,54,0
2020-03-16,Chile,NA,Santiago Metropolitan Region,7112808,69,0,123,0
2020-03-17,Chile,NA,Santiago Metropolitan Region,7112808,29,0,152,0
2020-03-18,Chile,NA,Santiago Metropolitan Region,7112808,22,0,174,0
2020-03-19,Chile,NA,Santiago Metropolitan Region,7112808,73,0,247,0
2020-03-20,Chile,NA,Santiago Metropolitan Region,7112808,57,0,304,0
2020-03-21,Chile,NA,Santiago Metropolitan Region,7112808,55,0,359,0
2020-03-22,Chile,NA,Santiago Metropolitan Region,7112808,50,0,409,1
2020-03-23,Chile,NA,Santiago Metropolitan Region,7112808,50,0,459,1
2020-03-24,Chile,NA,Santiago Metropolitan Region,7112808,81,1,540,2
2020-03-25,Chile,NA,Santiago Metropolitan Region,7112808,142,0,682,2
2020-03-26,Chile,NA,Santiago Metropolitan Region,7112808,64,1,746,3
2020-03-27,Chile,NA,Santiago Metropolitan Region,7112808,192,0,938,3
2020-03-28,Chile,NA,Santiago Metropolitan Region,7112808,146,0,1084,3
2020-03-29,Chile,NA,Santiago Metropolitan Region,7112808,83,0,1167,3
2020-03-30,Chile,NA,Santiago Metropolitan Region,7112808,128,0,1295,3
2020-03-31,Chile,NA,Santiago Metropolitan Region,7112808,125,1,1420,4
2020-04-01,Chile,NA,Santiago Metropolitan Region,7112808,101,1,1521,5
2020-04-02,Chile,NA,Santiago Metropolitan Region,7112808,115,1,1636,6
2020-04-03,Chile,NA,Santiago Metropolitan Region,7112808,106,2,1742,8
2020-04-04,Chile,NA,Santiago Metropolitan Region,7112808,215,1,1957,9
2020-04-05,Chile,NA,Santiago Metropolitan Region,7112808,145,1,2102,10
2020-04-06,Chile,NA,Santiago Metropolitan Region,7112808,142,0,2244,10
2020-04-07,Chile,NA,Santiago Metropolitan Region,7112808,106,2,2350,12
2020-04-08,Chile,NA,Santiago Metropolitan Region,7112808,198,2,2548,14
2020-04-09,Chile,NA,Santiago Metropolitan Region,7112808,284,7,2832,21
2020-04-10,Chile,NA,Santiago Metropolitan Region,7112808,361,8,3193,29
2020-04-11,Chile,NA,Santiago Metropolitan Region,7112808,255,3,3448,32
2020-04-12,Chile,NA,Santiago Metropolitan Region,7112808,151,3,3599,35
2020-04-13,Chile,NA,Santiago Metropolitan Region,7112808,204,1,3803,36
2020-04-14,Chile,NA,Santiago Metropolitan Region,7112808,283,4,4086,40
2020-04-15,Chile,NA,Santiago Metropolitan Region,7112808,248,1,4334,41
2020-04-16,Chile,NA,Santiago Metropolitan Region,7112808,348,7,4682,48
2020-04-17,Chile,NA,Santiago Metropolitan Region,7112808,233,3,4915,51
2020-04-18,Chile,NA,Santiago Metropolitan Region,7112808,277,7,5192,58
2020-04-19,Chile,NA,Santiago Metropolitan Region,7112808,189,5,5381,63
2020-04-20,Chile,NA,Santiago Metropolitan Region,7112808,262,4,5643,67
2020-04-21,Chile,NA,Santiago Metropolitan Region,7112808,145,2,5788,69
2020-04-22,Chile,NA,Santiago Metropolitan Region,7112808,295,9,6083,78
2020-04-23,Chile,NA,Santiago Metropolitan Region,7112808,351,7,6434,85
2020-04-24,Chile,NA,Santiago Metropolitan Region,7112808,327,1,6761,86
2020-04-25,Chile,NA,Santiago Metropolitan Region,7112808,404,3,7165,89
2020-04-26,Chile,NA,Santiago Metropolitan Region,7112808,331,2,7496,91
2020-04-27,Chile,NA,Santiago Metropolitan Region,7112808,362,4,7858,95
2020-04-28,Chile,NA,Santiago Metropolitan Region,7112808,442,5,8300,100
2020-04-29,Chile,NA,Santiago Metropolitan Region,7112808,589,4,8889,104
2020-04-30,Chile,NA,Santiago Metropolitan Region,7112808,736,6,9625,110
2020-05-01,Chile,NA,Santiago Metropolitan Region,7112808,891,4,10516,114
2020-05-02,Chile,NA,Santiago Metropolitan Region,7112808,1145,8,11661,122
2020-05-03,Chile,NA,Santiago Metropolitan Region,7112808,995,13,12656,135
2020-05-04,Chile,NA,Santiago Metropolitan Region,7112808,872,8,13528,143
2020-05-05,Chile,NA,Santiago Metropolitan Region,7112808,1179,3,14707,146
2020-05-06,Chile,NA,Santiago Metropolitan Region,7112808,875,4,15582,150
2020-05-07,Chile,NA,Santiago Metropolitan Region,7112808,1246,2,16828,152
2020-05-08,Chile,NA,Santiago Metropolitan Region,7112808,1151,5,17979,157
2020-05-09,Chile,NA,Santiago Metropolitan Region,7112808,978,6,18957,163
2020-05-10,Chile,NA,Santiago Metropolitan Region,7112808,1396,3,20353,166
2020-05-11,Chile,NA,Santiago Metropolitan Region,7112808,964,6,21317,172
2020-05-12,Chile,NA,Santiago Metropolitan Region,7112808,1392,6,22709,178
2020-05-13,Chile,NA,Santiago Metropolitan Region,7112808,2256,6,24965,184
2020-05-14,Chile,NA,Santiago Metropolitan Region,7112808,2251,18,27216,202
2020-05-15,Chile,NA,Santiago Metropolitan Region,7112808,2060,19,29276,221
2020-05-16,Chile,NA,Santiago Metropolitan Region,7112808,1518,25,30794,246
2020-05-17,Chile,NA,Santiago Metropolitan Region,7112808,1890,24,32684,270
2020-05-18,Chile,NA,Santiago Metropolitan Region,7112808,1767,24,34451,294
2020-05-19,Chile,NA,Santiago Metropolitan Region,7112808,3140,24,37591,318
2020-05-20,Chile,NA,Santiago Metropolitan Region,7112808,3588,30,41179,348
2020-05-21,Chile,NA,Santiago Metropolitan Region,7112808,3462,40,44641,388
2020-05-22,Chile,NA,Santiago Metropolitan Region,7112808,3709,35,48350,423
2020-05-23,Chile,NA,Santiago Metropolitan Region,7112808,3049,32,51399,455
2020-05-24,Chile,NA,Santiago Metropolitan Region,7112808,3145,39,54544,494
2020-05-25,Chile,NA,Santiago Metropolitan Region,7112808,4386,35,58930,529
2020-05-26,Chile,NA,Santiago Metropolitan Region,7112808,3355,38,62285,567
2020-05-27,Chile,NA,Santiago Metropolitan Region,7112808,3726,28,66011,595
2020-05-28,Chile,NA,Santiago Metropolitan Region,7112808,3904,43,69915,638
2020-05-29,Chile,NA,Santiago Metropolitan Region,7112808,2995,47,72910,685
2020-05-30,Chile,NA,Santiago Metropolitan Region,7112808,3341,43,76251,728
2020-05-31,Chile,NA,Santiago Metropolitan Region,7112808,4253,47,80504,775
2020-06-01,Chile,NA,Santiago Metropolitan Region,7112808,4735,49,85239,824
2020-06-02,Chile,NA,Santiago Metropolitan Region,7112808,2955,70,88194,894
2020-06-03,Chile,NA,Santiago Metropolitan Region,7112808,3997,67,92191,961
2020-06-04,Chile,NA,Santiago Metropolitan Region,7112808,3699,73,95890,1034
2020-06-05,Chile,NA,Santiago Metropolitan Region,7112808,3176,71,99066,1105
2020-06-06,Chile,NA,Santiago Metropolitan Region,7112808,4128,79,103194,1184
2020-06-07,Chile,NA,Santiago Metropolitan Region,7112808,5268,700,108462,1884
2020-06-08,Chile,NA,Santiago Metropolitan Region,7112808,3674,66,112136,1950
2020-06-09,Chile,NA,Santiago Metropolitan Region,7112808,2990,18,115126,1968
2020-06-10,Chile,NA,Santiago Metropolitan Region,7112808,4620,147,119746,2115
2020-06-11,Chile,NA,Santiago Metropolitan Region,7112808,4389,158,124135,2273
2020-06-12,Chile,NA,Santiago Metropolitan Region,7112808,5559,195,129694,2468
2020-06-13,Chile,NA,Santiago Metropolitan Region,7112808,5057,213,134751,2681
2020-06-14,Chile,NA,Santiago Metropolitan Region,7112808,5647,197,140398,2878
2020-06-15,Chile,NA,Santiago Metropolitan Region,7112808,3882,35,144280,2913
2020-06-16,Chile,NA,Santiago Metropolitan Region,7112808,4022,21,148302,2934
2020-06-17,Chile,NA,Santiago Metropolitan Region,7112808,3539,180,151841,3114
2020-06-18,Chile,NA,Santiago Metropolitan Region,7112808,3021,205,154862,3319
2020-06-19,Chile,NA,Santiago Metropolitan Region,7112808,4421,226,159283,3545
2020-06-20,Chile,NA,Santiago Metropolitan Region,7112808,3603,170,162886,3715
2020-06-21,Chile,NA,Santiago Metropolitan Region,7112808,3789,155,166675,3870
2020-06-22,Chile,NA,Santiago Metropolitan Region,7112808,3026,22,169701,3892
2020-06-23,Chile,NA,Santiago Metropolitan Region,7112808,2469,3,172170,3895
2020-06-24,Chile,NA,Santiago Metropolitan Region,7112808,2350,170,174520,4065
2020-06-25,Chile,NA,Santiago Metropolitan Region,7112808,3035,141,177555,4206
2020-06-26,Chile,NA,Santiago Metropolitan Region,7112808,2616,136,180171,4342
2020-06-27,Chile,NA,Santiago Metropolitan Region,7112808,2957,242,183128,4584
2020-06-28,Chile,NA,Santiago Metropolitan Region,7112808,2569,127,185697,4711
2020-06-29,Chile,NA,Santiago Metropolitan Region,7112808,2508,66,188205,4777
2020-06-30,Chile,NA,Santiago Metropolitan Region,7112808,2255,112,190460,4889
2020-07-01,Chile,NA,Santiago Metropolitan Region,7112808,1316,65,191776,4954
2020-07-02,Chile,NA,Santiago Metropolitan Region,7112808,1353,101,193129,5055
2020-07-03,Chile,NA,Santiago Metropolitan Region,7112808,2072,90,195201,5145
2020-07-04,Chile,NA,Santiago Metropolitan Region,7112808,2236,106,197437,5251
2020-07-05,Chile,NA,Santiago Metropolitan Region,7112808,2080,77,199517,5328
2020-07-06,Chile,NA,Santiago Metropolitan Region,7112808,1648,73,201165,5401
2020-07-07,Chile,NA,Santiago Metropolitan Region,7112808,1315,50,202480,5451
2020-07-08,Chile,NA,Santiago Metropolitan Region,7112808,987,82,203467,5533
2020-07-09,Chile,NA,Santiago Metropolitan Region,7112808,1687,77,205154,5610
2020-07-10,Chile,NA,Santiago Metropolitan Region,7112808,1525,63,206679,5673
2020-07-11,Chile,NA,Santiago Metropolitan Region,7112808,1329,73,208008,5746
2020-07-12,Chile,NA,Santiago Metropolitan Region,7112808,1661,68,209669,5814
2020-07-13,Chile,NA,Santiago Metropolitan Region,7112808,1431,44,211100,5858
2020-07-14,Chile,NA,Santiago Metropolitan Region,7112808,864,40,211964,5898
2020-07-15,Chile,NA,Santiago Metropolitan Region,7112808,690,59,212654,5957
2020-07-16,Chile,NA,Santiago Metropolitan Region,7112808,1193,70,213847,6027
2020-07-17,Chile,NA,Santiago Metropolitan Region,7112808,1501,831,215348,6858
2020-07-18,Chile,NA,Santiago Metropolitan Region,7112808,1086,66,216434,6924
2020-07-19,Chile,NA,Santiago Metropolitan Region,7112808,828,51,217262,6975
2020-07-20,Chile,NA,Santiago Metropolitan Region,7112808,965,78,218227,7053
2020-07-21,Chile,NA,Santiago Metropolitan Region,7112808,685,43,218912,7096
2020-07-22,Chile,NA,Santiago Metropolitan Region,7112808,714,37,219626,7133
2020-07-23,Chile,NA,Santiago Metropolitan Region,7112808,1013,59,220639,7192
2020-07-24,Chile,NA,Santiago Metropolitan Region,7112808,1066,49,221705,7241
2020-07-25,Chile,NA,Santiago Metropolitan Region,7112808,886,62,222591,7303
2020-07-26,Chile,NA,Santiago Metropolitan Region,7112808,802,50,223393,7353
2020-07-27,Chile,NA,Santiago Metropolitan Region,7112808,912,47,224305,7400
2020-07-28,Chile,NA,Santiago Metropolitan Region,7112808,658,44,224963,7444
2020-07-29,Chile,NA,Santiago Metropolitan Region,7112808,661,33,225624,7477
2020-07-30,Chile,NA,Santiago Metropolitan Region,7112808,684,38,226308,7515
2020-07-31,Chile,NA,Santiago Metropolitan Region,7112808,825,39,227133,7554
2020-08-01,Chile,NA,Santiago Metropolitan Region,7112808,771,45,227904,7599
2020-08-02,Chile,NA,Santiago Metropolitan Region,7112808,773,50,228677,7649
2020-08-03,Chile,NA,Santiago Metropolitan Region,7112808,687,51,229364,7700
2020-08-04,Chile,NA,Santiago Metropolitan Region,7112808,497,35,229861,7735
2020-08-05,Chile,NA,Santiago Metropolitan Region,7112808,664,39,230525,7774
2020-08-06,Chile,NA,Santiago Metropolitan Region,7112808,702,34,231227,7808
2020-08-07,Chile,NA,Santiago Metropolitan Region,7112808,728,39,231955,7847
2020-08-08,Chile,NA,Santiago Metropolitan Region,7112808,700,24,232655,7871
2020-08-09,Chile,NA,Santiago Metropolitan Region,7112808,695,38,233350,7909
2020-08-10,Chile,NA,Santiago Metropolitan Region,7112808,591,37,233941,7946
2020-08-11,Chile,NA,Santiago Metropolitan Region,7112808,446,26,234387,7972
2020-08-12,Chile,NA,Santiago Metropolitan Region,7112808,463,20,234850,7992
2020-08-13,Chile,NA,Santiago Metropolitan Region,7112808,603,31,235453,8023
2020-08-14,Chile,NA,Santiago Metropolitan Region,7112808,764,21,236217,8044
2020-08-15,Chile,NA,Santiago Metropolitan Region,7112808,524,30,236741,8074
2020-08-16,Chile,NA,Santiago Metropolitan Region,7112808,649,31,237390,8105
2020-08-17,Chile,NA,Santiago Metropolitan Region,7112808,494,33,237884,8138
2020-08-18,Chile,NA,Santiago Metropolitan Region,7112808,339,22,238223,8160
2020-08-19,Chile,NA,Santiago Metropolitan Region,7112808,322,27,238545,8187
2020-08-20,Chile,NA,Santiago Metropolitan Region,7112808,595,32,239140,8219
2020-08-21,Chile,NA,Santiago Metropolitan Region,7112808,544,31,239684,8250
2020-08-22,Chile,NA,Santiago Metropolitan Region,7112808,627,38,240311,8288
2020-08-23,Chile,NA,Santiago Metropolitan Region,7112808,553,30,240864,8318
2020-08-24,Chile,NA,Santiago Metropolitan Region,7112808,509,21,241373,8339
2020-08-25,Chile,NA,Santiago Metropolitan Region,7112808,453,34,241826,8373
2020-08-26,Chile,NA,Santiago Metropolitan Region,7112808,357,29,242183,8402
2020-08-27,Chile,NA,Santiago Metropolitan Region,7112808,468,29,242651,8431
2020-08-28,Chile,NA,Santiago Metropolitan Region,7112808,541,31,243192,8462
2020-08-29,Chile,NA,Santiago Metropolitan Region,7112808,559,21,243751,8483
2020-08-30,Chile,NA,Santiago Metropolitan Region,7112808,641,34,244392,8517
2020-08-31,Chile,NA,Santiago Metropolitan Region,7112808,482,21,244874,8538
2020-09-01,Chile,NA,Santiago Metropolitan Region,7112808,424,21,245298,8559
2020-09-02,Chile,NA,Santiago Metropolitan Region,7112808,465,21,245763,8580
2020-09-03,Chile,NA,Santiago Metropolitan Region,7112808,526,28,246289,8608
2020-09-04,Chile,NA,Santiago Metropolitan Region,7112808,569,30,246858,8638
2020-09-05,Chile,NA,Santiago Metropolitan Region,7112808,573,33,247431,8671
2020-09-06,Chile,NA,Santiago Metropolitan Region,7112808,619,22,248050,8693
2020-09-07,Chile,NA,Santiago Metropolitan Region,7112808,476,26,248526,8719
2020-09-08,Chile,NA,Santiago Metropolitan Region,7112808,350,22,248876,8741
2020-09-09,Chile,NA,Santiago Metropolitan Region,7112808,513,20,249389,8761
2020-09-10,Chile,NA,Santiago Metropolitan Region,7112808,469,30,249858,8791
2020-09-11,Chile,NA,Santiago Metropolitan Region,7112808,407,27,250265,8818
2020-09-12,Chile,NA,Santiago Metropolitan Region,7112808,538,20,250803,8838
2020-09-13,Chile,NA,Santiago Metropolitan Region,7112808,480,25,251283,8863
2020-09-14,Chile,NA,Santiago Metropolitan Region,7112808,463,30,251746,8893
2020-09-15,Chile,NA,Santiago Metropolitan Region,7112808,322,21,252068,8914
2020-09-16,Chile,NA,Santiago Metropolitan Region,7112808,377,18,252445,8932
2020-09-17,Chile,NA,Santiago Metropolitan Region,7112808,456,14,252901,8946
2020-09-18,Chile,NA,Santiago Metropolitan Region,7112808,383,28,253284,8974
2020-09-19,Chile,NA,Santiago Metropolitan Region,7112808,417,24,253701,8998
2020-09-20,Chile,NA,Santiago Metropolitan Region,7112808,453,10,254154,9008
2020-09-21,Chile,NA,Santiago Metropolitan Region,7112808,198,12,254352,9020
2020-09-22,Chile,NA,Santiago Metropolitan Region,7112808,223,21,254575,9041
2020-09-23,Chile,NA,Santiago Metropolitan Region,7112808,332,23,254907,9064
2020-04-02,Chile,NA,Tarapaca,330558,2,0,12,0
2020-04-03,Chile,NA,Tarapaca,330558,1,0,13,0
2020-04-04,Chile,NA,Tarapaca,330558,4,0,17,0
2020-04-05,Chile,NA,Tarapaca,330558,3,0,20,0
2020-04-06,Chile,NA,Tarapaca,330558,1,0,21,0
2020-04-07,Chile,NA,Tarapaca,330558,2,0,23,0
2020-04-08,Chile,NA,Tarapaca,330558,3,0,26,0
2020-04-09,Chile,NA,Tarapaca,330558,3,0,29,0
2020-04-10,Chile,NA,Tarapaca,330558,6,0,35,0
2020-04-11,Chile,NA,Tarapaca,330558,3,0,38,0
2020-04-12,Chile,NA,Tarapaca,330558,8,0,46,0
2020-04-13,Chile,NA,Tarapaca,330558,6,0,52,0
2020-04-14,Chile,NA,Tarapaca,330558,10,0,62,0
2020-04-15,Chile,NA,Tarapaca,330558,0,0,62,0
2020-04-16,Chile,NA,Tarapaca,330558,4,0,66,0
2020-04-17,Chile,NA,Tarapaca,330558,7,0,73,0
2020-04-18,Chile,NA,Tarapaca,330558,8,0,81,0
2020-04-19,Chile,NA,Tarapaca,330558,9,0,90,0
2020-04-20,Chile,NA,Tarapaca,330558,3,0,93,0
2020-04-21,Chile,NA,Tarapaca,330558,11,0,104,0
2020-04-22,Chile,NA,Tarapaca,330558,10,0,114,0
2020-04-23,Chile,NA,Tarapaca,330558,14,0,128,0
2020-04-24,Chile,NA,Tarapaca,330558,6,0,134,0
2020-04-25,Chile,NA,Tarapaca,330558,9,1,143,1
2020-04-26,Chile,NA,Tarapaca,330558,13,0,156,1
2020-04-27,Chile,NA,Tarapaca,330558,8,0,164,1
2020-04-28,Chile,NA,Tarapaca,330558,5,0,169,1
2020-04-29,Chile,NA,Tarapaca,330558,14,0,183,1
2020-04-30,Chile,NA,Tarapaca,330558,15,0,198,1
2020-05-01,Chile,NA,Tarapaca,330558,2,0,200,1
2020-05-02,Chile,NA,Tarapaca,330558,12,0,212,1
2020-05-03,Chile,NA,Tarapaca,330558,60,0,272,1
2020-05-04,Chile,NA,Tarapaca,330558,23,0,295,1
2020-05-05,Chile,NA,Tarapaca,330558,27,0,322,1
2020-05-06,Chile,NA,Tarapaca,330558,17,0,339,1
2020-05-07,Chile,NA,Tarapaca,330558,78,0,417,1
2020-05-08,Chile,NA,Tarapaca,330558,42,0,459,1
2020-05-09,Chile,NA,Tarapaca,330558,26,0,485,1
2020-05-10,Chile,NA,Tarapaca,330558,35,0,520,1
2020-05-11,Chile,NA,Tarapaca,330558,27,0,547,1
2020-05-12,Chile,NA,Tarapaca,330558,31,0,578,1
2020-05-13,Chile,NA,Tarapaca,330558,37,0,615,1
2020-05-14,Chile,NA,Tarapaca,330558,67,0,682,1
2020-05-15,Chile,NA,Tarapaca,330558,97,1,779,2
2020-05-16,Chile,NA,Tarapaca,330558,66,0,845,2
2020-05-17,Chile,NA,Tarapaca,330558,130,2,975,4
2020-05-18,Chile,NA,Tarapaca,330558,81,0,1056,4
2020-05-19,Chile,NA,Tarapaca,330558,53,0,1109,4
2020-05-20,Chile,NA,Tarapaca,330558,30,0,1139,4
2020-05-21,Chile,NA,Tarapaca,330558,107,0,1246,4
2020-05-22,Chile,NA,Tarapaca,330558,147,1,1393,5
2020-05-23,Chile,NA,Tarapaca,330558,78,0,1471,5
2020-05-24,Chile,NA,Tarapaca,330558,93,2,1564,7
2020-05-25,Chile,NA,Tarapaca,330558,66,0,1630,7
2020-05-26,Chile,NA,Tarapaca,330558,107,1,1737,8
2020-05-27,Chile,NA,Tarapaca,330558,74,3,1811,11
2020-05-28,Chile,NA,Tarapaca,330558,146,1,1957,12
2020-05-29,Chile,NA,Tarapaca,330558,136,2,2093,14
2020-05-30,Chile,NA,Tarapaca,330558,157,4,2250,18
2020-05-31,Chile,NA,Tarapaca,330558,111,3,2361,21
2020-06-01,Chile,NA,Tarapaca,330558,165,1,2526,22
2020-06-02,Chile,NA,Tarapaca,330558,68,1,2594,23
2020-06-03,Chile,NA,Tarapaca,330558,88,5,2682,28
2020-06-04,Chile,NA,Tarapaca,330558,128,0,2810,28
2020-06-05,Chile,NA,Tarapaca,330558,155,0,2965,28
2020-06-06,Chile,NA,Tarapaca,330558,129,2,3094,30
2020-06-07,Chile,NA,Tarapaca,330558,156,5,3250,35
2020-06-08,Chile,NA,Tarapaca,330558,142,0,3392,35
2020-06-09,Chile,NA,Tarapaca,330558,99,0,3491,35
2020-06-10,Chile,NA,Tarapaca,330558,100,11,3591,46
2020-06-11,Chile,NA,Tarapaca,330558,105,0,3696,46
2020-06-12,Chile,NA,Tarapaca,330558,127,2,3823,48
2020-06-13,Chile,NA,Tarapaca,330558,181,4,4004,52
2020-06-14,Chile,NA,Tarapaca,330558,141,6,4145,58
2020-06-15,Chile,NA,Tarapaca,330558,113,0,4258,58
2020-06-16,Chile,NA,Tarapaca,330558,107,0,4365,58
2020-06-17,Chile,NA,Tarapaca,330558,114,9,4479,67
2020-06-18,Chile,NA,Tarapaca,330558,82,1,4561,68
2020-06-19,Chile,NA,Tarapaca,330558,126,3,4687,71
2020-06-20,Chile,NA,Tarapaca,330558,148,8,4835,79
2020-06-21,Chile,NA,Tarapaca,330558,115,1,4950,80
2020-06-22,Chile,NA,Tarapaca,330558,97,0,5047,80
2020-06-23,Chile,NA,Tarapaca,330558,87,0,5134,80
2020-06-24,Chile,NA,Tarapaca,330558,62,4,5196,84
2020-06-25,Chile,NA,Tarapaca,330558,73,1,5269,85
2020-06-26,Chile,NA,Tarapaca,330558,135,0,5404,85
2020-06-27,Chile,NA,Tarapaca,330558,59,3,5463,88
2020-06-28,Chile,NA,Tarapaca,330558,122,3,5585,91
2020-06-29,Chile,NA,Tarapaca,330558,81,0,5666,91
2020-06-30,Chile,NA,Tarapaca,330558,75,0,5741,91
2020-07-01,Chile,NA,Tarapaca,330558,67,0,5808,91
2020-07-02,Chile,NA,Tarapaca,330558,99,4,5907,95
2020-07-03,Chile,NA,Tarapaca,330558,83,1,5990,96
2020-07-04,Chile,NA,Tarapaca,330558,74,2,6064,98
2020-07-05,Chile,NA,Tarapaca,330558,136,4,6200,102
2020-07-06,Chile,NA,Tarapaca,330558,124,0,6324,102
2020-07-07,Chile,NA,Tarapaca,330558,73,0,6397,102
2020-07-08,Chile,NA,Tarapaca,330558,84,3,6481,105
2020-07-09,Chile,NA,Tarapaca,330558,78,2,6559,107
2020-07-10,Chile,NA,Tarapaca,330558,94,0,6653,107
2020-07-11,Chile,NA,Tarapaca,330558,89,1,6742,108
2020-07-12,Chile,NA,Tarapaca,330558,97,3,6839,111
2020-07-13,Chile,NA,Tarapaca,330558,44,0,6883,111
2020-07-14,Chile,NA,Tarapaca,330558,26,0,6909,111
2020-07-15,Chile,NA,Tarapaca,330558,49,4,6958,115
2020-07-16,Chile,NA,Tarapaca,330558,43,2,7001,117
2020-07-17,Chile,NA,Tarapaca,330558,98,22,7099,139
2020-07-18,Chile,NA,Tarapaca,330558,105,1,7204,140
2020-07-19,Chile,NA,Tarapaca,330558,70,1,7274,141
2020-07-20,Chile,NA,Tarapaca,330558,134,3,7408,144
2020-07-21,Chile,NA,Tarapaca,330558,54,0,7462,144
2020-07-22,Chile,NA,Tarapaca,330558,50,0,7512,144
2020-07-23,Chile,NA,Tarapaca,330558,84,6,7596,150
2020-07-24,Chile,NA,Tarapaca,330558,125,0,7721,150
2020-07-25,Chile,NA,Tarapaca,330558,70,3,7791,153
2020-07-26,Chile,NA,Tarapaca,330558,41,2,7832,155
2020-07-27,Chile,NA,Tarapaca,330558,120,4,7952,159
2020-07-28,Chile,NA,Tarapaca,330558,276,1,8228,160
2020-07-29,Chile,NA,Tarapaca,330558,63,0,8291,160
2020-07-30,Chile,NA,Tarapaca,330558,116,2,8407,162
2020-07-31,Chile,NA,Tarapaca,330558,35,4,8442,166
2020-08-01,Chile,NA,Tarapaca,330558,64,2,8506,168
2020-08-02,Chile,NA,Tarapaca,330558,61,2,8567,170
2020-08-03,Chile,NA,Tarapaca,330558,63,3,8630,173
2020-08-04,Chile,NA,Tarapaca,330558,60,0,8690,173
2020-08-05,Chile,NA,Tarapaca,330558,83,0,8773,173
2020-08-06,Chile,NA,Tarapaca,330558,39,4,8812,177
2020-08-07,Chile,NA,Tarapaca,330558,85,1,8897,178
2020-08-08,Chile,NA,Tarapaca,330558,27,2,8924,180
2020-08-09,Chile,NA,Tarapaca,330558,89,1,9013,181
2020-08-10,Chile,NA,Tarapaca,330558,52,1,9065,182
2020-08-11,Chile,NA,Tarapaca,330558,124,0,9189,182
2020-08-12,Chile,NA,Tarapaca,330558,72,0,9261,182
2020-08-13,Chile,NA,Tarapaca,330558,85,3,9346,185
2020-08-14,Chile,NA,Tarapaca,330558,72,0,9418,185
2020-08-15,Chile,NA,Tarapaca,330558,51,0,9469,185
2020-08-16,Chile,NA,Tarapaca,330558,54,1,9523,186
2020-08-17,Chile,NA,Tarapaca,330558,93,0,9616,186
2020-08-18,Chile,NA,Tarapaca,330558,63,0,9679,186
2020-08-19,Chile,NA,Tarapaca,330558,52,0,9731,186
2020-08-20,Chile,NA,Tarapaca,330558,52,5,9783,191
2020-08-21,Chile,NA,Tarapaca,330558,76,0,9859,191
2020-08-22,Chile,NA,Tarapaca,330558,49,2,9908,193
2020-08-23,Chile,NA,Tarapaca,330558,69,0,9977,193
2020-08-24,Chile,NA,Tarapaca,330558,54,3,10031,196
2020-08-25,Chile,NA,Tarapaca,330558,44,0,10075,196
2020-08-26,Chile,NA,Tarapaca,330558,38,0,10113,196
2020-08-27,Chile,NA,Tarapaca,330558,39,2,10152,198
2020-08-28,Chile,NA,Tarapaca,330558,35,1,10187,199
2020-08-29,Chile,NA,Tarapaca,330558,64,0,10251,199
2020-08-30,Chile,NA,Tarapaca,330558,43,4,10294,203
2020-08-31,Chile,NA,Tarapaca,330558,39,1,10333,204
2020-09-01,Chile,NA,Tarapaca,330558,28,0,10361,204
2020-09-02,Chile,NA,Tarapaca,330558,46,0,10407,204
2020-09-03,Chile,NA,Tarapaca,330558,36,2,10443,206
2020-09-04,Chile,NA,Tarapaca,330558,36,1,10479,207
2020-09-05,Chile,NA,Tarapaca,330558,41,0,10520,207
2020-09-06,Chile,NA,Tarapaca,330558,40,3,10560,210
2020-09-07,Chile,NA,Tarapaca,330558,21,1,10581,211
2020-09-08,Chile,NA,Tarapaca,330558,38,0,10619,211
2020-09-09,Chile,NA,Tarapaca,330558,48,0,10667,211
2020-09-10,Chile,NA,Tarapaca,330558,30,2,10697,213
2020-09-11,Chile,NA,Tarapaca,330558,40,0,10737,213
2020-09-12,Chile,NA,Tarapaca,330558,40,0,10777,213
2020-09-13,Chile,NA,Tarapaca,330558,61,1,10838,214
2020-09-14,Chile,NA,Tarapaca,330558,41,1,10879,215
2020-09-15,Chile,NA,Tarapaca,330558,37,0,10916,215
2020-09-16,Chile,NA,Tarapaca,330558,21,0,10937,215
2020-09-17,Chile,NA,Tarapaca,330558,46,3,10983,218
2020-09-18,Chile,NA,Tarapaca,330558,42,0,11025,218
2020-09-19,Chile,NA,Tarapaca,330558,20,0,11045,218
2020-09-20,Chile,NA,Tarapaca,330558,34,1,11079,219
2020-09-21,Chile,NA,Tarapaca,330558,34,0,11113,219
2020-09-22,Chile,NA,Tarapaca,330558,28,0,11141,219
2020-09-23,Chile,NA,Tarapaca,330558,15,0,11156,219
2020-03-21,Chile,NA,Valparaiso,1815902,8,0,13,0
2020-03-22,Chile,NA,Valparaiso,1815902,3,0,16,0
2020-03-23,Chile,NA,Valparaiso,1815902,3,0,19,0
2020-03-24,Chile,NA,Valparaiso,1815902,6,0,25,0
2020-03-25,Chile,NA,Valparaiso,1815902,7,0,32,0
2020-03-26,Chile,NA,Valparaiso,1815902,12,0,44,0
2020-03-27,Chile,NA,Valparaiso,1815902,5,0,49,0
2020-03-28,Chile,NA,Valparaiso,1815902,22,0,71,0
2020-03-29,Chile,NA,Valparaiso,1815902,9,0,80,0
2020-03-30,Chile,NA,Valparaiso,1815902,28,0,108,0
2020-03-31,Chile,NA,Valparaiso,1815902,7,1,115,1
2020-04-01,Chile,NA,Valparaiso,1815902,21,0,136,1
2020-04-02,Chile,NA,Valparaiso,1815902,20,0,156,1
2020-04-03,Chile,NA,Valparaiso,1815902,20,0,176,1
2020-04-04,Chile,NA,Valparaiso,1815902,9,0,185,1
2020-04-05,Chile,NA,Valparaiso,1815902,6,0,191,1
2020-04-06,Chile,NA,Valparaiso,1815902,7,0,198,1
2020-04-07,Chile,NA,Valparaiso,1815902,16,0,214,1
2020-04-08,Chile,NA,Valparaiso,1815902,11,1,225,2
2020-04-09,Chile,NA,Valparaiso,1815902,5,0,230,2
2020-04-10,Chile,NA,Valparaiso,1815902,11,0,241,2
2020-04-11,Chile,NA,Valparaiso,1815902,7,0,248,2
2020-04-12,Chile,NA,Valparaiso,1815902,6,0,254,2
2020-04-13,Chile,NA,Valparaiso,1815902,19,0,273,2
2020-04-14,Chile,NA,Valparaiso,1815902,12,0,285,2
2020-04-15,Chile,NA,Valparaiso,1815902,14,0,299,2
2020-04-16,Chile,NA,Valparaiso,1815902,31,2,330,4
2020-04-17,Chile,NA,Valparaiso,1815902,15,0,345,4
2020-04-18,Chile,NA,Valparaiso,1815902,14,0,359,4
2020-04-19,Chile,NA,Valparaiso,1815902,22,1,381,5
2020-04-20,Chile,NA,Valparaiso,1815902,7,0,388,5
2020-04-21,Chile,NA,Valparaiso,1815902,15,1,403,6
2020-04-22,Chile,NA,Valparaiso,1815902,18,1,421,7
2020-04-23,Chile,NA,Valparaiso,1815902,8,0,429,7
2020-04-24,Chile,NA,Valparaiso,1815902,7,1,436,8
2020-04-25,Chile,NA,Valparaiso,1815902,18,1,454,9
2020-04-26,Chile,NA,Valparaiso,1815902,6,0,460,9
2020-04-27,Chile,NA,Valparaiso,1815902,25,0,485,9
2020-04-28,Chile,NA,Valparaiso,1815902,8,1,493,10
2020-04-29,Chile,NA,Valparaiso,1815902,33,2,526,12
2020-04-30,Chile,NA,Valparaiso,1815902,33,0,559,12
2020-05-01,Chile,NA,Valparaiso,1815902,9,0,568,12
2020-05-02,Chile,NA,Valparaiso,1815902,46,1,614,13
2020-05-03,Chile,NA,Valparaiso,1815902,24,0,638,13
2020-05-04,Chile,NA,Valparaiso,1815902,18,0,656,13
2020-05-05,Chile,NA,Valparaiso,1815902,31,2,687,15
2020-05-06,Chile,NA,Valparaiso,1815902,29,1,716,16
2020-05-07,Chile,NA,Valparaiso,1815902,65,1,781,17
2020-05-08,Chile,NA,Valparaiso,1815902,47,1,828,18
2020-05-09,Chile,NA,Valparaiso,1815902,50,1,878,19
2020-05-10,Chile,NA,Valparaiso,1815902,55,1,933,20
2020-05-11,Chile,NA,Valparaiso,1815902,37,1,970,21
2020-05-12,Chile,NA,Valparaiso,1815902,59,2,1029,23
2020-05-13,Chile,NA,Valparaiso,1815902,94,1,1123,24
2020-05-14,Chile,NA,Valparaiso,1815902,90,1,1213,25
2020-05-15,Chile,NA,Valparaiso,1815902,99,2,1312,27
2020-05-16,Chile,NA,Valparaiso,1815902,53,1,1365,28
2020-05-17,Chile,NA,Valparaiso,1815902,109,1,1474,29
2020-05-18,Chile,NA,Valparaiso,1815902,79,1,1553,30
2020-05-19,Chile,NA,Valparaiso,1815902,86,2,1639,32
2020-05-20,Chile,NA,Valparaiso,1815902,131,3,1770,35
2020-05-21,Chile,NA,Valparaiso,1815902,117,3,1887,38
2020-05-22,Chile,NA,Valparaiso,1815902,133,2,2020,40
2020-05-23,Chile,NA,Valparaiso,1815902,96,4,2116,44
2020-05-24,Chile,NA,Valparaiso,1815902,114,4,2230,48
2020-05-25,Chile,NA,Valparaiso,1815902,75,5,2305,53
2020-05-26,Chile,NA,Valparaiso,1815902,150,4,2455,57
2020-05-27,Chile,NA,Valparaiso,1815902,121,1,2576,58
2020-05-28,Chile,NA,Valparaiso,1815902,154,2,2730,60
2020-05-29,Chile,NA,Valparaiso,1815902,112,1,2842,61
2020-05-30,Chile,NA,Valparaiso,1815902,195,2,3037,63
2020-05-31,Chile,NA,Valparaiso,1815902,130,3,3167,66
2020-06-01,Chile,NA,Valparaiso,1815902,181,4,3348,70
2020-06-02,Chile,NA,Valparaiso,1815902,247,2,3595,72
2020-06-03,Chile,NA,Valparaiso,1815902,174,5,3769,77
2020-06-04,Chile,NA,Valparaiso,1815902,248,1,4017,78
2020-06-05,Chile,NA,Valparaiso,1815902,249,10,4266,88
2020-06-06,Chile,NA,Valparaiso,1815902,314,3,4580,91
2020-06-07,Chile,NA,Valparaiso,1815902,282,0,4862,91
2020-06-08,Chile,NA,Valparaiso,1815902,287,2,5149,91
2020-06-09,Chile,NA,Valparaiso,1815902,242,0,5391,91
2020-06-10,Chile,NA,Valparaiso,1815902,223,14,5614,99
2020-06-11,Chile,NA,Valparaiso,1815902,251,8,5865,107
2020-06-12,Chile,NA,Valparaiso,1815902,306,11,6171,118
2020-06-13,Chile,NA,Valparaiso,1815902,356,2,6527,120
2020-06-14,Chile,NA,Valparaiso,1815902,231,5,6758,125
2020-06-15,Chile,NA,Valparaiso,1815902,254,1,7012,126
2020-06-16,Chile,NA,Valparaiso,1815902,250,0,7262,126
2020-06-17,Chile,NA,Valparaiso,1815902,206,15,7468,141
2020-06-18,Chile,NA,Valparaiso,1815902,220,2,7688,143
2020-06-19,Chile,NA,Valparaiso,1815902,285,7,7973,150
2020-06-20,Chile,NA,Valparaiso,1815902,256,8,8229,158
2020-06-21,Chile,NA,Valparaiso,1815902,284,12,8513,170
2020-06-22,Chile,NA,Valparaiso,1815902,317,0,8830,170
2020-06-23,Chile,NA,Valparaiso,1815902,286,0,9116,170
2020-06-24,Chile,NA,Valparaiso,1815902,286,17,9402,187
2020-06-25,Chile,NA,Valparaiso,1815902,295,8,9697,195
2020-06-26,Chile,NA,Valparaiso,1815902,315,9,10012,204
2020-06-27,Chile,NA,Valparaiso,1815902,257,13,10269,217
2020-06-28,Chile,NA,Valparaiso,1815902,253,12,10522,229
2020-06-29,Chile,NA,Valparaiso,1815902,234,0,10756,229
2020-06-30,Chile,NA,Valparaiso,1815902,211,1,10967,230
2020-07-01,Chile,NA,Valparaiso,1815902,256,0,11223,230
2020-07-02,Chile,NA,Valparaiso,1815902,193,22,11416,252
2020-07-03,Chile,NA,Valparaiso,1815902,264,14,11680,266
2020-07-04,Chile,NA,Valparaiso,1815902,301,12,11981,278
2020-07-05,Chile,NA,Valparaiso,1815902,285,14,12266,292
2020-07-06,Chile,NA,Valparaiso,1815902,180,0,12446,292
2020-07-07,Chile,NA,Valparaiso,1815902,202,0,12648,292
2020-07-08,Chile,NA,Valparaiso,1815902,165,11,12813,303
2020-07-09,Chile,NA,Valparaiso,1815902,199,9,13012,312
2020-07-10,Chile,NA,Valparaiso,1815902,256,8,13268,320
2020-07-11,Chile,NA,Valparaiso,1815902,204,6,13472,326
2020-07-12,Chile,NA,Valparaiso,1815902,259,5,13731,331
2020-07-13,Chile,NA,Valparaiso,1815902,218,0,13949,331
2020-07-14,Chile,NA,Valparaiso,1815902,169,0,14118,331
2020-07-15,Chile,NA,Valparaiso,1815902,113,16,14231,347
2020-07-16,Chile,NA,Valparaiso,1815902,196,16,14427,363
2020-07-17,Chile,NA,Valparaiso,1815902,193,44,14620,407
2020-07-18,Chile,NA,Valparaiso,1815902,142,6,14762,413
2020-07-19,Chile,NA,Valparaiso,1815902,180,1,14942,414
2020-07-20,Chile,NA,Valparaiso,1815902,181,13,15123,427
2020-07-21,Chile,NA,Valparaiso,1815902,146,0,15269,427
2020-07-22,Chile,NA,Valparaiso,1815902,207,1,15476,428
2020-07-23,Chile,NA,Valparaiso,1815902,197,13,15673,441
2020-07-24,Chile,NA,Valparaiso,1815902,160,10,15833,451
2020-07-25,Chile,NA,Valparaiso,1815902,247,9,16080,460
2020-07-26,Chile,NA,Valparaiso,1815902,143,4,16223,464
2020-07-27,Chile,NA,Valparaiso,1815902,147,6,16370,470
2020-07-28,Chile,NA,Valparaiso,1815902,131,1,16501,471
2020-07-29,Chile,NA,Valparaiso,1815902,111,0,16612,471
2020-07-30,Chile,NA,Valparaiso,1815902,176,21,16788,492
2020-07-31,Chile,NA,Valparaiso,1815902,149,5,16937,497
2020-08-01,Chile,NA,Valparaiso,1815902,185,10,17122,507
2020-08-02,Chile,NA,Valparaiso,1815902,193,6,17315,513
2020-08-03,Chile,NA,Valparaiso,1815902,123,9,17438,522
2020-08-04,Chile,NA,Valparaiso,1815902,137,0,17575,522
2020-08-05,Chile,NA,Valparaiso,1815902,109,2,17684,524
2020-08-06,Chile,NA,Valparaiso,1815902,190,18,17874,542
2020-08-07,Chile,NA,Valparaiso,1815902,166,5,18040,547
2020-08-08,Chile,NA,Valparaiso,1815902,240,4,18280,551
2020-08-09,Chile,NA,Valparaiso,1815902,170,13,18450,564
2020-08-10,Chile,NA,Valparaiso,1815902,155,5,18605,569
2020-08-11,Chile,NA,Valparaiso,1815902,127,0,18732,569
2020-08-12,Chile,NA,Valparaiso,1815902,145,4,18877,573
2020-08-13,Chile,NA,Valparaiso,1815902,181,19,19058,592
2020-08-14,Chile,NA,Valparaiso,1815902,186,3,19244,595
2020-08-15,Chile,NA,Valparaiso,1815902,183,5,19427,600
2020-08-16,Chile,NA,Valparaiso,1815902,234,7,19661,607
2020-08-17,Chile,NA,Valparaiso,1815902,130,9,19791,616
2020-08-18,Chile,NA,Valparaiso,1815902,111,1,19902,617
2020-08-19,Chile,NA,Valparaiso,1815902,160,1,20062,618
2020-08-20,Chile,NA,Valparaiso,1815902,154,10,20216,628
2020-08-21,Chile,NA,Valparaiso,1815902,190,6,20406,634
2020-08-22,Chile,NA,Valparaiso,1815902,165,7,20571,641
2020-08-23,Chile,NA,Valparaiso,1815902,193,4,20764,645
2020-08-24,Chile,NA,Valparaiso,1815902,172,6,20936,651
2020-08-25,Chile,NA,Valparaiso,1815902,111,1,21047,652
2020-08-26,Chile,NA,Valparaiso,1815902,141,0,21188,652
2020-08-27,Chile,NA,Valparaiso,1815902,179,13,21367,665
2020-08-28,Chile,NA,Valparaiso,1815902,218,9,21585,674
2020-08-29,Chile,NA,Valparaiso,1815902,233,8,21818,682
2020-08-30,Chile,NA,Valparaiso,1815902,233,11,22051,693
2020-08-31,Chile,NA,Valparaiso,1815902,206,8,22257,701
2020-09-01,Chile,NA,Valparaiso,1815902,171,2,22428,703
2020-09-02,Chile,NA,Valparaiso,1815902,206,0,22634,703
2020-09-03,Chile,NA,Valparaiso,1815902,149,16,22783,719
2020-09-04,Chile,NA,Valparaiso,1815902,204,9,22987,728
2020-09-05,Chile,NA,Valparaiso,1815902,207,7,23194,735
2020-09-06,Chile,NA,Valparaiso,1815902,195,6,23389,741
2020-09-07,Chile,NA,Valparaiso,1815902,139,11,23528,752
2020-09-08,Chile,NA,Valparaiso,1815902,121,2,23649,754
2020-09-09,Chile,NA,Valparaiso,1815902,111,0,23760,754
2020-09-10,Chile,NA,Valparaiso,1815902,166,12,23926,766
2020-09-11,Chile,NA,Valparaiso,1815902,187,4,24113,770
2020-09-12,Chile,NA,Valparaiso,1815902,191,6,24304,776
2020-09-13,Chile,NA,Valparaiso,1815902,200,7,24504,783
2020-09-14,Chile,NA,Valparaiso,1815902,191,8,24695,791
2020-09-15,Chile,NA,Valparaiso,1815902,149,0,24844,791
2020-09-16,Chile,NA,Valparaiso,1815902,103,0,24947,791
2020-09-17,Chile,NA,Valparaiso,1815902,121,14,25068,805
2020-09-18,Chile,NA,Valparaiso,1815902,200,9,25268,814
2020-09-19,Chile,NA,Valparaiso,1815902,155,9,25423,823
2020-09-20,Chile,NA,Valparaiso,1815902,116,3,25539,826
2020-09-21,Chile,NA,Valparaiso,1815902,67,0,25606,826
2020-09-22,Chile,NA,Valparaiso,1815902,53,0,25659,826
2020-09-23,Chile,NA,Valparaiso,1815902,98,0,25757,826
2020-04-23,Colombia,NA,Amazonas,79020,7,1,14,2
2020-04-24,Colombia,NA,Amazonas,79020,2,1,16,3
2020-04-25,Colombia,NA,Amazonas,79020,23,1,39,6
2020-04-26,Colombia,NA,Amazonas,79020,3,1,42,7
2020-04-28,Colombia,NA,Amazonas,79020,37,2,79,9
2020-04-29,Colombia,NA,Amazonas,79020,27,3,106,12
2020-04-30,Colombia,NA,Amazonas,79020,0,5,106,17
2020-05-01,Colombia,NA,Amazonas,79020,1,2,107,19
2020-05-02,Colombia,NA,Amazonas,79020,34,1,141,20
2020-05-03,Colombia,NA,Amazonas,79020,45,0,186,20
2020-05-04,Colombia,NA,Amazonas,79020,47,1,233,21
2020-05-05,Colombia,NA,Amazonas,79020,1,3,234,24
2020-05-06,Colombia,NA,Amazonas,79020,2,5,236,29
2020-05-07,Colombia,NA,Amazonas,79020,187,8,423,37
2020-05-08,Colombia,NA,Amazonas,79020,12,2,435,39
2020-05-09,Colombia,NA,Amazonas,79020,4,0,439,39
2020-05-10,Colombia,NA,Amazonas,79020,96,0,535,39
2020-05-11,Colombia,NA,Amazonas,79020,189,2,724,41
2020-05-12,Colombia,NA,Amazonas,79020,27,2,751,43
2020-05-13,Colombia,NA,Amazonas,79020,126,4,877,47
2020-05-14,Colombia,NA,Amazonas,79020,53,2,930,49
2020-05-15,Colombia,NA,Amazonas,79020,79,2,1009,51
2020-05-16,Colombia,NA,Amazonas,79020,1,1,1010,52
2020-05-17,Colombia,NA,Amazonas,79020,6,2,1016,54
2020-05-18,Colombia,NA,Amazonas,79020,176,4,1192,58
2020-05-19,Colombia,NA,Amazonas,79020,38,3,1230,61
2020-05-20,Colombia,NA,Amazonas,79020,90,0,1320,61
2020-05-21,Colombia,NA,Amazonas,79020,72,1,1392,62
2020-05-22,Colombia,NA,Amazonas,79020,0,2,1392,64
2020-05-23,Colombia,NA,Amazonas,79020,3,2,1395,66
2020-05-24,Colombia,NA,Amazonas,79020,67,2,1462,68
2020-05-25,Colombia,NA,Amazonas,79020,54,0,1516,68
2020-05-26,Colombia,NA,Amazonas,79020,36,2,1552,70
2020-05-27,Colombia,NA,Amazonas,79020,192,6,1744,76
2020-05-28,Colombia,NA,Amazonas,79020,38,0,1782,76
2020-05-29,Colombia,NA,Amazonas,79020,42,1,1824,77
2020-05-30,Colombia,NA,Amazonas,79020,35,1,1859,78
2020-05-31,Colombia,NA,Amazonas,79020,13,0,1872,78
2020-06-01,Colombia,NA,Amazonas,79020,0,1,1872,79
2020-06-02,Colombia,NA,Amazonas,79020,5,3,1877,82
2020-06-03,Colombia,NA,Amazonas,79020,42,4,1919,86
2020-06-04,Colombia,NA,Amazonas,79020,2,1,1921,87
2020-06-05,Colombia,NA,Amazonas,79020,31,4,1952,91
2020-06-06,Colombia,NA,Amazonas,79020,4,1,1956,92
2020-06-07,Colombia,NA,Amazonas,79020,11,1,1967,93
2020-06-08,Colombia,NA,Amazonas,79020,37,1,2004,94
2020-06-09,Colombia,NA,Amazonas,79020,4,0,2008,94
2020-06-10,Colombia,NA,Amazonas,79020,33,1,2041,95
2020-06-11,Colombia,NA,Amazonas,79020,23,0,2064,95
2020-06-12,Colombia,NA,Amazonas,79020,0,1,2064,96
2020-06-13,Colombia,NA,Amazonas,79020,20,0,2084,96
2020-06-14,Colombia,NA,Amazonas,79020,15,1,2099,97
2020-06-15,Colombia,NA,Amazonas,79020,5,0,2104,97
2020-06-16,Colombia,NA,Amazonas,79020,25,0,2129,97
2020-06-17,Colombia,NA,Amazonas,79020,8,0,2137,97
2020-06-18,Colombia,NA,Amazonas,79020,8,1,2145,98
2020-06-19,Colombia,NA,Amazonas,79020,5,0,2150,98
2020-06-20,Colombia,NA,Amazonas,79020,1,0,2151,98
2020-06-21,Colombia,NA,Amazonas,79020,10,0,2161,98
2020-06-22,Colombia,NA,Amazonas,79020,5,0,2166,98
2020-06-23,Colombia,NA,Amazonas,79020,12,1,2178,99
2020-06-24,Colombia,NA,Amazonas,79020,6,0,2184,99
2020-06-25,Colombia,NA,Amazonas,79020,4,0,2188,99
2020-06-26,Colombia,NA,Amazonas,79020,14,0,2202,99
2020-06-27,Colombia,NA,Amazonas,79020,7,0,2209,99
2020-06-28,Colombia,NA,Amazonas,79020,18,2,2227,101
2020-06-29,Colombia,NA,Amazonas,79020,28,0,2255,101
2020-06-30,Colombia,NA,Amazonas,79020,7,0,2262,101
2020-07-01,Colombia,NA,Amazonas,79020,13,0,2275,101
2020-07-02,Colombia,NA,Amazonas,79020,3,0,2278,101
2020-07-03,Colombia,NA,Amazonas,79020,3,0,2281,101
2020-07-04,Colombia,NA,Amazonas,79020,4,0,2285,101
2020-07-05,Colombia,NA,Amazonas,79020,4,1,2289,102
2020-07-06,Colombia,NA,Amazonas,79020,7,3,2296,105
2020-07-07,Colombia,NA,Amazonas,79020,5,1,2301,106
2020-07-08,Colombia,NA,Amazonas,79020,9,0,2310,106
2020-07-09,Colombia,NA,Amazonas,79020,9,0,2319,106
2020-07-10,Colombia,NA,Amazonas,79020,4,0,2323,106
2020-07-11,Colombia,NA,Amazonas,79020,5,1,2328,107
2020-07-12,Colombia,NA,Amazonas,79020,3,0,2331,107
2020-07-13,Colombia,NA,Amazonas,79020,5,0,2336,107
2020-07-14,Colombia,NA,Amazonas,79020,4,0,2340,107
2020-07-15,Colombia,NA,Amazonas,79020,9,0,2349,107
2020-07-16,Colombia,NA,Amazonas,79020,4,0,2353,107
2020-07-17,Colombia,NA,Amazonas,79020,1,0,2354,107
2020-07-18,Colombia,NA,Amazonas,79020,4,0,2358,107
2020-07-19,Colombia,NA,Amazonas,79020,0,0,2358,107
2020-07-20,Colombia,NA,Amazonas,79020,1,0,2359,107
2020-07-21,Colombia,NA,Amazonas,79020,1,1,2360,108
2020-07-22,Colombia,NA,Amazonas,79020,29,1,2389,109
2020-07-23,Colombia,NA,Amazonas,79020,5,0,2394,109
2020-07-24,Colombia,NA,Amazonas,79020,5,0,2399,109
2020-07-25,Colombia,NA,Amazonas,79020,0,0,2399,109
2020-07-26,Colombia,NA,Amazonas,79020,3,1,2402,110
2020-07-27,Colombia,NA,Amazonas,79020,0,0,2402,110
2020-07-28,Colombia,NA,Amazonas,79020,0,0,2402,110
2020-07-29,Colombia,NA,Amazonas,79020,2,0,2404,110
2020-07-30,Colombia,NA,Amazonas,79020,1,0,2405,110
2020-07-31,Colombia,NA,Amazonas,79020,1,0,2406,110
2020-08-01,Colombia,NA,Amazonas,79020,1,0,2407,110
2020-08-02,Colombia,NA,Amazonas,79020,6,0,2413,110
2020-08-03,Colombia,NA,Amazonas,79020,0,0,2413,110
2020-08-04,Colombia,NA,Amazonas,79020,38,0,2451,110
2020-08-05,Colombia,NA,Amazonas,79020,39,0,2490,110
2020-08-06,Colombia,NA,Amazonas,79020,0,2,2490,112
2020-08-07,Colombia,NA,Amazonas,79020,4,0,2494,112
2020-08-09,Colombia,NA,Amazonas,79020,32,0,2526,112
2020-08-10,Colombia,NA,Amazonas,79020,5,0,2531,112
2020-08-11,Colombia,NA,Amazonas,79020,7,1,2538,113
2020-08-12,Colombia,NA,Amazonas,79020,3,0,2541,113
2020-08-13,Colombia,NA,Amazonas,79020,6,0,2547,113
2020-08-14,Colombia,NA,Amazonas,79020,1,1,2548,114
2020-08-15,Colombia,NA,Amazonas,79020,7,0,2555,114
2020-08-16,Colombia,NA,Amazonas,79020,0,0,2555,114
2020-08-17,Colombia,NA,Amazonas,79020,5,0,2560,114
2020-08-18,Colombia,NA,Amazonas,79020,3,0,2563,114
2020-08-19,Colombia,NA,Amazonas,79020,3,0,2566,114
2020-08-20,Colombia,NA,Amazonas,79020,1,0,2567,114
2020-08-21,Colombia,NA,Amazonas,79020,2,0,2569,114
2020-08-22,Colombia,NA,Amazonas,79020,6,0,2575,114
2020-08-23,Colombia,NA,Amazonas,79020,1,0,2576,114
2020-08-24,Colombia,NA,Amazonas,79020,0,0,2576,114
2020-08-25,Colombia,NA,Amazonas,79020,3,0,2579,114
2020-08-26,Colombia,NA,Amazonas,79020,0,0,2579,114
2020-08-27,Colombia,NA,Amazonas,79020,3,1,2582,115
2020-08-28,Colombia,NA,Amazonas,79020,0,0,2582,115
2020-08-29,Colombia,NA,Amazonas,79020,4,0,2586,115
2020-08-30,Colombia,NA,Amazonas,79020,2,1,2588,116
2020-08-31,Colombia,NA,Amazonas,79020,2,2,2590,118
2020-09-01,Colombia,NA,Amazonas,79020,12,0,2602,118
2020-09-02,Colombia,NA,Amazonas,79020,1,1,2603,119
2020-09-03,Colombia,NA,Amazonas,79020,0,0,2603,119
2020-09-04,Colombia,NA,Amazonas,79020,2,1,2605,120
2020-09-05,Colombia,NA,Amazonas,79020,2,0,2607,120
2020-09-06,Colombia,NA,Amazonas,79020,0,0,2607,120
2020-09-07,Colombia,NA,Amazonas,79020,3,0,2610,120
2020-09-08,Colombia,NA,Amazonas,79020,4,0,2614,120
2020-09-09,Colombia,NA,Amazonas,79020,0,0,2614,120
2020-09-10,Colombia,NA,Amazonas,79020,2,0,2616,120
2020-09-11,Colombia,NA,Amazonas,79020,5,1,2621,121
2020-09-12,Colombia,NA,Amazonas,79020,0,0,2621,121
2020-09-13,Colombia,NA,Amazonas,79020,0,0,2621,121
2020-09-14,Colombia,NA,Amazonas,79020,0,0,2621,121
2020-09-15,Colombia,NA,Amazonas,79020,0,0,2621,121
2020-09-18,Colombia,NA,Amazonas,79020,4,0,2625,121
2020-09-19,Colombia,NA,Amazonas,79020,0,1,2625,122
2020-09-20,Colombia,NA,Amazonas,79020,0,0,2625,122
2020-09-21,Colombia,NA,Amazonas,79020,0,0,2625,122
2020-09-22,Colombia,NA,Amazonas,79020,1,0,2626,122
2020-09-23,Colombia,NA,Amazonas,79020,2,0,2628,122
2020-03-19,Colombia,NA,Antioquia,6677930,3,0,11,0
2020-03-20,Colombia,NA,Antioquia,6677930,11,0,22,0
2020-03-21,Colombia,NA,Antioquia,6677930,3,0,25,0
2020-03-22,Colombia,NA,Antioquia,6677930,5,0,30,0
2020-03-23,Colombia,NA,Antioquia,6677930,22,0,52,0
2020-03-24,Colombia,NA,Antioquia,6677930,0,0,52,0
2020-03-25,Colombia,NA,Antioquia,6677930,8,0,60,0
2020-03-26,Colombia,NA,Antioquia,6677930,0,0,60,0
2020-03-28,Colombia,NA,Antioquia,6677930,7,0,67,0
2020-03-29,Colombia,NA,Antioquia,6677930,19,0,86,0
2020-03-30,Colombia,NA,Antioquia,6677930,10,0,96,0
2020-03-31,Colombia,NA,Antioquia,6677930,5,0,101,0
2020-04-01,Colombia,NA,Antioquia,6677930,6,0,107,0
2020-04-02,Colombia,NA,Antioquia,6677930,20,0,127,0
2020-04-03,Colombia,NA,Antioquia,6677930,18,1,145,1
2020-04-04,Colombia,NA,Antioquia,6677930,5,0,150,1
2020-04-05,Colombia,NA,Antioquia,6677930,22,0,172,1
2020-04-06,Colombia,NA,Antioquia,6677930,11,0,183,1
2020-04-07,Colombia,NA,Antioquia,6677930,15,0,198,1
2020-04-08,Colombia,NA,Antioquia,6677930,37,0,235,1
2020-04-09,Colombia,NA,Antioquia,6677930,4,0,239,1
2020-04-10,Colombia,NA,Antioquia,6677930,7,0,246,1
2020-04-11,Colombia,NA,Antioquia,6677930,6,0,252,1
2020-04-12,Colombia,NA,Antioquia,6677930,8,0,260,1
2020-04-13,Colombia,NA,Antioquia,6677930,13,0,273,1
2020-04-14,Colombia,NA,Antioquia,6677930,17,0,290,1
2020-04-15,Colombia,NA,Antioquia,6677930,12,0,302,1
2020-04-16,Colombia,NA,Antioquia,6677930,7,0,309,1
2020-04-17,Colombia,NA,Antioquia,6677930,16,0,325,1
2020-04-18,Colombia,NA,Antioquia,6677930,9,2,334,3
2020-04-19,Colombia,NA,Antioquia,6677930,18,0,352,3
2020-04-20,Colombia,NA,Antioquia,6677930,11,0,363,3
2020-04-21,Colombia,NA,Antioquia,6677930,3,0,366,3
2020-04-22,Colombia,NA,Antioquia,6677930,12,0,378,3
2020-04-23,Colombia,NA,Antioquia,6677930,23,0,401,3
2020-04-24,Colombia,NA,Antioquia,6677930,6,1,407,4
2020-04-25,Colombia,NA,Antioquia,6677930,2,0,409,4
2020-04-26,Colombia,NA,Antioquia,6677930,3,0,412,4
2020-04-27,Colombia,NA,Antioquia,6677930,8,1,420,5
2020-04-28,Colombia,NA,Antioquia,6677930,3,0,423,5
2020-04-29,Colombia,NA,Antioquia,6677930,5,0,428,5
2020-04-30,Colombia,NA,Antioquia,6677930,4,0,432,5
2020-05-01,Colombia,NA,Antioquia,6677930,3,0,435,5
2020-05-02,Colombia,NA,Antioquia,6677930,1,1,436,6
2020-05-03,Colombia,NA,Antioquia,6677930,7,0,443,6
2020-05-04,Colombia,NA,Antioquia,6677930,5,0,448,6
2020-05-05,Colombia,NA,Antioquia,6677930,3,0,451,6
2020-05-06,Colombia,NA,Antioquia,6677930,5,0,456,6
2020-05-07,Colombia,NA,Antioquia,6677930,4,0,460,6
2020-05-08,Colombia,NA,Antioquia,6677930,4,0,464,6
2020-05-09,Colombia,NA,Antioquia,6677930,2,0,466,6
2020-05-10,Colombia,NA,Antioquia,6677930,2,0,468,6
2020-05-11,Colombia,NA,Antioquia,6677930,6,0,474,6
2020-05-12,Colombia,NA,Antioquia,6677930,7,0,481,6
2020-05-13,Colombia,NA,Antioquia,6677930,10,0,491,6
2020-05-14,Colombia,NA,Antioquia,6677930,11,0,502,6
2020-05-15,Colombia,NA,Antioquia,6677930,8,0,510,6
2020-05-16,Colombia,NA,Antioquia,6677930,9,0,519,6
2020-05-17,Colombia,NA,Antioquia,6677930,16,0,535,6
2020-05-18,Colombia,NA,Antioquia,6677930,9,0,544,6
2020-05-19,Colombia,NA,Antioquia,6677930,18,0,562,6
2020-05-20,Colombia,NA,Antioquia,6677930,12,0,574,6
2020-05-21,Colombia,NA,Antioquia,6677930,14,0,588,6
2020-05-22,Colombia,NA,Antioquia,6677930,29,0,617,6
2020-05-23,Colombia,NA,Antioquia,6677930,61,0,678,6
2020-05-24,Colombia,NA,Antioquia,6677930,43,0,721,6
2020-05-25,Colombia,NA,Antioquia,6677930,141,0,862,6
2020-05-26,Colombia,NA,Antioquia,6677930,68,0,930,6
2020-05-27,Colombia,NA,Antioquia,6677930,25,0,955,6
2020-05-28,Colombia,NA,Antioquia,6677930,48,0,1003,6
2020-05-29,Colombia,NA,Antioquia,6677930,22,0,1025,6
2020-05-30,Colombia,NA,Antioquia,6677930,35,0,1060,6
2020-05-31,Colombia,NA,Antioquia,6677930,45,0,1105,6
2020-06-01,Colombia,NA,Antioquia,6677930,67,0,1172,6
2020-06-02,Colombia,NA,Antioquia,6677930,28,0,1200,6
2020-06-03,Colombia,NA,Antioquia,6677930,61,0,1261,6
2020-06-04,Colombia,NA,Antioquia,6677930,68,0,1329,6
2020-06-05,Colombia,NA,Antioquia,6677930,32,1,1361,7
2020-06-06,Colombia,NA,Antioquia,6677930,91,1,1452,8
2020-06-07,Colombia,NA,Antioquia,6677930,67,1,1519,9
2020-06-08,Colombia,NA,Antioquia,6677930,55,0,1574,9
2020-06-09,Colombia,NA,Antioquia,6677930,74,0,1648,9
2020-06-10,Colombia,NA,Antioquia,6677930,56,0,1704,9
2020-06-11,Colombia,NA,Antioquia,6677930,56,1,1760,10
2020-06-12,Colombia,NA,Antioquia,6677930,60,0,1820,10
2020-06-13,Colombia,NA,Antioquia,6677930,78,0,1898,10
2020-06-14,Colombia,NA,Antioquia,6677930,124,1,2022,11
2020-06-15,Colombia,NA,Antioquia,6677930,113,2,2135,13
2020-06-16,Colombia,NA,Antioquia,6677930,126,0,2261,13
2020-06-17,Colombia,NA,Antioquia,6677930,89,1,2350,14
2020-06-18,Colombia,NA,Antioquia,6677930,126,0,2476,14
2020-06-19,Colombia,NA,Antioquia,6677930,163,0,2639,14
2020-06-20,Colombia,NA,Antioquia,6677930,94,2,2733,16
2020-06-21,Colombia,NA,Antioquia,6677930,165,2,2898,18
2020-06-22,Colombia,NA,Antioquia,6677930,89,2,2987,20
2020-06-23,Colombia,NA,Antioquia,6677930,89,1,3076,21
2020-06-24,Colombia,NA,Antioquia,6677930,148,6,3224,27
2020-06-25,Colombia,NA,Antioquia,6677930,162,1,3386,28
2020-06-26,Colombia,NA,Antioquia,6677930,265,1,3651,29
2020-06-27,Colombia,NA,Antioquia,6677930,142,1,3793,30
2020-06-28,Colombia,NA,Antioquia,6677930,248,2,4041,32
2020-06-29,Colombia,NA,Antioquia,6677930,145,2,4186,34
2020-06-30,Colombia,NA,Antioquia,6677930,212,6,4398,40
2020-07-01,Colombia,NA,Antioquia,6677930,270,5,4668,45
2020-07-02,Colombia,NA,Antioquia,6677930,339,6,5007,51
2020-07-03,Colombia,NA,Antioquia,6677930,319,6,5326,57
2020-07-04,Colombia,NA,Antioquia,6677930,471,4,5797,61
2020-07-05,Colombia,NA,Antioquia,6677930,356,6,6153,67
2020-07-06,Colombia,NA,Antioquia,6677930,438,9,6591,76
2020-07-07,Colombia,NA,Antioquia,6677930,452,3,7043,79
2020-07-08,Colombia,NA,Antioquia,6677930,517,8,7560,87
2020-07-09,Colombia,NA,Antioquia,6677930,804,18,8364,105
2020-07-10,Colombia,NA,Antioquia,6677930,678,16,9042,121
2020-07-11,Colombia,NA,Antioquia,6677930,669,20,9711,141
2020-07-12,Colombia,NA,Antioquia,6677930,461,14,10172,155
2020-07-13,Colombia,NA,Antioquia,6677930,1062,26,11234,181
2020-07-14,Colombia,NA,Antioquia,6677930,1379,18,12613,199
2020-07-15,Colombia,NA,Antioquia,6677930,993,15,13606,214
2020-07-16,Colombia,NA,Antioquia,6677930,1199,28,14805,242
2020-07-17,Colombia,NA,Antioquia,6677930,664,22,15469,264
2020-07-18,Colombia,NA,Antioquia,6677930,850,17,16319,281
2020-07-19,Colombia,NA,Antioquia,6677930,1306,28,17625,309
2020-07-20,Colombia,NA,Antioquia,6677930,533,23,18158,332
2020-07-21,Colombia,NA,Antioquia,6677930,1665,36,19823,368
2020-07-22,Colombia,NA,Antioquia,6677930,1910,29,21733,397
2020-07-23,Colombia,NA,Antioquia,6677930,1528,28,23261,425
2020-07-24,Colombia,NA,Antioquia,6677930,1827,36,25088,461
2020-07-25,Colombia,NA,Antioquia,6677930,1637,30,26725,491
2020-07-26,Colombia,NA,Antioquia,6677930,1945,38,28670,529
2020-07-27,Colombia,NA,Antioquia,6677930,1811,33,30481,562
2020-07-28,Colombia,NA,Antioquia,6677930,1855,45,32336,607
2020-07-29,Colombia,NA,Antioquia,6677930,1836,44,34172,651
2020-07-30,Colombia,NA,Antioquia,6677930,1847,47,36019,698
2020-07-31,Colombia,NA,Antioquia,6677930,2405,38,38424,736
2020-08-01,Colombia,NA,Antioquia,6677930,2293,45,40717,781
2020-08-02,Colombia,NA,Antioquia,6677930,1020,35,41737,816
2020-08-03,Colombia,NA,Antioquia,6677930,1760,47,43497,863
2020-08-04,Colombia,NA,Antioquia,6677930,1504,48,45001,911
2020-08-05,Colombia,NA,Antioquia,6677930,2033,31,47034,942
2020-08-06,Colombia,NA,Antioquia,6677930,2307,48,49341,990
2020-08-07,Colombia,NA,Antioquia,6677930,1714,41,51055,1031
2020-08-08,Colombia,NA,Antioquia,6677930,1999,50,53054,1081
2020-08-09,Colombia,NA,Antioquia,6677930,1223,42,54277,1123
2020-08-10,Colombia,NA,Antioquia,6677930,1518,34,55795,1157
2020-08-11,Colombia,NA,Antioquia,6677930,1944,41,57739,1198
2020-08-12,Colombia,NA,Antioquia,6677930,1995,42,59734,1240
2020-08-13,Colombia,NA,Antioquia,6677930,1485,35,61219,1275
2020-08-14,Colombia,NA,Antioquia,6677930,1743,32,62962,1307
2020-08-15,Colombia,NA,Antioquia,6677930,1288,46,64250,1353
2020-08-16,Colombia,NA,Antioquia,6677930,1106,35,65356,1388
2020-08-17,Colombia,NA,Antioquia,6677930,985,31,66341,1419
2020-08-18,Colombia,NA,Antioquia,6677930,964,42,67305,1461
2020-08-19,Colombia,NA,Antioquia,6677930,1395,37,68700,1498
2020-08-20,Colombia,NA,Antioquia,6677930,1520,34,70220,1532
2020-08-21,Colombia,NA,Antioquia,6677930,1427,45,71647,1577
2020-08-22,Colombia,NA,Antioquia,6677930,1338,34,72985,1611
2020-08-23,Colombia,NA,Antioquia,6677930,886,44,73871,1655
2020-08-24,Colombia,NA,Antioquia,6677930,1182,34,75053,1689
2020-08-25,Colombia,NA,Antioquia,6677930,1651,41,76704,1730
2020-08-26,Colombia,NA,Antioquia,6677930,1337,20,78041,1750
2020-08-27,Colombia,NA,Antioquia,6677930,1287,42,79328,1792
2020-08-28,Colombia,NA,Antioquia,6677930,1243,40,80571,1832
2020-08-29,Colombia,NA,Antioquia,6677930,873,35,81444,1867
2020-08-30,Colombia,NA,Antioquia,6677930,702,30,82146,1897
2020-08-31,Colombia,NA,Antioquia,6677930,1132,33,83278,1930
2020-09-01,Colombia,NA,Antioquia,6677930,1216,26,84494,1956
2020-09-02,Colombia,NA,Antioquia,6677930,1616,30,86110,1986
2020-09-03,Colombia,NA,Antioquia,6677930,989,24,87099,2010
2020-09-04,Colombia,NA,Antioquia,6677930,1053,25,88152,2035
2020-09-05,Colombia,NA,Antioquia,6677930,1092,28,89244,2063
2020-09-06,Colombia,NA,Antioquia,6677930,531,33,89775,2096
2020-09-07,Colombia,NA,Antioquia,6677930,645,27,90420,2123
2020-09-08,Colombia,NA,Antioquia,6677930,1326,23,91746,2146
2020-09-09,Colombia,NA,Antioquia,6677930,1645,34,93391,2180
2020-09-10,Colombia,NA,Antioquia,6677930,1198,17,94589,2197
2020-09-11,Colombia,NA,Antioquia,6677930,1225,26,95814,2223
2020-09-12,Colombia,NA,Antioquia,6677930,956,27,96770,2250
2020-09-13,Colombia,NA,Antioquia,6677930,750,27,97520,2277
2020-09-14,Colombia,NA,Antioquia,6677930,1007,14,98527,2291
2020-09-15,Colombia,NA,Antioquia,6677930,1522,21,100049,2312
2020-09-16,Colombia,NA,Antioquia,6677930,1279,23,101328,2335
2020-09-17,Colombia,NA,Antioquia,6677930,1370,23,102698,2358
2020-09-18,Colombia,NA,Antioquia,6677930,1001,25,103699,2383
2020-09-19,Colombia,NA,Antioquia,6677930,920,18,104619,2401
2020-09-20,Colombia,NA,Antioquia,6677930,619,17,105238,2418
2020-09-21,Colombia,NA,Antioquia,6677930,1109,19,106347,2437
2020-09-22,Colombia,NA,Antioquia,6677930,998,20,107345,2457
2020-09-23,Colombia,NA,Antioquia,6677930,606,21,107951,2478
2020-06-13,Colombia,NA,Arauca,294206,13,0,22,0
2020-06-14,Colombia,NA,Arauca,294206,25,0,47,0
2020-06-18,Colombia,NA,Arauca,294206,4,0,51,0
2020-06-19,Colombia,NA,Arauca,294206,3,0,54,0
2020-06-20,Colombia,NA,Arauca,294206,1,0,55,0
2020-06-21,Colombia,NA,Arauca,294206,5,0,60,0
2020-06-22,Colombia,NA,Arauca,294206,9,0,69,0
2020-06-23,Colombia,NA,Arauca,294206,2,0,71,0
2020-06-24,Colombia,NA,Arauca,294206,4,0,75,0
2020-06-26,Colombia,NA,Arauca,294206,1,0,76,0
2020-06-29,Colombia,NA,Arauca,294206,0,0,76,0
2020-07-01,Colombia,NA,Arauca,294206,4,0,80,0
2020-07-02,Colombia,NA,Arauca,294206,3,0,83,0
2020-07-04,Colombia,NA,Arauca,294206,14,0,97,0
2020-07-06,Colombia,NA,Arauca,294206,0,0,97,0
2020-07-07,Colombia,NA,Arauca,294206,33,0,130,0
2020-07-08,Colombia,NA,Arauca,294206,1,0,131,0
2020-07-09,Colombia,NA,Arauca,294206,8,0,139,0
2020-07-10,Colombia,NA,Arauca,294206,3,0,142,0
2020-07-11,Colombia,NA,Arauca,294206,1,0,143,0
2020-07-13,Colombia,NA,Arauca,294206,6,0,149,0
2020-07-14,Colombia,NA,Arauca,294206,12,0,161,0
2020-07-15,Colombia,NA,Arauca,294206,1,0,162,0
2020-07-16,Colombia,NA,Arauca,294206,0,0,162,0
2020-07-17,Colombia,NA,Arauca,294206,7,0,169,0
2020-07-18,Colombia,NA,Arauca,294206,2,0,171,0
2020-07-19,Colombia,NA,Arauca,294206,9,0,180,0
2020-07-20,Colombia,NA,Arauca,294206,5,1,185,1
2020-07-21,Colombia,NA,Arauca,294206,1,1,186,2
2020-07-22,Colombia,NA,Arauca,294206,2,0,188,2
2020-07-23,Colombia,NA,Arauca,294206,0,1,188,3
2020-07-24,Colombia,NA,Arauca,294206,4,1,192,4
2020-07-25,Colombia,NA,Arauca,294206,2,0,194,4
2020-07-26,Colombia,NA,Arauca,294206,0,0,194,4
2020-07-27,Colombia,NA,Arauca,294206,3,1,197,5
2020-07-28,Colombia,NA,Arauca,294206,20,0,217,5
2020-07-29,Colombia,NA,Arauca,294206,3,0,220,5
2020-07-30,Colombia,NA,Arauca,294206,11,0,231,5
2020-07-31,Colombia,NA,Arauca,294206,6,1,237,6
2020-08-01,Colombia,NA,Arauca,294206,65,0,302,6
2020-08-02,Colombia,NA,Arauca,294206,1,1,303,7
2020-08-03,Colombia,NA,Arauca,294206,0,1,303,8
2020-08-04,Colombia,NA,Arauca,294206,5,0,308,8
2020-08-05,Colombia,NA,Arauca,294206,59,0,367,8
2020-08-06,Colombia,NA,Arauca,294206,19,0,386,8
2020-08-07,Colombia,NA,Arauca,294206,9,1,395,9
2020-08-08,Colombia,NA,Arauca,294206,111,0,506,9
2020-08-09,Colombia,NA,Arauca,294206,4,0,510,9
2020-08-10,Colombia,NA,Arauca,294206,7,0,517,9
2020-08-11,Colombia,NA,Arauca,294206,0,0,517,9
2020-08-12,Colombia,NA,Arauca,294206,42,0,559,9
2020-08-13,Colombia,NA,Arauca,294206,6,2,565,11
2020-08-14,Colombia,NA,Arauca,294206,36,0,601,11
2020-08-15,Colombia,NA,Arauca,294206,15,1,616,12
2020-08-16,Colombia,NA,Arauca,294206,1,2,617,14
2020-08-17,Colombia,NA,Arauca,294206,72,1,689,15
2020-08-18,Colombia,NA,Arauca,294206,19,1,708,16
2020-08-19,Colombia,NA,Arauca,294206,49,0,757,16
2020-08-20,Colombia,NA,Arauca,294206,9,0,766,16
2020-08-21,Colombia,NA,Arauca,294206,1,0,767,16
2020-08-22,Colombia,NA,Arauca,294206,15,1,782,17
2020-08-23,Colombia,NA,Arauca,294206,8,1,790,18
2020-08-24,Colombia,NA,Arauca,294206,15,1,805,19
2020-08-25,Colombia,NA,Arauca,294206,6,1,811,20
2020-08-26,Colombia,NA,Arauca,294206,20,1,831,21
2020-08-27,Colombia,NA,Arauca,294206,103,0,934,21
2020-08-28,Colombia,NA,Arauca,294206,20,1,954,22
2020-08-29,Colombia,NA,Arauca,294206,1,0,955,22
2020-08-30,Colombia,NA,Arauca,294206,0,0,955,22
2020-08-31,Colombia,NA,Arauca,294206,51,0,1006,22
2020-09-01,Colombia,NA,Arauca,294206,6,2,1012,24
2020-09-02,Colombia,NA,Arauca,294206,68,1,1080,25
2020-09-03,Colombia,NA,Arauca,294206,7,1,1087,26
2020-09-04,Colombia,NA,Arauca,294206,25,0,1112,26
2020-09-05,Colombia,NA,Arauca,294206,3,0,1115,26
2020-09-06,Colombia,NA,Arauca,294206,1,2,1116,28
2020-09-07,Colombia,NA,Arauca,294206,30,2,1146,30
2020-09-08,Colombia,NA,Arauca,294206,28,2,1174,32
2020-09-09,Colombia,NA,Arauca,294206,51,1,1225,33
2020-09-10,Colombia,NA,Arauca,294206,48,1,1273,34
2020-09-11,Colombia,NA,Arauca,294206,31,0,1304,34
2020-09-12,Colombia,NA,Arauca,294206,46,0,1350,34
2020-09-13,Colombia,NA,Arauca,294206,18,0,1368,34
2020-09-14,Colombia,NA,Arauca,294206,12,0,1380,34
2020-09-15,Colombia,NA,Arauca,294206,38,2,1418,36
2020-09-16,Colombia,NA,Arauca,294206,38,3,1456,39
2020-09-17,Colombia,NA,Arauca,294206,29,0,1485,39
2020-09-18,Colombia,NA,Arauca,294206,22,1,1507,40
2020-09-19,Colombia,NA,Arauca,294206,32,1,1539,41
2020-09-20,Colombia,NA,Arauca,294206,5,1,1544,42
2020-09-21,Colombia,NA,Arauca,294206,17,1,1561,43
2020-09-22,Colombia,NA,Arauca,294206,42,0,1603,43
2020-09-23,Colombia,NA,Arauca,294206,10,0,1613,43
2020-03-25,Colombia,NA,Atlantico,2722128,4,0,13,0
2020-03-27,Colombia,NA,Atlantico,2722128,3,1,16,1
2020-03-28,Colombia,NA,Atlantico,2722128,4,0,20,1
2020-03-29,Colombia,NA,Atlantico,2722128,4,0,24,1
2020-03-30,Colombia,NA,Atlantico,2722128,1,0,25,1
2020-03-31,Colombia,NA,Atlantico,2722128,8,0,33,1
2020-04-01,Colombia,NA,Atlantico,2722128,3,0,36,1
2020-04-02,Colombia,NA,Atlantico,2722128,1,1,37,2
2020-04-03,Colombia,NA,Atlantico,2722128,11,2,48,4
2020-04-04,Colombia,NA,Atlantico,2722128,0,0,48,4
2020-04-05,Colombia,NA,Atlantico,2722128,4,0,52,4
2020-04-06,Colombia,NA,Atlantico,2722128,2,0,54,4
2020-04-07,Colombia,NA,Atlantico,2722128,8,0,62,4
2020-04-08,Colombia,NA,Atlantico,2722128,6,1,68,5
2020-04-09,Colombia,NA,Atlantico,2722128,7,1,75,6
2020-04-10,Colombia,NA,Atlantico,2722128,6,0,81,6
2020-04-11,Colombia,NA,Atlantico,2722128,5,0,86,6
2020-04-12,Colombia,NA,Atlantico,2722128,5,0,91,6
2020-04-13,Colombia,NA,Atlantico,2722128,3,0,94,6
2020-04-14,Colombia,NA,Atlantico,2722128,1,0,95,6
2020-04-15,Colombia,NA,Atlantico,2722128,1,0,96,6
2020-04-16,Colombia,NA,Atlantico,2722128,2,0,98,6
2020-04-17,Colombia,NA,Atlantico,2722128,3,0,101,6
2020-04-18,Colombia,NA,Atlantico,2722128,6,0,107,6
2020-04-19,Colombia,NA,Atlantico,2722128,4,0,111,6
2020-04-20,Colombia,NA,Atlantico,2722128,3,1,114,7
2020-04-21,Colombia,NA,Atlantico,2722128,6,0,120,7
2020-04-22,Colombia,NA,Atlantico,2722128,3,1,123,8
2020-04-23,Colombia,NA,Atlantico,2722128,7,0,130,8
2020-04-24,Colombia,NA,Atlantico,2722128,10,1,140,9
2020-04-25,Colombia,NA,Atlantico,2722128,22,3,162,12
2020-04-26,Colombia,NA,Atlantico,2722128,21,1,183,13
2020-04-27,Colombia,NA,Atlantico,2722128,41,1,224,14
2020-04-28,Colombia,NA,Atlantico,2722128,18,0,242,14
2020-04-29,Colombia,NA,Atlantico,2722128,17,2,259,16
2020-04-30,Colombia,NA,Atlantico,2722128,55,4,314,20
2020-05-01,Colombia,NA,Atlantico,2722128,54,3,368,23
2020-05-02,Colombia,NA,Atlantico,2722128,53,7,421,30
2020-05-03,Colombia,NA,Atlantico,2722128,77,3,498,33
2020-05-04,Colombia,NA,Atlantico,2722128,39,1,537,34
2020-05-05,Colombia,NA,Atlantico,2722128,109,5,646,39
2020-05-06,Colombia,NA,Atlantico,2722128,39,4,685,43
2020-05-07,Colombia,NA,Atlantico,2722128,83,2,768,45
2020-05-08,Colombia,NA,Atlantico,2722128,108,4,876,49
2020-05-09,Colombia,NA,Atlantico,2722128,41,2,917,51
2020-05-10,Colombia,NA,Atlantico,2722128,66,3,983,54
2020-05-11,Colombia,NA,Atlantico,2722128,55,2,1038,56
2020-05-12,Colombia,NA,Atlantico,2722128,108,2,1146,58
2020-05-13,Colombia,NA,Atlantico,2722128,140,1,1286,59
2020-05-14,Colombia,NA,Atlantico,2722128,116,2,1402,61
2020-05-15,Colombia,NA,Atlantico,2722128,107,5,1509,66
2020-05-16,Colombia,NA,Atlantico,2722128,66,2,1575,68
2020-05-17,Colombia,NA,Atlantico,2722128,188,3,1763,71
2020-05-18,Colombia,NA,Atlantico,2722128,82,3,1845,74
2020-05-19,Colombia,NA,Atlantico,2722128,101,9,1946,83
2020-05-20,Colombia,NA,Atlantico,2722128,123,4,2069,87
2020-05-21,Colombia,NA,Atlantico,2722128,147,4,2216,91
2020-05-22,Colombia,NA,Atlantico,2722128,200,10,2416,101
2020-05-23,Colombia,NA,Atlantico,2722128,231,10,2647,111
2020-05-24,Colombia,NA,Atlantico,2722128,173,8,2820,119
2020-05-25,Colombia,NA,Atlantico,2722128,86,8,2906,127
2020-05-26,Colombia,NA,Atlantico,2722128,169,18,3075,145
2020-05-27,Colombia,NA,Atlantico,2722128,96,7,3171,152
2020-05-28,Colombia,NA,Atlantico,2722128,157,13,3328,165
2020-05-29,Colombia,NA,Atlantico,2722128,153,12,3481,177
2020-05-30,Colombia,NA,Atlantico,2722128,315,20,3796,197
2020-05-31,Colombia,NA,Atlantico,2722128,202,14,3998,211
2020-06-01,Colombia,NA,Atlantico,2722128,224,23,4222,234
2020-06-02,Colombia,NA,Atlantico,2722128,392,29,4614,263
2020-06-03,Colombia,NA,Atlantico,2722128,215,41,4829,304
2020-06-04,Colombia,NA,Atlantico,2722128,605,31,5434,335
2020-06-05,Colombia,NA,Atlantico,2722128,393,27,5827,362
2020-06-06,Colombia,NA,Atlantico,2722128,332,26,6159,388
2020-06-07,Colombia,NA,Atlantico,2722128,375,33,6534,421
2020-06-08,Colombia,NA,Atlantico,2722128,264,30,6798,451
2020-06-09,Colombia,NA,Atlantico,2722128,338,47,7136,498
2020-06-10,Colombia,NA,Atlantico,2722128,404,37,7540,535
2020-06-11,Colombia,NA,Atlantico,2722128,599,46,8139,581
2020-06-12,Colombia,NA,Atlantico,2722128,492,44,8631,625
2020-06-13,Colombia,NA,Atlantico,2722128,628,45,9259,670
2020-06-14,Colombia,NA,Atlantico,2722128,1034,55,10293,725
2020-06-15,Colombia,NA,Atlantico,2722128,647,53,10940,778
2020-06-16,Colombia,NA,Atlantico,2722128,590,68,11530,846
2020-06-17,Colombia,NA,Atlantico,2722128,713,50,12243,896
2020-06-18,Colombia,NA,Atlantico,2722128,833,71,13076,967
2020-06-19,Colombia,NA,Atlantico,2722128,733,55,13809,1022
2020-06-20,Colombia,NA,Atlantico,2722128,846,61,14655,1083
2020-06-21,Colombia,NA,Atlantico,2722128,730,61,15385,1144
2020-06-22,Colombia,NA,Atlantico,2722128,886,67,16271,1211
2020-06-23,Colombia,NA,Atlantico,2722128,852,61,17123,1272
2020-06-24,Colombia,NA,Atlantico,2722128,1181,65,18304,1337
2020-06-25,Colombia,NA,Atlantico,2722128,737,65,19041,1402
2020-06-26,Colombia,NA,Atlantico,2722128,1567,62,20608,1464
2020-06-27,Colombia,NA,Atlantico,2722128,916,59,21524,1523
2020-06-28,Colombia,NA,Atlantico,2722128,842,45,22366,1568
2020-06-29,Colombia,NA,Atlantico,2722128,764,60,23130,1628
2020-06-30,Colombia,NA,Atlantico,2722128,517,47,23647,1675
2020-07-01,Colombia,NA,Atlantico,2722128,1033,54,24680,1729
2020-07-02,Colombia,NA,Atlantico,2722128,1000,59,25680,1788
2020-07-03,Colombia,NA,Atlantico,2722128,859,61,26539,1849
2020-07-04,Colombia,NA,Atlantico,2722128,944,49,27483,1898
2020-07-05,Colombia,NA,Atlantico,2722128,808,46,28291,1944
2020-07-06,Colombia,NA,Atlantico,2722128,809,52,29100,1996
2020-07-07,Colombia,NA,Atlantico,2722128,1252,61,30352,2057
2020-07-08,Colombia,NA,Atlantico,2722128,951,52,31303,2109
2020-07-09,Colombia,NA,Atlantico,2722128,1360,43,32663,2152
2020-07-10,Colombia,NA,Atlantico,2722128,1588,42,34251,2194
2020-07-11,Colombia,NA,Atlantico,2722128,1532,32,35783,2226
2020-07-12,Colombia,NA,Atlantico,2722128,1126,33,36909,2259
2020-07-13,Colombia,NA,Atlantico,2722128,1763,42,38672,2301
2020-07-14,Colombia,NA,Atlantico,2722128,1409,34,40081,2335
2020-07-15,Colombia,NA,Atlantico,2722128,1308,31,41389,2366
2020-07-16,Colombia,NA,Atlantico,2722128,869,42,42258,2408
2020-07-17,Colombia,NA,Atlantico,2722128,600,37,42858,2445
2020-07-18,Colombia,NA,Atlantico,2722128,594,53,43452,2498
2020-07-19,Colombia,NA,Atlantico,2722128,791,39,44243,2537
2020-07-20,Colombia,NA,Atlantico,2722128,332,17,44575,2554
2020-07-21,Colombia,NA,Atlantico,2722128,892,26,45467,2580
2020-07-22,Colombia,NA,Atlantico,2722128,844,26,46311,2606
2020-07-23,Colombia,NA,Atlantico,2722128,779,32,47090,2638
2020-07-24,Colombia,NA,Atlantico,2722128,800,18,47890,2656
2020-07-25,Colombia,NA,Atlantico,2722128,647,28,48537,2684
2020-07-26,Colombia,NA,Atlantico,2722128,737,17,49274,2701
2020-07-27,Colombia,NA,Atlantico,2722128,859,19,50133,2720
2020-07-28,Colombia,NA,Atlantico,2722128,694,28,50827,2748
2020-07-29,Colombia,NA,Atlantico,2722128,1117,22,51944,2770
2020-07-30,Colombia,NA,Atlantico,2722128,588,21,52532,2791
2020-07-31,Colombia,NA,Atlantico,2722128,424,14,52956,2805
2020-08-01,Colombia,NA,Atlantico,2722128,418,21,53374,2826
2020-08-02,Colombia,NA,Atlantico,2722128,366,24,53740,2850
2020-08-03,Colombia,NA,Atlantico,2722128,487,12,54227,2862
2020-08-04,Colombia,NA,Atlantico,2722128,472,17,54699,2879
2020-08-05,Colombia,NA,Atlantico,2722128,602,15,55301,2894
2020-08-06,Colombia,NA,Atlantico,2722128,589,10,55890,2904
2020-08-07,Colombia,NA,Atlantico,2722128,644,14,56534,2918
2020-08-08,Colombia,NA,Atlantico,2722128,461,12,56995,2930
2020-08-09,Colombia,NA,Atlantico,2722128,176,12,57171,2942
2020-08-10,Colombia,NA,Atlantico,2722128,602,9,57773,2951
2020-08-11,Colombia,NA,Atlantico,2722128,271,9,58044,2960
2020-08-12,Colombia,NA,Atlantico,2722128,389,12,58433,2972
2020-08-13,Colombia,NA,Atlantico,2722128,413,12,58846,2984
2020-08-14,Colombia,NA,Atlantico,2722128,362,10,59208,2994
2020-08-15,Colombia,NA,Atlantico,2722128,224,8,59432,3002
2020-08-16,Colombia,NA,Atlantico,2722128,218,11,59650,3013
2020-08-17,Colombia,NA,Atlantico,2722128,524,9,60174,3022
2020-08-18,Colombia,NA,Atlantico,2722128,175,6,60349,3028
2020-08-19,Colombia,NA,Atlantico,2722128,331,12,60680,3040
2020-08-20,Colombia,NA,Atlantico,2722128,233,14,60913,3054
2020-08-21,Colombia,NA,Atlantico,2722128,172,11,61085,3065
2020-08-22,Colombia,NA,Atlantico,2722128,194,7,61279,3072
2020-08-23,Colombia,NA,Atlantico,2722128,131,8,61410,3080
2020-08-24,Colombia,NA,Atlantico,2722128,116,12,61526,3092
2020-08-25,Colombia,NA,Atlantico,2722128,260,6,61786,3098
2020-08-26,Colombia,NA,Atlantico,2722128,109,5,61895,3103
2020-08-27,Colombia,NA,Atlantico,2722128,185,11,62080,3114
2020-08-28,Colombia,NA,Atlantico,2722128,100,9,62180,3123
2020-08-29,Colombia,NA,Atlantico,2722128,117,6,62297,3129
2020-08-30,Colombia,NA,Atlantico,2722128,104,6,62401,3135
2020-08-31,Colombia,NA,Atlantico,2722128,115,6,62516,3141
2020-09-01,Colombia,NA,Atlantico,2722128,89,13,62605,3154
2020-09-02,Colombia,NA,Atlantico,2722128,381,6,62986,3160
2020-09-03,Colombia,NA,Atlantico,2722128,115,2,63101,3162
2020-09-04,Colombia,NA,Atlantico,2722128,116,6,63217,3168
2020-09-05,Colombia,NA,Atlantico,2722128,84,7,63301,3175
2020-09-06,Colombia,NA,Atlantico,2722128,40,1,63341,3176
2020-09-07,Colombia,NA,Atlantico,2722128,178,5,63519,3181
2020-09-08,Colombia,NA,Atlantico,2722128,89,1,63608,3182
2020-09-09,Colombia,NA,Atlantico,2722128,123,4,63731,3186
2020-09-10,Colombia,NA,Atlantico,2722128,102,5,63833,3191
2020-09-11,Colombia,NA,Atlantico,2722128,128,5,63961,3196
2020-09-12,Colombia,NA,Atlantico,2722128,67,4,64028,3200
2020-09-13,Colombia,NA,Atlantico,2722128,37,4,64065,3204
2020-09-14,Colombia,NA,Atlantico,2722128,208,3,64273,3207
2020-09-15,Colombia,NA,Atlantico,2722128,117,5,64390,3212
2020-09-16,Colombia,NA,Atlantico,2722128,111,6,64501,3218
2020-09-17,Colombia,NA,Atlantico,2722128,119,1,64620,3219
2020-09-18,Colombia,NA,Atlantico,2722128,119,3,64739,3222
2020-09-19,Colombia,NA,Atlantico,2722128,58,3,64797,3225
2020-09-20,Colombia,NA,Atlantico,2722128,68,9,64865,3234
2020-09-21,Colombia,NA,Atlantico,2722128,120,5,64985,3239
2020-09-22,Colombia,NA,Atlantico,2722128,85,4,65070,3243
2020-09-23,Colombia,NA,Atlantico,2722128,56,0,65126,3243
2020-03-14,Colombia,NA,Bogota D.C.,7743955,10,0,16,0
2020-03-15,Colombia,NA,Bogota D.C.,7743955,10,0,26,0
2020-03-16,Colombia,NA,Bogota D.C.,7743955,6,0,32,0
2020-03-17,Colombia,NA,Bogota D.C.,7743955,7,0,39,0
2020-03-18,Colombia,NA,Bogota D.C.,7743955,5,0,44,0
2020-03-19,Colombia,NA,Bogota D.C.,7743955,8,0,52,0
2020-03-20,Colombia,NA,Bogota D.C.,7743955,27,0,79,0
2020-03-21,Colombia,NA,Bogota D.C.,7743955,5,0,84,0
2020-03-22,Colombia,NA,Bogota D.C.,7743955,4,0,88,0
2020-03-23,Colombia,NA,Bogota D.C.,7743955,29,0,117,0
2020-03-24,Colombia,NA,Bogota D.C.,7743955,41,0,158,0
2020-03-25,Colombia,NA,Bogota D.C.,7743955,14,1,172,1
2020-03-26,Colombia,NA,Bogota D.C.,7743955,7,2,179,3
2020-03-27,Colombia,NA,Bogota D.C.,7743955,38,0,217,3
2020-03-28,Colombia,NA,Bogota D.C.,7743955,38,3,255,6
2020-03-29,Colombia,NA,Bogota D.C.,7743955,33,1,288,7
2020-03-30,Colombia,NA,Bogota D.C.,7743955,55,1,343,8
2020-03-31,Colombia,NA,Bogota D.C.,7743955,40,2,383,10
2020-04-01,Colombia,NA,Bogota D.C.,7743955,81,1,464,11
2020-04-02,Colombia,NA,Bogota D.C.,7743955,68,4,532,15
2020-04-03,Colombia,NA,Bogota D.C.,7743955,44,5,576,20
2020-04-04,Colombia,NA,Bogota D.C.,7743955,104,10,680,30
2020-04-05,Colombia,NA,Bogota D.C.,7743955,30,4,710,34
2020-04-06,Colombia,NA,Bogota D.C.,7743955,53,6,763,40
2020-04-07,Colombia,NA,Bogota D.C.,7743955,84,5,847,45
2020-04-08,Colombia,NA,Bogota D.C.,7743955,130,2,977,47
2020-04-09,Colombia,NA,Bogota D.C.,7743955,36,4,1013,51
2020-04-10,Colombia,NA,Bogota D.C.,7743955,88,3,1101,54
2020-04-11,Colombia,NA,Bogota D.C.,7743955,44,5,1145,59
2020-04-12,Colombia,NA,Bogota D.C.,7743955,19,1,1164,60
2020-04-13,Colombia,NA,Bogota D.C.,7743955,24,4,1188,64
2020-04-14,Colombia,NA,Bogota D.C.,7743955,36,6,1224,70
2020-04-15,Colombia,NA,Bogota D.C.,7743955,48,3,1272,73
2020-04-16,Colombia,NA,Bogota D.C.,7743955,43,4,1315,77
2020-04-17,Colombia,NA,Bogota D.C.,7743955,59,1,1374,78
2020-04-18,Colombia,NA,Bogota D.C.,7743955,86,2,1460,80
2020-04-19,Colombia,NA,Bogota D.C.,7743955,119,4,1579,84
2020-04-20,Colombia,NA,Bogota D.C.,7743955,79,4,1658,88
2020-04-21,Colombia,NA,Bogota D.C.,7743955,74,6,1732,94
2020-04-22,Colombia,NA,Bogota D.C.,7743955,84,1,1816,95
2020-04-23,Colombia,NA,Bogota D.C.,7743955,47,2,1863,97
2020-04-24,Colombia,NA,Bogota D.C.,7743955,179,4,2042,101
2020-04-25,Colombia,NA,Bogota D.C.,7743955,89,1,2131,102
2020-04-26,Colombia,NA,Bogota D.C.,7743955,92,6,2223,108
2020-04-27,Colombia,NA,Bogota D.C.,7743955,105,3,2328,111
2020-04-28,Colombia,NA,Bogota D.C.,7743955,64,6,2392,117
2020-04-29,Colombia,NA,Bogota D.C.,7743955,133,6,2525,123
2020-04-30,Colombia,NA,Bogota D.C.,7743955,89,8,2614,131
2020-05-01,Colombia,NA,Bogota D.C.,7743955,147,3,2761,134
2020-05-02,Colombia,NA,Bogota D.C.,7743955,71,3,2832,137
2020-05-03,Colombia,NA,Bogota D.C.,7743955,111,3,2943,140
2020-05-04,Colombia,NA,Bogota D.C.,7743955,127,5,3070,145
2020-05-05,Colombia,NA,Bogota D.C.,7743955,193,2,3263,147
2020-05-06,Colombia,NA,Bogota D.C.,7743955,200,7,3463,154
2020-05-07,Colombia,NA,Bogota D.C.,7743955,130,3,3593,157
2020-05-08,Colombia,NA,Bogota D.C.,7743955,226,4,3819,161
2020-05-09,Colombia,NA,Bogota D.C.,7743955,209,6,4028,167
2020-05-10,Colombia,NA,Bogota D.C.,7743955,128,7,4156,174
2020-05-11,Colombia,NA,Bogota D.C.,7743955,150,7,4306,181
2020-05-12,Colombia,NA,Bogota D.C.,7743955,258,0,4564,181
2020-05-13,Colombia,NA,Bogota D.C.,7743955,122,3,4686,184
2020-05-14,Colombia,NA,Bogota D.C.,7743955,207,2,4893,186
2020-05-15,Colombia,NA,Bogota D.C.,7743955,115,7,5008,193
2020-05-16,Colombia,NA,Bogota D.C.,7743955,277,4,5285,197
2020-05-17,Colombia,NA,Bogota D.C.,7743955,241,3,5526,200
2020-05-18,Colombia,NA,Bogota D.C.,7743955,197,6,5723,206
2020-05-19,Colombia,NA,Bogota D.C.,7743955,216,5,5939,211
2020-05-20,Colombia,NA,Bogota D.C.,7743955,253,6,6192,217
2020-05-21,Colombia,NA,Bogota D.C.,7743955,122,10,6314,227
2020-05-22,Colombia,NA,Bogota D.C.,7743955,280,9,6594,236
2020-05-23,Colombia,NA,Bogota D.C.,7743955,383,9,6977,245
2020-05-24,Colombia,NA,Bogota D.C.,7743955,238,5,7215,250
2020-05-25,Colombia,NA,Bogota D.C.,7743955,177,4,7392,254
2020-05-26,Colombia,NA,Bogota D.C.,7743955,356,8,7748,262
2020-05-27,Colombia,NA,Bogota D.C.,7743955,305,6,8053,268
2020-05-28,Colombia,NA,Bogota D.C.,7743955,490,4,8543,272
2020-05-29,Colombia,NA,Bogota D.C.,7743955,627,11,9170,283
2020-05-30,Colombia,NA,Bogota D.C.,7743955,478,7,9648,290
2020-05-31,Colombia,NA,Bogota D.C.,7743955,347,11,9995,301
2020-06-01,Colombia,NA,Bogota D.C.,7743955,384,8,10379,309
2020-06-02,Colombia,NA,Bogota D.C.,7743955,374,6,10753,315
2020-06-03,Colombia,NA,Bogota D.C.,7743955,505,9,11258,324
2020-06-04,Colombia,NA,Bogota D.C.,7743955,537,11,11795,335
2020-06-05,Colombia,NA,Bogota D.C.,7743955,404,14,12199,349
2020-06-06,Colombia,NA,Bogota D.C.,7743955,379,9,12578,358
2020-06-07,Colombia,NA,Bogota D.C.,7743955,319,10,12897,368
2020-06-08,Colombia,NA,Bogota D.C.,7743955,443,13,13340,381
2020-06-09,Colombia,NA,Bogota D.C.,7743955,391,14,13731,395
2020-06-10,Colombia,NA,Bogota D.C.,7743955,425,11,14156,406
2020-06-11,Colombia,NA,Bogota D.C.,7743955,410,14,14566,420
2020-06-12,Colombia,NA,Bogota D.C.,7743955,416,8,14982,428
2020-06-13,Colombia,NA,Bogota D.C.,7743955,565,11,15547,439
2020-06-14,Colombia,NA,Bogota D.C.,7743955,627,19,16174,458
2020-06-15,Colombia,NA,Bogota D.C.,7743955,415,18,16589,476
2020-06-16,Colombia,NA,Bogota D.C.,7743955,808,14,17397,490
2020-06-17,Colombia,NA,Bogota D.C.,7743955,80,24,17477,514
2020-06-18,Colombia,NA,Bogota D.C.,7743955,806,9,18283,523
2020-06-19,Colombia,NA,Bogota D.C.,7743955,1081,17,19364,540
2020-06-20,Colombia,NA,Bogota D.C.,7743955,693,12,20057,552
2020-06-21,Colombia,NA,Bogota D.C.,7743955,876,22,20933,574
2020-06-22,Colombia,NA,Bogota D.C.,7743955,1183,20,22116,594
2020-06-23,Colombia,NA,Bogota D.C.,7743955,1333,25,23449,619
2020-06-24,Colombia,NA,Bogota D.C.,7743955,110,24,23559,643
2020-06-25,Colombia,NA,Bogota D.C.,7743955,1276,21,24835,664
2020-06-26,Colombia,NA,Bogota D.C.,7743955,1012,25,25847,689
2020-06-27,Colombia,NA,Bogota D.C.,7743955,2157,31,28004,720
2020-06-28,Colombia,NA,Bogota D.C.,7743955,1466,34,29470,754
2020-06-29,Colombia,NA,Bogota D.C.,7743955,23,25,29493,779
2020-06-30,Colombia,NA,Bogota D.C.,7743955,708,32,30201,811
2020-07-01,Colombia,NA,Bogota D.C.,7743955,1413,29,31614,840
2020-07-02,Colombia,NA,Bogota D.C.,7743955,1336,38,32950,878
2020-07-03,Colombia,NA,Bogota D.C.,7743955,1446,46,34396,924
2020-07-04,Colombia,NA,Bogota D.C.,7743955,1174,34,35570,958
2020-07-05,Colombia,NA,Bogota D.C.,7743955,1286,39,36856,997
2020-07-06,Colombia,NA,Bogota D.C.,7743955,1098,43,37954,1040
2020-07-07,Colombia,NA,Bogota D.C.,7743955,1626,50,39580,1090
2020-07-08,Colombia,NA,Bogota D.C.,7743955,1496,46,41076,1136
2020-07-09,Colombia,NA,Bogota D.C.,7743955,1643,69,42719,1205
2020-07-10,Colombia,NA,Bogota D.C.,7743955,2688,64,45407,1269
2020-07-11,Colombia,NA,Bogota D.C.,7743955,2508,74,47915,1343
2020-07-12,Colombia,NA,Bogota D.C.,7743955,2176,60,50091,1403
2020-07-13,Colombia,NA,Bogota D.C.,7743955,1719,75,51810,1478
2020-07-14,Colombia,NA,Bogota D.C.,7743955,1892,73,53702,1551
2020-07-15,Colombia,NA,Bogota D.C.,7743955,2457,88,56159,1639
2020-07-16,Colombia,NA,Bogota D.C.,7743955,3125,78,59284,1717
2020-07-17,Colombia,NA,Bogota D.C.,7743955,142,100,59426,1817
2020-07-18,Colombia,NA,Bogota D.C.,7743955,1862,83,61288,1900
2020-07-19,Colombia,NA,Bogota D.C.,7743955,3782,66,65070,1966
2020-07-20,Colombia,NA,Bogota D.C.,7743955,4086,95,69156,2061
2020-07-21,Colombia,NA,Bogota D.C.,7743955,3568,114,72724,2175
2020-07-22,Colombia,NA,Bogota D.C.,7743955,3946,96,76670,2271
2020-07-23,Colombia,NA,Bogota D.C.,7743955,2326,112,78996,2383
2020-07-24,Colombia,NA,Bogota D.C.,7743955,3259,108,82255,2491
2020-07-25,Colombia,NA,Bogota D.C.,7743955,2466,104,84721,2595
2020-07-26,Colombia,NA,Bogota D.C.,7743955,87,111,84808,2706
2020-07-27,Colombia,NA,Bogota D.C.,7743955,3205,103,88013,2809
2020-07-28,Colombia,NA,Bogota D.C.,7743955,8552,97,96565,2906
2020-07-29,Colombia,NA,Bogota D.C.,7743955,3229,112,99794,3018
2020-07-30,Colombia,NA,Bogota D.C.,7743955,3171,127,102965,3145
2020-07-31,Colombia,NA,Bogota D.C.,7743955,544,128,103509,3273
2020-08-01,Colombia,NA,Bogota D.C.,7743955,3934,88,107443,3361
2020-08-02,Colombia,NA,Bogota D.C.,7743955,6895,109,114338,3470
2020-08-03,Colombia,NA,Bogota D.C.,7743955,3041,120,117379,3590
2020-08-04,Colombia,NA,Bogota D.C.,7743955,4934,106,122313,3696
2020-08-05,Colombia,NA,Bogota D.C.,7743955,3609,114,125922,3810
2020-08-06,Colombia,NA,Bogota D.C.,7743955,2740,101,128662,3911
2020-08-07,Colombia,NA,Bogota D.C.,7743955,3383,113,132045,4024
2020-08-08,Colombia,NA,Bogota D.C.,7743955,3422,119,135467,4143
2020-08-09,Colombia,NA,Bogota D.C.,7743955,2173,101,137640,4244
2020-08-10,Colombia,NA,Bogota D.C.,7743955,658,87,138298,4331
2020-08-11,Colombia,NA,Bogota D.C.,7743955,8470,103,146768,4434
2020-08-12,Colombia,NA,Bogota D.C.,7743955,1172,85,147940,4519
2020-08-13,Colombia,NA,Bogota D.C.,7743955,7065,87,155005,4606
2020-08-14,Colombia,NA,Bogota D.C.,7743955,100,76,155105,4682
2020-08-15,Colombia,NA,Bogota D.C.,7743955,5054,75,160159,4757
2020-08-16,Colombia,NA,Bogota D.C.,7743955,8423,83,168582,4840
2020-08-17,Colombia,NA,Bogota D.C.,7743955,3557,76,172139,4916
2020-08-18,Colombia,NA,Bogota D.C.,7743955,758,101,172897,5017
2020-08-19,Colombia,NA,Bogota D.C.,7743955,7900,90,180797,5107
2020-08-20,Colombia,NA,Bogota D.C.,7743955,3641,80,184438,5187
2020-08-21,Colombia,NA,Bogota D.C.,7743955,3681,81,188119,5268
2020-08-22,Colombia,NA,Bogota D.C.,7743955,2904,81,191023,5349
2020-08-23,Colombia,NA,Bogota D.C.,7743955,3479,62,194502,5411
2020-08-24,Colombia,NA,Bogota D.C.,7743955,3170,72,197672,5483
2020-08-25,Colombia,NA,Bogota D.C.,7743955,3279,92,200951,5575
2020-08-26,Colombia,NA,Bogota D.C.,7743955,2512,72,203463,5647
2020-08-27,Colombia,NA,Bogota D.C.,7743955,2288,86,205751,5733
2020-08-28,Colombia,NA,Bogota D.C.,7743955,2991,56,208742,5789
2020-08-29,Colombia,NA,Bogota D.C.,7743955,2083,79,210825,5868
2020-08-30,Colombia,NA,Bogota D.C.,7743955,2044,56,212869,5924
2020-08-31,Colombia,NA,Bogota D.C.,7743955,3607,63,216476,5987
2020-09-01,Colombia,NA,Bogota D.C.,7743955,2921,52,219397,6039
2020-09-02,Colombia,NA,Bogota D.C.,7743955,2005,59,221402,6098
2020-09-03,Colombia,NA,Bogota D.C.,7743955,2564,54,223966,6152
2020-09-04,Colombia,NA,Bogota D.C.,7743955,2137,77,226103,6229
2020-09-05,Colombia,NA,Bogota D.C.,7743955,2039,49,228142,6278
2020-09-06,Colombia,NA,Bogota D.C.,7743955,1172,48,229314,6326
2020-09-07,Colombia,NA,Bogota D.C.,7743955,2662,74,231976,6400
2020-09-08,Colombia,NA,Bogota D.C.,7743955,1843,61,233819,6461
2020-09-09,Colombia,NA,Bogota D.C.,7743955,1766,38,235585,6499
2020-09-10,Colombia,NA,Bogota D.C.,7743955,2701,57,238286,6556
2020-09-11,Colombia,NA,Bogota D.C.,7743955,2139,55,240425,6611
2020-09-12,Colombia,NA,Bogota D.C.,7743955,1556,52,241981,6663
2020-09-13,Colombia,NA,Bogota D.C.,7743955,898,50,242879,6713
2020-09-14,Colombia,NA,Bogota D.C.,7743955,1857,49,244736,6762
2020-09-15,Colombia,NA,Bogota D.C.,7743955,1966,47,246702,6809
2020-09-16,Colombia,NA,Bogota D.C.,7743955,1984,44,248686,6853
2020-09-17,Colombia,NA,Bogota D.C.,7743955,1709,42,250395,6895
2020-09-18,Colombia,NA,Bogota D.C.,7743955,1906,47,252301,6942
2020-09-19,Colombia,NA,Bogota D.C.,7743955,1611,48,253912,6990
2020-09-20,Colombia,NA,Bogota D.C.,7743955,1452,38,255364,7028
2020-09-21,Colombia,NA,Bogota D.C.,7743955,1584,42,256948,7070
2020-09-22,Colombia,NA,Bogota D.C.,7743955,1408,47,258356,7117
2020-09-23,Colombia,NA,Bogota D.C.,7743955,563,45,258919,7162
2020-03-20,Colombia,NA,Bolivar,2180976,1,0,11,1
2020-03-21,Colombia,NA,Bolivar,2180976,4,0,15,1
2020-03-23,Colombia,NA,Bolivar,2180976,1,0,16,1
2020-03-24,Colombia,NA,Bolivar,2180976,5,0,21,1
2020-03-25,Colombia,NA,Bolivar,2180976,5,0,26,1
2020-03-27,Colombia,NA,Bolivar,2180976,0,1,26,2
2020-03-28,Colombia,NA,Bolivar,2180976,2,0,28,2
2020-03-29,Colombia,NA,Bolivar,2180976,10,0,38,2
2020-03-30,Colombia,NA,Bolivar,2180976,3,2,41,4
2020-03-31,Colombia,NA,Bolivar,2180976,2,1,43,5
2020-04-03,Colombia,NA,Bolivar,2180976,3,0,46,5
2020-04-04,Colombia,NA,Bolivar,2180976,0,0,46,5
2020-04-05,Colombia,NA,Bolivar,2180976,0,1,46,6
2020-04-06,Colombia,NA,Bolivar,2180976,11,1,57,7
2020-04-07,Colombia,NA,Bolivar,2180976,3,0,60,7
2020-04-08,Colombia,NA,Bolivar,2180976,12,0,72,7
2020-04-09,Colombia,NA,Bolivar,2180976,17,1,89,8
2020-04-10,Colombia,NA,Bolivar,2180976,21,1,110,9
2020-04-11,Colombia,NA,Bolivar,2180976,8,1,118,10
2020-04-12,Colombia,NA,Bolivar,2180976,6,1,124,11
2020-04-13,Colombia,NA,Bolivar,2180976,11,1,135,12
2020-04-14,Colombia,NA,Bolivar,2180976,11,0,146,12
2020-04-15,Colombia,NA,Bolivar,2180976,14,0,160,12
2020-04-16,Colombia,NA,Bolivar,2180976,8,3,168,15
2020-04-17,Colombia,NA,Bolivar,2180976,6,1,174,16
2020-04-18,Colombia,NA,Bolivar,2180976,10,1,184,17
2020-04-19,Colombia,NA,Bolivar,2180976,1,0,185,17
2020-04-20,Colombia,NA,Bolivar,2180976,11,1,196,18
2020-04-21,Colombia,NA,Bolivar,2180976,4,0,200,18
2020-04-22,Colombia,NA,Bolivar,2180976,0,1,200,19
2020-04-23,Colombia,NA,Bolivar,2180976,5,2,205,21
2020-04-24,Colombia,NA,Bolivar,2180976,16,2,221,23
2020-04-25,Colombia,NA,Bolivar,2180976,6,1,227,24
2020-04-26,Colombia,NA,Bolivar,2180976,14,0,241,24
2020-04-27,Colombia,NA,Bolivar,2180976,4,2,245,26
2020-04-28,Colombia,NA,Bolivar,2180976,13,1,258,27
2020-04-29,Colombia,NA,Bolivar,2180976,11,1,269,28
2020-04-30,Colombia,NA,Bolivar,2180976,26,3,295,31
2020-05-01,Colombia,NA,Bolivar,2180976,14,2,309,33
2020-05-02,Colombia,NA,Bolivar,2180976,26,1,335,34
2020-05-03,Colombia,NA,Bolivar,2180976,19,4,354,38
2020-05-04,Colombia,NA,Bolivar,2180976,20,3,374,41
2020-05-05,Colombia,NA,Bolivar,2180976,33,5,407,46
2020-05-06,Colombia,NA,Bolivar,2180976,25,4,432,50
2020-05-07,Colombia,NA,Bolivar,2180976,5,5,437,55
2020-05-08,Colombia,NA,Bolivar,2180976,101,3,538,58
2020-05-09,Colombia,NA,Bolivar,2180976,45,3,583,61
2020-05-10,Colombia,NA,Bolivar,2180976,98,4,681,65
2020-05-11,Colombia,NA,Bolivar,2180976,65,6,746,71
2020-05-12,Colombia,NA,Bolivar,2180976,88,5,834,76
2020-05-13,Colombia,NA,Bolivar,2180976,113,2,947,78
2020-05-14,Colombia,NA,Bolivar,2180976,115,7,1062,85
2020-05-15,Colombia,NA,Bolivar,2180976,95,6,1157,91
2020-05-16,Colombia,NA,Bolivar,2180976,129,5,1286,96
2020-05-17,Colombia,NA,Bolivar,2180976,70,6,1356,102
2020-05-18,Colombia,NA,Bolivar,2180976,148,7,1504,109
2020-05-19,Colombia,NA,Bolivar,2180976,85,5,1589,114
2020-05-20,Colombia,NA,Bolivar,2180976,116,8,1705,122
2020-05-21,Colombia,NA,Bolivar,2180976,130,5,1835,127
2020-05-22,Colombia,NA,Bolivar,2180976,46,5,1881,132
2020-05-23,Colombia,NA,Bolivar,2180976,150,7,2031,139
2020-05-24,Colombia,NA,Bolivar,2180976,242,9,2273,148
2020-05-25,Colombia,NA,Bolivar,2180976,39,8,2312,156
2020-05-26,Colombia,NA,Bolivar,2180976,77,5,2389,161
2020-05-27,Colombia,NA,Bolivar,2180976,137,5,2526,166
2020-05-28,Colombia,NA,Bolivar,2180976,151,9,2677,175
2020-05-29,Colombia,NA,Bolivar,2180976,182,2,2859,177
2020-05-30,Colombia,NA,Bolivar,2180976,197,5,3056,182
2020-05-31,Colombia,NA,Bolivar,2180976,150,5,3206,187
2020-06-01,Colombia,NA,Bolivar,2180976,78,6,3284,193
2020-06-02,Colombia,NA,Bolivar,2180976,95,4,3379,197
2020-06-03,Colombia,NA,Bolivar,2180976,205,7,3584,204
2020-06-04,Colombia,NA,Bolivar,2180976,152,6,3736,210
2020-06-05,Colombia,NA,Bolivar,2180976,140,7,3876,217
2020-06-06,Colombia,NA,Bolivar,2180976,118,9,3994,226
2020-06-07,Colombia,NA,Bolivar,2180976,158,3,4152,229
2020-06-08,Colombia,NA,Bolivar,2180976,90,6,4242,235
2020-06-09,Colombia,NA,Bolivar,2180976,144,5,4386,240
2020-06-10,Colombia,NA,Bolivar,2180976,121,3,4507,243
2020-06-11,Colombia,NA,Bolivar,2180976,196,4,4703,247
2020-06-12,Colombia,NA,Bolivar,2180976,64,10,4767,257
2020-06-13,Colombia,NA,Bolivar,2180976,170,9,4937,266
2020-06-14,Colombia,NA,Bolivar,2180976,183,8,5120,274
2020-06-15,Colombia,NA,Bolivar,2180976,101,7,5221,281
2020-06-16,Colombia,NA,Bolivar,2180976,168,4,5389,285
2020-06-17,Colombia,NA,Bolivar,2180976,131,8,5520,293
2020-06-18,Colombia,NA,Bolivar,2180976,271,18,5791,311
2020-06-19,Colombia,NA,Bolivar,2180976,414,9,6205,320
2020-06-20,Colombia,NA,Bolivar,2180976,222,7,6427,327
2020-06-21,Colombia,NA,Bolivar,2180976,261,17,6688,344
2020-06-22,Colombia,NA,Bolivar,2180976,309,8,6997,352
2020-06-23,Colombia,NA,Bolivar,2180976,205,9,7202,361
2020-06-24,Colombia,NA,Bolivar,2180976,273,12,7475,373
2020-06-25,Colombia,NA,Bolivar,2180976,418,8,7893,381
2020-06-26,Colombia,NA,Bolivar,2180976,483,9,8376,390
2020-06-27,Colombia,NA,Bolivar,2180976,255,14,8631,404
2020-06-28,Colombia,NA,Bolivar,2180976,253,12,8884,416
2020-06-29,Colombia,NA,Bolivar,2180976,219,7,9103,423
2020-06-30,Colombia,NA,Bolivar,2180976,127,7,9230,430
2020-07-01,Colombia,NA,Bolivar,2180976,306,3,9536,433
2020-07-02,Colombia,NA,Bolivar,2180976,253,7,9789,440
2020-07-03,Colombia,NA,Bolivar,2180976,252,13,10041,453
2020-07-04,Colombia,NA,Bolivar,2180976,304,6,10345,459
2020-07-05,Colombia,NA,Bolivar,2180976,392,9,10737,468
2020-07-06,Colombia,NA,Bolivar,2180976,298,4,11035,472
2020-07-07,Colombia,NA,Bolivar,2180976,298,8,11333,480
2020-07-08,Colombia,NA,Bolivar,2180976,402,10,11735,490
2020-07-09,Colombia,NA,Bolivar,2180976,246,6,11981,496
2020-07-10,Colombia,NA,Bolivar,2180976,384,6,12365,502
2020-07-11,Colombia,NA,Bolivar,2180976,416,11,12781,513
2020-07-12,Colombia,NA,Bolivar,2180976,426,9,13207,522
2020-07-13,Colombia,NA,Bolivar,2180976,397,6,13604,528
2020-07-14,Colombia,NA,Bolivar,2180976,445,6,14049,534
2020-07-15,Colombia,NA,Bolivar,2180976,320,6,14369,540
2020-07-16,Colombia,NA,Bolivar,2180976,362,5,14731,545
2020-07-17,Colombia,NA,Bolivar,2180976,134,8,14865,553
2020-07-18,Colombia,NA,Bolivar,2180976,107,4,14972,557
2020-07-19,Colombia,NA,Bolivar,2180976,241,7,15213,564
2020-07-20,Colombia,NA,Bolivar,2180976,149,12,15362,576
2020-07-21,Colombia,NA,Bolivar,2180976,321,3,15683,579
2020-07-22,Colombia,NA,Bolivar,2180976,424,6,16107,585
2020-07-23,Colombia,NA,Bolivar,2180976,277,8,16384,593
2020-07-24,Colombia,NA,Bolivar,2180976,353,9,16737,602
2020-07-25,Colombia,NA,Bolivar,2180976,340,8,17077,610
2020-07-26,Colombia,NA,Bolivar,2180976,138,7,17215,617
2020-07-27,Colombia,NA,Bolivar,2180976,437,5,17652,622
2020-07-28,Colombia,NA,Bolivar,2180976,344,8,17996,630
2020-07-29,Colombia,NA,Bolivar,2180976,362,5,18358,635
2020-07-30,Colombia,NA,Bolivar,2180976,560,6,18918,641
2020-07-31,Colombia,NA,Bolivar,2180976,220,9,19138,650
2020-08-01,Colombia,NA,Bolivar,2180976,139,3,19277,653
2020-08-02,Colombia,NA,Bolivar,2180976,167,10,19444,663
2020-08-03,Colombia,NA,Bolivar,2180976,146,7,19590,670
2020-08-04,Colombia,NA,Bolivar,2180976,234,4,19824,674
2020-08-05,Colombia,NA,Bolivar,2180976,180,6,20004,680
2020-08-06,Colombia,NA,Bolivar,2180976,221,5,20225,685
2020-08-07,Colombia,NA,Bolivar,2180976,227,0,20452,685
2020-08-08,Colombia,NA,Bolivar,2180976,242,2,20694,687
2020-08-09,Colombia,NA,Bolivar,2180976,135,8,20829,695
2020-08-10,Colombia,NA,Bolivar,2180976,197,5,21026,700
2020-08-11,Colombia,NA,Bolivar,2180976,246,2,21272,702
2020-08-12,Colombia,NA,Bolivar,2180976,138,2,21410,704
2020-08-13,Colombia,NA,Bolivar,2180976,297,7,21707,711
2020-08-14,Colombia,NA,Bolivar,2180976,233,2,21940,713
2020-08-15,Colombia,NA,Bolivar,2180976,116,2,22056,715
2020-08-16,Colombia,NA,Bolivar,2180976,183,3,22239,718
2020-08-17,Colombia,NA,Bolivar,2180976,317,2,22556,720
2020-08-18,Colombia,NA,Bolivar,2180976,153,6,22709,726
2020-08-19,Colombia,NA,Bolivar,2180976,64,10,22773,736
2020-08-20,Colombia,NA,Bolivar,2180976,210,3,22983,739
2020-08-21,Colombia,NA,Bolivar,2180976,218,4,23201,743
2020-08-22,Colombia,NA,Bolivar,2180976,136,3,23337,746
2020-08-23,Colombia,NA,Bolivar,2180976,107,4,23444,750
2020-08-24,Colombia,NA,Bolivar,2180976,350,3,23794,753
2020-08-25,Colombia,NA,Bolivar,2180976,316,1,24110,754
2020-08-26,Colombia,NA,Bolivar,2180976,353,4,24463,758
2020-08-27,Colombia,NA,Bolivar,2180976,94,3,24557,761
2020-08-28,Colombia,NA,Bolivar,2180976,187,5,24744,766
2020-08-29,Colombia,NA,Bolivar,2180976,85,0,24829,766
2020-08-30,Colombia,NA,Bolivar,2180976,65,2,24894,768
2020-08-31,Colombia,NA,Bolivar,2180976,188,3,25082,771
2020-09-01,Colombia,NA,Bolivar,2180976,79,4,25161,775
2020-09-02,Colombia,NA,Bolivar,2180976,124,2,25285,777
2020-09-03,Colombia,NA,Bolivar,2180976,67,6,25352,783
2020-09-04,Colombia,NA,Bolivar,2180976,66,3,25418,786
2020-09-05,Colombia,NA,Bolivar,2180976,127,1,25545,787
2020-09-06,Colombia,NA,Bolivar,2180976,49,3,25594,790
2020-09-07,Colombia,NA,Bolivar,2180976,107,3,25701,793
2020-09-08,Colombia,NA,Bolivar,2180976,143,0,25844,793
2020-09-09,Colombia,NA,Bolivar,2180976,447,4,26291,797
2020-09-10,Colombia,NA,Bolivar,2180976,194,0,26485,797
2020-09-11,Colombia,NA,Bolivar,2180976,74,2,26559,799
2020-09-12,Colombia,NA,Bolivar,2180976,259,5,26818,804
2020-09-13,Colombia,NA,Bolivar,2180976,23,0,26841,804
2020-09-14,Colombia,NA,Bolivar,2180976,265,4,27106,808
2020-09-15,Colombia,NA,Bolivar,2180976,125,1,27231,809
2020-09-16,Colombia,NA,Bolivar,2180976,111,0,27342,809
2020-09-17,Colombia,NA,Bolivar,2180976,98,2,27440,811
2020-09-18,Colombia,NA,Bolivar,2180976,82,3,27522,814
2020-09-19,Colombia,NA,Bolivar,2180976,31,2,27553,816
2020-09-20,Colombia,NA,Bolivar,2180976,31,2,27584,818
2020-09-21,Colombia,NA,Bolivar,2180976,161,0,27745,818
2020-09-22,Colombia,NA,Bolivar,2180976,84,2,27829,820
2020-09-23,Colombia,NA,Bolivar,2180976,48,1,27877,821
2020-04-04,Colombia,NA,Boyaca,1242731,7,1,13,1
2020-04-06,Colombia,NA,Boyaca,1242731,0,0,13,1
2020-04-08,Colombia,NA,Boyaca,1242731,6,0,19,1
2020-04-09,Colombia,NA,Boyaca,1242731,5,0,24,1
2020-04-10,Colombia,NA,Boyaca,1242731,4,0,28,1
2020-04-11,Colombia,NA,Boyaca,1242731,3,0,31,1
2020-04-13,Colombia,NA,Boyaca,1242731,0,0,31,1
2020-04-14,Colombia,NA,Boyaca,1242731,0,0,31,1
2020-04-15,Colombia,NA,Boyaca,1242731,0,0,31,1
2020-04-16,Colombia,NA,Boyaca,1242731,1,0,32,1
2020-04-19,Colombia,NA,Boyaca,1242731,0,0,32,1
2020-04-20,Colombia,NA,Boyaca,1242731,1,0,33,1
2020-04-23,Colombia,NA,Boyaca,1242731,0,1,33,2
2020-04-25,Colombia,NA,Boyaca,1242731,0,0,33,2
2020-04-26,Colombia,NA,Boyaca,1242731,2,0,35,2
2020-04-28,Colombia,NA,Boyaca,1242731,2,0,37,2
2020-04-29,Colombia,NA,Boyaca,1242731,0,2,37,4
2020-04-30,Colombia,NA,Boyaca,1242731,2,0,39,4
2020-05-01,Colombia,NA,Boyaca,1242731,7,0,46,4
2020-05-02,Colombia,NA,Boyaca,1242731,1,0,47,4
2020-05-04,Colombia,NA,Boyaca,1242731,11,0,58,4
2020-05-05,Colombia,NA,Boyaca,1242731,2,0,60,4
2020-05-06,Colombia,NA,Boyaca,1242731,0,0,60,4
2020-05-07,Colombia,NA,Boyaca,1242731,1,0,61,4
2020-05-09,Colombia,NA,Boyaca,1242731,0,0,61,4
2020-05-10,Colombia,NA,Boyaca,1242731,6,0,67,4
2020-05-11,Colombia,NA,Boyaca,1242731,10,0,77,4
2020-05-12,Colombia,NA,Boyaca,1242731,2,0,79,4
2020-05-13,Colombia,NA,Boyaca,1242731,8,0,87,4
2020-05-14,Colombia,NA,Boyaca,1242731,1,0,88,4
2020-05-15,Colombia,NA,Boyaca,1242731,0,0,88,4
2020-05-16,Colombia,NA,Boyaca,1242731,17,3,105,7
2020-05-18,Colombia,NA,Boyaca,1242731,3,1,108,8
2020-05-19,Colombia,NA,Boyaca,1242731,12,0,120,8
2020-05-20,Colombia,NA,Boyaca,1242731,6,0,126,8
2020-05-21,Colombia,NA,Boyaca,1242731,10,1,136,9
2020-05-22,Colombia,NA,Boyaca,1242731,8,1,144,10
2020-05-23,Colombia,NA,Boyaca,1242731,8,0,152,10
2020-05-24,Colombia,NA,Boyaca,1242731,7,0,159,10
2020-05-25,Colombia,NA,Boyaca,1242731,3,0,162,10
2020-05-26,Colombia,NA,Boyaca,1242731,4,0,166,10
2020-05-27,Colombia,NA,Boyaca,1242731,11,0,177,10
2020-05-28,Colombia,NA,Boyaca,1242731,4,0,181,10
2020-05-29,Colombia,NA,Boyaca,1242731,8,1,189,11
2020-05-30,Colombia,NA,Boyaca,1242731,1,0,190,11
2020-05-31,Colombia,NA,Boyaca,1242731,21,1,211,12
2020-06-01,Colombia,NA,Boyaca,1242731,0,0,211,12
2020-06-02,Colombia,NA,Boyaca,1242731,0,0,211,12
2020-06-03,Colombia,NA,Boyaca,1242731,2,0,213,12
2020-06-04,Colombia,NA,Boyaca,1242731,6,0,219,12
2020-06-05,Colombia,NA,Boyaca,1242731,2,0,221,12
2020-06-06,Colombia,NA,Boyaca,1242731,2,0,223,12
2020-06-07,Colombia,NA,Boyaca,1242731,0,0,223,12
2020-06-08,Colombia,NA,Boyaca,1242731,2,0,225,12
2020-06-09,Colombia,NA,Boyaca,1242731,2,0,227,12
2020-06-10,Colombia,NA,Boyaca,1242731,4,1,231,13
2020-06-11,Colombia,NA,Boyaca,1242731,4,0,235,13
2020-06-12,Colombia,NA,Boyaca,1242731,0,0,235,13
2020-06-13,Colombia,NA,Boyaca,1242731,5,1,240,14
2020-06-14,Colombia,NA,Boyaca,1242731,5,0,245,14
2020-06-15,Colombia,NA,Boyaca,1242731,5,0,250,14
2020-06-16,Colombia,NA,Boyaca,1242731,5,0,255,14
2020-06-17,Colombia,NA,Boyaca,1242731,6,2,261,16
2020-06-18,Colombia,NA,Boyaca,1242731,4,0,265,16
2020-06-19,Colombia,NA,Boyaca,1242731,24,0,289,16
2020-06-20,Colombia,NA,Boyaca,1242731,7,0,296,16
2020-06-21,Colombia,NA,Boyaca,1242731,8,0,304,16
2020-06-22,Colombia,NA,Boyaca,1242731,4,0,308,16
2020-06-23,Colombia,NA,Boyaca,1242731,5,0,313,16
2020-06-24,Colombia,NA,Boyaca,1242731,18,0,331,16
2020-06-25,Colombia,NA,Boyaca,1242731,5,0,336,16
2020-06-26,Colombia,NA,Boyaca,1242731,5,0,341,16
2020-06-27,Colombia,NA,Boyaca,1242731,9,0,350,16
2020-06-28,Colombia,NA,Boyaca,1242731,4,1,354,17
2020-06-29,Colombia,NA,Boyaca,1242731,3,0,357,17
2020-06-30,Colombia,NA,Boyaca,1242731,8,0,365,17
2020-07-01,Colombia,NA,Boyaca,1242731,14,0,379,17
2020-07-02,Colombia,NA,Boyaca,1242731,17,1,396,18
2020-07-03,Colombia,NA,Boyaca,1242731,7,1,403,19
2020-07-04,Colombia,NA,Boyaca,1242731,10,0,413,19
2020-07-05,Colombia,NA,Boyaca,1242731,16,0,429,19
2020-07-06,Colombia,NA,Boyaca,1242731,6,0,435,19
2020-07-07,Colombia,NA,Boyaca,1242731,12,0,447,19
2020-07-08,Colombia,NA,Boyaca,1242731,3,0,450,19
2020-07-09,Colombia,NA,Boyaca,1242731,15,2,465,21
2020-07-10,Colombia,NA,Boyaca,1242731,21,1,486,22
2020-07-11,Colombia,NA,Boyaca,1242731,11,0,497,22
2020-07-12,Colombia,NA,Boyaca,1242731,12,1,509,23
2020-07-13,Colombia,NA,Boyaca,1242731,18,2,527,25
2020-07-14,Colombia,NA,Boyaca,1242731,6,0,533,25
2020-07-15,Colombia,NA,Boyaca,1242731,10,1,543,26
2020-07-16,Colombia,NA,Boyaca,1242731,72,0,615,26
2020-07-17,Colombia,NA,Boyaca,1242731,7,2,622,28
2020-07-18,Colombia,NA,Boyaca,1242731,21,2,643,30
2020-07-19,Colombia,NA,Boyaca,1242731,14,0,657,30
2020-07-20,Colombia,NA,Boyaca,1242731,0,1,657,31
2020-07-21,Colombia,NA,Boyaca,1242731,8,2,665,33
2020-07-22,Colombia,NA,Boyaca,1242731,48,0,713,33
2020-07-23,Colombia,NA,Boyaca,1242731,26,1,739,34
2020-07-24,Colombia,NA,Boyaca,1242731,28,1,767,35
2020-07-25,Colombia,NA,Boyaca,1242731,30,0,797,35
2020-07-26,Colombia,NA,Boyaca,1242731,27,0,824,35
2020-07-27,Colombia,NA,Boyaca,1242731,33,1,857,36
2020-07-28,Colombia,NA,Boyaca,1242731,83,3,940,39
2020-07-29,Colombia,NA,Boyaca,1242731,62,0,1002,39
2020-07-30,Colombia,NA,Boyaca,1242731,53,1,1055,40
2020-07-31,Colombia,NA,Boyaca,1242731,47,1,1102,41
2020-08-01,Colombia,NA,Boyaca,1242731,57,2,1159,43
2020-08-02,Colombia,NA,Boyaca,1242731,56,0,1215,43
2020-08-03,Colombia,NA,Boyaca,1242731,29,2,1244,45
2020-08-04,Colombia,NA,Boyaca,1242731,73,1,1317,46
2020-08-05,Colombia,NA,Boyaca,1242731,65,3,1382,49
2020-08-06,Colombia,NA,Boyaca,1242731,68,1,1450,50
2020-08-07,Colombia,NA,Boyaca,1242731,76,1,1526,51
2020-08-08,Colombia,NA,Boyaca,1242731,28,4,1554,55
2020-08-09,Colombia,NA,Boyaca,1242731,111,1,1665,56
2020-08-10,Colombia,NA,Boyaca,1242731,70,2,1735,58
2020-08-11,Colombia,NA,Boyaca,1242731,47,3,1782,61
2020-08-12,Colombia,NA,Boyaca,1242731,107,2,1889,63
2020-08-13,Colombia,NA,Boyaca,1242731,100,3,1989,66
2020-08-14,Colombia,NA,Boyaca,1242731,121,3,2110,69
2020-08-15,Colombia,NA,Boyaca,1242731,101,0,2211,69
2020-08-16,Colombia,NA,Boyaca,1242731,89,1,2300,70
2020-08-17,Colombia,NA,Boyaca,1242731,69,2,2369,72
2020-08-18,Colombia,NA,Boyaca,1242731,86,1,2455,73
2020-08-19,Colombia,NA,Boyaca,1242731,65,0,2520,73
2020-08-20,Colombia,NA,Boyaca,1242731,281,5,2801,78
2020-08-21,Colombia,NA,Boyaca,1242731,199,1,3000,79
2020-08-22,Colombia,NA,Boyaca,1242731,129,1,3129,80
2020-08-23,Colombia,NA,Boyaca,1242731,93,2,3222,82
2020-08-24,Colombia,NA,Boyaca,1242731,121,1,3343,83
2020-08-25,Colombia,NA,Boyaca,1242731,75,0,3418,83
2020-08-26,Colombia,NA,Boyaca,1242731,79,4,3497,87
2020-08-27,Colombia,NA,Boyaca,1242731,140,4,3637,91
2020-08-28,Colombia,NA,Boyaca,1242731,101,4,3738,95
2020-08-29,Colombia,NA,Boyaca,1242731,81,2,3819,97
2020-08-30,Colombia,NA,Boyaca,1242731,60,3,3879,100
2020-08-31,Colombia,NA,Boyaca,1242731,71,1,3950,101
2020-09-01,Colombia,NA,Boyaca,1242731,135,0,4085,101
2020-09-02,Colombia,NA,Boyaca,1242731,163,5,4248,106
2020-09-03,Colombia,NA,Boyaca,1242731,63,0,4311,106
2020-09-04,Colombia,NA,Boyaca,1242731,170,3,4481,109
2020-09-05,Colombia,NA,Boyaca,1242731,101,2,4582,111
2020-09-06,Colombia,NA,Boyaca,1242731,69,3,4651,114
2020-09-07,Colombia,NA,Boyaca,1242731,118,2,4769,116
2020-09-08,Colombia,NA,Boyaca,1242731,113,4,4882,120
2020-09-09,Colombia,NA,Boyaca,1242731,95,2,4977,122
2020-09-10,Colombia,NA,Boyaca,1242731,128,3,5105,125
2020-09-11,Colombia,NA,Boyaca,1242731,70,3,5175,128
2020-09-12,Colombia,NA,Boyaca,1242731,127,2,5302,130
2020-09-13,Colombia,NA,Boyaca,1242731,204,2,5506,132
2020-09-14,Colombia,NA,Boyaca,1242731,84,2,5590,134
2020-09-15,Colombia,NA,Boyaca,1242731,155,1,5745,135
2020-09-16,Colombia,NA,Boyaca,1242731,108,1,5853,136
2020-09-17,Colombia,NA,Boyaca,1242731,154,5,6007,141
2020-09-18,Colombia,NA,Boyaca,1242731,81,2,6088,143
2020-09-19,Colombia,NA,Boyaca,1242731,89,4,6177,147
2020-09-20,Colombia,NA,Boyaca,1242731,86,2,6263,149
2020-09-21,Colombia,NA,Boyaca,1242731,116,0,6379,149
2020-09-22,Colombia,NA,Boyaca,1242731,99,2,6478,151
2020-09-23,Colombia,NA,Boyaca,1242731,178,0,6656,151
2020-03-25,Colombia,NA,Caldas,1018453,2,0,11,0
2020-03-26,Colombia,NA,Caldas,1018453,0,0,11,0
2020-03-27,Colombia,NA,Caldas,1018453,1,0,12,0
2020-03-28,Colombia,NA,Caldas,1018453,1,0,13,0
2020-03-29,Colombia,NA,Caldas,1018453,1,0,14,0
2020-03-30,Colombia,NA,Caldas,1018453,1,0,15,0
2020-03-31,Colombia,NA,Caldas,1018453,0,0,15,0
2020-04-01,Colombia,NA,Caldas,1018453,0,1,15,1
2020-04-02,Colombia,NA,Caldas,1018453,1,0,16,1
2020-04-04,Colombia,NA,Caldas,1018453,0,0,16,1
2020-04-05,Colombia,NA,Caldas,1018453,0,0,16,1
2020-04-08,Colombia,NA,Caldas,1018453,3,0,19,1
2020-04-09,Colombia,NA,Caldas,1018453,5,0,24,1
2020-04-10,Colombia,NA,Caldas,1018453,1,0,25,1
2020-04-11,Colombia,NA,Caldas,1018453,8,1,33,2
2020-04-12,Colombia,NA,Caldas,1018453,1,0,34,2
2020-04-13,Colombia,NA,Caldas,1018453,2,0,36,2
2020-04-15,Colombia,NA,Caldas,1018453,6,0,42,2
2020-04-16,Colombia,NA,Caldas,1018453,2,0,44,2
2020-04-17,Colombia,NA,Caldas,1018453,3,0,47,2
2020-04-19,Colombia,NA,Caldas,1018453,0,0,47,2
2020-04-20,Colombia,NA,Caldas,1018453,2,0,49,2
2020-04-21,Colombia,NA,Caldas,1018453,0,0,49,2
2020-04-23,Colombia,NA,Caldas,1018453,0,0,49,2
2020-04-24,Colombia,NA,Caldas,1018453,3,0,52,2
2020-04-26,Colombia,NA,Caldas,1018453,1,0,53,2
2020-04-27,Colombia,NA,Caldas,1018453,0,0,53,2
2020-04-28,Colombia,NA,Caldas,1018453,3,0,56,2
2020-04-29,Colombia,NA,Caldas,1018453,3,0,59,2
2020-04-30,Colombia,NA,Caldas,1018453,10,0,69,2
2020-05-02,Colombia,NA,Caldas,1018453,10,0,79,2
2020-05-03,Colombia,NA,Caldas,1018453,0,1,79,3
2020-05-05,Colombia,NA,Caldas,1018453,12,0,91,3
2020-05-06,Colombia,NA,Caldas,1018453,3,0,94,3
2020-05-07,Colombia,NA,Caldas,1018453,0,0,94,3
2020-05-08,Colombia,NA,Caldas,1018453,0,1,94,4
2020-05-09,Colombia,NA,Caldas,1018453,6,1,100,5
2020-05-10,Colombia,NA,Caldas,1018453,0,0,100,5
2020-05-11,Colombia,NA,Caldas,1018453,0,0,100,5
2020-05-12,Colombia,NA,Caldas,1018453,4,0,104,5
2020-05-13,Colombia,NA,Caldas,1018453,0,0,104,5
2020-05-14,Colombia,NA,Caldas,1018453,4,0,108,5
2020-05-15,Colombia,NA,Caldas,1018453,1,0,109,5
2020-05-16,Colombia,NA,Caldas,1018453,10,0,119,5
2020-05-17,Colombia,NA,Caldas,1018453,1,0,120,5
2020-05-18,Colombia,NA,Caldas,1018453,0,0,120,5
2020-05-19,Colombia,NA,Caldas,1018453,0,0,120,5
2020-05-20,Colombia,NA,Caldas,1018453,6,0,126,5
2020-05-21,Colombia,NA,Caldas,1018453,0,0,126,5
2020-05-22,Colombia,NA,Caldas,1018453,0,0,126,5
2020-05-23,Colombia,NA,Caldas,1018453,1,0,127,5
2020-05-24,Colombia,NA,Caldas,1018453,1,1,128,6
2020-05-25,Colombia,NA,Caldas,1018453,0,0,128,6
2020-05-26,Colombia,NA,Caldas,1018453,2,0,130,6
2020-05-27,Colombia,NA,Caldas,1018453,4,0,134,6
2020-05-28,Colombia,NA,Caldas,1018453,1,0,135,6
2020-05-29,Colombia,NA,Caldas,1018453,0,0,135,6
2020-05-30,Colombia,NA,Caldas,1018453,0,0,135,6
2020-05-31,Colombia,NA,Caldas,1018453,0,0,135,6
2020-06-01,Colombia,NA,Caldas,1018453,3,0,138,6
2020-06-02,Colombia,NA,Caldas,1018453,8,0,146,6
2020-06-03,Colombia,NA,Caldas,1018453,11,1,157,7
2020-06-04,Colombia,NA,Caldas,1018453,5,0,162,7
2020-06-05,Colombia,NA,Caldas,1018453,2,0,164,7
2020-06-06,Colombia,NA,Caldas,1018453,9,0,173,7
2020-06-07,Colombia,NA,Caldas,1018453,3,0,176,7
2020-06-09,Colombia,NA,Caldas,1018453,4,0,180,7
2020-06-10,Colombia,NA,Caldas,1018453,5,0,185,7
2020-06-11,Colombia,NA,Caldas,1018453,3,0,188,7
2020-06-12,Colombia,NA,Caldas,1018453,3,0,191,7
2020-06-13,Colombia,NA,Caldas,1018453,1,0,192,7
2020-06-14,Colombia,NA,Caldas,1018453,5,0,197,7
2020-06-15,Colombia,NA,Caldas,1018453,4,0,201,7
2020-06-16,Colombia,NA,Caldas,1018453,5,0,206,7
2020-06-17,Colombia,NA,Caldas,1018453,0,0,206,7
2020-06-18,Colombia,NA,Caldas,1018453,2,0,208,7
2020-06-19,Colombia,NA,Caldas,1018453,4,0,212,7
2020-06-20,Colombia,NA,Caldas,1018453,5,0,217,7
2020-06-21,Colombia,NA,Caldas,1018453,2,0,219,7
2020-06-22,Colombia,NA,Caldas,1018453,13,0,232,7
2020-06-23,Colombia,NA,Caldas,1018453,6,0,238,7
2020-06-24,Colombia,NA,Caldas,1018453,1,0,239,7
2020-06-25,Colombia,NA,Caldas,1018453,2,0,241,7
2020-06-26,Colombia,NA,Caldas,1018453,3,0,244,7
2020-06-27,Colombia,NA,Caldas,1018453,1,0,245,7
2020-06-28,Colombia,NA,Caldas,1018453,12,0,257,7
2020-06-29,Colombia,NA,Caldas,1018453,2,0,259,7
2020-06-30,Colombia,NA,Caldas,1018453,1,0,260,7
2020-07-01,Colombia,NA,Caldas,1018453,4,1,264,8
2020-07-02,Colombia,NA,Caldas,1018453,3,0,267,8
2020-07-03,Colombia,NA,Caldas,1018453,1,0,268,8
2020-07-04,Colombia,NA,Caldas,1018453,3,0,271,8
2020-07-05,Colombia,NA,Caldas,1018453,0,0,271,8
2020-07-06,Colombia,NA,Caldas,1018453,2,0,273,8
2020-07-07,Colombia,NA,Caldas,1018453,5,0,278,8
2020-07-08,Colombia,NA,Caldas,1018453,1,0,279,8
2020-07-09,Colombia,NA,Caldas,1018453,8,0,287,8
2020-07-10,Colombia,NA,Caldas,1018453,7,0,294,8
2020-07-11,Colombia,NA,Caldas,1018453,0,0,294,8
2020-07-12,Colombia,NA,Caldas,1018453,8,0,302,8
2020-07-13,Colombia,NA,Caldas,1018453,0,0,302,8
2020-07-14,Colombia,NA,Caldas,1018453,10,2,312,10
2020-07-15,Colombia,NA,Caldas,1018453,10,0,322,10
2020-07-16,Colombia,NA,Caldas,1018453,10,0,332,10
2020-07-17,Colombia,NA,Caldas,1018453,35,0,367,10
2020-07-18,Colombia,NA,Caldas,1018453,28,0,395,10
2020-07-19,Colombia,NA,Caldas,1018453,1,1,396,11
2020-07-20,Colombia,NA,Caldas,1018453,9,2,405,13
2020-07-21,Colombia,NA,Caldas,1018453,71,1,476,14
2020-07-22,Colombia,NA,Caldas,1018453,82,0,558,14
2020-07-23,Colombia,NA,Caldas,1018453,29,1,587,15
2020-07-24,Colombia,NA,Caldas,1018453,59,0,646,15
2020-07-25,Colombia,NA,Caldas,1018453,67,0,713,15
2020-07-26,Colombia,NA,Caldas,1018453,7,1,720,16
2020-07-27,Colombia,NA,Caldas,1018453,7,0,727,16
2020-07-28,Colombia,NA,Caldas,1018453,66,1,793,17
2020-07-29,Colombia,NA,Caldas,1018453,59,3,852,20
2020-07-30,Colombia,NA,Caldas,1018453,90,1,942,21
2020-07-31,Colombia,NA,Caldas,1018453,49,1,991,22
2020-08-01,Colombia,NA,Caldas,1018453,29,2,1020,24
2020-08-02,Colombia,NA,Caldas,1018453,12,1,1032,25
2020-08-03,Colombia,NA,Caldas,1018453,25,0,1057,25
2020-08-04,Colombia,NA,Caldas,1018453,89,0,1146,25
2020-08-05,Colombia,NA,Caldas,1018453,17,1,1163,26
2020-08-06,Colombia,NA,Caldas,1018453,19,2,1182,28
2020-08-07,Colombia,NA,Caldas,1018453,35,1,1217,29
2020-08-08,Colombia,NA,Caldas,1018453,93,2,1310,31
2020-08-09,Colombia,NA,Caldas,1018453,76,2,1386,33
2020-08-10,Colombia,NA,Caldas,1018453,30,3,1416,36
2020-08-11,Colombia,NA,Caldas,1018453,40,1,1456,37
2020-08-12,Colombia,NA,Caldas,1018453,32,0,1488,37
2020-08-13,Colombia,NA,Caldas,1018453,59,2,1547,39
2020-08-14,Colombia,NA,Caldas,1018453,47,2,1594,41
2020-08-15,Colombia,NA,Caldas,1018453,70,0,1664,41
2020-08-16,Colombia,NA,Caldas,1018453,20,1,1684,42
2020-08-17,Colombia,NA,Caldas,1018453,70,3,1754,45
2020-08-18,Colombia,NA,Caldas,1018453,77,3,1831,48
2020-08-19,Colombia,NA,Caldas,1018453,126,0,1957,48
2020-08-20,Colombia,NA,Caldas,1018453,175,1,2132,49
2020-08-21,Colombia,NA,Caldas,1018453,90,4,2222,53
2020-08-22,Colombia,NA,Caldas,1018453,81,1,2303,54
2020-08-23,Colombia,NA,Caldas,1018453,55,4,2358,58
2020-08-24,Colombia,NA,Caldas,1018453,99,2,2457,60
2020-08-25,Colombia,NA,Caldas,1018453,83,2,2540,62
2020-08-26,Colombia,NA,Caldas,1018453,66,4,2606,66
2020-08-27,Colombia,NA,Caldas,1018453,90,3,2696,69
2020-08-28,Colombia,NA,Caldas,1018453,118,1,2814,70
2020-08-29,Colombia,NA,Caldas,1018453,63,6,2877,76
2020-08-30,Colombia,NA,Caldas,1018453,81,2,2958,78
2020-08-31,Colombia,NA,Caldas,1018453,53,1,3011,79
2020-09-01,Colombia,NA,Caldas,1018453,63,3,3074,82
2020-09-02,Colombia,NA,Caldas,1018453,122,8,3196,90
2020-09-03,Colombia,NA,Caldas,1018453,47,3,3243,93
2020-09-04,Colombia,NA,Caldas,1018453,75,2,3318,95
2020-09-05,Colombia,NA,Caldas,1018453,69,1,3387,96
2020-09-06,Colombia,NA,Caldas,1018453,67,4,3454,100
2020-09-07,Colombia,NA,Caldas,1018453,76,1,3530,101
2020-09-08,Colombia,NA,Caldas,1018453,66,4,3596,105
2020-09-09,Colombia,NA,Caldas,1018453,65,1,3661,106
2020-09-10,Colombia,NA,Caldas,1018453,159,1,3820,107
2020-09-11,Colombia,NA,Caldas,1018453,76,3,3896,110
2020-09-12,Colombia,NA,Caldas,1018453,122,2,4018,112
2020-09-13,Colombia,NA,Caldas,1018453,53,6,4071,118
2020-09-14,Colombia,NA,Caldas,1018453,125,0,4196,118
2020-09-15,Colombia,NA,Caldas,1018453,87,6,4283,124
2020-09-16,Colombia,NA,Caldas,1018453,105,1,4388,125
2020-09-17,Colombia,NA,Caldas,1018453,93,4,4481,129
2020-09-18,Colombia,NA,Caldas,1018453,192,1,4673,130
2020-09-19,Colombia,NA,Caldas,1018453,69,3,4742,133
2020-09-20,Colombia,NA,Caldas,1018453,50,3,4792,136
2020-09-21,Colombia,NA,Caldas,1018453,126,1,4918,137
2020-09-22,Colombia,NA,Caldas,1018453,214,2,5132,139
2020-09-23,Colombia,NA,Caldas,1018453,95,1,5227,140
2020-05-05,Colombia,NA,Caqueta,410521,6,0,15,1
2020-05-10,Colombia,NA,Caqueta,410521,1,0,16,1
2020-05-12,Colombia,NA,Caqueta,410521,1,0,17,1
2020-05-13,Colombia,NA,Caqueta,410521,2,0,19,1
2020-05-14,Colombia,NA,Caqueta,410521,0,0,19,1
2020-05-15,Colombia,NA,Caqueta,410521,0,0,19,1
2020-05-16,Colombia,NA,Caqueta,410521,1,0,20,1
2020-05-18,Colombia,NA,Caqueta,410521,1,0,21,1
2020-05-20,Colombia,NA,Caqueta,410521,0,0,21,1
2020-05-22,Colombia,NA,Caqueta,410521,0,0,21,1
2020-05-25,Colombia,NA,Caqueta,410521,1,0,22,1
2020-05-26,Colombia,NA,Caqueta,410521,2,0,24,1
2020-05-28,Colombia,NA,Caqueta,410521,0,0,24,1
2020-05-31,Colombia,NA,Caqueta,410521,0,0,24,1
2020-06-02,Colombia,NA,Caqueta,410521,0,0,24,1
2020-06-03,Colombia,NA,Caqueta,410521,0,0,24,1
2020-06-05,Colombia,NA,Caqueta,410521,0,0,24,1
2020-06-07,Colombia,NA,Caqueta,410521,1,0,25,1
2020-06-08,Colombia,NA,Caqueta,410521,0,0,25,1
2020-06-18,Colombia,NA,Caqueta,410521,1,0,26,1
2020-06-19,Colombia,NA,Caqueta,410521,0,0,26,1
2020-06-27,Colombia,NA,Caqueta,410521,5,0,31,1
2020-06-28,Colombia,NA,Caqueta,410521,4,0,35,1
2020-07-01,Colombia,NA,Caqueta,410521,4,0,39,1
2020-07-02,Colombia,NA,Caqueta,410521,4,0,43,1
2020-07-04,Colombia,NA,Caqueta,410521,11,0,54,1
2020-07-05,Colombia,NA,Caqueta,410521,1,1,55,2
2020-07-06,Colombia,NA,Caqueta,410521,5,0,60,2
2020-07-07,Colombia,NA,Caqueta,410521,5,1,65,3
2020-07-08,Colombia,NA,Caqueta,410521,13,1,78,4
2020-07-09,Colombia,NA,Caqueta,410521,1,0,79,4
2020-07-10,Colombia,NA,Caqueta,410521,9,0,88,4
2020-07-11,Colombia,NA,Caqueta,410521,14,1,102,5
2020-07-12,Colombia,NA,Caqueta,410521,17,0,119,5
2020-07-13,Colombia,NA,Caqueta,410521,13,1,132,6
2020-07-14,Colombia,NA,Caqueta,410521,3,1,135,7
2020-07-15,Colombia,NA,Caqueta,410521,54,0,189,7
2020-07-16,Colombia,NA,Caqueta,410521,87,0,276,7
2020-07-17,Colombia,NA,Caqueta,410521,36,1,312,8
2020-07-18,Colombia,NA,Caqueta,410521,113,2,425,10
2020-07-19,Colombia,NA,Caqueta,410521,93,1,518,11
2020-07-20,Colombia,NA,Caqueta,410521,45,1,563,12
2020-07-21,Colombia,NA,Caqueta,410521,13,0,576,12
2020-07-22,Colombia,NA,Caqueta,410521,17,2,593,14
2020-07-23,Colombia,NA,Caqueta,410521,17,1,610,15
2020-07-24,Colombia,NA,Caqueta,410521,122,2,732,17
2020-07-25,Colombia,NA,Caqueta,410521,71,3,803,20
2020-07-26,Colombia,NA,Caqueta,410521,108,2,911,22
2020-07-27,Colombia,NA,Caqueta,410521,94,2,1005,24
2020-07-28,Colombia,NA,Caqueta,410521,106,1,1111,25
2020-07-29,Colombia,NA,Caqueta,410521,98,6,1209,31
2020-07-30,Colombia,NA,Caqueta,410521,109,6,1318,37
2020-07-31,Colombia,NA,Caqueta,410521,181,7,1499,44
2020-08-01,Colombia,NA,Caqueta,410521,139,4,1638,48
2020-08-02,Colombia,NA,Caqueta,410521,145,1,1783,49
2020-08-03,Colombia,NA,Caqueta,410521,111,3,1894,52
2020-08-04,Colombia,NA,Caqueta,410521,203,3,2097,55
2020-08-05,Colombia,NA,Caqueta,410521,107,6,2204,61
2020-08-06,Colombia,NA,Caqueta,410521,133,5,2337,66
2020-08-07,Colombia,NA,Caqueta,410521,166,7,2503,73
2020-08-08,Colombia,NA,Caqueta,410521,227,7,2730,80
2020-08-09,Colombia,NA,Caqueta,410521,155,11,2885,91
2020-08-10,Colombia,NA,Caqueta,410521,145,9,3030,100
2020-08-11,Colombia,NA,Caqueta,410521,226,7,3256,107
2020-08-12,Colombia,NA,Caqueta,410521,198,6,3454,113
2020-08-13,Colombia,NA,Caqueta,410521,198,12,3652,125
2020-08-14,Colombia,NA,Caqueta,410521,215,13,3867,138
2020-08-15,Colombia,NA,Caqueta,410521,209,3,4076,141
2020-08-16,Colombia,NA,Caqueta,410521,258,7,4334,148
2020-08-17,Colombia,NA,Caqueta,410521,112,5,4446,153
2020-08-18,Colombia,NA,Caqueta,410521,84,14,4530,167
2020-08-19,Colombia,NA,Caqueta,410521,67,11,4597,178
2020-08-20,Colombia,NA,Caqueta,410521,149,8,4746,186
2020-08-21,Colombia,NA,Caqueta,410521,154,7,4900,193
2020-08-22,Colombia,NA,Caqueta,410521,77,5,4977,198
2020-08-23,Colombia,NA,Caqueta,410521,227,4,5204,202
2020-08-24,Colombia,NA,Caqueta,410521,73,2,5277,204
2020-08-25,Colombia,NA,Caqueta,410521,179,4,5456,208
2020-08-26,Colombia,NA,Caqueta,410521,180,0,5636,208
2020-08-27,Colombia,NA,Caqueta,410521,200,4,5836,212
2020-08-28,Colombia,NA,Caqueta,410521,145,7,5981,219
2020-08-29,Colombia,NA,Caqueta,410521,36,2,6017,221
2020-08-30,Colombia,NA,Caqueta,410521,78,3,6095,224
2020-08-31,Colombia,NA,Caqueta,410521,182,7,6277,231
2020-09-01,Colombia,NA,Caqueta,410521,71,4,6348,235
2020-09-02,Colombia,NA,Caqueta,410521,131,1,6479,236
2020-09-03,Colombia,NA,Caqueta,410521,176,5,6655,241
2020-09-04,Colombia,NA,Caqueta,410521,58,1,6713,242
2020-09-05,Colombia,NA,Caqueta,410521,219,6,6932,248
2020-09-06,Colombia,NA,Caqueta,410521,6,7,6938,255
2020-09-07,Colombia,NA,Caqueta,410521,138,6,7076,261
2020-09-08,Colombia,NA,Caqueta,410521,80,4,7156,265
2020-09-09,Colombia,NA,Caqueta,410521,73,1,7229,266
2020-09-10,Colombia,NA,Caqueta,410521,74,3,7303,269
2020-09-11,Colombia,NA,Caqueta,410521,17,5,7320,274
2020-09-12,Colombia,NA,Caqueta,410521,155,5,7475,279
2020-09-13,Colombia,NA,Caqueta,410521,2,3,7477,282
2020-09-14,Colombia,NA,Caqueta,410521,158,1,7635,283
2020-09-15,Colombia,NA,Caqueta,410521,53,5,7688,288
2020-09-16,Colombia,NA,Caqueta,410521,62,4,7750,292
2020-09-17,Colombia,NA,Caqueta,410521,138,0,7888,292
2020-09-18,Colombia,NA,Caqueta,410521,31,3,7919,295
2020-09-19,Colombia,NA,Caqueta,410521,23,0,7942,295
2020-09-20,Colombia,NA,Caqueta,410521,0,3,7942,298
2020-09-21,Colombia,NA,Caqueta,410521,15,1,7957,299
2020-09-22,Colombia,NA,Caqueta,410521,27,1,7984,300
2020-09-23,Colombia,NA,Caqueta,410521,49,1,8033,301
2020-04-24,Colombia,NA,Casanare,435195,1,0,11,0
2020-04-28,Colombia,NA,Casanare,435195,5,0,16,0
2020-04-29,Colombia,NA,Casanare,435195,2,0,18,0
2020-05-03,Colombia,NA,Casanare,435195,1,0,19,0
2020-05-04,Colombia,NA,Casanare,435195,1,0,20,0
2020-05-05,Colombia,NA,Casanare,435195,0,0,20,0
2020-05-06,Colombia,NA,Casanare,435195,0,0,20,0
2020-05-07,Colombia,NA,Casanare,435195,0,0,20,0
2020-05-10,Colombia,NA,Casanare,435195,1,0,21,0
2020-05-12,Colombia,NA,Casanare,435195,0,0,21,0
2020-05-13,Colombia,NA,Casanare,435195,4,0,25,0
2020-05-19,Colombia,NA,Casanare,435195,0,0,25,0
2020-05-20,Colombia,NA,Casanare,435195,1,0,26,0
2020-05-21,Colombia,NA,Casanare,435195,0,0,26,0
2020-05-23,Colombia,NA,Casanare,435195,0,0,26,0
2020-05-25,Colombia,NA,Casanare,435195,6,0,32,0
2020-05-26,Colombia,NA,Casanare,435195,0,0,32,0
2020-05-27,Colombia,NA,Casanare,435195,1,0,33,0
2020-05-28,Colombia,NA,Casanare,435195,0,0,33,0
2020-05-29,Colombia,NA,Casanare,435195,1,0,34,0
2020-05-31,Colombia,NA,Casanare,435195,1,0,35,0
2020-06-03,Colombia,NA,Casanare,435195,0,0,35,0
2020-06-04,Colombia,NA,Casanare,435195,1,0,36,0
2020-06-05,Colombia,NA,Casanare,435195,0,0,36,0
2020-06-06,Colombia,NA,Casanare,435195,0,0,36,0
2020-06-11,Colombia,NA,Casanare,435195,0,0,36,0
2020-06-12,Colombia,NA,Casanare,435195,1,0,37,0
2020-06-14,Colombia,NA,Casanare,435195,1,0,38,0
2020-06-17,Colombia,NA,Casanare,435195,2,0,40,0
2020-06-18,Colombia,NA,Casanare,435195,2,0,42,0
2020-06-19,Colombia,NA,Casanare,435195,9,0,51,0
2020-06-20,Colombia,NA,Casanare,435195,1,0,52,0
2020-06-21,Colombia,NA,Casanare,435195,3,0,55,0
2020-06-22,Colombia,NA,Casanare,435195,2,0,57,0
2020-06-23,Colombia,NA,Casanare,435195,1,0,58,0
2020-06-24,Colombia,NA,Casanare,435195,3,0,61,0
2020-06-25,Colombia,NA,Casanare,435195,3,0,64,0
2020-06-26,Colombia,NA,Casanare,435195,1,0,65,0
2020-06-27,Colombia,NA,Casanare,435195,1,0,66,0
2020-06-29,Colombia,NA,Casanare,435195,0,0,66,0
2020-06-30,Colombia,NA,Casanare,435195,0,0,66,0
2020-07-01,Colombia,NA,Casanare,435195,2,0,68,0
2020-07-02,Colombia,NA,Casanare,435195,2,0,70,0
2020-07-03,Colombia,NA,Casanare,435195,15,0,85,0
2020-07-04,Colombia,NA,Casanare,435195,0,0,85,0
2020-07-05,Colombia,NA,Casanare,435195,2,0,87,0
2020-07-06,Colombia,NA,Casanare,435195,2,0,89,0
2020-07-08,Colombia,NA,Casanare,435195,2,1,91,1
2020-07-09,Colombia,NA,Casanare,435195,7,0,98,1
2020-07-10,Colombia,NA,Casanare,435195,15,0,113,1
2020-07-11,Colombia,NA,Casanare,435195,5,0,118,1
2020-07-12,Colombia,NA,Casanare,435195,2,1,120,2
2020-07-13,Colombia,NA,Casanare,435195,13,0,133,2
2020-07-14,Colombia,NA,Casanare,435195,10,0,143,2
2020-07-15,Colombia,NA,Casanare,435195,4,0,147,2
2020-07-16,Colombia,NA,Casanare,435195,3,0,150,2
2020-07-17,Colombia,NA,Casanare,435195,3,0,153,2
2020-07-18,Colombia,NA,Casanare,435195,9,0,162,2
2020-07-19,Colombia,NA,Casanare,435195,23,1,185,3
2020-07-20,Colombia,NA,Casanare,435195,6,0,191,3
2020-07-21,Colombia,NA,Casanare,435195,7,1,198,4
2020-07-22,Colombia,NA,Casanare,435195,10,1,208,5
2020-07-23,Colombia,NA,Casanare,435195,6,0,214,5
2020-07-24,Colombia,NA,Casanare,435195,12,1,226,6
2020-07-25,Colombia,NA,Casanare,435195,11,0,237,6
2020-07-26,Colombia,NA,Casanare,435195,27,1,264,7
2020-07-27,Colombia,NA,Casanare,435195,17,0,281,7
2020-07-28,Colombia,NA,Casanare,435195,10,0,291,7
2020-07-29,Colombia,NA,Casanare,435195,25,2,316,9
2020-07-30,Colombia,NA,Casanare,435195,9,0,325,9
2020-07-31,Colombia,NA,Casanare,435195,8,1,333,10
2020-08-01,Colombia,NA,Casanare,435195,19,0,352,10
2020-08-02,Colombia,NA,Casanare,435195,14,2,366,12
2020-08-03,Colombia,NA,Casanare,435195,12,0,378,12
2020-08-04,Colombia,NA,Casanare,435195,32,0,410,12
2020-08-05,Colombia,NA,Casanare,435195,13,0,423,12
2020-08-06,Colombia,NA,Casanare,435195,15,2,438,14
2020-08-07,Colombia,NA,Casanare,435195,17,0,455,14
2020-08-08,Colombia,NA,Casanare,435195,15,0,470,14
2020-08-09,Colombia,NA,Casanare,435195,49,1,519,15
2020-08-10,Colombia,NA,Casanare,435195,13,0,532,15
2020-08-11,Colombia,NA,Casanare,435195,15,1,547,16
2020-08-12,Colombia,NA,Casanare,435195,47,1,594,17
2020-08-13,Colombia,NA,Casanare,435195,22,0,616,17
2020-08-14,Colombia,NA,Casanare,435195,28,0,644,17
2020-08-15,Colombia,NA,Casanare,435195,29,3,673,20
2020-08-16,Colombia,NA,Casanare,435195,22,1,695,21
2020-08-17,Colombia,NA,Casanare,435195,15,1,710,22
2020-08-18,Colombia,NA,Casanare,435195,51,0,761,22
2020-08-19,Colombia,NA,Casanare,435195,17,0,778,22
2020-08-20,Colombia,NA,Casanare,435195,31,2,809,24
2020-08-21,Colombia,NA,Casanare,435195,38,0,847,24
2020-08-22,Colombia,NA,Casanare,435195,26,0,873,24
2020-08-23,Colombia,NA,Casanare,435195,18,1,891,25
2020-08-24,Colombia,NA,Casanare,435195,23,0,914,25
2020-08-25,Colombia,NA,Casanare,435195,28,1,942,26
2020-08-26,Colombia,NA,Casanare,435195,18,0,960,26
2020-08-27,Colombia,NA,Casanare,435195,30,1,990,27
2020-08-28,Colombia,NA,Casanare,435195,27,2,1017,29
2020-08-29,Colombia,NA,Casanare,435195,19,0,1036,29
2020-08-30,Colombia,NA,Casanare,435195,28,0,1064,29
2020-08-31,Colombia,NA,Casanare,435195,25,0,1089,29
2020-09-01,Colombia,NA,Casanare,435195,42,0,1131,29
2020-09-02,Colombia,NA,Casanare,435195,28,2,1159,31
2020-09-03,Colombia,NA,Casanare,435195,18,1,1177,32
2020-09-04,Colombia,NA,Casanare,435195,68,1,1245,33
2020-09-05,Colombia,NA,Casanare,435195,29,1,1274,34
2020-09-06,Colombia,NA,Casanare,435195,21,2,1295,36
2020-09-07,Colombia,NA,Casanare,435195,32,0,1327,36
2020-09-08,Colombia,NA,Casanare,435195,40,0,1367,36
2020-09-09,Colombia,NA,Casanare,435195,46,0,1413,36
2020-09-10,Colombia,NA,Casanare,435195,65,0,1478,36
2020-09-11,Colombia,NA,Casanare,435195,46,1,1524,37
2020-09-12,Colombia,NA,Casanare,435195,32,1,1556,38
2020-09-13,Colombia,NA,Casanare,435195,18,0,1574,38
2020-09-14,Colombia,NA,Casanare,435195,30,2,1604,40
2020-09-15,Colombia,NA,Casanare,435195,38,0,1642,40
2020-09-16,Colombia,NA,Casanare,435195,79,1,1721,41
2020-09-17,Colombia,NA,Casanare,435195,102,3,1823,44
2020-09-18,Colombia,NA,Casanare,435195,12,0,1835,44
2020-09-19,Colombia,NA,Casanare,435195,43,0,1878,44
2020-09-20,Colombia,NA,Casanare,435195,50,1,1928,45
2020-09-21,Colombia,NA,Casanare,435195,25,0,1953,45
2020-09-22,Colombia,NA,Casanare,435195,28,1,1981,46
2020-09-23,Colombia,NA,Casanare,435195,31,0,2012,46
2020-04-01,Colombia,NA,Cauca,1491937,3,0,12,2
2020-04-06,Colombia,NA,Cauca,1491937,1,0,13,2
2020-04-07,Colombia,NA,Cauca,1491937,1,0,14,2
2020-04-08,Colombia,NA,Cauca,1491937,1,0,15,2
2020-04-09,Colombia,NA,Cauca,1491937,1,0,16,2
2020-04-10,Colombia,NA,Cauca,1491937,3,1,19,3
2020-04-11,Colombia,NA,Cauca,1491937,1,0,20,3
2020-04-14,Colombia,NA,Cauca,1491937,1,0,21,3
2020-04-16,Colombia,NA,Cauca,1491937,2,0,23,3
2020-04-17,Colombia,NA,Cauca,1491937,1,0,24,3
2020-04-19,Colombia,NA,Cauca,1491937,0,0,24,3
2020-04-22,Colombia,NA,Cauca,1491937,1,0,25,3
2020-04-23,Colombia,NA,Cauca,1491937,1,0,26,3
2020-04-24,Colombia,NA,Cauca,1491937,0,1,26,4
2020-04-25,Colombia,NA,Cauca,1491937,1,0,27,4
2020-04-26,Colombia,NA,Cauca,1491937,1,0,28,4
2020-04-27,Colombia,NA,Cauca,1491937,4,0,32,4
2020-04-28,Colombia,NA,Cauca,1491937,3,0,35,4
2020-04-29,Colombia,NA,Cauca,1491937,1,0,36,4
2020-04-30,Colombia,NA,Cauca,1491937,0,0,36,4
2020-05-03,Colombia,NA,Cauca,1491937,0,0,36,4
2020-05-04,Colombia,NA,Cauca,1491937,1,0,37,4
2020-05-05,Colombia,NA,Cauca,1491937,4,0,41,4
2020-05-06,Colombia,NA,Cauca,1491937,0,0,41,4
2020-05-07,Colombia,NA,Cauca,1491937,0,0,41,4
2020-05-08,Colombia,NA,Cauca,1491937,1,0,42,4
2020-05-09,Colombia,NA,Cauca,1491937,0,0,42,4
2020-05-10,Colombia,NA,Cauca,1491937,5,0,47,4
2020-05-11,Colombia,NA,Cauca,1491937,4,0,51,4
2020-05-12,Colombia,NA,Cauca,1491937,2,0,53,4
2020-05-13,Colombia,NA,Cauca,1491937,1,0,54,4
2020-05-15,Colombia,NA,Cauca,1491937,7,0,61,4
2020-05-16,Colombia,NA,Cauca,1491937,0,0,61,4
2020-05-17,Colombia,NA,Cauca,1491937,3,0,64,4
2020-05-18,Colombia,NA,Cauca,1491937,0,0,64,4
2020-05-19,Colombia,NA,Cauca,1491937,0,0,64,4
2020-05-20,Colombia,NA,Cauca,1491937,2,0,66,4
2020-05-21,Colombia,NA,Cauca,1491937,1,0,67,4
2020-05-22,Colombia,NA,Cauca,1491937,5,0,72,4
2020-05-23,Colombia,NA,Cauca,1491937,2,0,74,4
2020-05-24,Colombia,NA,Cauca,1491937,1,0,75,4
2020-05-25,Colombia,NA,Cauca,1491937,0,0,75,4
2020-05-26,Colombia,NA,Cauca,1491937,3,0,78,4
2020-05-27,Colombia,NA,Cauca,1491937,3,0,81,4
2020-05-28,Colombia,NA,Cauca,1491937,10,0,91,4
2020-05-29,Colombia,NA,Cauca,1491937,1,0,92,4
2020-05-30,Colombia,NA,Cauca,1491937,5,0,97,4
2020-05-31,Colombia,NA,Cauca,1491937,6,0,103,4
2020-06-01,Colombia,NA,Cauca,1491937,1,0,104,4
2020-06-02,Colombia,NA,Cauca,1491937,9,0,113,4
2020-06-03,Colombia,NA,Cauca,1491937,3,1,116,5
2020-06-04,Colombia,NA,Cauca,1491937,9,0,125,5
2020-06-05,Colombia,NA,Cauca,1491937,10,1,135,6
2020-06-06,Colombia,NA,Cauca,1491937,8,0,143,6
2020-06-07,Colombia,NA,Cauca,1491937,10,0,153,6
2020-06-08,Colombia,NA,Cauca,1491937,3,1,156,7
2020-06-09,Colombia,NA,Cauca,1491937,2,0,158,7
2020-06-10,Colombia,NA,Cauca,1491937,4,1,162,8
2020-06-11,Colombia,NA,Cauca,1491937,5,0,167,8
2020-06-12,Colombia,NA,Cauca,1491937,3,1,170,9
2020-06-13,Colombia,NA,Cauca,1491937,16,0,186,9
2020-06-14,Colombia,NA,Cauca,1491937,1,1,187,10
2020-06-15,Colombia,NA,Cauca,1491937,3,1,190,11
2020-06-16,Colombia,NA,Cauca,1491937,7,0,197,11
2020-06-17,Colombia,NA,Cauca,1491937,11,1,208,12
2020-06-18,Colombia,NA,Cauca,1491937,6,0,214,12
2020-06-19,Colombia,NA,Cauca,1491937,17,1,231,13
2020-06-20,Colombia,NA,Cauca,1491937,13,0,244,13
2020-06-21,Colombia,NA,Cauca,1491937,7,0,251,13
2020-06-22,Colombia,NA,Cauca,1491937,6,2,257,15
2020-06-23,Colombia,NA,Cauca,1491937,13,2,270,17
2020-06-24,Colombia,NA,Cauca,1491937,20,0,290,17
2020-06-25,Colombia,NA,Cauca,1491937,17,0,307,17
2020-06-26,Colombia,NA,Cauca,1491937,18,0,325,17
2020-06-27,Colombia,NA,Cauca,1491937,12,0,337,17
2020-06-28,Colombia,NA,Cauca,1491937,13,1,350,18
2020-06-29,Colombia,NA,Cauca,1491937,19,1,369,19
2020-06-30,Colombia,NA,Cauca,1491937,8,1,377,20
2020-07-01,Colombia,NA,Cauca,1491937,33,1,410,21
2020-07-02,Colombia,NA,Cauca,1491937,68,0,478,21
2020-07-03,Colombia,NA,Cauca,1491937,14,0,492,21
2020-07-04,Colombia,NA,Cauca,1491937,32,1,524,22
2020-07-05,Colombia,NA,Cauca,1491937,31,0,555,22
2020-07-06,Colombia,NA,Cauca,1491937,18,2,573,24
2020-07-07,Colombia,NA,Cauca,1491937,88,3,661,27
2020-07-08,Colombia,NA,Cauca,1491937,36,0,697,27
2020-07-09,Colombia,NA,Cauca,1491937,38,1,735,28
2020-07-10,Colombia,NA,Cauca,1491937,74,3,809,31
2020-07-11,Colombia,NA,Cauca,1491937,43,1,852,32
2020-07-12,Colombia,NA,Cauca,1491937,42,1,894,33
2020-07-13,Colombia,NA,Cauca,1491937,44,3,938,36
2020-07-14,Colombia,NA,Cauca,1491937,51,1,989,37
2020-07-15,Colombia,NA,Cauca,1491937,24,1,1013,38
2020-07-16,Colombia,NA,Cauca,1491937,79,1,1092,39
2020-07-17,Colombia,NA,Cauca,1491937,22,0,1114,39
2020-07-18,Colombia,NA,Cauca,1491937,55,4,1169,43
2020-07-19,Colombia,NA,Cauca,1491937,16,2,1185,45
2020-07-20,Colombia,NA,Cauca,1491937,30,3,1215,48
2020-07-21,Colombia,NA,Cauca,1491937,125,4,1340,52
2020-07-22,Colombia,NA,Cauca,1491937,111,5,1451,57
2020-07-23,Colombia,NA,Cauca,1491937,27,2,1478,59
2020-07-24,Colombia,NA,Cauca,1491937,110,1,1588,60
2020-07-25,Colombia,NA,Cauca,1491937,66,3,1654,63
2020-07-26,Colombia,NA,Cauca,1491937,45,6,1699,69
2020-07-27,Colombia,NA,Cauca,1491937,100,1,1799,70
2020-07-28,Colombia,NA,Cauca,1491937,67,3,1866,73
2020-07-29,Colombia,NA,Cauca,1491937,83,2,1949,75
2020-07-30,Colombia,NA,Cauca,1491937,77,4,2026,79
2020-07-31,Colombia,NA,Cauca,1491937,90,5,2116,84
2020-08-01,Colombia,NA,Cauca,1491937,63,2,2179,86
2020-08-02,Colombia,NA,Cauca,1491937,35,2,2214,88
2020-08-03,Colombia,NA,Cauca,1491937,42,7,2256,95
2020-08-04,Colombia,NA,Cauca,1491937,189,3,2445,98
2020-08-05,Colombia,NA,Cauca,1491937,48,5,2493,103
2020-08-06,Colombia,NA,Cauca,1491937,70,5,2563,108
2020-08-07,Colombia,NA,Cauca,1491937,68,4,2631,112
2020-08-08,Colombia,NA,Cauca,1491937,98,4,2729,116
2020-08-09,Colombia,NA,Cauca,1491937,7,5,2736,121
2020-08-10,Colombia,NA,Cauca,1491937,88,2,2824,123
2020-08-11,Colombia,NA,Cauca,1491937,55,4,2879,127
2020-08-12,Colombia,NA,Cauca,1491937,216,3,3095,130
2020-08-13,Colombia,NA,Cauca,1491937,120,5,3215,135
2020-08-14,Colombia,NA,Cauca,1491937,99,3,3314,138
2020-08-15,Colombia,NA,Cauca,1491937,87,2,3401,140
2020-08-16,Colombia,NA,Cauca,1491937,12,3,3413,143
2020-08-17,Colombia,NA,Cauca,1491937,84,7,3497,150
2020-08-18,Colombia,NA,Cauca,1491937,90,3,3587,153
2020-08-19,Colombia,NA,Cauca,1491937,159,3,3746,156
2020-08-20,Colombia,NA,Cauca,1491937,200,3,3946,159
2020-08-21,Colombia,NA,Cauca,1491937,154,4,4100,163
2020-08-22,Colombia,NA,Cauca,1491937,209,5,4309,168
2020-08-23,Colombia,NA,Cauca,1491937,48,1,4357,169
2020-08-24,Colombia,NA,Cauca,1491937,105,3,4462,172
2020-08-25,Colombia,NA,Cauca,1491937,195,3,4657,175
2020-08-26,Colombia,NA,Cauca,1491937,58,2,4715,177
2020-08-27,Colombia,NA,Cauca,1491937,68,6,4783,183
2020-08-28,Colombia,NA,Cauca,1491937,330,2,5113,185
2020-08-29,Colombia,NA,Cauca,1491937,185,4,5298,189
2020-08-30,Colombia,NA,Cauca,1491937,26,1,5324,190
2020-08-31,Colombia,NA,Cauca,1491937,100,3,5424,193
2020-09-01,Colombia,NA,Cauca,1491937,285,8,5709,201
2020-09-02,Colombia,NA,Cauca,1491937,253,5,5962,206
2020-09-03,Colombia,NA,Cauca,1491937,49,2,6011,208
2020-09-04,Colombia,NA,Cauca,1491937,234,2,6245,210
2020-09-05,Colombia,NA,Cauca,1491937,213,4,6458,214
2020-09-06,Colombia,NA,Cauca,1491937,23,5,6481,219
2020-09-07,Colombia,NA,Cauca,1491937,253,4,6734,223
2020-09-08,Colombia,NA,Cauca,1491937,208,3,6942,226
2020-09-09,Colombia,NA,Cauca,1491937,101,4,7043,230
2020-09-10,Colombia,NA,Cauca,1491937,149,4,7192,234
2020-09-11,Colombia,NA,Cauca,1491937,133,3,7325,237
2020-09-12,Colombia,NA,Cauca,1491937,62,3,7387,240
2020-09-13,Colombia,NA,Cauca,1491937,26,5,7413,245
2020-09-14,Colombia,NA,Cauca,1491937,109,3,7522,248
2020-09-15,Colombia,NA,Cauca,1491937,289,2,7811,250
2020-09-16,Colombia,NA,Cauca,1491937,132,2,7943,252
2020-09-17,Colombia,NA,Cauca,1491937,136,1,8079,253
2020-09-18,Colombia,NA,Cauca,1491937,195,3,8274,256
2020-09-19,Colombia,NA,Cauca,1491937,91,4,8365,260
2020-09-20,Colombia,NA,Cauca,1491937,31,1,8396,261
2020-09-21,Colombia,NA,Cauca,1491937,224,4,8620,265
2020-09-22,Colombia,NA,Cauca,1491937,62,4,8682,269
2020-09-23,Colombia,NA,Cauca,1491937,96,2,8778,271
2020-03-31,Colombia,NA,Cesar,1295387,7,0,11,0
2020-04-01,Colombia,NA,Cesar,1295387,5,0,16,0
2020-04-03,Colombia,NA,Cesar,1295387,0,0,16,0
2020-04-04,Colombia,NA,Cesar,1295387,0,0,16,0
2020-04-05,Colombia,NA,Cesar,1295387,0,0,16,0
2020-04-07,Colombia,NA,Cesar,1295387,0,0,16,0
2020-04-08,Colombia,NA,Cesar,1295387,1,0,17,0
2020-04-09,Colombia,NA,Cesar,1295387,1,0,18,0
2020-04-10,Colombia,NA,Cesar,1295387,2,0,20,0
2020-04-11,Colombia,NA,Cesar,1295387,12,0,32,0
2020-04-12,Colombia,NA,Cesar,1295387,0,0,32,0
2020-04-13,Colombia,NA,Cesar,1295387,0,0,32,0
2020-04-14,Colombia,NA,Cesar,1295387,0,0,32,0
2020-04-15,Colombia,NA,Cesar,1295387,0,0,32,0
2020-04-16,Colombia,NA,Cesar,1295387,1,1,33,1
2020-04-17,Colombia,NA,Cesar,1295387,0,0,33,1
2020-04-19,Colombia,NA,Cesar,1295387,0,0,33,1
2020-04-20,Colombia,NA,Cesar,1295387,2,0,35,1
2020-04-21,Colombia,NA,Cesar,1295387,0,1,35,2
2020-04-22,Colombia,NA,Cesar,1295387,0,2,35,4
2020-04-24,Colombia,NA,Cesar,1295387,7,2,42,6
2020-04-25,Colombia,NA,Cesar,1295387,11,0,53,6
2020-04-27,Colombia,NA,Cesar,1295387,0,1,53,7
2020-04-28,Colombia,NA,Cesar,1295387,2,0,55,7
2020-04-29,Colombia,NA,Cesar,1295387,0,0,55,7
2020-05-02,Colombia,NA,Cesar,1295387,4,0,59,7
2020-05-03,Colombia,NA,Cesar,1295387,3,2,62,9
2020-05-04,Colombia,NA,Cesar,1295387,0,0,62,9
2020-05-05,Colombia,NA,Cesar,1295387,8,1,70,10
2020-05-06,Colombia,NA,Cesar,1295387,0,0,70,10
2020-05-07,Colombia,NA,Cesar,1295387,0,1,70,11
2020-05-08,Colombia,NA,Cesar,1295387,0,0,70,11
2020-05-09,Colombia,NA,Cesar,1295387,1,0,71,11
2020-05-10,Colombia,NA,Cesar,1295387,1,0,72,11
2020-05-13,Colombia,NA,Cesar,1295387,0,0,72,11
2020-05-14,Colombia,NA,Cesar,1295387,0,1,72,12
2020-05-15,Colombia,NA,Cesar,1295387,0,0,72,12
2020-05-16,Colombia,NA,Cesar,1295387,3,0,75,12
2020-05-17,Colombia,NA,Cesar,1295387,1,0,76,12
2020-05-18,Colombia,NA,Cesar,1295387,1,0,77,12
2020-05-19,Colombia,NA,Cesar,1295387,1,0,78,12
2020-05-20,Colombia,NA,Cesar,1295387,1,0,79,12
2020-05-21,Colombia,NA,Cesar,1295387,1,0,80,12
2020-05-22,Colombia,NA,Cesar,1295387,0,0,80,12
2020-05-23,Colombia,NA,Cesar,1295387,11,0,91,12
2020-05-24,Colombia,NA,Cesar,1295387,4,0,95,12
2020-05-25,Colombia,NA,Cesar,1295387,4,0,99,12
2020-05-26,Colombia,NA,Cesar,1295387,6,0,105,12
2020-05-27,Colombia,NA,Cesar,1295387,15,0,120,12
2020-05-28,Colombia,NA,Cesar,1295387,13,0,133,12
2020-05-29,Colombia,NA,Cesar,1295387,34,0,167,12
2020-05-30,Colombia,NA,Cesar,1295387,44,0,211,12
2020-05-31,Colombia,NA,Cesar,1295387,46,0,257,12
2020-06-01,Colombia,NA,Cesar,1295387,34,0,291,12
2020-06-02,Colombia,NA,Cesar,1295387,36,0,327,12
2020-06-03,Colombia,NA,Cesar,1295387,24,1,351,13
2020-06-04,Colombia,NA,Cesar,1295387,48,1,399,14
2020-06-05,Colombia,NA,Cesar,1295387,20,0,419,14
2020-06-06,Colombia,NA,Cesar,1295387,11,0,430,14
2020-06-07,Colombia,NA,Cesar,1295387,3,1,433,15
2020-06-08,Colombia,NA,Cesar,1295387,21,3,454,18
2020-06-09,Colombia,NA,Cesar,1295387,20,1,474,19
2020-06-10,Colombia,NA,Cesar,1295387,26,1,500,20
2020-06-11,Colombia,NA,Cesar,1295387,3,0,503,20
2020-06-12,Colombia,NA,Cesar,1295387,5,1,508,21
2020-06-13,Colombia,NA,Cesar,1295387,31,1,539,22
2020-06-14,Colombia,NA,Cesar,1295387,7,1,546,23
2020-06-15,Colombia,NA,Cesar,1295387,11,0,557,23
2020-06-16,Colombia,NA,Cesar,1295387,7,0,564,23
2020-06-17,Colombia,NA,Cesar,1295387,30,0,594,23
2020-06-18,Colombia,NA,Cesar,1295387,31,0,625,23
2020-06-19,Colombia,NA,Cesar,1295387,9,2,634,25
2020-06-20,Colombia,NA,Cesar,1295387,79,1,713,26
2020-06-21,Colombia,NA,Cesar,1295387,8,0,721,26
2020-06-22,Colombia,NA,Cesar,1295387,37,0,758,26
2020-06-23,Colombia,NA,Cesar,1295387,22,0,780,26
2020-06-24,Colombia,NA,Cesar,1295387,36,1,816,27
2020-06-25,Colombia,NA,Cesar,1295387,21,2,837,29
2020-06-26,Colombia,NA,Cesar,1295387,59,1,896,30
2020-06-27,Colombia,NA,Cesar,1295387,50,0,946,30
2020-06-28,Colombia,NA,Cesar,1295387,32,3,978,33
2020-06-29,Colombia,NA,Cesar,1295387,23,2,1001,35
2020-06-30,Colombia,NA,Cesar,1295387,13,1,1014,36
2020-07-01,Colombia,NA,Cesar,1295387,34,1,1048,37
2020-07-02,Colombia,NA,Cesar,1295387,8,0,1056,37
2020-07-03,Colombia,NA,Cesar,1295387,96,0,1152,37
2020-07-04,Colombia,NA,Cesar,1295387,86,0,1238,37
2020-07-05,Colombia,NA,Cesar,1295387,38,2,1276,39
2020-07-06,Colombia,NA,Cesar,1295387,35,0,1311,39
2020-07-07,Colombia,NA,Cesar,1295387,19,1,1330,40
2020-07-08,Colombia,NA,Cesar,1295387,16,0,1346,40
2020-07-09,Colombia,NA,Cesar,1295387,34,0,1380,40
2020-07-10,Colombia,NA,Cesar,1295387,50,1,1430,41
2020-07-11,Colombia,NA,Cesar,1295387,36,0,1466,41
2020-07-12,Colombia,NA,Cesar,1295387,70,1,1536,42
2020-07-13,Colombia,NA,Cesar,1295387,56,2,1592,44
2020-07-14,Colombia,NA,Cesar,1295387,95,1,1687,45
2020-07-15,Colombia,NA,Cesar,1295387,40,1,1727,46
2020-07-16,Colombia,NA,Cesar,1295387,84,2,1811,48
2020-07-17,Colombia,NA,Cesar,1295387,20,2,1831,50
2020-07-18,Colombia,NA,Cesar,1295387,123,2,1954,52
2020-07-19,Colombia,NA,Cesar,1295387,105,3,2059,55
2020-07-20,Colombia,NA,Cesar,1295387,1,0,2060,55
2020-07-21,Colombia,NA,Cesar,1295387,89,2,2149,57
2020-07-22,Colombia,NA,Cesar,1295387,145,2,2294,59
2020-07-23,Colombia,NA,Cesar,1295387,91,3,2385,62
2020-07-24,Colombia,NA,Cesar,1295387,108,3,2493,65
2020-07-25,Colombia,NA,Cesar,1295387,130,3,2623,68
2020-07-26,Colombia,NA,Cesar,1295387,2,1,2625,69
2020-07-27,Colombia,NA,Cesar,1295387,206,4,2831,73
2020-07-28,Colombia,NA,Cesar,1295387,68,4,2899,77
2020-07-29,Colombia,NA,Cesar,1295387,137,0,3036,77
2020-07-30,Colombia,NA,Cesar,1295387,82,3,3118,80
2020-07-31,Colombia,NA,Cesar,1295387,228,4,3346,84
2020-08-01,Colombia,NA,Cesar,1295387,157,3,3503,87
2020-08-02,Colombia,NA,Cesar,1295387,4,6,3507,93
2020-08-03,Colombia,NA,Cesar,1295387,202,6,3709,99
2020-08-04,Colombia,NA,Cesar,1295387,105,9,3814,108
2020-08-05,Colombia,NA,Cesar,1295387,198,2,4012,110
2020-08-06,Colombia,NA,Cesar,1295387,306,2,4318,112
2020-08-07,Colombia,NA,Cesar,1295387,91,5,4409,117
2020-08-08,Colombia,NA,Cesar,1295387,22,4,4431,121
2020-08-09,Colombia,NA,Cesar,1295387,39,7,4470,128
2020-08-10,Colombia,NA,Cesar,1295387,335,5,4805,133
2020-08-11,Colombia,NA,Cesar,1295387,138,4,4943,137
2020-08-12,Colombia,NA,Cesar,1295387,380,8,5323,145
2020-08-13,Colombia,NA,Cesar,1295387,156,13,5479,158
2020-08-14,Colombia,NA,Cesar,1295387,190,11,5669,169
2020-08-15,Colombia,NA,Cesar,1295387,297,8,5966,177
2020-08-16,Colombia,NA,Cesar,1295387,63,7,6029,184
2020-08-17,Colombia,NA,Cesar,1295387,39,15,6068,199
2020-08-18,Colombia,NA,Cesar,1295387,438,11,6506,210
2020-08-19,Colombia,NA,Cesar,1295387,311,10,6817,220
2020-08-20,Colombia,NA,Cesar,1295387,543,14,7360,234
2020-08-21,Colombia,NA,Cesar,1295387,500,9,7860,243
2020-08-22,Colombia,NA,Cesar,1295387,253,9,8113,252
2020-08-23,Colombia,NA,Cesar,1295387,83,11,8196,263
2020-08-24,Colombia,NA,Cesar,1295387,260,18,8456,281
2020-08-25,Colombia,NA,Cesar,1295387,519,10,8975,291
2020-08-26,Colombia,NA,Cesar,1295387,582,7,9557,298
2020-08-27,Colombia,NA,Cesar,1295387,439,11,9996,309
2020-08-28,Colombia,NA,Cesar,1295387,336,10,10332,319
2020-08-29,Colombia,NA,Cesar,1295387,352,12,10684,331
2020-08-30,Colombia,NA,Cesar,1295387,68,6,10752,337
2020-08-31,Colombia,NA,Cesar,1295387,479,14,11231,351
2020-09-01,Colombia,NA,Cesar,1295387,510,15,11741,366
2020-09-02,Colombia,NA,Cesar,1295387,325,12,12066,378
2020-09-03,Colombia,NA,Cesar,1295387,212,9,12278,387
2020-09-04,Colombia,NA,Cesar,1295387,524,8,12802,395
2020-09-05,Colombia,NA,Cesar,1295387,287,16,13089,411
2020-09-06,Colombia,NA,Cesar,1295387,51,10,13140,421
2020-09-07,Colombia,NA,Cesar,1295387,484,4,13624,425
2020-09-08,Colombia,NA,Cesar,1295387,310,11,13934,436
2020-09-09,Colombia,NA,Cesar,1295387,668,12,14602,448
2020-09-10,Colombia,NA,Cesar,1295387,555,16,15157,464
2020-09-11,Colombia,NA,Cesar,1295387,286,8,15443,472
2020-09-12,Colombia,NA,Cesar,1295387,204,14,15647,486
2020-09-13,Colombia,NA,Cesar,1295387,97,6,15744,492
2020-09-14,Colombia,NA,Cesar,1295387,384,4,16128,496
2020-09-15,Colombia,NA,Cesar,1295387,252,7,16380,503
2020-09-16,Colombia,NA,Cesar,1295387,259,13,16639,516
2020-09-17,Colombia,NA,Cesar,1295387,177,15,16816,531
2020-09-18,Colombia,NA,Cesar,1295387,343,8,17159,539
2020-09-19,Colombia,NA,Cesar,1295387,182,8,17341,547
2020-09-20,Colombia,NA,Cesar,1295387,43,7,17384,554
2020-09-21,Colombia,NA,Cesar,1295387,121,7,17505,561
2020-09-22,Colombia,NA,Cesar,1295387,296,5,17801,566
2020-09-23,Colombia,NA,Cesar,1295387,232,5,18033,571
2020-04-26,Colombia,NA,Choco,544764,1,0,11,1
2020-04-28,Colombia,NA,Choco,544764,1,0,12,1
2020-04-29,Colombia,NA,Choco,544764,1,0,13,1
2020-04-30,Colombia,NA,Choco,544764,0,1,13,2
2020-05-01,Colombia,NA,Choco,544764,1,0,14,2
2020-05-02,Colombia,NA,Choco,544764,2,1,16,3
2020-05-04,Colombia,NA,Choco,544764,8,0,24,3
2020-05-05,Colombia,NA,Choco,544764,1,0,25,3
2020-05-06,Colombia,NA,Choco,544764,3,0,28,3
2020-05-10,Colombia,NA,Choco,544764,1,0,29,3
2020-05-11,Colombia,NA,Choco,544764,0,0,29,3
2020-05-12,Colombia,NA,Choco,544764,8,0,37,3
2020-05-13,Colombia,NA,Choco,544764,5,0,42,3
2020-05-15,Colombia,NA,Choco,544764,2,0,44,3
2020-05-16,Colombia,NA,Choco,544764,0,1,44,4
2020-05-17,Colombia,NA,Choco,544764,1,1,45,5
2020-05-18,Colombia,NA,Choco,544764,0,0,45,5
2020-05-19,Colombia,NA,Choco,544764,30,0,75,5
2020-05-20,Colombia,NA,Choco,544764,7,0,82,5
2020-05-21,Colombia,NA,Choco,544764,0,0,82,5
2020-05-22,Colombia,NA,Choco,544764,2,0,84,5
2020-05-23,Colombia,NA,Choco,544764,2,0,86,5
2020-05-24,Colombia,NA,Choco,544764,9,0,95,5
2020-05-25,Colombia,NA,Choco,544764,16,1,111,6
2020-05-26,Colombia,NA,Choco,544764,12,1,123,7
2020-05-27,Colombia,NA,Choco,544764,33,0,156,7
2020-05-28,Colombia,NA,Choco,544764,42,1,198,8
2020-05-29,Colombia,NA,Choco,544764,0,5,198,13
2020-05-30,Colombia,NA,Choco,544764,23,0,221,13
2020-05-31,Colombia,NA,Choco,544764,6,1,227,14
2020-06-01,Colombia,NA,Choco,544764,1,1,228,15
2020-06-02,Colombia,NA,Choco,544764,65,1,293,16
2020-06-03,Colombia,NA,Choco,544764,0,3,293,19
2020-06-04,Colombia,NA,Choco,544764,41,1,334,20
2020-06-05,Colombia,NA,Choco,544764,57,3,391,23
2020-06-06,Colombia,NA,Choco,544764,1,3,392,26
2020-06-07,Colombia,NA,Choco,544764,14,3,406,29
2020-06-08,Colombia,NA,Choco,544764,58,2,464,31
2020-06-09,Colombia,NA,Choco,544764,17,2,481,33
2020-06-10,Colombia,NA,Choco,544764,68,2,549,35
2020-06-11,Colombia,NA,Choco,544764,20,0,569,35
2020-06-12,Colombia,NA,Choco,544764,4,0,573,35
2020-06-13,Colombia,NA,Choco,544764,98,4,671,39
2020-06-14,Colombia,NA,Choco,544764,16,0,687,39
2020-06-15,Colombia,NA,Choco,544764,20,4,707,43
2020-06-16,Colombia,NA,Choco,544764,107,2,814,45
2020-06-17,Colombia,NA,Choco,544764,19,4,833,49
2020-06-18,Colombia,NA,Choco,544764,80,3,913,52
2020-06-19,Colombia,NA,Choco,544764,32,5,945,57
2020-06-20,Colombia,NA,Choco,544764,25,2,970,59
2020-06-21,Colombia,NA,Choco,544764,12,4,982,63
2020-06-22,Colombia,NA,Choco,544764,34,1,1016,64
2020-06-23,Colombia,NA,Choco,544764,23,3,1039,67
2020-06-24,Colombia,NA,Choco,544764,106,4,1145,71
2020-06-25,Colombia,NA,Choco,544764,57,0,1202,71
2020-06-26,Colombia,NA,Choco,544764,86,1,1288,72
2020-06-27,Colombia,NA,Choco,544764,71,2,1359,74
2020-06-28,Colombia,NA,Choco,544764,31,3,1390,77
2020-06-29,Colombia,NA,Choco,544764,60,3,1450,80
2020-06-30,Colombia,NA,Choco,544764,52,2,1502,82
2020-07-01,Colombia,NA,Choco,544764,137,3,1639,85
2020-07-02,Colombia,NA,Choco,544764,57,2,1696,87
2020-07-03,Colombia,NA,Choco,544764,13,0,1709,87
2020-07-04,Colombia,NA,Choco,544764,80,2,1789,89
2020-07-05,Colombia,NA,Choco,544764,39,4,1828,93
2020-07-06,Colombia,NA,Choco,544764,116,2,1944,95
2020-07-07,Colombia,NA,Choco,544764,26,2,1970,97
2020-07-08,Colombia,NA,Choco,544764,30,1,2000,98
2020-07-09,Colombia,NA,Choco,544764,61,3,2061,101
2020-07-10,Colombia,NA,Choco,544764,47,2,2108,103
2020-07-11,Colombia,NA,Choco,544764,56,3,2164,106
2020-07-12,Colombia,NA,Choco,544764,62,1,2226,107
2020-07-13,Colombia,NA,Choco,544764,68,3,2294,110
2020-07-14,Colombia,NA,Choco,544764,37,1,2331,111
2020-07-15,Colombia,NA,Choco,544764,48,0,2379,111
2020-07-16,Colombia,NA,Choco,544764,28,1,2407,112
2020-07-17,Colombia,NA,Choco,544764,40,0,2447,112
2020-07-18,Colombia,NA,Choco,544764,28,1,2475,113
2020-07-19,Colombia,NA,Choco,544764,39,2,2514,115
2020-07-20,Colombia,NA,Choco,544764,31,0,2545,115
2020-07-21,Colombia,NA,Choco,544764,74,2,2619,117
2020-07-22,Colombia,NA,Choco,544764,130,0,2749,117
2020-07-23,Colombia,NA,Choco,544764,21,2,2770,119
2020-07-24,Colombia,NA,Choco,544764,28,1,2798,120
2020-07-25,Colombia,NA,Choco,544764,20,1,2818,121
2020-07-26,Colombia,NA,Choco,544764,17,6,2835,127
2020-07-27,Colombia,NA,Choco,544764,66,4,2901,131
2020-07-28,Colombia,NA,Choco,544764,22,2,2923,133
2020-07-29,Colombia,NA,Choco,544764,19,0,2942,133
2020-07-30,Colombia,NA,Choco,544764,19,1,2961,134
2020-07-31,Colombia,NA,Choco,544764,26,0,2987,134
2020-08-01,Colombia,NA,Choco,544764,28,2,3015,136
2020-08-02,Colombia,NA,Choco,544764,0,1,3015,137
2020-08-03,Colombia,NA,Choco,544764,24,0,3039,137
2020-08-04,Colombia,NA,Choco,544764,3,1,3042,138
2020-08-05,Colombia,NA,Choco,544764,26,1,3068,139
2020-08-06,Colombia,NA,Choco,544764,25,2,3093,141
2020-08-07,Colombia,NA,Choco,544764,10,1,3103,142
2020-08-08,Colombia,NA,Choco,544764,60,1,3163,143
2020-08-09,Colombia,NA,Choco,544764,112,1,3275,144
2020-08-10,Colombia,NA,Choco,544764,46,1,3321,145
2020-08-11,Colombia,NA,Choco,544764,14,0,3335,145
2020-08-12,Colombia,NA,Choco,544764,28,0,3363,145
2020-08-13,Colombia,NA,Choco,544764,0,0,3363,145
2020-08-14,Colombia,NA,Choco,544764,5,0,3368,145
2020-08-15,Colombia,NA,Choco,544764,30,0,3398,145
2020-08-16,Colombia,NA,Choco,544764,23,2,3421,147
2020-08-17,Colombia,NA,Choco,544764,29,3,3450,150
2020-08-18,Colombia,NA,Choco,544764,42,1,3492,151
2020-08-19,Colombia,NA,Choco,544764,12,1,3504,152
2020-08-20,Colombia,NA,Choco,544764,26,0,3530,152
2020-08-21,Colombia,NA,Choco,544764,5,1,3535,153
2020-08-22,Colombia,NA,Choco,544764,55,2,3590,155
2020-08-23,Colombia,NA,Choco,544764,1,0,3591,155
2020-08-24,Colombia,NA,Choco,544764,9,1,3600,156
2020-08-25,Colombia,NA,Choco,544764,5,0,3605,156
2020-08-26,Colombia,NA,Choco,544764,11,1,3616,157
2020-08-27,Colombia,NA,Choco,544764,7,1,3623,158
2020-08-28,Colombia,NA,Choco,544764,9,1,3632,159
2020-08-29,Colombia,NA,Choco,544764,11,1,3643,160
2020-08-30,Colombia,NA,Choco,544764,3,2,3646,162
2020-08-31,Colombia,NA,Choco,544764,16,0,3662,162
2020-09-01,Colombia,NA,Choco,544764,12,0,3674,162
2020-09-02,Colombia,NA,Choco,544764,23,1,3697,163
2020-09-03,Colombia,NA,Choco,544764,3,0,3700,163
2020-09-04,Colombia,NA,Choco,544764,6,1,3706,164
2020-09-05,Colombia,NA,Choco,544764,22,1,3728,165
2020-09-06,Colombia,NA,Choco,544764,3,1,3731,166
2020-09-07,Colombia,NA,Choco,544764,5,0,3736,166
2020-09-08,Colombia,NA,Choco,544764,46,0,3782,166
2020-09-09,Colombia,NA,Choco,544764,11,1,3793,167
2020-09-10,Colombia,NA,Choco,544764,5,0,3798,167
2020-09-11,Colombia,NA,Choco,544764,4,0,3802,167
2020-09-12,Colombia,NA,Choco,544764,6,0,3808,167
2020-09-13,Colombia,NA,Choco,544764,2,0,3810,167
2020-09-14,Colombia,NA,Choco,544764,10,0,3820,167
2020-09-15,Colombia,NA,Choco,544764,4,0,3824,167
2020-09-16,Colombia,NA,Choco,544764,12,0,3836,167
2020-09-17,Colombia,NA,Choco,544764,17,0,3853,167
2020-09-18,Colombia,NA,Choco,544764,6,1,3859,168
2020-09-19,Colombia,NA,Choco,544764,11,0,3870,168
2020-09-20,Colombia,NA,Choco,544764,11,0,3881,168
2020-09-21,Colombia,NA,Choco,544764,6,1,3887,169
2020-09-22,Colombia,NA,Choco,544764,3,0,3890,169
2020-09-23,Colombia,NA,Choco,544764,7,0,3897,169
2020-04-11,Colombia,NA,Cordoba,1828947,6,0,13,2
2020-04-13,Colombia,NA,Cordoba,1828947,0,0,13,2
2020-04-14,Colombia,NA,Cordoba,1828947,2,0,15,2
2020-04-16,Colombia,NA,Cordoba,1828947,2,0,17,2
2020-04-18,Colombia,NA,Cordoba,1828947,1,0,18,2
2020-04-19,Colombia,NA,Cordoba,1828947,2,0,20,2
2020-04-22,Colombia,NA,Cordoba,1828947,1,0,21,2
2020-04-23,Colombia,NA,Cordoba,1828947,0,1,21,3
2020-04-24,Colombia,NA,Cordoba,1828947,1,0,22,3
2020-04-25,Colombia,NA,Cordoba,1828947,1,0,23,3
2020-04-28,Colombia,NA,Cordoba,1828947,3,0,26,3
2020-05-01,Colombia,NA,Cordoba,1828947,3,0,29,3
2020-05-03,Colombia,NA,Cordoba,1828947,0,0,29,3
2020-05-06,Colombia,NA,Cordoba,1828947,1,0,30,3
2020-05-08,Colombia,NA,Cordoba,1828947,1,1,31,4
2020-05-09,Colombia,NA,Cordoba,1828947,0,0,31,4
2020-05-10,Colombia,NA,Cordoba,1828947,8,0,39,4
2020-05-12,Colombia,NA,Cordoba,1828947,3,0,42,4
2020-05-14,Colombia,NA,Cordoba,1828947,9,0,51,4
2020-05-15,Colombia,NA,Cordoba,1828947,11,1,62,5
2020-05-16,Colombia,NA,Cordoba,1828947,9,0,71,5
2020-05-17,Colombia,NA,Cordoba,1828947,7,0,78,5
2020-05-19,Colombia,NA,Cordoba,1828947,5,0,83,5
2020-05-20,Colombia,NA,Cordoba,1828947,3,1,86,6
2020-05-21,Colombia,NA,Cordoba,1828947,0,0,86,6
2020-05-22,Colombia,NA,Cordoba,1828947,1,0,87,6
2020-05-23,Colombia,NA,Cordoba,1828947,1,1,88,7
2020-05-24,Colombia,NA,Cordoba,1828947,3,1,91,8
2020-05-25,Colombia,NA,Cordoba,1828947,1,1,92,9
2020-05-26,Colombia,NA,Cordoba,1828947,1,0,93,9
2020-05-27,Colombia,NA,Cordoba,1828947,3,0,96,9
2020-05-28,Colombia,NA,Cordoba,1828947,5,0,101,9
2020-05-29,Colombia,NA,Cordoba,1828947,9,0,110,9
2020-05-30,Colombia,NA,Cordoba,1828947,10,0,120,9
2020-05-31,Colombia,NA,Cordoba,1828947,4,0,124,9
2020-06-01,Colombia,NA,Cordoba,1828947,11,0,135,9
2020-06-02,Colombia,NA,Cordoba,1828947,0,1,135,10
2020-06-03,Colombia,NA,Cordoba,1828947,28,1,163,11
2020-06-04,Colombia,NA,Cordoba,1828947,9,0,172,11
2020-06-05,Colombia,NA,Cordoba,1828947,22,0,194,11
2020-06-06,Colombia,NA,Cordoba,1828947,14,2,208,13
2020-06-07,Colombia,NA,Cordoba,1828947,11,2,219,15
2020-06-08,Colombia,NA,Cordoba,1828947,5,0,224,15
2020-06-09,Colombia,NA,Cordoba,1828947,6,0,230,15
2020-06-10,Colombia,NA,Cordoba,1828947,5,2,235,17
2020-06-11,Colombia,NA,Cordoba,1828947,8,0,243,17
2020-06-12,Colombia,NA,Cordoba,1828947,4,1,247,18
2020-06-13,Colombia,NA,Cordoba,1828947,18,1,265,19
2020-06-14,Colombia,NA,Cordoba,1828947,21,1,286,20
2020-06-15,Colombia,NA,Cordoba,1828947,4,0,290,20
2020-06-16,Colombia,NA,Cordoba,1828947,15,1,305,21
2020-06-17,Colombia,NA,Cordoba,1828947,3,1,308,22
2020-06-18,Colombia,NA,Cordoba,1828947,57,1,365,23
2020-06-19,Colombia,NA,Cordoba,1828947,25,2,390,25
2020-06-20,Colombia,NA,Cordoba,1828947,13,4,403,29
2020-06-21,Colombia,NA,Cordoba,1828947,19,2,422,31
2020-06-22,Colombia,NA,Cordoba,1828947,12,4,434,35
2020-06-23,Colombia,NA,Cordoba,1828947,12,5,446,40
2020-06-24,Colombia,NA,Cordoba,1828947,21,5,467,45
2020-06-25,Colombia,NA,Cordoba,1828947,40,5,507,50
2020-06-26,Colombia,NA,Cordoba,1828947,34,3,541,53
2020-06-27,Colombia,NA,Cordoba,1828947,35,4,576,57
2020-06-28,Colombia,NA,Cordoba,1828947,80,7,656,64
2020-06-29,Colombia,NA,Cordoba,1828947,95,12,751,76
2020-06-30,Colombia,NA,Cordoba,1828947,39,17,790,93
2020-07-01,Colombia,NA,Cordoba,1828947,36,6,826,99
2020-07-02,Colombia,NA,Cordoba,1828947,97,12,923,111
2020-07-03,Colombia,NA,Cordoba,1828947,32,12,955,123
2020-07-04,Colombia,NA,Cordoba,1828947,113,20,1068,143
2020-07-05,Colombia,NA,Cordoba,1828947,56,16,1124,159
2020-07-06,Colombia,NA,Cordoba,1828947,70,22,1194,181
2020-07-07,Colombia,NA,Cordoba,1828947,134,29,1328,210
2020-07-08,Colombia,NA,Cordoba,1828947,139,29,1467,239
2020-07-09,Colombia,NA,Cordoba,1828947,253,28,1720,267
2020-07-10,Colombia,NA,Cordoba,1828947,130,24,1850,291
2020-07-11,Colombia,NA,Cordoba,1828947,59,27,1909,318
2020-07-12,Colombia,NA,Cordoba,1828947,166,30,2075,348
2020-07-13,Colombia,NA,Cordoba,1828947,184,39,2259,387
2020-07-14,Colombia,NA,Cordoba,1828947,242,26,2501,413
2020-07-15,Colombia,NA,Cordoba,1828947,226,32,2727,445
2020-07-16,Colombia,NA,Cordoba,1828947,262,30,2989,475
2020-07-17,Colombia,NA,Cordoba,1828947,245,49,3234,524
2020-07-18,Colombia,NA,Cordoba,1828947,158,30,3392,554
2020-07-19,Colombia,NA,Cordoba,1828947,188,37,3580,591
2020-07-20,Colombia,NA,Cordoba,1828947,105,30,3685,621
2020-07-21,Colombia,NA,Cordoba,1828947,309,41,3994,662
2020-07-22,Colombia,NA,Cordoba,1828947,445,47,4439,709
2020-07-23,Colombia,NA,Cordoba,1828947,341,31,4780,740
2020-07-24,Colombia,NA,Cordoba,1828947,458,41,5238,781
2020-07-25,Colombia,NA,Cordoba,1828947,192,32,5430,813
2020-07-26,Colombia,NA,Cordoba,1828947,504,27,5934,840
2020-07-27,Colombia,NA,Cordoba,1828947,601,42,6535,882
2020-07-28,Colombia,NA,Cordoba,1828947,332,44,6867,926
2020-07-29,Colombia,NA,Cordoba,1828947,352,39,7219,965
2020-07-30,Colombia,NA,Cordoba,1828947,175,37,7394,1002
2020-07-31,Colombia,NA,Cordoba,1828947,284,26,7678,1028
2020-08-01,Colombia,NA,Cordoba,1828947,491,25,8169,1053
2020-08-02,Colombia,NA,Cordoba,1828947,214,27,8383,1080
2020-08-03,Colombia,NA,Cordoba,1828947,393,29,8776,1109
2020-08-04,Colombia,NA,Cordoba,1828947,232,20,9008,1129
2020-08-05,Colombia,NA,Cordoba,1828947,396,17,9404,1146
2020-08-06,Colombia,NA,Cordoba,1828947,352,23,9756,1169
2020-08-07,Colombia,NA,Cordoba,1828947,663,27,10419,1196
2020-08-08,Colombia,NA,Cordoba,1828947,949,22,11368,1218
2020-08-09,Colombia,NA,Cordoba,1828947,319,19,11687,1237
2020-08-10,Colombia,NA,Cordoba,1828947,951,19,12638,1256
2020-08-11,Colombia,NA,Cordoba,1828947,577,20,13215,1276
2020-08-12,Colombia,NA,Cordoba,1828947,758,13,13973,1289
2020-08-13,Colombia,NA,Cordoba,1828947,423,20,14396,1309
2020-08-14,Colombia,NA,Cordoba,1828947,549,17,14945,1326
2020-08-15,Colombia,NA,Cordoba,1828947,562,19,15507,1345
2020-08-16,Colombia,NA,Cordoba,1828947,577,16,16084,1361
2020-08-17,Colombia,NA,Cordoba,1828947,523,17,16607,1378
2020-08-18,Colombia,NA,Cordoba,1828947,332,10,16939,1388
2020-08-19,Colombia,NA,Cordoba,1828947,235,16,17174,1404
2020-08-20,Colombia,NA,Cordoba,1828947,302,13,17476,1417
2020-08-21,Colombia,NA,Cordoba,1828947,208,13,17684,1430
2020-08-22,Colombia,NA,Cordoba,1828947,198,6,17882,1436
2020-08-23,Colombia,NA,Cordoba,1828947,167,14,18049,1450
2020-08-24,Colombia,NA,Cordoba,1828947,369,14,18418,1464
2020-08-25,Colombia,NA,Cordoba,1828947,589,5,19007,1469
2020-08-26,Colombia,NA,Cordoba,1828947,238,9,19245,1478
2020-08-27,Colombia,NA,Cordoba,1828947,219,7,19464,1485
2020-08-28,Colombia,NA,Cordoba,1828947,132,5,19596,1490
2020-08-29,Colombia,NA,Cordoba,1828947,194,10,19790,1500
2020-08-30,Colombia,NA,Cordoba,1828947,197,7,19987,1507
2020-08-31,Colombia,NA,Cordoba,1828947,151,13,20138,1520
2020-09-01,Colombia,NA,Cordoba,1828947,94,6,20232,1526
2020-09-02,Colombia,NA,Cordoba,1828947,303,3,20535,1529
2020-09-03,Colombia,NA,Cordoba,1828947,158,4,20693,1533
2020-09-04,Colombia,NA,Cordoba,1828947,163,4,20856,1537
2020-09-05,Colombia,NA,Cordoba,1828947,256,7,21112,1544
2020-09-06,Colombia,NA,Cordoba,1828947,72,6,21184,1550
2020-09-07,Colombia,NA,Cordoba,1828947,280,5,21464,1555
2020-09-08,Colombia,NA,Cordoba,1828947,146,4,21610,1559
2020-09-09,Colombia,NA,Cordoba,1828947,121,3,21731,1562
2020-09-10,Colombia,NA,Cordoba,1828947,257,8,21988,1570
2020-09-11,Colombia,NA,Cordoba,1828947,89,4,22077,1574
2020-09-12,Colombia,NA,Cordoba,1828947,72,8,22149,1582
2020-09-13,Colombia,NA,Cordoba,1828947,29,5,22178,1587
2020-09-14,Colombia,NA,Cordoba,1828947,80,8,22258,1595
2020-09-15,Colombia,NA,Cordoba,1828947,101,3,22359,1598
2020-09-16,Colombia,NA,Cordoba,1828947,104,5,22463,1603
2020-09-17,Colombia,NA,Cordoba,1828947,102,6,22565,1609
2020-09-18,Colombia,NA,Cordoba,1828947,146,0,22711,1609
2020-09-19,Colombia,NA,Cordoba,1828947,26,2,22737,1611
2020-09-20,Colombia,NA,Cordoba,1828947,104,2,22841,1613
2020-09-21,Colombia,NA,Cordoba,1828947,364,8,23205,1621
2020-09-22,Colombia,NA,Cordoba,1828947,80,1,23285,1622
2020-09-23,Colombia,NA,Cordoba,1828947,17,3,23302,1625
2020-03-21,Colombia,NA,Cundinamarca,3242999,2,0,12,0
2020-03-23,Colombia,NA,Cundinamarca,3242999,5,0,17,0
2020-03-24,Colombia,NA,Cundinamarca,3242999,7,0,24,0
2020-03-25,Colombia,NA,Cundinamarca,3242999,3,0,27,0
2020-03-27,Colombia,NA,Cundinamarca,3242999,1,0,28,0
2020-03-28,Colombia,NA,Cundinamarca,3242999,2,0,30,0
2020-03-30,Colombia,NA,Cundinamarca,3242999,5,0,35,0
2020-03-31,Colombia,NA,Cundinamarca,3242999,9,0,44,0
2020-04-01,Colombia,NA,Cundinamarca,3242999,6,1,50,1
2020-04-02,Colombia,NA,Cundinamarca,3242999,2,0,52,1
2020-04-03,Colombia,NA,Cundinamarca,3242999,3,3,55,4
2020-04-04,Colombia,NA,Cundinamarca,3242999,7,0,62,4
2020-04-05,Colombia,NA,Cundinamarca,3242999,5,0,67,4
2020-04-06,Colombia,NA,Cundinamarca,3242999,4,0,71,4
2020-04-07,Colombia,NA,Cundinamarca,3242999,5,0,76,4
2020-04-08,Colombia,NA,Cundinamarca,3242999,5,0,81,4
2020-04-09,Colombia,NA,Cundinamarca,3242999,9,1,90,5
2020-04-10,Colombia,NA,Cundinamarca,3242999,16,0,106,5
2020-04-11,Colombia,NA,Cundinamarca,3242999,21,0,127,5
2020-04-12,Colombia,NA,Cundinamarca,3242999,7,0,134,5
2020-04-13,Colombia,NA,Cundinamarca,3242999,3,0,137,5
2020-04-14,Colombia,NA,Cundinamarca,3242999,5,0,142,5
2020-04-15,Colombia,NA,Cundinamarca,3242999,8,0,150,5
2020-04-16,Colombia,NA,Cundinamarca,3242999,1,1,151,6
2020-04-17,Colombia,NA,Cundinamarca,3242999,13,1,164,7
2020-04-18,Colombia,NA,Cundinamarca,3242999,7,0,171,7
2020-04-19,Colombia,NA,Cundinamarca,3242999,6,0,177,7
2020-04-20,Colombia,NA,Cundinamarca,3242999,7,0,184,7
2020-04-21,Colombia,NA,Cundinamarca,3242999,10,2,194,9
2020-04-22,Colombia,NA,Cundinamarca,3242999,3,0,197,9
2020-04-23,Colombia,NA,Cundinamarca,3242999,6,0,203,9
2020-04-24,Colombia,NA,Cundinamarca,3242999,7,1,210,10
2020-04-25,Colombia,NA,Cundinamarca,3242999,7,0,217,10
2020-04-26,Colombia,NA,Cundinamarca,3242999,7,1,224,11
2020-04-27,Colombia,NA,Cundinamarca,3242999,6,0,230,11
2020-04-28,Colombia,NA,Cundinamarca,3242999,2,0,232,11
2020-04-29,Colombia,NA,Cundinamarca,3242999,5,0,237,11
2020-04-30,Colombia,NA,Cundinamarca,3242999,5,0,242,11
2020-05-01,Colombia,NA,Cundinamarca,3242999,4,0,246,11
2020-05-02,Colombia,NA,Cundinamarca,3242999,2,0,248,11
2020-05-03,Colombia,NA,Cundinamarca,3242999,11,1,259,12
2020-05-04,Colombia,NA,Cundinamarca,3242999,3,0,262,12
2020-05-05,Colombia,NA,Cundinamarca,3242999,5,0,267,12
2020-05-06,Colombia,NA,Cundinamarca,3242999,0,0,267,12
2020-05-07,Colombia,NA,Cundinamarca,3242999,7,0,274,12
2020-05-08,Colombia,NA,Cundinamarca,3242999,3,0,277,12
2020-05-09,Colombia,NA,Cundinamarca,3242999,2,0,279,12
2020-05-10,Colombia,NA,Cundinamarca,3242999,4,0,283,12
2020-05-11,Colombia,NA,Cundinamarca,3242999,7,0,290,12
2020-05-12,Colombia,NA,Cundinamarca,3242999,18,0,308,12
2020-05-13,Colombia,NA,Cundinamarca,3242999,3,0,311,12
2020-05-14,Colombia,NA,Cundinamarca,3242999,7,0,318,12
2020-05-15,Colombia,NA,Cundinamarca,3242999,16,0,334,12
2020-05-16,Colombia,NA,Cundinamarca,3242999,8,0,342,12
2020-05-17,Colombia,NA,Cundinamarca,3242999,10,0,352,12
2020-05-18,Colombia,NA,Cundinamarca,3242999,11,1,363,13
2020-05-19,Colombia,NA,Cundinamarca,3242999,12,2,375,15
2020-05-20,Colombia,NA,Cundinamarca,3242999,6,0,381,15
2020-05-21,Colombia,NA,Cundinamarca,3242999,7,0,388,15
2020-05-22,Colombia,NA,Cundinamarca,3242999,7,0,395,15
2020-05-23,Colombia,NA,Cundinamarca,3242999,31,0,426,15
2020-05-24,Colombia,NA,Cundinamarca,3242999,34,0,460,15
2020-05-25,Colombia,NA,Cundinamarca,3242999,70,0,530,15
2020-05-26,Colombia,NA,Cundinamarca,3242999,48,1,578,16
2020-05-27,Colombia,NA,Cundinamarca,3242999,51,1,629,17
2020-05-28,Colombia,NA,Cundinamarca,3242999,75,1,704,18
2020-05-29,Colombia,NA,Cundinamarca,3242999,50,1,754,19
2020-05-30,Colombia,NA,Cundinamarca,3242999,36,2,790,21
2020-05-31,Colombia,NA,Cundinamarca,3242999,43,0,833,21
2020-06-01,Colombia,NA,Cundinamarca,3242999,74,4,907,25
2020-06-02,Colombia,NA,Cundinamarca,3242999,58,2,965,27
2020-06-03,Colombia,NA,Cundinamarca,3242999,53,3,1018,30
2020-06-04,Colombia,NA,Cundinamarca,3242999,52,5,1070,35
2020-06-05,Colombia,NA,Cundinamarca,3242999,51,1,1121,36
2020-06-06,Colombia,NA,Cundinamarca,3242999,39,1,1160,37
2020-06-07,Colombia,NA,Cundinamarca,3242999,50,2,1210,39
2020-06-08,Colombia,NA,Cundinamarca,3242999,115,1,1325,40
2020-06-09,Colombia,NA,Cundinamarca,3242999,51,2,1376,42
2020-06-10,Colombia,NA,Cundinamarca,3242999,40,1,1416,43
2020-06-11,Colombia,NA,Cundinamarca,3242999,99,1,1515,44
2020-06-12,Colombia,NA,Cundinamarca,3242999,51,2,1566,46
2020-06-13,Colombia,NA,Cundinamarca,3242999,58,0,1624,46
2020-06-14,Colombia,NA,Cundinamarca,3242999,21,1,1645,47
2020-06-15,Colombia,NA,Cundinamarca,3242999,23,1,1668,48
2020-06-16,Colombia,NA,Cundinamarca,3242999,47,0,1715,48
2020-06-17,Colombia,NA,Cundinamarca,3242999,27,0,1742,48
2020-06-18,Colombia,NA,Cundinamarca,3242999,65,1,1807,49
2020-06-19,Colombia,NA,Cundinamarca,3242999,57,0,1864,49
2020-06-20,Colombia,NA,Cundinamarca,3242999,56,1,1920,50
2020-06-21,Colombia,NA,Cundinamarca,3242999,27,1,1947,51
2020-06-22,Colombia,NA,Cundinamarca,3242999,62,1,2009,52
2020-06-23,Colombia,NA,Cundinamarca,3242999,112,2,2121,54
2020-06-24,Colombia,NA,Cundinamarca,3242999,88,1,2209,55
2020-06-25,Colombia,NA,Cundinamarca,3242999,100,1,2309,56
2020-06-26,Colombia,NA,Cundinamarca,3242999,118,1,2427,57
2020-06-27,Colombia,NA,Cundinamarca,3242999,68,1,2495,58
2020-06-28,Colombia,NA,Cundinamarca,3242999,85,1,2580,59
2020-06-29,Colombia,NA,Cundinamarca,3242999,64,2,2644,61
2020-06-30,Colombia,NA,Cundinamarca,3242999,23,2,2667,63
2020-07-01,Colombia,NA,Cundinamarca,3242999,159,3,2826,66
2020-07-02,Colombia,NA,Cundinamarca,3242999,175,0,3001,66
2020-07-03,Colombia,NA,Cundinamarca,3242999,114,6,3115,72
2020-07-04,Colombia,NA,Cundinamarca,3242999,157,6,3272,78
2020-07-05,Colombia,NA,Cundinamarca,3242999,100,2,3372,80
2020-07-06,Colombia,NA,Cundinamarca,3242999,96,5,3468,85
2020-07-07,Colombia,NA,Cundinamarca,3242999,104,1,3572,86
2020-07-08,Colombia,NA,Cundinamarca,3242999,135,3,3707,89
2020-07-09,Colombia,NA,Cundinamarca,3242999,286,6,3993,95
2020-07-10,Colombia,NA,Cundinamarca,3242999,252,4,4245,99
2020-07-11,Colombia,NA,Cundinamarca,3242999,218,3,4463,102
2020-07-12,Colombia,NA,Cundinamarca,3242999,245,7,4708,109
2020-07-13,Colombia,NA,Cundinamarca,3242999,287,9,4995,118
2020-07-14,Colombia,NA,Cundinamarca,3242999,300,10,5295,128
2020-07-15,Colombia,NA,Cundinamarca,3242999,175,7,5470,135
2020-07-16,Colombia,NA,Cundinamarca,3242999,186,4,5656,139
2020-07-17,Colombia,NA,Cundinamarca,3242999,181,13,5837,152
2020-07-18,Colombia,NA,Cundinamarca,3242999,261,7,6098,159
2020-07-19,Colombia,NA,Cundinamarca,3242999,189,9,6287,168
2020-07-20,Colombia,NA,Cundinamarca,3242999,78,10,6365,178
2020-07-21,Colombia,NA,Cundinamarca,3242999,222,14,6587,192
2020-07-22,Colombia,NA,Cundinamarca,3242999,329,11,6916,203
2020-07-23,Colombia,NA,Cundinamarca,3242999,218,8,7134,211
2020-07-24,Colombia,NA,Cundinamarca,3242999,240,8,7374,219
2020-07-25,Colombia,NA,Cundinamarca,3242999,223,10,7597,229
2020-07-26,Colombia,NA,Cundinamarca,3242999,142,10,7739,239
2020-07-27,Colombia,NA,Cundinamarca,3242999,374,19,8113,258
2020-07-28,Colombia,NA,Cundinamarca,3242999,343,8,8456,266
2020-07-29,Colombia,NA,Cundinamarca,3242999,317,15,8773,281
2020-07-30,Colombia,NA,Cundinamarca,3242999,286,17,9059,298
2020-07-31,Colombia,NA,Cundinamarca,3242999,342,12,9401,310
2020-08-01,Colombia,NA,Cundinamarca,3242999,439,12,9840,322
2020-08-02,Colombia,NA,Cundinamarca,3242999,259,7,10099,329
2020-08-03,Colombia,NA,Cundinamarca,3242999,225,9,10324,338
2020-08-04,Colombia,NA,Cundinamarca,3242999,498,12,10822,350
2020-08-05,Colombia,NA,Cundinamarca,3242999,408,14,11230,364
2020-08-06,Colombia,NA,Cundinamarca,3242999,287,17,11517,381
2020-08-07,Colombia,NA,Cundinamarca,3242999,446,17,11963,398
2020-08-08,Colombia,NA,Cundinamarca,3242999,238,15,12201,413
2020-08-09,Colombia,NA,Cundinamarca,3242999,298,13,12499,426
2020-08-10,Colombia,NA,Cundinamarca,3242999,629,13,13128,439
2020-08-11,Colombia,NA,Cundinamarca,3242999,365,14,13493,453
2020-08-12,Colombia,NA,Cundinamarca,3242999,580,14,14073,467
2020-08-13,Colombia,NA,Cundinamarca,3242999,533,19,14606,486
2020-08-14,Colombia,NA,Cundinamarca,3242999,741,13,15347,499
2020-08-15,Colombia,NA,Cundinamarca,3242999,525,12,15872,511
2020-08-16,Colombia,NA,Cundinamarca,3242999,471,11,16343,522
2020-08-17,Colombia,NA,Cundinamarca,3242999,382,12,16725,534
2020-08-18,Colombia,NA,Cundinamarca,3242999,925,8,17650,542
2020-08-19,Colombia,NA,Cundinamarca,3242999,376,10,18026,552
2020-08-20,Colombia,NA,Cundinamarca,3242999,515,16,18541,568
2020-08-21,Colombia,NA,Cundinamarca,3242999,545,15,19086,583
2020-08-22,Colombia,NA,Cundinamarca,3242999,424,13,19510,596
2020-08-23,Colombia,NA,Cundinamarca,3242999,488,13,19998,609
2020-08-24,Colombia,NA,Cundinamarca,3242999,550,14,20548,623
2020-08-25,Colombia,NA,Cundinamarca,3242999,440,15,20988,638
2020-08-26,Colombia,NA,Cundinamarca,3242999,557,15,21545,653
2020-08-27,Colombia,NA,Cundinamarca,3242999,592,13,22137,666
2020-08-28,Colombia,NA,Cundinamarca,3242999,484,15,22621,681
2020-08-29,Colombia,NA,Cundinamarca,3242999,367,12,22988,693
2020-08-30,Colombia,NA,Cundinamarca,3242999,402,14,23390,707
2020-08-31,Colombia,NA,Cundinamarca,3242999,537,13,23927,720
2020-09-01,Colombia,NA,Cundinamarca,3242999,525,18,24452,738
2020-09-02,Colombia,NA,Cundinamarca,3242999,445,12,24897,750
2020-09-03,Colombia,NA,Cundinamarca,3242999,334,22,25231,772
2020-09-04,Colombia,NA,Cundinamarca,3242999,553,11,25784,783
2020-09-05,Colombia,NA,Cundinamarca,3242999,368,11,26152,794
2020-09-06,Colombia,NA,Cundinamarca,3242999,193,11,26345,805
2020-09-07,Colombia,NA,Cundinamarca,3242999,404,12,26749,817
2020-09-08,Colombia,NA,Cundinamarca,3242999,336,17,27085,834
2020-09-09,Colombia,NA,Cundinamarca,3242999,401,10,27486,844
2020-09-10,Colombia,NA,Cundinamarca,3242999,525,14,28011,858
2020-09-11,Colombia,NA,Cundinamarca,3242999,249,13,28260,871
2020-09-12,Colombia,NA,Cundinamarca,3242999,344,11,28604,882
2020-09-13,Colombia,NA,Cundinamarca,3242999,234,9,28838,891
2020-09-14,Colombia,NA,Cundinamarca,3242999,318,14,29156,905
2020-09-15,Colombia,NA,Cundinamarca,3242999,402,14,29558,919
2020-09-16,Colombia,NA,Cundinamarca,3242999,307,16,29865,935
2020-09-17,Colombia,NA,Cundinamarca,3242999,374,12,30239,947
2020-09-18,Colombia,NA,Cundinamarca,3242999,360,2,30599,949
2020-09-19,Colombia,NA,Cundinamarca,3242999,279,10,30878,959
2020-09-20,Colombia,NA,Cundinamarca,3242999,177,3,31055,962
2020-09-21,Colombia,NA,Cundinamarca,3242999,205,13,31260,975
2020-09-22,Colombia,NA,Cundinamarca,3242999,275,7,31535,982
2020-09-23,Colombia,NA,Cundinamarca,3242999,394,2,31929,984
2020-06-20,Colombia,NA,Guainia,50636,7,0,14,1
2020-07-01,Colombia,NA,Guainia,50636,0,0,14,1
2020-07-06,Colombia,NA,Guainia,50636,0,0,14,1
2020-07-17,Colombia,NA,Guainia,50636,0,0,14,1
2020-08-14,Colombia,NA,Guainia,50636,0,1,14,2
2020-08-15,Colombia,NA,Guainia,50636,4,0,18,2
2020-08-16,Colombia,NA,Guainia,50636,3,0,21,2
2020-08-20,Colombia,NA,Guainia,50636,8,0,29,2
2020-08-21,Colombia,NA,Guainia,50636,1,0,30,2
2020-08-22,Colombia,NA,Guainia,50636,43,0,73,2
2020-08-23,Colombia,NA,Guainia,50636,0,0,73,2
2020-08-24,Colombia,NA,Guainia,50636,15,0,88,2
2020-08-25,Colombia,NA,Guainia,50636,3,1,91,3
2020-08-26,Colombia,NA,Guainia,50636,2,0,93,3
2020-08-27,Colombia,NA,Guainia,50636,5,0,98,3
2020-08-28,Colombia,NA,Guainia,50636,1,2,99,5
2020-08-29,Colombia,NA,Guainia,50636,44,0,143,5
2020-08-31,Colombia,NA,Guainia,50636,16,2,159,7
2020-09-01,Colombia,NA,Guainia,50636,7,0,166,7
2020-09-02,Colombia,NA,Guainia,50636,0,0,166,7
2020-09-03,Colombia,NA,Guainia,50636,2,1,168,8
2020-09-04,Colombia,NA,Guainia,50636,0,0,168,8
2020-09-05,Colombia,NA,Guainia,50636,109,0,277,8
2020-09-06,Colombia,NA,Guainia,50636,6,0,283,8
2020-09-07,Colombia,NA,Guainia,50636,50,1,333,9
2020-09-08,Colombia,NA,Guainia,50636,2,1,335,10
2020-09-09,Colombia,NA,Guainia,50636,8,0,343,10
2020-09-10,Colombia,NA,Guainia,50636,6,0,349,10
2020-09-11,Colombia,NA,Guainia,50636,1,0,350,10
2020-09-12,Colombia,NA,Guainia,50636,1,0,351,10
2020-09-13,Colombia,NA,Guainia,50636,0,0,351,10
2020-09-14,Colombia,NA,Guainia,50636,111,0,462,10
2020-09-15,Colombia,NA,Guainia,50636,42,0,504,10
2020-09-16,Colombia,NA,Guainia,50636,30,0,534,10
2020-09-17,Colombia,NA,Guainia,50636,19,0,553,10
2020-09-18,Colombia,NA,Guainia,50636,90,1,643,11
2020-09-19,Colombia,NA,Guainia,50636,6,0,649,11
2020-09-20,Colombia,NA,Guainia,50636,54,0,703,11
2020-09-21,Colombia,NA,Guainia,50636,29,0,732,11
2020-09-22,Colombia,NA,Guainia,50636,2,0,734,11
2020-09-23,Colombia,NA,Guainia,50636,2,0,736,11
2020-06-16,Colombia,NA,Guaviare,86657,22,0,31,0
2020-06-17,Colombia,NA,Guaviare,86657,1,0,32,0
2020-06-18,Colombia,NA,Guaviare,86657,3,0,35,0
2020-06-19,Colombia,NA,Guaviare,86657,1,0,36,0
2020-06-20,Colombia,NA,Guaviare,86657,1,0,37,0
2020-06-21,Colombia,NA,Guaviare,86657,0,0,37,0
2020-06-26,Colombia,NA,Guaviare,86657,0,0,37,0
2020-06-27,Colombia,NA,Guaviare,86657,0,0,37,0
2020-06-28,Colombia,NA,Guaviare,86657,0,0,37,0
2020-06-29,Colombia,NA,Guaviare,86657,0,0,37,0
2020-07-01,Colombia,NA,Guaviare,86657,2,0,39,0
2020-07-06,Colombia,NA,Guaviare,86657,0,0,39,0
2020-07-08,Colombia,NA,Guaviare,86657,0,0,39,0
2020-07-09,Colombia,NA,Guaviare,86657,3,0,42,0
2020-07-10,Colombia,NA,Guaviare,86657,0,0,42,0
2020-07-11,Colombia,NA,Guaviare,86657,0,0,42,0
2020-07-12,Colombia,NA,Guaviare,86657,0,0,42,0
2020-07-13,Colombia,NA,Guaviare,86657,0,0,42,0
2020-07-14,Colombia,NA,Guaviare,86657,6,0,48,0
2020-07-15,Colombia,NA,Guaviare,86657,3,0,51,0
2020-07-18,Colombia,NA,Guaviare,86657,1,0,52,0
2020-07-19,Colombia,NA,Guaviare,86657,1,0,53,0
2020-07-21,Colombia,NA,Guaviare,86657,1,0,54,0
2020-07-23,Colombia,NA,Guaviare,86657,27,0,81,0
2020-07-26,Colombia,NA,Guaviare,86657,1,0,82,0
2020-07-27,Colombia,NA,Guaviare,86657,13,0,95,0
2020-07-29,Colombia,NA,Guaviare,86657,6,0,101,0
2020-07-30,Colombia,NA,Guaviare,86657,13,0,114,0
2020-07-31,Colombia,NA,Guaviare,86657,0,0,114,0
2020-08-01,Colombia,NA,Guaviare,86657,9,0,123,0
2020-08-02,Colombia,NA,Guaviare,86657,2,0,125,0
2020-08-03,Colombia,NA,Guaviare,86657,6,1,131,1
2020-08-04,Colombia,NA,Guaviare,86657,8,0,139,1
2020-08-05,Colombia,NA,Guaviare,86657,1,0,140,1
2020-08-06,Colombia,NA,Guaviare,86657,0,0,140,1
2020-08-07,Colombia,NA,Guaviare,86657,4,0,144,1
2020-08-08,Colombia,NA,Guaviare,86657,26,0,170,1
2020-08-09,Colombia,NA,Guaviare,86657,6,0,176,1
2020-08-10,Colombia,NA,Guaviare,86657,16,0,192,1
2020-08-11,Colombia,NA,Guaviare,86657,0,0,192,1
2020-08-12,Colombia,NA,Guaviare,86657,2,0,194,1
2020-08-13,Colombia,NA,Guaviare,86657,2,0,196,1
2020-08-14,Colombia,NA,Guaviare,86657,0,0,196,1
2020-08-15,Colombia,NA,Guaviare,86657,4,0,200,1
2020-08-16,Colombia,NA,Guaviare,86657,0,0,200,1
2020-08-17,Colombia,NA,Guaviare,86657,0,0,200,1
2020-08-18,Colombia,NA,Guaviare,86657,3,1,203,2
2020-08-19,Colombia,NA,Guaviare,86657,2,0,205,2
2020-08-20,Colombia,NA,Guaviare,86657,13,0,218,2
2020-08-21,Colombia,NA,Guaviare,86657,1,0,219,2
2020-08-22,Colombia,NA,Guaviare,86657,18,0,237,2
2020-08-23,Colombia,NA,Guaviare,86657,0,1,237,3
2020-08-24,Colombia,NA,Guaviare,86657,3,0,240,3
2020-08-25,Colombia,NA,Guaviare,86657,0,1,240,4
2020-08-26,Colombia,NA,Guaviare,86657,0,0,240,4
2020-08-27,Colombia,NA,Guaviare,86657,1,0,241,4
2020-08-28,Colombia,NA,Guaviare,86657,2,3,243,7
2020-08-29,Colombia,NA,Guaviare,86657,32,0,275,7
2020-08-30,Colombia,NA,Guaviare,86657,0,0,275,7
2020-08-31,Colombia,NA,Guaviare,86657,7,0,282,7
2020-09-01,Colombia,NA,Guaviare,86657,24,0,306,7
2020-09-02,Colombia,NA,Guaviare,86657,33,0,339,7
2020-09-03,Colombia,NA,Guaviare,86657,3,0,342,7
2020-09-04,Colombia,NA,Guaviare,86657,8,0,350,7
2020-09-05,Colombia,NA,Guaviare,86657,14,0,364,7
2020-09-06,Colombia,NA,Guaviare,86657,5,1,369,8
2020-09-07,Colombia,NA,Guaviare,86657,15,0,384,8
2020-09-08,Colombia,NA,Guaviare,86657,26,0,410,8
2020-09-09,Colombia,NA,Guaviare,86657,49,0,459,8
2020-09-10,Colombia,NA,Guaviare,86657,18,2,477,10
2020-09-11,Colombia,NA,Guaviare,86657,11,0,488,10
2020-09-12,Colombia,NA,Guaviare,86657,19,0,507,10
2020-09-13,Colombia,NA,Guaviare,86657,18,1,525,11
2020-09-14,Colombia,NA,Guaviare,86657,16,0,541,11
2020-09-15,Colombia,NA,Guaviare,86657,4,1,545,12
2020-09-16,Colombia,NA,Guaviare,86657,45,1,590,13
2020-09-17,Colombia,NA,Guaviare,86657,13,0,603,13
2020-09-18,Colombia,NA,Guaviare,86657,39,0,642,13
2020-09-19,Colombia,NA,Guaviare,86657,7,0,649,13
2020-09-20,Colombia,NA,Guaviare,86657,10,0,659,13
2020-09-21,Colombia,NA,Guaviare,86657,10,0,669,13
2020-09-22,Colombia,NA,Guaviare,86657,12,0,681,13
2020-09-23,Colombia,NA,Guaviare,86657,5,0,686,13
2020-03-23,Colombia,NA,Huila,1122622,1,0,11,0
2020-03-24,Colombia,NA,Huila,1122622,3,0,14,0
2020-03-25,Colombia,NA,Huila,1122622,0,1,14,1
2020-03-28,Colombia,NA,Huila,1122622,0,0,14,1
2020-03-29,Colombia,NA,Huila,1122622,2,0,16,1
2020-03-30,Colombia,NA,Huila,1122622,5,0,21,1
2020-03-31,Colombia,NA,Huila,1122622,3,0,24,1
2020-04-01,Colombia,NA,Huila,1122622,6,0,30,1
2020-04-02,Colombia,NA,Huila,1122622,0,0,30,1
2020-04-03,Colombia,NA,Huila,1122622,2,0,32,1
2020-04-04,Colombia,NA,Huila,1122622,2,0,34,1
2020-04-06,Colombia,NA,Huila,1122622,0,1,34,2
2020-04-07,Colombia,NA,Huila,1122622,0,0,34,2
2020-04-08,Colombia,NA,Huila,1122622,4,0,38,2
2020-04-09,Colombia,NA,Huila,1122622,1,1,39,3
2020-04-10,Colombia,NA,Huila,1122622,2,0,41,3
2020-04-11,Colombia,NA,Huila,1122622,11,0,52,3
2020-04-12,Colombia,NA,Huila,1122622,0,0,52,3
2020-04-13,Colombia,NA,Huila,1122622,3,1,55,4
2020-04-14,Colombia,NA,Huila,1122622,0,1,55,5
2020-04-15,Colombia,NA,Huila,1122622,0,0,55,5
2020-04-16,Colombia,NA,Huila,1122622,5,0,60,5
2020-04-17,Colombia,NA,Huila,1122622,2,0,62,5
2020-04-18,Colombia,NA,Huila,1122622,16,0,78,5
2020-04-20,Colombia,NA,Huila,1122622,1,0,79,5
2020-04-21,Colombia,NA,Huila,1122622,2,0,81,5
2020-04-23,Colombia,NA,Huila,1122622,0,0,81,5
2020-04-24,Colombia,NA,Huila,1122622,1,0,82,5
2020-04-25,Colombia,NA,Huila,1122622,2,2,84,7
2020-04-26,Colombia,NA,Huila,1122622,3,1,87,8
2020-04-27,Colombia,NA,Huila,1122622,5,0,92,8
2020-04-28,Colombia,NA,Huila,1122622,9,0,101,8
2020-04-29,Colombia,NA,Huila,1122622,3,0,104,8
2020-04-30,Colombia,NA,Huila,1122622,16,1,120,9
2020-05-01,Colombia,NA,Huila,1122622,13,0,133,9
2020-05-02,Colombia,NA,Huila,1122622,0,0,133,9
2020-05-03,Colombia,NA,Huila,1122622,0,0,133,9
2020-05-04,Colombia,NA,Huila,1122622,1,1,134,10
2020-05-05,Colombia,NA,Huila,1122622,3,0,137,10
2020-05-06,Colombia,NA,Huila,1122622,0,0,137,10
2020-05-07,Colombia,NA,Huila,1122622,10,0,147,10
2020-05-08,Colombia,NA,Huila,1122622,0,0,147,10
2020-05-09,Colombia,NA,Huila,1122622,0,0,147,10
2020-05-10,Colombia,NA,Huila,1122622,31,0,178,10
2020-05-11,Colombia,NA,Huila,1122622,1,0,179,10
2020-05-12,Colombia,NA,Huila,1122622,6,1,185,11
2020-05-13,Colombia,NA,Huila,1122622,1,0,186,11
2020-05-14,Colombia,NA,Huila,1122622,0,0,186,11
2020-05-15,Colombia,NA,Huila,1122622,20,0,206,11
2020-05-16,Colombia,NA,Huila,1122622,1,1,207,12
2020-05-17,Colombia,NA,Huila,1122622,2,1,209,13
2020-05-18,Colombia,NA,Huila,1122622,4,0,213,13
2020-05-19,Colombia,NA,Huila,1122622,0,0,213,13
2020-05-20,Colombia,NA,Huila,1122622,7,0,220,13
2020-05-21,Colombia,NA,Huila,1122622,8,0,228,13
2020-05-22,Colombia,NA,Huila,1122622,4,0,232,13
2020-05-23,Colombia,NA,Huila,1122622,2,0,234,13
2020-05-25,Colombia,NA,Huila,1122622,4,0,238,13
2020-05-26,Colombia,NA,Huila,1122622,2,0,240,13
2020-05-27,Colombia,NA,Huila,1122622,5,0,245,13
2020-05-28,Colombia,NA,Huila,1122622,3,0,248,13
2020-05-29,Colombia,NA,Huila,1122622,0,0,248,13
2020-05-30,Colombia,NA,Huila,1122622,0,0,248,13
2020-05-31,Colombia,NA,Huila,1122622,2,0,250,13
2020-06-01,Colombia,NA,Huila,1122622,2,0,252,13
2020-06-02,Colombia,NA,Huila,1122622,0,0,252,13
2020-06-03,Colombia,NA,Huila,1122622,1,0,253,13
2020-06-04,Colombia,NA,Huila,1122622,1,0,254,13
2020-06-05,Colombia,NA,Huila,1122622,0,0,254,13
2020-06-07,Colombia,NA,Huila,1122622,2,0,256,13
2020-06-08,Colombia,NA,Huila,1122622,2,0,258,13
2020-06-09,Colombia,NA,Huila,1122622,2,0,260,13
2020-06-10,Colombia,NA,Huila,1122622,0,0,260,13
2020-06-11,Colombia,NA,Huila,1122622,7,0,267,13
2020-06-13,Colombia,NA,Huila,1122622,3,0,270,13
2020-06-14,Colombia,NA,Huila,1122622,2,0,272,13
2020-06-15,Colombia,NA,Huila,1122622,2,0,274,13
2020-06-16,Colombia,NA,Huila,1122622,4,0,278,13
2020-06-17,Colombia,NA,Huila,1122622,4,0,282,13
2020-06-18,Colombia,NA,Huila,1122622,4,0,286,13
2020-06-19,Colombia,NA,Huila,1122622,2,0,288,13
2020-06-20,Colombia,NA,Huila,1122622,6,0,294,13
2020-06-21,Colombia,NA,Huila,1122622,13,0,307,13
2020-06-22,Colombia,NA,Huila,1122622,2,1,309,14
2020-06-23,Colombia,NA,Huila,1122622,6,0,315,14
2020-06-24,Colombia,NA,Huila,1122622,1,0,316,14
2020-06-25,Colombia,NA,Huila,1122622,3,0,319,14
2020-06-26,Colombia,NA,Huila,1122622,4,0,323,14
2020-06-27,Colombia,NA,Huila,1122622,1,0,324,14
2020-06-28,Colombia,NA,Huila,1122622,3,0,327,14
2020-06-29,Colombia,NA,Huila,1122622,7,1,334,15
2020-06-30,Colombia,NA,Huila,1122622,3,0,337,15
2020-07-01,Colombia,NA,Huila,1122622,0,0,337,15
2020-07-02,Colombia,NA,Huila,1122622,24,0,361,15
2020-07-03,Colombia,NA,Huila,1122622,4,0,365,15
2020-07-04,Colombia,NA,Huila,1122622,5,0,370,15
2020-07-05,Colombia,NA,Huila,1122622,6,2,376,17
2020-07-06,Colombia,NA,Huila,1122622,5,0,381,17
2020-07-07,Colombia,NA,Huila,1122622,1,0,382,17
2020-07-08,Colombia,NA,Huila,1122622,9,0,391,17
2020-07-09,Colombia,NA,Huila,1122622,8,0,399,17
2020-07-10,Colombia,NA,Huila,1122622,16,0,415,17
2020-07-11,Colombia,NA,Huila,1122622,7,1,422,18
2020-07-12,Colombia,NA,Huila,1122622,10,0,432,18
2020-07-13,Colombia,NA,Huila,1122622,16,0,448,18
2020-07-14,Colombia,NA,Huila,1122622,19,1,467,19
2020-07-15,Colombia,NA,Huila,1122622,22,0,489,19
2020-07-16,Colombia,NA,Huila,1122622,9,1,498,20
2020-07-17,Colombia,NA,Huila,1122622,26,0,524,20
2020-07-18,Colombia,NA,Huila,1122622,43,0,567,20
2020-07-19,Colombia,NA,Huila,1122622,18,1,585,21
2020-07-20,Colombia,NA,Huila,1122622,6,1,591,22
2020-07-21,Colombia,NA,Huila,1122622,20,2,611,24
2020-07-22,Colombia,NA,Huila,1122622,44,0,655,24
2020-07-23,Colombia,NA,Huila,1122622,27,0,682,24
2020-07-24,Colombia,NA,Huila,1122622,39,2,721,26
2020-07-25,Colombia,NA,Huila,1122622,34,0,755,26
2020-07-26,Colombia,NA,Huila,1122622,17,3,772,29
2020-07-27,Colombia,NA,Huila,1122622,36,1,808,30
2020-07-28,Colombia,NA,Huila,1122622,44,1,852,31
2020-07-29,Colombia,NA,Huila,1122622,129,1,981,32
2020-07-30,Colombia,NA,Huila,1122622,26,2,1007,34
2020-07-31,Colombia,NA,Huila,1122622,58,2,1065,36
2020-08-01,Colombia,NA,Huila,1122622,50,1,1115,37
2020-08-02,Colombia,NA,Huila,1122622,84,2,1199,39
2020-08-03,Colombia,NA,Huila,1122622,62,3,1261,42
2020-08-04,Colombia,NA,Huila,1122622,51,3,1312,45
2020-08-05,Colombia,NA,Huila,1122622,61,2,1373,47
2020-08-06,Colombia,NA,Huila,1122622,89,2,1462,49
2020-08-07,Colombia,NA,Huila,1122622,121,3,1583,52
2020-08-08,Colombia,NA,Huila,1122622,197,6,1780,58
2020-08-09,Colombia,NA,Huila,1122622,112,5,1892,63
2020-08-10,Colombia,NA,Huila,1122622,159,6,2051,69
2020-08-11,Colombia,NA,Huila,1122622,85,2,2136,71
2020-08-12,Colombia,NA,Huila,1122622,201,3,2337,74
2020-08-13,Colombia,NA,Huila,1122622,77,3,2414,77
2020-08-14,Colombia,NA,Huila,1122622,173,5,2587,82
2020-08-15,Colombia,NA,Huila,1122622,109,7,2696,89
2020-08-16,Colombia,NA,Huila,1122622,176,4,2872,93
2020-08-17,Colombia,NA,Huila,1122622,159,2,3031,95
2020-08-18,Colombia,NA,Huila,1122622,143,3,3174,98
2020-08-19,Colombia,NA,Huila,1122622,65,3,3239,101
2020-08-20,Colombia,NA,Huila,1122622,213,8,3452,109
2020-08-21,Colombia,NA,Huila,1122622,44,4,3496,113
2020-08-22,Colombia,NA,Huila,1122622,196,3,3692,116
2020-08-23,Colombia,NA,Huila,1122622,61,8,3753,124
2020-08-24,Colombia,NA,Huila,1122622,137,6,3890,130
2020-08-25,Colombia,NA,Huila,1122622,107,11,3997,141
2020-08-26,Colombia,NA,Huila,1122622,494,4,4491,145
2020-08-27,Colombia,NA,Huila,1122622,196,5,4687,150
2020-08-28,Colombia,NA,Huila,1122622,188,8,4875,158
2020-08-29,Colombia,NA,Huila,1122622,255,4,5130,162
2020-08-30,Colombia,NA,Huila,1122622,130,4,5260,166
2020-08-31,Colombia,NA,Huila,1122622,173,5,5433,171
2020-09-01,Colombia,NA,Huila,1122622,182,10,5615,181
2020-09-02,Colombia,NA,Huila,1122622,283,12,5898,193
2020-09-03,Colombia,NA,Huila,1122622,148,8,6046,201
2020-09-04,Colombia,NA,Huila,1122622,189,7,6235,208
2020-09-05,Colombia,NA,Huila,1122622,109,6,6344,214
2020-09-06,Colombia,NA,Huila,1122622,282,9,6626,223
2020-09-07,Colombia,NA,Huila,1122622,181,7,6807,230
2020-09-08,Colombia,NA,Huila,1122622,265,10,7072,240
2020-09-09,Colombia,NA,Huila,1122622,215,7,7287,247
2020-09-10,Colombia,NA,Huila,1122622,251,4,7538,251
2020-09-11,Colombia,NA,Huila,1122622,193,5,7731,256
2020-09-12,Colombia,NA,Huila,1122622,210,5,7941,261
2020-09-13,Colombia,NA,Huila,1122622,93,8,8034,269
2020-09-14,Colombia,NA,Huila,1122622,258,12,8292,281
2020-09-15,Colombia,NA,Huila,1122622,233,5,8525,286
2020-09-16,Colombia,NA,Huila,1122622,251,11,8776,297
2020-09-17,Colombia,NA,Huila,1122622,378,4,9154,301
2020-09-18,Colombia,NA,Huila,1122622,248,14,9402,315
2020-09-19,Colombia,NA,Huila,1122622,148,7,9550,322
2020-09-20,Colombia,NA,Huila,1122622,112,7,9662,329
2020-09-21,Colombia,NA,Huila,1122622,273,3,9935,332
2020-09-22,Colombia,NA,Huila,1122622,164,3,10099,335
2020-09-23,Colombia,NA,Huila,1122622,341,5,10440,340
2020-05-05,Colombia,NA,La Guajira,965718,4,0,14,2
2020-05-06,Colombia,NA,La Guajira,965718,0,1,14,2
2020-05-07,Colombia,NA,La Guajira,965718,0,0,14,2
2020-05-08,Colombia,NA,La Guajira,965718,1,0,15,3
2020-05-10,Colombia,NA,La Guajira,965718,12,0,27,4
2020-05-11,Colombia,NA,La Guajira,965718,0,1,27,5
2020-05-12,Colombia,NA,La Guajira,965718,1,0,28,5
2020-05-13,Colombia,NA,La Guajira,965718,4,0,32,5
2020-05-15,Colombia,NA,La Guajira,965718,3,0,35,5
2020-05-16,Colombia,NA,La Guajira,965718,10,0,45,5
2020-05-17,Colombia,NA,La Guajira,965718,2,0,47,5
2020-05-19,Colombia,NA,La Guajira,965718,0,0,47,5
2020-05-20,Colombia,NA,La Guajira,965718,0,0,47,5
2020-05-21,Colombia,NA,La Guajira,965718,0,0,47,5
2020-05-22,Colombia,NA,La Guajira,965718,0,0,47,5
2020-05-23,Colombia,NA,La Guajira,965718,1,0,48,5
2020-05-25,Colombia,NA,La Guajira,965718,1,0,49,5
2020-05-26,Colombia,NA,La Guajira,965718,5,0,54,5
2020-05-27,Colombia,NA,La Guajira,965718,1,0,55,5
2020-05-28,Colombia,NA,La Guajira,965718,2,0,57,5
2020-05-29,Colombia,NA,La Guajira,965718,0,0,57,5
2020-05-30,Colombia,NA,La Guajira,965718,2,0,59,5
2020-05-31,Colombia,NA,La Guajira,965718,3,0,62,5
2020-06-01,Colombia,NA,La Guajira,965718,2,0,64,5
2020-06-02,Colombia,NA,La Guajira,965718,2,0,66,5
2020-06-03,Colombia,NA,La Guajira,965718,0,0,66,5
2020-06-04,Colombia,NA,La Guajira,965718,3,0,69,5
2020-06-05,Colombia,NA,La Guajira,965718,4,0,73,5
2020-06-06,Colombia,NA,La Guajira,965718,35,1,108,6
2020-06-07,Colombia,NA,La Guajira,965718,1,2,109,8
2020-06-08,Colombia,NA,La Guajira,965718,1,1,110,9
2020-06-09,Colombia,NA,La Guajira,965718,4,0,114,9
2020-06-11,Colombia,NA,La Guajira,965718,1,0,115,9
2020-06-12,Colombia,NA,La Guajira,965718,0,0,115,9
2020-06-13,Colombia,NA,La Guajira,965718,7,0,122,9
2020-06-14,Colombia,NA,La Guajira,965718,7,2,129,11
2020-06-15,Colombia,NA,La Guajira,965718,11,0,140,11
2020-06-16,Colombia,NA,La Guajira,965718,9,0,149,11
2020-06-17,Colombia,NA,La Guajira,965718,9,1,158,12
2020-06-18,Colombia,NA,La Guajira,965718,3,0,161,12
2020-06-19,Colombia,NA,La Guajira,965718,8,0,169,12
2020-06-20,Colombia,NA,La Guajira,965718,14,2,183,14
2020-06-21,Colombia,NA,La Guajira,965718,24,4,207,18
2020-06-22,Colombia,NA,La Guajira,965718,9,0,216,18
2020-06-23,Colombia,NA,La Guajira,965718,8,0,224,18
2020-06-24,Colombia,NA,La Guajira,965718,20,0,244,18
2020-06-25,Colombia,NA,La Guajira,965718,13,2,257,20
2020-06-26,Colombia,NA,La Guajira,965718,25,5,282,25
2020-06-27,Colombia,NA,La Guajira,965718,20,1,302,26
2020-06-28,Colombia,NA,La Guajira,965718,83,2,385,28
2020-06-29,Colombia,NA,La Guajira,965718,53,4,438,32
2020-06-30,Colombia,NA,La Guajira,965718,34,1,472,33
2020-07-01,Colombia,NA,La Guajira,965718,28,7,500,40
2020-07-02,Colombia,NA,La Guajira,965718,65,6,565,46
2020-07-03,Colombia,NA,La Guajira,965718,42,2,607,48
2020-07-04,Colombia,NA,La Guajira,965718,45,1,652,49
2020-07-05,Colombia,NA,La Guajira,965718,44,3,696,52
2020-07-06,Colombia,NA,La Guajira,965718,49,6,745,58
2020-07-07,Colombia,NA,La Guajira,965718,72,1,817,59
2020-07-08,Colombia,NA,La Guajira,965718,76,3,893,62
2020-07-09,Colombia,NA,La Guajira,965718,68,3,961,65
2020-07-10,Colombia,NA,La Guajira,965718,58,5,1019,70
2020-07-11,Colombia,NA,La Guajira,965718,66,8,1085,78
2020-07-12,Colombia,NA,La Guajira,965718,60,4,1145,82
2020-07-13,Colombia,NA,La Guajira,965718,70,4,1215,86
2020-07-14,Colombia,NA,La Guajira,965718,145,4,1360,90
2020-07-15,Colombia,NA,La Guajira,965718,92,6,1452,96
2020-07-16,Colombia,NA,La Guajira,965718,26,4,1478,100
2020-07-17,Colombia,NA,La Guajira,965718,88,3,1566,103
2020-07-18,Colombia,NA,La Guajira,965718,69,1,1635,104
2020-07-19,Colombia,NA,La Guajira,965718,48,4,1683,108
2020-07-20,Colombia,NA,La Guajira,965718,39,5,1722,113
2020-07-21,Colombia,NA,La Guajira,965718,44,6,1766,119
2020-07-22,Colombia,NA,La Guajira,965718,56,4,1822,123
2020-07-23,Colombia,NA,La Guajira,965718,50,3,1872,126
2020-07-24,Colombia,NA,La Guajira,965718,83,9,1955,135
2020-07-25,Colombia,NA,La Guajira,965718,51,0,2006,135
2020-07-26,Colombia,NA,La Guajira,965718,34,3,2040,138
2020-07-27,Colombia,NA,La Guajira,965718,136,0,2176,138
2020-07-28,Colombia,NA,La Guajira,965718,44,1,2220,139
2020-07-29,Colombia,NA,La Guajira,965718,28,4,2248,143
2020-07-30,Colombia,NA,La Guajira,965718,20,3,2268,146
2020-07-31,Colombia,NA,La Guajira,965718,43,3,2311,149
2020-08-01,Colombia,NA,La Guajira,965718,64,3,2375,152
2020-08-02,Colombia,NA,La Guajira,965718,62,5,2437,157
2020-08-03,Colombia,NA,La Guajira,965718,74,6,2511,163
2020-08-04,Colombia,NA,La Guajira,965718,51,4,2562,167
2020-08-05,Colombia,NA,La Guajira,965718,88,2,2650,169
2020-08-06,Colombia,NA,La Guajira,965718,98,1,2748,170
2020-08-07,Colombia,NA,La Guajira,965718,51,5,2799,175
2020-08-08,Colombia,NA,La Guajira,965718,78,2,2877,177
2020-08-09,Colombia,NA,La Guajira,965718,85,2,2962,179
2020-08-10,Colombia,NA,La Guajira,965718,213,4,3175,183
2020-08-11,Colombia,NA,La Guajira,965718,97,8,3272,191
2020-08-12,Colombia,NA,La Guajira,965718,169,3,3441,194
2020-08-13,Colombia,NA,La Guajira,965718,97,2,3538,196
2020-08-14,Colombia,NA,La Guajira,965718,83,5,3621,201
2020-08-15,Colombia,NA,La Guajira,965718,72,3,3693,204
2020-08-16,Colombia,NA,La Guajira,965718,111,2,3804,206
2020-08-17,Colombia,NA,La Guajira,965718,53,4,3857,210
2020-08-18,Colombia,NA,La Guajira,965718,159,6,4016,216
2020-08-19,Colombia,NA,La Guajira,965718,58,4,4074,220
2020-08-20,Colombia,NA,La Guajira,965718,216,2,4290,222
2020-08-21,Colombia,NA,La Guajira,965718,123,6,4413,228
2020-08-22,Colombia,NA,La Guajira,965718,88,5,4501,233
2020-08-23,Colombia,NA,La Guajira,965718,45,1,4546,234
2020-08-24,Colombia,NA,La Guajira,965718,123,2,4669,236
2020-08-25,Colombia,NA,La Guajira,965718,35,5,4704,241
2020-08-26,Colombia,NA,La Guajira,965718,118,0,4822,241
2020-08-27,Colombia,NA,La Guajira,965718,99,4,4921,245
2020-08-28,Colombia,NA,La Guajira,965718,116,1,5037,246
2020-08-29,Colombia,NA,La Guajira,965718,71,3,5108,249
2020-08-30,Colombia,NA,La Guajira,965718,140,1,5248,250
2020-08-31,Colombia,NA,La Guajira,965718,47,2,5295,252
2020-09-01,Colombia,NA,La Guajira,965718,178,4,5473,256
2020-09-02,Colombia,NA,La Guajira,965718,156,3,5629,259
2020-09-03,Colombia,NA,La Guajira,965718,64,6,5693,265
2020-09-04,Colombia,NA,La Guajira,965718,173,2,5866,267
2020-09-05,Colombia,NA,La Guajira,965718,51,0,5917,267
2020-09-06,Colombia,NA,La Guajira,965718,58,2,5975,269
2020-09-07,Colombia,NA,La Guajira,965718,121,1,6096,270
2020-09-08,Colombia,NA,La Guajira,965718,188,2,6284,272
2020-09-09,Colombia,NA,La Guajira,965718,118,4,6402,276
2020-09-10,Colombia,NA,La Guajira,965718,103,0,6505,276
2020-09-11,Colombia,NA,La Guajira,965718,82,0,6587,276
2020-09-12,Colombia,NA,La Guajira,965718,92,5,6679,281
2020-09-13,Colombia,NA,La Guajira,965718,35,4,6714,285
2020-09-14,Colombia,NA,La Guajira,965718,185,2,6899,287
2020-09-15,Colombia,NA,La Guajira,965718,101,0,7000,287
2020-09-16,Colombia,NA,La Guajira,965718,93,2,7093,289
2020-09-17,Colombia,NA,La Guajira,965718,61,0,7154,289
2020-09-18,Colombia,NA,La Guajira,965718,73,2,7227,291
2020-09-19,Colombia,NA,La Guajira,965718,174,4,7401,295
2020-09-20,Colombia,NA,La Guajira,965718,75,0,7476,295
2020-09-21,Colombia,NA,La Guajira,965718,52,3,7528,298
2020-09-22,Colombia,NA,La Guajira,965718,77,2,7605,300
2020-09-23,Colombia,NA,La Guajira,965718,76,1,7681,301
2020-03-31,Colombia,NA,Magdalena,1427026,2,0,11,2
2020-04-01,Colombia,NA,Magdalena,1427026,2,0,13,2
2020-04-05,Colombia,NA,Magdalena,1427026,0,2,13,2
2020-04-06,Colombia,NA,Magdalena,1427026,0,0,13,2
2020-04-07,Colombia,NA,Magdalena,1427026,0,1,13,2
2020-04-08,Colombia,NA,Magdalena,1427026,14,1,27,5
2020-04-09,Colombia,NA,Magdalena,1427026,4,1,31,6
2020-04-10,Colombia,NA,Magdalena,1427026,12,0,43,7
2020-04-11,Colombia,NA,Magdalena,1427026,15,0,58,7
2020-04-12,Colombia,NA,Magdalena,1427026,4,2,62,9
2020-04-13,Colombia,NA,Magdalena,1427026,5,0,67,9
2020-04-14,Colombia,NA,Magdalena,1427026,0,1,67,10
2020-04-15,Colombia,NA,Magdalena,1427026,4,0,71,10
2020-04-16,Colombia,NA,Magdalena,1427026,16,0,87,10
2020-04-17,Colombia,NA,Magdalena,1427026,2,0,89,10
2020-04-18,Colombia,NA,Magdalena,1427026,0,2,89,12
2020-04-20,Colombia,NA,Magdalena,1427026,5,0,94,12
2020-04-21,Colombia,NA,Magdalena,1427026,17,0,111,12
2020-04-22,Colombia,NA,Magdalena,1427026,10,1,121,13
2020-04-23,Colombia,NA,Magdalena,1427026,22,1,143,14
2020-04-24,Colombia,NA,Magdalena,1427026,4,0,147,14
2020-04-25,Colombia,NA,Magdalena,1427026,5,1,152,15
2020-04-26,Colombia,NA,Magdalena,1427026,8,3,160,18
2020-04-27,Colombia,NA,Magdalena,1427026,3,0,163,18
2020-04-28,Colombia,NA,Magdalena,1427026,3,1,166,19
2020-04-29,Colombia,NA,Magdalena,1427026,6,0,172,19
2020-04-30,Colombia,NA,Magdalena,1427026,30,1,202,20
2020-05-01,Colombia,NA,Magdalena,1427026,18,0,220,20
2020-05-02,Colombia,NA,Magdalena,1427026,10,1,230,21
2020-05-03,Colombia,NA,Magdalena,1427026,6,2,236,23
2020-05-04,Colombia,NA,Magdalena,1427026,6,2,242,25
2020-05-05,Colombia,NA,Magdalena,1427026,15,1,257,26
2020-05-06,Colombia,NA,Magdalena,1427026,0,0,257,26
2020-05-07,Colombia,NA,Magdalena,1427026,1,1,258,27
2020-05-08,Colombia,NA,Magdalena,1427026,6,3,264,30
2020-05-09,Colombia,NA,Magdalena,1427026,0,1,264,31
2020-05-10,Colombia,NA,Magdalena,1427026,8,1,272,32
2020-05-11,Colombia,NA,Magdalena,1427026,12,1,284,33
2020-05-12,Colombia,NA,Magdalena,1427026,24,1,308,34
2020-05-13,Colombia,NA,Magdalena,1427026,14,1,322,35
2020-05-14,Colombia,NA,Magdalena,1427026,33,0,355,35
2020-05-15,Colombia,NA,Magdalena,1427026,25,0,380,35
2020-05-16,Colombia,NA,Magdalena,1427026,25,0,405,35
2020-05-17,Colombia,NA,Magdalena,1427026,5,1,410,36
2020-05-18,Colombia,NA,Magdalena,1427026,26,0,436,36
2020-05-19,Colombia,NA,Magdalena,1427026,6,2,442,38
2020-05-20,Colombia,NA,Magdalena,1427026,6,1,448,39
2020-05-21,Colombia,NA,Magdalena,1427026,18,0,466,39
2020-05-22,Colombia,NA,Magdalena,1427026,17,2,483,41
2020-05-23,Colombia,NA,Magdalena,1427026,3,3,486,44
2020-05-24,Colombia,NA,Magdalena,1427026,6,0,492,44
2020-05-25,Colombia,NA,Magdalena,1427026,11,1,503,45
2020-05-26,Colombia,NA,Magdalena,1427026,23,1,526,46
2020-05-27,Colombia,NA,Magdalena,1427026,19,1,545,47
2020-05-28,Colombia,NA,Magdalena,1427026,9,0,554,47
2020-05-29,Colombia,NA,Magdalena,1427026,13,2,567,49
2020-05-30,Colombia,NA,Magdalena,1427026,28,2,595,51
2020-05-31,Colombia,NA,Magdalena,1427026,15,3,610,54
2020-06-01,Colombia,NA,Magdalena,1427026,24,1,634,55
2020-06-02,Colombia,NA,Magdalena,1427026,17,1,651,56
2020-06-03,Colombia,NA,Magdalena,1427026,52,0,703,56
2020-06-04,Colombia,NA,Magdalena,1427026,11,1,714,57
2020-06-05,Colombia,NA,Magdalena,1427026,17,2,731,59
2020-06-06,Colombia,NA,Magdalena,1427026,15,1,746,60
2020-06-07,Colombia,NA,Magdalena,1427026,3,0,749,60
2020-06-08,Colombia,NA,Magdalena,1427026,25,2,774,62
2020-06-09,Colombia,NA,Magdalena,1427026,19,2,793,64
2020-06-10,Colombia,NA,Magdalena,1427026,21,3,814,67
2020-06-11,Colombia,NA,Magdalena,1427026,30,4,844,71
2020-06-12,Colombia,NA,Magdalena,1427026,2,4,846,75
2020-06-13,Colombia,NA,Magdalena,1427026,64,3,910,78
2020-06-14,Colombia,NA,Magdalena,1427026,17,9,927,87
2020-06-15,Colombia,NA,Magdalena,1427026,26,3,953,90
2020-06-16,Colombia,NA,Magdalena,1427026,22,4,975,94
2020-06-17,Colombia,NA,Magdalena,1427026,27,4,1002,98
2020-06-18,Colombia,NA,Magdalena,1427026,88,7,1090,105
2020-06-19,Colombia,NA,Magdalena,1427026,31,5,1121,110
2020-06-20,Colombia,NA,Magdalena,1427026,48,1,1169,111
2020-06-21,Colombia,NA,Magdalena,1427026,60,7,1229,118
2020-06-22,Colombia,NA,Magdalena,1427026,34,11,1263,129
2020-06-23,Colombia,NA,Magdalena,1427026,29,5,1292,134
2020-06-24,Colombia,NA,Magdalena,1427026,70,7,1362,141
2020-06-25,Colombia,NA,Magdalena,1427026,103,11,1465,152
2020-06-26,Colombia,NA,Magdalena,1427026,119,7,1584,159
2020-06-27,Colombia,NA,Magdalena,1427026,72,9,1656,168
2020-06-28,Colombia,NA,Magdalena,1427026,114,7,1770,175
2020-06-29,Colombia,NA,Magdalena,1427026,77,10,1847,185
2020-06-30,Colombia,NA,Magdalena,1427026,82,16,1929,201
2020-07-01,Colombia,NA,Magdalena,1427026,76,14,2005,215
2020-07-02,Colombia,NA,Magdalena,1427026,139,12,2144,227
2020-07-03,Colombia,NA,Magdalena,1427026,58,7,2202,234
2020-07-04,Colombia,NA,Magdalena,1427026,110,6,2312,240
2020-07-05,Colombia,NA,Magdalena,1427026,53,15,2365,255
2020-07-06,Colombia,NA,Magdalena,1427026,93,16,2458,271
2020-07-07,Colombia,NA,Magdalena,1427026,148,11,2606,282
2020-07-08,Colombia,NA,Magdalena,1427026,113,14,2719,296
2020-07-09,Colombia,NA,Magdalena,1427026,241,8,2960,304
2020-07-10,Colombia,NA,Magdalena,1427026,198,7,3158,311
2020-07-11,Colombia,NA,Magdalena,1427026,180,13,3338,324
2020-07-12,Colombia,NA,Magdalena,1427026,47,12,3385,336
2020-07-13,Colombia,NA,Magdalena,1427026,222,5,3607,341
2020-07-14,Colombia,NA,Magdalena,1427026,137,7,3744,348
2020-07-15,Colombia,NA,Magdalena,1427026,163,12,3907,360
2020-07-16,Colombia,NA,Magdalena,1427026,205,14,4112,374
2020-07-17,Colombia,NA,Magdalena,1427026,188,13,4300,387
2020-07-18,Colombia,NA,Magdalena,1427026,248,12,4548,399
2020-07-19,Colombia,NA,Magdalena,1427026,139,4,4687,403
2020-07-20,Colombia,NA,Magdalena,1427026,133,8,4820,411
2020-07-21,Colombia,NA,Magdalena,1427026,229,12,5049,423
2020-07-22,Colombia,NA,Magdalena,1427026,232,7,5281,430
2020-07-23,Colombia,NA,Magdalena,1427026,116,9,5397,439
2020-07-24,Colombia,NA,Magdalena,1427026,131,12,5528,451
2020-07-25,Colombia,NA,Magdalena,1427026,96,6,5624,457
2020-07-26,Colombia,NA,Magdalena,1427026,219,7,5843,464
2020-07-27,Colombia,NA,Magdalena,1427026,203,14,6046,478
2020-07-28,Colombia,NA,Magdalena,1427026,138,10,6184,488
2020-07-29,Colombia,NA,Magdalena,1427026,270,11,6454,499
2020-07-30,Colombia,NA,Magdalena,1427026,178,10,6632,509
2020-07-31,Colombia,NA,Magdalena,1427026,183,17,6815,526
2020-08-01,Colombia,NA,Magdalena,1427026,328,8,7143,534
2020-08-02,Colombia,NA,Magdalena,1427026,162,5,7305,539
2020-08-03,Colombia,NA,Magdalena,1427026,159,13,7464,552
2020-08-04,Colombia,NA,Magdalena,1427026,347,4,7811,556
2020-08-05,Colombia,NA,Magdalena,1427026,250,11,8061,567
2020-08-06,Colombia,NA,Magdalena,1427026,143,9,8204,576
2020-08-07,Colombia,NA,Magdalena,1427026,248,5,8452,581
2020-08-08,Colombia,NA,Magdalena,1427026,117,8,8569,589
2020-08-09,Colombia,NA,Magdalena,1427026,207,5,8776,594
2020-08-10,Colombia,NA,Magdalena,1427026,366,9,9142,603
2020-08-11,Colombia,NA,Magdalena,1427026,276,13,9418,616
2020-08-12,Colombia,NA,Magdalena,1427026,393,5,9811,621
2020-08-13,Colombia,NA,Magdalena,1427026,199,13,10010,634
2020-08-14,Colombia,NA,Magdalena,1427026,198,12,10208,646
2020-08-15,Colombia,NA,Magdalena,1427026,170,13,10378,659
2020-08-16,Colombia,NA,Magdalena,1427026,116,11,10494,670
2020-08-17,Colombia,NA,Magdalena,1427026,192,11,10686,681
2020-08-18,Colombia,NA,Magdalena,1427026,158,6,10844,687
2020-08-19,Colombia,NA,Magdalena,1427026,69,8,10913,695
2020-08-20,Colombia,NA,Magdalena,1427026,149,5,11062,700
2020-08-21,Colombia,NA,Magdalena,1427026,182,8,11244,708
2020-08-22,Colombia,NA,Magdalena,1427026,57,8,11301,716
2020-08-23,Colombia,NA,Magdalena,1427026,94,5,11395,721
2020-08-24,Colombia,NA,Magdalena,1427026,162,11,11557,732
2020-08-25,Colombia,NA,Magdalena,1427026,145,8,11702,740
2020-08-26,Colombia,NA,Magdalena,1427026,135,9,11837,749
2020-08-27,Colombia,NA,Magdalena,1427026,156,8,11993,757
2020-08-28,Colombia,NA,Magdalena,1427026,185,10,12178,767
2020-08-29,Colombia,NA,Magdalena,1427026,104,2,12282,769
2020-08-30,Colombia,NA,Magdalena,1427026,132,4,12414,773
2020-08-31,Colombia,NA,Magdalena,1427026,86,7,12500,780
2020-09-01,Colombia,NA,Magdalena,1427026,124,6,12624,786
2020-09-02,Colombia,NA,Magdalena,1427026,209,3,12833,789
2020-09-03,Colombia,NA,Magdalena,1427026,104,7,12937,796
2020-09-04,Colombia,NA,Magdalena,1427026,78,9,13015,805
2020-09-05,Colombia,NA,Magdalena,1427026,41,4,13056,809
2020-09-06,Colombia,NA,Magdalena,1427026,53,7,13109,816
2020-09-07,Colombia,NA,Magdalena,1427026,181,9,13290,825
2020-09-08,Colombia,NA,Magdalena,1427026,47,2,13337,827
2020-09-09,Colombia,NA,Magdalena,1427026,135,0,13472,827
2020-09-10,Colombia,NA,Magdalena,1427026,151,2,13623,829
2020-09-11,Colombia,NA,Magdalena,1427026,131,2,13754,831
2020-09-12,Colombia,NA,Magdalena,1427026,51,5,13805,836
2020-09-13,Colombia,NA,Magdalena,1427026,16,0,13821,836
2020-09-14,Colombia,NA,Magdalena,1427026,89,8,13910,844
2020-09-15,Colombia,NA,Magdalena,1427026,129,3,14039,847
2020-09-16,Colombia,NA,Magdalena,1427026,160,5,14199,852
2020-09-17,Colombia,NA,Magdalena,1427026,81,2,14280,854
2020-09-18,Colombia,NA,Magdalena,1427026,111,8,14391,862
2020-09-19,Colombia,NA,Magdalena,1427026,104,4,14495,866
2020-09-20,Colombia,NA,Magdalena,1427026,11,3,14506,869
2020-09-21,Colombia,NA,Magdalena,1427026,93,3,14599,872
2020-09-22,Colombia,NA,Magdalena,1427026,157,3,14756,875
2020-09-23,Colombia,NA,Magdalena,1427026,34,2,14790,877
2020-03-31,Colombia,NA,Meta,1062454,4,0,12,0
2020-04-01,Colombia,NA,Meta,1062454,1,0,13,0
2020-04-02,Colombia,NA,Meta,1062454,0,0,13,0
2020-04-03,Colombia,NA,Meta,1062454,1,0,14,0
2020-04-04,Colombia,NA,Meta,1062454,0,0,14,0
2020-04-05,Colombia,NA,Meta,1062454,1,1,15,1
2020-04-06,Colombia,NA,Meta,1062454,0,1,15,2
2020-04-07,Colombia,NA,Meta,1062454,0,1,15,3
2020-04-09,Colombia,NA,Meta,1062454,1,0,16,3
2020-04-10,Colombia,NA,Meta,1062454,1,0,17,3
2020-04-11,Colombia,NA,Meta,1062454,5,0,22,3
2020-04-13,Colombia,NA,Meta,1062454,2,0,24,3
2020-04-14,Colombia,NA,Meta,1062454,15,0,39,3
2020-04-16,Colombia,NA,Meta,1062454,5,1,44,4
2020-04-17,Colombia,NA,Meta,1062454,2,0,46,4
2020-04-18,Colombia,NA,Meta,1062454,2,0,48,4
2020-04-19,Colombia,NA,Meta,1062454,5,0,53,4
2020-04-20,Colombia,NA,Meta,1062454,4,0,57,4
2020-04-21,Colombia,NA,Meta,1062454,3,0,60,4
2020-04-22,Colombia,NA,Meta,1062454,40,0,100,4
2020-04-23,Colombia,NA,Meta,1062454,36,0,136,4
2020-04-24,Colombia,NA,Meta,1062454,26,0,162,4
2020-04-25,Colombia,NA,Meta,1062454,24,0,186,4
2020-04-26,Colombia,NA,Meta,1062454,46,0,232,4
2020-04-27,Colombia,NA,Meta,1062454,16,0,248,4
2020-04-28,Colombia,NA,Meta,1062454,107,0,355,4
2020-04-29,Colombia,NA,Meta,1062454,8,0,363,4
2020-04-30,Colombia,NA,Meta,1062454,22,2,385,6
2020-05-01,Colombia,NA,Meta,1062454,90,1,475,7
2020-05-02,Colombia,NA,Meta,1062454,4,0,479,7
2020-05-03,Colombia,NA,Meta,1062454,86,0,565,7
2020-05-04,Colombia,NA,Meta,1062454,0,0,565,7
2020-05-05,Colombia,NA,Meta,1062454,154,0,719,7
2020-05-06,Colombia,NA,Meta,1062454,23,0,742,7
2020-05-07,Colombia,NA,Meta,1062454,17,0,759,7
2020-05-08,Colombia,NA,Meta,1062454,76,0,835,7
2020-05-09,Colombia,NA,Meta,1062454,63,0,898,7
2020-05-10,Colombia,NA,Meta,1062454,25,0,923,7
2020-05-11,Colombia,NA,Meta,1062454,4,2,927,9
2020-05-12,Colombia,NA,Meta,1062454,9,0,936,9
2020-05-13,Colombia,NA,Meta,1062454,3,0,939,9
2020-05-14,Colombia,NA,Meta,1062454,2,0,941,9
2020-05-15,Colombia,NA,Meta,1062454,0,0,941,9
2020-05-16,Colombia,NA,Meta,1062454,5,0,946,9
2020-05-17,Colombia,NA,Meta,1062454,4,0,950,9
2020-05-18,Colombia,NA,Meta,1062454,2,0,952,9
2020-05-19,Colombia,NA,Meta,1062454,3,0,955,9
2020-05-20,Colombia,NA,Meta,1062454,9,0,964,9
2020-05-21,Colombia,NA,Meta,1062454,3,0,967,9
2020-05-22,Colombia,NA,Meta,1062454,2,0,969,9
2020-05-23,Colombia,NA,Meta,1062454,0,0,969,9
2020-05-24,Colombia,NA,Meta,1062454,2,0,971,9
2020-05-25,Colombia,NA,Meta,1062454,1,0,972,9
2020-05-26,Colombia,NA,Meta,1062454,3,0,975,9
2020-05-27,Colombia,NA,Meta,1062454,0,0,975,9
2020-05-28,Colombia,NA,Meta,1062454,1,1,976,10
2020-05-29,Colombia,NA,Meta,1062454,1,0,977,10
2020-05-30,Colombia,NA,Meta,1062454,0,0,977,10
2020-05-31,Colombia,NA,Meta,1062454,0,1,977,11
2020-06-01,Colombia,NA,Meta,1062454,3,0,980,11
2020-06-02,Colombia,NA,Meta,1062454,4,0,984,11
2020-06-03,Colombia,NA,Meta,1062454,2,0,986,11
2020-06-04,Colombia,NA,Meta,1062454,2,0,988,11
2020-06-05,Colombia,NA,Meta,1062454,2,0,990,11
2020-06-06,Colombia,NA,Meta,1062454,2,0,992,11
2020-06-07,Colombia,NA,Meta,1062454,2,0,994,11
2020-06-08,Colombia,NA,Meta,1062454,1,0,995,11
2020-06-09,Colombia,NA,Meta,1062454,7,0,1002,11
2020-06-10,Colombia,NA,Meta,1062454,2,1,1004,12
2020-06-11,Colombia,NA,Meta,1062454,12,0,1016,12
2020-06-12,Colombia,NA,Meta,1062454,2,0,1018,12
2020-06-13,Colombia,NA,Meta,1062454,3,0,1021,12
2020-06-14,Colombia,NA,Meta,1062454,2,0,1023,12
2020-06-15,Colombia,NA,Meta,1062454,8,0,1031,12
2020-06-16,Colombia,NA,Meta,1062454,1,0,1032,12
2020-06-17,Colombia,NA,Meta,1062454,6,1,1038,13
2020-06-18,Colombia,NA,Meta,1062454,7,0,1045,13
2020-06-19,Colombia,NA,Meta,1062454,22,1,1067,14
2020-06-20,Colombia,NA,Meta,1062454,8,0,1075,14
2020-06-21,Colombia,NA,Meta,1062454,21,0,1096,14
2020-06-22,Colombia,NA,Meta,1062454,6,0,1102,14
2020-06-23,Colombia,NA,Meta,1062454,30,0,1132,14
2020-06-24,Colombia,NA,Meta,1062454,17,0,1149,14
2020-06-25,Colombia,NA,Meta,1062454,13,1,1162,15
2020-06-26,Colombia,NA,Meta,1062454,22,0,1184,15
2020-06-27,Colombia,NA,Meta,1062454,10,0,1194,15
2020-06-28,Colombia,NA,Meta,1062454,23,0,1217,15
2020-06-29,Colombia,NA,Meta,1062454,8,2,1225,17
2020-06-30,Colombia,NA,Meta,1062454,21,0,1246,17
2020-07-01,Colombia,NA,Meta,1062454,25,0,1271,17
2020-07-02,Colombia,NA,Meta,1062454,26,0,1297,17
2020-07-03,Colombia,NA,Meta,1062454,16,0,1313,17
2020-07-04,Colombia,NA,Meta,1062454,33,0,1346,17
2020-07-05,Colombia,NA,Meta,1062454,16,1,1362,18
2020-07-06,Colombia,NA,Meta,1062454,16,1,1378,19
2020-07-07,Colombia,NA,Meta,1062454,44,0,1422,19
2020-07-08,Colombia,NA,Meta,1062454,23,0,1445,19
2020-07-09,Colombia,NA,Meta,1062454,38,0,1483,19
2020-07-10,Colombia,NA,Meta,1062454,82,0,1565,19
2020-07-11,Colombia,NA,Meta,1062454,64,0,1629,19
2020-07-12,Colombia,NA,Meta,1062454,36,1,1665,20
2020-07-13,Colombia,NA,Meta,1062454,36,2,1701,22
2020-07-14,Colombia,NA,Meta,1062454,100,0,1801,22
2020-07-15,Colombia,NA,Meta,1062454,46,2,1847,24
2020-07-16,Colombia,NA,Meta,1062454,53,0,1900,24
2020-07-17,Colombia,NA,Meta,1062454,43,1,1943,25
2020-07-18,Colombia,NA,Meta,1062454,39,0,1982,25
2020-07-19,Colombia,NA,Meta,1062454,25,5,2007,30
2020-07-20,Colombia,NA,Meta,1062454,29,1,2036,31
2020-07-21,Colombia,NA,Meta,1062454,40,2,2076,33
2020-07-22,Colombia,NA,Meta,1062454,107,1,2183,34
2020-07-23,Colombia,NA,Meta,1062454,64,2,2247,36
2020-07-24,Colombia,NA,Meta,1062454,125,0,2372,36
2020-07-25,Colombia,NA,Meta,1062454,36,1,2408,37
2020-07-26,Colombia,NA,Meta,1062454,49,3,2457,40
2020-07-27,Colombia,NA,Meta,1062454,82,2,2539,42
2020-07-28,Colombia,NA,Meta,1062454,146,0,2685,42
2020-07-29,Colombia,NA,Meta,1062454,108,3,2793,45
2020-07-30,Colombia,NA,Meta,1062454,117,5,2910,50
2020-07-31,Colombia,NA,Meta,1062454,102,4,3012,54
2020-08-01,Colombia,NA,Meta,1062454,77,4,3089,58
2020-08-02,Colombia,NA,Meta,1062454,36,2,3125,60
2020-08-03,Colombia,NA,Meta,1062454,93,2,3218,62
2020-08-04,Colombia,NA,Meta,1062454,210,2,3428,64
2020-08-05,Colombia,NA,Meta,1062454,143,4,3571,68
2020-08-06,Colombia,NA,Meta,1062454,171,3,3742,71
2020-08-07,Colombia,NA,Meta,1062454,251,4,3993,75
2020-08-08,Colombia,NA,Meta,1062454,179,4,4172,79
2020-08-09,Colombia,NA,Meta,1062454,118,8,4290,87
2020-08-10,Colombia,NA,Meta,1062454,173,7,4463,94
2020-08-11,Colombia,NA,Meta,1062454,295,5,4758,99
2020-08-12,Colombia,NA,Meta,1062454,172,5,4930,104
2020-08-13,Colombia,NA,Meta,1062454,189,6,5119,110
2020-08-14,Colombia,NA,Meta,1062454,205,6,5324,116
2020-08-15,Colombia,NA,Meta,1062454,150,5,5474,121
2020-08-16,Colombia,NA,Meta,1062454,163,8,5637,129
2020-08-17,Colombia,NA,Meta,1062454,228,11,5865,140
2020-08-18,Colombia,NA,Meta,1062454,264,8,6129,148
2020-08-19,Colombia,NA,Meta,1062454,174,8,6303,156
2020-08-20,Colombia,NA,Meta,1062454,315,9,6618,165
2020-08-21,Colombia,NA,Meta,1062454,195,3,6813,168
2020-08-22,Colombia,NA,Meta,1062454,240,7,7053,175
2020-08-23,Colombia,NA,Meta,1062454,246,7,7299,182
2020-08-24,Colombia,NA,Meta,1062454,232,7,7531,189
2020-08-25,Colombia,NA,Meta,1062454,296,4,7827,193
2020-08-26,Colombia,NA,Meta,1062454,298,6,8125,199
2020-08-27,Colombia,NA,Meta,1062454,353,13,8478,212
2020-08-28,Colombia,NA,Meta,1062454,226,14,8704,226
2020-08-29,Colombia,NA,Meta,1062454,139,10,8843,236
2020-08-30,Colombia,NA,Meta,1062454,293,8,9136,244
2020-08-31,Colombia,NA,Meta,1062454,239,12,9375,256
2020-09-01,Colombia,NA,Meta,1062454,385,11,9760,267
2020-09-02,Colombia,NA,Meta,1062454,377,9,10137,276
2020-09-03,Colombia,NA,Meta,1062454,146,8,10283,284
2020-09-04,Colombia,NA,Meta,1062454,377,6,10660,290
2020-09-05,Colombia,NA,Meta,1062454,263,8,10923,298
2020-09-06,Colombia,NA,Meta,1062454,181,10,11104,308
2020-09-07,Colombia,NA,Meta,1062454,401,5,11505,313
2020-09-08,Colombia,NA,Meta,1062454,178,9,11683,322
2020-09-09,Colombia,NA,Meta,1062454,276,9,11959,331
2020-09-10,Colombia,NA,Meta,1062454,392,4,12351,335
2020-09-11,Colombia,NA,Meta,1062454,155,11,12506,346
2020-09-12,Colombia,NA,Meta,1062454,250,8,12756,354
2020-09-13,Colombia,NA,Meta,1062454,170,5,12926,359
2020-09-14,Colombia,NA,Meta,1062454,189,10,13115,369
2020-09-15,Colombia,NA,Meta,1062454,286,5,13401,374
2020-09-16,Colombia,NA,Meta,1062454,213,9,13614,383
2020-09-17,Colombia,NA,Meta,1062454,358,5,13972,388
2020-09-18,Colombia,NA,Meta,1062454,164,2,14136,390
2020-09-19,Colombia,NA,Meta,1062454,166,6,14302,396
2020-09-20,Colombia,NA,Meta,1062454,116,3,14418,399
2020-09-21,Colombia,NA,Meta,1062454,291,4,14709,403
2020-09-22,Colombia,NA,Meta,1062454,203,4,14912,407
2020-09-23,Colombia,NA,Meta,1062454,181,2,15093,409
2020-04-09,Colombia,NA,Narino,1627589,19,1,28,2
2020-04-10,Colombia,NA,Narino,1627589,3,0,31,2
2020-04-11,Colombia,NA,Narino,1627589,7,1,38,3
2020-04-12,Colombia,NA,Narino,1627589,1,0,39,3
2020-04-14,Colombia,NA,Narino,1627589,3,1,42,4
2020-04-15,Colombia,NA,Narino,1627589,1,1,43,5
2020-04-16,Colombia,NA,Narino,1627589,2,0,45,5
2020-04-17,Colombia,NA,Narino,1627589,2,0,47,5
2020-04-18,Colombia,NA,Narino,1627589,1,1,48,6
2020-04-19,Colombia,NA,Narino,1627589,0,0,48,6
2020-04-20,Colombia,NA,Narino,1627589,5,0,53,6
2020-04-21,Colombia,NA,Narino,1627589,10,0,63,6
2020-04-22,Colombia,NA,Narino,1627589,0,0,63,6
2020-04-24,Colombia,NA,Narino,1627589,17,0,80,6
2020-04-25,Colombia,NA,Narino,1627589,13,0,93,6
2020-04-26,Colombia,NA,Narino,1627589,1,1,94,7
2020-04-27,Colombia,NA,Narino,1627589,3,0,97,7
2020-04-28,Colombia,NA,Narino,1627589,17,1,114,8
2020-04-29,Colombia,NA,Narino,1627589,5,1,119,9
2020-05-01,Colombia,NA,Narino,1627589,36,0,155,9
2020-05-02,Colombia,NA,Narino,1627589,3,1,158,10
2020-05-03,Colombia,NA,Narino,1627589,44,0,202,10
2020-05-04,Colombia,NA,Narino,1627589,0,2,202,12
2020-05-05,Colombia,NA,Narino,1627589,46,2,248,14
2020-05-06,Colombia,NA,Narino,1627589,6,0,254,14
2020-05-07,Colombia,NA,Narino,1627589,0,4,254,18
2020-05-08,Colombia,NA,Narino,1627589,0,2,254,20
2020-05-09,Colombia,NA,Narino,1627589,9,4,263,24
2020-05-10,Colombia,NA,Narino,1627589,34,1,297,25
2020-05-11,Colombia,NA,Narino,1627589,10,3,307,28
2020-05-12,Colombia,NA,Narino,1627589,32,1,339,29
2020-05-13,Colombia,NA,Narino,1627589,0,0,339,29
2020-05-14,Colombia,NA,Narino,1627589,39,2,378,31
2020-05-15,Colombia,NA,Narino,1627589,48,2,426,33
2020-05-16,Colombia,NA,Narino,1627589,65,1,491,34
2020-05-17,Colombia,NA,Narino,1627589,5,2,496,36
2020-05-18,Colombia,NA,Narino,1627589,4,3,500,39
2020-05-19,Colombia,NA,Narino,1627589,20,3,520,42
2020-05-20,Colombia,NA,Narino,1627589,32,3,552,45
2020-05-21,Colombia,NA,Narino,1627589,44,1,596,46
2020-05-22,Colombia,NA,Narino,1627589,40,3,636,49
2020-05-23,Colombia,NA,Narino,1627589,17,5,653,54
2020-05-24,Colombia,NA,Narino,1627589,60,3,713,57
2020-05-25,Colombia,NA,Narino,1627589,79,0,792,57
2020-05-26,Colombia,NA,Narino,1627589,13,4,805,61
2020-05-27,Colombia,NA,Narino,1627589,25,3,830,64
2020-05-28,Colombia,NA,Narino,1627589,43,1,873,65
2020-05-29,Colombia,NA,Narino,1627589,79,4,952,69
2020-05-30,Colombia,NA,Narino,1627589,61,4,1013,73
2020-05-31,Colombia,NA,Narino,1627589,102,1,1115,74
2020-06-01,Colombia,NA,Narino,1627589,106,3,1221,77
2020-06-02,Colombia,NA,Narino,1627589,50,1,1271,78
2020-06-03,Colombia,NA,Narino,1627589,77,3,1348,81
2020-06-04,Colombia,NA,Narino,1627589,38,2,1386,83
2020-06-05,Colombia,NA,Narino,1627589,47,7,1433,90
2020-06-06,Colombia,NA,Narino,1627589,120,1,1553,91
2020-06-07,Colombia,NA,Narino,1627589,74,1,1627,92
2020-06-08,Colombia,NA,Narino,1627589,78,1,1705,93
2020-06-09,Colombia,NA,Narino,1627589,93,1,1798,94
2020-06-10,Colombia,NA,Narino,1627589,195,1,1993,95
2020-06-11,Colombia,NA,Narino,1627589,59,1,2052,96
2020-06-12,Colombia,NA,Narino,1627589,11,0,2063,96
2020-06-13,Colombia,NA,Narino,1627589,32,0,2095,96
2020-06-14,Colombia,NA,Narino,1627589,40,4,2135,100
2020-06-15,Colombia,NA,Narino,1627589,12,3,2147,103
2020-06-16,Colombia,NA,Narino,1627589,35,4,2182,107
2020-06-17,Colombia,NA,Narino,1627589,18,1,2200,108
2020-06-18,Colombia,NA,Narino,1627589,167,2,2367,110
2020-06-19,Colombia,NA,Narino,1627589,99,0,2466,110
2020-06-20,Colombia,NA,Narino,1627589,31,2,2497,112
2020-06-21,Colombia,NA,Narino,1627589,128,5,2625,117
2020-06-22,Colombia,NA,Narino,1627589,62,1,2687,118
2020-06-23,Colombia,NA,Narino,1627589,33,3,2720,121
2020-06-24,Colombia,NA,Narino,1627589,103,0,2823,121
2020-06-25,Colombia,NA,Narino,1627589,102,1,2925,122
2020-06-26,Colombia,NA,Narino,1627589,115,3,3040,125
2020-06-27,Colombia,NA,Narino,1627589,88,1,3128,126
2020-06-28,Colombia,NA,Narino,1627589,118,1,3246,127
2020-06-29,Colombia,NA,Narino,1627589,108,2,3354,129
2020-06-30,Colombia,NA,Narino,1627589,3,1,3357,130
2020-07-01,Colombia,NA,Narino,1627589,89,2,3446,132
2020-07-02,Colombia,NA,Narino,1627589,61,4,3507,136
2020-07-03,Colombia,NA,Narino,1627589,110,1,3617,137
2020-07-04,Colombia,NA,Narino,1627589,69,2,3686,139
2020-07-05,Colombia,NA,Narino,1627589,165,3,3851,142
2020-07-06,Colombia,NA,Narino,1627589,72,2,3923,144
2020-07-07,Colombia,NA,Narino,1627589,111,4,4034,148
2020-07-08,Colombia,NA,Narino,1627589,57,2,4091,150
2020-07-09,Colombia,NA,Narino,1627589,186,5,4277,155
2020-07-10,Colombia,NA,Narino,1627589,164,9,4441,164
2020-07-11,Colombia,NA,Narino,1627589,109,2,4550,166
2020-07-12,Colombia,NA,Narino,1627589,91,8,4641,174
2020-07-13,Colombia,NA,Narino,1627589,162,8,4803,182
2020-07-14,Colombia,NA,Narino,1627589,137,5,4940,187
2020-07-15,Colombia,NA,Narino,1627589,201,7,5141,194
2020-07-16,Colombia,NA,Narino,1627589,141,4,5282,198
2020-07-17,Colombia,NA,Narino,1627589,47,5,5329,203
2020-07-18,Colombia,NA,Narino,1627589,292,5,5621,208
2020-07-19,Colombia,NA,Narino,1627589,233,7,5854,215
2020-07-20,Colombia,NA,Narino,1627589,175,8,6029,223
2020-07-21,Colombia,NA,Narino,1627589,208,3,6237,226
2020-07-22,Colombia,NA,Narino,1627589,347,9,6584,235
2020-07-23,Colombia,NA,Narino,1627589,279,9,6863,244
2020-07-24,Colombia,NA,Narino,1627589,134,8,6997,252
2020-07-25,Colombia,NA,Narino,1627589,163,9,7160,261
2020-07-26,Colombia,NA,Narino,1627589,183,10,7343,271
2020-07-27,Colombia,NA,Narino,1627589,275,5,7618,276
2020-07-28,Colombia,NA,Narino,1627589,308,14,7926,290
2020-07-29,Colombia,NA,Narino,1627589,218,9,8144,299
2020-07-30,Colombia,NA,Narino,1627589,155,12,8299,311
2020-07-31,Colombia,NA,Narino,1627589,138,6,8437,317
2020-08-01,Colombia,NA,Narino,1627589,103,3,8540,320
2020-08-02,Colombia,NA,Narino,1627589,165,5,8705,325
2020-08-03,Colombia,NA,Narino,1627589,225,11,8930,336
2020-08-04,Colombia,NA,Narino,1627589,195,11,9125,347
2020-08-05,Colombia,NA,Narino,1627589,224,11,9349,358
2020-08-06,Colombia,NA,Narino,1627589,118,13,9467,371
2020-08-07,Colombia,NA,Narino,1627589,231,11,9698,382
2020-08-08,Colombia,NA,Narino,1627589,179,10,9877,392
2020-08-09,Colombia,NA,Narino,1627589,230,15,10107,407
2020-08-10,Colombia,NA,Narino,1627589,283,14,10390,421
2020-08-11,Colombia,NA,Narino,1627589,533,8,10923,429
2020-08-12,Colombia,NA,Narino,1627589,255,12,11178,441
2020-08-13,Colombia,NA,Narino,1627589,244,14,11422,455
2020-08-14,Colombia,NA,Narino,1627589,295,8,11717,463
2020-08-15,Colombia,NA,Narino,1627589,115,7,11832,470
2020-08-16,Colombia,NA,Narino,1627589,216,7,12048,477
2020-08-17,Colombia,NA,Narino,1627589,223,7,12271,484
2020-08-18,Colombia,NA,Narino,1627589,122,10,12393,494
2020-08-19,Colombia,NA,Narino,1627589,181,9,12574,503
2020-08-20,Colombia,NA,Narino,1627589,437,2,13011,505
2020-08-21,Colombia,NA,Narino,1627589,156,5,13167,510
2020-08-22,Colombia,NA,Narino,1627589,164,9,13331,519
2020-08-23,Colombia,NA,Narino,1627589,85,8,13416,527
2020-08-24,Colombia,NA,Narino,1627589,184,10,13600,537
2020-08-25,Colombia,NA,Narino,1627589,256,5,13856,542
2020-08-26,Colombia,NA,Narino,1627589,142,11,13998,553
2020-08-27,Colombia,NA,Narino,1627589,176,6,14174,559
2020-08-28,Colombia,NA,Narino,1627589,174,7,14348,566
2020-08-29,Colombia,NA,Narino,1627589,155,11,14503,577
2020-08-30,Colombia,NA,Narino,1627589,131,11,14634,588
2020-08-31,Colombia,NA,Narino,1627589,200,9,14834,597
2020-09-01,Colombia,NA,Narino,1627589,109,7,14943,604
2020-09-02,Colombia,NA,Narino,1627589,227,3,15170,607
2020-09-03,Colombia,NA,Narino,1627589,179,6,15349,613
2020-09-04,Colombia,NA,Narino,1627589,132,11,15481,624
2020-09-05,Colombia,NA,Narino,1627589,109,5,15590,629
2020-09-06,Colombia,NA,Narino,1627589,136,5,15726,634
2020-09-07,Colombia,NA,Narino,1627589,105,5,15831,639
2020-09-08,Colombia,NA,Narino,1627589,94,3,15925,642
2020-09-09,Colombia,NA,Narino,1627589,209,5,16134,647
2020-09-10,Colombia,NA,Narino,1627589,118,6,16252,653
2020-09-11,Colombia,NA,Narino,1627589,116,7,16368,660
2020-09-12,Colombia,NA,Narino,1627589,88,6,16456,666
2020-09-13,Colombia,NA,Narino,1627589,98,8,16554,674
2020-09-14,Colombia,NA,Narino,1627589,99,9,16653,683
2020-09-15,Colombia,NA,Narino,1627589,117,3,16770,686
2020-09-16,Colombia,NA,Narino,1627589,99,5,16869,691
2020-09-17,Colombia,NA,Narino,1627589,293,5,17162,696
2020-09-18,Colombia,NA,Narino,1627589,139,4,17301,700
2020-09-19,Colombia,NA,Narino,1627589,65,5,17366,705
2020-09-20,Colombia,NA,Narino,1627589,72,4,17438,709
2020-09-21,Colombia,NA,Narino,1627589,54,5,17492,714
2020-09-22,Colombia,NA,Narino,1627589,108,2,17600,716
2020-09-23,Colombia,NA,Narino,1627589,55,0,17655,716
2020-03-24,Colombia,NA,Norte de Santander,1620318,3,0,11,0
2020-03-25,Colombia,NA,Norte de Santander,1620318,4,0,15,0
2020-03-27,Colombia,NA,Norte de Santander,1620318,0,1,15,1
2020-03-28,Colombia,NA,Norte de Santander,1620318,0,1,15,2
2020-03-29,Colombia,NA,Norte de Santander,1620318,0,0,15,2
2020-03-30,Colombia,NA,Norte de Santander,1620318,1,0,16,2
2020-03-31,Colombia,NA,Norte de Santander,1620318,3,0,19,2
2020-04-02,Colombia,NA,Norte de Santander,1620318,2,0,21,2
2020-04-03,Colombia,NA,Norte de Santander,1620318,4,0,25,2
2020-04-06,Colombia,NA,Norte de Santander,1620318,0,1,25,3
2020-04-08,Colombia,NA,Norte de Santander,1620318,2,1,27,4
2020-04-09,Colombia,NA,Norte de Santander,1620318,11,0,38,4
2020-04-10,Colombia,NA,Norte de Santander,1620318,2,0,40,4
2020-04-11,Colombia,NA,Norte de Santander,1620318,1,0,41,4
2020-04-12,Colombia,NA,Norte de Santander,1620318,2,0,43,4
2020-04-14,Colombia,NA,Norte de Santander,1620318,7,0,50,4
2020-04-15,Colombia,NA,Norte de Santander,1620318,7,0,57,4
2020-04-16,Colombia,NA,Norte de Santander,1620318,0,0,57,4
2020-04-17,Colombia,NA,Norte de Santander,1620318,0,0,57,4
2020-04-18,Colombia,NA,Norte de Santander,1620318,2,0,59,4
2020-04-19,Colombia,NA,Norte de Santander,1620318,0,0,59,4
2020-04-21,Colombia,NA,Norte de Santander,1620318,0,0,59,4
2020-04-22,Colombia,NA,Norte de Santander,1620318,1,0,60,4
2020-04-23,Colombia,NA,Norte de Santander,1620318,0,0,60,4
2020-04-24,Colombia,NA,Norte de Santander,1620318,0,1,60,5
2020-04-25,Colombia,NA,Norte de Santander,1620318,0,0,60,5
2020-04-26,Colombia,NA,Norte de Santander,1620318,1,2,61,7
2020-04-27,Colombia,NA,Norte de Santander,1620318,1,0,62,7
2020-04-28,Colombia,NA,Norte de Santander,1620318,7,0,69,7
2020-04-29,Colombia,NA,Norte de Santander,1620318,0,1,69,8
2020-04-30,Colombia,NA,Norte de Santander,1620318,1,0,70,8
2020-05-01,Colombia,NA,Norte de Santander,1620318,4,0,74,8
2020-05-02,Colombia,NA,Norte de Santander,1620318,10,0,84,8
2020-05-03,Colombia,NA,Norte de Santander,1620318,0,1,84,9
2020-05-05,Colombia,NA,Norte de Santander,1620318,1,0,85,9
2020-05-06,Colombia,NA,Norte de Santander,1620318,0,0,85,9
2020-05-07,Colombia,NA,Norte de Santander,1620318,0,1,85,10
2020-05-08,Colombia,NA,Norte de Santander,1620318,6,0,91,10
2020-05-09,Colombia,NA,Norte de Santander,1620318,3,0,94,10
2020-05-10,Colombia,NA,Norte de Santander,1620318,5,0,99,10
2020-05-11,Colombia,NA,Norte de Santander,1620318,0,1,99,11
2020-05-12,Colombia,NA,Norte de Santander,1620318,5,0,104,11
2020-05-13,Colombia,NA,Norte de Santander,1620318,0,0,104,11
2020-05-14,Colombia,NA,Norte de Santander,1620318,1,0,105,11
2020-05-15,Colombia,NA,Norte de Santander,1620318,2,1,107,12
2020-05-16,Colombia,NA,Norte de Santander,1620318,5,0,112,12
2020-05-17,Colombia,NA,Norte de Santander,1620318,1,0,113,12
2020-05-18,Colombia,NA,Norte de Santander,1620318,1,0,114,12
2020-05-19,Colombia,NA,Norte de Santander,1620318,0,0,114,12
2020-05-20,Colombia,NA,Norte de Santander,1620318,2,0,116,12
2020-05-21,Colombia,NA,Norte de Santander,1620318,0,1,116,13
2020-05-22,Colombia,NA,Norte de Santander,1620318,3,0,119,13
2020-05-24,Colombia,NA,Norte de Santander,1620318,0,0,119,13
2020-05-25,Colombia,NA,Norte de Santander,1620318,0,0,119,13
2020-05-26,Colombia,NA,Norte de Santander,1620318,2,0,121,13
2020-05-27,Colombia,NA,Norte de Santander,1620318,3,0,124,13
2020-05-28,Colombia,NA,Norte de Santander,1620318,4,0,128,13
2020-05-29,Colombia,NA,Norte de Santander,1620318,0,1,128,14
2020-05-30,Colombia,NA,Norte de Santander,1620318,0,0,128,14
2020-05-31,Colombia,NA,Norte de Santander,1620318,0,0,128,14
2020-06-01,Colombia,NA,Norte de Santander,1620318,0,0,128,14
2020-06-02,Colombia,NA,Norte de Santander,1620318,1,0,129,14
2020-06-03,Colombia,NA,Norte de Santander,1620318,3,0,132,14
2020-06-04,Colombia,NA,Norte de Santander,1620318,0,0,132,14
2020-06-05,Colombia,NA,Norte de Santander,1620318,0,0,132,14
2020-06-07,Colombia,NA,Norte de Santander,1620318,6,1,138,15
2020-06-08,Colombia,NA,Norte de Santander,1620318,7,0,145,15
2020-06-09,Colombia,NA,Norte de Santander,1620318,3,1,148,16
2020-06-10,Colombia,NA,Norte de Santander,1620318,0,0,148,16
2020-06-12,Colombia,NA,Norte de Santander,1620318,0,0,148,16
2020-06-13,Colombia,NA,Norte de Santander,1620318,9,0,157,16
2020-06-14,Colombia,NA,Norte de Santander,1620318,2,0,159,16
2020-06-15,Colombia,NA,Norte de Santander,1620318,1,0,160,16
2020-06-16,Colombia,NA,Norte de Santander,1620318,4,2,164,18
2020-06-17,Colombia,NA,Norte de Santander,1620318,1,0,165,18
2020-06-18,Colombia,NA,Norte de Santander,1620318,19,1,184,19
2020-06-19,Colombia,NA,Norte de Santander,1620318,17,0,201,19
2020-06-20,Colombia,NA,Norte de Santander,1620318,23,0,224,19
2020-06-21,Colombia,NA,Norte de Santander,1620318,18,0,242,19
2020-06-22,Colombia,NA,Norte de Santander,1620318,4,2,246,21
2020-06-23,Colombia,NA,Norte de Santander,1620318,8,0,254,21
2020-06-24,Colombia,NA,Norte de Santander,1620318,13,1,267,22
2020-06-25,Colombia,NA,Norte de Santander,1620318,8,1,275,23
2020-06-26,Colombia,NA,Norte de Santander,1620318,9,0,284,23
2020-06-27,Colombia,NA,Norte de Santander,1620318,18,1,302,24
2020-06-28,Colombia,NA,Norte de Santander,1620318,16,0,318,24
2020-06-29,Colombia,NA,Norte de Santander,1620318,6,0,324,24
2020-06-30,Colombia,NA,Norte de Santander,1620318,2,1,326,25
2020-07-01,Colombia,NA,Norte de Santander,1620318,9,1,335,26
2020-07-02,Colombia,NA,Norte de Santander,1620318,5,0,340,26
2020-07-03,Colombia,NA,Norte de Santander,1620318,11,0,351,26
2020-07-04,Colombia,NA,Norte de Santander,1620318,40,3,391,29
2020-07-05,Colombia,NA,Norte de Santander,1620318,30,1,421,30
2020-07-06,Colombia,NA,Norte de Santander,1620318,29,0,450,30
2020-07-07,Colombia,NA,Norte de Santander,1620318,48,2,498,32
2020-07-08,Colombia,NA,Norte de Santander,1620318,12,1,510,33
2020-07-09,Colombia,NA,Norte de Santander,1620318,35,2,545,35
2020-07-10,Colombia,NA,Norte de Santander,1620318,85,0,630,35
2020-07-11,Colombia,NA,Norte de Santander,1620318,68,1,698,36
2020-07-12,Colombia,NA,Norte de Santander,1620318,38,1,736,37
2020-07-13,Colombia,NA,Norte de Santander,1620318,69,4,805,41
2020-07-14,Colombia,NA,Norte de Santander,1620318,86,2,891,43
2020-07-15,Colombia,NA,Norte de Santander,1620318,75,3,966,46
2020-07-16,Colombia,NA,Norte de Santander,1620318,65,2,1031,48
2020-07-17,Colombia,NA,Norte de Santander,1620318,75,9,1106,57
2020-07-18,Colombia,NA,Norte de Santander,1620318,74,3,1180,60
2020-07-19,Colombia,NA,Norte de Santander,1620318,64,7,1244,67
2020-07-20,Colombia,NA,Norte de Santander,1620318,57,7,1301,74
2020-07-21,Colombia,NA,Norte de Santander,1620318,132,14,1433,88
2020-07-22,Colombia,NA,Norte de Santander,1620318,254,7,1687,95
2020-07-23,Colombia,NA,Norte de Santander,1620318,178,7,1865,102
2020-07-24,Colombia,NA,Norte de Santander,1620318,231,8,2096,110
2020-07-25,Colombia,NA,Norte de Santander,1620318,66,20,2162,130
2020-07-26,Colombia,NA,Norte de Santander,1620318,114,11,2276,141
2020-07-27,Colombia,NA,Norte de Santander,1620318,136,20,2412,161
2020-07-28,Colombia,NA,Norte de Santander,1620318,230,11,2642,172
2020-07-29,Colombia,NA,Norte de Santander,1620318,125,15,2767,187
2020-07-30,Colombia,NA,Norte de Santander,1620318,239,11,3006,198
2020-07-31,Colombia,NA,Norte de Santander,1620318,133,18,3139,216
2020-08-01,Colombia,NA,Norte de Santander,1620318,146,21,3285,237
2020-08-02,Colombia,NA,Norte de Santander,1620318,105,15,3390,252
2020-08-03,Colombia,NA,Norte de Santander,1620318,264,25,3654,277
2020-08-04,Colombia,NA,Norte de Santander,1620318,287,20,3941,297
2020-08-05,Colombia,NA,Norte de Santander,1620318,137,18,4078,315
2020-08-06,Colombia,NA,Norte de Santander,1620318,474,17,4552,332
2020-08-07,Colombia,NA,Norte de Santander,1620318,398,23,4950,355
2020-08-08,Colombia,NA,Norte de Santander,1620318,274,25,5224,380
2020-08-09,Colombia,NA,Norte de Santander,1620318,129,21,5353,401
2020-08-10,Colombia,NA,Norte de Santander,1620318,300,18,5653,419
2020-08-11,Colombia,NA,Norte de Santander,1620318,389,18,6042,437
2020-08-12,Colombia,NA,Norte de Santander,1620318,401,18,6443,455
2020-08-13,Colombia,NA,Norte de Santander,1620318,262,20,6705,475
2020-08-14,Colombia,NA,Norte de Santander,1620318,326,13,7031,488
2020-08-15,Colombia,NA,Norte de Santander,1620318,304,24,7335,512
2020-08-16,Colombia,NA,Norte de Santander,1620318,214,20,7549,532
2020-08-17,Colombia,NA,Norte de Santander,1620318,228,12,7777,544
2020-08-18,Colombia,NA,Norte de Santander,1620318,185,12,7962,556
2020-08-19,Colombia,NA,Norte de Santander,1620318,500,22,8462,578
2020-08-20,Colombia,NA,Norte de Santander,1620318,253,14,8715,592
2020-08-21,Colombia,NA,Norte de Santander,1620318,333,14,9048,606
2020-08-22,Colombia,NA,Norte de Santander,1620318,157,15,9205,621
2020-08-23,Colombia,NA,Norte de Santander,1620318,84,15,9289,636
2020-08-24,Colombia,NA,Norte de Santander,1620318,335,13,9624,649
2020-08-25,Colombia,NA,Norte de Santander,1620318,563,14,10187,663
2020-08-26,Colombia,NA,Norte de Santander,1620318,415,19,10602,682
2020-08-27,Colombia,NA,Norte de Santander,1620318,453,11,11055,693
2020-08-28,Colombia,NA,Norte de Santander,1620318,390,14,11445,707
2020-08-29,Colombia,NA,Norte de Santander,1620318,284,18,11729,725
2020-08-30,Colombia,NA,Norte de Santander,1620318,217,7,11946,732
2020-08-31,Colombia,NA,Norte de Santander,1620318,122,12,12068,744
2020-09-01,Colombia,NA,Norte de Santander,1620318,163,11,12231,755
2020-09-02,Colombia,NA,Norte de Santander,1620318,162,11,12393,766
2020-09-03,Colombia,NA,Norte de Santander,1620318,68,7,12461,773
2020-09-04,Colombia,NA,Norte de Santander,1620318,252,6,12713,779
2020-09-05,Colombia,NA,Norte de Santander,1620318,86,6,12799,785
2020-09-06,Colombia,NA,Norte de Santander,1620318,137,7,12936,792
2020-09-07,Colombia,NA,Norte de Santander,1620318,89,9,13025,801
2020-09-08,Colombia,NA,Norte de Santander,1620318,141,6,13166,807
2020-09-09,Colombia,NA,Norte de Santander,1620318,173,12,13339,819
2020-09-10,Colombia,NA,Norte de Santander,1620318,213,13,13552,832
2020-09-11,Colombia,NA,Norte de Santander,1620318,69,6,13621,838
2020-09-12,Colombia,NA,Norte de Santander,1620318,89,1,13710,839
2020-09-13,Colombia,NA,Norte de Santander,1620318,23,3,13733,842
2020-09-14,Colombia,NA,Norte de Santander,1620318,163,6,13896,848
2020-09-15,Colombia,NA,Norte de Santander,1620318,159,6,14055,854
2020-09-16,Colombia,NA,Norte de Santander,1620318,100,6,14155,860
2020-09-17,Colombia,NA,Norte de Santander,1620318,141,9,14296,869
2020-09-18,Colombia,NA,Norte de Santander,1620318,138,3,14434,872
2020-09-19,Colombia,NA,Norte de Santander,1620318,112,3,14546,875
2020-09-20,Colombia,NA,Norte de Santander,1620318,33,6,14579,881
2020-09-21,Colombia,NA,Norte de Santander,1620318,226,6,14805,887
2020-09-22,Colombia,NA,Norte de Santander,1620318,118,6,14923,893
2020-09-23,Colombia,NA,Norte de Santander,1620318,61,1,14984,894
2020-06-05,Colombia,NA,Putumayo,359127,1,0,11,2
2020-06-08,Colombia,NA,Putumayo,359127,0,1,11,2
2020-06-09,Colombia,NA,Putumayo,359127,0,0,11,2
2020-06-10,Colombia,NA,Putumayo,359127,0,0,11,2
2020-06-11,Colombia,NA,Putumayo,359127,1,0,12,2
2020-06-14,Colombia,NA,Putumayo,359127,1,0,13,2
2020-06-15,Colombia,NA,Putumayo,359127,0,1,13,2
2020-06-17,Colombia,NA,Putumayo,359127,2,0,15,3
2020-06-20,Colombia,NA,Putumayo,359127,2,0,17,3
2020-06-22,Colombia,NA,Putumayo,359127,0,2,17,3
2020-06-23,Colombia,NA,Putumayo,359127,2,0,19,3
2020-06-28,Colombia,NA,Putumayo,359127,3,1,22,4
2020-06-29,Colombia,NA,Putumayo,359127,4,0,26,5
2020-06-30,Colombia,NA,Putumayo,359127,2,0,28,5
2020-07-01,Colombia,NA,Putumayo,359127,1,0,29,5
2020-07-02,Colombia,NA,Putumayo,359127,2,1,31,6
2020-07-03,Colombia,NA,Putumayo,359127,4,0,35,7
2020-07-04,Colombia,NA,Putumayo,359127,3,0,38,7
2020-07-06,Colombia,NA,Putumayo,359127,2,0,40,8
2020-07-07,Colombia,NA,Putumayo,359127,0,1,40,8
2020-07-08,Colombia,NA,Putumayo,359127,1,0,41,8
2020-07-09,Colombia,NA,Putumayo,359127,2,2,43,8
2020-07-10,Colombia,NA,Putumayo,359127,12,0,55,11
2020-07-11,Colombia,NA,Putumayo,359127,40,3,95,14
2020-07-12,Colombia,NA,Putumayo,359127,15,4,110,18
2020-07-13,Colombia,NA,Putumayo,359127,41,0,151,18
2020-07-14,Colombia,NA,Putumayo,359127,5,2,156,20
2020-07-15,Colombia,NA,Putumayo,359127,13,2,169,22
2020-07-16,Colombia,NA,Putumayo,359127,22,1,191,23
2020-07-17,Colombia,NA,Putumayo,359127,70,0,261,23
2020-07-18,Colombia,NA,Putumayo,359127,61,1,322,24
2020-07-19,Colombia,NA,Putumayo,359127,2,3,324,27
2020-07-20,Colombia,NA,Putumayo,359127,27,2,351,29
2020-07-21,Colombia,NA,Putumayo,359127,58,3,409,32
2020-07-22,Colombia,NA,Putumayo,359127,183,4,592,36
2020-07-23,Colombia,NA,Putumayo,359127,97,2,689,38
2020-07-24,Colombia,NA,Putumayo,359127,50,4,739,42
2020-07-25,Colombia,NA,Putumayo,359127,5,3,744,45
2020-07-26,Colombia,NA,Putumayo,359127,118,3,862,48
2020-07-27,Colombia,NA,Putumayo,359127,75,4,937,52
2020-07-28,Colombia,NA,Putumayo,359127,17,0,954,52
2020-07-29,Colombia,NA,Putumayo,359127,73,6,1027,58
2020-07-30,Colombia,NA,Putumayo,359127,53,4,1080,62
2020-07-31,Colombia,NA,Putumayo,359127,14,1,1094,63
2020-08-01,Colombia,NA,Putumayo,359127,56,6,1150,69
2020-08-02,Colombia,NA,Putumayo,359127,98,2,1248,71
2020-08-03,Colombia,NA,Putumayo,359127,87,5,1335,76
2020-08-04,Colombia,NA,Putumayo,359127,85,2,1420,78
2020-08-05,Colombia,NA,Putumayo,359127,16,6,1436,84
2020-08-06,Colombia,NA,Putumayo,359127,30,3,1466,87
2020-08-07,Colombia,NA,Putumayo,359127,32,0,1498,87
2020-08-08,Colombia,NA,Putumayo,359127,30,3,1528,90
2020-08-09,Colombia,NA,Putumayo,359127,152,5,1680,95
2020-08-10,Colombia,NA,Putumayo,359127,15,2,1695,97
2020-08-11,Colombia,NA,Putumayo,359127,122,8,1817,105
2020-08-12,Colombia,NA,Putumayo,359127,46,1,1863,106
2020-08-13,Colombia,NA,Putumayo,359127,142,8,2005,114
2020-08-14,Colombia,NA,Putumayo,359127,44,2,2049,116
2020-08-15,Colombia,NA,Putumayo,359127,26,5,2075,121
2020-08-16,Colombia,NA,Putumayo,359127,157,1,2232,122
2020-08-17,Colombia,NA,Putumayo,359127,64,2,2296,124
2020-08-18,Colombia,NA,Putumayo,359127,34,4,2330,128
2020-08-19,Colombia,NA,Putumayo,359127,41,2,2371,130
2020-08-20,Colombia,NA,Putumayo,359127,78,3,2449,133
2020-08-21,Colombia,NA,Putumayo,359127,54,3,2503,136
2020-08-22,Colombia,NA,Putumayo,359127,43,2,2546,138
2020-08-23,Colombia,NA,Putumayo,359127,58,0,2604,138
2020-08-24,Colombia,NA,Putumayo,359127,48,2,2652,140
2020-08-25,Colombia,NA,Putumayo,359127,71,3,2723,143
2020-08-26,Colombia,NA,Putumayo,359127,49,2,2772,145
2020-08-27,Colombia,NA,Putumayo,359127,71,0,2843,145
2020-08-28,Colombia,NA,Putumayo,359127,51,2,2894,147
2020-08-29,Colombia,NA,Putumayo,359127,23,1,2917,148
2020-08-30,Colombia,NA,Putumayo,359127,129,0,3046,148
2020-08-31,Colombia,NA,Putumayo,359127,38,3,3084,151
2020-09-01,Colombia,NA,Putumayo,359127,23,0,3107,151
2020-09-02,Colombia,NA,Putumayo,359127,108,2,3215,153
2020-09-03,Colombia,NA,Putumayo,359127,20,0,3235,153
2020-09-04,Colombia,NA,Putumayo,359127,26,2,3261,155
2020-09-05,Colombia,NA,Putumayo,359127,86,1,3347,156
2020-09-06,Colombia,NA,Putumayo,359127,39,0,3386,156
2020-09-07,Colombia,NA,Putumayo,359127,8,1,3394,157
2020-09-08,Colombia,NA,Putumayo,359127,11,0,3405,157
2020-09-09,Colombia,NA,Putumayo,359127,29,2,3434,159
2020-09-10,Colombia,NA,Putumayo,359127,44,1,3478,160
2020-09-11,Colombia,NA,Putumayo,359127,16,2,3494,162
2020-09-12,Colombia,NA,Putumayo,359127,20,3,3514,165
2020-09-13,Colombia,NA,Putumayo,359127,16,0,3530,165
2020-09-14,Colombia,NA,Putumayo,359127,18,1,3548,166
2020-09-15,Colombia,NA,Putumayo,359127,17,0,3565,166
2020-09-16,Colombia,NA,Putumayo,359127,18,1,3583,167
2020-09-17,Colombia,NA,Putumayo,359127,28,0,3611,167
2020-09-18,Colombia,NA,Putumayo,359127,19,0,3630,167
2020-09-19,Colombia,NA,Putumayo,359127,17,2,3647,169
2020-09-20,Colombia,NA,Putumayo,359127,12,1,3659,170
2020-09-21,Colombia,NA,Putumayo,359127,12,1,3671,171
2020-09-22,Colombia,NA,Putumayo,359127,9,1,3680,172
2020-09-23,Colombia,NA,Putumayo,359127,9,0,3689,172
2020-03-25,Colombia,NA,Quindio,555401,4,0,12,0
2020-03-27,Colombia,NA,Quindio,555401,3,0,15,0
2020-03-28,Colombia,NA,Quindio,555401,1,0,16,0
2020-03-29,Colombia,NA,Quindio,555401,0,0,16,0
2020-03-30,Colombia,NA,Quindio,555401,0,0,16,0
2020-04-01,Colombia,NA,Quindio,555401,7,0,23,0
2020-04-03,Colombia,NA,Quindio,555401,0,1,23,1
2020-04-04,Colombia,NA,Quindio,555401,0,1,23,2
2020-04-05,Colombia,NA,Quindio,555401,0,0,23,2
2020-04-08,Colombia,NA,Quindio,555401,17,0,40,2
2020-04-09,Colombia,NA,Quindio,555401,1,0,41,2
2020-04-10,Colombia,NA,Quindio,555401,3,0,44,2
2020-04-11,Colombia,NA,Quindio,555401,3,0,47,2
2020-04-12,Colombia,NA,Quindio,555401,0,0,47,2
2020-04-13,Colombia,NA,Quindio,555401,2,0,49,2
2020-04-15,Colombia,NA,Quindio,555401,0,0,49,2
2020-04-17,Colombia,NA,Quindio,555401,2,0,51,2
2020-04-18,Colombia,NA,Quindio,555401,2,0,53,2
2020-04-19,Colombia,NA,Quindio,555401,0,0,53,2
2020-04-20,Colombia,NA,Quindio,555401,2,0,55,2
2020-04-21,Colombia,NA,Quindio,555401,0,0,55,2
2020-04-23,Colombia,NA,Quindio,555401,0,0,55,2
2020-04-24,Colombia,NA,Quindio,555401,0,0,55,2
2020-04-25,Colombia,NA,Quindio,555401,0,0,55,2
2020-04-26,Colombia,NA,Quindio,555401,1,0,56,2
2020-04-27,Colombia,NA,Quindio,555401,2,0,58,2
2020-04-28,Colombia,NA,Quindio,555401,1,0,59,2
2020-04-29,Colombia,NA,Quindio,555401,0,0,59,2
2020-04-30,Colombia,NA,Quindio,555401,0,0,59,2
2020-05-01,Colombia,NA,Quindio,555401,1,0,60,2
2020-05-02,Colombia,NA,Quindio,555401,0,1,60,3
2020-05-04,Colombia,NA,Quindio,555401,0,0,60,3
2020-05-05,Colombia,NA,Quindio,555401,3,0,63,3
2020-05-06,Colombia,NA,Quindio,555401,0,0,63,3
2020-05-07,Colombia,NA,Quindio,555401,2,0,65,3
2020-05-08,Colombia,NA,Quindio,555401,1,0,66,3
2020-05-09,Colombia,NA,Quindio,555401,0,0,66,3
2020-05-10,Colombia,NA,Quindio,555401,1,0,67,3
2020-05-11,Colombia,NA,Quindio,555401,3,1,70,4
2020-05-13,Colombia,NA,Quindio,555401,7,0,77,4
2020-05-14,Colombia,NA,Quindio,555401,0,0,77,4
2020-05-15,Colombia,NA,Quindio,555401,1,0,78,4
2020-05-16,Colombia,NA,Quindio,555401,1,0,79,4
2020-05-17,Colombia,NA,Quindio,555401,0,0,79,4
2020-05-18,Colombia,NA,Quindio,555401,2,0,81,4
2020-05-19,Colombia,NA,Quindio,555401,0,0,81,4
2020-05-20,Colombia,NA,Quindio,555401,3,0,84,4
2020-05-21,Colombia,NA,Quindio,555401,0,0,84,4
2020-05-22,Colombia,NA,Quindio,555401,2,0,86,4
2020-05-23,Colombia,NA,Quindio,555401,2,0,88,4
2020-05-24,Colombia,NA,Quindio,555401,1,0,89,4
2020-05-25,Colombia,NA,Quindio,555401,5,0,94,4
2020-05-26,Colombia,NA,Quindio,555401,0,0,94,4
2020-05-27,Colombia,NA,Quindio,555401,13,0,107,4
2020-05-28,Colombia,NA,Quindio,555401,0,1,107,5
2020-05-29,Colombia,NA,Quindio,555401,0,0,107,5
2020-05-30,Colombia,NA,Quindio,555401,0,0,107,5
2020-05-31,Colombia,NA,Quindio,555401,4,0,111,5
2020-06-01,Colombia,NA,Quindio,555401,1,0,112,5
2020-06-02,Colombia,NA,Quindio,555401,1,0,113,5
2020-06-03,Colombia,NA,Quindio,555401,6,0,119,5
2020-06-04,Colombia,NA,Quindio,555401,0,0,119,5
2020-06-05,Colombia,NA,Quindio,555401,1,0,120,5
2020-06-06,Colombia,NA,Quindio,555401,1,0,121,5
2020-06-07,Colombia,NA,Quindio,555401,0,1,121,6
2020-06-09,Colombia,NA,Quindio,555401,1,0,122,6
2020-06-10,Colombia,NA,Quindio,555401,0,0,122,6
2020-06-11,Colombia,NA,Quindio,555401,2,0,124,6
2020-06-13,Colombia,NA,Quindio,555401,1,0,125,6
2020-06-14,Colombia,NA,Quindio,555401,1,0,126,6
2020-06-15,Colombia,NA,Quindio,555401,2,0,128,6
2020-06-16,Colombia,NA,Quindio,555401,1,0,129,6
2020-06-17,Colombia,NA,Quindio,555401,2,0,131,6
2020-06-18,Colombia,NA,Quindio,555401,8,0,139,6
2020-06-19,Colombia,NA,Quindio,555401,3,1,142,7
2020-06-20,Colombia,NA,Quindio,555401,3,0,145,7
2020-06-21,Colombia,NA,Quindio,555401,2,0,147,7
2020-06-22,Colombia,NA,Quindio,555401,2,0,149,7
2020-06-23,Colombia,NA,Quindio,555401,1,0,150,7
2020-06-24,Colombia,NA,Quindio,555401,2,0,152,7
2020-06-25,Colombia,NA,Quindio,555401,4,0,156,7
2020-06-26,Colombia,NA,Quindio,555401,2,0,158,7
2020-06-27,Colombia,NA,Quindio,555401,1,0,159,7
2020-06-28,Colombia,NA,Quindio,555401,0,0,159,7
2020-06-29,Colombia,NA,Quindio,555401,5,0,164,7
2020-06-30,Colombia,NA,Quindio,555401,2,0,166,7
2020-07-02,Colombia,NA,Quindio,555401,1,0,167,7
2020-07-03,Colombia,NA,Quindio,555401,1,0,168,7
2020-07-04,Colombia,NA,Quindio,555401,9,0,177,7
2020-07-05,Colombia,NA,Quindio,555401,0,0,177,7
2020-07-06,Colombia,NA,Quindio,555401,0,0,177,7
2020-07-07,Colombia,NA,Quindio,555401,0,0,177,7
2020-07-08,Colombia,NA,Quindio,555401,3,0,180,7
2020-07-09,Colombia,NA,Quindio,555401,8,1,188,8
2020-07-10,Colombia,NA,Quindio,555401,4,0,192,8
2020-07-11,Colombia,NA,Quindio,555401,1,0,193,8
2020-07-12,Colombia,NA,Quindio,555401,0,0,193,8
2020-07-13,Colombia,NA,Quindio,555401,7,0,200,8
2020-07-14,Colombia,NA,Quindio,555401,4,1,204,9
2020-07-15,Colombia,NA,Quindio,555401,1,0,205,9
2020-07-16,Colombia,NA,Quindio,555401,3,0,208,9
2020-07-17,Colombia,NA,Quindio,555401,1,0,209,9
2020-07-18,Colombia,NA,Quindio,555401,4,0,213,9
2020-07-19,Colombia,NA,Quindio,555401,4,0,217,9
2020-07-20,Colombia,NA,Quindio,555401,2,0,219,9
2020-07-21,Colombia,NA,Quindio,555401,1,0,220,9
2020-07-22,Colombia,NA,Quindio,555401,10,0,230,9
2020-07-23,Colombia,NA,Quindio,555401,9,0,239,9
2020-07-24,Colombia,NA,Quindio,555401,13,0,252,9
2020-07-25,Colombia,NA,Quindio,555401,3,0,255,9
2020-07-26,Colombia,NA,Quindio,555401,14,1,269,10
2020-07-27,Colombia,NA,Quindio,555401,5,0,274,10
2020-07-28,Colombia,NA,Quindio,555401,40,2,314,12
2020-07-29,Colombia,NA,Quindio,555401,20,0,334,12
2020-07-30,Colombia,NA,Quindio,555401,31,0,365,12
2020-07-31,Colombia,NA,Quindio,555401,9,0,374,12
2020-08-01,Colombia,NA,Quindio,555401,15,1,389,13
2020-08-02,Colombia,NA,Quindio,555401,13,0,402,13
2020-08-03,Colombia,NA,Quindio,555401,15,0,417,13
2020-08-04,Colombia,NA,Quindio,555401,44,1,461,14
2020-08-05,Colombia,NA,Quindio,555401,19,1,480,15
2020-08-06,Colombia,NA,Quindio,555401,5,1,485,16
2020-08-07,Colombia,NA,Quindio,555401,23,1,508,17
2020-08-08,Colombia,NA,Quindio,555401,23,0,531,17
2020-08-09,Colombia,NA,Quindio,555401,2,0,533,17
2020-08-10,Colombia,NA,Quindio,555401,33,0,566,17
2020-08-11,Colombia,NA,Quindio,555401,10,2,576,19
2020-08-12,Colombia,NA,Quindio,555401,14,2,590,21
2020-08-13,Colombia,NA,Quindio,555401,58,2,648,23
2020-08-14,Colombia,NA,Quindio,555401,23,1,671,24
2020-08-15,Colombia,NA,Quindio,555401,18,1,689,25
2020-08-16,Colombia,NA,Quindio,555401,11,1,700,26
2020-08-17,Colombia,NA,Quindio,555401,10,0,710,26
2020-08-18,Colombia,NA,Quindio,555401,28,2,738,28
2020-08-19,Colombia,NA,Quindio,555401,21,3,759,31
2020-08-20,Colombia,NA,Quindio,555401,72,2,831,33
2020-08-21,Colombia,NA,Quindio,555401,45,0,876,33
2020-08-22,Colombia,NA,Quindio,555401,48,2,924,35
2020-08-23,Colombia,NA,Quindio,555401,27,1,951,36
2020-08-24,Colombia,NA,Quindio,555401,41,1,992,37
2020-08-25,Colombia,NA,Quindio,555401,34,2,1026,39
2020-08-26,Colombia,NA,Quindio,555401,29,3,1055,42
2020-08-27,Colombia,NA,Quindio,555401,38,2,1093,44
2020-08-28,Colombia,NA,Quindio,555401,58,1,1151,45
2020-08-29,Colombia,NA,Quindio,555401,131,1,1282,46
2020-08-30,Colombia,NA,Quindio,555401,47,2,1329,48
2020-08-31,Colombia,NA,Quindio,555401,35,0,1364,48
2020-09-01,Colombia,NA,Quindio,555401,67,1,1431,49
2020-09-02,Colombia,NA,Quindio,555401,68,1,1499,50
2020-09-03,Colombia,NA,Quindio,555401,36,2,1535,52
2020-09-04,Colombia,NA,Quindio,555401,53,1,1588,53
2020-09-05,Colombia,NA,Quindio,555401,40,3,1628,56
2020-09-06,Colombia,NA,Quindio,555401,40,0,1668,56
2020-09-07,Colombia,NA,Quindio,555401,41,1,1709,57
2020-09-08,Colombia,NA,Quindio,555401,61,3,1770,60
2020-09-09,Colombia,NA,Quindio,555401,101,1,1871,61
2020-09-10,Colombia,NA,Quindio,555401,102,0,1973,61
2020-09-11,Colombia,NA,Quindio,555401,111,5,2084,66
2020-09-12,Colombia,NA,Quindio,555401,89,1,2173,67
2020-09-13,Colombia,NA,Quindio,555401,35,1,2208,68
2020-09-14,Colombia,NA,Quindio,555401,38,4,2246,72
2020-09-15,Colombia,NA,Quindio,555401,67,5,2313,77
2020-09-16,Colombia,NA,Quindio,555401,112,1,2425,78
2020-09-17,Colombia,NA,Quindio,555401,107,1,2532,79
2020-09-18,Colombia,NA,Quindio,555401,104,0,2636,79
2020-09-19,Colombia,NA,Quindio,555401,40,3,2676,82
2020-09-20,Colombia,NA,Quindio,555401,125,2,2801,84
2020-09-21,Colombia,NA,Quindio,555401,94,4,2895,88
2020-09-22,Colombia,NA,Quindio,555401,56,1,2951,89
2020-09-23,Colombia,NA,Quindio,555401,35,2,2986,91
2020-03-22,Colombia,NA,Risaralda,961055,5,0,12,0
2020-03-23,Colombia,NA,Risaralda,961055,1,0,13,0
2020-03-24,Colombia,NA,Risaralda,961055,3,0,16,0
2020-03-25,Colombia,NA,Risaralda,961055,2,0,18,0
2020-03-26,Colombia,NA,Risaralda,961055,0,0,18,0
2020-03-28,Colombia,NA,Risaralda,961055,0,0,18,0
2020-03-29,Colombia,NA,Risaralda,961055,10,0,28,0
2020-03-30,Colombia,NA,Risaralda,961055,0,1,28,1
2020-03-31,Colombia,NA,Risaralda,961055,6,0,34,1
2020-04-01,Colombia,NA,Risaralda,961055,0,1,34,2
2020-04-02,Colombia,NA,Risaralda,961055,0,0,34,2
2020-04-03,Colombia,NA,Risaralda,961055,2,0,36,2
2020-04-04,Colombia,NA,Risaralda,961055,0,0,36,2
2020-04-07,Colombia,NA,Risaralda,961055,0,0,36,2
2020-04-08,Colombia,NA,Risaralda,961055,10,0,46,2
2020-04-09,Colombia,NA,Risaralda,961055,3,0,49,2
2020-04-10,Colombia,NA,Risaralda,961055,3,0,52,2
2020-04-11,Colombia,NA,Risaralda,961055,6,0,58,2
2020-04-12,Colombia,NA,Risaralda,961055,3,0,61,2
2020-04-13,Colombia,NA,Risaralda,961055,1,0,62,2
2020-04-14,Colombia,NA,Risaralda,961055,8,0,70,2
2020-04-15,Colombia,NA,Risaralda,961055,3,1,73,3
2020-04-16,Colombia,NA,Risaralda,961055,0,1,73,4
2020-04-17,Colombia,NA,Risaralda,961055,40,0,113,4
2020-04-18,Colombia,NA,Risaralda,961055,12,1,125,5
2020-04-19,Colombia,NA,Risaralda,961055,6,0,131,5
2020-04-20,Colombia,NA,Risaralda,961055,0,0,131,5
2020-04-21,Colombia,NA,Risaralda,961055,5,0,136,5
2020-04-22,Colombia,NA,Risaralda,961055,6,0,142,5
2020-04-23,Colombia,NA,Risaralda,961055,4,0,146,5
2020-04-24,Colombia,NA,Risaralda,961055,2,1,148,6
2020-04-25,Colombia,NA,Risaralda,961055,32,0,180,6
2020-04-26,Colombia,NA,Risaralda,961055,5,0,185,6
2020-04-27,Colombia,NA,Risaralda,961055,0,0,185,6
2020-04-28,Colombia,NA,Risaralda,961055,6,0,191,6
2020-04-29,Colombia,NA,Risaralda,961055,2,1,193,7
2020-04-30,Colombia,NA,Risaralda,961055,6,0,199,7
2020-05-01,Colombia,NA,Risaralda,961055,4,0,203,7
2020-05-02,Colombia,NA,Risaralda,961055,5,1,208,8
2020-05-03,Colombia,NA,Risaralda,961055,3,0,211,8
2020-05-04,Colombia,NA,Risaralda,961055,0,0,211,8
2020-05-05,Colombia,NA,Risaralda,961055,0,0,211,8
2020-05-06,Colombia,NA,Risaralda,961055,1,0,212,8
2020-05-07,Colombia,NA,Risaralda,961055,0,0,212,8
2020-05-08,Colombia,NA,Risaralda,961055,2,0,214,8
2020-05-09,Colombia,NA,Risaralda,961055,2,0,216,8
2020-05-10,Colombia,NA,Risaralda,961055,0,0,216,8
2020-05-11,Colombia,NA,Risaralda,961055,0,0,216,8
2020-05-12,Colombia,NA,Risaralda,961055,0,0,216,8
2020-05-13,Colombia,NA,Risaralda,961055,17,0,233,8
2020-05-14,Colombia,NA,Risaralda,961055,3,0,236,8
2020-05-15,Colombia,NA,Risaralda,961055,0,0,236,8
2020-05-17,Colombia,NA,Risaralda,961055,2,0,238,8
2020-05-18,Colombia,NA,Risaralda,961055,0,0,238,8
2020-05-19,Colombia,NA,Risaralda,961055,0,0,238,8
2020-05-20,Colombia,NA,Risaralda,961055,0,0,238,8
2020-05-21,Colombia,NA,Risaralda,961055,1,0,239,8
2020-05-22,Colombia,NA,Risaralda,961055,1,0,240,8
2020-05-23,Colombia,NA,Risaralda,961055,1,0,241,8
2020-05-24,Colombia,NA,Risaralda,961055,4,0,245,8
2020-05-25,Colombia,NA,Risaralda,961055,1,0,246,8
2020-05-27,Colombia,NA,Risaralda,961055,4,0,250,8
2020-05-28,Colombia,NA,Risaralda,961055,1,0,251,8
2020-05-29,Colombia,NA,Risaralda,961055,1,0,252,8
2020-05-30,Colombia,NA,Risaralda,961055,2,1,254,9
2020-05-31,Colombia,NA,Risaralda,961055,2,0,256,9
2020-06-02,Colombia,NA,Risaralda,961055,3,0,259,9
2020-06-03,Colombia,NA,Risaralda,961055,5,0,264,9
2020-06-04,Colombia,NA,Risaralda,961055,3,0,267,9
2020-06-05,Colombia,NA,Risaralda,961055,2,1,269,10
2020-06-06,Colombia,NA,Risaralda,961055,6,0,275,10
2020-06-07,Colombia,NA,Risaralda,961055,4,0,279,10
2020-06-08,Colombia,NA,Risaralda,961055,0,0,279,10
2020-06-09,Colombia,NA,Risaralda,961055,8,1,287,11
2020-06-10,Colombia,NA,Risaralda,961055,8,0,295,11
2020-06-11,Colombia,NA,Risaralda,961055,9,0,304,11
2020-06-12,Colombia,NA,Risaralda,961055,5,0,309,11
2020-06-13,Colombia,NA,Risaralda,961055,9,0,318,11
2020-06-14,Colombia,NA,Risaralda,961055,6,0,324,11
2020-06-16,Colombia,NA,Risaralda,961055,1,0,325,11
2020-06-17,Colombia,NA,Risaralda,961055,8,0,333,11
2020-06-18,Colombia,NA,Risaralda,961055,53,0,386,11
2020-06-19,Colombia,NA,Risaralda,961055,11,2,397,13
2020-06-20,Colombia,NA,Risaralda,961055,14,0,411,13
2020-06-21,Colombia,NA,Risaralda,961055,10,0,421,13
2020-06-22,Colombia,NA,Risaralda,961055,3,0,424,13
2020-06-23,Colombia,NA,Risaralda,961055,13,0,437,13
2020-06-24,Colombia,NA,Risaralda,961055,28,1,465,14
2020-06-25,Colombia,NA,Risaralda,961055,8,1,473,15
2020-06-26,Colombia,NA,Risaralda,961055,24,0,497,15
2020-06-27,Colombia,NA,Risaralda,961055,6,1,503,16
2020-06-28,Colombia,NA,Risaralda,961055,4,0,507,16
2020-06-29,Colombia,NA,Risaralda,961055,4,1,511,17
2020-06-30,Colombia,NA,Risaralda,961055,0,0,511,17
2020-07-01,Colombia,NA,Risaralda,961055,35,0,546,17
2020-07-02,Colombia,NA,Risaralda,961055,18,0,564,17
2020-07-03,Colombia,NA,Risaralda,961055,24,0,588,17
2020-07-04,Colombia,NA,Risaralda,961055,24,0,612,17
2020-07-05,Colombia,NA,Risaralda,961055,3,2,615,19
2020-07-06,Colombia,NA,Risaralda,961055,6,2,621,21
2020-07-07,Colombia,NA,Risaralda,961055,23,0,644,21
2020-07-08,Colombia,NA,Risaralda,961055,18,0,662,21
2020-07-09,Colombia,NA,Risaralda,961055,57,0,719,21
2020-07-10,Colombia,NA,Risaralda,961055,12,0,731,21
2020-07-11,Colombia,NA,Risaralda,961055,25,0,756,21
2020-07-12,Colombia,NA,Risaralda,961055,7,1,763,22
2020-07-13,Colombia,NA,Risaralda,961055,31,0,794,22
2020-07-14,Colombia,NA,Risaralda,961055,81,0,875,22
2020-07-15,Colombia,NA,Risaralda,961055,38,0,913,22
2020-07-16,Colombia,NA,Risaralda,961055,36,0,949,22
2020-07-17,Colombia,NA,Risaralda,961055,45,0,994,22
2020-07-18,Colombia,NA,Risaralda,961055,21,0,1015,22
2020-07-19,Colombia,NA,Risaralda,961055,3,1,1018,23
2020-07-20,Colombia,NA,Risaralda,961055,14,1,1032,24
2020-07-21,Colombia,NA,Risaralda,961055,78,0,1110,24
2020-07-22,Colombia,NA,Risaralda,961055,83,3,1193,27
2020-07-23,Colombia,NA,Risaralda,961055,71,0,1264,27
2020-07-24,Colombia,NA,Risaralda,961055,67,0,1331,27
2020-07-25,Colombia,NA,Risaralda,961055,47,1,1378,28
2020-07-26,Colombia,NA,Risaralda,961055,2,0,1380,28
2020-07-27,Colombia,NA,Risaralda,961055,88,1,1468,29
2020-07-28,Colombia,NA,Risaralda,961055,88,0,1556,29
2020-07-29,Colombia,NA,Risaralda,961055,104,3,1660,32
2020-07-30,Colombia,NA,Risaralda,961055,77,2,1737,34
2020-07-31,Colombia,NA,Risaralda,961055,164,4,1901,38
2020-08-01,Colombia,NA,Risaralda,961055,167,2,2068,40
2020-08-02,Colombia,NA,Risaralda,961055,11,3,2079,43
2020-08-03,Colombia,NA,Risaralda,961055,123,6,2202,49
2020-08-04,Colombia,NA,Risaralda,961055,79,1,2281,50
2020-08-05,Colombia,NA,Risaralda,961055,114,4,2395,54
2020-08-06,Colombia,NA,Risaralda,961055,118,1,2513,55
2020-08-07,Colombia,NA,Risaralda,961055,102,2,2615,57
2020-08-08,Colombia,NA,Risaralda,961055,45,5,2660,62
2020-08-09,Colombia,NA,Risaralda,961055,112,1,2772,63
2020-08-10,Colombia,NA,Risaralda,961055,182,1,2954,64
2020-08-11,Colombia,NA,Risaralda,961055,162,0,3116,64
2020-08-12,Colombia,NA,Risaralda,961055,135,1,3251,65
2020-08-13,Colombia,NA,Risaralda,961055,163,3,3414,68
2020-08-14,Colombia,NA,Risaralda,961055,202,2,3616,70
2020-08-15,Colombia,NA,Risaralda,961055,213,2,3829,72
2020-08-16,Colombia,NA,Risaralda,961055,27,2,3856,74
2020-08-17,Colombia,NA,Risaralda,961055,106,1,3962,75
2020-08-18,Colombia,NA,Risaralda,961055,155,4,4117,79
2020-08-19,Colombia,NA,Risaralda,961055,81,8,4198,87
2020-08-20,Colombia,NA,Risaralda,961055,222,4,4420,91
2020-08-21,Colombia,NA,Risaralda,961055,273,2,4693,93
2020-08-22,Colombia,NA,Risaralda,961055,303,3,4996,96
2020-08-23,Colombia,NA,Risaralda,961055,68,4,5064,100
2020-08-24,Colombia,NA,Risaralda,961055,283,6,5347,106
2020-08-25,Colombia,NA,Risaralda,961055,206,3,5553,109
2020-08-26,Colombia,NA,Risaralda,961055,203,5,5756,114
2020-08-27,Colombia,NA,Risaralda,961055,136,4,5892,118
2020-08-28,Colombia,NA,Risaralda,961055,195,8,6087,126
2020-08-29,Colombia,NA,Risaralda,961055,119,1,6206,127
2020-08-30,Colombia,NA,Risaralda,961055,168,3,6374,130
2020-08-31,Colombia,NA,Risaralda,961055,164,3,6538,133
2020-09-01,Colombia,NA,Risaralda,961055,124,4,6662,137
2020-09-02,Colombia,NA,Risaralda,961055,205,2,6867,139
2020-09-03,Colombia,NA,Risaralda,961055,140,8,7007,147
2020-09-04,Colombia,NA,Risaralda,961055,191,3,7198,150
2020-09-05,Colombia,NA,Risaralda,961055,152,8,7350,158
2020-09-06,Colombia,NA,Risaralda,961055,63,5,7413,163
2020-09-07,Colombia,NA,Risaralda,961055,135,10,7548,173
2020-09-08,Colombia,NA,Risaralda,961055,134,6,7682,179
2020-09-09,Colombia,NA,Risaralda,961055,299,4,7981,183
2020-09-10,Colombia,NA,Risaralda,961055,184,5,8165,188
2020-09-11,Colombia,NA,Risaralda,961055,213,5,8378,193
2020-09-12,Colombia,NA,Risaralda,961055,165,2,8543,195
2020-09-13,Colombia,NA,Risaralda,961055,59,5,8602,200
2020-09-14,Colombia,NA,Risaralda,961055,115,3,8717,203
2020-09-15,Colombia,NA,Risaralda,961055,208,4,8925,207
2020-09-16,Colombia,NA,Risaralda,961055,224,2,9149,209
2020-09-17,Colombia,NA,Risaralda,961055,197,3,9346,212
2020-09-18,Colombia,NA,Risaralda,961055,193,6,9539,218
2020-09-19,Colombia,NA,Risaralda,961055,157,3,9696,221
2020-09-20,Colombia,NA,Risaralda,961055,82,9,9778,230
2020-09-21,Colombia,NA,Risaralda,961055,276,7,10054,237
2020-09-22,Colombia,NA,Risaralda,961055,277,2,10331,239
2020-09-23,Colombia,NA,Risaralda,961055,61,2,10392,241
2020-05-12,Colombia,NA,San Andres and Providencia,63692,9,0,15,0
2020-05-14,Colombia,NA,San Andres and Providencia,63692,0,0,15,0
2020-05-21,Colombia,NA,San Andres and Providencia,63692,0,0,15,0
2020-05-22,Colombia,NA,San Andres and Providencia,63692,0,0,15,0
2020-05-24,Colombia,NA,San Andres and Providencia,63692,0,0,15,0
2020-05-27,Colombia,NA,San Andres and Providencia,63692,2,0,17,0
2020-05-31,Colombia,NA,San Andres and Providencia,63692,0,0,17,0
2020-06-05,Colombia,NA,San Andres and Providencia,63692,0,0,17,0
2020-06-12,Colombia,NA,San Andres and Providencia,63692,1,0,18,0
2020-06-15,Colombia,NA,San Andres and Providencia,63692,1,0,19,0
2020-06-16,Colombia,NA,San Andres and Providencia,63692,1,0,20,0
2020-06-19,Colombia,NA,San Andres and Providencia,63692,3,0,23,0
2020-06-25,Colombia,NA,San Andres and Providencia,63692,0,0,23,0
2020-06-26,Colombia,NA,San Andres and Providencia,63692,0,0,23,0
2020-07-02,Colombia,NA,San Andres and Providencia,63692,5,0,28,0
2020-07-11,Colombia,NA,San Andres and Providencia,63692,1,0,29,0
2020-07-16,Colombia,NA,San Andres and Providencia,63692,1,0,30,0
2020-07-17,Colombia,NA,San Andres and Providencia,63692,1,0,31,0
2020-07-21,Colombia,NA,San Andres and Providencia,63692,1,0,32,0
2020-07-22,Colombia,NA,San Andres and Providencia,63692,2,0,34,0
2020-07-23,Colombia,NA,San Andres and Providencia,63692,0,0,34,0
2020-07-24,Colombia,NA,San Andres and Providencia,63692,2,0,36,0
2020-07-26,Colombia,NA,San Andres and Providencia,63692,2,0,38,0
2020-07-28,Colombia,NA,San Andres and Providencia,63692,2,0,40,0
2020-07-29,Colombia,NA,San Andres and Providencia,63692,0,0,40,0
2020-08-01,Colombia,NA,San Andres and Providencia,63692,4,0,44,0
2020-08-02,Colombia,NA,San Andres and Providencia,63692,1,0,45,0
2020-08-03,Colombia,NA,San Andres and Providencia,63692,1,0,46,0
2020-08-04,Colombia,NA,San Andres and Providencia,63692,0,0,46,0
2020-08-06,Colombia,NA,San Andres and Providencia,63692,4,0,50,0
2020-08-08,Colombia,NA,San Andres and Providencia,63692,4,0,54,0
2020-08-09,Colombia,NA,San Andres and Providencia,63692,1,0,55,0
2020-08-10,Colombia,NA,San Andres and Providencia,63692,3,0,58,0
2020-08-11,Colombia,NA,San Andres and Providencia,63692,2,0,60,0
2020-08-12,Colombia,NA,San Andres and Providencia,63692,5,0,65,0
2020-08-13,Colombia,NA,San Andres and Providencia,63692,3,0,68,0
2020-08-14,Colombia,NA,San Andres and Providencia,63692,10,0,78,0
2020-08-15,Colombia,NA,San Andres and Providencia,63692,6,0,84,0
2020-08-16,Colombia,NA,San Andres and Providencia,63692,17,0,101,0
2020-08-17,Colombia,NA,San Andres and Providencia,63692,0,0,101,0
2020-08-18,Colombia,NA,San Andres and Providencia,63692,13,0,114,0
2020-08-19,Colombia,NA,San Andres and Providencia,63692,4,1,118,1
2020-08-20,Colombia,NA,San Andres and Providencia,63692,1,0,119,1
2020-08-21,Colombia,NA,San Andres and Providencia,63692,8,0,127,1
2020-08-22,Colombia,NA,San Andres and Providencia,63692,0,0,127,1
2020-08-23,Colombia,NA,San Andres and Providencia,63692,0,0,127,1
2020-08-24,Colombia,NA,San Andres and Providencia,63692,46,0,173,1
2020-08-25,Colombia,NA,San Andres and Providencia,63692,3,0,176,1
2020-08-26,Colombia,NA,San Andres and Providencia,63692,0,1,176,2
2020-08-27,Colombia,NA,San Andres and Providencia,63692,0,0,176,2
2020-08-28,Colombia,NA,San Andres and Providencia,63692,0,0,176,2
2020-08-29,Colombia,NA,San Andres and Providencia,63692,33,0,209,2
2020-08-30,Colombia,NA,San Andres and Providencia,63692,15,0,224,2
2020-08-31,Colombia,NA,San Andres and Providencia,63692,40,0,264,2
2020-09-01,Colombia,NA,San Andres and Providencia,63692,11,1,275,3
2020-09-02,Colombia,NA,San Andres and Providencia,63692,5,1,280,4
2020-09-03,Colombia,NA,San Andres and Providencia,63692,20,0,300,4
2020-09-04,Colombia,NA,San Andres and Providencia,63692,5,1,305,5
2020-09-05,Colombia,NA,San Andres and Providencia,63692,38,1,343,6
2020-09-06,Colombia,NA,San Andres and Providencia,63692,56,0,399,6
2020-09-07,Colombia,NA,San Andres and Providencia,63692,21,0,420,6
2020-09-08,Colombia,NA,San Andres and Providencia,63692,51,0,471,6
2020-09-09,Colombia,NA,San Andres and Providencia,63692,11,0,482,6
2020-09-10,Colombia,NA,San Andres and Providencia,63692,31,1,513,7
2020-09-11,Colombia,NA,San Andres and Providencia,63692,44,1,557,8
2020-09-12,Colombia,NA,San Andres and Providencia,63692,53,0,610,8
2020-09-13,Colombia,NA,San Andres and Providencia,63692,9,2,619,10
2020-09-14,Colombia,NA,San Andres and Providencia,63692,9,0,628,10
2020-09-15,Colombia,NA,San Andres and Providencia,63692,64,0,692,10
2020-09-16,Colombia,NA,San Andres and Providencia,63692,81,1,773,11
2020-09-17,Colombia,NA,San Andres and Providencia,63692,66,0,839,11
2020-09-18,Colombia,NA,San Andres and Providencia,63692,63,0,902,11
2020-09-19,Colombia,NA,San Andres and Providencia,63692,64,0,966,11
2020-09-20,Colombia,NA,San Andres and Providencia,63692,42,0,1008,11
2020-09-21,Colombia,NA,San Andres and Providencia,63692,42,0,1050,11
2020-09-22,Colombia,NA,San Andres and Providencia,63692,17,0,1067,11
2020-09-23,Colombia,NA,San Andres and Providencia,63692,12,0,1079,11
2020-03-31,Colombia,NA,Santander,2280908,3,0,11,0
2020-04-01,Colombia,NA,Santander,2280908,1,0,12,0
2020-04-06,Colombia,NA,Santander,2280908,2,0,14,0
2020-04-07,Colombia,NA,Santander,2280908,0,1,14,1
2020-04-08,Colombia,NA,Santander,2280908,0,0,14,1
2020-04-09,Colombia,NA,Santander,2280908,7,0,21,1
2020-04-10,Colombia,NA,Santander,2280908,0,0,21,1
2020-04-11,Colombia,NA,Santander,2280908,6,0,27,1
2020-04-12,Colombia,NA,Santander,2280908,2,0,29,1
2020-04-13,Colombia,NA,Santander,2280908,0,0,29,1
2020-04-14,Colombia,NA,Santander,2280908,1,0,30,1
2020-04-16,Colombia,NA,Santander,2280908,3,0,33,1
2020-04-17,Colombia,NA,Santander,2280908,0,1,33,2
2020-04-21,Colombia,NA,Santander,2280908,1,0,34,2
2020-04-22,Colombia,NA,Santander,2280908,2,0,36,2
2020-04-23,Colombia,NA,Santander,2280908,1,0,37,2
2020-04-24,Colombia,NA,Santander,2280908,0,0,37,2
2020-04-25,Colombia,NA,Santander,2280908,1,1,38,3
2020-04-26,Colombia,NA,Santander,2280908,1,0,39,3
2020-04-27,Colombia,NA,Santander,2280908,0,0,39,3
2020-04-28,Colombia,NA,Santander,2280908,1,0,40,3
2020-05-01,Colombia,NA,Santander,2280908,0,0,40,3
2020-05-07,Colombia,NA,Santander,2280908,0,0,40,3
2020-05-08,Colombia,NA,Santander,2280908,1,0,41,3
2020-05-09,Colombia,NA,Santander,2280908,1,0,42,3
2020-05-14,Colombia,NA,Santander,2280908,0,0,42,3
2020-05-16,Colombia,NA,Santander,2280908,7,0,49,3
2020-05-18,Colombia,NA,Santander,2280908,1,0,50,3
2020-05-21,Colombia,NA,Santander,2280908,1,0,51,3
2020-05-22,Colombia,NA,Santander,2280908,1,0,52,3
2020-05-23,Colombia,NA,Santander,2280908,5,0,57,3
2020-05-26,Colombia,NA,Santander,2280908,0,0,57,3
2020-05-27,Colombia,NA,Santander,2280908,0,0,57,3
2020-05-28,Colombia,NA,Santander,2280908,0,0,57,3
2020-05-29,Colombia,NA,Santander,2280908,1,0,58,3
2020-05-30,Colombia,NA,Santander,2280908,0,1,58,4
2020-05-31,Colombia,NA,Santander,2280908,11,0,69,4
2020-06-01,Colombia,NA,Santander,2280908,3,0,72,4
2020-06-02,Colombia,NA,Santander,2280908,11,0,83,4
2020-06-03,Colombia,NA,Santander,2280908,30,1,113,5
2020-06-04,Colombia,NA,Santander,2280908,2,0,115,5
2020-06-05,Colombia,NA,Santander,2280908,20,0,135,5
2020-06-06,Colombia,NA,Santander,2280908,14,2,149,7
2020-06-07,Colombia,NA,Santander,2280908,10,0,159,7
2020-06-08,Colombia,NA,Santander,2280908,7,1,166,8
2020-06-09,Colombia,NA,Santander,2280908,25,0,191,8
2020-06-10,Colombia,NA,Santander,2280908,11,1,202,9
2020-06-11,Colombia,NA,Santander,2280908,9,1,211,10
2020-06-12,Colombia,NA,Santander,2280908,0,0,211,10
2020-06-13,Colombia,NA,Santander,2280908,19,0,230,10
2020-06-14,Colombia,NA,Santander,2280908,11,0,241,10
2020-06-15,Colombia,NA,Santander,2280908,22,0,263,10
2020-06-16,Colombia,NA,Santander,2280908,19,0,282,10
2020-06-17,Colombia,NA,Santander,2280908,32,0,314,10
2020-06-18,Colombia,NA,Santander,2280908,19,1,333,11
2020-06-19,Colombia,NA,Santander,2280908,15,1,348,12
2020-06-20,Colombia,NA,Santander,2280908,18,0,366,12
2020-06-21,Colombia,NA,Santander,2280908,93,0,459,12
2020-06-22,Colombia,NA,Santander,2280908,21,0,480,12
2020-06-23,Colombia,NA,Santander,2280908,10,1,490,13
2020-06-24,Colombia,NA,Santander,2280908,11,0,501,13
2020-06-25,Colombia,NA,Santander,2280908,26,0,527,13
2020-06-26,Colombia,NA,Santander,2280908,51,0,578,13
2020-06-27,Colombia,NA,Santander,2280908,33,2,611,15
2020-06-28,Colombia,NA,Santander,2280908,24,1,635,16
2020-06-29,Colombia,NA,Santander,2280908,35,1,670,17
2020-06-30,Colombia,NA,Santander,2280908,16,0,686,17
2020-07-01,Colombia,NA,Santander,2280908,45,1,731,18
2020-07-02,Colombia,NA,Santander,2280908,57,1,788,19
2020-07-03,Colombia,NA,Santander,2280908,37,2,825,21
2020-07-04,Colombia,NA,Santander,2280908,101,1,926,22
2020-07-05,Colombia,NA,Santander,2280908,47,1,973,23
2020-07-06,Colombia,NA,Santander,2280908,15,3,988,26
2020-07-07,Colombia,NA,Santander,2280908,60,1,1048,27
2020-07-08,Colombia,NA,Santander,2280908,40,0,1088,27
2020-07-09,Colombia,NA,Santander,2280908,67,3,1155,30
2020-07-10,Colombia,NA,Santander,2280908,90,2,1245,32
2020-07-11,Colombia,NA,Santander,2280908,42,3,1287,35
2020-07-12,Colombia,NA,Santander,2280908,46,1,1333,36
2020-07-13,Colombia,NA,Santander,2280908,134,4,1467,40
2020-07-14,Colombia,NA,Santander,2280908,152,5,1619,45
2020-07-15,Colombia,NA,Santander,2280908,88,2,1707,47
2020-07-16,Colombia,NA,Santander,2280908,137,5,1844,52
2020-07-17,Colombia,NA,Santander,2280908,105,3,1949,55
2020-07-18,Colombia,NA,Santander,2280908,78,4,2027,59
2020-07-19,Colombia,NA,Santander,2280908,90,3,2117,62
2020-07-20,Colombia,NA,Santander,2280908,39,5,2156,67
2020-07-21,Colombia,NA,Santander,2280908,91,5,2247,72
2020-07-22,Colombia,NA,Santander,2280908,166,8,2413,80
2020-07-23,Colombia,NA,Santander,2280908,175,4,2588,84
2020-07-24,Colombia,NA,Santander,2280908,181,8,2769,92
2020-07-25,Colombia,NA,Santander,2280908,174,5,2943,97
2020-07-26,Colombia,NA,Santander,2280908,99,10,3042,107
2020-07-27,Colombia,NA,Santander,2280908,235,12,3277,119
2020-07-28,Colombia,NA,Santander,2280908,316,12,3593,131
2020-07-29,Colombia,NA,Santander,2280908,215,12,3808,143
2020-07-30,Colombia,NA,Santander,2280908,244,20,4052,163
2020-07-31,Colombia,NA,Santander,2280908,219,13,4271,176
2020-08-01,Colombia,NA,Santander,2280908,309,24,4580,200
2020-08-02,Colombia,NA,Santander,2280908,138,17,4718,217
2020-08-03,Colombia,NA,Santander,2280908,470,19,5188,236
2020-08-04,Colombia,NA,Santander,2280908,353,9,5541,245
2020-08-05,Colombia,NA,Santander,2280908,501,23,6042,268
2020-08-06,Colombia,NA,Santander,2280908,302,29,6344,297
2020-08-07,Colombia,NA,Santander,2280908,515,19,6859,316
2020-08-08,Colombia,NA,Santander,2280908,597,26,7456,342
2020-08-09,Colombia,NA,Santander,2280908,246,22,7702,364
2020-08-10,Colombia,NA,Santander,2280908,478,31,8180,395
2020-08-11,Colombia,NA,Santander,2280908,587,29,8767,424
2020-08-12,Colombia,NA,Santander,2280908,508,23,9275,447
2020-08-13,Colombia,NA,Santander,2280908,445,18,9720,465
2020-08-14,Colombia,NA,Santander,2280908,412,15,10132,480
2020-08-15,Colombia,NA,Santander,2280908,437,21,10569,501
2020-08-16,Colombia,NA,Santander,2280908,230,29,10799,530
2020-08-17,Colombia,NA,Santander,2280908,475,25,11274,555
2020-08-18,Colombia,NA,Santander,2280908,721,22,11995,577
2020-08-19,Colombia,NA,Santander,2280908,462,28,12457,605
2020-08-20,Colombia,NA,Santander,2280908,755,22,13212,627
2020-08-21,Colombia,NA,Santander,2280908,561,34,13773,661
2020-08-22,Colombia,NA,Santander,2280908,599,23,14372,684
2020-08-23,Colombia,NA,Santander,2280908,439,24,14811,708
2020-08-24,Colombia,NA,Santander,2280908,620,23,15431,731
2020-08-25,Colombia,NA,Santander,2280908,630,26,16061,757
2020-08-26,Colombia,NA,Santander,2280908,587,26,16648,783
2020-08-27,Colombia,NA,Santander,2280908,653,16,17301,799
2020-08-28,Colombia,NA,Santander,2280908,652,21,17953,820
2020-08-29,Colombia,NA,Santander,2280908,531,33,18484,853
2020-08-30,Colombia,NA,Santander,2280908,379,17,18863,870
2020-08-31,Colombia,NA,Santander,2280908,682,16,19545,886
2020-09-01,Colombia,NA,Santander,2280908,616,19,20161,905
2020-09-02,Colombia,NA,Santander,2280908,766,23,20927,928
2020-09-03,Colombia,NA,Santander,2280908,158,21,21085,949
2020-09-04,Colombia,NA,Santander,2280908,462,31,21547,980
2020-09-05,Colombia,NA,Santander,2280908,378,26,21925,1006
2020-09-06,Colombia,NA,Santander,2280908,183,21,22108,1027
2020-09-07,Colombia,NA,Santander,2280908,423,21,22531,1048
2020-09-08,Colombia,NA,Santander,2280908,515,17,23046,1065
2020-09-09,Colombia,NA,Santander,2280908,495,25,23541,1090
2020-09-10,Colombia,NA,Santander,2280908,581,13,24122,1103
2020-09-11,Colombia,NA,Santander,2280908,326,19,24448,1122
2020-09-12,Colombia,NA,Santander,2280908,504,16,24952,1138
2020-09-13,Colombia,NA,Santander,2280908,189,18,25141,1156
2020-09-14,Colombia,NA,Santander,2280908,505,16,25646,1172
2020-09-15,Colombia,NA,Santander,2280908,509,17,26155,1189
2020-09-16,Colombia,NA,Santander,2280908,380,11,26535,1200
2020-09-17,Colombia,NA,Santander,2280908,460,19,26995,1219
2020-09-18,Colombia,NA,Santander,2280908,408,12,27403,1231
2020-09-19,Colombia,NA,Santander,2280908,404,16,27807,1247
2020-09-20,Colombia,NA,Santander,2280908,174,8,27981,1255
2020-09-21,Colombia,NA,Santander,2280908,423,9,28404,1264
2020-09-22,Colombia,NA,Santander,2280908,352,7,28756,1271
2020-09-23,Colombia,NA,Santander,2280908,306,8,29062,1279
2020-05-28,Colombia,NA,Sucre,949252,5,0,15,1
2020-05-30,Colombia,NA,Sucre,949252,4,0,19,1
2020-05-31,Colombia,NA,Sucre,949252,2,1,21,2
2020-06-01,Colombia,NA,Sucre,949252,3,0,24,2
2020-06-02,Colombia,NA,Sucre,949252,1,0,25,2
2020-06-03,Colombia,NA,Sucre,949252,22,0,47,2
2020-06-04,Colombia,NA,Sucre,949252,26,0,73,2
2020-06-05,Colombia,NA,Sucre,949252,8,0,81,2
2020-06-06,Colombia,NA,Sucre,949252,17,1,98,3
2020-06-07,Colombia,NA,Sucre,949252,28,0,126,3
2020-06-08,Colombia,NA,Sucre,949252,6,1,132,4
2020-06-09,Colombia,NA,Sucre,949252,14,2,146,6
2020-06-10,Colombia,NA,Sucre,949252,24,3,170,9
2020-06-11,Colombia,NA,Sucre,949252,8,1,178,10
2020-06-12,Colombia,NA,Sucre,949252,23,2,201,12
2020-06-13,Colombia,NA,Sucre,949252,18,3,219,15
2020-06-14,Colombia,NA,Sucre,949252,24,1,243,16
2020-06-15,Colombia,NA,Sucre,949252,2,2,245,18
2020-06-16,Colombia,NA,Sucre,949252,32,5,277,23
2020-06-17,Colombia,NA,Sucre,949252,29,3,306,26
2020-06-18,Colombia,NA,Sucre,949252,101,2,407,28
2020-06-19,Colombia,NA,Sucre,949252,42,4,449,32
2020-06-20,Colombia,NA,Sucre,949252,46,4,495,36
2020-06-21,Colombia,NA,Sucre,949252,41,5,536,41
2020-06-22,Colombia,NA,Sucre,949252,58,7,594,48
2020-06-23,Colombia,NA,Sucre,949252,63,5,657,53
2020-06-24,Colombia,NA,Sucre,949252,88,7,745,60
2020-06-25,Colombia,NA,Sucre,949252,116,12,861,72
2020-06-26,Colombia,NA,Sucre,949252,88,10,949,82
2020-06-27,Colombia,NA,Sucre,949252,61,11,1010,93
2020-06-28,Colombia,NA,Sucre,949252,126,9,1136,102
2020-06-29,Colombia,NA,Sucre,949252,49,4,1185,106
2020-06-30,Colombia,NA,Sucre,949252,93,8,1278,114
2020-07-01,Colombia,NA,Sucre,949252,148,4,1426,118
2020-07-02,Colombia,NA,Sucre,949252,142,13,1568,131
2020-07-03,Colombia,NA,Sucre,949252,102,10,1670,141
2020-07-04,Colombia,NA,Sucre,949252,155,6,1825,147
2020-07-05,Colombia,NA,Sucre,949252,160,11,1985,158
2020-07-06,Colombia,NA,Sucre,949252,98,13,2083,171
2020-07-07,Colombia,NA,Sucre,949252,141,15,2224,186
2020-07-08,Colombia,NA,Sucre,949252,183,15,2407,201
2020-07-09,Colombia,NA,Sucre,949252,204,10,2611,211
2020-07-10,Colombia,NA,Sucre,949252,210,14,2821,225
2020-07-11,Colombia,NA,Sucre,949252,158,13,2979,238
2020-07-12,Colombia,NA,Sucre,949252,127,12,3106,250
2020-07-13,Colombia,NA,Sucre,949252,224,8,3330,258
2020-07-14,Colombia,NA,Sucre,949252,275,8,3605,266
2020-07-15,Colombia,NA,Sucre,949252,192,8,3797,274
2020-07-16,Colombia,NA,Sucre,949252,211,15,4008,289
2020-07-17,Colombia,NA,Sucre,949252,224,10,4232,299
2020-07-18,Colombia,NA,Sucre,949252,248,15,4480,314
2020-07-19,Colombia,NA,Sucre,949252,119,8,4599,322
2020-07-20,Colombia,NA,Sucre,949252,51,7,4650,329
2020-07-21,Colombia,NA,Sucre,949252,134,6,4784,335
2020-07-22,Colombia,NA,Sucre,949252,291,12,5075,347
2020-07-23,Colombia,NA,Sucre,949252,176,12,5251,359
2020-07-24,Colombia,NA,Sucre,949252,213,16,5464,375
2020-07-25,Colombia,NA,Sucre,949252,132,4,5596,379
2020-07-26,Colombia,NA,Sucre,949252,23,9,5619,388
2020-07-27,Colombia,NA,Sucre,949252,257,6,5876,394
2020-07-28,Colombia,NA,Sucre,949252,183,9,6059,403
2020-07-29,Colombia,NA,Sucre,949252,210,6,6269,409
2020-07-30,Colombia,NA,Sucre,949252,95,5,6364,414
2020-07-31,Colombia,NA,Sucre,949252,63,7,6427,421
2020-08-01,Colombia,NA,Sucre,949252,166,6,6593,427
2020-08-02,Colombia,NA,Sucre,949252,162,7,6755,434
2020-08-03,Colombia,NA,Sucre,949252,174,6,6929,440
2020-08-04,Colombia,NA,Sucre,949252,140,3,7069,443
2020-08-05,Colombia,NA,Sucre,949252,111,2,7180,445
2020-08-06,Colombia,NA,Sucre,949252,250,5,7430,450
2020-08-07,Colombia,NA,Sucre,949252,102,4,7532,454
2020-08-08,Colombia,NA,Sucre,949252,286,7,7818,461
2020-08-09,Colombia,NA,Sucre,949252,65,4,7883,465
2020-08-10,Colombia,NA,Sucre,949252,239,5,8122,470
2020-08-11,Colombia,NA,Sucre,949252,265,2,8387,472
2020-08-12,Colombia,NA,Sucre,949252,269,7,8656,479
2020-08-13,Colombia,NA,Sucre,949252,161,6,8817,485
2020-08-14,Colombia,NA,Sucre,949252,146,8,8963,493
2020-08-15,Colombia,NA,Sucre,949252,143,5,9106,498
2020-08-16,Colombia,NA,Sucre,949252,103,5,9209,503
2020-08-17,Colombia,NA,Sucre,949252,262,5,9471,508
2020-08-18,Colombia,NA,Sucre,949252,343,8,9814,516
2020-08-19,Colombia,NA,Sucre,949252,149,5,9963,521
2020-08-20,Colombia,NA,Sucre,949252,339,3,10302,524
2020-08-21,Colombia,NA,Sucre,949252,80,4,10382,528
2020-08-22,Colombia,NA,Sucre,949252,150,2,10532,530
2020-08-23,Colombia,NA,Sucre,949252,74,2,10606,532
2020-08-24,Colombia,NA,Sucre,949252,251,4,10857,536
2020-08-25,Colombia,NA,Sucre,949252,86,3,10943,539
2020-08-26,Colombia,NA,Sucre,949252,369,5,11312,544
2020-08-27,Colombia,NA,Sucre,949252,142,2,11454,546
2020-08-28,Colombia,NA,Sucre,949252,91,5,11545,551
2020-08-29,Colombia,NA,Sucre,949252,75,1,11620,552
2020-08-30,Colombia,NA,Sucre,949252,98,3,11718,555
2020-08-31,Colombia,NA,Sucre,949252,35,1,11753,556
2020-09-01,Colombia,NA,Sucre,949252,160,3,11913,559
2020-09-02,Colombia,NA,Sucre,949252,168,1,12081,560
2020-09-03,Colombia,NA,Sucre,949252,105,5,12186,565
2020-09-04,Colombia,NA,Sucre,949252,124,5,12310,570
2020-09-05,Colombia,NA,Sucre,949252,161,1,12471,571
2020-09-06,Colombia,NA,Sucre,949252,40,0,12511,571
2020-09-07,Colombia,NA,Sucre,949252,114,2,12625,573
2020-09-08,Colombia,NA,Sucre,949252,127,3,12752,576
2020-09-09,Colombia,NA,Sucre,949252,48,1,12800,577
2020-09-10,Colombia,NA,Sucre,949252,164,2,12964,579
2020-09-11,Colombia,NA,Sucre,949252,96,4,13060,583
2020-09-12,Colombia,NA,Sucre,949252,138,0,13198,583
2020-09-13,Colombia,NA,Sucre,949252,19,1,13217,584
2020-09-14,Colombia,NA,Sucre,949252,51,4,13268,588
2020-09-15,Colombia,NA,Sucre,949252,54,2,13322,590
2020-09-16,Colombia,NA,Sucre,949252,65,2,13387,592
2020-09-17,Colombia,NA,Sucre,949252,42,3,13429,595
2020-09-18,Colombia,NA,Sucre,949252,42,0,13471,595
2020-09-19,Colombia,NA,Sucre,949252,34,3,13505,598
2020-09-20,Colombia,NA,Sucre,949252,74,1,13579,599
2020-09-21,Colombia,NA,Sucre,949252,139,1,13718,600
2020-09-22,Colombia,NA,Sucre,949252,32,1,13750,601
2020-09-23,Colombia,NA,Sucre,949252,72,0,13822,601
2020-04-01,Colombia,NA,Tolima,1339998,5,0,14,0
2020-04-03,Colombia,NA,Tolima,1339998,1,0,15,0
2020-04-04,Colombia,NA,Tolima,1339998,0,0,15,0
2020-04-09,Colombia,NA,Tolima,1339998,1,0,16,0
2020-04-10,Colombia,NA,Tolima,1339998,5,0,21,0
2020-04-11,Colombia,NA,Tolima,1339998,2,1,23,1
2020-04-12,Colombia,NA,Tolima,1339998,0,1,23,2
2020-04-13,Colombia,NA,Tolima,1339998,2,0,25,2
2020-04-15,Colombia,NA,Tolima,1339998,2,0,27,2
2020-04-16,Colombia,NA,Tolima,1339998,1,0,28,2
2020-04-17,Colombia,NA,Tolima,1339998,2,0,30,2
2020-04-18,Colombia,NA,Tolima,1339998,0,0,30,2
2020-04-19,Colombia,NA,Tolima,1339998,2,0,32,2
2020-04-21,Colombia,NA,Tolima,1339998,4,0,36,2
2020-04-22,Colombia,NA,Tolima,1339998,4,0,40,2
2020-04-23,Colombia,NA,Tolima,1339998,1,0,41,2
2020-04-25,Colombia,NA,Tolima,1339998,1,0,42,2
2020-04-26,Colombia,NA,Tolima,1339998,1,0,43,2
2020-04-27,Colombia,NA,Tolima,1339998,12,0,55,2
2020-04-28,Colombia,NA,Tolima,1339998,7,0,62,2
2020-04-29,Colombia,NA,Tolima,1339998,4,1,66,3
2020-04-30,Colombia,NA,Tolima,1339998,2,0,68,3
2020-05-01,Colombia,NA,Tolima,1339998,19,1,87,4
2020-05-02,Colombia,NA,Tolima,1339998,1,1,88,5
2020-05-03,Colombia,NA,Tolima,1339998,5,0,93,5
2020-05-04,Colombia,NA,Tolima,1339998,1,0,94,5
2020-05-05,Colombia,NA,Tolima,1339998,0,1,94,6
2020-05-06,Colombia,NA,Tolima,1339998,0,0,94,6
2020-05-07,Colombia,NA,Tolima,1339998,4,0,98,6
2020-05-08,Colombia,NA,Tolima,1339998,5,0,103,6
2020-05-10,Colombia,NA,Tolima,1339998,27,0,130,6
2020-05-11,Colombia,NA,Tolima,1339998,0,0,130,6
2020-05-12,Colombia,NA,Tolima,1339998,3,0,133,6
2020-05-13,Colombia,NA,Tolima,1339998,1,0,134,6
2020-05-14,Colombia,NA,Tolima,1339998,0,0,134,6
2020-05-15,Colombia,NA,Tolima,1339998,20,0,154,6
2020-05-16,Colombia,NA,Tolima,1339998,5,0,159,6
2020-05-17,Colombia,NA,Tolima,1339998,0,1,159,7
2020-05-18,Colombia,NA,Tolima,1339998,5,0,164,7
2020-05-19,Colombia,NA,Tolima,1339998,10,0,174,7
2020-05-20,Colombia,NA,Tolima,1339998,2,0,176,7
2020-05-21,Colombia,NA,Tolima,1339998,1,0,177,7
2020-05-22,Colombia,NA,Tolima,1339998,4,0,181,7
2020-05-23,Colombia,NA,Tolima,1339998,6,0,187,7
2020-05-24,Colombia,NA,Tolima,1339998,2,0,189,7
2020-05-25,Colombia,NA,Tolima,1339998,36,0,225,7
2020-05-26,Colombia,NA,Tolima,1339998,13,0,238,7
2020-05-27,Colombia,NA,Tolima,1339998,0,0,238,7
2020-05-28,Colombia,NA,Tolima,1339998,9,0,247,7
2020-05-29,Colombia,NA,Tolima,1339998,0,0,247,7
2020-05-30,Colombia,NA,Tolima,1339998,1,0,248,7
2020-05-31,Colombia,NA,Tolima,1339998,15,0,263,7
2020-06-01,Colombia,NA,Tolima,1339998,10,0,273,7
2020-06-02,Colombia,NA,Tolima,1339998,1,0,274,7
2020-06-03,Colombia,NA,Tolima,1339998,0,0,274,7
2020-06-04,Colombia,NA,Tolima,1339998,2,0,276,7
2020-06-05,Colombia,NA,Tolima,1339998,3,1,279,8
2020-06-06,Colombia,NA,Tolima,1339998,1,0,280,8
2020-06-07,Colombia,NA,Tolima,1339998,7,3,287,11
2020-06-08,Colombia,NA,Tolima,1339998,5,1,292,12
2020-06-09,Colombia,NA,Tolima,1339998,2,0,294,12
2020-06-10,Colombia,NA,Tolima,1339998,3,1,297,13
2020-06-11,Colombia,NA,Tolima,1339998,18,1,315,14
2020-06-12,Colombia,NA,Tolima,1339998,26,0,341,14
2020-06-13,Colombia,NA,Tolima,1339998,40,0,381,14
2020-06-14,Colombia,NA,Tolima,1339998,3,1,384,15
2020-06-15,Colombia,NA,Tolima,1339998,9,0,393,15
2020-06-16,Colombia,NA,Tolima,1339998,12,0,405,15
2020-06-17,Colombia,NA,Tolima,1339998,65,0,470,15
2020-06-18,Colombia,NA,Tolima,1339998,33,0,503,15
2020-06-19,Colombia,NA,Tolima,1339998,10,0,513,15
2020-06-20,Colombia,NA,Tolima,1339998,32,3,545,18
2020-06-21,Colombia,NA,Tolima,1339998,70,2,615,20
2020-06-22,Colombia,NA,Tolima,1339998,77,1,692,21
2020-06-23,Colombia,NA,Tolima,1339998,14,1,706,22
2020-06-24,Colombia,NA,Tolima,1339998,32,1,738,23
2020-06-25,Colombia,NA,Tolima,1339998,11,0,749,23
2020-06-26,Colombia,NA,Tolima,1339998,25,1,774,24
2020-06-27,Colombia,NA,Tolima,1339998,24,0,798,24
2020-06-28,Colombia,NA,Tolima,1339998,36,0,834,24
2020-06-29,Colombia,NA,Tolima,1339998,111,0,945,24
2020-06-30,Colombia,NA,Tolima,1339998,12,0,957,24
2020-07-01,Colombia,NA,Tolima,1339998,78,1,1035,25
2020-07-02,Colombia,NA,Tolima,1339998,20,1,1055,26
2020-07-03,Colombia,NA,Tolima,1339998,52,0,1107,26
2020-07-04,Colombia,NA,Tolima,1339998,15,0,1122,26
2020-07-05,Colombia,NA,Tolima,1339998,26,0,1148,26
2020-07-06,Colombia,NA,Tolima,1339998,37,1,1185,27
2020-07-07,Colombia,NA,Tolima,1339998,16,0,1201,27
2020-07-08,Colombia,NA,Tolima,1339998,17,1,1218,28
2020-07-09,Colombia,NA,Tolima,1339998,127,1,1345,29
2020-07-10,Colombia,NA,Tolima,1339998,127,0,1472,29
2020-07-11,Colombia,NA,Tolima,1339998,28,1,1500,30
2020-07-12,Colombia,NA,Tolima,1339998,31,1,1531,31
2020-07-13,Colombia,NA,Tolima,1339998,28,2,1559,33
2020-07-14,Colombia,NA,Tolima,1339998,35,0,1594,33
2020-07-15,Colombia,NA,Tolima,1339998,74,2,1668,35
2020-07-16,Colombia,NA,Tolima,1339998,58,1,1726,36
2020-07-17,Colombia,NA,Tolima,1339998,54,2,1780,38
2020-07-18,Colombia,NA,Tolima,1339998,48,2,1828,40
2020-07-19,Colombia,NA,Tolima,1339998,27,0,1855,40
2020-07-20,Colombia,NA,Tolima,1339998,15,2,1870,42
2020-07-21,Colombia,NA,Tolima,1339998,33,1,1903,43
2020-07-22,Colombia,NA,Tolima,1339998,46,3,1949,46
2020-07-23,Colombia,NA,Tolima,1339998,65,3,2014,49
2020-07-24,Colombia,NA,Tolima,1339998,84,1,2098,50
2020-07-25,Colombia,NA,Tolima,1339998,61,3,2159,53
2020-07-26,Colombia,NA,Tolima,1339998,180,7,2339,60
2020-07-27,Colombia,NA,Tolima,1339998,78,2,2417,62
2020-07-28,Colombia,NA,Tolima,1339998,88,1,2505,63
2020-07-29,Colombia,NA,Tolima,1339998,54,3,2559,66
2020-07-30,Colombia,NA,Tolima,1339998,101,3,2660,69
2020-07-31,Colombia,NA,Tolima,1339998,63,6,2723,75
2020-08-01,Colombia,NA,Tolima,1339998,117,3,2840,78
2020-08-02,Colombia,NA,Tolima,1339998,87,5,2927,83
2020-08-03,Colombia,NA,Tolima,1339998,121,3,3048,86
2020-08-04,Colombia,NA,Tolima,1339998,233,3,3281,89
2020-08-05,Colombia,NA,Tolima,1339998,47,3,3328,92
2020-08-06,Colombia,NA,Tolima,1339998,92,3,3420,95
2020-08-07,Colombia,NA,Tolima,1339998,185,3,3605,98
2020-08-08,Colombia,NA,Tolima,1339998,150,5,3755,103
2020-08-09,Colombia,NA,Tolima,1339998,103,3,3858,106
2020-08-10,Colombia,NA,Tolima,1339998,98,4,3956,110
2020-08-11,Colombia,NA,Tolima,1339998,92,6,4048,116
2020-08-12,Colombia,NA,Tolima,1339998,111,3,4159,119
2020-08-13,Colombia,NA,Tolima,1339998,123,3,4282,122
2020-08-14,Colombia,NA,Tolima,1339998,157,7,4439,129
2020-08-15,Colombia,NA,Tolima,1339998,228,4,4667,133
2020-08-16,Colombia,NA,Tolima,1339998,123,5,4790,138
2020-08-17,Colombia,NA,Tolima,1339998,145,8,4935,146
2020-08-18,Colombia,NA,Tolima,1339998,143,8,5078,154
2020-08-19,Colombia,NA,Tolima,1339998,106,8,5184,162
2020-08-20,Colombia,NA,Tolima,1339998,176,9,5360,171
2020-08-21,Colombia,NA,Tolima,1339998,170,6,5530,177
2020-08-22,Colombia,NA,Tolima,1339998,165,4,5695,181
2020-08-23,Colombia,NA,Tolima,1339998,152,2,5847,183
2020-08-24,Colombia,NA,Tolima,1339998,259,8,6106,191
2020-08-25,Colombia,NA,Tolima,1339998,206,6,6312,197
2020-08-26,Colombia,NA,Tolima,1339998,191,7,6503,204
2020-08-27,Colombia,NA,Tolima,1339998,294,9,6797,213
2020-08-28,Colombia,NA,Tolima,1339998,221,6,7018,219
2020-08-29,Colombia,NA,Tolima,1339998,136,4,7154,223
2020-08-30,Colombia,NA,Tolima,1339998,163,2,7317,225
2020-08-31,Colombia,NA,Tolima,1339998,129,4,7446,229
2020-09-01,Colombia,NA,Tolima,1339998,183,2,7629,231
2020-09-02,Colombia,NA,Tolima,1339998,184,9,7813,240
2020-09-03,Colombia,NA,Tolima,1339998,210,6,8023,246
2020-09-04,Colombia,NA,Tolima,1339998,274,4,8297,250
2020-09-05,Colombia,NA,Tolima,1339998,178,7,8475,257
2020-09-06,Colombia,NA,Tolima,1339998,98,5,8573,262
2020-09-07,Colombia,NA,Tolima,1339998,165,7,8738,269
2020-09-08,Colombia,NA,Tolima,1339998,148,3,8886,272
2020-09-09,Colombia,NA,Tolima,1339998,254,4,9140,276
2020-09-10,Colombia,NA,Tolima,1339998,265,7,9405,283
2020-09-11,Colombia,NA,Tolima,1339998,120,4,9525,287
2020-09-12,Colombia,NA,Tolima,1339998,124,6,9649,293
2020-09-13,Colombia,NA,Tolima,1339998,84,4,9733,297
2020-09-14,Colombia,NA,Tolima,1339998,234,5,9967,302
2020-09-15,Colombia,NA,Tolima,1339998,262,7,10229,309
2020-09-16,Colombia,NA,Tolima,1339998,158,10,10387,319
2020-09-17,Colombia,NA,Tolima,1339998,286,5,10673,324
2020-09-18,Colombia,NA,Tolima,1339998,215,4,10888,328
2020-09-19,Colombia,NA,Tolima,1339998,113,5,11001,333
2020-09-20,Colombia,NA,Tolima,1339998,93,2,11094,335
2020-09-21,Colombia,NA,Tolima,1339998,198,6,11292,341
2020-09-22,Colombia,NA,Tolima,1339998,160,4,11452,345
2020-09-23,Colombia,NA,Tolima,1339998,121,4,11573,349
2020-03-17,Colombia,NA,Valle Del Cauca,4532152,8,0,13,0
2020-03-19,Colombia,NA,Valle Del Cauca,4532152,1,0,14,0
2020-03-20,Colombia,NA,Valle Del Cauca,4532152,1,0,15,0
2020-03-21,Colombia,NA,Valle Del Cauca,4532152,12,0,27,0
2020-03-22,Colombia,NA,Valle Del Cauca,4532152,5,1,32,1
2020-03-23,Colombia,NA,Valle Del Cauca,4532152,6,0,38,1
2020-03-24,Colombia,NA,Valle Del Cauca,4532152,29,0,67,1
2020-03-25,Colombia,NA,Valle Del Cauca,4532152,5,2,72,3
2020-03-26,Colombia,NA,Valle Del Cauca,4532152,2,0,74,3
2020-03-28,Colombia,NA,Valle Del Cauca,4532152,11,0,85,3
2020-03-29,Colombia,NA,Valle Del Cauca,4532152,8,0,93,3
2020-03-30,Colombia,NA,Valle Del Cauca,4532152,13,1,106,4
2020-03-31,Colombia,NA,Valle Del Cauca,4532152,11,1,117,5
2020-04-01,Colombia,NA,Valle Del Cauca,4532152,31,0,148,5
2020-04-02,Colombia,NA,Valle Del Cauca,4532152,3,1,151,6
2020-04-03,Colombia,NA,Valle Del Cauca,4532152,17,1,168,7
2020-04-04,Colombia,NA,Valle Del Cauca,4532152,13,3,181,10
2020-04-05,Colombia,NA,Valle Del Cauca,4532152,17,0,198,10
2020-04-06,Colombia,NA,Valle Del Cauca,4532152,14,2,212,12
2020-04-07,Colombia,NA,Valle Del Cauca,4532152,15,0,227,12
2020-04-08,Colombia,NA,Valle Del Cauca,4532152,92,0,319,12
2020-04-09,Colombia,NA,Valle Del Cauca,4532152,37,3,356,15
2020-04-10,Colombia,NA,Valle Del Cauca,4532152,70,0,426,15
2020-04-11,Colombia,NA,Valle Del Cauca,4532152,60,0,486,15
2020-04-12,Colombia,NA,Valle Del Cauca,4532152,10,7,496,22
2020-04-13,Colombia,NA,Valle Del Cauca,4532152,4,1,500,23
2020-04-14,Colombia,NA,Valle Del Cauca,4532152,16,2,516,25
2020-04-15,Colombia,NA,Valle Del Cauca,4532152,20,6,536,31
2020-04-16,Colombia,NA,Valle Del Cauca,4532152,27,5,563,36
2020-04-17,Colombia,NA,Valle Del Cauca,4532152,44,1,607,37
2020-04-18,Colombia,NA,Valle Del Cauca,4532152,23,3,630,40
2020-04-19,Colombia,NA,Valle Del Cauca,4532152,10,4,640,44
2020-04-20,Colombia,NA,Valle Del Cauca,4532152,49,2,689,46
2020-04-21,Colombia,NA,Valle Del Cauca,4532152,31,1,720,47
2020-04-22,Colombia,NA,Valle Del Cauca,4532152,27,3,747,50
2020-04-23,Colombia,NA,Valle Del Cauca,4532152,35,2,782,52
2020-04-24,Colombia,NA,Valle Del Cauca,4532152,23,0,805,52
2020-04-25,Colombia,NA,Valle Del Cauca,4532152,19,0,824,52
2020-04-26,Colombia,NA,Valle Del Cauca,4532152,26,2,850,54
2020-04-27,Colombia,NA,Valle Del Cauca,4532152,7,3,857,57
2020-04-28,Colombia,NA,Valle Del Cauca,4532152,34,2,891,59
2020-04-29,Colombia,NA,Valle Del Cauca,4532152,22,3,913,62
2020-04-30,Colombia,NA,Valle Del Cauca,4532152,41,1,954,63
2020-05-01,Colombia,NA,Valle Del Cauca,4532152,62,1,1016,64
2020-05-02,Colombia,NA,Valle Del Cauca,4532152,44,3,1060,67
2020-05-03,Colombia,NA,Valle Del Cauca,4532152,2,1,1062,68
2020-05-04,Colombia,NA,Valle Del Cauca,4532152,37,5,1099,73
2020-05-05,Colombia,NA,Valle Del Cauca,4532152,38,0,1137,73
2020-05-06,Colombia,NA,Valle Del Cauca,4532152,42,3,1179,76
2020-05-07,Colombia,NA,Valle Del Cauca,4532152,49,2,1228,78
2020-05-08,Colombia,NA,Valle Del Cauca,4532152,40,1,1268,79
2020-05-09,Colombia,NA,Valle Del Cauca,4532152,57,2,1325,81
2020-05-10,Colombia,NA,Valle Del Cauca,4532152,11,3,1336,84
2020-05-11,Colombia,NA,Valle Del Cauca,4532152,36,6,1372,90
2020-05-12,Colombia,NA,Valle Del Cauca,4532152,48,1,1420,91
2020-05-13,Colombia,NA,Valle Del Cauca,4532152,62,3,1482,94
2020-05-14,Colombia,NA,Valle Del Cauca,4532152,79,5,1561,99
2020-05-15,Colombia,NA,Valle Del Cauca,4532152,42,1,1603,100
2020-05-16,Colombia,NA,Valle Del Cauca,4532152,72,2,1675,102
2020-05-17,Colombia,NA,Valle Del Cauca,4532152,78,5,1753,107
2020-05-18,Colombia,NA,Valle Del Cauca,4532152,47,3,1800,110
2020-05-19,Colombia,NA,Valle Del Cauca,4532152,89,2,1889,112
2020-05-20,Colombia,NA,Valle Del Cauca,4532152,90,8,1979,120
2020-05-21,Colombia,NA,Valle Del Cauca,4532152,69,5,2048,125
2020-05-22,Colombia,NA,Valle Del Cauca,4532152,168,10,2216,135
2020-05-23,Colombia,NA,Valle Del Cauca,4532152,101,5,2317,140
2020-05-24,Colombia,NA,Valle Del Cauca,4532152,114,10,2431,150
2020-05-25,Colombia,NA,Valle Del Cauca,4532152,63,5,2494,155
2020-05-26,Colombia,NA,Valle Del Cauca,4532152,184,7,2678,162
2020-05-27,Colombia,NA,Valle Del Cauca,4532152,156,6,2834,168
2020-05-28,Colombia,NA,Valle Del Cauca,4532152,137,10,2971,178
2020-05-29,Colombia,NA,Valle Del Cauca,4532152,112,9,3083,187
2020-05-30,Colombia,NA,Valle Del Cauca,4532152,283,9,3366,196
2020-05-31,Colombia,NA,Valle Del Cauca,4532152,106,9,3472,205
2020-06-01,Colombia,NA,Valle Del Cauca,4532152,114,5,3586,210
2020-06-02,Colombia,NA,Valle Del Cauca,4532152,132,10,3718,220
2020-06-03,Colombia,NA,Valle Del Cauca,4532152,172,6,3890,226
2020-06-04,Colombia,NA,Valle Del Cauca,4532152,101,4,3991,230
2020-06-05,Colombia,NA,Valle Del Cauca,4532152,205,8,4196,238
2020-06-06,Colombia,NA,Valle Del Cauca,4532152,153,8,4349,246
2020-06-07,Colombia,NA,Valle Del Cauca,4532152,65,9,4414,255
2020-06-08,Colombia,NA,Valle Del Cauca,4532152,248,10,4662,265
2020-06-09,Colombia,NA,Valle Del Cauca,4532152,142,5,4804,270
2020-06-10,Colombia,NA,Valle Del Cauca,4532152,159,5,4963,275
2020-06-11,Colombia,NA,Valle Del Cauca,4532152,362,6,5325,281
2020-06-12,Colombia,NA,Valle Del Cauca,4532152,95,9,5420,290
2020-06-13,Colombia,NA,Valle Del Cauca,4532152,300,6,5720,296
2020-06-14,Colombia,NA,Valle Del Cauca,4532152,78,11,5798,307
2020-06-15,Colombia,NA,Valle Del Cauca,4532152,241,6,6039,313
2020-06-16,Colombia,NA,Valle Del Cauca,4532152,213,11,6252,324
2020-06-17,Colombia,NA,Valle Del Cauca,4532152,222,8,6474,332
2020-06-18,Colombia,NA,Valle Del Cauca,4532152,267,10,6741,342
2020-06-19,Colombia,NA,Valle Del Cauca,4532152,243,10,6984,352
2020-06-20,Colombia,NA,Valle Del Cauca,4532152,212,12,7196,364
2020-06-21,Colombia,NA,Valle Del Cauca,4532152,248,10,7444,374
2020-06-22,Colombia,NA,Valle Del Cauca,4532152,141,11,7585,385
2020-06-23,Colombia,NA,Valle Del Cauca,4532152,276,8,7861,393
2020-06-24,Colombia,NA,Valle Del Cauca,4532152,403,10,8264,403
2020-06-25,Colombia,NA,Valle Del Cauca,4532152,346,9,8610,412
2020-06-26,Colombia,NA,Valle Del Cauca,4532152,446,10,9056,422
2020-06-27,Colombia,NA,Valle Del Cauca,4532152,206,6,9262,428
2020-06-28,Colombia,NA,Valle Del Cauca,4532152,217,3,9479,431
2020-06-29,Colombia,NA,Valle Del Cauca,4532152,291,13,9770,444
2020-06-30,Colombia,NA,Valle Del Cauca,4532152,116,14,9886,458
2020-07-01,Colombia,NA,Valle Del Cauca,4532152,549,16,10435,474
2020-07-02,Colombia,NA,Valle Del Cauca,4532152,398,10,10833,484
2020-07-03,Colombia,NA,Valle Del Cauca,4532152,329,18,11162,502
2020-07-04,Colombia,NA,Valle Del Cauca,4532152,491,13,11653,515
2020-07-05,Colombia,NA,Valle Del Cauca,4532152,217,14,11870,529
2020-07-06,Colombia,NA,Valle Del Cauca,4532152,264,15,12134,544
2020-07-07,Colombia,NA,Valle Del Cauca,4532152,396,25,12530,569
2020-07-08,Colombia,NA,Valle Del Cauca,4532152,465,17,12995,586
2020-07-09,Colombia,NA,Valle Del Cauca,4532152,626,10,13621,596
2020-07-10,Colombia,NA,Valle Del Cauca,4532152,605,14,14226,610
2020-07-11,Colombia,NA,Valle Del Cauca,4532152,325,10,14551,620
2020-07-12,Colombia,NA,Valle Del Cauca,4532152,266,18,14817,638
2020-07-13,Colombia,NA,Valle Del Cauca,4532152,681,23,15498,661
2020-07-14,Colombia,NA,Valle Del Cauca,4532152,803,29,16301,690
2020-07-15,Colombia,NA,Valle Del Cauca,4532152,407,30,16708,720
2020-07-16,Colombia,NA,Valle Del Cauca,4532152,288,17,16996,737
2020-07-17,Colombia,NA,Valle Del Cauca,4532152,441,20,17437,757
2020-07-18,Colombia,NA,Valle Del Cauca,4532152,362,27,17799,784
2020-07-19,Colombia,NA,Valle Del Cauca,4532152,344,26,18143,810
2020-07-20,Colombia,NA,Valle Del Cauca,4532152,396,31,18539,841
2020-07-21,Colombia,NA,Valle Del Cauca,4532152,756,34,19295,875
2020-07-22,Colombia,NA,Valle Del Cauca,4532152,1101,28,20396,903
2020-07-23,Colombia,NA,Valle Del Cauca,4532152,522,37,20918,940
2020-07-24,Colombia,NA,Valle Del Cauca,4532152,674,27,21592,967
2020-07-25,Colombia,NA,Valle Del Cauca,4532152,507,28,22099,995
2020-07-26,Colombia,NA,Valle Del Cauca,4532152,413,23,22512,1018
2020-07-27,Colombia,NA,Valle Del Cauca,4532152,789,35,23301,1053
2020-07-28,Colombia,NA,Valle Del Cauca,4532152,377,32,23678,1085
2020-07-29,Colombia,NA,Valle Del Cauca,4532152,1031,29,24709,1114
2020-07-30,Colombia,NA,Valle Del Cauca,4532152,608,30,25317,1144
2020-07-31,Colombia,NA,Valle Del Cauca,4532152,894,27,26211,1171
2020-08-01,Colombia,NA,Valle Del Cauca,4532152,725,31,26936,1202
2020-08-02,Colombia,NA,Valle Del Cauca,4532152,385,23,27321,1225
2020-08-03,Colombia,NA,Valle Del Cauca,4532152,478,23,27799,1248
2020-08-04,Colombia,NA,Valle Del Cauca,4532152,969,29,28768,1277
2020-08-05,Colombia,NA,Valle Del Cauca,4532152,945,25,29713,1302
2020-08-06,Colombia,NA,Valle Del Cauca,4532152,824,29,30537,1331
2020-08-07,Colombia,NA,Valle Del Cauca,4532152,546,34,31083,1365
2020-08-08,Colombia,NA,Valle Del Cauca,4532152,780,37,31863,1402
2020-08-09,Colombia,NA,Valle Del Cauca,4532152,197,28,32060,1430
2020-08-10,Colombia,NA,Valle Del Cauca,4532152,726,29,32786,1459
2020-08-11,Colombia,NA,Valle Del Cauca,4532152,2186,32,34972,1491
2020-08-12,Colombia,NA,Valle Del Cauca,4532152,795,23,35767,1514
2020-08-13,Colombia,NA,Valle Del Cauca,4532152,721,27,36488,1541
2020-08-14,Colombia,NA,Valle Del Cauca,4532152,813,24,37301,1565
2020-08-15,Colombia,NA,Valle Del Cauca,4532152,755,23,38056,1588
2020-08-16,Colombia,NA,Valle Del Cauca,4532152,265,24,38321,1612
2020-08-17,Colombia,NA,Valle Del Cauca,4532152,1114,26,39435,1638
2020-08-18,Colombia,NA,Valle Del Cauca,4532152,877,16,40312,1654
2020-08-19,Colombia,NA,Valle Del Cauca,4532152,642,24,40954,1678
2020-08-20,Colombia,NA,Valle Del Cauca,4532152,1054,15,42008,1693
2020-08-21,Colombia,NA,Valle Del Cauca,4532152,752,24,42760,1717
2020-08-22,Colombia,NA,Valle Del Cauca,4532152,506,23,43266,1740
2020-08-23,Colombia,NA,Valle Del Cauca,4532152,270,24,43536,1764
2020-08-24,Colombia,NA,Valle Del Cauca,4532152,635,21,44171,1785
2020-08-25,Colombia,NA,Valle Del Cauca,4532152,638,18,44809,1803
2020-08-26,Colombia,NA,Valle Del Cauca,4532152,415,20,45224,1823
2020-08-27,Colombia,NA,Valle Del Cauca,4532152,481,25,45705,1848
2020-08-28,Colombia,NA,Valle Del Cauca,4532152,537,27,46242,1875
2020-08-29,Colombia,NA,Valle Del Cauca,4532152,367,19,46609,1894
2020-08-30,Colombia,NA,Valle Del Cauca,4532152,360,26,46969,1920
2020-08-31,Colombia,NA,Valle Del Cauca,4532152,756,26,47725,1946
2020-09-01,Colombia,NA,Valle Del Cauca,4532152,379,22,48104,1968
2020-09-02,Colombia,NA,Valle Del Cauca,4532152,603,18,48707,1986
2020-09-03,Colombia,NA,Valle Del Cauca,4532152,302,18,49009,2004
2020-09-04,Colombia,NA,Valle Del Cauca,4532152,607,15,49616,2019
2020-09-05,Colombia,NA,Valle Del Cauca,4532152,551,26,50167,2045
2020-09-06,Colombia,NA,Valle Del Cauca,4532152,188,18,50355,2063
2020-09-07,Colombia,NA,Valle Del Cauca,4532152,617,11,50972,2074
2020-09-08,Colombia,NA,Valle Del Cauca,4532152,371,26,51343,2100
2020-09-09,Colombia,NA,Valle Del Cauca,4532152,744,19,52087,2119
2020-09-10,Colombia,NA,Valle Del Cauca,4532152,549,18,52636,2137
2020-09-11,Colombia,NA,Valle Del Cauca,4532152,481,16,53117,2153
2020-09-12,Colombia,NA,Valle Del Cauca,4532152,354,13,53471,2166
2020-09-13,Colombia,NA,Valle Del Cauca,4532152,337,19,53808,2185
2020-09-14,Colombia,NA,Valle Del Cauca,4532152,532,12,54340,2197
2020-09-15,Colombia,NA,Valle Del Cauca,4532152,700,16,55040,2213
2020-09-16,Colombia,NA,Valle Del Cauca,4532152,527,8,55567,2221
2020-09-17,Colombia,NA,Valle Del Cauca,4532152,590,18,56157,2239
2020-09-18,Colombia,NA,Valle Del Cauca,4532152,603,8,56760,2247
2020-09-19,Colombia,NA,Valle Del Cauca,4532152,346,18,57106,2265
2020-09-20,Colombia,NA,Valle Del Cauca,4532152,270,10,57376,2275
2020-09-21,Colombia,NA,Valle Del Cauca,4532152,576,20,57952,2295
2020-09-22,Colombia,NA,Valle Del Cauca,4532152,481,16,58433,2311
2020-09-23,Colombia,NA,Valle Del Cauca,4532152,463,10,58896,2321
2020-05-13,Colombia,NA,Vaupes,44712,9,0,11,0
2020-05-22,Colombia,NA,Vaupes,44712,0,0,11,0
2020-06-04,Colombia,NA,Vaupes,44712,0,0,11,0
2020-06-13,Colombia,NA,Vaupes,44712,16,0,27,0
2020-06-18,Colombia,NA,Vaupes,44712,0,0,27,0
2020-06-19,Colombia,NA,Vaupes,44712,0,0,27,0
2020-06-22,Colombia,NA,Vaupes,44712,1,0,28,0
2020-06-26,Colombia,NA,Vaupes,44712,0,0,28,0
2020-06-29,Colombia,NA,Vaupes,44712,0,0,28,0
2020-07-01,Colombia,NA,Vaupes,44712,0,1,28,1
2020-07-03,Colombia,NA,Vaupes,44712,0,0,28,1
2020-07-04,Colombia,NA,Vaupes,44712,0,0,28,1
2020-07-08,Colombia,NA,Vaupes,44712,1,0,29,1
2020-07-09,Colombia,NA,Vaupes,44712,0,0,29,1
2020-07-11,Colombia,NA,Vaupes,44712,1,0,30,1
2020-07-12,Colombia,NA,Vaupes,44712,1,0,31,1
2020-07-13,Colombia,NA,Vaupes,44712,30,0,61,1
2020-07-15,Colombia,NA,Vaupes,44712,1,0,62,1
2020-07-18,Colombia,NA,Vaupes,44712,0,0,62,1
2020-07-23,Colombia,NA,Vaupes,44712,0,0,62,1
2020-07-24,Colombia,NA,Vaupes,44712,0,0,62,1
2020-07-25,Colombia,NA,Vaupes,44712,0,0,62,1
2020-07-26,Colombia,NA,Vaupes,44712,0,0,62,1
2020-07-27,Colombia,NA,Vaupes,44712,0,0,62,1
2020-08-01,Colombia,NA,Vaupes,44712,0,0,62,1
2020-08-03,Colombia,NA,Vaupes,44712,0,0,62,1
2020-08-08,Colombia,NA,Vaupes,44712,1,0,63,1
2020-08-10,Colombia,NA,Vaupes,44712,74,0,137,1
2020-08-11,Colombia,NA,Vaupes,44712,2,0,139,1
2020-08-13,Colombia,NA,Vaupes,44712,1,0,140,1
2020-08-14,Colombia,NA,Vaupes,44712,3,0,143,1
2020-08-17,Colombia,NA,Vaupes,44712,22,0,165,1
2020-08-18,Colombia,NA,Vaupes,44712,0,0,165,1
2020-08-19,Colombia,NA,Vaupes,44712,1,0,166,1
2020-08-20,Colombia,NA,Vaupes,44712,3,0,169,1
2020-08-21,Colombia,NA,Vaupes,44712,33,0,202,1
2020-08-22,Colombia,NA,Vaupes,44712,6,0,208,1
2020-08-23,Colombia,NA,Vaupes,44712,3,0,211,1
2020-08-24,Colombia,NA,Vaupes,44712,11,0,222,1
2020-08-25,Colombia,NA,Vaupes,44712,17,0,239,1
2020-08-26,Colombia,NA,Vaupes,44712,11,0,250,1
2020-08-27,Colombia,NA,Vaupes,44712,16,0,266,1
2020-08-28,Colombia,NA,Vaupes,44712,52,0,318,1
2020-08-29,Colombia,NA,Vaupes,44712,22,0,340,1
2020-08-30,Colombia,NA,Vaupes,44712,9,0,349,1
2020-08-31,Colombia,NA,Vaupes,44712,9,0,358,1
2020-09-01,Colombia,NA,Vaupes,44712,38,0,396,1
2020-09-02,Colombia,NA,Vaupes,44712,23,1,419,2
2020-09-03,Colombia,NA,Vaupes,44712,18,2,437,4
2020-09-04,Colombia,NA,Vaupes,44712,18,0,455,4
2020-09-05,Colombia,NA,Vaupes,44712,13,0,468,4
2020-09-06,Colombia,NA,Vaupes,44712,5,0,473,4
2020-09-07,Colombia,NA,Vaupes,44712,66,0,539,4
2020-09-08,Colombia,NA,Vaupes,44712,3,0,542,4
2020-09-09,Colombia,NA,Vaupes,44712,12,0,554,4
2020-09-10,Colombia,NA,Vaupes,44712,9,0,563,4
2020-09-11,Colombia,NA,Vaupes,44712,61,0,624,4
2020-09-12,Colombia,NA,Vaupes,44712,6,0,630,4
2020-09-13,Colombia,NA,Vaupes,44712,1,1,631,5
2020-09-14,Colombia,NA,Vaupes,44712,14,0,645,5
2020-09-15,Colombia,NA,Vaupes,44712,26,1,671,6
2020-09-16,Colombia,NA,Vaupes,44712,11,0,682,6
2020-09-17,Colombia,NA,Vaupes,44712,7,0,689,6
2020-09-18,Colombia,NA,Vaupes,44712,28,0,717,6
2020-09-19,Colombia,NA,Vaupes,44712,2,1,719,7
2020-09-20,Colombia,NA,Vaupes,44712,3,0,722,7
2020-09-21,Colombia,NA,Vaupes,44712,8,0,730,7
2020-09-22,Colombia,NA,Vaupes,44712,2,0,732,7
2020-09-23,Colombia,NA,Vaupes,44712,1,0,733,7
2020-03-16,France,NA,Auvergne-Rhone-Alpes,8005882,16,0,20,0
2020-03-17,France,NA,Auvergne-Rhone-Alpes,8005882,9,0,29,0
2020-03-18,France,NA,Auvergne-Rhone-Alpes,8005882,55,0,84,7
2020-03-19,France,NA,Auvergne-Rhone-Alpes,8005882,84,15,168,22
2020-03-20,France,NA,Auvergne-Rhone-Alpes,8005882,105,11,273,33
2020-03-21,France,NA,Auvergne-Rhone-Alpes,8005882,8,5,281,38
2020-03-22,France,NA,Auvergne-Rhone-Alpes,8005882,9,9,290,47
2020-03-23,France,NA,Auvergne-Rhone-Alpes,8005882,96,23,386,70
2020-03-24,France,NA,Auvergne-Rhone-Alpes,8005882,97,16,483,86
2020-03-25,France,NA,Auvergne-Rhone-Alpes,8005882,53,21,536,107
2020-03-26,France,NA,Auvergne-Rhone-Alpes,8005882,60,27,596,119
2020-03-27,France,NA,Auvergne-Rhone-Alpes,8005882,37,31,633,126
2020-03-28,France,NA,Auvergne-Rhone-Alpes,8005882,15,30,648,129
2020-03-29,France,NA,Auvergne-Rhone-Alpes,8005882,4,32,652,130
2020-03-30,France,NA,Auvergne-Rhone-Alpes,8005882,85,37,737,147
2020-03-31,France,NA,Auvergne-Rhone-Alpes,8005882,84,31,821,164
2020-04-01,France,NA,Auvergne-Rhone-Alpes,8005882,64,54,885,177
2020-04-02,France,NA,Auvergne-Rhone-Alpes,8005882,58,55,943,188
2020-04-03,France,NA,Auvergne-Rhone-Alpes,8005882,66,44,1009,201
2020-04-04,France,NA,Auvergne-Rhone-Alpes,8005882,12,30,1021,204
2020-04-05,France,NA,Auvergne-Rhone-Alpes,8005882,0,30,1021,204
2020-04-06,France,NA,Auvergne-Rhone-Alpes,8005882,83,47,1104,220
2020-04-07,France,NA,Auvergne-Rhone-Alpes,8005882,100,45,1204,240
2020-04-08,France,NA,Auvergne-Rhone-Alpes,8005882,60,54,1264,252
2020-04-09,France,NA,Auvergne-Rhone-Alpes,8005882,40,31,1304,260
2020-04-10,France,NA,Auvergne-Rhone-Alpes,8005882,92,36,1396,279
2020-04-11,France,NA,Auvergne-Rhone-Alpes,8005882,19,34,1415,283
2020-04-12,France,NA,Auvergne-Rhone-Alpes,8005882,2,18,1417,283
2020-04-13,France,NA,Auvergne-Rhone-Alpes,8005882,74,21,1491,298
2020-04-14,France,NA,Auvergne-Rhone-Alpes,8005882,89,42,1580,316
2020-04-15,France,NA,Auvergne-Rhone-Alpes,8005882,70,49,1650,330
2020-04-16,France,NA,Auvergne-Rhone-Alpes,8005882,68,42,1718,343
2020-04-17,France,NA,Auvergne-Rhone-Alpes,8005882,35,27,1753,350
2020-04-18,France,NA,Auvergne-Rhone-Alpes,8005882,15,38,1768,353
2020-04-19,France,NA,Auvergne-Rhone-Alpes,8005882,0,19,1768,353
2020-04-20,France,NA,Auvergne-Rhone-Alpes,8005882,39,51,1807,361
2020-04-21,France,NA,Auvergne-Rhone-Alpes,8005882,25,41,1832,366
2020-04-22,France,NA,Auvergne-Rhone-Alpes,8005882,34,30,1866,373
2020-04-23,France,NA,Auvergne-Rhone-Alpes,8005882,87,34,1953,390
2020-04-24,France,NA,Auvergne-Rhone-Alpes,8005882,23,25,1976,395
2020-04-25,France,NA,Auvergne-Rhone-Alpes,8005882,4,20,1980,396
2020-04-26,France,NA,Auvergne-Rhone-Alpes,8005882,2,14,1982,396
2020-04-27,France,NA,Auvergne-Rhone-Alpes,8005882,24,29,2006,401
2020-04-28,France,NA,Auvergne-Rhone-Alpes,8005882,32,20,2038,407
2020-04-29,France,NA,Auvergne-Rhone-Alpes,8005882,12,36,2050,410
2020-04-30,France,NA,Auvergne-Rhone-Alpes,8005882,2,20,2052,410
2020-05-01,France,NA,Auvergne-Rhone-Alpes,8005882,1,15,2053,410
2020-05-02,France,NA,Auvergne-Rhone-Alpes,8005882,0,9,2053,410
2020-05-03,France,NA,Auvergne-Rhone-Alpes,8005882,1,9,2054,410
2020-05-04,France,NA,Auvergne-Rhone-Alpes,8005882,20,22,2074,414
2020-05-05,France,NA,Auvergne-Rhone-Alpes,8005882,16,33,2090,418
2020-05-06,France,NA,Auvergne-Rhone-Alpes,8005882,6,18,2096,419
2020-05-07,France,NA,Auvergne-Rhone-Alpes,8005882,12,25,2108,421
2020-05-08,France,NA,Auvergne-Rhone-Alpes,8005882,1,7,2109,421
2020-05-09,France,NA,Auvergne-Rhone-Alpes,8005882,1,4,2110,422
2020-05-10,France,NA,Auvergne-Rhone-Alpes,8005882,1,10,2111,422
2020-05-11,France,NA,Auvergne-Rhone-Alpes,8005882,5,16,2116,423
2020-05-12,France,NA,Auvergne-Rhone-Alpes,8005882,7,18,2123,424
2020-05-13,France,NA,Auvergne-Rhone-Alpes,8005882,57,9,2180,436
2020-05-14,France,NA,Auvergne-Rhone-Alpes,8005882,103,11,2283,456
2020-05-15,France,NA,Auvergne-Rhone-Alpes,8005882,79,11,2362,472
2020-05-16,France,NA,Auvergne-Rhone-Alpes,8005882,25,14,2387,477
2020-05-17,France,NA,Auvergne-Rhone-Alpes,8005882,13,2,2400,480
2020-05-18,France,NA,Auvergne-Rhone-Alpes,8005882,73,7,2473,494
2020-05-19,France,NA,Auvergne-Rhone-Alpes,8005882,72,20,2545,509
2020-05-20,France,NA,Auvergne-Rhone-Alpes,8005882,60,12,2605,521
2020-05-21,France,NA,Auvergne-Rhone-Alpes,8005882,15,5,2620,524
2020-05-22,France,NA,Auvergne-Rhone-Alpes,8005882,73,7,2693,538
2020-05-23,France,NA,Auvergne-Rhone-Alpes,8005882,22,8,2715,543
2020-05-24,France,NA,Auvergne-Rhone-Alpes,8005882,2,0,2717,543
2020-05-25,France,NA,Auvergne-Rhone-Alpes,8005882,43,10,2760,552
2020-05-26,France,NA,Auvergne-Rhone-Alpes,8005882,42,12,2802,560
2020-05-27,France,NA,Auvergne-Rhone-Alpes,8005882,47,7,2849,569
2020-05-28,France,NA,Auvergne-Rhone-Alpes,8005882,51,9,2900,580
2020-05-29,France,NA,Auvergne-Rhone-Alpes,8005882,51,8,2951,590
2020-05-30,France,NA,Auvergne-Rhone-Alpes,8005882,22,1,2973,594
2020-05-31,France,NA,Auvergne-Rhone-Alpes,8005882,3,3,2976,595
2020-06-01,France,NA,Auvergne-Rhone-Alpes,8005882,16,2,2992,598
2020-06-02,France,NA,Auvergne-Rhone-Alpes,8005882,49,10,3041,608
2020-06-03,France,NA,Auvergne-Rhone-Alpes,8005882,38,7,3079,615
2020-06-04,France,NA,Auvergne-Rhone-Alpes,8005882,27,2,3106,621
2020-06-05,France,NA,Auvergne-Rhone-Alpes,8005882,27,0,3133,626
2020-06-06,France,NA,Auvergne-Rhone-Alpes,8005882,20,2,3153,630
2020-06-07,France,NA,Auvergne-Rhone-Alpes,8005882,7,1,3160,632
2020-06-08,France,NA,Auvergne-Rhone-Alpes,8005882,39,7,3199,639
2020-06-09,France,NA,Auvergne-Rhone-Alpes,8005882,25,3,3224,644
2020-06-10,France,NA,Auvergne-Rhone-Alpes,8005882,33,5,3257,651
2020-06-11,France,NA,Auvergne-Rhone-Alpes,8005882,51,4,3308,661
2020-06-12,France,NA,Auvergne-Rhone-Alpes,8005882,41,1,3349,669
2020-06-13,France,NA,Auvergne-Rhone-Alpes,8005882,7,1,3356,671
2020-06-14,France,NA,Auvergne-Rhone-Alpes,8005882,10,0,3366,673
2020-06-15,France,NA,Auvergne-Rhone-Alpes,8005882,33,2,3399,679
2020-06-16,France,NA,Auvergne-Rhone-Alpes,8005882,29,1,3428,685
2020-06-17,France,NA,Auvergne-Rhone-Alpes,8005882,41,0,3469,693
2020-06-18,France,NA,Auvergne-Rhone-Alpes,8005882,36,1,3505,701
2020-06-19,France,NA,Auvergne-Rhone-Alpes,8005882,40,0,3545,709
2020-06-20,France,NA,Auvergne-Rhone-Alpes,8005882,28,1,3573,714
2020-06-21,France,NA,Auvergne-Rhone-Alpes,8005882,2,0,3575,715
2020-06-22,France,NA,Auvergne-Rhone-Alpes,8005882,32,3,3607,721
2020-06-23,France,NA,Auvergne-Rhone-Alpes,8005882,33,1,3640,728
2020-06-24,France,NA,Auvergne-Rhone-Alpes,8005882,47,1,3687,737
2020-06-25,France,NA,Auvergne-Rhone-Alpes,8005882,34,0,3721,744
2020-06-26,France,NA,Auvergne-Rhone-Alpes,8005882,48,1,3769,753
2020-06-27,France,NA,Auvergne-Rhone-Alpes,8005882,28,0,3797,753
2020-06-28,France,NA,Auvergne-Rhone-Alpes,8005882,9,1,3806,753
2020-06-29,France,NA,Auvergne-Rhone-Alpes,8005882,41,0,3847,753
2020-06-30,France,NA,Auvergne-Rhone-Alpes,8005882,41,1485,3888,777
2020-07-01,France,NA,Auvergne-Rhone-Alpes,8005882,31,0,3919,783
2020-07-02,France,NA,Auvergne-Rhone-Alpes,8005882,39,1,3958,791
2020-07-03,France,NA,Auvergne-Rhone-Alpes,8005882,38,2,3996,799
2020-07-04,France,NA,Auvergne-Rhone-Alpes,8005882,12,0,4008,801
2020-07-05,France,NA,Auvergne-Rhone-Alpes,8005882,3,1,4011,802
2020-07-06,France,NA,Auvergne-Rhone-Alpes,8005882,31,1,4042,808
2020-07-07,France,NA,Auvergne-Rhone-Alpes,8005882,36,0,4078,815
2020-07-08,France,NA,Auvergne-Rhone-Alpes,8005882,61,1,4139,827
2020-07-09,France,NA,Auvergne-Rhone-Alpes,8005882,51,2,4190,838
2020-07-10,France,NA,Auvergne-Rhone-Alpes,8005882,78,2,4268,853
2020-07-11,France,NA,Auvergne-Rhone-Alpes,8005882,25,0,4293,858
2020-07-12,France,NA,Auvergne-Rhone-Alpes,8005882,6,0,4299,859
2020-07-13,France,NA,Auvergne-Rhone-Alpes,8005882,73,0,4372,874
2020-07-14,France,NA,Auvergne-Rhone-Alpes,8005882,5,0,4377,875
2020-07-15,France,NA,Auvergne-Rhone-Alpes,8005882,56,1,4433,886
2020-07-16,France,NA,Auvergne-Rhone-Alpes,8005882,61,0,4494,898
2020-07-17,France,NA,Auvergne-Rhone-Alpes,8005882,65,1,4559,911
2020-07-18,France,NA,Auvergne-Rhone-Alpes,8005882,32,0,4591,918
2020-07-19,France,NA,Auvergne-Rhone-Alpes,8005882,9,1,4600,920
2020-07-20,France,NA,Auvergne-Rhone-Alpes,8005882,75,2,4675,935
2020-07-21,France,NA,Auvergne-Rhone-Alpes,8005882,86,0,4761,952
2020-07-22,France,NA,Auvergne-Rhone-Alpes,8005882,88,0,4849,969
2020-07-23,France,NA,Auvergne-Rhone-Alpes,8005882,92,2,4941,988
2020-07-24,France,NA,Auvergne-Rhone-Alpes,8005882,135,2,5076,1015
2020-07-25,France,NA,Auvergne-Rhone-Alpes,8005882,68,1,5144,1028
2020-07-26,France,NA,Auvergne-Rhone-Alpes,8005882,41,0,5185,1037
2020-07-27,France,NA,Auvergne-Rhone-Alpes,8005882,131,1,5316,1063
2020-07-28,France,NA,Auvergne-Rhone-Alpes,8005882,103,1,5419,1083
2020-07-29,France,NA,Auvergne-Rhone-Alpes,8005882,127,0,5546,1109
2020-07-30,France,NA,Auvergne-Rhone-Alpes,8005882,140,1,5686,1137
2020-07-31,France,NA,Auvergne-Rhone-Alpes,8005882,118,0,5804,1160
2020-08-01,France,NA,Auvergne-Rhone-Alpes,8005882,59,0,5863,1172
2020-08-02,France,NA,Auvergne-Rhone-Alpes,8005882,12,0,5875,1175
2020-08-03,France,NA,Auvergne-Rhone-Alpes,8005882,145,1,6020,1204
2020-08-04,France,NA,Auvergne-Rhone-Alpes,8005882,146,0,6166,1233
2020-08-05,France,NA,Auvergne-Rhone-Alpes,8005882,148,0,6314,1262
2020-08-06,France,NA,Auvergne-Rhone-Alpes,8005882,123,0,6437,1287
2020-08-07,France,NA,Auvergne-Rhone-Alpes,8005882,158,0,6595,1319
2020-08-08,France,NA,Auvergne-Rhone-Alpes,8005882,77,0,6672,1334
2020-08-09,France,NA,Auvergne-Rhone-Alpes,8005882,19,0,6691,1338
2020-08-10,France,NA,Auvergne-Rhone-Alpes,8005882,210,0,6901,1380
2020-08-11,France,NA,Auvergne-Rhone-Alpes,8005882,194,2,7095,1419
2020-08-12,France,NA,Auvergne-Rhone-Alpes,8005882,224,2,7319,1463
2020-08-13,France,NA,Auvergne-Rhone-Alpes,8005882,258,1,7577,1515
2020-08-14,France,NA,Auvergne-Rhone-Alpes,8005882,315,1,7892,1578
2020-08-15,France,NA,Auvergne-Rhone-Alpes,8005882,43,1,7935,1587
2020-08-16,France,NA,Auvergne-Rhone-Alpes,8005882,46,0,7981,1596
2020-08-17,France,NA,Auvergne-Rhone-Alpes,8005882,500,3,8481,1696
2020-08-18,France,NA,Auvergne-Rhone-Alpes,8005882,408,0,8889,1771
2020-08-19,France,NA,Auvergne-Rhone-Alpes,8005882,435,1,9324,1772
2020-08-20,France,NA,Auvergne-Rhone-Alpes,8005882,523,0,9847,1772
2020-08-21,France,NA,Auvergne-Rhone-Alpes,8005882,592,0,10439,1772
2020-08-22,France,NA,Auvergne-Rhone-Alpes,8005882,160,0,10599,1772
2020-08-23,France,NA,Auvergne-Rhone-Alpes,8005882,71,0,10670,1772
2020-08-24,France,NA,Auvergne-Rhone-Alpes,8005882,658,3,11328,1774
2020-08-25,France,NA,Auvergne-Rhone-Alpes,8005882,633,2,11961,1776
2020-08-26,France,NA,Auvergne-Rhone-Alpes,8005882,690,0,12651,1776
2020-08-27,France,NA,Auvergne-Rhone-Alpes,8005882,769,0,13420,1776
2020-08-28,France,NA,Auvergne-Rhone-Alpes,8005882,784,1,14204,1777
2020-08-29,France,NA,Auvergne-Rhone-Alpes,8005882,304,1,14508,1778
2020-08-30,France,NA,Auvergne-Rhone-Alpes,8005882,102,0,14610,1778
2020-08-31,France,NA,Auvergne-Rhone-Alpes,8005882,1025,1,15635,1779
2020-09-01,France,NA,Auvergne-Rhone-Alpes,8005882,1009,1,16644,1780
2020-09-02,France,NA,Auvergne-Rhone-Alpes,8005882,952,1,17596,1781
2020-09-03,France,NA,Auvergne-Rhone-Alpes,8005882,1170,2,18766,1783
2020-09-04,France,NA,Auvergne-Rhone-Alpes,8005882,1083,0,19849,1783
2020-09-05,France,NA,Auvergne-Rhone-Alpes,8005882,400,0,20249,1783
2020-09-06,France,NA,Auvergne-Rhone-Alpes,8005882,117,1,20366,1784
2020-09-07,France,NA,Auvergne-Rhone-Alpes,8005882,1361,3,21727,1787
2020-09-08,France,NA,Auvergne-Rhone-Alpes,8005882,1545,8,23272,1795
2020-09-09,France,NA,Auvergne-Rhone-Alpes,8005882,1372,4,24644,1799
2020-09-10,France,NA,Auvergne-Rhone-Alpes,8005882,1431,2,26075,1801
2020-09-11,France,NA,Auvergne-Rhone-Alpes,8005882,1333,0,27408,1801
2020-09-12,France,NA,Auvergne-Rhone-Alpes,8005882,533,2,27941,1803
2020-09-13,France,NA,Auvergne-Rhone-Alpes,8005882,129,1,28070,1804
2020-09-14,France,NA,Auvergne-Rhone-Alpes,8005882,1697,5,29767,1809
2020-09-15,France,NA,Auvergne-Rhone-Alpes,8005882,1637,3,31404,1812
2020-09-16,France,NA,Auvergne-Rhone-Alpes,8005882,1709,4,33113,1816
2020-09-17,France,NA,Auvergne-Rhone-Alpes,8005882,1685,7,34798,1823
2020-09-18,France,NA,Auvergne-Rhone-Alpes,8005882,1520,9,36318,1832
2020-09-19,France,NA,Auvergne-Rhone-Alpes,8005882,525,4,36843,1836
2020-09-20,France,NA,Auvergne-Rhone-Alpes,8005882,161,2,37004,1838
2020-09-21,France,NA,Auvergne-Rhone-Alpes,8005882,1864,13,38868,1851
2020-03-18,France,NA,Bourgogne-Franche-Comte,2793333,8,0,16,3
2020-03-19,France,NA,Bourgogne-Franche-Comte,2793333,13,8,29,5
2020-03-20,France,NA,Bourgogne-Franche-Comte,2793333,13,8,42,8
2020-03-21,France,NA,Bourgogne-Franche-Comte,2793333,8,5,50,10
2020-03-22,France,NA,Bourgogne-Franche-Comte,2793333,0,13,50,10
2020-03-23,France,NA,Bourgogne-Franche-Comte,2793333,41,22,91,18
2020-03-24,France,NA,Bourgogne-Franche-Comte,2793333,43,23,134,26
2020-03-25,France,NA,Bourgogne-Franche-Comte,2793333,46,17,180,36
2020-03-26,France,NA,Bourgogne-Franche-Comte,2793333,43,21,223,44
2020-03-27,France,NA,Bourgogne-Franche-Comte,2793333,38,16,261,52
2020-03-28,France,NA,Bourgogne-Franche-Comte,2793333,16,9,277,55
2020-03-29,France,NA,Bourgogne-Franche-Comte,2793333,0,16,277,55
2020-03-30,France,NA,Bourgogne-Franche-Comte,2793333,38,23,315,63
2020-03-31,France,NA,Bourgogne-Franche-Comte,2793333,51,27,366,73
2020-04-01,France,NA,Bourgogne-Franche-Comte,2793333,45,16,411,82
2020-04-02,France,NA,Bourgogne-Franche-Comte,2793333,52,41,463,92
2020-04-03,France,NA,Bourgogne-Franche-Comte,2793333,58,32,521,104
2020-04-04,France,NA,Bourgogne-Franche-Comte,2793333,3,20,524,104
2020-04-05,France,NA,Bourgogne-Franche-Comte,2793333,0,18,524,104
2020-04-06,France,NA,Bourgogne-Franche-Comte,2793333,76,26,600,120
2020-04-07,France,NA,Bourgogne-Franche-Comte,2793333,46,29,646,129
2020-04-08,France,NA,Bourgogne-Franche-Comte,2793333,56,16,702,140
2020-04-09,France,NA,Bourgogne-Franche-Comte,2793333,77,15,779,155
2020-04-10,France,NA,Bourgogne-Franche-Comte,2793333,82,32,861,172
2020-04-11,France,NA,Bourgogne-Franche-Comte,2793333,5,19,866,173
2020-04-12,France,NA,Bourgogne-Franche-Comte,2793333,2,22,868,173
2020-04-13,France,NA,Bourgogne-Franche-Comte,2793333,6,12,874,174
2020-04-14,France,NA,Bourgogne-Franche-Comte,2793333,71,39,945,189
2020-04-15,France,NA,Bourgogne-Franche-Comte,2793333,59,30,1004,200
2020-04-16,France,NA,Bourgogne-Franche-Comte,2793333,27,26,1031,206
2020-04-17,France,NA,Bourgogne-Franche-Comte,2793333,44,16,1075,215
2020-04-18,France,NA,Bourgogne-Franche-Comte,2793333,5,21,1080,216
2020-04-19,France,NA,Bourgogne-Franche-Comte,2793333,2,13,1082,216
2020-04-20,France,NA,Bourgogne-Franche-Comte,2793333,36,20,1118,223
2020-04-21,France,NA,Bourgogne-Franche-Comte,2793333,34,28,1152,230
2020-04-22,France,NA,Bourgogne-Franche-Comte,2793333,17,16,1169,233
2020-04-23,France,NA,Bourgogne-Franche-Comte,2793333,16,32,1185,237
2020-04-24,France,NA,Bourgogne-Franche-Comte,2793333,17,17,1202,240
2020-04-25,France,NA,Bourgogne-Franche-Comte,2793333,1,16,1203,240
2020-04-26,France,NA,Bourgogne-Franche-Comte,2793333,0,11,1203,240
2020-04-27,France,NA,Bourgogne-Franche-Comte,2793333,8,17,1211,242
2020-04-28,France,NA,Bourgogne-Franche-Comte,2793333,10,5,1221,244
2020-04-29,France,NA,Bourgogne-Franche-Comte,2793333,18,13,1239,247
2020-04-30,France,NA,Bourgogne-Franche-Comte,2793333,13,6,1252,250
2020-05-01,France,NA,Bourgogne-Franche-Comte,2793333,0,5,1252,250
2020-05-02,France,NA,Bourgogne-Franche-Comte,2793333,2,7,1254,250
2020-05-03,France,NA,Bourgogne-Franche-Comte,2793333,0,6,1254,250
2020-05-04,France,NA,Bourgogne-Franche-Comte,2793333,8,13,1262,252
2020-05-05,France,NA,Bourgogne-Franche-Comte,2793333,11,15,1273,254
2020-05-06,France,NA,Bourgogne-Franche-Comte,2793333,12,12,1285,257
2020-05-07,France,NA,Bourgogne-Franche-Comte,2793333,10,10,1295,259
2020-05-08,France,NA,Bourgogne-Franche-Comte,2793333,0,8,1295,259
2020-05-09,France,NA,Bourgogne-Franche-Comte,2793333,0,7,1295,259
2020-05-10,France,NA,Bourgogne-Franche-Comte,2793333,0,5,1295,259
2020-05-11,France,NA,Bourgogne-Franche-Comte,2793333,13,13,1308,261
2020-05-12,France,NA,Bourgogne-Franche-Comte,2793333,1,8,1309,261
2020-05-13,France,NA,Bourgogne-Franche-Comte,2793333,20,6,1329,265
2020-05-14,France,NA,Bourgogne-Franche-Comte,2793333,33,3,1362,272
2020-05-15,France,NA,Bourgogne-Franche-Comte,2793333,64,2,1426,285
2020-05-16,France,NA,Bourgogne-Franche-Comte,2793333,23,1,1449,289
2020-05-17,France,NA,Bourgogne-Franche-Comte,2793333,8,0,1457,291
2020-05-18,France,NA,Bourgogne-Franche-Comte,2793333,41,10,1498,299
2020-05-19,France,NA,Bourgogne-Franche-Comte,2793333,38,9,1536,307
2020-05-20,France,NA,Bourgogne-Franche-Comte,2793333,30,2,1566,313
2020-05-21,France,NA,Bourgogne-Franche-Comte,2793333,5,3,1571,314
2020-05-22,France,NA,Bourgogne-Franche-Comte,2793333,35,5,1606,321
2020-05-23,France,NA,Bourgogne-Franche-Comte,2793333,12,0,1618,323
2020-05-24,France,NA,Bourgogne-Franche-Comte,2793333,6,2,1624,324
2020-05-25,France,NA,Bourgogne-Franche-Comte,2793333,22,4,1646,329
2020-05-26,France,NA,Bourgogne-Franche-Comte,2793333,11,3,1657,331
2020-05-27,France,NA,Bourgogne-Franche-Comte,2793333,15,4,1672,334
2020-05-28,France,NA,Bourgogne-Franche-Comte,2793333,13,3,1685,337
2020-05-29,France,NA,Bourgogne-Franche-Comte,2793333,8,4,1693,338
2020-05-30,France,NA,Bourgogne-Franche-Comte,2793333,12,1,1705,341
2020-05-31,France,NA,Bourgogne-Franche-Comte,2793333,4,1,1709,341
2020-06-01,France,NA,Bourgogne-Franche-Comte,2793333,3,1,1712,342
2020-06-02,France,NA,Bourgogne-Franche-Comte,2793333,26,2,1738,347
2020-06-03,France,NA,Bourgogne-Franche-Comte,2793333,15,4,1753,350
2020-06-04,France,NA,Bourgogne-Franche-Comte,2793333,13,5,1766,353
2020-06-05,France,NA,Bourgogne-Franche-Comte,2793333,12,0,1778,355
2020-06-06,France,NA,Bourgogne-Franche-Comte,2793333,8,0,1786,357
2020-06-07,France,NA,Bourgogne-Franche-Comte,2793333,0,0,1786,357
2020-06-08,France,NA,Bourgogne-Franche-Comte,2793333,9,1,1795,359
2020-06-09,France,NA,Bourgogne-Franche-Comte,2793333,9,4,1804,360
2020-06-10,France,NA,Bourgogne-Franche-Comte,2793333,18,4,1822,364
2020-06-11,France,NA,Bourgogne-Franche-Comte,2793333,8,0,1830,366
2020-06-12,France,NA,Bourgogne-Franche-Comte,2793333,15,0,1845,369
2020-06-13,France,NA,Bourgogne-Franche-Comte,2793333,1,2,1846,369
2020-06-14,France,NA,Bourgogne-Franche-Comte,2793333,3,0,1849,369
2020-06-15,France,NA,Bourgogne-Franche-Comte,2793333,9,0,1858,371
2020-06-16,France,NA,Bourgogne-Franche-Comte,2793333,9,0,1867,373
2020-06-17,France,NA,Bourgogne-Franche-Comte,2793333,9,1,1876,375
2020-06-18,France,NA,Bourgogne-Franche-Comte,2793333,8,1,1884,376
2020-06-19,France,NA,Bourgogne-Franche-Comte,2793333,13,0,1897,379
2020-06-20,France,NA,Bourgogne-Franche-Comte,2793333,2,0,1899,379
2020-06-21,France,NA,Bourgogne-Franche-Comte,2793333,2,0,1901,380
2020-06-22,France,NA,Bourgogne-Franche-Comte,2793333,7,1,1908,381
2020-06-23,France,NA,Bourgogne-Franche-Comte,2793333,9,0,1917,383
2020-06-24,France,NA,Bourgogne-Franche-Comte,2793333,11,1,1928,385
2020-06-25,France,NA,Bourgogne-Franche-Comte,2793333,8,1,1936,387
2020-06-26,France,NA,Bourgogne-Franche-Comte,2793333,7,0,1943,388
2020-06-27,France,NA,Bourgogne-Franche-Comte,2793333,8,0,1951,390
2020-06-28,France,NA,Bourgogne-Franche-Comte,2793333,7,0,1958,391
2020-06-29,France,NA,Bourgogne-Franche-Comte,2793333,13,1,1971,394
2020-06-30,France,NA,Bourgogne-Franche-Comte,2793333,15,0,1986,397
2020-07-01,France,NA,Bourgogne-Franche-Comte,2793333,20,3,2006,401
2020-07-02,France,NA,Bourgogne-Franche-Comte,2793333,8,1,2014,402
2020-07-03,France,NA,Bourgogne-Franche-Comte,2793333,6,0,2020,404
2020-07-04,France,NA,Bourgogne-Franche-Comte,2793333,8,0,2028,405
2020-07-05,France,NA,Bourgogne-Franche-Comte,2793333,3,0,2031,406
2020-07-06,France,NA,Bourgogne-Franche-Comte,2793333,9,0,2040,408
2020-07-07,France,NA,Bourgogne-Franche-Comte,2793333,14,2,2054,410
2020-07-08,France,NA,Bourgogne-Franche-Comte,2793333,17,0,2071,414
2020-07-09,France,NA,Bourgogne-Franche-Comte,2793333,18,1,2089,417
2020-07-10,France,NA,Bourgogne-Franche-Comte,2793333,14,12,2103,420
2020-07-11,France,NA,Bourgogne-Franche-Comte,2793333,11,0,2114,422
2020-07-12,France,NA,Bourgogne-Franche-Comte,2793333,6,0,2120,424
2020-07-13,France,NA,Bourgogne-Franche-Comte,2793333,14,1,2134,426
2020-07-14,France,NA,Bourgogne-Franche-Comte,2793333,4,0,2138,427
2020-07-15,France,NA,Bourgogne-Franche-Comte,2793333,13,2,2151,430
2020-07-16,France,NA,Bourgogne-Franche-Comte,2793333,11,0,2162,432
2020-07-17,France,NA,Bourgogne-Franche-Comte,2793333,21,1,2183,436
2020-07-18,France,NA,Bourgogne-Franche-Comte,2793333,5,0,2188,437
2020-07-19,France,NA,Bourgogne-Franche-Comte,2793333,5,0,2193,438
2020-07-20,France,NA,Bourgogne-Franche-Comte,2793333,20,0,2213,442
2020-07-21,France,NA,Bourgogne-Franche-Comte,2793333,11,0,2224,444
2020-07-22,France,NA,Bourgogne-Franche-Comte,2793333,8,0,2232,446
2020-07-23,France,NA,Bourgogne-Franche-Comte,2793333,23,0,2255,451
2020-07-24,France,NA,Bourgogne-Franche-Comte,2793333,22,1,2277,455
2020-07-25,France,NA,Bourgogne-Franche-Comte,2793333,10,0,2287,457
2020-07-26,France,NA,Bourgogne-Franche-Comte,2793333,7,0,2294,458
2020-07-27,France,NA,Bourgogne-Franche-Comte,2793333,28,0,2322,464
2020-07-28,France,NA,Bourgogne-Franche-Comte,2793333,12,0,2334,466
2020-07-29,France,NA,Bourgogne-Franche-Comte,2793333,19,0,2353,470
2020-07-30,France,NA,Bourgogne-Franche-Comte,2793333,20,0,2373,474
2020-07-31,France,NA,Bourgogne-Franche-Comte,2793333,23,0,2396,479
2020-08-01,France,NA,Bourgogne-Franche-Comte,2793333,8,0,2404,480
2020-08-02,France,NA,Bourgogne-Franche-Comte,2793333,6,0,2410,482
2020-08-03,France,NA,Bourgogne-Franche-Comte,2793333,31,0,2441,488
2020-08-04,France,NA,Bourgogne-Franche-Comte,2793333,18,0,2459,491
2020-08-05,France,NA,Bourgogne-Franche-Comte,2793333,33,1,2492,498
2020-08-06,France,NA,Bourgogne-Franche-Comte,2793333,31,0,2523,504
2020-08-07,France,NA,Bourgogne-Franche-Comte,2793333,33,0,2556,511
2020-08-08,France,NA,Bourgogne-Franche-Comte,2793333,19,0,2575,515
2020-08-09,France,NA,Bourgogne-Franche-Comte,2793333,4,0,2579,515
2020-08-10,France,NA,Bourgogne-Franche-Comte,2793333,39,0,2618,523
2020-08-11,France,NA,Bourgogne-Franche-Comte,2793333,38,0,2656,531
2020-08-12,France,NA,Bourgogne-Franche-Comte,2793333,43,0,2699,539
2020-08-13,France,NA,Bourgogne-Franche-Comte,2793333,47,0,2746,549
2020-08-14,France,NA,Bourgogne-Franche-Comte,2793333,60,0,2806,561
2020-08-15,France,NA,Bourgogne-Franche-Comte,2793333,22,0,2828,565
2020-08-16,France,NA,Bourgogne-Franche-Comte,2793333,23,0,2851,570
2020-08-17,France,NA,Bourgogne-Franche-Comte,2793333,98,1,2949,589
2020-08-18,France,NA,Bourgogne-Franche-Comte,2793333,94,0,3043,608
2020-08-19,France,NA,Bourgogne-Franche-Comte,2793333,82,1,3125,625
2020-08-20,France,NA,Bourgogne-Franche-Comte,2793333,85,0,3210,642
2020-08-21,France,NA,Bourgogne-Franche-Comte,2793333,116,0,3326,665
2020-08-22,France,NA,Bourgogne-Franche-Comte,2793333,65,0,3391,678
2020-08-23,France,NA,Bourgogne-Franche-Comte,2793333,37,0,3428,685
2020-08-24,France,NA,Bourgogne-Franche-Comte,2793333,146,1,3574,714
2020-08-25,France,NA,Bourgogne-Franche-Comte,2793333,129,0,3703,740
2020-08-26,France,NA,Bourgogne-Franche-Comte,2793333,146,0,3849,769
2020-08-27,France,NA,Bourgogne-Franche-Comte,2793333,170,0,4019,803
2020-08-28,France,NA,Bourgogne-Franche-Comte,2793333,187,0,4206,841
2020-08-29,France,NA,Bourgogne-Franche-Comte,2793333,85,0,4291,858
2020-08-30,France,NA,Bourgogne-Franche-Comte,2793333,34,0,4325,865
2020-08-31,France,NA,Bourgogne-Franche-Comte,2793333,193,0,4518,903
2020-09-01,France,NA,Bourgogne-Franche-Comte,2793333,188,0,4706,941
2020-09-02,France,NA,Bourgogne-Franche-Comte,2793333,169,0,4875,975
2020-09-03,France,NA,Bourgogne-Franche-Comte,2793333,189,0,5064,1012
2020-09-04,France,NA,Bourgogne-Franche-Comte,2793333,228,0,5292,1058
2020-09-05,France,NA,Bourgogne-Franche-Comte,2793333,117,0,5409,1065
2020-09-06,France,NA,Bourgogne-Franche-Comte,2793333,46,0,5455,1065
2020-09-07,France,NA,Bourgogne-Franche-Comte,2793333,278,0,5733,1065
2020-09-08,France,NA,Bourgogne-Franche-Comte,2793333,273,0,6006,1065
2020-09-09,France,NA,Bourgogne-Franche-Comte,2793333,202,1,6208,1066
2020-09-10,France,NA,Bourgogne-Franche-Comte,2793333,278,1,6486,1067
2020-09-11,France,NA,Bourgogne-Franche-Comte,2793333,294,0,6780,1067
2020-09-12,France,NA,Bourgogne-Franche-Comte,2793333,156,0,6936,1067
2020-09-13,France,NA,Bourgogne-Franche-Comte,2793333,64,0,7000,1067
2020-09-14,France,NA,Bourgogne-Franche-Comte,2793333,334,1,7334,1068
2020-09-15,France,NA,Bourgogne-Franche-Comte,2793333,262,0,7596,1068
2020-09-16,France,NA,Bourgogne-Franche-Comte,2793333,305,0,7901,1068
2020-09-17,France,NA,Bourgogne-Franche-Comte,2793333,329,3,8230,1071
2020-09-18,France,NA,Bourgogne-Franche-Comte,2793333,311,1,8541,1072
2020-09-19,France,NA,Bourgogne-Franche-Comte,2793333,131,0,8672,1072
2020-09-20,France,NA,Bourgogne-Franche-Comte,2793333,68,0,8740,1072
2020-09-21,France,NA,Bourgogne-Franche-Comte,2793333,310,0,9050,1072
2020-03-31,France,NA,Brittany,3333720,2,5,12,2
2020-04-01,France,NA,Brittany,3333720,0,5,12,2
2020-04-02,France,NA,Brittany,3333720,1,8,13,2
2020-04-03,France,NA,Brittany,3333720,2,6,15,3
2020-04-04,France,NA,Brittany,3333720,0,6,15,3
2020-04-05,France,NA,Brittany,3333720,0,6,15,3
2020-04-06,France,NA,Brittany,3333720,1,7,16,3
2020-04-07,France,NA,Brittany,3333720,0,9,16,3
2020-04-08,France,NA,Brittany,3333720,0,10,16,3
2020-04-09,France,NA,Brittany,3333720,0,2,16,3
2020-04-10,France,NA,Brittany,3333720,0,12,16,3
2020-04-11,France,NA,Brittany,3333720,0,8,16,3
2020-04-12,France,NA,Brittany,3333720,0,3,16,3
2020-04-13,France,NA,Brittany,3333720,0,4,16,3
2020-04-14,France,NA,Brittany,3333720,0,13,16,3
2020-04-15,France,NA,Brittany,3333720,0,10,16,3
2020-04-16,France,NA,Brittany,3333720,1,7,17,3
2020-04-17,France,NA,Brittany,3333720,0,5,17,3
2020-04-18,France,NA,Brittany,3333720,0,10,17,3
2020-04-19,France,NA,Brittany,3333720,0,4,17,3
2020-04-20,France,NA,Brittany,3333720,1,4,18,3
2020-04-21,France,NA,Brittany,3333720,1,4,19,3
2020-04-22,France,NA,Brittany,3333720,2,0,21,4
2020-04-23,France,NA,Brittany,3333720,1,6,22,4
2020-04-24,France,NA,Brittany,3333720,0,0,22,4
2020-04-25,France,NA,Brittany,3333720,0,3,22,4
2020-04-26,France,NA,Brittany,3333720,0,1,22,4
2020-04-27,France,NA,Brittany,3333720,0,1,22,4
2020-04-28,France,NA,Brittany,3333720,0,3,22,4
2020-04-29,France,NA,Brittany,3333720,0,3,22,4
2020-04-30,France,NA,Brittany,3333720,0,2,22,4
2020-05-01,France,NA,Brittany,3333720,0,0,22,4
2020-05-02,France,NA,Brittany,3333720,0,4,22,4
2020-05-03,France,NA,Brittany,3333720,0,3,22,4
2020-05-04,France,NA,Brittany,3333720,0,3,22,4
2020-05-05,France,NA,Brittany,3333720,0,0,22,4
2020-05-06,France,NA,Brittany,3333720,0,1,22,4
2020-05-07,France,NA,Brittany,3333720,0,1,22,4
2020-05-08,France,NA,Brittany,3333720,0,1,22,4
2020-05-09,France,NA,Brittany,3333720,0,1,22,4
2020-05-10,France,NA,Brittany,3333720,0,1,22,4
2020-05-11,France,NA,Brittany,3333720,0,3,22,4
2020-05-12,France,NA,Brittany,3333720,1,1,23,4
2020-05-13,France,NA,Brittany,3333720,10,1,33,6
2020-05-14,France,NA,Brittany,3333720,17,0,50,10
2020-05-15,France,NA,Brittany,3333720,81,1,131,26
2020-05-16,France,NA,Brittany,3333720,17,2,148,29
2020-05-17,France,NA,Brittany,3333720,3,1,151,30
2020-05-18,France,NA,Brittany,3333720,24,3,175,35
2020-05-19,France,NA,Brittany,3333720,53,1,228,45
2020-05-20,France,NA,Brittany,3333720,37,0,265,53
2020-05-21,France,NA,Brittany,3333720,28,1,293,58
2020-05-22,France,NA,Brittany,3333720,27,1,320,64
2020-05-23,France,NA,Brittany,3333720,11,0,331,66
2020-05-24,France,NA,Brittany,3333720,7,0,338,67
2020-05-25,France,NA,Brittany,3333720,21,2,359,71
2020-05-26,France,NA,Brittany,3333720,18,2,377,75
2020-05-27,France,NA,Brittany,3333720,21,2,398,79
2020-05-28,France,NA,Brittany,3333720,18,1,416,83
2020-05-29,France,NA,Brittany,3333720,6,0,422,84
2020-05-30,France,NA,Brittany,3333720,7,0,429,85
2020-05-31,France,NA,Brittany,3333720,4,0,433,86
2020-06-01,France,NA,Brittany,3333720,1,2,434,86
2020-06-02,France,NA,Brittany,3333720,8,1,442,88
2020-06-03,France,NA,Brittany,3333720,7,1,449,89
2020-06-04,France,NA,Brittany,3333720,5,1,454,90
2020-06-05,France,NA,Brittany,3333720,5,1,459,91
2020-06-06,France,NA,Brittany,3333720,5,0,464,92
2020-06-07,France,NA,Brittany,3333720,1,0,465,93
2020-06-08,France,NA,Brittany,3333720,6,0,471,94
2020-06-09,France,NA,Brittany,3333720,5,0,476,95
2020-06-10,France,NA,Brittany,3333720,5,0,481,96
2020-06-11,France,NA,Brittany,3333720,0,0,481,96
2020-06-12,France,NA,Brittany,3333720,3,1,484,96
2020-06-13,France,NA,Brittany,3333720,0,0,484,96
2020-06-14,France,NA,Brittany,3333720,1,1,485,97
2020-06-15,France,NA,Brittany,3333720,3,0,488,97
2020-06-16,France,NA,Brittany,3333720,5,0,493,98
2020-06-17,France,NA,Brittany,3333720,6,0,499,99
2020-06-18,France,NA,Brittany,3333720,3,0,502,100
2020-06-19,France,NA,Brittany,3333720,4,0,506,101
2020-06-20,France,NA,Brittany,3333720,0,0,506,101
2020-06-21,France,NA,Brittany,3333720,1,0,507,101
2020-06-22,France,NA,Brittany,3333720,5,0,512,102
2020-06-23,France,NA,Brittany,3333720,5,1,517,103
2020-06-24,France,NA,Brittany,3333720,4,0,521,104
2020-06-25,France,NA,Brittany,3333720,7,0,528,105
2020-06-26,France,NA,Brittany,3333720,6,1,534,106
2020-06-27,France,NA,Brittany,3333720,2,0,536,107
2020-06-28,France,NA,Brittany,3333720,1,0,537,107
2020-06-29,France,NA,Brittany,3333720,3,0,540,108
2020-06-30,France,NA,Brittany,3333720,7,0,547,109
2020-07-01,France,NA,Brittany,3333720,4,0,551,110
2020-07-02,France,NA,Brittany,3333720,3,1,554,110
2020-07-03,France,NA,Brittany,3333720,9,0,563,112
2020-07-04,France,NA,Brittany,3333720,2,0,565,113
2020-07-05,France,NA,Brittany,3333720,0,0,565,113
2020-07-06,France,NA,Brittany,3333720,5,0,570,114
2020-07-07,France,NA,Brittany,3333720,3,0,573,114
2020-07-08,France,NA,Brittany,3333720,13,0,586,117
2020-07-09,France,NA,Brittany,3333720,12,0,598,119
2020-07-10,France,NA,Brittany,3333720,49,0,647,129
2020-07-11,France,NA,Brittany,3333720,12,0,659,131
2020-07-12,France,NA,Brittany,3333720,3,0,662,132
2020-07-13,France,NA,Brittany,3333720,55,0,717,143
2020-07-14,France,NA,Brittany,3333720,0,0,717,143
2020-07-15,France,NA,Brittany,3333720,91,0,808,161
2020-07-16,France,NA,Brittany,3333720,55,1,863,172
2020-07-17,France,NA,Brittany,3333720,27,1,890,178
2020-07-18,France,NA,Brittany,3333720,9,0,899,179
2020-07-19,France,NA,Brittany,3333720,1,0,900,180
2020-07-20,France,NA,Brittany,3333720,26,0,926,185
2020-07-21,France,NA,Brittany,3333720,17,0,943,188
2020-07-22,France,NA,Brittany,3333720,42,0,985,197
2020-07-23,France,NA,Brittany,3333720,31,0,1016,203
2020-07-24,France,NA,Brittany,3333720,56,1,1072,214
2020-07-25,France,NA,Brittany,3333720,49,0,1121,224
2020-07-26,France,NA,Brittany,3333720,10,0,1131,226
2020-07-27,France,NA,Brittany,3333720,54,1,1185,237
2020-07-28,France,NA,Brittany,3333720,71,1,1256,251
2020-07-29,France,NA,Brittany,3333720,33,1,1289,257
2020-07-30,France,NA,Brittany,3333720,36,1,1325,265
2020-07-31,France,NA,Brittany,3333720,63,0,1388,267
2020-08-01,France,NA,Brittany,3333720,22,0,1410,267
2020-08-02,France,NA,Brittany,3333720,14,0,1424,267
2020-08-03,France,NA,Brittany,3333720,79,0,1503,267
2020-08-04,France,NA,Brittany,3333720,76,0,1579,267
2020-08-05,France,NA,Brittany,3333720,86,0,1665,267
2020-08-06,France,NA,Brittany,3333720,50,0,1715,267
2020-08-07,France,NA,Brittany,3333720,72,1,1787,268
2020-08-08,France,NA,Brittany,3333720,30,0,1817,268
2020-08-09,France,NA,Brittany,3333720,10,0,1827,268
2020-08-10,France,NA,Brittany,3333720,58,0,1885,268
2020-08-11,France,NA,Brittany,3333720,56,0,1941,268
2020-08-12,France,NA,Brittany,3333720,47,0,1988,268
2020-08-13,France,NA,Brittany,3333720,67,0,2055,268
2020-08-14,France,NA,Brittany,3333720,105,0,2160,268
2020-08-15,France,NA,Brittany,3333720,9,0,2169,268
2020-08-16,France,NA,Brittany,3333720,17,0,2186,268
2020-08-17,France,NA,Brittany,3333720,96,0,2282,268
2020-08-18,France,NA,Brittany,3333720,110,0,2392,268
2020-08-19,France,NA,Brittany,3333720,95,0,2487,268
2020-08-20,France,NA,Brittany,3333720,101,0,2588,268
2020-08-21,France,NA,Brittany,3333720,91,0,2679,268
2020-08-22,France,NA,Brittany,3333720,63,1,2742,269
2020-08-23,France,NA,Brittany,3333720,22,0,2764,269
2020-08-24,France,NA,Brittany,3333720,118,0,2882,269
2020-08-25,France,NA,Brittany,3333720,123,0,3005,269
2020-08-26,France,NA,Brittany,3333720,127,0,3132,269
2020-08-27,France,NA,Brittany,3333720,132,0,3264,269
2020-08-28,France,NA,Brittany,3333720,145,0,3409,269
2020-08-29,France,NA,Brittany,3333720,80,0,3489,269
2020-08-30,France,NA,Brittany,3333720,32,0,3521,269
2020-08-31,France,NA,Brittany,3333720,191,0,3712,269
2020-09-01,France,NA,Brittany,3333720,190,0,3902,269
2020-09-02,France,NA,Brittany,3333720,199,0,4101,269
2020-09-03,France,NA,Brittany,3333720,297,0,4398,269
2020-09-04,France,NA,Brittany,3333720,267,0,4665,269
2020-09-05,France,NA,Brittany,3333720,137,0,4802,269
2020-09-06,France,NA,Brittany,3333720,49,0,4851,269
2020-09-07,France,NA,Brittany,3333720,296,0,5147,269
2020-09-08,France,NA,Brittany,3333720,266,0,5413,269
2020-09-09,France,NA,Brittany,3333720,324,0,5737,269
2020-09-10,France,NA,Brittany,3333720,299,0,6036,269
2020-09-11,France,NA,Brittany,3333720,252,0,6288,269
2020-09-12,France,NA,Brittany,3333720,137,0,6425,269
2020-09-13,France,NA,Brittany,3333720,60,0,6485,269
2020-09-14,France,NA,Brittany,3333720,292,1,6777,270
2020-09-15,France,NA,Brittany,3333720,362,1,7139,271
2020-09-16,France,NA,Brittany,3333720,359,1,7498,272
2020-09-17,France,NA,Brittany,3333720,398,0,7896,272
2020-09-18,France,NA,Brittany,3333720,411,2,8307,274
2020-09-19,France,NA,Brittany,3333720,165,0,8472,274
2020-09-20,France,NA,Brittany,3333720,74,0,8546,274
2020-09-21,France,NA,Brittany,3333720,339,3,8885,277
2020-03-19,France,NA,Centre-Val de Loire,2565258,14,0,23,1
2020-03-20,France,NA,Centre-Val de Loire,2565258,10,1,33,2
2020-03-21,France,NA,Centre-Val de Loire,2565258,11,0,44,2
2020-03-22,France,NA,Centre-Val de Loire,2565258,5,1,49,3
2020-03-23,France,NA,Centre-Val de Loire,2565258,49,5,98,8
2020-03-24,France,NA,Centre-Val de Loire,2565258,61,1,159,9
2020-03-25,France,NA,Centre-Val de Loire,2565258,62,4,221,13
2020-03-26,France,NA,Centre-Val de Loire,2565258,69,7,290,20
2020-03-27,France,NA,Centre-Val de Loire,2565258,78,6,368,26
2020-03-28,France,NA,Centre-Val de Loire,2565258,26,9,394,35
2020-03-29,France,NA,Centre-Val de Loire,2565258,5,4,399,39
2020-03-30,France,NA,Centre-Val de Loire,2565258,81,14,480,53
2020-03-31,France,NA,Centre-Val de Loire,2565258,90,7,570,60
2020-04-01,France,NA,Centre-Val de Loire,2565258,78,17,648,77
2020-04-02,France,NA,Centre-Val de Loire,2565258,82,7,730,84
2020-04-03,France,NA,Centre-Val de Loire,2565258,73,14,803,98
2020-04-04,France,NA,Centre-Val de Loire,2565258,7,8,810,106
2020-04-05,France,NA,Centre-Val de Loire,2565258,0,9,810,115
2020-04-06,France,NA,Centre-Val de Loire,2565258,96,17,906,132
2020-04-07,France,NA,Centre-Val de Loire,2565258,93,8,999,140
2020-04-08,France,NA,Centre-Val de Loire,2565258,106,14,1105,154
2020-04-09,France,NA,Centre-Val de Loire,2565258,87,10,1192,164
2020-04-10,France,NA,Centre-Val de Loire,2565258,154,15,1346,179
2020-04-11,France,NA,Centre-Val de Loire,2565258,12,14,1358,193
2020-04-12,France,NA,Centre-Val de Loire,2565258,1,8,1359,201
2020-04-13,France,NA,Centre-Val de Loire,2565258,1,13,1360,214
2020-04-14,France,NA,Centre-Val de Loire,2565258,42,13,1402,227
2020-04-15,France,NA,Centre-Val de Loire,2565258,47,18,1449,245
2020-04-16,France,NA,Centre-Val de Loire,2565258,31,7,1480,252
2020-04-17,France,NA,Centre-Val de Loire,2565258,35,12,1515,264
2020-04-18,France,NA,Centre-Val de Loire,2565258,1,12,1516,276
2020-04-19,France,NA,Centre-Val de Loire,2565258,1,8,1517,284
2020-04-20,France,NA,Centre-Val de Loire,2565258,26,14,1543,298
2020-04-21,France,NA,Centre-Val de Loire,2565258,33,10,1576,308
2020-04-22,France,NA,Centre-Val de Loire,2565258,21,20,1597,319
2020-04-23,France,NA,Centre-Val de Loire,2565258,47,6,1644,328
2020-04-24,France,NA,Centre-Val de Loire,2565258,20,9,1664,332
2020-04-25,France,NA,Centre-Val de Loire,2565258,3,5,1667,333
2020-04-26,France,NA,Centre-Val de Loire,2565258,0,7,1667,333
2020-04-27,France,NA,Centre-Val de Loire,2565258,11,12,1678,335
2020-04-28,France,NA,Centre-Val de Loire,2565258,15,3,1693,338
2020-04-29,France,NA,Centre-Val de Loire,2565258,15,13,1708,341
2020-04-30,France,NA,Centre-Val de Loire,2565258,11,5,1719,343
2020-05-01,France,NA,Centre-Val de Loire,2565258,0,7,1719,343
2020-05-02,France,NA,Centre-Val de Loire,2565258,2,2,1721,344
2020-05-03,France,NA,Centre-Val de Loire,2565258,0,4,1721,344
2020-05-04,France,NA,Centre-Val de Loire,2565258,21,10,1742,348
2020-05-05,France,NA,Centre-Val de Loire,2565258,17,10,1759,351
2020-05-06,France,NA,Centre-Val de Loire,2565258,8,8,1767,353
2020-05-07,France,NA,Centre-Val de Loire,2565258,6,5,1773,354
2020-05-08,France,NA,Centre-Val de Loire,2565258,4,5,1777,355
2020-05-09,France,NA,Centre-Val de Loire,2565258,0,2,1777,355
2020-05-10,France,NA,Centre-Val de Loire,2565258,0,3,1777,355
2020-05-11,France,NA,Centre-Val de Loire,2565258,25,5,1802,360
2020-05-12,France,NA,Centre-Val de Loire,2565258,2,5,1804,360
2020-05-13,France,NA,Centre-Val de Loire,2565258,30,2,1834,366
2020-05-14,France,NA,Centre-Val de Loire,2565258,33,5,1867,373
2020-05-15,France,NA,Centre-Val de Loire,2565258,54,7,1921,384
2020-05-16,France,NA,Centre-Val de Loire,2565258,35,3,1956,391
2020-05-17,France,NA,Centre-Val de Loire,2565258,17,2,1973,394
2020-05-18,France,NA,Centre-Val de Loire,2565258,51,4,2024,404
2020-05-19,France,NA,Centre-Val de Loire,2565258,45,6,2069,413
2020-05-20,France,NA,Centre-Val de Loire,2565258,53,7,2122,424
2020-05-21,France,NA,Centre-Val de Loire,2565258,11,2,2133,426
2020-05-22,France,NA,Centre-Val de Loire,2565258,19,1,2152,430
2020-05-23,France,NA,Centre-Val de Loire,2565258,7,2,2159,431
2020-05-24,France,NA,Centre-Val de Loire,2565258,9,1,2168,433
2020-05-25,France,NA,Centre-Val de Loire,2565258,31,3,2199,439
2020-05-26,France,NA,Centre-Val de Loire,2565258,24,2,2223,444
2020-05-27,France,NA,Centre-Val de Loire,2565258,16,1,2239,447
2020-05-28,France,NA,Centre-Val de Loire,2565258,44,0,2283,456
2020-05-29,France,NA,Centre-Val de Loire,2565258,28,5,2311,462
2020-05-30,France,NA,Centre-Val de Loire,2565258,5,0,2316,463
2020-05-31,France,NA,Centre-Val de Loire,2565258,6,1,2322,464
2020-06-01,France,NA,Centre-Val de Loire,2565258,2,1,2324,464
2020-06-02,France,NA,Centre-Val de Loire,2565258,12,1,2336,467
2020-06-03,France,NA,Centre-Val de Loire,2565258,15,5,2351,470
2020-06-04,France,NA,Centre-Val de Loire,2565258,19,3,2370,474
2020-06-05,France,NA,Centre-Val de Loire,2565258,10,0,2380,476
2020-06-06,France,NA,Centre-Val de Loire,2565258,2,0,2382,476
2020-06-07,France,NA,Centre-Val de Loire,2565258,0,1,2382,476
2020-06-08,France,NA,Centre-Val de Loire,2565258,13,3,2395,479
2020-06-09,France,NA,Centre-Val de Loire,2565258,16,1,2411,482
2020-06-10,France,NA,Centre-Val de Loire,2565258,9,1,2420,484
2020-06-11,France,NA,Centre-Val de Loire,2565258,13,1,2433,486
2020-06-12,France,NA,Centre-Val de Loire,2565258,9,2,2442,488
2020-06-13,France,NA,Centre-Val de Loire,2565258,6,1,2448,489
2020-06-14,France,NA,Centre-Val de Loire,2565258,2,0,2450,490
2020-06-15,France,NA,Centre-Val de Loire,2565258,13,0,2463,492
2020-06-16,France,NA,Centre-Val de Loire,2565258,7,0,2470,494
2020-06-17,France,NA,Centre-Val de Loire,2565258,11,6,2481,496
2020-06-18,France,NA,Centre-Val de Loire,2565258,8,7,2489,497
2020-06-19,France,NA,Centre-Val de Loire,2565258,20,2,2509,501
2020-06-20,France,NA,Centre-Val de Loire,2565258,11,0,2520,504
2020-06-21,France,NA,Centre-Val de Loire,2565258,1,0,2521,504
2020-06-22,France,NA,Centre-Val de Loire,2565258,7,0,2528,505
2020-06-23,France,NA,Centre-Val de Loire,2565258,12,0,2540,508
2020-06-24,France,NA,Centre-Val de Loire,2565258,5,0,2545,509
2020-06-25,France,NA,Centre-Val de Loire,2565258,5,1,2550,510
2020-06-26,France,NA,Centre-Val de Loire,2565258,18,1,2568,513
2020-06-27,France,NA,Centre-Val de Loire,2565258,6,0,2574,514
2020-06-28,France,NA,Centre-Val de Loire,2565258,4,0,2578,515
2020-06-29,France,NA,Centre-Val de Loire,2565258,16,0,2594,518
2020-06-30,France,NA,Centre-Val de Loire,2565258,13,1,2607,521
2020-07-01,France,NA,Centre-Val de Loire,2565258,13,1,2620,524
2020-07-02,France,NA,Centre-Val de Loire,2565258,17,0,2637,527
2020-07-03,France,NA,Centre-Val de Loire,2565258,7,0,2644,528
2020-07-04,France,NA,Centre-Val de Loire,2565258,2,1,2646,529
2020-07-05,France,NA,Centre-Val de Loire,2565258,2,0,2648,529
2020-07-06,France,NA,Centre-Val de Loire,2565258,29,0,2677,535
2020-07-07,France,NA,Centre-Val de Loire,2565258,8,0,2685,537
2020-07-08,France,NA,Centre-Val de Loire,2565258,7,1,2692,538
2020-07-09,France,NA,Centre-Val de Loire,2565258,7,1,2699,539
2020-07-10,France,NA,Centre-Val de Loire,2565258,9,3,2708,541
2020-07-11,France,NA,Centre-Val de Loire,2565258,1,0,2709,541
2020-07-12,France,NA,Centre-Val de Loire,2565258,2,0,2711,542
2020-07-13,France,NA,Centre-Val de Loire,2565258,6,0,2717,543
2020-07-14,France,NA,Centre-Val de Loire,2565258,1,0,2718,543
2020-07-15,France,NA,Centre-Val de Loire,2565258,3,0,2721,544
2020-07-16,France,NA,Centre-Val de Loire,2565258,8,2,2729,545
2020-07-17,France,NA,Centre-Val de Loire,2565258,13,0,2742,548
2020-07-18,France,NA,Centre-Val de Loire,2565258,4,0,2746,549
2020-07-19,France,NA,Centre-Val de Loire,2565258,2,0,2748,549
2020-07-20,France,NA,Centre-Val de Loire,2565258,17,0,2765,553
2020-07-21,France,NA,Centre-Val de Loire,2565258,15,0,2780,555
2020-07-22,France,NA,Centre-Val de Loire,2565258,32,1,2812,556
2020-07-23,France,NA,Centre-Val de Loire,2565258,30,1,2842,557
2020-07-24,France,NA,Centre-Val de Loire,2565258,37,0,2879,557
2020-07-25,France,NA,Centre-Val de Loire,2565258,16,0,2895,557
2020-07-26,France,NA,Centre-Val de Loire,2565258,4,0,2899,557
2020-07-27,France,NA,Centre-Val de Loire,2565258,34,0,2933,557
2020-07-28,France,NA,Centre-Val de Loire,2565258,36,0,2969,557
2020-07-29,France,NA,Centre-Val de Loire,2565258,25,0,2994,557
2020-07-30,France,NA,Centre-Val de Loire,2565258,40,0,3034,557
2020-07-31,France,NA,Centre-Val de Loire,2565258,43,2,3077,559
2020-08-01,France,NA,Centre-Val de Loire,2565258,13,0,3090,559
2020-08-02,France,NA,Centre-Val de Loire,2565258,5,0,3095,559
2020-08-03,France,NA,Centre-Val de Loire,2565258,41,0,3136,559
2020-08-04,France,NA,Centre-Val de Loire,2565258,39,0,3175,559
2020-08-05,France,NA,Centre-Val de Loire,2565258,28,0,3203,559
2020-08-06,France,NA,Centre-Val de Loire,2565258,65,1,3268,560
2020-08-07,France,NA,Centre-Val de Loire,2565258,56,0,3324,560
2020-08-08,France,NA,Centre-Val de Loire,2565258,37,0,3361,560
2020-08-09,France,NA,Centre-Val de Loire,2565258,2,0,3363,560
2020-08-10,France,NA,Centre-Val de Loire,2565258,74,0,3437,560
2020-08-11,France,NA,Centre-Val de Loire,2565258,56,2,3493,562
2020-08-12,France,NA,Centre-Val de Loire,2565258,79,1,3572,563
2020-08-13,France,NA,Centre-Val de Loire,2565258,117,3,3689,566
2020-08-14,France,NA,Centre-Val de Loire,2565258,123,3,3812,569
2020-08-15,France,NA,Centre-Val de Loire,2565258,25,0,3837,569
2020-08-16,France,NA,Centre-Val de Loire,2565258,26,0,3863,569
2020-08-17,France,NA,Centre-Val de Loire,2565258,167,0,4030,569
2020-08-18,France,NA,Centre-Val de Loire,2565258,138,0,4168,569
2020-08-19,France,NA,Centre-Val de Loire,2565258,70,1,4238,570
2020-08-20,France,NA,Centre-Val de Loire,2565258,128,0,4366,570
2020-08-21,France,NA,Centre-Val de Loire,2565258,129,1,4495,571
2020-08-22,France,NA,Centre-Val de Loire,2565258,56,0,4551,571
2020-08-23,France,NA,Centre-Val de Loire,2565258,16,0,4567,571
2020-08-24,France,NA,Centre-Val de Loire,2565258,165,1,4732,572
2020-08-25,France,NA,Centre-Val de Loire,2565258,138,1,4870,573
2020-08-26,France,NA,Centre-Val de Loire,2565258,144,1,5014,574
2020-08-27,France,NA,Centre-Val de Loire,2565258,178,0,5192,574
2020-08-28,France,NA,Centre-Val de Loire,2565258,158,0,5350,574
2020-08-29,France,NA,Centre-Val de Loire,2565258,84,0,5434,574
2020-08-30,France,NA,Centre-Val de Loire,2565258,23,0,5457,574
2020-08-31,France,NA,Centre-Val de Loire,2565258,181,0,5638,574
2020-09-01,France,NA,Centre-Val de Loire,2565258,167,0,5805,574
2020-09-02,France,NA,Centre-Val de Loire,2565258,218,0,6023,574
2020-09-03,France,NA,Centre-Val de Loire,2565258,179,0,6202,574
2020-09-04,France,NA,Centre-Val de Loire,2565258,240,1,6442,575
2020-09-05,France,NA,Centre-Val de Loire,2565258,106,0,6548,575
2020-09-06,France,NA,Centre-Val de Loire,2565258,24,0,6572,575
2020-09-07,France,NA,Centre-Val de Loire,2565258,270,1,6842,576
2020-09-08,France,NA,Centre-Val de Loire,2565258,273,0,7115,576
2020-09-09,France,NA,Centre-Val de Loire,2565258,203,0,7318,576
2020-09-10,France,NA,Centre-Val de Loire,2565258,238,2,7556,578
2020-09-11,France,NA,Centre-Val de Loire,2565258,244,1,7800,579
2020-09-12,France,NA,Centre-Val de Loire,2565258,111,1,7911,580
2020-09-13,France,NA,Centre-Val de Loire,2565258,24,0,7935,580
2020-09-14,France,NA,Centre-Val de Loire,2565258,318,0,8253,580
2020-09-15,France,NA,Centre-Val de Loire,2565258,277,4,8530,584
2020-09-16,France,NA,Centre-Val de Loire,2565258,277,0,8807,584
2020-09-17,France,NA,Centre-Val de Loire,2565258,285,1,9092,585
2020-09-18,France,NA,Centre-Val de Loire,2565258,279,1,9371,586
2020-09-19,France,NA,Centre-Val de Loire,2565258,119,1,9490,587
2020-09-20,France,NA,Centre-Val de Loire,2565258,17,0,9507,587
2020-09-21,France,NA,Centre-Val de Loire,2565258,319,1,9826,588
2020-05-16,France,NA,Corsica,341554,1,0,11,2
2020-05-17,France,NA,Corsica,341554,0,0,11,2
2020-05-18,France,NA,Corsica,341554,2,1,13,2
2020-05-19,France,NA,Corsica,341554,4,0,17,3
2020-05-20,France,NA,Corsica,341554,3,0,20,4
2020-05-21,France,NA,Corsica,341554,0,0,20,4
2020-05-22,France,NA,Corsica,341554,0,0,20,4
2020-05-23,France,NA,Corsica,341554,2,0,22,4
2020-05-24,France,NA,Corsica,341554,0,1,22,4
2020-05-25,France,NA,Corsica,341554,1,0,23,4
2020-05-26,France,NA,Corsica,341554,1,0,24,4
2020-05-27,France,NA,Corsica,341554,0,0,24,4
2020-05-28,France,NA,Corsica,341554,3,0,27,5
2020-05-29,France,NA,Corsica,341554,1,0,28,5
2020-05-30,France,NA,Corsica,341554,0,0,28,5
2020-05-31,France,NA,Corsica,341554,0,0,28,5
2020-06-01,France,NA,Corsica,341554,0,0,28,5
2020-06-02,France,NA,Corsica,341554,1,0,29,5
2020-06-03,France,NA,Corsica,341554,2,0,31,6
2020-06-04,France,NA,Corsica,341554,1,0,32,6
2020-06-05,France,NA,Corsica,341554,2,0,34,6
2020-06-06,France,NA,Corsica,341554,1,0,35,7
2020-06-07,France,NA,Corsica,341554,0,0,35,7
2020-06-08,France,NA,Corsica,341554,2,0,37,7
2020-06-09,France,NA,Corsica,341554,0,0,37,7
2020-06-10,France,NA,Corsica,341554,1,0,38,7
2020-06-11,France,NA,Corsica,341554,3,0,41,8
2020-06-12,France,NA,Corsica,341554,0,1,41,8
2020-06-13,France,NA,Corsica,341554,0,0,41,8
2020-06-14,France,NA,Corsica,341554,0,0,41,8
2020-06-15,France,NA,Corsica,341554,1,0,42,8
2020-06-16,France,NA,Corsica,341554,2,0,44,8
2020-06-17,France,NA,Corsica,341554,1,0,45,9
2020-06-18,France,NA,Corsica,341554,0,0,45,9
2020-06-19,France,NA,Corsica,341554,0,0,45,9
2020-06-20,France,NA,Corsica,341554,0,0,45,9
2020-06-21,France,NA,Corsica,341554,0,0,45,9
2020-06-22,France,NA,Corsica,341554,1,0,46,9
2020-06-23,France,NA,Corsica,341554,1,0,47,9
2020-06-24,France,NA,Corsica,341554,1,0,48,9
2020-06-25,France,NA,Corsica,341554,0,0,48,9
2020-06-26,France,NA,Corsica,341554,1,0,49,9
2020-06-27,France,NA,Corsica,341554,0,0,49,9
2020-06-28,France,NA,Corsica,341554,0,0,49,9
2020-06-29,France,NA,Corsica,341554,1,0,50,10
2020-06-30,France,NA,Corsica,341554,0,0,50,10
2020-07-01,France,NA,Corsica,341554,2,0,52,10
2020-07-02,France,NA,Corsica,341554,1,0,53,10
2020-07-03,France,NA,Corsica,341554,0,0,53,10
2020-07-04,France,NA,Corsica,341554,0,0,53,10
2020-07-05,France,NA,Corsica,341554,0,0,53,10
2020-07-06,France,NA,Corsica,341554,1,0,54,10
2020-07-07,France,NA,Corsica,341554,0,0,54,10
2020-07-08,France,NA,Corsica,341554,2,0,56,11
2020-07-09,France,NA,Corsica,341554,1,0,57,11
2020-07-10,France,NA,Corsica,341554,1,0,58,11
2020-07-11,France,NA,Corsica,341554,1,0,59,11
2020-07-12,France,NA,Corsica,341554,0,0,59,11
2020-07-13,France,NA,Corsica,341554,6,0,65,13
2020-07-14,France,NA,Corsica,341554,5,0,70,14
2020-07-15,France,NA,Corsica,341554,3,0,73,14
2020-07-16,France,NA,Corsica,341554,2,0,75,15
2020-07-17,France,NA,Corsica,341554,2,0,77,15
2020-07-18,France,NA,Corsica,341554,1,0,78,15
2020-07-19,France,NA,Corsica,341554,0,0,78,15
2020-07-20,France,NA,Corsica,341554,0,0,78,15
2020-07-21,France,NA,Corsica,341554,1,0,79,15
2020-07-22,France,NA,Corsica,341554,1,0,80,16
2020-07-23,France,NA,Corsica,341554,0,0,80,16
2020-07-24,France,NA,Corsica,341554,0,0,80,16
2020-07-25,France,NA,Corsica,341554,1,0,81,16
2020-07-26,France,NA,Corsica,341554,0,0,81,16
2020-07-27,France,NA,Corsica,341554,1,0,82,16
2020-07-28,France,NA,Corsica,341554,1,0,83,16
2020-07-29,France,NA,Corsica,341554,1,0,84,16
2020-07-30,France,NA,Corsica,341554,0,0,84,16
2020-07-31,France,NA,Corsica,341554,3,0,87,17
2020-08-01,France,NA,Corsica,341554,0,0,87,17
2020-08-02,France,NA,Corsica,341554,1,0,88,17
2020-08-03,France,NA,Corsica,341554,3,0,91,18
2020-08-04,France,NA,Corsica,341554,6,0,97,19
2020-08-05,France,NA,Corsica,341554,2,0,99,19
2020-08-06,France,NA,Corsica,341554,4,0,103,20
2020-08-07,France,NA,Corsica,341554,1,0,104,20
2020-08-08,France,NA,Corsica,341554,1,0,105,21
2020-08-09,France,NA,Corsica,341554,1,0,106,21
2020-08-10,France,NA,Corsica,341554,4,0,110,22
2020-08-11,France,NA,Corsica,341554,1,0,111,22
2020-08-12,France,NA,Corsica,341554,4,0,115,23
2020-08-13,France,NA,Corsica,341554,1,0,116,23
2020-08-14,France,NA,Corsica,341554,6,0,122,24
2020-08-15,France,NA,Corsica,341554,0,0,122,24
2020-08-16,France,NA,Corsica,341554,0,0,122,24
2020-08-17,France,NA,Corsica,341554,9,0,131,26
2020-08-18,France,NA,Corsica,341554,6,0,137,27
2020-08-19,France,NA,Corsica,341554,7,0,144,28
2020-08-20,France,NA,Corsica,341554,7,0,151,30
2020-08-21,France,NA,Corsica,341554,6,0,157,31
2020-08-22,France,NA,Corsica,341554,5,0,162,32
2020-08-23,France,NA,Corsica,341554,0,0,162,32
2020-08-24,France,NA,Corsica,341554,32,0,194,38
2020-08-25,France,NA,Corsica,341554,22,0,216,43
2020-08-26,France,NA,Corsica,341554,36,0,252,50
2020-08-27,France,NA,Corsica,341554,50,0,302,59
2020-08-28,France,NA,Corsica,341554,45,0,347,59
2020-08-29,France,NA,Corsica,341554,12,0,359,59
2020-08-30,France,NA,Corsica,341554,5,0,364,59
2020-08-31,France,NA,Corsica,341554,54,0,418,59
2020-09-01,France,NA,Corsica,341554,62,0,480,59
2020-09-02,France,NA,Corsica,341554,55,0,535,59
2020-09-03,France,NA,Corsica,341554,65,0,600,59
2020-09-04,France,NA,Corsica,341554,62,0,662,59
2020-09-05,France,NA,Corsica,341554,19,0,681,59
2020-09-06,France,NA,Corsica,341554,4,0,685,59
2020-09-07,France,NA,Corsica,341554,91,0,776,59
2020-09-08,France,NA,Corsica,341554,47,0,823,59
2020-09-09,France,NA,Corsica,341554,51,0,874,59
2020-09-10,France,NA,Corsica,341554,48,0,922,59
2020-09-11,France,NA,Corsica,341554,41,0,963,59
2020-09-12,France,NA,Corsica,341554,26,0,989,59
2020-09-13,France,NA,Corsica,341554,7,1,996,60
2020-09-14,France,NA,Corsica,341554,47,1,1043,61
2020-09-15,France,NA,Corsica,341554,36,0,1079,61
2020-09-16,France,NA,Corsica,341554,46,0,1125,61
2020-09-17,France,NA,Corsica,341554,41,0,1166,61
2020-09-18,France,NA,Corsica,341554,33,1,1199,62
2020-09-19,France,NA,Corsica,341554,12,0,1211,62
2020-09-20,France,NA,Corsica,341554,4,0,1215,62
2020-09-21,France,NA,Corsica,341554,49,0,1264,62
2020-03-12,France,NA,Grand Est,5525291,7,0,14,0
2020-03-13,France,NA,Grand Est,5525291,5,0,19,0
2020-03-14,France,NA,Grand Est,5525291,4,0,23,0
2020-03-15,France,NA,Grand Est,5525291,2,0,25,0
2020-03-16,France,NA,Grand Est,5525291,7,0,32,0
2020-03-17,France,NA,Grand Est,5525291,16,0,48,0
2020-03-18,France,NA,Grand Est,5525291,24,0,72,14
2020-03-19,France,NA,Grand Est,5525291,36,28,108,21
2020-03-20,France,NA,Grand Est,5525291,41,35,149,29
2020-03-21,France,NA,Grand Est,5525291,4,26,153,30
2020-03-22,France,NA,Grand Est,5525291,4,43,157,31
2020-03-23,France,NA,Grand Est,5525291,42,75,199,39
2020-03-24,France,NA,Grand Est,5525291,112,80,311,62
2020-03-25,France,NA,Grand Est,5525291,123,98,434,86
2020-03-26,France,NA,Grand Est,5525291,135,79,569,113
2020-03-27,France,NA,Grand Est,5525291,186,73,755,151
2020-03-28,France,NA,Grand Est,5525291,39,96,794,158
2020-03-29,France,NA,Grand Est,5525291,12,62,806,161
2020-03-30,France,NA,Grand Est,5525291,196,104,1002,200
2020-03-31,France,NA,Grand Est,5525291,253,96,1255,251
2020-04-01,France,NA,Grand Est,5525291,206,111,1461,292
2020-04-02,France,NA,Grand Est,5525291,211,52,1672,334
2020-04-03,France,NA,Grand Est,5525291,197,133,1869,373
2020-04-04,France,NA,Grand Est,5525291,15,91,1884,376
2020-04-05,France,NA,Grand Est,5525291,2,69,1886,377
2020-04-06,France,NA,Grand Est,5525291,126,103,2012,402
2020-04-07,France,NA,Grand Est,5525291,116,100,2128,425
2020-04-08,France,NA,Grand Est,5525291,256,107,2384,476
2020-04-09,France,NA,Grand Est,5525291,205,73,2589,517
2020-04-10,France,NA,Grand Est,5525291,79,98,2668,533
2020-04-11,France,NA,Grand Est,5525291,15,56,2683,536
2020-04-12,France,NA,Grand Est,5525291,1,56,2684,536
2020-04-13,France,NA,Grand Est,5525291,3,41,2687,537
2020-04-14,France,NA,Grand Est,5525291,214,61,2901,580
2020-04-15,France,NA,Grand Est,5525291,98,83,2999,599
2020-04-16,France,NA,Grand Est,5525291,162,57,3161,632
2020-04-17,France,NA,Grand Est,5525291,101,52,3262,652
2020-04-18,France,NA,Grand Est,5525291,5,64,3267,653
2020-04-19,France,NA,Grand Est,5525291,0,41,3267,653
2020-04-20,France,NA,Grand Est,5525291,41,52,3308,661
2020-04-21,France,NA,Grand Est,5525291,68,49,3376,675
2020-04-22,France,NA,Grand Est,5525291,29,48,3405,681
2020-04-23,France,NA,Grand Est,5525291,23,34,3428,685
2020-04-24,France,NA,Grand Est,5525291,29,33,3457,691
2020-04-25,France,NA,Grand Est,5525291,3,35,3460,692
2020-04-26,France,NA,Grand Est,5525291,0,23,3460,692
2020-04-27,France,NA,Grand Est,5525291,11,42,3471,694
2020-04-28,France,NA,Grand Est,5525291,16,20,3487,697
2020-04-29,France,NA,Grand Est,5525291,32,64,3519,703
2020-04-30,France,NA,Grand Est,5525291,16,22,3535,707
2020-05-01,France,NA,Grand Est,5525291,0,30,3535,707
2020-05-02,France,NA,Grand Est,5525291,0,22,3535,707
2020-05-03,France,NA,Grand Est,5525291,0,16,3535,707
2020-05-04,France,NA,Grand Est,5525291,15,30,3550,710
2020-05-05,France,NA,Grand Est,5525291,17,28,3567,713
2020-05-06,France,NA,Grand Est,5525291,6,26,3573,714
2020-05-07,France,NA,Grand Est,5525291,2,23,3575,715
2020-05-08,France,NA,Grand Est,5525291,0,30,3575,715
2020-05-09,France,NA,Grand Est,5525291,0,15,3575,715
2020-05-10,France,NA,Grand Est,5525291,0,8,3575,715
2020-05-11,France,NA,Grand Est,5525291,5,25,3580,716
2020-05-12,France,NA,Grand Est,5525291,10,33,3590,718
2020-05-13,France,NA,Grand Est,5525291,152,20,3742,748
2020-05-14,France,NA,Grand Est,5525291,110,31,3852,770
2020-05-15,France,NA,Grand Est,5525291,150,27,4002,800
2020-05-16,France,NA,Grand Est,5525291,39,7,4041,808
2020-05-17,France,NA,Grand Est,5525291,6,16,4047,809
2020-05-18,France,NA,Grand Est,5525291,165,19,4212,842
2020-05-19,France,NA,Grand Est,5525291,140,22,4352,870
2020-05-20,France,NA,Grand Est,5525291,195,18,4547,909
2020-05-21,France,NA,Grand Est,5525291,22,4,4569,913
2020-05-22,France,NA,Grand Est,5525291,90,14,4659,931
2020-05-23,France,NA,Grand Est,5525291,21,8,4680,936
2020-05-24,France,NA,Grand Est,5525291,7,11,4687,937
2020-05-25,France,NA,Grand Est,5525291,91,7,4778,955
2020-05-26,France,NA,Grand Est,5525291,91,4,4869,973
2020-05-27,France,NA,Grand Est,5525291,59,10,4928,985
2020-05-28,France,NA,Grand Est,5525291,69,8,4997,999
2020-05-29,France,NA,Grand Est,5525291,79,11,5076,1015
2020-05-30,France,NA,Grand Est,5525291,23,9,5099,1019
2020-05-31,France,NA,Grand Est,5525291,6,3,5105,1021
2020-06-01,France,NA,Grand Est,5525291,9,4,5114,1022
2020-06-02,France,NA,Grand Est,5525291,140,19,5254,1050
2020-06-03,France,NA,Grand Est,5525291,154,10,5408,1081
2020-06-04,France,NA,Grand Est,5525291,84,8,5492,1098
2020-06-05,France,NA,Grand Est,5525291,69,16,5561,1112
2020-06-06,France,NA,Grand Est,5525291,26,4,5587,1117
2020-06-07,France,NA,Grand Est,5525291,21,2,5608,1121
2020-06-08,France,NA,Grand Est,5525291,76,12,5684,1136
2020-06-09,France,NA,Grand Est,5525291,80,5,5764,1152
2020-06-10,France,NA,Grand Est,5525291,70,0,5834,1166
2020-06-11,France,NA,Grand Est,5525291,58,2,5892,1178
2020-06-12,France,NA,Grand Est,5525291,60,2,5952,1190
2020-06-13,France,NA,Grand Est,5525291,13,3,5965,1193
2020-06-14,France,NA,Grand Est,5525291,4,2,5969,1193
2020-06-15,France,NA,Grand Est,5525291,48,7,6017,1203
2020-06-16,France,NA,Grand Est,5525291,63,5,6080,1216
2020-06-17,France,NA,Grand Est,5525291,58,2,6138,1227
2020-06-18,France,NA,Grand Est,5525291,37,8,6175,1235
2020-06-19,France,NA,Grand Est,5525291,54,4,6229,1245
2020-06-20,France,NA,Grand Est,5525291,18,3,6247,1249
2020-06-21,France,NA,Grand Est,5525291,7,1,6254,1250
2020-06-22,France,NA,Grand Est,5525291,37,5,6291,1258
2020-06-23,France,NA,Grand Est,5525291,27,5,6318,1263
2020-06-24,France,NA,Grand Est,5525291,33,0,6351,1270
2020-06-25,France,NA,Grand Est,5525291,26,4,6377,1275
2020-06-26,France,NA,Grand Est,5525291,28,6,6405,1281
2020-06-27,France,NA,Grand Est,5525291,11,0,6416,1281
2020-06-28,France,NA,Grand Est,5525291,6,0,6422,1281
2020-06-29,France,NA,Grand Est,5525291,20,0,6442,1281
2020-06-30,France,NA,Grand Est,5525291,28,3503,6470,1294
2020-07-01,France,NA,Grand Est,5525291,27,8,6497,1299
2020-07-02,France,NA,Grand Est,5525291,25,2,6522,1304
2020-07-03,France,NA,Grand Est,5525291,27,4,6549,1309
2020-07-04,France,NA,Grand Est,5525291,19,3,6568,1313
2020-07-05,France,NA,Grand Est,5525291,3,0,6571,1314
2020-07-06,France,NA,Grand Est,5525291,26,1,6597,1319
2020-07-07,France,NA,Grand Est,5525291,22,0,6619,1323
2020-07-08,France,NA,Grand Est,5525291,27,2,6646,1329
2020-07-09,France,NA,Grand Est,5525291,38,1,6684,1336
2020-07-10,France,NA,Grand Est,5525291,31,1,6715,1343
2020-07-11,France,NA,Grand Est,5525291,7,0,6722,1344
2020-07-12,France,NA,Grand Est,5525291,5,0,6727,1345
2020-07-13,France,NA,Grand Est,5525291,55,2,6782,1356
2020-07-14,France,NA,Grand Est,5525291,7,1,6789,1357
2020-07-15,France,NA,Grand Est,5525291,65,3,6854,1370
2020-07-16,France,NA,Grand Est,5525291,88,3,6942,1388
2020-07-17,France,NA,Grand Est,5525291,86,5,7028,1405
2020-07-18,France,NA,Grand Est,5525291,34,0,7062,1412
2020-07-19,France,NA,Grand Est,5525291,3,0,7065,1413
2020-07-20,France,NA,Grand Est,5525291,68,1,7133,1426
2020-07-21,France,NA,Grand Est,5525291,63,1,7196,1439
2020-07-22,France,NA,Grand Est,5525291,56,3,7252,1450
2020-07-23,France,NA,Grand Est,5525291,56,4,7308,1461
2020-07-24,France,NA,Grand Est,5525291,73,0,7381,1476
2020-07-25,France,NA,Grand Est,5525291,34,0,7415,1483
2020-07-26,France,NA,Grand Est,5525291,5,0,7420,1484
2020-07-27,France,NA,Grand Est,5525291,80,0,7500,1500
2020-07-28,France,NA,Grand Est,5525291,70,0,7570,1514
2020-07-29,France,NA,Grand Est,5525291,57,2,7627,1525
2020-07-30,France,NA,Grand Est,5525291,73,5,7700,1540
2020-07-31,France,NA,Grand Est,5525291,112,2,7812,1562
2020-08-01,France,NA,Grand Est,5525291,43,4,7855,1571
2020-08-02,France,NA,Grand Est,5525291,9,0,7864,1572
2020-08-03,France,NA,Grand Est,5525291,106,1,7970,1594
2020-08-04,France,NA,Grand Est,5525291,87,1,8057,1611
2020-08-05,France,NA,Grand Est,5525291,80,2,8137,1627
2020-08-06,France,NA,Grand Est,5525291,147,1,8284,1656
2020-08-07,France,NA,Grand Est,5525291,82,2,8366,1673
2020-08-08,France,NA,Grand Est,5525291,42,0,8408,1681
2020-08-09,France,NA,Grand Est,5525291,1,0,8409,1681
2020-08-10,France,NA,Grand Est,5525291,92,1,8501,1700
2020-08-11,France,NA,Grand Est,5525291,109,3,8610,1722
2020-08-12,France,NA,Grand Est,5525291,136,2,8746,1749
2020-08-13,France,NA,Grand Est,5525291,135,3,8881,1776
2020-08-14,France,NA,Grand Est,5525291,155,2,9036,1807
2020-08-15,France,NA,Grand Est,5525291,31,1,9067,1813
2020-08-16,France,NA,Grand Est,5525291,13,0,9080,1816
2020-08-17,France,NA,Grand Est,5525291,215,0,9295,1859
2020-08-18,France,NA,Grand Est,5525291,176,2,9471,1894
2020-08-19,France,NA,Grand Est,5525291,180,1,9651,1930
2020-08-20,France,NA,Grand Est,5525291,167,0,9818,1963
2020-08-21,France,NA,Grand Est,5525291,188,2,10006,2001
2020-08-22,France,NA,Grand Est,5525291,125,1,10131,2026
2020-08-23,France,NA,Grand Est,5525291,28,0,10159,2031
2020-08-24,France,NA,Grand Est,5525291,280,1,10439,2087
2020-08-25,France,NA,Grand Est,5525291,275,13,10714,2142
2020-08-26,France,NA,Grand Est,5525291,251,1,10965,2193
2020-08-27,France,NA,Grand Est,5525291,269,0,11234,2246
2020-08-28,France,NA,Grand Est,5525291,295,4,11529,2305
2020-08-29,France,NA,Grand Est,5525291,157,1,11686,2337
2020-08-30,France,NA,Grand Est,5525291,30,0,11716,2343
2020-08-31,France,NA,Grand Est,5525291,373,3,12089,2417
2020-09-01,France,NA,Grand Est,5525291,261,1,12350,2470
2020-09-02,France,NA,Grand Est,5525291,315,4,12665,2533
2020-09-03,France,NA,Grand Est,5525291,280,1,12945,2589
2020-09-04,France,NA,Grand Est,5525291,311,1,13256,2651
2020-09-05,France,NA,Grand Est,5525291,143,5,13399,2679
2020-09-06,France,NA,Grand Est,5525291,25,0,13424,2684
2020-09-07,France,NA,Grand Est,5525291,361,2,13785,2757
2020-09-08,France,NA,Grand Est,5525291,384,10,14169,2833
2020-09-09,France,NA,Grand Est,5525291,399,4,14568,2913
2020-09-10,France,NA,Grand Est,5525291,479,0,15047,3009
2020-09-11,France,NA,Grand Est,5525291,454,11,15501,3100
2020-09-12,France,NA,Grand Est,5525291,268,0,15769,3153
2020-09-13,France,NA,Grand Est,5525291,67,0,15836,3167
2020-09-14,France,NA,Grand Est,5525291,552,2,16388,3277
2020-09-15,France,NA,Grand Est,5525291,527,0,16915,3383
2020-09-16,France,NA,Grand Est,5525291,430,2,17345,3469
2020-09-17,France,NA,Grand Est,5525291,399,5,17744,3548
2020-09-18,France,NA,Grand Est,5525291,439,3,18183,3636
2020-09-19,France,NA,Grand Est,5525291,195,0,18378,3675
2020-09-20,France,NA,Grand Est,5525291,30,0,18408,3681
2020-09-21,France,NA,Grand Est,5525291,492,2,18900,3721
2020-03-17,France,NA,Hauts-de-France,5977437,5,0,15,0
2020-03-18,France,NA,Hauts-de-France,5977437,7,0,22,4
2020-03-19,France,NA,Hauts-de-France,5977437,16,19,38,7
2020-03-20,France,NA,Hauts-de-France,5977437,19,11,57,11
2020-03-21,France,NA,Hauts-de-France,5977437,7,5,64,12
2020-03-22,France,NA,Hauts-de-France,5977437,6,11,70,14
2020-03-23,France,NA,Hauts-de-France,5977437,52,19,122,24
2020-03-24,France,NA,Hauts-de-France,5977437,81,23,203,40
2020-03-25,France,NA,Hauts-de-France,5977437,77,13,280,56
2020-03-26,France,NA,Hauts-de-France,5977437,99,28,379,75
2020-03-27,France,NA,Hauts-de-France,5977437,65,19,444,88
2020-03-28,France,NA,Hauts-de-France,5977437,26,27,470,94
2020-03-29,France,NA,Hauts-de-France,5977437,11,15,481,96
2020-03-30,France,NA,Hauts-de-France,5977437,146,31,627,125
2020-03-31,France,NA,Hauts-de-France,5977437,144,38,771,154
2020-04-01,France,NA,Hauts-de-France,5977437,112,50,883,176
2020-04-02,France,NA,Hauts-de-France,5977437,145,40,1028,205
2020-04-03,France,NA,Hauts-de-France,5977437,173,68,1201,240
2020-04-04,France,NA,Hauts-de-France,5977437,37,50,1238,247
2020-04-05,France,NA,Hauts-de-France,5977437,6,32,1244,248
2020-04-06,France,NA,Hauts-de-France,5977437,133,57,1377,275
2020-04-07,France,NA,Hauts-de-France,5977437,154,58,1531,306
2020-04-08,France,NA,Hauts-de-France,5977437,162,44,1693,338
2020-04-09,France,NA,Hauts-de-France,5977437,151,36,1844,368
2020-04-10,France,NA,Hauts-de-France,5977437,143,47,1987,397
2020-04-11,France,NA,Hauts-de-France,5977437,25,44,2012,402
2020-04-12,France,NA,Hauts-de-France,5977437,5,34,2017,403
2020-04-13,France,NA,Hauts-de-France,5977437,0,33,2017,403
2020-04-14,France,NA,Hauts-de-France,5977437,112,47,2129,425
2020-04-15,France,NA,Hauts-de-France,5977437,119,55,2248,449
2020-04-16,France,NA,Hauts-de-France,5977437,75,31,2323,464
2020-04-17,France,NA,Hauts-de-France,5977437,57,48,2380,476
2020-04-18,France,NA,Hauts-de-France,5977437,10,23,2390,478
2020-04-19,France,NA,Hauts-de-France,5977437,2,17,2392,478
2020-04-20,France,NA,Hauts-de-France,5977437,81,33,2473,494
2020-04-21,France,NA,Hauts-de-France,5977437,73,36,2546,509
2020-04-22,France,NA,Hauts-de-France,5977437,60,35,2606,521
2020-04-23,France,NA,Hauts-de-France,5977437,59,35,2665,533
2020-04-24,France,NA,Hauts-de-France,5977437,49,24,2714,542
2020-04-25,France,NA,Hauts-de-France,5977437,7,24,2721,544
2020-04-26,France,NA,Hauts-de-France,5977437,2,10,2723,544
2020-04-27,France,NA,Hauts-de-France,5977437,65,24,2788,557
2020-04-28,France,NA,Hauts-de-France,5977437,77,15,2865,573
2020-04-29,France,NA,Hauts-de-France,5977437,80,25,2945,589
2020-04-30,France,NA,Hauts-de-France,5977437,43,19,2988,597
2020-05-01,France,NA,Hauts-de-France,5977437,0,16,2988,597
2020-05-02,France,NA,Hauts-de-France,5977437,3,6,2991,598
2020-05-03,France,NA,Hauts-de-France,5977437,0,14,2991,598
2020-05-04,France,NA,Hauts-de-France,5977437,54,18,3045,609
2020-05-05,France,NA,Hauts-de-France,5977437,49,33,3094,618
2020-05-06,France,NA,Hauts-de-France,5977437,46,19,3140,628
2020-05-07,France,NA,Hauts-de-France,5977437,32,16,3172,634
2020-05-08,France,NA,Hauts-de-France,5977437,0,11,3172,634
2020-05-09,France,NA,Hauts-de-France,5977437,3,4,3175,635
2020-05-10,France,NA,Hauts-de-France,5977437,1,10,3176,635
2020-05-11,France,NA,Hauts-de-France,5977437,19,24,3195,639
2020-05-12,France,NA,Hauts-de-France,5977437,29,25,3224,644
2020-05-13,France,NA,Hauts-de-France,5977437,78,8,3302,660
2020-05-14,France,NA,Hauts-de-France,5977437,97,10,3399,679
2020-05-15,France,NA,Hauts-de-France,5977437,83,16,3482,696
2020-05-16,France,NA,Hauts-de-France,5977437,30,12,3512,702
2020-05-17,France,NA,Hauts-de-France,5977437,10,9,3522,704
2020-05-18,France,NA,Hauts-de-France,5977437,99,15,3621,724
2020-05-19,France,NA,Hauts-de-France,5977437,130,6,3751,750
2020-05-20,France,NA,Hauts-de-France,5977437,118,11,3869,773
2020-05-21,France,NA,Hauts-de-France,5977437,22,7,3891,778
2020-05-22,France,NA,Hauts-de-France,5977437,143,4,4034,806
2020-05-23,France,NA,Hauts-de-France,5977437,43,7,4077,815
2020-05-24,France,NA,Hauts-de-France,5977437,12,4,4089,817
2020-05-25,France,NA,Hauts-de-France,5977437,110,12,4199,839
2020-05-26,France,NA,Hauts-de-France,5977437,116,6,4315,863
2020-05-27,France,NA,Hauts-de-France,5977437,104,7,4419,883
2020-05-28,France,NA,Hauts-de-France,5977437,55,12,4474,894
2020-05-29,France,NA,Hauts-de-France,5977437,85,6,4559,911
2020-05-30,France,NA,Hauts-de-France,5977437,36,8,4595,919
2020-05-31,France,NA,Hauts-de-France,5977437,5,3,4600,920
2020-06-01,France,NA,Hauts-de-France,5977437,19,5,4619,923
2020-06-02,France,NA,Hauts-de-France,5977437,77,7,4696,939
2020-06-03,France,NA,Hauts-de-France,5977437,80,9,4776,955
2020-06-04,France,NA,Hauts-de-France,5977437,73,10,4849,969
2020-06-05,France,NA,Hauts-de-France,5977437,86,8,4935,987
2020-06-06,France,NA,Hauts-de-France,5977437,47,2,4982,996
2020-06-07,France,NA,Hauts-de-France,5977437,14,1,4996,999
2020-06-08,France,NA,Hauts-de-France,5977437,99,8,5095,1019
2020-06-09,France,NA,Hauts-de-France,5977437,68,2,5163,1032
2020-06-10,France,NA,Hauts-de-France,5977437,69,4,5232,1046
2020-06-11,France,NA,Hauts-de-France,5977437,64,1,5296,1059
2020-06-12,France,NA,Hauts-de-France,5977437,37,2,5333,1066
2020-06-13,France,NA,Hauts-de-France,5977437,16,1,5349,1069
2020-06-14,France,NA,Hauts-de-France,5977437,12,1,5361,1072
2020-06-15,France,NA,Hauts-de-France,5977437,65,3,5426,1085
2020-06-16,France,NA,Hauts-de-France,5977437,53,7,5479,1095
2020-06-17,France,NA,Hauts-de-France,5977437,52,5,5531,1106
2020-06-18,France,NA,Hauts-de-France,5977437,36,2,5567,1113
2020-06-19,France,NA,Hauts-de-France,5977437,48,2,5615,1123
2020-06-20,France,NA,Hauts-de-France,5977437,25,2,5640,1128
2020-06-21,France,NA,Hauts-de-France,5977437,5,1,5645,1129
2020-06-22,France,NA,Hauts-de-France,5977437,48,2,5693,1138
2020-06-23,France,NA,Hauts-de-France,5977437,66,0,5759,1151
2020-06-24,France,NA,Hauts-de-France,5977437,41,2,5800,1160
2020-06-25,France,NA,Hauts-de-France,5977437,51,4,5851,1170
2020-06-26,France,NA,Hauts-de-France,5977437,59,3,5910,1182
2020-06-27,France,NA,Hauts-de-France,5977437,20,0,5930,1182
2020-06-28,France,NA,Hauts-de-France,5977437,7,0,5937,1182
2020-06-29,France,NA,Hauts-de-France,5977437,49,0,5986,1182
2020-06-30,France,NA,Hauts-de-France,5977437,46,1556,6032,1206
2020-07-01,France,NA,Hauts-de-France,5977437,54,1,6086,1217
2020-07-02,France,NA,Hauts-de-France,5977437,67,2,6153,1230
2020-07-03,France,NA,Hauts-de-France,5977437,60,2,6213,1242
2020-07-04,France,NA,Hauts-de-France,5977437,21,0,6234,1246
2020-07-05,France,NA,Hauts-de-France,5977437,1,0,6235,1247
2020-07-06,France,NA,Hauts-de-France,5977437,75,4,6310,1262
2020-07-07,France,NA,Hauts-de-France,5977437,49,13,6359,1271
2020-07-08,France,NA,Hauts-de-France,5977437,41,18,6400,1280
2020-07-09,France,NA,Hauts-de-France,5977437,65,4,6465,1293
2020-07-10,France,NA,Hauts-de-France,5977437,54,1,6519,1303
2020-07-11,France,NA,Hauts-de-France,5977437,41,1,6560,1312
2020-07-12,France,NA,Hauts-de-France,5977437,8,0,6568,1313
2020-07-13,France,NA,Hauts-de-France,5977437,59,1,6627,1325
2020-07-14,France,NA,Hauts-de-France,5977437,10,1,6637,1327
2020-07-15,France,NA,Hauts-de-France,5977437,67,7,6704,1340
2020-07-16,France,NA,Hauts-de-France,5977437,91,1,6795,1359
2020-07-17,France,NA,Hauts-de-France,5977437,84,2,6879,1375
2020-07-18,France,NA,Hauts-de-France,5977437,47,0,6926,1385
2020-07-19,France,NA,Hauts-de-France,5977437,6,0,6932,1386
2020-07-20,France,NA,Hauts-de-France,5977437,82,6,7014,1402
2020-07-21,France,NA,Hauts-de-France,5977437,111,2,7125,1425
2020-07-22,France,NA,Hauts-de-France,5977437,119,2,7244,1448
2020-07-23,France,NA,Hauts-de-France,5977437,81,0,7325,1465
2020-07-24,France,NA,Hauts-de-France,5977437,111,1,7436,1487
2020-07-25,France,NA,Hauts-de-France,5977437,72,1,7508,1501
2020-07-26,France,NA,Hauts-de-France,5977437,7,0,7515,1503
2020-07-27,France,NA,Hauts-de-France,5977437,141,3,7656,1531
2020-07-28,France,NA,Hauts-de-France,5977437,110,2,7766,1553
2020-07-29,France,NA,Hauts-de-France,5977437,135,1,7901,1580
2020-07-30,France,NA,Hauts-de-France,5977437,185,3,8086,1617
2020-07-31,France,NA,Hauts-de-France,5977437,136,3,8222,1644
2020-08-01,France,NA,Hauts-de-France,5977437,92,1,8314,1662
2020-08-02,France,NA,Hauts-de-France,5977437,12,0,8326,1665
2020-08-03,France,NA,Hauts-de-France,5977437,206,5,8532,1706
2020-08-04,France,NA,Hauts-de-France,5977437,150,1,8682,1736
2020-08-05,France,NA,Hauts-de-France,5977437,148,0,8830,1766
2020-08-06,France,NA,Hauts-de-France,5977437,162,0,8992,1798
2020-08-07,France,NA,Hauts-de-France,5977437,165,0,9157,1831
2020-08-08,France,NA,Hauts-de-France,5977437,66,0,9223,1844
2020-08-09,France,NA,Hauts-de-France,5977437,15,0,9238,1847
2020-08-10,France,NA,Hauts-de-France,5977437,195,3,9433,1886
2020-08-11,France,NA,Hauts-de-France,5977437,187,3,9620,1924
2020-08-12,France,NA,Hauts-de-France,5977437,179,0,9799,1925
2020-08-13,France,NA,Hauts-de-France,5977437,197,2,9996,1927
2020-08-14,France,NA,Hauts-de-France,5977437,211,2,10207,1929
2020-08-15,France,NA,Hauts-de-France,5977437,27,1,10234,1930
2020-08-16,France,NA,Hauts-de-France,5977437,14,0,10248,1930
2020-08-17,France,NA,Hauts-de-France,5977437,214,1,10462,1931
2020-08-18,France,NA,Hauts-de-France,5977437,233,1,10695,1932
2020-08-19,France,NA,Hauts-de-France,5977437,179,1,10874,1933
2020-08-20,France,NA,Hauts-de-France,5977437,233,1,11107,1934
2020-08-21,France,NA,Hauts-de-France,5977437,256,2,11363,1936
2020-08-22,France,NA,Hauts-de-France,5977437,101,0,11464,1936
2020-08-23,France,NA,Hauts-de-France,5977437,23,0,11487,1936
2020-08-24,France,NA,Hauts-de-France,5977437,278,1,11765,1937
2020-08-25,France,NA,Hauts-de-France,5977437,272,1,12037,1938
2020-08-26,France,NA,Hauts-de-France,5977437,279,0,12316,1938
2020-08-27,France,NA,Hauts-de-France,5977437,356,3,12672,1941
2020-08-28,France,NA,Hauts-de-France,5977437,319,2,12991,1943
2020-08-29,France,NA,Hauts-de-France,5977437,137,0,13128,1943
2020-08-30,France,NA,Hauts-de-France,5977437,46,0,13174,1943
2020-08-31,France,NA,Hauts-de-France,5977437,506,2,13680,1945
2020-09-01,France,NA,Hauts-de-France,5977437,564,2,14244,1947
2020-09-02,France,NA,Hauts-de-France,5977437,788,1,15032,1948
2020-09-03,France,NA,Hauts-de-France,5977437,808,2,15840,1950
2020-09-04,France,NA,Hauts-de-France,5977437,1026,0,16866,1950
2020-09-05,France,NA,Hauts-de-France,5977437,512,0,17378,1950
2020-09-06,France,NA,Hauts-de-France,5977437,76,0,17454,1950
2020-09-07,France,NA,Hauts-de-France,5977437,1357,1,18811,1951
2020-09-08,France,NA,Hauts-de-France,5977437,1191,3,20002,1954
2020-09-09,France,NA,Hauts-de-France,5977437,1170,2,21172,1956
2020-09-10,France,NA,Hauts-de-France,5977437,1207,0,22379,1956
2020-09-11,France,NA,Hauts-de-France,5977437,1089,6,23468,1962
2020-09-12,France,NA,Hauts-de-France,5977437,485,0,23953,1962
2020-09-13,France,NA,Hauts-de-France,5977437,107,0,24060,1962
2020-09-14,France,NA,Hauts-de-France,5977437,1693,1,25753,1963
2020-09-15,France,NA,Hauts-de-France,5977437,1544,1,27297,1964
2020-09-16,France,NA,Hauts-de-France,5977437,1449,3,28746,1967
2020-09-17,France,NA,Hauts-de-France,5977437,1552,1,30298,1968
2020-09-18,France,NA,Hauts-de-France,5977437,1481,3,31779,1971
2020-09-19,France,NA,Hauts-de-France,5977437,498,1,32277,1972
2020-09-20,France,NA,Hauts-de-France,5977437,225,0,32502,1972
2020-09-21,France,NA,Hauts-de-France,5977437,1299,6,33801,1978
2020-03-11,France,NA,Ile-de-France,12244807,11,0,15,0
2020-03-12,France,NA,Ile-de-France,12244807,22,0,37,0
2020-03-13,France,NA,Ile-de-France,12244807,49,0,86,0
2020-03-14,France,NA,Ile-de-France,12244807,48,0,134,0
2020-03-15,France,NA,Ile-de-France,12244807,44,0,178,0
2020-03-16,France,NA,Ile-de-France,12244807,140,0,318,0
2020-03-17,France,NA,Ile-de-France,12244807,154,0,472,0
2020-03-18,France,NA,Ile-de-France,12244807,233,0,705,36
2020-03-19,France,NA,Ile-de-France,12244807,264,20,969,56
2020-03-20,France,NA,Ile-de-France,12244807,381,43,1350,99
2020-03-21,France,NA,Ile-de-France,12244807,191,23,1541,122
2020-03-22,France,NA,Ile-de-France,12244807,195,18,1736,140
2020-03-23,France,NA,Ile-de-France,12244807,655,53,2391,193
2020-03-24,France,NA,Ile-de-France,12244807,568,69,2959,262
2020-03-25,France,NA,Ile-de-France,12244807,620,95,3579,357
2020-03-26,France,NA,Ile-de-France,12244807,728,103,4307,460
2020-03-27,France,NA,Ile-de-France,12244807,766,118,5073,578
2020-03-28,France,NA,Ile-de-France,12244807,325,110,5398,688
2020-03-29,France,NA,Ile-de-France,12244807,185,119,5583,807
2020-03-30,France,NA,Ile-de-France,12244807,824,147,6407,954
2020-03-31,France,NA,Ile-de-France,12244807,769,222,7176,1176
2020-04-01,France,NA,Ile-de-France,12244807,608,193,7784,1369
2020-04-02,France,NA,Ile-de-France,12244807,709,202,8493,1571
2020-04-03,France,NA,Ile-de-France,12244807,778,220,9271,1791
2020-04-04,France,NA,Ile-de-France,12244807,222,176,9493,1898
2020-04-05,France,NA,Ile-de-France,12244807,100,140,9593,1918
2020-04-06,France,NA,Ile-de-France,12244807,596,248,10189,2037
2020-04-07,France,NA,Ile-de-France,12244807,589,272,10778,2155
2020-04-08,France,NA,Ile-de-France,12244807,675,223,11453,2290
2020-04-09,France,NA,Ile-de-France,12244807,730,190,12183,2436
2020-04-10,France,NA,Ile-de-France,12244807,960,260,13143,2628
2020-04-11,France,NA,Ile-de-France,12244807,125,116,13268,2653
2020-04-12,France,NA,Ile-de-France,12244807,42,132,13310,2662
2020-04-13,France,NA,Ile-de-France,12244807,102,156,13412,2682
2020-04-14,France,NA,Ile-de-France,12244807,522,233,13934,2786
2020-04-15,France,NA,Ile-de-France,12244807,563,203,14497,2899
2020-04-16,France,NA,Ile-de-France,12244807,486,179,14983,2996
2020-04-17,France,NA,Ile-de-France,12244807,494,191,15477,3095
2020-04-18,France,NA,Ile-de-France,12244807,100,154,15577,3115
2020-04-19,France,NA,Ile-de-France,12244807,21,92,15598,3119
2020-04-20,France,NA,Ile-de-France,12244807,286,186,15884,3176
2020-04-21,France,NA,Ile-de-France,12244807,324,152,16208,3241
2020-04-22,France,NA,Ile-de-France,12244807,301,125,16509,3301
2020-04-23,France,NA,Ile-de-France,12244807,229,111,16738,3347
2020-04-24,France,NA,Ile-de-France,12244807,243,122,16981,3396
2020-04-25,France,NA,Ile-de-France,12244807,30,64,17011,3402
2020-04-26,France,NA,Ile-de-France,12244807,4,62,17015,3403
2020-04-27,France,NA,Ile-de-France,12244807,95,112,17110,3422
2020-04-28,France,NA,Ile-de-France,12244807,125,97,17235,3447
2020-04-29,France,NA,Ile-de-France,12244807,98,151,17333,3466
2020-04-30,France,NA,Ile-de-France,12244807,118,70,17451,3490
2020-05-01,France,NA,Ile-de-France,12244807,3,39,17454,3490
2020-05-02,France,NA,Ile-de-France,12244807,29,38,17483,3496
2020-05-03,France,NA,Ile-de-France,12244807,5,31,17488,3497
2020-05-04,France,NA,Ile-de-France,12244807,98,92,17586,3517
2020-05-05,France,NA,Ile-de-France,12244807,49,77,17635,3527
2020-05-06,France,NA,Ile-de-France,12244807,65,62,17700,3540
2020-05-07,France,NA,Ile-de-France,12244807,51,43,17751,3550
2020-05-08,France,NA,Ile-de-France,12244807,3,31,17754,3550
2020-05-09,France,NA,Ile-de-France,12244807,18,30,17772,3554
2020-05-10,France,NA,Ile-de-France,12244807,7,23,17779,3555
2020-05-11,France,NA,Ile-de-France,12244807,61,54,17840,3568
2020-05-12,France,NA,Ile-de-France,12244807,68,66,17908,3581
2020-05-13,France,NA,Ile-de-France,12244807,283,33,18191,3638
2020-05-14,France,NA,Ile-de-France,12244807,334,36,18525,3705
2020-05-15,France,NA,Ile-de-France,12244807,272,31,18797,3759
2020-05-16,France,NA,Ile-de-France,12244807,63,16,18860,3772
2020-05-17,France,NA,Ile-de-France,12244807,52,17,18912,3782
2020-05-18,France,NA,Ile-de-France,12244807,321,39,19233,3846
2020-05-19,France,NA,Ile-de-France,12244807,310,50,19543,3908
2020-05-20,France,NA,Ile-de-France,12244807,291,28,19834,3966
2020-05-21,France,NA,Ile-de-France,12244807,41,23,19875,3975
2020-05-22,France,NA,Ile-de-France,12244807,195,31,20070,4014
2020-05-23,France,NA,Ile-de-France,12244807,52,9,20122,4024
2020-05-24,France,NA,Ile-de-France,12244807,29,11,20151,4030
2020-05-25,France,NA,Ile-de-France,12244807,224,32,20375,4075
2020-05-26,France,NA,Ile-de-France,12244807,255,38,20630,4126
2020-05-27,France,NA,Ile-de-France,12244807,244,26,20874,4174
2020-05-28,France,NA,Ile-de-France,12244807,177,23,21051,4210
2020-05-29,France,NA,Ile-de-France,12244807,169,16,21220,4244
2020-05-30,France,NA,Ile-de-France,12244807,68,38,21288,4257
2020-05-31,France,NA,Ile-de-France,12244807,29,15,21317,4263
2020-06-01,France,NA,Ile-de-France,12244807,33,13,21350,4270
2020-06-02,France,NA,Ile-de-France,12244807,213,28,21563,4312
2020-06-03,France,NA,Ile-de-France,12244807,171,35,21734,4346
2020-06-04,France,NA,Ile-de-France,12244807,177,12,21911,4382
2020-06-05,France,NA,Ile-de-France,12244807,156,11,22067,4413
2020-06-06,France,NA,Ile-de-France,12244807,70,20,22137,4427
2020-06-07,France,NA,Ile-de-France,12244807,26,5,22163,4432
2020-06-08,France,NA,Ile-de-France,12244807,137,14,22300,4460
2020-06-09,France,NA,Ile-de-France,12244807,142,30,22442,4488
2020-06-10,France,NA,Ile-de-France,12244807,146,9,22588,4517
2020-06-11,France,NA,Ile-de-France,12244807,103,12,22691,4538
2020-06-12,France,NA,Ile-de-France,12244807,156,15,22847,4569
2020-06-13,France,NA,Ile-de-France,12244807,35,15,22882,4576
2020-06-14,France,NA,Ile-de-France,12244807,17,3,22899,4579
2020-06-15,France,NA,Ile-de-France,12244807,117,11,23016,4603
2020-06-16,France,NA,Ile-de-France,12244807,128,19,23144,4628
2020-06-17,France,NA,Ile-de-France,12244807,157,11,23301,4660
2020-06-18,France,NA,Ile-de-France,12244807,146,4,23447,4689
2020-06-19,France,NA,Ile-de-France,12244807,146,2,23593,4718
2020-06-20,France,NA,Ile-de-France,12244807,40,8,23633,4726
2020-06-21,France,NA,Ile-de-France,12244807,24,2,23657,4731
2020-06-22,France,NA,Ile-de-France,12244807,155,8,23812,4762
2020-06-23,France,NA,Ile-de-France,12244807,134,14,23946,4789
2020-06-24,France,NA,Ile-de-France,12244807,131,0,24077,4815
2020-06-25,France,NA,Ile-de-France,12244807,124,7,24201,4840
2020-06-26,France,NA,Ile-de-France,12244807,148,11,24349,4869
2020-06-27,France,NA,Ile-de-France,12244807,46,2,24395,4879
2020-06-28,France,NA,Ile-de-France,12244807,21,0,24416,4883
2020-06-29,France,NA,Ile-de-France,12244807,141,4,24557,4911
2020-06-30,France,NA,Ile-de-France,12244807,147,10,24704,4940
2020-07-01,France,NA,Ile-de-France,12244807,129,2,24833,4966
2020-07-02,France,NA,Ile-de-France,12244807,132,5,24965,4993
2020-07-03,France,NA,Ile-de-France,12244807,196,6,25161,5032
2020-07-04,France,NA,Ile-de-France,12244807,62,6,25223,5044
2020-07-05,France,NA,Ile-de-France,12244807,22,0,25245,5049
2020-07-06,France,NA,Ile-de-France,12244807,183,4,25428,5085
2020-07-07,France,NA,Ile-de-France,12244807,142,16,25570,5114
2020-07-08,France,NA,Ile-de-France,12244807,159,9,25729,5145
2020-07-09,France,NA,Ile-de-France,12244807,197,5,25926,5185
2020-07-10,France,NA,Ile-de-France,12244807,193,2,26119,5223
2020-07-11,France,NA,Ile-de-France,12244807,73,2,26192,5238
2020-07-12,France,NA,Ile-de-France,12244807,14,0,26206,5241
2020-07-13,France,NA,Ile-de-France,12244807,235,8,26441,5288
2020-07-14,France,NA,Ile-de-France,12244807,33,2,26474,5294
2020-07-15,France,NA,Ile-de-France,12244807,242,5,26716,5343
2020-07-16,France,NA,Ile-de-France,12244807,284,6,27000,5400
2020-07-17,France,NA,Ile-de-France,12244807,279,1,27279,5455
2020-07-18,France,NA,Ile-de-France,12244807,121,3,27400,5480
2020-07-19,France,NA,Ile-de-France,12244807,30,0,27430,5486
2020-07-20,France,NA,Ile-de-France,12244807,322,5,27752,5550
2020-07-21,France,NA,Ile-de-France,12244807,333,5,28085,5617
2020-07-22,France,NA,Ile-de-France,12244807,353,0,28438,5687
2020-07-23,France,NA,Ile-de-France,12244807,335,5,28773,5754
2020-07-24,France,NA,Ile-de-France,12244807,326,3,29099,5819
2020-07-25,France,NA,Ile-de-France,12244807,156,4,29255,5851
2020-07-26,France,NA,Ile-de-France,12244807,61,0,29316,5863
2020-07-27,France,NA,Ile-de-France,12244807,491,2,29807,5961
2020-07-28,France,NA,Ile-de-France,12244807,490,9,30297,6059
2020-07-29,France,NA,Ile-de-France,12244807,573,7,30870,6174
2020-07-30,France,NA,Ile-de-France,12244807,529,4,31399,6279
2020-07-31,France,NA,Ile-de-France,12244807,553,2,31952,6390
2020-08-01,France,NA,Ile-de-France,12244807,249,1,32201,6440
2020-08-02,France,NA,Ile-de-France,12244807,108,1,32309,6461
2020-08-03,France,NA,Ile-de-France,12244807,692,12,33001,6600
2020-08-04,France,NA,Ile-de-France,12244807,745,4,33746,6749
2020-08-05,France,NA,Ile-de-France,12244807,712,4,34458,6891
2020-08-06,France,NA,Ile-de-France,12244807,759,4,35217,7043
2020-08-07,France,NA,Ile-de-France,12244807,844,8,36061,7212
2020-08-08,France,NA,Ile-de-France,12244807,352,1,36413,7282
2020-08-09,France,NA,Ile-de-France,12244807,230,0,36643,7328
2020-08-10,France,NA,Ile-de-France,12244807,938,4,37581,7516
2020-08-11,France,NA,Ile-de-France,12244807,897,3,38478,7611
2020-08-12,France,NA,Ile-de-France,12244807,941,9,39419,7620
2020-08-13,France,NA,Ile-de-France,12244807,1154,4,40573,7624
2020-08-14,France,NA,Ile-de-France,12244807,1157,3,41730,7627
2020-08-15,France,NA,Ile-de-France,12244807,214,1,41944,7628
2020-08-16,France,NA,Ile-de-France,12244807,223,0,42167,7628
2020-08-17,France,NA,Ile-de-France,12244807,1398,8,43565,7636
2020-08-18,France,NA,Ile-de-France,12244807,1329,8,44894,7644
2020-08-19,France,NA,Ile-de-France,12244807,1391,6,46285,7650
2020-08-20,France,NA,Ile-de-France,12244807,1544,6,47829,7656
2020-08-21,France,NA,Ile-de-France,12244807,1482,15,49311,7671
2020-08-22,France,NA,Ile-de-France,12244807,595,5,49906,7676
2020-08-23,France,NA,Ile-de-France,12244807,315,1,50221,7677
2020-08-24,France,NA,Ile-de-France,12244807,2156,2,52377,7679
2020-08-25,France,NA,Ile-de-France,12244807,2125,2,54502,7681
2020-08-26,France,NA,Ile-de-France,12244807,2147,12,56649,7693
2020-08-27,France,NA,Ile-de-France,12244807,2259,6,58908,7699
2020-08-28,France,NA,Ile-de-France,12244807,2453,6,61361,7705
2020-08-29,France,NA,Ile-de-France,12244807,766,1,62127,7706
2020-08-30,France,NA,Ile-de-France,12244807,381,2,62508,7708
2020-08-31,France,NA,Ile-de-France,12244807,2841,11,65349,7719
2020-09-01,France,NA,Ile-de-France,12244807,2612,6,67961,7725
2020-09-02,France,NA,Ile-de-France,12244807,2473,14,70434,7739
2020-09-03,France,NA,Ile-de-France,12244807,2585,7,73019,7746
2020-09-04,France,NA,Ile-de-France,12244807,2577,6,75596,7752
2020-09-05,France,NA,Ile-de-France,12244807,1044,1,76640,7753
2020-09-06,France,NA,Ile-de-France,12244807,345,0,76985,7753
2020-09-07,France,NA,Ile-de-France,12244807,3257,5,80242,7758
2020-09-08,France,NA,Ile-de-France,12244807,3079,8,83321,7766
2020-09-09,France,NA,Ile-de-France,12244807,2865,7,86186,7773
2020-09-10,France,NA,Ile-de-France,12244807,3118,6,89304,7779
2020-09-11,France,NA,Ile-de-France,12244807,2829,5,92133,7784
2020-09-12,France,NA,Ile-de-France,12244807,855,6,92988,7790
2020-09-13,France,NA,Ile-de-France,12244807,355,2,93343,7792
2020-09-14,France,NA,Ile-de-France,12244807,3386,9,96729,7801
2020-09-15,France,NA,Ile-de-France,12244807,2863,10,99592,7811
2020-09-16,France,NA,Ile-de-France,12244807,3065,29,102657,7840
2020-09-17,France,NA,Ile-de-France,12244807,3146,13,105803,7853
2020-09-18,France,NA,Ile-de-France,12244807,2978,85,108781,7938
2020-09-19,France,NA,Ile-de-France,12244807,1298,8,110079,7946
2020-09-20,France,NA,Ile-de-France,12244807,476,5,110555,7951
2020-09-21,France,NA,Ile-de-France,12244807,3446,8,114001,7959
2020-03-19,France,NA,Normandy,3313340,6,2,12,2
2020-03-20,France,NA,Normandy,3313340,15,2,27,5
2020-03-21,France,NA,Normandy,3313340,6,0,33,6
2020-03-22,France,NA,Normandy,3313340,2,2,35,7
2020-03-23,France,NA,Normandy,3313340,40,1,75,9
2020-03-24,France,NA,Normandy,3313340,52,6,127,15
2020-03-25,France,NA,Normandy,3313340,47,3,174,18
2020-03-26,France,NA,Normandy,3313340,52,2,226,20
2020-03-27,France,NA,Normandy,3313340,36,4,262,24
2020-03-28,France,NA,Normandy,3313340,4,2,266,26
2020-03-29,France,NA,Normandy,3313340,0,6,266,32
2020-03-30,France,NA,Normandy,3313340,58,10,324,42
2020-03-31,France,NA,Normandy,3313340,43,20,367,62
2020-04-01,France,NA,Normandy,3313340,38,7,405,69
2020-04-02,France,NA,Normandy,3313340,34,12,439,81
2020-04-03,France,NA,Normandy,3313340,70,12,509,93
2020-04-04,France,NA,Normandy,3313340,2,6,511,99
2020-04-05,France,NA,Normandy,3313340,2,12,513,102
2020-04-06,France,NA,Normandy,3313340,62,16,575,115
2020-04-07,France,NA,Normandy,3313340,86,20,661,132
2020-04-08,France,NA,Normandy,3313340,52,18,713,142
2020-04-09,France,NA,Normandy,3313340,64,14,777,155
2020-04-10,France,NA,Normandy,3313340,82,9,859,171
2020-04-11,France,NA,Normandy,3313340,4,8,863,172
2020-04-12,France,NA,Normandy,3313340,14,5,877,175
2020-04-13,France,NA,Normandy,3313340,1,10,878,175
2020-04-14,France,NA,Normandy,3313340,70,19,948,189
2020-04-15,France,NA,Normandy,3313340,57,12,1005,201
2020-04-16,France,NA,Normandy,3313340,56,10,1061,212
2020-04-17,France,NA,Normandy,3313340,36,10,1097,219
2020-04-18,France,NA,Normandy,3313340,8,5,1105,221
2020-04-19,France,NA,Normandy,3313340,2,7,1107,221
2020-04-20,France,NA,Normandy,3313340,31,9,1138,227
2020-04-21,France,NA,Normandy,3313340,16,9,1154,230
2020-04-22,France,NA,Normandy,3313340,27,7,1181,236
2020-04-23,France,NA,Normandy,3313340,25,8,1206,241
2020-04-24,France,NA,Normandy,3313340,17,5,1223,244
2020-04-25,France,NA,Normandy,3313340,3,2,1226,245
2020-04-26,France,NA,Normandy,3313340,0,5,1226,245
2020-04-27,France,NA,Normandy,3313340,15,5,1241,248
2020-04-28,France,NA,Normandy,3313340,12,7,1253,250
2020-04-29,France,NA,Normandy,3313340,16,12,1269,253
2020-04-30,France,NA,Normandy,3313340,11,3,1280,256
2020-05-01,France,NA,Normandy,3313340,0,1,1280,256
2020-05-02,France,NA,Normandy,3313340,2,3,1282,256
2020-05-03,France,NA,Normandy,3313340,0,1,1282,256
2020-05-04,France,NA,Normandy,3313340,13,8,1295,259
2020-05-05,France,NA,Normandy,3313340,7,4,1302,260
2020-05-06,France,NA,Normandy,3313340,7,2,1309,261
2020-05-07,France,NA,Normandy,3313340,3,2,1312,262
2020-05-08,France,NA,Normandy,3313340,1,3,1313,262
2020-05-09,France,NA,Normandy,3313340,2,0,1315,263
2020-05-10,France,NA,Normandy,3313340,0,1,1315,263
2020-05-11,France,NA,Normandy,3313340,10,9,1325,265
2020-05-12,France,NA,Normandy,3313340,5,3,1330,266
2020-05-13,France,NA,Normandy,3313340,37,4,1367,273
2020-05-14,France,NA,Normandy,3313340,26,4,1393,278
2020-05-15,France,NA,Normandy,3313340,23,2,1416,283
2020-05-16,France,NA,Normandy,3313340,6,1,1422,284
2020-05-17,France,NA,Normandy,3313340,8,0,1430,286
2020-05-18,France,NA,Normandy,3313340,28,3,1458,291
2020-05-19,France,NA,Normandy,3313340,20,7,1478,295
2020-05-20,France,NA,Normandy,3313340,13,1,1491,298
2020-05-21,France,NA,Normandy,3313340,5,2,1496,299
2020-05-22,France,NA,Normandy,3313340,16,0,1512,302
2020-05-23,France,NA,Normandy,3313340,6,1,1518,303
2020-05-24,France,NA,Normandy,3313340,4,0,1522,304
2020-05-25,France,NA,Normandy,3313340,11,5,1533,306
2020-05-26,France,NA,Normandy,3313340,12,4,1545,309
2020-05-27,France,NA,Normandy,3313340,8,1,1553,310
2020-05-28,France,NA,Normandy,3313340,6,0,1559,311
2020-05-29,France,NA,Normandy,3313340,9,2,1568,313
2020-05-30,France,NA,Normandy,3313340,2,0,1570,314
2020-05-31,France,NA,Normandy,3313340,2,0,1572,314
2020-06-01,France,NA,Normandy,3313340,5,0,1577,315
2020-06-02,France,NA,Normandy,3313340,9,0,1586,317
2020-06-03,France,NA,Normandy,3313340,6,1,1592,318
2020-06-04,France,NA,Normandy,3313340,9,0,1601,320
2020-06-05,France,NA,Normandy,3313340,5,1,1606,321
2020-06-06,France,NA,Normandy,3313340,8,0,1614,322
2020-06-07,France,NA,Normandy,3313340,2,1,1616,323
2020-06-08,France,NA,Normandy,3313340,8,2,1624,324
2020-06-09,France,NA,Normandy,3313340,9,0,1633,326
2020-06-10,France,NA,Normandy,3313340,7,0,1640,328
2020-06-11,France,NA,Normandy,3313340,12,0,1652,330
2020-06-12,France,NA,Normandy,3313340,14,0,1666,333
2020-06-13,France,NA,Normandy,3313340,13,0,1679,335
2020-06-14,France,NA,Normandy,3313340,7,0,1686,337
2020-06-15,France,NA,Normandy,3313340,23,0,1709,341
2020-06-16,France,NA,Normandy,3313340,19,2,1728,345
2020-06-17,France,NA,Normandy,3313340,33,1,1761,352
2020-06-18,France,NA,Normandy,3313340,24,0,1785,357
2020-06-19,France,NA,Normandy,3313340,19,0,1804,360
2020-06-20,France,NA,Normandy,3313340,20,0,1824,364
2020-06-21,France,NA,Normandy,3313340,4,0,1828,365
2020-06-22,France,NA,Normandy,3313340,26,2,1854,370
2020-06-23,France,NA,Normandy,3313340,25,0,1879,375
2020-06-24,France,NA,Normandy,3313340,21,0,1900,380
2020-06-25,France,NA,Normandy,3313340,23,1,1923,384
2020-06-26,France,NA,Normandy,3313340,17,0,1940,388
2020-06-27,France,NA,Normandy,3313340,10,0,1950,390
2020-06-28,France,NA,Normandy,3313340,11,0,1961,392
2020-06-29,France,NA,Normandy,3313340,24,1,1985,397
2020-06-30,France,NA,Normandy,3313340,32,1,2017,403
2020-07-01,France,NA,Normandy,3313340,21,1,2038,407
2020-07-02,France,NA,Normandy,3313340,20,0,2058,411
2020-07-03,France,NA,Normandy,3313340,24,0,2082,416
2020-07-04,France,NA,Normandy,3313340,13,0,2095,419
2020-07-05,France,NA,Normandy,3313340,5,0,2100,420
2020-07-06,France,NA,Normandy,3313340,15,0,2115,423
2020-07-07,France,NA,Normandy,3313340,30,0,2145,429
2020-07-08,France,NA,Normandy,3313340,15,0,2160,432
2020-07-09,France,NA,Normandy,3313340,22,0,2182,434
2020-07-10,France,NA,Normandy,3313340,13,1,2195,435
2020-07-11,France,NA,Normandy,3313340,8,0,2203,435
2020-07-12,France,NA,Normandy,3313340,5,0,2208,435
2020-07-13,France,NA,Normandy,3313340,19,1,2227,436
2020-07-14,France,NA,Normandy,3313340,7,0,2234,436
2020-07-15,France,NA,Normandy,3313340,10,0,2244,436
2020-07-16,France,NA,Normandy,3313340,27,2,2271,438
2020-07-17,France,NA,Normandy,3313340,22,1,2293,439
2020-07-18,France,NA,Normandy,3313340,4,1,2297,440
2020-07-19,France,NA,Normandy,3313340,3,0,2300,440
2020-07-20,France,NA,Normandy,3313340,18,0,2318,440
2020-07-21,France,NA,Normandy,3313340,18,0,2336,440
2020-07-22,France,NA,Normandy,3313340,15,0,2351,440
2020-07-23,France,NA,Normandy,3313340,25,0,2376,440
2020-07-24,France,NA,Normandy,3313340,15,0,2391,440
2020-07-25,France,NA,Normandy,3313340,8,1,2399,440
2020-07-26,France,NA,Normandy,3313340,8,0,2407,440
2020-07-27,France,NA,Normandy,3313340,16,0,2423,440
2020-07-28,France,NA,Normandy,3313340,19,0,2442,440
2020-07-29,France,NA,Normandy,3313340,23,0,2465,440
2020-07-30,France,NA,Normandy,3313340,16,0,2481,440
2020-07-31,France,NA,Normandy,3313340,28,1,2509,440
2020-08-01,France,NA,Normandy,3313340,17,0,2526,440
2020-08-02,France,NA,Normandy,3313340,11,0,2537,440
2020-08-03,France,NA,Normandy,3313340,27,1,2564,441
2020-08-04,France,NA,Normandy,3313340,31,1,2595,442
2020-08-05,France,NA,Normandy,3313340,37,0,2632,442
2020-08-06,France,NA,Normandy,3313340,33,0,2665,442
2020-08-07,France,NA,Normandy,3313340,45,0,2710,442
2020-08-08,France,NA,Normandy,3313340,24,0,2734,442
2020-08-09,France,NA,Normandy,3313340,14,0,2748,442
2020-08-10,France,NA,Normandy,3313340,37,0,2785,442
2020-08-11,France,NA,Normandy,3313340,46,0,2831,442
2020-08-12,France,NA,Normandy,3313340,43,1,2874,443
2020-08-13,France,NA,Normandy,3313340,48,0,2922,443
2020-08-14,France,NA,Normandy,3313340,66,2,2988,445
2020-08-15,France,NA,Normandy,3313340,36,0,3024,445
2020-08-16,France,NA,Normandy,3313340,34,0,3058,445
2020-08-17,France,NA,Normandy,3313340,70,0,3128,445
2020-08-18,France,NA,Normandy,3313340,94,2,3222,447
2020-08-19,France,NA,Normandy,3313340,86,0,3308,447
2020-08-20,France,NA,Normandy,3313340,78,0,3386,447
2020-08-21,France,NA,Normandy,3313340,76,0,3462,447
2020-08-22,France,NA,Normandy,3313340,67,0,3529,447
2020-08-23,France,NA,Normandy,3313340,20,0,3549,447
2020-08-24,France,NA,Normandy,3313340,117,0,3666,447
2020-08-25,France,NA,Normandy,3313340,166,0,3832,447
2020-08-26,France,NA,Normandy,3313340,153,0,3985,447
2020-08-27,France,NA,Normandy,3313340,226,0,4211,447
2020-08-28,France,NA,Normandy,3313340,184,1,4395,447
2020-08-29,France,NA,Normandy,3313340,123,0,4518,447
2020-08-30,France,NA,Normandy,3313340,91,0,4609,447
2020-08-31,France,NA,Normandy,3313340,249,0,4858,447
2020-09-01,France,NA,Normandy,3313340,202,1,5060,448
2020-09-02,France,NA,Normandy,3313340,226,0,5286,448
2020-09-03,France,NA,Normandy,3313340,261,0,5547,448
2020-09-04,France,NA,Normandy,3313340,268,0,5815,448
2020-09-05,France,NA,Normandy,3313340,122,0,5937,448
2020-09-06,France,NA,Normandy,3313340,175,0,6112,448
2020-09-07,France,NA,Normandy,3313340,363,0,6475,448
2020-09-08,France,NA,Normandy,3313340,363,1,6838,449
2020-09-09,France,NA,Normandy,3313340,371,0,7209,449
2020-09-10,France,NA,Normandy,3313340,387,0,7596,449
2020-09-11,France,NA,Normandy,3313340,410,0,8006,449
2020-09-12,France,NA,Normandy,3313340,189,0,8195,449
2020-09-13,France,NA,Normandy,3313340,104,0,8299,449
2020-09-14,France,NA,Normandy,3313340,501,1,8800,450
2020-09-15,France,NA,Normandy,3313340,436,1,9236,451
2020-09-16,France,NA,Normandy,3313340,479,0,9715,451
2020-09-17,France,NA,Normandy,3313340,389,2,10104,453
2020-09-18,France,NA,Normandy,3313340,466,1,10570,454
2020-09-19,France,NA,Normandy,3313340,231,1,10801,455
2020-09-20,France,NA,Normandy,3313340,119,1,10920,456
2020-09-21,France,NA,Normandy,3313340,395,3,11315,459
2020-03-17,France,NA,Nouvelle-Aquitaine,5986318,10,0,17,0
2020-03-18,France,NA,Nouvelle-Aquitaine,5986318,9,0,26,2
2020-03-19,France,NA,Nouvelle-Aquitaine,5986318,10,1,36,3
2020-03-20,France,NA,Nouvelle-Aquitaine,5986318,12,1,48,4
2020-03-21,France,NA,Nouvelle-Aquitaine,5986318,4,1,52,5
2020-03-22,France,NA,Nouvelle-Aquitaine,5986318,5,3,57,8
2020-03-23,France,NA,Nouvelle-Aquitaine,5986318,34,5,91,13
2020-03-24,France,NA,Nouvelle-Aquitaine,5986318,42,3,133,16
2020-03-25,France,NA,Nouvelle-Aquitaine,5986318,27,9,160,25
2020-03-26,France,NA,Nouvelle-Aquitaine,5986318,31,9,191,34
2020-03-27,France,NA,Nouvelle-Aquitaine,5986318,40,8,231,42
2020-03-28,France,NA,Nouvelle-Aquitaine,5986318,9,8,240,48
2020-03-29,France,NA,Nouvelle-Aquitaine,5986318,0,8,240,48
2020-03-30,France,NA,Nouvelle-Aquitaine,5986318,61,14,301,60
2020-03-31,France,NA,Nouvelle-Aquitaine,5986318,53,6,354,70
2020-04-01,France,NA,Nouvelle-Aquitaine,5986318,38,4,392,78
2020-04-02,France,NA,Nouvelle-Aquitaine,5986318,38,12,430,86
2020-04-03,France,NA,Nouvelle-Aquitaine,5986318,39,6,469,93
2020-04-04,France,NA,Nouvelle-Aquitaine,5986318,3,11,472,94
2020-04-05,France,NA,Nouvelle-Aquitaine,5986318,1,9,473,94
2020-04-06,France,NA,Nouvelle-Aquitaine,5986318,44,18,517,103
2020-04-07,France,NA,Nouvelle-Aquitaine,5986318,29,14,546,109
2020-04-08,France,NA,Nouvelle-Aquitaine,5986318,29,13,575,115
2020-04-09,France,NA,Nouvelle-Aquitaine,5986318,22,8,597,119
2020-04-10,France,NA,Nouvelle-Aquitaine,5986318,31,1,628,125
2020-04-11,France,NA,Nouvelle-Aquitaine,5986318,3,6,631,126
2020-04-12,France,NA,Nouvelle-Aquitaine,5986318,0,10,631,126
2020-04-13,France,NA,Nouvelle-Aquitaine,5986318,1,4,632,126
2020-04-14,France,NA,Nouvelle-Aquitaine,5986318,62,13,694,138
2020-04-15,France,NA,Nouvelle-Aquitaine,5986318,11,7,705,141
2020-04-16,France,NA,Nouvelle-Aquitaine,5986318,28,6,733,146
2020-04-17,France,NA,Nouvelle-Aquitaine,5986318,16,13,749,149
2020-04-18,France,NA,Nouvelle-Aquitaine,5986318,18,8,767,153
2020-04-19,France,NA,Nouvelle-Aquitaine,5986318,1,6,768,153
2020-04-20,France,NA,Nouvelle-Aquitaine,5986318,6,12,774,154
2020-04-21,France,NA,Nouvelle-Aquitaine,5986318,35,7,809,161
2020-04-22,France,NA,Nouvelle-Aquitaine,5986318,21,1,830,166
2020-04-23,France,NA,Nouvelle-Aquitaine,5986318,11,10,841,168
2020-04-24,France,NA,Nouvelle-Aquitaine,5986318,6,8,847,169
2020-04-25,France,NA,Nouvelle-Aquitaine,5986318,1,4,848,169
2020-04-26,France,NA,Nouvelle-Aquitaine,5986318,0,5,848,169
2020-04-27,France,NA,Nouvelle-Aquitaine,5986318,5,7,853,170
2020-04-28,France,NA,Nouvelle-Aquitaine,5986318,2,1,855,171
2020-04-29,France,NA,Nouvelle-Aquitaine,5986318,12,11,867,173
2020-04-30,France,NA,Nouvelle-Aquitaine,5986318,5,11,872,174
2020-05-01,France,NA,Nouvelle-Aquitaine,5986318,0,0,872,174
2020-05-02,France,NA,Nouvelle-Aquitaine,5986318,0,3,872,174
2020-05-03,France,NA,Nouvelle-Aquitaine,5986318,0,2,872,174
2020-05-04,France,NA,Nouvelle-Aquitaine,5986318,3,7,875,175
2020-05-05,France,NA,Nouvelle-Aquitaine,5986318,9,0,884,176
2020-05-06,France,NA,Nouvelle-Aquitaine,5986318,4,6,888,177
2020-05-07,France,NA,Nouvelle-Aquitaine,5986318,4,5,892,178
2020-05-08,France,NA,Nouvelle-Aquitaine,5986318,0,1,892,178
2020-05-09,France,NA,Nouvelle-Aquitaine,5986318,0,3,892,178
2020-05-10,France,NA,Nouvelle-Aquitaine,5986318,0,2,892,178
2020-05-11,France,NA,Nouvelle-Aquitaine,5986318,23,5,915,183
2020-05-12,France,NA,Nouvelle-Aquitaine,5986318,14,4,929,185
2020-05-13,France,NA,Nouvelle-Aquitaine,5986318,38,2,967,193
2020-05-14,France,NA,Nouvelle-Aquitaine,5986318,23,3,990,198
2020-05-15,France,NA,Nouvelle-Aquitaine,5986318,30,3,1020,204
2020-05-16,France,NA,Nouvelle-Aquitaine,5986318,8,1,1028,205
2020-05-17,France,NA,Nouvelle-Aquitaine,5986318,2,2,1030,206
2020-05-18,France,NA,Nouvelle-Aquitaine,5986318,52,3,1082,216
2020-05-19,France,NA,Nouvelle-Aquitaine,5986318,77,1,1159,231
2020-05-20,France,NA,Nouvelle-Aquitaine,5986318,61,3,1220,244
2020-05-21,France,NA,Nouvelle-Aquitaine,5986318,1,0,1221,244
2020-05-22,France,NA,Nouvelle-Aquitaine,5986318,56,1,1277,255
2020-05-23,France,NA,Nouvelle-Aquitaine,5986318,20,1,1297,259
2020-05-24,France,NA,Nouvelle-Aquitaine,5986318,0,0,1297,259
2020-05-25,France,NA,Nouvelle-Aquitaine,5986318,29,3,1326,265
2020-05-26,France,NA,Nouvelle-Aquitaine,5986318,43,3,1369,273
2020-05-27,France,NA,Nouvelle-Aquitaine,5986318,42,2,1411,282
2020-05-28,France,NA,Nouvelle-Aquitaine,5986318,24,4,1435,287
2020-05-29,France,NA,Nouvelle-Aquitaine,5986318,14,0,1449,289
2020-05-30,France,NA,Nouvelle-Aquitaine,5986318,14,0,1463,292
2020-05-31,France,NA,Nouvelle-Aquitaine,5986318,1,1,1464,292
2020-06-01,France,NA,Nouvelle-Aquitaine,5986318,6,0,1470,294
2020-06-02,France,NA,Nouvelle-Aquitaine,5986318,12,3,1482,296
2020-06-03,France,NA,Nouvelle-Aquitaine,5986318,24,2,1506,301
2020-06-04,France,NA,Nouvelle-Aquitaine,5986318,10,0,1516,303
2020-06-05,France,NA,Nouvelle-Aquitaine,5986318,8,1,1524,304
2020-06-06,France,NA,Nouvelle-Aquitaine,5986318,7,2,1531,306
2020-06-07,France,NA,Nouvelle-Aquitaine,5986318,1,0,1532,306
2020-06-08,France,NA,Nouvelle-Aquitaine,5986318,6,0,1538,307
2020-06-09,France,NA,Nouvelle-Aquitaine,5986318,7,2,1545,309
2020-06-10,France,NA,Nouvelle-Aquitaine,5986318,14,1,1559,311
2020-06-11,France,NA,Nouvelle-Aquitaine,5986318,12,1,1571,314
2020-06-12,France,NA,Nouvelle-Aquitaine,5986318,9,1,1580,316
2020-06-13,France,NA,Nouvelle-Aquitaine,5986318,7,0,1587,317
2020-06-14,France,NA,Nouvelle-Aquitaine,5986318,1,0,1588,317
2020-06-15,France,NA,Nouvelle-Aquitaine,5986318,2,2,1590,318
2020-06-16,France,NA,Nouvelle-Aquitaine,5986318,2,1,1592,318
2020-06-17,France,NA,Nouvelle-Aquitaine,5986318,4,0,1596,319
2020-06-18,France,NA,Nouvelle-Aquitaine,5986318,14,1,1610,322
2020-06-19,France,NA,Nouvelle-Aquitaine,5986318,16,0,1626,325
2020-06-20,France,NA,Nouvelle-Aquitaine,5986318,6,0,1632,326
2020-06-21,France,NA,Nouvelle-Aquitaine,5986318,3,0,1635,327
2020-06-22,France,NA,Nouvelle-Aquitaine,5986318,8,0,1643,328
2020-06-23,France,NA,Nouvelle-Aquitaine,5986318,12,0,1655,331
2020-06-24,France,NA,Nouvelle-Aquitaine,5986318,7,0,1662,332
2020-06-25,France,NA,Nouvelle-Aquitaine,5986318,2,0,1664,332
2020-06-26,France,NA,Nouvelle-Aquitaine,5986318,14,1,1678,335
2020-06-27,France,NA,Nouvelle-Aquitaine,5986318,3,5,1681,336
2020-06-28,France,NA,Nouvelle-Aquitaine,5986318,4,0,1685,337
2020-06-29,France,NA,Nouvelle-Aquitaine,5986318,6,0,1691,338
2020-06-30,France,NA,Nouvelle-Aquitaine,5986318,12,0,1703,340
2020-07-01,France,NA,Nouvelle-Aquitaine,5986318,23,0,1726,345
2020-07-02,France,NA,Nouvelle-Aquitaine,5986318,12,1,1738,347
2020-07-03,France,NA,Nouvelle-Aquitaine,5986318,11,1,1749,349
2020-07-04,France,NA,Nouvelle-Aquitaine,5986318,7,1,1756,351
2020-07-05,France,NA,Nouvelle-Aquitaine,5986318,2,0,1758,351
2020-07-06,France,NA,Nouvelle-Aquitaine,5986318,13,0,1771,354
2020-07-07,France,NA,Nouvelle-Aquitaine,5986318,14,0,1785,357
2020-07-08,France,NA,Nouvelle-Aquitaine,5986318,35,0,1820,364
2020-07-09,France,NA,Nouvelle-Aquitaine,5986318,11,0,1831,366
2020-07-10,France,NA,Nouvelle-Aquitaine,5986318,26,1,1857,371
2020-07-11,France,NA,Nouvelle-Aquitaine,5986318,4,0,1861,372
2020-07-12,France,NA,Nouvelle-Aquitaine,5986318,1,0,1862,372
2020-07-13,France,NA,Nouvelle-Aquitaine,5986318,16,1,1878,375
2020-07-14,France,NA,Nouvelle-Aquitaine,5986318,4,0,1882,376
2020-07-15,France,NA,Nouvelle-Aquitaine,5986318,29,0,1911,382
2020-07-16,France,NA,Nouvelle-Aquitaine,5986318,30,1,1941,388
2020-07-17,France,NA,Nouvelle-Aquitaine,5986318,45,0,1986,397
2020-07-18,France,NA,Nouvelle-Aquitaine,5986318,17,0,2003,400
2020-07-19,France,NA,Nouvelle-Aquitaine,5986318,6,0,2009,401
2020-07-20,France,NA,Nouvelle-Aquitaine,5986318,19,0,2028,405
2020-07-21,France,NA,Nouvelle-Aquitaine,5986318,26,0,2054,410
2020-07-22,France,NA,Nouvelle-Aquitaine,5986318,43,0,2097,419
2020-07-23,France,NA,Nouvelle-Aquitaine,5986318,32,0,2129,424
2020-07-24,France,NA,Nouvelle-Aquitaine,5986318,48,0,2177,424
2020-07-25,France,NA,Nouvelle-Aquitaine,5986318,12,0,2189,424
2020-07-26,France,NA,Nouvelle-Aquitaine,5986318,6,0,2195,424
2020-07-27,France,NA,Nouvelle-Aquitaine,5986318,32,0,2227,424
2020-07-28,France,NA,Nouvelle-Aquitaine,5986318,23,0,2250,424
2020-07-29,France,NA,Nouvelle-Aquitaine,5986318,25,1,2275,425
2020-07-30,France,NA,Nouvelle-Aquitaine,5986318,28,0,2303,425
2020-07-31,France,NA,Nouvelle-Aquitaine,5986318,28,0,2331,425
2020-08-01,France,NA,Nouvelle-Aquitaine,5986318,23,0,2354,425
2020-08-02,France,NA,Nouvelle-Aquitaine,5986318,5,0,2359,425
2020-08-03,France,NA,Nouvelle-Aquitaine,5986318,42,0,2401,425
2020-08-04,France,NA,Nouvelle-Aquitaine,5986318,40,1,2441,426
2020-08-05,France,NA,Nouvelle-Aquitaine,5986318,40,0,2481,426
2020-08-06,France,NA,Nouvelle-Aquitaine,5986318,67,0,2548,426
2020-08-07,France,NA,Nouvelle-Aquitaine,5986318,62,1,2610,427
2020-08-08,France,NA,Nouvelle-Aquitaine,5986318,20,0,2630,427
2020-08-09,France,NA,Nouvelle-Aquitaine,5986318,12,0,2642,427
2020-08-10,France,NA,Nouvelle-Aquitaine,5986318,92,1,2734,428
2020-08-11,France,NA,Nouvelle-Aquitaine,5986318,91,0,2825,428
2020-08-12,France,NA,Nouvelle-Aquitaine,5986318,115,0,2940,428
2020-08-13,France,NA,Nouvelle-Aquitaine,5986318,142,1,3082,429
2020-08-14,France,NA,Nouvelle-Aquitaine,5986318,132,0,3214,429
2020-08-15,France,NA,Nouvelle-Aquitaine,5986318,43,0,3257,429
2020-08-16,France,NA,Nouvelle-Aquitaine,5986318,42,0,3299,429
2020-08-17,France,NA,Nouvelle-Aquitaine,5986318,230,1,3529,430
2020-08-18,France,NA,Nouvelle-Aquitaine,5986318,337,0,3866,430
2020-08-19,France,NA,Nouvelle-Aquitaine,5986318,305,0,4171,430
2020-08-20,France,NA,Nouvelle-Aquitaine,5986318,319,0,4490,430
2020-08-21,France,NA,Nouvelle-Aquitaine,5986318,314,0,4804,430
2020-08-22,France,NA,Nouvelle-Aquitaine,5986318,221,0,5025,430
2020-08-23,France,NA,Nouvelle-Aquitaine,5986318,143,0,5168,430
2020-08-24,France,NA,Nouvelle-Aquitaine,5986318,440,1,5608,431
2020-08-25,France,NA,Nouvelle-Aquitaine,5986318,490,0,6098,431
2020-08-26,France,NA,Nouvelle-Aquitaine,5986318,509,1,6607,432
2020-08-27,France,NA,Nouvelle-Aquitaine,5986318,627,0,7234,432
2020-08-28,France,NA,Nouvelle-Aquitaine,5986318,569,1,7803,433
2020-08-29,France,NA,Nouvelle-Aquitaine,5986318,291,0,8094,433
2020-08-30,France,NA,Nouvelle-Aquitaine,5986318,152,0,8246,433
2020-08-31,France,NA,Nouvelle-Aquitaine,5986318,702,1,8948,434
2020-09-01,France,NA,Nouvelle-Aquitaine,5986318,783,0,9731,434
2020-09-02,France,NA,Nouvelle-Aquitaine,5986318,858,2,10589,436
2020-09-03,France,NA,Nouvelle-Aquitaine,5986318,778,1,11367,437
2020-09-04,France,NA,Nouvelle-Aquitaine,5986318,852,1,12219,438
2020-09-05,France,NA,Nouvelle-Aquitaine,5986318,331,0,12550,438
2020-09-06,France,NA,Nouvelle-Aquitaine,5986318,157,0,12707,438
2020-09-07,France,NA,Nouvelle-Aquitaine,5986318,883,2,13590,440
2020-09-08,France,NA,Nouvelle-Aquitaine,5986318,803,1,14393,441
2020-09-09,France,NA,Nouvelle-Aquitaine,5986318,778,1,15171,442
2020-09-10,France,NA,Nouvelle-Aquitaine,5986318,861,0,16032,442
2020-09-11,France,NA,Nouvelle-Aquitaine,5986318,777,2,16809,444
2020-09-12,France,NA,Nouvelle-Aquitaine,5986318,248,0,17057,444
2020-09-13,France,NA,Nouvelle-Aquitaine,5986318,141,1,17198,445
2020-09-14,France,NA,Nouvelle-Aquitaine,5986318,976,3,18174,448
2020-09-15,France,NA,Nouvelle-Aquitaine,5986318,862,1,19036,449
2020-09-16,France,NA,Nouvelle-Aquitaine,5986318,821,2,19857,451
2020-09-17,France,NA,Nouvelle-Aquitaine,5986318,855,3,20712,454
2020-09-18,France,NA,Nouvelle-Aquitaine,5986318,823,2,21535,456
2020-09-19,France,NA,Nouvelle-Aquitaine,5986318,360,1,21895,457
2020-09-20,France,NA,Nouvelle-Aquitaine,5986318,100,3,21995,460
2020-09-21,France,NA,Nouvelle-Aquitaine,5986318,867,3,22862,463
2020-03-17,France,NA,Occitanie,5899209,11,0,21,0
2020-03-18,France,NA,Occitanie,5899209,28,0,49,6
2020-03-19,France,NA,Occitanie,5899209,46,11,95,17
2020-03-20,France,NA,Occitanie,5899209,60,4,155,21
2020-03-21,France,NA,Occitanie,5899209,13,3,168,24
2020-03-22,France,NA,Occitanie,5899209,19,1,187,25
2020-03-23,France,NA,Occitanie,5899209,105,7,292,32
2020-03-24,France,NA,Occitanie,5899209,109,7,401,39
2020-03-25,France,NA,Occitanie,5899209,104,7,505,46
2020-03-26,France,NA,Occitanie,5899209,124,8,629,54
2020-03-27,France,NA,Occitanie,5899209,100,7,729,61
2020-03-28,France,NA,Occitanie,5899209,34,7,763,68
2020-03-29,France,NA,Occitanie,5899209,5,8,768,76
2020-03-30,France,NA,Occitanie,5899209,132,6,900,82
2020-03-31,France,NA,Occitanie,5899209,101,9,1001,91
2020-04-01,France,NA,Occitanie,5899209,114,17,1115,108
2020-04-02,France,NA,Occitanie,5899209,97,11,1212,119
2020-04-03,France,NA,Occitanie,5899209,90,12,1302,131
2020-04-04,France,NA,Occitanie,5899209,22,17,1324,148
2020-04-05,France,NA,Occitanie,5899209,5,10,1329,158
2020-04-06,France,NA,Occitanie,5899209,86,14,1415,172
2020-04-07,France,NA,Occitanie,5899209,74,8,1489,180
2020-04-08,France,NA,Occitanie,5899209,83,15,1572,195
2020-04-09,France,NA,Occitanie,5899209,65,8,1637,203
2020-04-10,France,NA,Occitanie,5899209,100,19,1737,222
2020-04-11,France,NA,Occitanie,5899209,10,11,1747,233
2020-04-12,France,NA,Occitanie,5899209,2,6,1749,239
2020-04-13,France,NA,Occitanie,5899209,8,9,1757,248
2020-04-14,France,NA,Occitanie,5899209,85,18,1842,266
2020-04-15,France,NA,Occitanie,5899209,54,12,1896,278
2020-04-16,France,NA,Occitanie,5899209,53,3,1949,281
2020-04-17,France,NA,Occitanie,5899209,57,9,2006,290
2020-04-18,France,NA,Occitanie,5899209,10,2,2016,292
2020-04-19,France,NA,Occitanie,5899209,3,3,2019,295
2020-04-20,France,NA,Occitanie,5899209,49,17,2068,312
2020-04-21,France,NA,Occitanie,5899209,40,10,2108,322
2020-04-22,France,NA,Occitanie,5899209,32,6,2140,328
2020-04-23,France,NA,Occitanie,5899209,42,14,2182,342
2020-04-24,France,NA,Occitanie,5899209,36,14,2218,356
2020-04-25,France,NA,Occitanie,5899209,7,5,2225,361
2020-04-26,France,NA,Occitanie,5899209,5,1,2230,362
2020-04-27,France,NA,Occitanie,5899209,16,11,2246,373
2020-04-28,France,NA,Occitanie,5899209,21,7,2267,380
2020-04-29,France,NA,Occitanie,5899209,44,10,2311,390
2020-04-30,France,NA,Occitanie,5899209,20,11,2331,401
2020-05-01,France,NA,Occitanie,5899209,0,0,2331,401
2020-05-02,France,NA,Occitanie,5899209,6,15,2337,409
2020-05-03,France,NA,Occitanie,5899209,5,1,2342,410
2020-05-04,France,NA,Occitanie,5899209,45,14,2387,424
2020-05-05,France,NA,Occitanie,5899209,38,12,2425,436
2020-05-06,France,NA,Occitanie,5899209,19,5,2444,441
2020-05-07,France,NA,Occitanie,5899209,29,7,2473,448
2020-05-08,France,NA,Occitanie,5899209,3,2,2476,450
2020-05-09,France,NA,Occitanie,5899209,8,2,2484,452
2020-05-10,France,NA,Occitanie,5899209,8,1,2492,453
2020-05-11,France,NA,Occitanie,5899209,28,1,2520,454
2020-05-12,France,NA,Occitanie,5899209,22,5,2542,459
2020-05-13,France,NA,Occitanie,5899209,57,1,2599,460
2020-05-14,France,NA,Occitanie,5899209,89,5,2688,465
2020-05-15,France,NA,Occitanie,5899209,78,2,2766,467
2020-05-16,France,NA,Occitanie,5899209,10,2,2776,469
2020-05-17,France,NA,Occitanie,5899209,6,1,2782,470
2020-05-18,France,NA,Occitanie,5899209,85,2,2867,472
2020-05-19,France,NA,Occitanie,5899209,55,0,2922,472
2020-05-20,France,NA,Occitanie,5899209,51,6,2973,477
2020-05-21,France,NA,Occitanie,5899209,1,1,2974,478
2020-05-22,France,NA,Occitanie,5899209,24,3,2998,481
2020-05-23,France,NA,Occitanie,5899209,10,1,3008,482
2020-05-24,France,NA,Occitanie,5899209,7,1,3015,483
2020-05-25,France,NA,Occitanie,5899209,22,3,3037,486
2020-05-26,France,NA,Occitanie,5899209,18,2,3055,488
2020-05-27,France,NA,Occitanie,5899209,32,0,3087,488
2020-05-28,France,NA,Occitanie,5899209,13,3,3100,491
2020-05-29,France,NA,Occitanie,5899209,27,1,3127,492
2020-05-30,France,NA,Occitanie,5899209,11,0,3138,492
2020-05-31,France,NA,Occitanie,5899209,1,3,3139,495
2020-06-01,France,NA,Occitanie,5899209,2,1,3141,496
2020-06-02,France,NA,Occitanie,5899209,19,1,3160,497
2020-06-03,France,NA,Occitanie,5899209,16,2,3176,499
2020-06-04,France,NA,Occitanie,5899209,34,0,3210,499
2020-06-05,France,NA,Occitanie,5899209,18,2,3228,501
2020-06-06,France,NA,Occitanie,5899209,8,1,3236,502
2020-06-07,France,NA,Occitanie,5899209,1,0,3237,502
2020-06-08,France,NA,Occitanie,5899209,16,0,3253,502
2020-06-09,France,NA,Occitanie,5899209,43,1,3296,503
2020-06-10,France,NA,Occitanie,5899209,45,0,3341,503
2020-06-11,France,NA,Occitanie,5899209,48,1,3389,504
2020-06-12,France,NA,Occitanie,5899209,45,2,3434,506
2020-06-13,France,NA,Occitanie,5899209,4,0,3438,506
2020-06-14,France,NA,Occitanie,5899209,1,0,3439,506
2020-06-15,France,NA,Occitanie,5899209,14,2,3453,508
2020-06-16,France,NA,Occitanie,5899209,13,0,3466,508
2020-06-17,France,NA,Occitanie,5899209,15,0,3481,508
2020-06-18,France,NA,Occitanie,5899209,21,0,3502,508
2020-06-19,France,NA,Occitanie,5899209,37,0,3539,508
2020-06-20,France,NA,Occitanie,5899209,1,0,3540,508
2020-06-21,France,NA,Occitanie,5899209,3,0,3543,508
2020-06-22,France,NA,Occitanie,5899209,26,0,3569,508
2020-06-23,France,NA,Occitanie,5899209,21,0,3590,508
2020-06-24,France,NA,Occitanie,5899209,24,2,3614,510
2020-06-25,France,NA,Occitanie,5899209,12,1,3626,511
2020-06-26,France,NA,Occitanie,5899209,34,0,3660,511
2020-06-27,France,NA,Occitanie,5899209,5,0,3665,511
2020-06-28,France,NA,Occitanie,5899209,5,0,3670,511
2020-06-29,France,NA,Occitanie,5899209,27,0,3697,511
2020-06-30,France,NA,Occitanie,5899209,27,510,3724,512
2020-07-01,France,NA,Occitanie,5899209,25,0,3749,512
2020-07-02,France,NA,Occitanie,5899209,20,0,3769,512
2020-07-03,France,NA,Occitanie,5899209,21,0,3790,512
2020-07-04,France,NA,Occitanie,5899209,5,0,3795,512
2020-07-05,France,NA,Occitanie,5899209,3,0,3798,512
2020-07-06,France,NA,Occitanie,5899209,13,0,3811,512
2020-07-07,France,NA,Occitanie,5899209,15,0,3826,512
2020-07-08,France,NA,Occitanie,5899209,25,0,3851,512
2020-07-09,France,NA,Occitanie,5899209,32,0,3883,512
2020-07-10,France,NA,Occitanie,5899209,24,1,3907,513
2020-07-11,France,NA,Occitanie,5899209,7,0,3914,513
2020-07-12,France,NA,Occitanie,5899209,3,0,3917,513
2020-07-13,France,NA,Occitanie,5899209,22,0,3939,513
2020-07-14,France,NA,Occitanie,5899209,3,0,3942,513
2020-07-15,France,NA,Occitanie,5899209,23,0,3965,513
2020-07-16,France,NA,Occitanie,5899209,40,0,4005,513
2020-07-17,France,NA,Occitanie,5899209,38,0,4043,513
2020-07-18,France,NA,Occitanie,5899209,18,0,4061,513
2020-07-19,France,NA,Occitanie,5899209,2,0,4063,513
2020-07-20,France,NA,Occitanie,5899209,58,0,4121,513
2020-07-21,France,NA,Occitanie,5899209,63,0,4184,513
2020-07-22,France,NA,Occitanie,5899209,61,0,4245,513
2020-07-23,France,NA,Occitanie,5899209,84,0,4329,513
2020-07-24,France,NA,Occitanie,5899209,77,0,4406,513
2020-07-25,France,NA,Occitanie,5899209,38,0,4444,513
2020-07-26,France,NA,Occitanie,5899209,5,0,4449,513
2020-07-27,France,NA,Occitanie,5899209,68,0,4517,513
2020-07-28,France,NA,Occitanie,5899209,83,0,4600,513
2020-07-29,France,NA,Occitanie,5899209,101,1,4701,514
2020-07-30,France,NA,Occitanie,5899209,107,0,4808,514
2020-07-31,France,NA,Occitanie,5899209,117,0,4925,514
2020-08-01,France,NA,Occitanie,5899209,39,0,4964,514
2020-08-02,France,NA,Occitanie,5899209,16,0,4980,514
2020-08-03,France,NA,Occitanie,5899209,138,1,5118,515
2020-08-04,France,NA,Occitanie,5899209,134,0,5252,515
2020-08-05,France,NA,Occitanie,5899209,139,0,5391,515
2020-08-06,France,NA,Occitanie,5899209,180,0,5571,515
2020-08-07,France,NA,Occitanie,5899209,162,0,5733,515
2020-08-08,France,NA,Occitanie,5899209,71,0,5804,515
2020-08-09,France,NA,Occitanie,5899209,34,0,5838,515
2020-08-10,France,NA,Occitanie,5899209,190,0,6028,515
2020-08-11,France,NA,Occitanie,5899209,232,1,6260,516
2020-08-12,France,NA,Occitanie,5899209,303,0,6563,516
2020-08-13,France,NA,Occitanie,5899209,327,0,6890,516
2020-08-14,France,NA,Occitanie,5899209,342,0,7232,516
2020-08-15,France,NA,Occitanie,5899209,70,0,7302,516
2020-08-16,France,NA,Occitanie,5899209,41,0,7343,516
2020-08-17,France,NA,Occitanie,5899209,495,2,7838,518
2020-08-18,France,NA,Occitanie,5899209,521,0,8359,518
2020-08-19,France,NA,Occitanie,5899209,447,1,8806,519
2020-08-20,France,NA,Occitanie,5899209,509,1,9315,520
2020-08-21,France,NA,Occitanie,5899209,432,0,9747,520
2020-08-22,France,NA,Occitanie,5899209,195,0,9942,520
2020-08-23,France,NA,Occitanie,5899209,101,0,10043,520
2020-08-24,France,NA,Occitanie,5899209,569,1,10612,521
2020-08-25,France,NA,Occitanie,5899209,591,0,11203,521
2020-08-26,France,NA,Occitanie,5899209,531,0,11734,521
2020-08-27,France,NA,Occitanie,5899209,509,2,12243,523
2020-08-28,France,NA,Occitanie,5899209,605,1,12848,524
2020-08-29,France,NA,Occitanie,5899209,224,1,13072,525
2020-08-30,France,NA,Occitanie,5899209,125,0,13197,525
2020-08-31,France,NA,Occitanie,5899209,658,4,13855,529
2020-09-01,France,NA,Occitanie,5899209,700,1,14555,530
2020-09-02,France,NA,Occitanie,5899209,698,0,15253,530
2020-09-03,France,NA,Occitanie,5899209,903,0,16156,530
2020-09-04,France,NA,Occitanie,5899209,820,3,16976,533
2020-09-05,France,NA,Occitanie,5899209,298,1,17274,534
2020-09-06,France,NA,Occitanie,5899209,145,0,17419,534
2020-09-07,France,NA,Occitanie,5899209,1034,1,18453,535
2020-09-08,France,NA,Occitanie,5899209,1013,1,19466,536
2020-09-09,France,NA,Occitanie,5899209,1020,1,20486,537
2020-09-10,France,NA,Occitanie,5899209,1092,1,21578,538
2020-09-11,France,NA,Occitanie,5899209,950,5,22528,543
2020-09-12,France,NA,Occitanie,5899209,339,1,22867,544
2020-09-13,France,NA,Occitanie,5899209,134,0,23001,544
2020-09-14,France,NA,Occitanie,5899209,1359,2,24360,546
2020-09-15,France,NA,Occitanie,5899209,1287,4,25647,550
2020-09-16,France,NA,Occitanie,5899209,1272,2,26919,552
2020-09-17,France,NA,Occitanie,5899209,1351,4,28270,556
2020-09-18,France,NA,Occitanie,5899209,1246,2,29516,558
2020-09-19,France,NA,Occitanie,5899209,425,3,29941,561
2020-09-20,France,NA,Occitanie,5899209,136,0,30077,561
2020-09-21,France,NA,Occitanie,5899209,1255,6,31332,567
2020-03-22,France,NA,Pays de la Loire,3787400,1,1,11,2
2020-03-23,France,NA,Pays de la Loire,3787400,4,5,15,3
2020-03-24,France,NA,Pays de la Loire,3787400,1,4,16,3
2020-03-25,France,NA,Pays de la Loire,3787400,4,3,20,4
2020-03-26,France,NA,Pays de la Loire,3787400,9,8,29,5
2020-03-27,France,NA,Pays de la Loire,3787400,2,7,31,6
2020-03-28,France,NA,Pays de la Loire,3787400,2,11,33,6
2020-03-29,France,NA,Pays de la Loire,3787400,0,5,33,6
2020-03-30,France,NA,Pays de la Loire,3787400,6,11,39,7
2020-03-31,France,NA,Pays de la Loire,3787400,5,13,44,8
2020-04-01,France,NA,Pays de la Loire,3787400,6,11,50,10
2020-04-02,France,NA,Pays de la Loire,3787400,2,10,52,10
2020-04-03,France,NA,Pays de la Loire,3787400,2,17,54,10
2020-04-04,France,NA,Pays de la Loire,3787400,0,9,54,10
2020-04-05,France,NA,Pays de la Loire,3787400,0,5,54,10
2020-04-06,France,NA,Pays de la Loire,3787400,3,11,57,11
2020-04-07,France,NA,Pays de la Loire,3787400,0,10,57,11
2020-04-08,France,NA,Pays de la Loire,3787400,1,9,58,11
2020-04-09,France,NA,Pays de la Loire,3787400,0,5,58,11
2020-04-10,France,NA,Pays de la Loire,3787400,1,11,59,11
2020-04-11,France,NA,Pays de la Loire,3787400,0,9,59,11
2020-04-12,France,NA,Pays de la Loire,3787400,0,4,59,11
2020-04-13,France,NA,Pays de la Loire,3787400,0,10,59,11
2020-04-14,France,NA,Pays de la Loire,3787400,1,17,60,12
2020-04-15,France,NA,Pays de la Loire,3787400,1,13,61,12
2020-04-16,France,NA,Pays de la Loire,3787400,1,13,62,12
2020-04-17,France,NA,Pays de la Loire,3787400,1,7,63,12
2020-04-18,France,NA,Pays de la Loire,3787400,0,9,63,12
2020-04-19,France,NA,Pays de la Loire,3787400,0,7,63,12
2020-04-20,France,NA,Pays de la Loire,3787400,1,10,64,12
2020-04-21,France,NA,Pays de la Loire,3787400,2,8,66,13
2020-04-22,France,NA,Pays de la Loire,3787400,3,9,69,13
2020-04-23,France,NA,Pays de la Loire,3787400,0,6,69,13
2020-04-24,France,NA,Pays de la Loire,3787400,0,12,69,13
2020-04-25,France,NA,Pays de la Loire,3787400,0,4,69,13
2020-04-26,France,NA,Pays de la Loire,3787400,0,7,69,13
2020-04-27,France,NA,Pays de la Loire,3787400,2,9,71,14
2020-04-28,France,NA,Pays de la Loire,3787400,1,3,72,14
2020-04-29,France,NA,Pays de la Loire,3787400,0,10,72,14
2020-04-30,France,NA,Pays de la Loire,3787400,1,5,73,14
2020-05-01,France,NA,Pays de la Loire,3787400,0,2,73,14
2020-05-02,France,NA,Pays de la Loire,3787400,0,5,73,14
2020-05-03,France,NA,Pays de la Loire,3787400,0,3,73,14
2020-05-04,France,NA,Pays de la Loire,3787400,0,6,73,14
2020-05-05,France,NA,Pays de la Loire,3787400,1,5,74,14
2020-05-06,France,NA,Pays de la Loire,3787400,2,6,76,15
2020-05-07,France,NA,Pays de la Loire,3787400,0,4,76,15
2020-05-08,France,NA,Pays de la Loire,3787400,0,5,76,15
2020-05-09,France,NA,Pays de la Loire,3787400,0,5,76,15
2020-05-10,France,NA,Pays de la Loire,3787400,0,1,76,15
2020-05-11,France,NA,Pays de la Loire,3787400,0,2,76,15
2020-05-12,France,NA,Pays de la Loire,3787400,0,3,76,15
2020-05-13,France,NA,Pays de la Loire,3787400,22,0,98,19
2020-05-14,France,NA,Pays de la Loire,3787400,25,7,123,24
2020-05-15,France,NA,Pays de la Loire,3787400,37,6,160,32
2020-05-16,France,NA,Pays de la Loire,3787400,17,6,177,35
2020-05-17,France,NA,Pays de la Loire,3787400,5,0,182,36
2020-05-18,France,NA,Pays de la Loire,3787400,49,7,231,46
2020-05-19,France,NA,Pays de la Loire,3787400,42,1,273,54
2020-05-20,France,NA,Pays de la Loire,3787400,64,2,337,67
2020-05-21,France,NA,Pays de la Loire,3787400,18,3,355,71
2020-05-22,France,NA,Pays de la Loire,3787400,39,2,394,78
2020-05-23,France,NA,Pays de la Loire,3787400,9,3,403,80
2020-05-24,France,NA,Pays de la Loire,3787400,8,2,411,82
2020-05-25,France,NA,Pays de la Loire,3787400,24,2,435,87
2020-05-26,France,NA,Pays de la Loire,3787400,36,1,471,94
2020-05-27,France,NA,Pays de la Loire,3787400,56,4,527,105
2020-05-28,France,NA,Pays de la Loire,3787400,41,0,568,113
2020-05-29,France,NA,Pays de la Loire,3787400,41,3,609,121
2020-05-30,France,NA,Pays de la Loire,3787400,23,0,632,126
2020-05-31,France,NA,Pays de la Loire,3787400,18,2,650,130
2020-06-01,France,NA,Pays de la Loire,3787400,7,0,657,131
2020-06-02,France,NA,Pays de la Loire,3787400,49,2,706,141
2020-06-03,France,NA,Pays de la Loire,3787400,22,2,728,145
2020-06-04,France,NA,Pays de la Loire,3787400,19,2,747,149
2020-06-05,France,NA,Pays de la Loire,3787400,44,5,791,158
2020-06-06,France,NA,Pays de la Loire,3787400,12,0,803,160
2020-06-07,France,NA,Pays de la Loire,3787400,6,2,809,161
2020-06-08,France,NA,Pays de la Loire,3787400,29,2,838,167
2020-06-09,France,NA,Pays de la Loire,3787400,25,1,863,172
2020-06-10,France,NA,Pays de la Loire,3787400,27,1,890,178
2020-06-11,France,NA,Pays de la Loire,3787400,14,3,904,180
2020-06-12,France,NA,Pays de la Loire,3787400,24,1,928,185
2020-06-13,France,NA,Pays de la Loire,3787400,9,0,937,187
2020-06-14,France,NA,Pays de la Loire,3787400,1,1,938,187
2020-06-15,France,NA,Pays de la Loire,3787400,18,0,956,191
2020-06-16,France,NA,Pays de la Loire,3787400,23,0,979,195
2020-06-17,France,NA,Pays de la Loire,3787400,13,1,992,198
2020-06-18,France,NA,Pays de la Loire,3787400,17,2,1009,201
2020-06-19,France,NA,Pays de la Loire,3787400,21,0,1030,206
2020-06-20,France,NA,Pays de la Loire,3787400,15,0,1045,209
2020-06-21,France,NA,Pays de la Loire,3787400,1,1,1046,209
2020-06-22,France,NA,Pays de la Loire,3787400,15,0,1061,212
2020-06-23,France,NA,Pays de la Loire,3787400,15,0,1076,215
2020-06-24,France,NA,Pays de la Loire,3787400,16,2,1092,218
2020-06-25,France,NA,Pays de la Loire,3787400,11,0,1103,220
2020-06-26,France,NA,Pays de la Loire,3787400,16,0,1119,223
2020-06-27,France,NA,Pays de la Loire,3787400,13,0,1132,226
2020-06-28,France,NA,Pays de la Loire,3787400,3,0,1135,227
2020-06-29,France,NA,Pays de la Loire,3787400,48,0,1183,236
2020-06-30,France,NA,Pays de la Loire,3787400,48,0,1231,246
2020-07-01,France,NA,Pays de la Loire,3787400,34,1,1265,253
2020-07-02,France,NA,Pays de la Loire,3787400,28,1,1293,258
2020-07-03,France,NA,Pays de la Loire,3787400,30,0,1323,264
2020-07-04,France,NA,Pays de la Loire,3787400,20,0,1343,268
2020-07-05,France,NA,Pays de la Loire,3787400,5,0,1348,269
2020-07-06,France,NA,Pays de la Loire,3787400,25,0,1373,274
2020-07-07,France,NA,Pays de la Loire,3787400,25,1,1398,279
2020-07-08,France,NA,Pays de la Loire,3787400,44,0,1442,288
2020-07-09,France,NA,Pays de la Loire,3787400,35,0,1477,295
2020-07-10,France,NA,Pays de la Loire,3787400,76,0,1553,310
2020-07-11,France,NA,Pays de la Loire,3787400,52,0,1605,321
2020-07-12,France,NA,Pays de la Loire,3787400,16,0,1621,324
2020-07-13,France,NA,Pays de la Loire,3787400,84,0,1705,341
2020-07-14,France,NA,Pays de la Loire,3787400,14,0,1719,343
2020-07-15,France,NA,Pays de la Loire,3787400,62,0,1781,356
2020-07-16,France,NA,Pays de la Loire,3787400,61,0,1842,368
2020-07-17,France,NA,Pays de la Loire,3787400,107,0,1949,389
2020-07-18,France,NA,Pays de la Loire,3787400,63,1,2012,402
2020-07-19,France,NA,Pays de la Loire,3787400,24,0,2036,407
2020-07-20,France,NA,Pays de la Loire,3787400,125,0,2161,432
2020-07-21,France,NA,Pays de la Loire,3787400,127,3,2288,457
2020-07-22,France,NA,Pays de la Loire,3787400,113,1,2401,475
2020-07-23,France,NA,Pays de la Loire,3787400,142,0,2543,475
2020-07-24,France,NA,Pays de la Loire,3787400,126,0,2669,475
2020-07-25,France,NA,Pays de la Loire,3787400,49,0,2718,475
2020-07-26,France,NA,Pays de la Loire,3787400,11,0,2729,475
2020-07-27,France,NA,Pays de la Loire,3787400,79,0,2808,475
2020-07-28,France,NA,Pays de la Loire,3787400,89,0,2897,475
2020-07-29,France,NA,Pays de la Loire,3787400,76,0,2973,475
2020-07-30,France,NA,Pays de la Loire,3787400,73,1,3046,476
2020-07-31,France,NA,Pays de la Loire,3787400,100,0,3146,476
2020-08-01,France,NA,Pays de la Loire,3787400,50,0,3196,476
2020-08-02,France,NA,Pays de la Loire,3787400,12,0,3208,476
2020-08-03,France,NA,Pays de la Loire,3787400,83,1,3291,477
2020-08-04,France,NA,Pays de la Loire,3787400,100,0,3391,477
2020-08-05,France,NA,Pays de la Loire,3787400,100,1,3491,478
2020-08-06,France,NA,Pays de la Loire,3787400,101,0,3592,478
2020-08-07,France,NA,Pays de la Loire,3787400,111,0,3703,478
2020-08-08,France,NA,Pays de la Loire,3787400,40,0,3743,478
2020-08-09,France,NA,Pays de la Loire,3787400,16,0,3759,478
2020-08-10,France,NA,Pays de la Loire,3787400,109,2,3868,480
2020-08-11,France,NA,Pays de la Loire,3787400,94,0,3962,480
2020-08-12,France,NA,Pays de la Loire,3787400,104,1,4066,481
2020-08-13,France,NA,Pays de la Loire,3787400,153,2,4219,483
2020-08-14,France,NA,Pays de la Loire,3787400,222,0,4441,483
2020-08-15,France,NA,Pays de la Loire,3787400,59,0,4500,483
2020-08-16,France,NA,Pays de la Loire,3787400,63,0,4563,483
2020-08-17,France,NA,Pays de la Loire,3787400,179,2,4742,485
2020-08-18,France,NA,Pays de la Loire,3787400,185,0,4927,485
2020-08-19,France,NA,Pays de la Loire,3787400,226,2,5153,487
2020-08-20,France,NA,Pays de la Loire,3787400,191,0,5344,487
2020-08-21,France,NA,Pays de la Loire,3787400,164,0,5508,487
2020-08-22,France,NA,Pays de la Loire,3787400,57,1,5565,488
2020-08-23,France,NA,Pays de la Loire,3787400,27,0,5592,488
2020-08-24,France,NA,Pays de la Loire,3787400,178,1,5770,489
2020-08-25,France,NA,Pays de la Loire,3787400,177,0,5947,489
2020-08-26,France,NA,Pays de la Loire,3787400,156,1,6103,490
2020-08-27,France,NA,Pays de la Loire,3787400,177,0,6280,490
2020-08-28,France,NA,Pays de la Loire,3787400,231,2,6511,492
2020-08-29,France,NA,Pays de la Loire,3787400,89,0,6600,492
2020-08-30,France,NA,Pays de la Loire,3787400,26,0,6626,492
2020-08-31,France,NA,Pays de la Loire,3787400,257,0,6883,492
2020-09-01,France,NA,Pays de la Loire,3787400,273,0,7156,492
2020-09-02,France,NA,Pays de la Loire,3787400,289,1,7445,493
2020-09-03,France,NA,Pays de la Loire,3787400,329,1,7774,494
2020-09-04,France,NA,Pays de la Loire,3787400,377,1,8151,495
2020-09-05,France,NA,Pays de la Loire,3787400,169,1,8320,496
2020-09-06,France,NA,Pays de la Loire,3787400,20,0,8340,496
2020-09-07,France,NA,Pays de la Loire,3787400,404,3,8744,499
2020-09-08,France,NA,Pays de la Loire,3787400,347,0,9091,499
2020-09-09,France,NA,Pays de la Loire,3787400,378,0,9469,499
2020-09-10,France,NA,Pays de la Loire,3787400,334,0,9803,499
2020-09-11,France,NA,Pays de la Loire,3787400,338,2,10141,501
2020-09-12,France,NA,Pays de la Loire,3787400,172,0,10313,501
2020-09-13,France,NA,Pays de la Loire,3787400,30,0,10343,501
2020-09-14,France,NA,Pays de la Loire,3787400,360,0,10703,501
2020-09-15,France,NA,Pays de la Loire,3787400,388,1,11091,502
2020-09-16,France,NA,Pays de la Loire,3787400,434,1,11525,503
2020-09-17,France,NA,Pays de la Loire,3787400,385,2,11910,505
2020-09-18,France,NA,Pays de la Loire,3787400,395,1,12305,506
2020-09-19,France,NA,Pays de la Loire,3787400,138,0,12443,506
2020-09-20,France,NA,Pays de la Loire,3787400,35,0,12478,506
2020-09-21,France,NA,Pays de la Loire,3787400,473,1,12951,507
2020-03-17,France,NA,Provence-Alpes-Cote d'Azur,5048405,7,0,16,0
2020-03-18,France,NA,Provence-Alpes-Cote d'Azur,5048405,25,0,41,7
2020-03-19,France,NA,Provence-Alpes-Cote d'Azur,5048405,35,2,76,9
2020-03-20,France,NA,Provence-Alpes-Cote d'Azur,5048405,46,2,122,11
2020-03-21,France,NA,Provence-Alpes-Cote d'Azur,5048405,11,2,133,13
2020-03-22,France,NA,Provence-Alpes-Cote d'Azur,5048405,4,1,137,14
2020-03-23,France,NA,Provence-Alpes-Cote d'Azur,5048405,165,6,302,20
2020-03-24,France,NA,Provence-Alpes-Cote d'Azur,5048405,217,6,519,26
2020-03-25,France,NA,Provence-Alpes-Cote d'Azur,5048405,197,7,716,33
2020-03-26,France,NA,Provence-Alpes-Cote d'Azur,5048405,219,11,935,44
2020-03-27,France,NA,Provence-Alpes-Cote d'Azur,5048405,239,4,1174,48
2020-03-28,France,NA,Provence-Alpes-Cote d'Azur,5048405,26,7,1200,55
2020-03-29,France,NA,Provence-Alpes-Cote d'Azur,5048405,5,10,1205,65
2020-03-30,France,NA,Provence-Alpes-Cote d'Azur,5048405,289,15,1494,80
2020-03-31,France,NA,Provence-Alpes-Cote d'Azur,5048405,195,23,1689,103
2020-04-01,France,NA,Provence-Alpes-Cote d'Azur,5048405,156,21,1845,124
2020-04-02,France,NA,Provence-Alpes-Cote d'Azur,5048405,148,17,1993,141
2020-04-03,France,NA,Provence-Alpes-Cote d'Azur,5048405,119,20,2112,161
2020-04-04,France,NA,Provence-Alpes-Cote d'Azur,5048405,20,17,2132,178
2020-04-05,France,NA,Provence-Alpes-Cote d'Azur,5048405,4,17,2136,195
2020-04-06,France,NA,Provence-Alpes-Cote d'Azur,5048405,196,36,2332,231
2020-04-07,France,NA,Provence-Alpes-Cote d'Azur,5048405,141,22,2473,253
2020-04-08,France,NA,Provence-Alpes-Cote d'Azur,5048405,210,16,2683,269
2020-04-09,France,NA,Provence-Alpes-Cote d'Azur,5048405,148,17,2831,286
2020-04-10,France,NA,Provence-Alpes-Cote d'Azur,5048405,208,13,3039,299
2020-04-11,France,NA,Provence-Alpes-Cote d'Azur,5048405,24,18,3063,317
2020-04-12,France,NA,Provence-Alpes-Cote d'Azur,5048405,2,11,3065,328
2020-04-13,France,NA,Provence-Alpes-Cote d'Azur,5048405,10,20,3075,348
2020-04-14,France,NA,Provence-Alpes-Cote d'Azur,5048405,154,26,3229,374
2020-04-15,France,NA,Provence-Alpes-Cote d'Azur,5048405,132,19,3361,393
2020-04-16,France,NA,Provence-Alpes-Cote d'Azur,5048405,94,28,3455,421
2020-04-17,France,NA,Provence-Alpes-Cote d'Azur,5048405,81,26,3536,447
2020-04-18,France,NA,Provence-Alpes-Cote d'Azur,5048405,14,16,3550,463
2020-04-19,France,NA,Provence-Alpes-Cote d'Azur,5048405,0,7,3550,470
2020-04-20,France,NA,Provence-Alpes-Cote d'Azur,5048405,63,29,3613,499
2020-04-21,France,NA,Provence-Alpes-Cote d'Azur,5048405,46,27,3659,526
2020-04-22,France,NA,Provence-Alpes-Cote d'Azur,5048405,55,35,3714,561
2020-04-23,France,NA,Provence-Alpes-Cote d'Azur,5048405,44,14,3758,575
2020-04-24,France,NA,Provence-Alpes-Cote d'Azur,5048405,31,35,3789,610
2020-04-25,France,NA,Provence-Alpes-Cote d'Azur,5048405,7,15,3796,625
2020-04-26,France,NA,Provence-Alpes-Cote d'Azur,5048405,0,6,3796,631
2020-04-27,France,NA,Provence-Alpes-Cote d'Azur,5048405,39,25,3835,656
2020-04-28,France,NA,Provence-Alpes-Cote d'Azur,5048405,25,9,3860,665
2020-04-29,France,NA,Provence-Alpes-Cote d'Azur,5048405,35,17,3895,682
2020-04-30,France,NA,Provence-Alpes-Cote d'Azur,5048405,25,14,3920,696
2020-05-01,France,NA,Provence-Alpes-Cote d'Azur,5048405,0,8,3920,704
2020-05-02,France,NA,Provence-Alpes-Cote d'Azur,5048405,5,4,3925,708
2020-05-03,France,NA,Provence-Alpes-Cote d'Azur,5048405,0,5,3925,713
2020-05-04,France,NA,Provence-Alpes-Cote d'Azur,5048405,24,19,3949,732
2020-05-05,France,NA,Provence-Alpes-Cote d'Azur,5048405,64,14,4013,746
2020-05-06,France,NA,Provence-Alpes-Cote d'Azur,5048405,31,10,4044,756
2020-05-07,France,NA,Provence-Alpes-Cote d'Azur,5048405,16,8,4060,764
2020-05-08,France,NA,Provence-Alpes-Cote d'Azur,5048405,3,6,4063,770
2020-05-09,France,NA,Provence-Alpes-Cote d'Azur,5048405,1,3,4064,773
2020-05-10,France,NA,Provence-Alpes-Cote d'Azur,5048405,0,4,4064,777
2020-05-11,France,NA,Provence-Alpes-Cote d'Azur,5048405,20,20,4084,797
2020-05-12,France,NA,Provence-Alpes-Cote d'Azur,5048405,18,8,4102,805
2020-05-13,France,NA,Provence-Alpes-Cote d'Azur,5048405,86,11,4188,816
2020-05-14,France,NA,Provence-Alpes-Cote d'Azur,5048405,93,8,4281,824
2020-05-15,France,NA,Provence-Alpes-Cote d'Azur,5048405,74,7,4355,831
2020-05-16,France,NA,Provence-Alpes-Cote d'Azur,5048405,15,5,4370,836
2020-05-17,France,NA,Provence-Alpes-Cote d'Azur,5048405,6,4,4376,840
2020-05-18,France,NA,Provence-Alpes-Cote d'Azur,5048405,119,9,4495,849
2020-05-19,France,NA,Provence-Alpes-Cote d'Azur,5048405,59,6,4554,855
2020-05-20,France,NA,Provence-Alpes-Cote d'Azur,5048405,61,7,4615,862
2020-05-21,France,NA,Provence-Alpes-Cote d'Azur,5048405,9,7,4624,869
2020-05-22,France,NA,Provence-Alpes-Cote d'Azur,5048405,42,5,4666,874
2020-05-23,France,NA,Provence-Alpes-Cote d'Azur,5048405,12,2,4678,876
2020-05-24,France,NA,Provence-Alpes-Cote d'Azur,5048405,4,2,4682,878
2020-05-25,France,NA,Provence-Alpes-Cote d'Azur,5048405,41,6,4723,884
2020-05-26,France,NA,Provence-Alpes-Cote d'Azur,5048405,42,5,4765,889
2020-05-27,France,NA,Provence-Alpes-Cote d'Azur,5048405,40,1,4805,890
2020-05-28,France,NA,Provence-Alpes-Cote d'Azur,5048405,48,3,4853,893
2020-05-29,France,NA,Provence-Alpes-Cote d'Azur,5048405,18,5,4871,898
2020-05-30,France,NA,Provence-Alpes-Cote d'Azur,5048405,11,0,4882,898
2020-05-31,France,NA,Provence-Alpes-Cote d'Azur,5048405,21,0,4903,898
2020-06-01,France,NA,Provence-Alpes-Cote d'Azur,5048405,8,0,4911,898
2020-06-02,France,NA,Provence-Alpes-Cote d'Azur,5048405,50,10,4961,908
2020-06-03,France,NA,Provence-Alpes-Cote d'Azur,5048405,61,3,5022,911
2020-06-04,France,NA,Provence-Alpes-Cote d'Azur,5048405,90,1,5112,912
2020-06-05,France,NA,Provence-Alpes-Cote d'Azur,5048405,47,1,5159,913
2020-06-06,France,NA,Provence-Alpes-Cote d'Azur,5048405,21,0,5180,913
2020-06-07,France,NA,Provence-Alpes-Cote d'Azur,5048405,6,0,5186,913
2020-06-08,France,NA,Provence-Alpes-Cote d'Azur,5048405,40,4,5226,917
2020-06-09,France,NA,Provence-Alpes-Cote d'Azur,5048405,39,2,5265,919
2020-06-10,France,NA,Provence-Alpes-Cote d'Azur,5048405,38,1,5303,920
2020-06-11,France,NA,Provence-Alpes-Cote d'Azur,5048405,61,2,5364,922
2020-06-12,France,NA,Provence-Alpes-Cote d'Azur,5048405,39,1,5403,923
2020-06-13,France,NA,Provence-Alpes-Cote d'Azur,5048405,9,0,5412,923
2020-06-14,France,NA,Provence-Alpes-Cote d'Azur,5048405,4,0,5416,923
2020-06-15,France,NA,Provence-Alpes-Cote d'Azur,5048405,38,2,5454,925
2020-06-16,France,NA,Provence-Alpes-Cote d'Azur,5048405,31,2,5485,927
2020-06-17,France,NA,Provence-Alpes-Cote d'Azur,5048405,24,0,5509,927
2020-06-18,France,NA,Provence-Alpes-Cote d'Azur,5048405,23,2,5532,929
2020-06-19,France,NA,Provence-Alpes-Cote d'Azur,5048405,20,4,5552,933
2020-06-20,France,NA,Provence-Alpes-Cote d'Azur,5048405,3,2,5555,935
2020-06-21,France,NA,Provence-Alpes-Cote d'Azur,5048405,5,0,5560,935
2020-06-22,France,NA,Provence-Alpes-Cote d'Azur,5048405,10,1,5570,936
2020-06-23,France,NA,Provence-Alpes-Cote d'Azur,5048405,16,4,5586,940
2020-06-24,France,NA,Provence-Alpes-Cote d'Azur,5048405,19,1,5605,941
2020-06-25,France,NA,Provence-Alpes-Cote d'Azur,5048405,11,1,5616,942
2020-06-26,France,NA,Provence-Alpes-Cote d'Azur,5048405,19,1,5635,943
2020-06-27,France,NA,Provence-Alpes-Cote d'Azur,5048405,8,0,5643,943
2020-06-28,France,NA,Provence-Alpes-Cote d'Azur,5048405,1,0,5644,943
2020-06-29,France,NA,Provence-Alpes-Cote d'Azur,5048405,39,0,5683,943
2020-06-30,France,NA,Provence-Alpes-Cote d'Azur,5048405,19,730,5702,949
2020-07-01,France,NA,Provence-Alpes-Cote d'Azur,5048405,16,0,5718,949
2020-07-02,France,NA,Provence-Alpes-Cote d'Azur,5048405,22,0,5740,949
2020-07-03,France,NA,Provence-Alpes-Cote d'Azur,5048405,36,3,5776,952
2020-07-04,France,NA,Provence-Alpes-Cote d'Azur,5048405,12,0,5788,952
2020-07-05,France,NA,Provence-Alpes-Cote d'Azur,5048405,1,0,5789,952
2020-07-06,France,NA,Provence-Alpes-Cote d'Azur,5048405,34,0,5823,952
2020-07-07,France,NA,Provence-Alpes-Cote d'Azur,5048405,30,0,5853,952
2020-07-08,France,NA,Provence-Alpes-Cote d'Azur,5048405,52,0,5905,952
2020-07-09,France,NA,Provence-Alpes-Cote d'Azur,5048405,74,0,5979,952
2020-07-10,France,NA,Provence-Alpes-Cote d'Azur,5048405,36,0,6015,952
2020-07-11,France,NA,Provence-Alpes-Cote d'Azur,5048405,18,0,6033,952
2020-07-12,France,NA,Provence-Alpes-Cote d'Azur,5048405,3,1,6036,953
2020-07-13,France,NA,Provence-Alpes-Cote d'Azur,5048405,60,1,6096,954
2020-07-14,France,NA,Provence-Alpes-Cote d'Azur,5048405,6,0,6102,954
2020-07-15,France,NA,Provence-Alpes-Cote d'Azur,5048405,54,0,6156,954
2020-07-16,France,NA,Provence-Alpes-Cote d'Azur,5048405,35,1,6191,955
2020-07-17,France,NA,Provence-Alpes-Cote d'Azur,5048405,43,2,6234,957
2020-07-18,France,NA,Provence-Alpes-Cote d'Azur,5048405,26,0,6260,957
2020-07-19,France,NA,Provence-Alpes-Cote d'Azur,5048405,9,0,6269,957
2020-07-20,France,NA,Provence-Alpes-Cote d'Azur,5048405,64,1,6333,958
2020-07-21,France,NA,Provence-Alpes-Cote d'Azur,5048405,79,1,6412,959
2020-07-22,France,NA,Provence-Alpes-Cote d'Azur,5048405,73,0,6485,959
2020-07-23,France,NA,Provence-Alpes-Cote d'Azur,5048405,62,0,6547,959
2020-07-24,France,NA,Provence-Alpes-Cote d'Azur,5048405,105,2,6652,961
2020-07-25,France,NA,Provence-Alpes-Cote d'Azur,5048405,34,0,6686,961
2020-07-26,France,NA,Provence-Alpes-Cote d'Azur,5048405,15,0,6701,961
2020-07-27,France,NA,Provence-Alpes-Cote d'Azur,5048405,126,1,6827,962
2020-07-28,France,NA,Provence-Alpes-Cote d'Azur,5048405,108,1,6935,963
2020-07-29,France,NA,Provence-Alpes-Cote d'Azur,5048405,145,1,7080,964
2020-07-30,France,NA,Provence-Alpes-Cote d'Azur,5048405,186,1,7266,965
2020-07-31,France,NA,Provence-Alpes-Cote d'Azur,5048405,175,1,7441,966
2020-08-01,France,NA,Provence-Alpes-Cote d'Azur,5048405,104,0,7545,966
2020-08-02,France,NA,Provence-Alpes-Cote d'Azur,5048405,16,0,7561,966
2020-08-03,France,NA,Provence-Alpes-Cote d'Azur,5048405,297,0,7858,966
2020-08-04,France,NA,Provence-Alpes-Cote d'Azur,5048405,284,1,8142,967
2020-08-05,France,NA,Provence-Alpes-Cote d'Azur,5048405,299,0,8441,967
2020-08-06,France,NA,Provence-Alpes-Cote d'Azur,5048405,296,0,8737,967
2020-08-07,France,NA,Provence-Alpes-Cote d'Azur,5048405,354,0,9091,967
2020-08-08,France,NA,Provence-Alpes-Cote d'Azur,5048405,139,0,9230,967
2020-08-09,France,NA,Provence-Alpes-Cote d'Azur,5048405,24,0,9254,967
2020-08-10,France,NA,Provence-Alpes-Cote d'Azur,5048405,557,2,9811,969
2020-08-11,France,NA,Provence-Alpes-Cote d'Azur,5048405,441,1,10252,970
2020-08-12,France,NA,Provence-Alpes-Cote d'Azur,5048405,500,0,10752,970
2020-08-13,France,NA,Provence-Alpes-Cote d'Azur,5048405,600,1,11352,970
2020-08-14,France,NA,Provence-Alpes-Cote d'Azur,5048405,738,2,12090,972
2020-08-15,France,NA,Provence-Alpes-Cote d'Azur,5048405,84,0,12174,972
2020-08-16,France,NA,Provence-Alpes-Cote d'Azur,5048405,64,0,12238,972
2020-08-17,France,NA,Provence-Alpes-Cote d'Azur,5048405,1013,1,13251,972
2020-08-18,France,NA,Provence-Alpes-Cote d'Azur,5048405,786,3,14037,975
2020-08-19,France,NA,Provence-Alpes-Cote d'Azur,5048405,1058,2,15095,977
2020-08-20,France,NA,Provence-Alpes-Cote d'Azur,5048405,895,4,15990,981
2020-08-21,France,NA,Provence-Alpes-Cote d'Azur,5048405,964,2,16954,983
2020-08-22,France,NA,Provence-Alpes-Cote d'Azur,5048405,332,1,17286,984
2020-08-23,France,NA,Provence-Alpes-Cote d'Azur,5048405,95,0,17381,984
2020-08-24,France,NA,Provence-Alpes-Cote d'Azur,5048405,1380,1,18761,985
2020-08-25,France,NA,Provence-Alpes-Cote d'Azur,5048405,1207,1,19968,986
2020-08-26,France,NA,Provence-Alpes-Cote d'Azur,5048405,1032,2,21000,988
2020-08-27,France,NA,Provence-Alpes-Cote d'Azur,5048405,1181,0,22181,988
2020-08-28,France,NA,Provence-Alpes-Cote d'Azur,5048405,1209,0,23390,988
2020-08-29,France,NA,Provence-Alpes-Cote d'Azur,5048405,455,0,23845,988
2020-08-30,France,NA,Provence-Alpes-Cote d'Azur,5048405,105,1,23950,989
2020-08-31,France,NA,Provence-Alpes-Cote d'Azur,5048405,1561,4,25511,993
2020-09-01,France,NA,Provence-Alpes-Cote d'Azur,5048405,1256,2,26767,995
2020-09-02,France,NA,Provence-Alpes-Cote d'Azur,5048405,1241,0,28008,995
2020-09-03,France,NA,Provence-Alpes-Cote d'Azur,5048405,1318,4,29326,999
2020-09-04,France,NA,Provence-Alpes-Cote d'Azur,5048405,1426,4,30752,1003
2020-09-05,France,NA,Provence-Alpes-Cote d'Azur,5048405,431,2,31183,1005
2020-09-06,France,NA,Provence-Alpes-Cote d'Azur,5048405,144,0,31327,1005
2020-09-07,France,NA,Provence-Alpes-Cote d'Azur,5048405,1646,7,32973,1012
2020-09-08,France,NA,Provence-Alpes-Cote d'Azur,5048405,1394,5,34367,1017
2020-09-09,France,NA,Provence-Alpes-Cote d'Azur,5048405,1433,8,35800,1025
2020-09-10,France,NA,Provence-Alpes-Cote d'Azur,5048405,1331,4,37131,1029
2020-09-11,France,NA,Provence-Alpes-Cote d'Azur,5048405,1319,7,38450,1036
2020-09-12,France,NA,Provence-Alpes-Cote d'Azur,5048405,546,7,38996,1043
2020-09-13,France,NA,Provence-Alpes-Cote d'Azur,5048405,190,1,39186,1044
2020-09-14,France,NA,Provence-Alpes-Cote d'Azur,5048405,1566,8,40752,1052
2020-09-15,France,NA,Provence-Alpes-Cote d'Azur,5048405,1382,6,42134,1058
2020-09-16,France,NA,Provence-Alpes-Cote d'Azur,5048405,1287,1,43421,1059
2020-09-17,France,NA,Provence-Alpes-Cote d'Azur,5048405,1144,7,44565,1066
2020-09-18,France,NA,Provence-Alpes-Cote d'Azur,5048405,1151,8,45716,1074
2020-09-19,France,NA,Provence-Alpes-Cote d'Azur,5048405,385,1,46101,1075
2020-09-20,France,NA,Provence-Alpes-Cote d'Azur,5048405,100,0,46201,1075
2020-09-21,France,NA,Provence-Alpes-Cote d'Azur,5048405,1315,7,47516,1082
2020-04-08,India,NA,Andaman and Nicobar Islands,356152,1,0,11,0
2020-04-09,India,NA,Andaman and Nicobar Islands,356152,0,0,11,0
2020-04-10,India,NA,Andaman and Nicobar Islands,356152,0,0,11,0
2020-04-11,India,NA,Andaman and Nicobar Islands,356152,0,0,11,0
2020-04-12,India,NA,Andaman and Nicobar Islands,356152,0,0,11,0
2020-04-13,India,NA,Andaman and Nicobar Islands,356152,0,0,11,0
2020-04-14,India,NA,Andaman and Nicobar Islands,356152,0,0,11,0
2020-04-15,India,NA,Andaman and Nicobar Islands,356152,0,0,11,0
2020-04-16,India,NA,Andaman and Nicobar Islands,356152,0,0,11,0
2020-04-17,India,NA,Andaman and Nicobar Islands,356152,1,0,12,0
2020-04-18,India,NA,Andaman and Nicobar Islands,356152,2,0,14,0
2020-04-19,India,NA,Andaman and Nicobar Islands,356152,1,0,15,0
2020-04-20,India,NA,Andaman and Nicobar Islands,356152,1,0,16,0
2020-04-21,India,NA,Andaman and Nicobar Islands,356152,1,0,17,0
2020-04-22,India,NA,Andaman and Nicobar Islands,356152,1,0,18,0
2020-04-23,India,NA,Andaman and Nicobar Islands,356152,4,0,22,0
2020-04-24,India,NA,Andaman and Nicobar Islands,356152,7,0,29,0
2020-04-25,India,NA,Andaman and Nicobar Islands,356152,4,0,33,0
2020-04-26,India,NA,Andaman and Nicobar Islands,356152,0,0,33,0
2020-04-27,India,NA,Andaman and Nicobar Islands,356152,0,0,33,0
2020-04-28,India,NA,Andaman and Nicobar Islands,356152,0,0,33,0
2020-04-29,India,NA,Andaman and Nicobar Islands,356152,0,0,33,0
2020-04-30,India,NA,Andaman and Nicobar Islands,356152,0,0,33,0
2020-05-01,India,NA,Andaman and Nicobar Islands,356152,0,0,33,0
2020-05-02,India,NA,Andaman and Nicobar Islands,356152,0,0,33,0
2020-05-03,India,NA,Andaman and Nicobar Islands,356152,0,0,33,0
2020-05-04,India,NA,Andaman and Nicobar Islands,356152,0,0,33,0
2020-05-05,India,NA,Andaman and Nicobar Islands,356152,0,0,33,0
2020-05-06,India,NA,Andaman and Nicobar Islands,356152,0,0,33,0
2020-05-07,India,NA,Andaman and Nicobar Islands,356152,0,0,33,0
2020-05-08,India,NA,Andaman and Nicobar Islands,356152,0,0,33,0
2020-05-09,India,NA,Andaman and Nicobar Islands,356152,0,0,33,0
2020-05-10,India,NA,Andaman and Nicobar Islands,356152,0,0,33,0
2020-05-11,India,NA,Andaman and Nicobar Islands,356152,0,0,33,0
2020-05-12,India,NA,Andaman and Nicobar Islands,356152,0,0,33,0
2020-05-13,India,NA,Andaman and Nicobar Islands,356152,0,0,33,0
2020-05-14,India,NA,Andaman and Nicobar Islands,356152,0,0,33,0
2020-05-15,India,NA,Andaman and Nicobar Islands,356152,0,0,33,0
2020-05-16,India,NA,Andaman and Nicobar Islands,356152,0,0,33,0
2020-05-17,India,NA,Andaman and Nicobar Islands,356152,0,0,33,0
2020-05-18,India,NA,Andaman and Nicobar Islands,356152,0,0,33,0
2020-05-19,India,NA,Andaman and Nicobar Islands,356152,0,0,33,0
2020-05-20,India,NA,Andaman and Nicobar Islands,356152,0,0,33,0
2020-05-21,India,NA,Andaman and Nicobar Islands,356152,0,0,33,0
2020-05-22,India,NA,Andaman and Nicobar Islands,356152,0,0,33,0
2020-05-23,India,NA,Andaman and Nicobar Islands,356152,0,0,33,0
2020-05-24,India,NA,Andaman and Nicobar Islands,356152,0,0,33,0
2020-05-25,India,NA,Andaman and Nicobar Islands,356152,0,0,33,0
2020-05-26,India,NA,Andaman and Nicobar Islands,356152,0,0,33,0
2020-05-27,India,NA,Andaman and Nicobar Islands,356152,0,0,33,0
2020-05-28,India,NA,Andaman and Nicobar Islands,356152,0,0,33,0
2020-05-29,India,NA,Andaman and Nicobar Islands,356152,0,0,33,0
2020-05-30,India,NA,Andaman and Nicobar Islands,356152,0,0,33,0
2020-05-31,India,NA,Andaman and Nicobar Islands,356152,0,0,33,0
2020-06-01,India,NA,Andaman and Nicobar Islands,356152,0,0,33,0
2020-06-02,India,NA,Andaman and Nicobar Islands,356152,0,0,33,0
2020-06-03,India,NA,Andaman and Nicobar Islands,356152,0,0,33,0
2020-06-04,India,NA,Andaman and Nicobar Islands,356152,0,0,33,0
2020-06-05,India,NA,Andaman and Nicobar Islands,356152,0,0,33,0
2020-06-06,India,NA,Andaman and Nicobar Islands,356152,0,0,33,0
2020-06-07,India,NA,Andaman and Nicobar Islands,356152,0,0,33,0
2020-06-08,India,NA,Andaman and Nicobar Islands,356152,0,0,33,0
2020-06-09,India,NA,Andaman and Nicobar Islands,356152,1,0,34,0
2020-06-10,India,NA,Andaman and Nicobar Islands,356152,1,0,35,0
2020-06-11,India,NA,Andaman and Nicobar Islands,356152,3,0,38,0
2020-06-12,India,NA,Andaman and Nicobar Islands,356152,0,0,38,0
2020-06-13,India,NA,Andaman and Nicobar Islands,356152,0,0,38,0
2020-06-14,India,NA,Andaman and Nicobar Islands,356152,2,0,40,0
2020-06-15,India,NA,Andaman and Nicobar Islands,356152,1,0,41,0
2020-06-16,India,NA,Andaman and Nicobar Islands,356152,3,0,44,0
2020-06-17,India,NA,Andaman and Nicobar Islands,356152,0,0,44,0
2020-06-18,India,NA,Andaman and Nicobar Islands,356152,1,0,45,0
2020-06-19,India,NA,Andaman and Nicobar Islands,356152,2,0,47,0
2020-06-20,India,NA,Andaman and Nicobar Islands,356152,0,0,47,0
2020-06-21,India,NA,Andaman and Nicobar Islands,356152,1,0,48,0
2020-06-22,India,NA,Andaman and Nicobar Islands,356152,0,0,48,0
2020-06-23,India,NA,Andaman and Nicobar Islands,356152,2,0,50,0
2020-06-24,India,NA,Andaman and Nicobar Islands,356152,6,0,56,0
2020-06-25,India,NA,Andaman and Nicobar Islands,356152,2,0,58,0
2020-06-26,India,NA,Andaman and Nicobar Islands,356152,14,0,72,0
2020-06-27,India,NA,Andaman and Nicobar Islands,356152,0,0,72,0
2020-06-28,India,NA,Andaman and Nicobar Islands,356152,11,0,83,0
2020-06-29,India,NA,Andaman and Nicobar Islands,356152,7,0,90,0
2020-06-30,India,NA,Andaman and Nicobar Islands,356152,7,0,97,0
2020-07-01,India,NA,Andaman and Nicobar Islands,356152,3,0,100,0
2020-07-02,India,NA,Andaman and Nicobar Islands,356152,9,0,109,0
2020-07-03,India,NA,Andaman and Nicobar Islands,356152,7,0,116,0
2020-07-04,India,NA,Andaman and Nicobar Islands,356152,3,0,119,0
2020-07-05,India,NA,Andaman and Nicobar Islands,356152,6,0,125,0
2020-07-06,India,NA,Andaman and Nicobar Islands,356152,16,0,141,0
2020-07-07,India,NA,Andaman and Nicobar Islands,356152,6,0,147,0
2020-07-08,India,NA,Andaman and Nicobar Islands,356152,2,0,149,0
2020-07-09,India,NA,Andaman and Nicobar Islands,356152,7,0,156,0
2020-07-10,India,NA,Andaman and Nicobar Islands,356152,0,0,156,0
2020-07-11,India,NA,Andaman and Nicobar Islands,356152,0,0,156,0
2020-07-12,India,NA,Andaman and Nicobar Islands,356152,7,0,163,0
2020-07-13,India,NA,Andaman and Nicobar Islands,356152,3,0,166,0
2020-07-14,India,NA,Andaman and Nicobar Islands,356152,5,0,171,0
2020-07-15,India,NA,Andaman and Nicobar Islands,356152,5,0,176,0
2020-07-16,India,NA,Andaman and Nicobar Islands,356152,4,0,180,0
2020-07-17,India,NA,Andaman and Nicobar Islands,356152,0,0,180,0
2020-07-18,India,NA,Andaman and Nicobar Islands,356152,4,0,184,0
2020-07-19,India,NA,Andaman and Nicobar Islands,356152,15,0,199,0
2020-07-20,India,NA,Andaman and Nicobar Islands,356152,4,0,203,0
2020-07-21,India,NA,Andaman and Nicobar Islands,356152,5,0,208,0
2020-07-22,India,NA,Andaman and Nicobar Islands,356152,9,0,217,0
2020-07-23,India,NA,Andaman and Nicobar Islands,356152,19,0,236,0
2020-07-24,India,NA,Andaman and Nicobar Islands,356152,19,0,255,0
2020-07-25,India,NA,Andaman and Nicobar Islands,356152,31,0,286,0
2020-07-26,India,NA,Andaman and Nicobar Islands,356152,28,0,314,0
2020-07-27,India,NA,Andaman and Nicobar Islands,356152,20,1,334,1
2020-07-28,India,NA,Andaman and Nicobar Islands,356152,25,0,359,1
2020-07-29,India,NA,Andaman and Nicobar Islands,356152,65,1,424,2
2020-07-30,India,NA,Andaman and Nicobar Islands,356152,42,1,466,3
2020-07-31,India,NA,Andaman and Nicobar Islands,356152,78,2,544,5
2020-08-01,India,NA,Andaman and Nicobar Islands,356152,88,2,632,7
2020-08-02,India,NA,Andaman and Nicobar Islands,356152,98,1,730,8
2020-08-03,India,NA,Andaman and Nicobar Islands,356152,96,2,826,10
2020-08-04,India,NA,Andaman and Nicobar Islands,356152,98,2,924,12
2020-08-05,India,NA,Andaman and Nicobar Islands,356152,99,2,1023,14
2020-08-06,India,NA,Andaman and Nicobar Islands,356152,96,2,1119,16
2020-08-07,India,NA,Andaman and Nicobar Islands,356152,99,3,1218,19
2020-08-08,India,NA,Andaman and Nicobar Islands,356152,129,1,1347,20
2020-08-09,India,NA,Andaman and Nicobar Islands,356152,139,0,1486,20
2020-08-10,India,NA,Andaman and Nicobar Islands,356152,135,0,1621,20
2020-08-11,India,NA,Andaman and Nicobar Islands,356152,139,1,1760,21
2020-08-12,India,NA,Andaman and Nicobar Islands,356152,136,0,1896,21
2020-08-13,India,NA,Andaman and Nicobar Islands,356152,137,1,2033,22
2020-08-14,India,NA,Andaman and Nicobar Islands,356152,149,2,2182,24
2020-08-15,India,NA,Andaman and Nicobar Islands,356152,120,0,2302,24
2020-08-16,India,NA,Andaman and Nicobar Islands,356152,93,4,2395,28
2020-08-17,India,NA,Andaman and Nicobar Islands,356152,46,1,2441,29
2020-08-18,India,NA,Andaman and Nicobar Islands,356152,84,1,2525,30
2020-08-19,India,NA,Andaman and Nicobar Islands,356152,75,0,2600,30
2020-08-20,India,NA,Andaman and Nicobar Islands,356152,76,1,2676,31
2020-08-21,India,NA,Andaman and Nicobar Islands,356152,67,1,2743,32
2020-08-22,India,NA,Andaman and Nicobar Islands,356152,61,0,2804,32
2020-08-23,India,NA,Andaman and Nicobar Islands,356152,52,1,2856,33
2020-08-24,India,NA,Andaman and Nicobar Islands,356152,44,2,2900,35
2020-08-25,India,NA,Andaman and Nicobar Islands,356152,41,2,2941,37
2020-08-26,India,NA,Andaman and Nicobar Islands,356152,40,4,2981,41
2020-08-27,India,NA,Andaman and Nicobar Islands,356152,33,1,3014,42
2020-08-28,India,NA,Andaman and Nicobar Islands,356152,32,0,3046,42
2020-08-29,India,NA,Andaman and Nicobar Islands,356152,31,2,3077,44
2020-08-30,India,NA,Andaman and Nicobar Islands,356152,23,1,3100,45
2020-08-31,India,NA,Andaman and Nicobar Islands,356152,28,1,3128,46
2020-09-01,India,NA,Andaman and Nicobar Islands,356152,28,0,3156,46
2020-09-02,India,NA,Andaman and Nicobar Islands,356152,26,1,3182,47
2020-09-03,India,NA,Andaman and Nicobar Islands,356152,37,1,3219,48
2020-09-04,India,NA,Andaman and Nicobar Islands,356152,34,1,3253,49
2020-09-05,India,NA,Andaman and Nicobar Islands,356152,35,1,3288,50
2020-09-06,India,NA,Andaman and Nicobar Islands,356152,40,0,3328,50
2020-09-07,India,NA,Andaman and Nicobar Islands,356152,27,0,3355,50
2020-09-08,India,NA,Andaman and Nicobar Islands,356152,33,0,3388,50
2020-09-09,India,NA,Andaman and Nicobar Islands,356152,34,1,3422,51
2020-09-10,India,NA,Andaman and Nicobar Islands,356152,39,0,3461,51
2020-09-11,India,NA,Andaman and Nicobar Islands,356152,29,0,3490,51
2020-09-12,India,NA,Andaman and Nicobar Islands,356152,27,0,3517,51
2020-09-13,India,NA,Andaman and Nicobar Islands,356152,25,0,3542,51
2020-09-14,India,NA,Andaman and Nicobar Islands,356152,11,1,3553,52
2020-09-15,India,NA,Andaman and Nicobar Islands,356152,17,0,3570,52
2020-09-16,India,NA,Andaman and Nicobar Islands,356152,19,0,3589,52
2020-09-17,India,NA,Andaman and Nicobar Islands,356152,11,0,3600,52
2020-09-18,India,NA,Andaman and Nicobar Islands,356152,27,0,3627,52
2020-09-19,India,NA,Andaman and Nicobar Islands,356152,13,0,3640,52
2020-09-20,India,NA,Andaman and Nicobar Islands,356152,7,0,3647,52
2020-09-21,India,NA,Andaman and Nicobar Islands,356152,22,0,3669,52
2020-09-22,India,NA,Andaman and Nicobar Islands,356152,18,0,3687,52
2020-09-23,India,NA,Andaman and Nicobar Islands,356152,21,0,3708,52
2020-03-26,India,NA,Andhra Pradesh,49386799,1,0,11,0
2020-03-27,India,NA,Andhra Pradesh,49386799,2,0,13,0
2020-03-28,India,NA,Andhra Pradesh,49386799,6,0,19,0
2020-03-29,India,NA,Andhra Pradesh,49386799,2,0,21,0
2020-03-30,India,NA,Andhra Pradesh,49386799,2,0,23,0
2020-03-31,India,NA,Andhra Pradesh,49386799,21,0,44,0
2020-04-01,India,NA,Andhra Pradesh,49386799,67,0,111,0
2020-04-02,India,NA,Andhra Pradesh,49386799,38,0,149,0
2020-04-03,India,NA,Andhra Pradesh,49386799,15,1,164,1
2020-04-04,India,NA,Andhra Pradesh,49386799,28,0,192,1
2020-04-05,India,NA,Andhra Pradesh,49386799,64,0,256,1
2020-04-06,India,NA,Andhra Pradesh,49386799,47,2,303,3
2020-04-07,India,NA,Andhra Pradesh,49386799,11,1,314,4
2020-04-08,India,NA,Andhra Pradesh,49386799,34,0,348,4
2020-04-09,India,NA,Andhra Pradesh,49386799,15,2,363,6
2020-04-10,India,NA,Andhra Pradesh,49386799,18,0,381,6
2020-04-11,India,NA,Andhra Pradesh,49386799,24,0,405,6
2020-04-12,India,NA,Andhra Pradesh,49386799,15,1,420,7
2020-04-13,India,NA,Andhra Pradesh,49386799,19,0,439,7
2020-04-14,India,NA,Andhra Pradesh,49386799,45,4,484,11
2020-04-15,India,NA,Andhra Pradesh,49386799,41,3,525,14
2020-04-16,India,NA,Andhra Pradesh,49386799,9,0,534,14
2020-04-17,India,NA,Andhra Pradesh,49386799,38,0,572,14
2020-04-18,India,NA,Andhra Pradesh,49386799,31,2,603,16
2020-04-19,India,NA,Andhra Pradesh,49386799,44,1,647,17
2020-04-20,India,NA,Andhra Pradesh,49386799,75,3,722,20
2020-04-21,India,NA,Andhra Pradesh,49386799,35,2,757,22
2020-04-22,India,NA,Andhra Pradesh,49386799,56,2,813,24
2020-04-23,India,NA,Andhra Pradesh,49386799,80,3,893,27
2020-04-24,India,NA,Andhra Pradesh,49386799,62,2,955,29
2020-04-25,India,NA,Andhra Pradesh,49386799,61,2,1016,31
2020-04-26,India,NA,Andhra Pradesh,49386799,81,0,1097,31
2020-04-27,India,NA,Andhra Pradesh,49386799,80,0,1177,31
2020-04-28,India,NA,Andhra Pradesh,49386799,82,0,1259,31
2020-04-29,India,NA,Andhra Pradesh,49386799,73,0,1332,31
2020-04-30,India,NA,Andhra Pradesh,49386799,71,0,1403,31
2020-05-01,India,NA,Andhra Pradesh,49386799,60,2,1463,33
2020-05-02,India,NA,Andhra Pradesh,49386799,62,0,1525,33
2020-05-03,India,NA,Andhra Pradesh,49386799,58,0,1583,33
2020-05-04,India,NA,Andhra Pradesh,49386799,67,0,1650,33
2020-05-05,India,NA,Andhra Pradesh,49386799,67,1,1717,34
2020-05-06,India,NA,Andhra Pradesh,49386799,60,2,1777,36
2020-05-07,India,NA,Andhra Pradesh,49386799,56,2,1833,38
2020-05-08,India,NA,Andhra Pradesh,49386799,54,3,1887,41
2020-05-09,India,NA,Andhra Pradesh,49386799,43,3,1930,44
2020-05-10,India,NA,Andhra Pradesh,49386799,50,1,1980,45
2020-05-11,India,NA,Andhra Pradesh,49386799,38,0,2018,45
2020-05-12,India,NA,Andhra Pradesh,49386799,71,1,2089,46
2020-05-13,India,NA,Andhra Pradesh,49386799,48,1,2137,47
2020-05-14,India,NA,Andhra Pradesh,49386799,68,1,2205,48
2020-05-15,India,NA,Andhra Pradesh,49386799,102,0,2307,48
2020-05-16,India,NA,Andhra Pradesh,49386799,48,1,2355,49
2020-05-17,India,NA,Andhra Pradesh,49386799,25,1,2380,50
2020-05-18,India,NA,Andhra Pradesh,49386799,52,0,2432,50
2020-05-19,India,NA,Andhra Pradesh,49386799,57,2,2489,52
2020-05-20,India,NA,Andhra Pradesh,49386799,71,1,2560,53
2020-05-21,India,NA,Andhra Pradesh,49386799,45,1,2605,54
2020-05-22,India,NA,Andhra Pradesh,49386799,62,1,2667,55
2020-05-23,India,NA,Andhra Pradesh,49386799,47,1,2714,56
2020-05-24,India,NA,Andhra Pradesh,49386799,66,0,2780,56
2020-05-25,India,NA,Andhra Pradesh,49386799,106,0,2886,56
2020-05-26,India,NA,Andhra Pradesh,49386799,97,1,2983,57
2020-05-27,India,NA,Andhra Pradesh,49386799,134,1,3117,58
2020-05-28,India,NA,Andhra Pradesh,49386799,128,1,3245,59
2020-05-29,India,NA,Andhra Pradesh,49386799,85,1,3330,60
2020-05-30,India,NA,Andhra Pradesh,49386799,131,0,3461,60
2020-05-31,India,NA,Andhra Pradesh,49386799,110,2,3571,62
2020-06-01,India,NA,Andhra Pradesh,49386799,105,2,3676,64
2020-06-02,India,NA,Andhra Pradesh,49386799,115,0,3791,64
2020-06-03,India,NA,Andhra Pradesh,49386799,180,4,3971,68
2020-06-04,India,NA,Andhra Pradesh,49386799,141,3,4112,71
2020-06-05,India,NA,Andhra Pradesh,49386799,138,2,4250,73
2020-06-06,India,NA,Andhra Pradesh,49386799,210,0,4460,73
2020-06-07,India,NA,Andhra Pradesh,49386799,199,2,4659,75
2020-06-08,India,NA,Andhra Pradesh,49386799,154,0,4813,75
2020-06-09,India,NA,Andhra Pradesh,49386799,69,2,4882,77
2020-06-10,India,NA,Andhra Pradesh,49386799,365,1,5247,78
2020-06-11,India,NA,Andhra Pradesh,49386799,182,2,5429,80
2020-06-12,India,NA,Andhra Pradesh,49386799,207,0,5636,80
2020-06-13,India,NA,Andhra Pradesh,49386799,222,2,5858,82
2020-06-14,India,NA,Andhra Pradesh,49386799,294,2,6152,84
2020-06-15,India,NA,Andhra Pradesh,49386799,304,2,6456,86
2020-06-16,India,NA,Andhra Pradesh,49386799,264,2,6720,88
2020-06-17,India,NA,Andhra Pradesh,49386799,351,2,7071,90
2020-06-18,India,NA,Andhra Pradesh,49386799,425,2,7496,92
2020-06-19,India,NA,Andhra Pradesh,49386799,465,4,7961,96
2020-06-20,India,NA,Andhra Pradesh,49386799,491,5,8452,101
2020-06-21,India,NA,Andhra Pradesh,49386799,477,5,8929,106
2020-06-22,India,NA,Andhra Pradesh,49386799,443,5,9372,111
2020-06-23,India,NA,Andhra Pradesh,49386799,462,8,9834,119
2020-06-24,India,NA,Andhra Pradesh,49386799,497,10,10331,129
2020-06-25,India,NA,Andhra Pradesh,49386799,553,7,10884,136
2020-06-26,India,NA,Andhra Pradesh,49386799,605,10,11489,146
2020-06-27,India,NA,Andhra Pradesh,49386799,796,11,12285,157
2020-06-28,India,NA,Andhra Pradesh,49386799,813,12,13098,169
2020-06-29,India,NA,Andhra Pradesh,49386799,793,11,13891,180
2020-06-30,India,NA,Andhra Pradesh,49386799,704,7,14595,187
2020-07-01,India,NA,Andhra Pradesh,49386799,657,6,15252,193
2020-07-02,India,NA,Andhra Pradesh,49386799,845,5,16097,198
2020-07-03,India,NA,Andhra Pradesh,49386799,837,8,16934,206
2020-07-04,India,NA,Andhra Pradesh,49386799,765,12,17699,218
2020-07-05,India,NA,Andhra Pradesh,49386799,998,14,18697,232
2020-07-06,India,NA,Andhra Pradesh,49386799,1322,7,20019,239
2020-07-07,India,NA,Andhra Pradesh,49386799,1178,13,21197,252
2020-07-08,India,NA,Andhra Pradesh,49386799,1062,12,22259,264
2020-07-09,India,NA,Andhra Pradesh,49386799,1555,13,23814,277
2020-07-10,India,NA,Andhra Pradesh,49386799,1608,15,25422,292
2020-07-11,India,NA,Andhra Pradesh,49386799,1813,17,27235,309
2020-07-12,India,NA,Andhra Pradesh,49386799,1933,19,29168,328
2020-07-13,India,NA,Andhra Pradesh,49386799,1935,37,31103,365
2020-07-14,India,NA,Andhra Pradesh,49386799,1916,43,33019,408
2020-07-15,India,NA,Andhra Pradesh,49386799,2432,44,35451,452
2020-07-16,India,NA,Andhra Pradesh,49386799,2593,40,38044,492
2020-07-17,India,NA,Andhra Pradesh,49386799,2602,42,40646,534
2020-07-18,India,NA,Andhra Pradesh,49386799,3963,52,44609,586
2020-07-19,India,NA,Andhra Pradesh,49386799,5041,56,49650,642
2020-07-20,India,NA,Andhra Pradesh,49386799,4074,54,53724,696
2020-07-21,India,NA,Andhra Pradesh,49386799,4944,62,58668,758
2020-07-22,India,NA,Andhra Pradesh,49386799,6045,65,64713,823
2020-07-23,India,NA,Andhra Pradesh,49386799,7998,61,72711,884
2020-07-24,India,NA,Andhra Pradesh,49386799,8147,49,80858,933
2020-07-25,India,NA,Andhra Pradesh,49386799,7813,52,88671,985
2020-07-26,India,NA,Andhra Pradesh,49386799,7627,56,96298,1041
2020-07-27,India,NA,Andhra Pradesh,49386799,6051,49,102349,1090
2020-07-28,India,NA,Andhra Pradesh,49386799,7948,58,110297,1148
2020-07-29,India,NA,Andhra Pradesh,49386799,10093,65,120390,1213
2020-07-30,India,NA,Andhra Pradesh,49386799,10167,68,130557,1281
2020-07-31,India,NA,Andhra Pradesh,49386799,10376,68,140933,1349
2020-08-01,India,NA,Andhra Pradesh,49386799,9276,58,150209,1407
2020-08-02,India,NA,Andhra Pradesh,49386799,8555,67,158764,1474
2020-08-03,India,NA,Andhra Pradesh,49386799,7822,63,166586,1537
2020-08-04,India,NA,Andhra Pradesh,49386799,9747,67,176333,1604
2020-08-05,India,NA,Andhra Pradesh,49386799,10128,77,186461,1681
2020-08-06,India,NA,Andhra Pradesh,49386799,10328,72,196789,1753
2020-08-07,India,NA,Andhra Pradesh,49386799,10171,89,206960,1842
2020-08-08,India,NA,Andhra Pradesh,49386799,10080,97,217040,1939
2020-08-09,India,NA,Andhra Pradesh,49386799,10820,97,227860,2036
2020-08-10,India,NA,Andhra Pradesh,49386799,7665,80,235525,2116
2020-08-11,India,NA,Andhra Pradesh,49386799,9024,87,244549,2203
2020-08-12,India,NA,Andhra Pradesh,49386799,9597,93,254146,2296
2020-08-13,India,NA,Andhra Pradesh,49386799,9996,82,264142,2378
2020-08-14,India,NA,Andhra Pradesh,49386799,8943,97,273085,2475
2020-08-15,India,NA,Andhra Pradesh,49386799,8732,87,281817,2562
2020-08-16,India,NA,Andhra Pradesh,49386799,8012,88,289829,2650
2020-08-17,India,NA,Andhra Pradesh,49386799,6780,82,296609,2732
2020-08-18,India,NA,Andhra Pradesh,49386799,9652,88,306261,2820
2020-08-19,India,NA,Andhra Pradesh,49386799,9742,86,316003,2906
2020-08-20,India,NA,Andhra Pradesh,49386799,9393,95,325396,3001
2020-08-21,India,NA,Andhra Pradesh,49386799,9544,91,334940,3092
2020-08-22,India,NA,Andhra Pradesh,49386799,10276,97,345216,3189
2020-08-23,India,NA,Andhra Pradesh,49386799,7895,93,353111,3282
2020-08-24,India,NA,Andhra Pradesh,49386799,8601,86,361712,3368
2020-08-25,India,NA,Andhra Pradesh,49386799,9927,92,371639,3460
2020-08-26,India,NA,Andhra Pradesh,49386799,10830,81,382469,3541
2020-08-27,India,NA,Andhra Pradesh,49386799,10621,92,393090,3633
2020-08-28,India,NA,Andhra Pradesh,49386799,10526,81,403616,3714
2020-08-29,India,NA,Andhra Pradesh,49386799,10548,82,414164,3796
2020-08-30,India,NA,Andhra Pradesh,49386799,10603,88,424767,3884
2020-08-31,India,NA,Andhra Pradesh,49386799,10004,85,434771,3969
2020-09-01,India,NA,Andhra Pradesh,49386799,10368,84,445139,4053
2020-09-02,India,NA,Andhra Pradesh,49386799,10392,72,455531,4125
2020-09-03,India,NA,Andhra Pradesh,49386799,10199,75,465730,4200
2020-09-04,India,NA,Andhra Pradesh,49386799,10776,76,476506,4276
2020-09-05,India,NA,Andhra Pradesh,49386799,10825,71,487331,4347
2020-09-06,India,NA,Andhra Pradesh,49386799,10794,70,498125,4417
2020-09-07,India,NA,Andhra Pradesh,49386799,8368,70,506493,4487
2020-09-08,India,NA,Andhra Pradesh,49386799,10601,73,517094,4560
2020-09-09,India,NA,Andhra Pradesh,49386799,10418,74,527512,4634
2020-09-10,India,NA,Andhra Pradesh,49386799,10175,68,537687,4702
2020-09-11,India,NA,Andhra Pradesh,49386799,9999,77,547686,4779
2020-09-12,India,NA,Andhra Pradesh,49386799,9901,67,557587,4846
2020-09-13,India,NA,Andhra Pradesh,49386799,9536,66,567123,4912
2020-09-14,India,NA,Andhra Pradesh,49386799,7956,60,575079,4972
2020-09-15,India,NA,Andhra Pradesh,49386799,8846,69,583925,5041
2020-09-16,India,NA,Andhra Pradesh,49386799,8835,64,592760,5105
2020-09-17,India,NA,Andhra Pradesh,49386799,8702,72,601462,5177
2020-09-18,India,NA,Andhra Pradesh,49386799,8096,67,609558,5244
2020-09-19,India,NA,Andhra Pradesh,49386799,8218,58,617776,5302
2020-09-20,India,NA,Andhra Pradesh,49386799,7738,57,625514,5359
2020-09-21,India,NA,Andhra Pradesh,49386799,6235,51,631749,5410
2020-09-22,India,NA,Andhra Pradesh,49386799,7553,51,639302,5461
2020-09-23,India,NA,Andhra Pradesh,49386799,7228,45,646530,5506
2020-06-01,India,NA,Arunachal Pradesh,1382611,18,0,22,0
2020-06-02,India,NA,Arunachal Pradesh,1382611,2,0,24,0
2020-06-03,India,NA,Arunachal Pradesh,1382611,10,0,34,0
2020-06-04,India,NA,Arunachal Pradesh,1382611,5,0,39,0
2020-06-05,India,NA,Arunachal Pradesh,1382611,4,0,43,0
2020-06-06,India,NA,Arunachal Pradesh,1382611,2,0,45,0
2020-06-07,India,NA,Arunachal Pradesh,1382611,3,0,48,0
2020-06-08,India,NA,Arunachal Pradesh,1382611,6,0,54,0
2020-06-09,India,NA,Arunachal Pradesh,1382611,0,0,54,0
2020-06-10,India,NA,Arunachal Pradesh,1382611,4,0,58,0
2020-06-11,India,NA,Arunachal Pradesh,1382611,6,0,64,0
2020-06-12,India,NA,Arunachal Pradesh,1382611,19,0,83,0
2020-06-13,India,NA,Arunachal Pradesh,1382611,5,0,88,0
2020-06-14,India,NA,Arunachal Pradesh,1382611,3,0,91,0
2020-06-15,India,NA,Arunachal Pradesh,1382611,4,0,95,0
2020-06-16,India,NA,Arunachal Pradesh,1382611,4,0,99,0
2020-06-17,India,NA,Arunachal Pradesh,1382611,4,0,103,0
2020-06-18,India,NA,Arunachal Pradesh,1382611,0,0,103,0
2020-06-19,India,NA,Arunachal Pradesh,1382611,32,0,135,0
2020-06-20,India,NA,Arunachal Pradesh,1382611,0,0,135,0
2020-06-21,India,NA,Arunachal Pradesh,1382611,4,0,139,0
2020-06-22,India,NA,Arunachal Pradesh,1382611,9,0,148,0
2020-06-23,India,NA,Arunachal Pradesh,1382611,10,0,158,0
2020-06-24,India,NA,Arunachal Pradesh,1382611,2,1,160,1
2020-06-25,India,NA,Arunachal Pradesh,1382611,12,0,172,1
2020-06-26,India,NA,Arunachal Pradesh,1382611,2,0,174,1
2020-06-27,India,NA,Arunachal Pradesh,1382611,3,0,177,1
2020-06-28,India,NA,Arunachal Pradesh,1382611,5,0,182,1
2020-06-29,India,NA,Arunachal Pradesh,1382611,5,0,187,1
2020-06-30,India,NA,Arunachal Pradesh,1382611,4,0,191,1
2020-07-01,India,NA,Arunachal Pradesh,1382611,4,0,195,1
2020-07-02,India,NA,Arunachal Pradesh,1382611,37,0,232,1
2020-07-03,India,NA,Arunachal Pradesh,1382611,20,0,252,1
2020-07-04,India,NA,Arunachal Pradesh,1382611,7,0,259,1
2020-07-05,India,NA,Arunachal Pradesh,1382611,10,0,269,1
2020-07-06,India,NA,Arunachal Pradesh,1382611,1,1,270,2
2020-07-07,India,NA,Arunachal Pradesh,1382611,6,0,276,2
2020-07-08,India,NA,Arunachal Pradesh,1382611,11,0,287,2
2020-07-09,India,NA,Arunachal Pradesh,1382611,15,0,302,2
2020-07-10,India,NA,Arunachal Pradesh,1382611,33,0,335,2
2020-07-11,India,NA,Arunachal Pradesh,1382611,6,0,341,2
2020-07-12,India,NA,Arunachal Pradesh,1382611,19,0,360,2
2020-07-13,India,NA,Arunachal Pradesh,1382611,27,1,387,3
2020-07-14,India,NA,Arunachal Pradesh,1382611,75,0,462,3
2020-07-15,India,NA,Arunachal Pradesh,1382611,29,0,491,3
2020-07-16,India,NA,Arunachal Pradesh,1382611,52,0,543,3
2020-07-17,India,NA,Arunachal Pradesh,1382611,66,0,609,3
2020-07-18,India,NA,Arunachal Pradesh,1382611,41,0,650,3
2020-07-19,India,NA,Arunachal Pradesh,1382611,90,0,740,3
2020-07-20,India,NA,Arunachal Pradesh,1382611,50,0,790,3
2020-07-21,India,NA,Arunachal Pradesh,1382611,68,0,858,3
2020-07-22,India,NA,Arunachal Pradesh,1382611,91,0,949,3
2020-07-23,India,NA,Arunachal Pradesh,1382611,42,0,991,3
2020-07-24,India,NA,Arunachal Pradesh,1382611,65,0,1056,3
2020-07-25,India,NA,Arunachal Pradesh,1382611,70,0,1126,3
2020-07-26,India,NA,Arunachal Pradesh,1382611,32,0,1158,3
2020-07-27,India,NA,Arunachal Pradesh,1382611,81,0,1239,3
2020-07-28,India,NA,Arunachal Pradesh,1382611,91,0,1330,3
2020-07-29,India,NA,Arunachal Pradesh,1382611,80,0,1410,3
2020-07-30,India,NA,Arunachal Pradesh,1382611,74,0,1484,3
2020-07-31,India,NA,Arunachal Pradesh,1382611,107,0,1591,3
2020-08-01,India,NA,Arunachal Pradesh,1382611,83,0,1674,3
2020-08-02,India,NA,Arunachal Pradesh,1382611,24,0,1698,3
2020-08-03,India,NA,Arunachal Pradesh,1382611,60,0,1758,3
2020-08-04,India,NA,Arunachal Pradesh,1382611,32,0,1790,3
2020-08-05,India,NA,Arunachal Pradesh,1382611,65,0,1855,3
2020-08-06,India,NA,Arunachal Pradesh,1382611,93,0,1948,3
2020-08-07,India,NA,Arunachal Pradesh,1382611,101,0,2049,3
2020-08-08,India,NA,Arunachal Pradesh,1382611,68,0,2117,3
2020-08-09,India,NA,Arunachal Pradesh,1382611,38,0,2155,3
2020-08-10,India,NA,Arunachal Pradesh,1382611,76,0,2231,3
2020-08-11,India,NA,Arunachal Pradesh,1382611,96,0,2327,3
2020-08-12,India,NA,Arunachal Pradesh,1382611,103,0,2430,3
2020-08-13,India,NA,Arunachal Pradesh,1382611,82,1,2512,4
2020-08-14,India,NA,Arunachal Pradesh,1382611,95,1,2607,5
2020-08-15,India,NA,Arunachal Pradesh,1382611,51,0,2658,5
2020-08-16,India,NA,Arunachal Pradesh,1382611,43,0,2701,5
2020-08-17,India,NA,Arunachal Pradesh,1382611,40,0,2741,5
2020-08-18,India,NA,Arunachal Pradesh,1382611,134,0,2875,5
2020-08-19,India,NA,Arunachal Pradesh,1382611,75,0,2950,5
2020-08-20,India,NA,Arunachal Pradesh,1382611,116,0,3066,5
2020-08-21,India,NA,Arunachal Pradesh,1382611,60,0,3126,5
2020-08-22,India,NA,Arunachal Pradesh,1382611,97,0,3223,5
2020-08-23,India,NA,Arunachal Pradesh,1382611,40,0,3263,5
2020-08-24,India,NA,Arunachal Pradesh,1382611,49,0,3312,5
2020-08-25,India,NA,Arunachal Pradesh,1382611,100,0,3412,5
2020-08-26,India,NA,Arunachal Pradesh,1382611,143,0,3555,5
2020-08-27,India,NA,Arunachal Pradesh,1382611,78,0,3633,5
2020-08-28,India,NA,Arunachal Pradesh,1382611,112,2,3745,7
2020-08-29,India,NA,Arunachal Pradesh,1382611,132,0,3877,7
2020-08-30,India,NA,Arunachal Pradesh,1382611,157,0,4034,7
2020-08-31,India,NA,Arunachal Pradesh,1382611,78,0,4112,7
2020-09-01,India,NA,Arunachal Pradesh,1382611,100,0,4212,7
2020-09-02,India,NA,Arunachal Pradesh,1382611,148,0,4360,7
2020-09-03,India,NA,Arunachal Pradesh,1382611,214,1,4574,8
2020-09-04,India,NA,Arunachal Pradesh,1382611,201,0,4775,8
2020-09-05,India,NA,Arunachal Pradesh,1382611,139,0,4914,8
2020-09-06,India,NA,Arunachal Pradesh,1382611,86,0,5000,8
2020-09-07,India,NA,Arunachal Pradesh,1382611,180,0,5180,8
2020-09-08,India,NA,Arunachal Pradesh,1382611,221,1,5401,9
2020-09-09,India,NA,Arunachal Pradesh,1382611,144,0,5545,9
2020-09-10,India,NA,Arunachal Pradesh,1382611,127,0,5672,9
2020-09-11,India,NA,Arunachal Pradesh,1382611,153,1,5825,10
2020-09-12,India,NA,Arunachal Pradesh,1382611,136,0,5961,10
2020-09-13,India,NA,Arunachal Pradesh,1382611,160,0,6121,10
2020-09-14,India,NA,Arunachal Pradesh,1382611,176,1,6297,11
2020-09-15,India,NA,Arunachal Pradesh,1382611,169,2,6466,13
2020-09-16,India,NA,Arunachal Pradesh,1382611,226,0,6692,13
2020-09-17,India,NA,Arunachal Pradesh,1382611,159,0,6851,13
2020-09-18,India,NA,Arunachal Pradesh,1382611,154,0,7005,13
2020-09-19,India,NA,Arunachal Pradesh,1382611,245,0,7250,13
2020-09-20,India,NA,Arunachal Pradesh,1382611,135,0,7385,13
2020-09-21,India,NA,Arunachal Pradesh,1382611,210,0,7595,13
2020-09-22,India,NA,Arunachal Pradesh,1382611,249,1,7844,14
2020-09-23,India,NA,Arunachal Pradesh,1382611,289,0,8133,14
2020-04-01,India,NA,Assam,31205576,15,0,16,0
2020-04-02,India,NA,Assam,31205576,0,0,16,0
2020-04-03,India,NA,Assam,31205576,7,0,23,0
2020-04-04,India,NA,Assam,31205576,3,0,26,0
2020-04-05,India,NA,Assam,31205576,0,0,26,0
2020-04-06,India,NA,Assam,31205576,0,0,26,0
2020-04-07,India,NA,Assam,31205576,2,0,28,0
2020-04-08,India,NA,Assam,31205576,0,0,28,0
2020-04-09,India,NA,Assam,31205576,1,0,29,0
2020-04-10,India,NA,Assam,31205576,0,1,29,1
2020-04-11,India,NA,Assam,31205576,0,0,29,1
2020-04-12,India,NA,Assam,31205576,1,0,30,1
2020-04-13,India,NA,Assam,31205576,2,0,32,1
2020-04-14,India,NA,Assam,31205576,1,0,33,1
2020-04-15,India,NA,Assam,31205576,0,0,33,1
2020-04-16,India,NA,Assam,31205576,2,0,35,1
2020-04-17,India,NA,Assam,31205576,0,0,35,1
2020-04-18,India,NA,Assam,31205576,0,0,35,1
2020-04-19,India,NA,Assam,31205576,0,0,35,1
2020-04-20,India,NA,Assam,31205576,0,0,35,1
2020-04-21,India,NA,Assam,31205576,0,0,35,1
2020-04-22,India,NA,Assam,31205576,0,0,35,1
2020-04-23,India,NA,Assam,31205576,1,0,36,1
2020-04-24,India,NA,Assam,31205576,0,0,36,1
2020-04-25,India,NA,Assam,31205576,0,0,36,1
2020-04-26,India,NA,Assam,31205576,0,0,36,1
2020-04-27,India,NA,Assam,31205576,0,0,36,1
2020-04-28,India,NA,Assam,31205576,2,0,38,1
2020-04-29,India,NA,Assam,31205576,0,0,38,1
2020-04-30,India,NA,Assam,31205576,5,0,43,1
2020-05-01,India,NA,Assam,31205576,0,0,43,1
2020-05-02,India,NA,Assam,31205576,0,0,43,1
2020-05-03,India,NA,Assam,31205576,0,0,43,1
2020-05-04,India,NA,Assam,31205576,0,0,43,1
2020-05-05,India,NA,Assam,31205576,2,0,45,1
2020-05-06,India,NA,Assam,31205576,1,0,46,1
2020-05-07,India,NA,Assam,31205576,8,0,54,1
2020-05-08,India,NA,Assam,31205576,6,1,60,2
2020-05-09,India,NA,Assam,31205576,2,0,62,2
2020-05-10,India,NA,Assam,31205576,1,0,63,2
2020-05-11,India,NA,Assam,31205576,2,0,65,2
2020-05-12,India,NA,Assam,31205576,0,0,65,2
2020-05-13,India,NA,Assam,31205576,15,0,80,2
2020-05-14,India,NA,Assam,31205576,7,0,87,2
2020-05-15,India,NA,Assam,31205576,3,0,90,2
2020-05-16,India,NA,Assam,31205576,3,0,93,2
2020-05-17,India,NA,Assam,31205576,8,0,101,2
2020-05-18,India,NA,Assam,31205576,15,2,116,3
2020-05-19,India,NA,Assam,31205576,42,0,158,3
2020-05-20,India,NA,Assam,31205576,31,0,189,3
2020-05-21,India,NA,Assam,31205576,22,0,211,3
2020-05-22,India,NA,Assam,31205576,15,0,226,3
2020-05-23,India,NA,Assam,31205576,121,0,347,3
2020-05-24,India,NA,Assam,31205576,46,0,393,3
2020-05-25,India,NA,Assam,31205576,156,0,549,3
2020-05-26,India,NA,Assam,31205576,134,0,683,3
2020-05-27,India,NA,Assam,31205576,101,0,784,3
2020-05-28,India,NA,Assam,31205576,97,0,881,3
2020-05-29,India,NA,Assam,31205576,177,0,1058,3
2020-05-30,India,NA,Assam,31205576,159,0,1217,3
2020-05-31,India,NA,Assam,31205576,123,0,1340,3
2020-06-01,India,NA,Assam,31205576,146,0,1486,3
2020-06-02,India,NA,Assam,31205576,74,0,1560,3
2020-06-03,India,NA,Assam,31205576,271,0,1831,3
2020-06-04,India,NA,Assam,31205576,285,0,2116,3
2020-06-05,India,NA,Assam,31205576,128,0,2244,3
2020-06-06,India,NA,Assam,31205576,230,0,2474,3
2020-06-07,India,NA,Assam,31205576,208,0,2682,3
2020-06-08,India,NA,Assam,31205576,154,0,2836,3
2020-06-09,India,NA,Assam,31205576,215,1,3051,4
2020-06-10,India,NA,Assam,31205576,235,1,3286,5
2020-06-11,India,NA,Assam,31205576,145,0,3431,5
2020-06-12,India,NA,Assam,31205576,263,2,3694,7
2020-06-13,India,NA,Assam,31205576,207,0,3901,7
2020-06-14,India,NA,Assam,31205576,218,0,4119,7
2020-06-15,India,NA,Assam,31205576,191,0,4310,7
2020-06-16,India,NA,Assam,31205576,201,0,4511,7
2020-06-17,India,NA,Assam,31205576,184,0,4695,7
2020-06-18,India,NA,Assam,31205576,209,1,4904,8
2020-06-19,India,NA,Assam,31205576,0,0,4904,8
2020-06-20,India,NA,Assam,31205576,249,0,5153,8
2020-06-21,India,NA,Assam,31205576,332,0,5485,8
2020-06-22,India,NA,Assam,31205576,267,0,5752,8
2020-06-23,India,NA,Assam,31205576,203,0,5955,8
2020-06-24,India,NA,Assam,31205576,226,0,6181,8
2020-06-25,India,NA,Assam,31205576,364,0,6545,8
2020-06-26,India,NA,Assam,31205576,273,0,6818,8
2020-06-27,India,NA,Assam,31205576,246,1,7064,9
2020-06-28,India,NA,Assam,31205576,327,1,7391,10
2020-06-29,India,NA,Assam,31205576,302,0,7693,10
2020-06-30,India,NA,Assam,31205576,613,1,8306,11
2020-07-01,India,NA,Assam,31205576,548,0,8854,11
2020-07-02,India,NA,Assam,31205576,479,2,9333,13
2020-07-03,India,NA,Assam,31205576,365,0,9698,13
2020-07-04,India,NA,Assam,31205576,1202,0,10900,13
2020-07-05,India,NA,Assam,31205576,735,0,11635,13
2020-07-06,India,NA,Assam,31205576,786,0,12421,13
2020-07-07,India,NA,Assam,31205576,814,2,13235,15
2020-07-08,India,NA,Assam,31205576,696,6,13931,21
2020-07-09,India,NA,Assam,31205576,568,5,14499,26
2020-07-10,India,NA,Assam,31205576,936,8,15435,34
2020-07-11,India,NA,Assam,31205576,535,2,15970,36
2020-07-12,India,NA,Assam,31205576,735,4,16705,40
2020-07-13,India,NA,Assam,31205576,1001,4,17706,44
2020-07-14,India,NA,Assam,31205576,859,6,18565,50
2020-07-15,India,NA,Assam,31205576,1088,2,19653,52
2020-07-16,India,NA,Assam,31205576,892,2,20545,54
2020-07-17,India,NA,Assam,31205576,1218,1,21763,55
2020-07-18,India,NA,Assam,31205576,1117,2,22880,57
2020-07-19,India,NA,Assam,31205576,1018,4,23898,61
2020-07-20,India,NA,Assam,31205576,1093,1,24991,62
2020-07-21,India,NA,Assam,31205576,1680,6,26671,68
2020-07-22,India,NA,Assam,31205576,972,2,27643,70
2020-07-23,India,NA,Assam,31205576,1047,4,28690,74
2020-07-24,India,NA,Assam,31205576,1130,6,29820,80
2020-07-25,India,NA,Assam,31205576,1165,1,30985,81
2020-07-26,India,NA,Assam,31205576,1142,2,32127,83
2020-07-27,India,NA,Assam,31205576,1348,7,33475,90
2020-07-28,India,NA,Assam,31205576,1371,2,34846,92
2020-07-29,India,NA,Assam,31205576,1348,4,36194,96
2020-07-30,India,NA,Assam,31205576,2112,2,38306,98
2020-07-31,India,NA,Assam,31205576,1862,4,40168,102
2020-08-01,India,NA,Assam,31205576,1457,3,41625,105
2020-08-02,India,NA,Assam,31205576,1178,4,42803,109
2020-08-03,India,NA,Assam,31205576,2371,4,45174,113
2020-08-04,India,NA,Assam,31205576,2886,6,48060,119
2020-08-05,India,NA,Assam,31205576,2284,6,50344,125
2020-08-06,India,NA,Assam,31205576,2372,5,52716,130
2020-08-07,India,NA,Assam,31205576,2679,6,55395,136
2020-08-08,India,NA,Assam,31205576,2218,8,57613,144
2020-08-09,India,NA,Assam,31205576,1123,5,58736,149
2020-08-10,India,NA,Assam,31205576,2900,6,61636,155
2020-08-11,India,NA,Assam,31205576,2669,4,64305,159
2020-08-12,India,NA,Assam,31205576,4593,6,68898,165
2020-08-13,India,NA,Assam,31205576,2796,8,71694,173
2020-08-14,India,NA,Assam,31205576,2706,6,74400,179
2020-08-15,India,NA,Assam,31205576,1057,7,75457,186
2020-08-16,India,NA,Assam,31205576,1317,7,76774,193
2020-08-17,India,NA,Assam,31205576,2792,8,79566,201
2020-08-18,India,NA,Assam,31205576,2534,6,82100,207
2020-08-19,India,NA,Assam,31205576,2116,10,84216,217
2020-08-20,India,NA,Assam,31205576,1735,8,85951,225
2020-08-21,India,NA,Assam,31205576,1856,6,87807,231
2020-08-22,India,NA,Assam,31205576,1560,7,89367,238
2020-08-23,India,NA,Assam,31205576,1272,8,90639,246
2020-08-24,India,NA,Assam,31205576,1879,10,92518,256
2020-08-25,India,NA,Assam,31205576,1973,8,94491,264
2020-08-26,India,NA,Assam,31205576,2179,14,96670,278
2020-08-27,India,NA,Assam,31205576,2036,4,98706,282
2020-08-28,India,NA,Assam,31205576,2560,8,101266,290
2020-08-29,India,NA,Assam,31205576,2427,3,103693,293
2020-08-30,India,NA,Assam,31205576,1980,7,105673,300
2020-08-31,India,NA,Assam,31205576,3266,10,108939,310
2020-09-01,India,NA,Assam,31205576,2684,9,111623,319
2020-09-02,India,NA,Assam,31205576,3555,8,115178,327
2020-09-03,India,NA,Assam,31205576,3054,7,118232,334
2020-09-04,India,NA,Assam,31205576,2891,15,121123,349
2020-09-05,India,NA,Assam,31205576,2698,7,123821,356
2020-09-06,India,NA,Assam,31205576,1537,8,125358,364
2020-09-07,India,NA,Assam,31205576,2785,10,128143,374
2020-09-08,India,NA,Assam,31205576,2578,8,130721,382
2020-09-09,India,NA,Assam,31205576,2243,18,132964,400
2020-09-10,India,NA,Assam,31205576,2739,18,135703,418
2020-09-11,India,NA,Assam,31205576,2534,16,138237,434
2020-09-12,India,NA,Assam,31205576,2132,23,140369,457
2020-09-13,India,NA,Assam,31205576,1292,16,141661,473
2020-09-14,India,NA,Assam,31205576,2403,13,144064,486
2020-09-15,India,NA,Assam,31205576,2409,10,146473,496
2020-09-16,India,NA,Assam,31205576,2394,19,148867,515
2020-09-17,India,NA,Assam,31205576,1380,17,150247,532
2020-09-18,India,NA,Assam,31205576,2509,12,152756,544
2020-09-19,India,NA,Assam,31205576,2595,8,155351,552
2020-09-20,India,NA,Assam,31205576,1227,14,156578,566
2020-09-21,India,NA,Assam,31205576,2640,16,159218,582
2020-09-22,India,NA,Assam,31205576,2073,8,161291,590
2020-09-23,India,NA,Assam,31205576,2098,11,163389,601
2020-03-28,India,NA,Bihar,103804637,2,0,11,1
2020-03-29,India,NA,Bihar,103804637,4,0,15,1
2020-03-30,India,NA,Bihar,103804637,0,0,15,1
2020-03-31,India,NA,Bihar,103804637,6,0,21,1
2020-04-01,India,NA,Bihar,103804637,3,0,24,1
2020-04-02,India,NA,Bihar,103804637,5,0,29,1
2020-04-03,India,NA,Bihar,103804637,2,0,31,1
2020-04-04,India,NA,Bihar,103804637,1,0,32,1
2020-04-05,India,NA,Bihar,103804637,0,0,32,1
2020-04-06,India,NA,Bihar,103804637,0,0,32,1
2020-04-07,India,NA,Bihar,103804637,6,0,38,1
2020-04-08,India,NA,Bihar,103804637,1,0,39,1
2020-04-09,India,NA,Bihar,103804637,19,0,58,1
2020-04-10,India,NA,Bihar,103804637,2,0,60,1
2020-04-11,India,NA,Bihar,103804637,4,0,64,1
2020-04-12,India,NA,Bihar,103804637,0,0,64,1
2020-04-13,India,NA,Bihar,103804637,2,0,66,1
2020-04-14,India,NA,Bihar,103804637,0,0,66,1
2020-04-15,India,NA,Bihar,103804637,6,0,72,1
2020-04-16,India,NA,Bihar,103804637,11,0,83,1
2020-04-17,India,NA,Bihar,103804637,2,0,85,1
2020-04-18,India,NA,Bihar,103804637,1,1,86,2
2020-04-19,India,NA,Bihar,103804637,10,0,96,2
2020-04-20,India,NA,Bihar,103804637,17,0,113,2
2020-04-21,India,NA,Bihar,103804637,13,0,126,2
2020-04-22,India,NA,Bihar,103804637,17,0,143,2
2020-04-23,India,NA,Bihar,103804637,27,0,170,2
2020-04-24,India,NA,Bihar,103804637,53,0,223,2
2020-04-25,India,NA,Bihar,103804637,28,0,251,2
2020-04-26,India,NA,Bihar,103804637,26,0,277,2
2020-04-27,India,NA,Bihar,103804637,69,0,346,2
2020-04-28,India,NA,Bihar,103804637,20,0,366,2
2020-04-29,India,NA,Bihar,103804637,37,0,403,2
2020-04-30,India,NA,Bihar,103804637,22,0,425,2
2020-05-01,India,NA,Bihar,103804637,41,1,466,3
2020-05-02,India,NA,Bihar,103804637,15,1,481,4
2020-05-03,India,NA,Bihar,103804637,36,0,517,4
2020-05-04,India,NA,Bihar,103804637,11,0,528,4
2020-05-05,India,NA,Bihar,103804637,7,0,535,4
2020-05-06,India,NA,Bihar,103804637,7,0,542,4
2020-05-07,India,NA,Bihar,103804637,8,1,550,5
2020-05-08,India,NA,Bihar,103804637,29,0,579,5
2020-05-09,India,NA,Bihar,103804637,32,0,611,5
2020-05-10,India,NA,Bihar,103804637,96,1,707,6
2020-05-11,India,NA,Bihar,103804637,42,0,749,6
2020-05-12,India,NA,Bihar,103804637,130,0,879,6
2020-05-13,India,NA,Bihar,103804637,74,1,953,7
2020-05-14,India,NA,Bihar,103804637,46,0,999,7
2020-05-15,India,NA,Bihar,103804637,34,0,1033,7
2020-05-16,India,NA,Bihar,103804637,145,1,1178,8
2020-05-17,India,NA,Bihar,103804637,142,0,1320,8
2020-05-18,India,NA,Bihar,103804637,103,1,1423,9
2020-05-19,India,NA,Bihar,103804637,96,0,1519,9
2020-05-20,India,NA,Bihar,103804637,257,0,1776,9
2020-05-21,India,NA,Bihar,103804637,211,0,1987,9
2020-05-22,India,NA,Bihar,103804637,179,2,2166,11
2020-05-23,India,NA,Bihar,103804637,228,0,2394,11
2020-05-24,India,NA,Bihar,103804637,180,0,2574,11
2020-05-25,India,NA,Bihar,103804637,163,2,2737,13
2020-05-26,India,NA,Bihar,103804637,231,1,2968,14
2020-05-27,India,NA,Bihar,103804637,68,1,3036,15
2020-05-28,India,NA,Bihar,103804637,149,0,3185,15
2020-05-29,India,NA,Bihar,103804637,174,0,3359,15
2020-05-30,India,NA,Bihar,103804637,206,6,3565,21
2020-05-31,India,NA,Bihar,103804637,242,2,3807,23
2020-06-01,India,NA,Bihar,103804637,138,0,3945,23
2020-06-02,India,NA,Bihar,103804637,151,1,4096,24
2020-06-03,India,NA,Bihar,103804637,230,1,4326,25
2020-06-04,India,NA,Bihar,103804637,126,3,4452,28
2020-06-05,India,NA,Bihar,103804637,146,1,4598,29
2020-06-06,India,NA,Bihar,103804637,233,0,4831,29
2020-06-07,India,NA,Bihar,103804637,239,1,5070,30
2020-06-08,India,NA,Bihar,103804637,177,1,5247,31
2020-06-09,India,NA,Bihar,103804637,208,2,5455,33
2020-06-10,India,NA,Bihar,103804637,243,1,5698,34
2020-06-11,India,NA,Bihar,103804637,250,0,5948,34
2020-06-12,India,NA,Bihar,103804637,148,1,6096,35
2020-06-13,India,NA,Bihar,103804637,193,0,6289,35
2020-06-14,India,NA,Bihar,103804637,186,1,6475,36
2020-06-15,India,NA,Bihar,103804637,187,2,6662,38
2020-06-16,India,NA,Bihar,103804637,148,1,6810,39
2020-06-17,India,NA,Bihar,103804637,130,0,6940,39
2020-06-18,India,NA,Bihar,103804637,100,5,7040,44
2020-06-19,India,NA,Bihar,103804637,250,5,7290,49
2020-06-20,India,NA,Bihar,103804637,213,0,7503,49
2020-06-21,India,NA,Bihar,103804637,162,2,7665,51
2020-06-22,India,NA,Bihar,103804637,228,1,7893,52
2020-06-23,India,NA,Bihar,103804637,157,2,8050,54
2020-06-24,India,NA,Bihar,103804637,223,1,8273,55
2020-06-25,India,NA,Bihar,103804637,215,1,8488,56
2020-06-26,India,NA,Bihar,103804637,190,0,8678,56
2020-06-27,India,NA,Bihar,103804637,302,2,8980,58
2020-06-28,India,NA,Bihar,103804637,244,4,9224,62
2020-06-29,India,NA,Bihar,103804637,394,1,9618,63
2020-06-30,India,NA,Bihar,103804637,370,5,9988,68
2020-07-01,India,NA,Bihar,103804637,216,5,10204,73
2020-07-02,India,NA,Bihar,103804637,478,5,10682,78
2020-07-03,India,NA,Bihar,103804637,426,6,11108,84
2020-07-04,India,NA,Bihar,103804637,349,4,11457,88
2020-07-05,India,NA,Bihar,103804637,403,2,11860,90
2020-07-06,India,NA,Bihar,103804637,280,7,12140,97
2020-07-07,India,NA,Bihar,103804637,385,1,12525,98
2020-07-08,India,NA,Bihar,103804637,749,2,13274,100
2020-07-09,India,NA,Bihar,103804637,704,9,13978,109
2020-07-10,India,NA,Bihar,103804637,352,2,14330,111
2020-07-11,India,NA,Bihar,103804637,709,7,15039,118
2020-07-12,India,NA,Bihar,103804637,1266,7,16305,125
2020-07-13,India,NA,Bihar,103804637,1116,9,17421,134
2020-07-14,India,NA,Bihar,103804637,1432,9,18853,143
2020-07-15,India,NA,Bihar,103804637,1320,14,20173,157
2020-07-16,India,NA,Bihar,103804637,1385,10,21558,167
2020-07-17,India,NA,Bihar,103804637,1742,6,23300,173
2020-07-18,India,NA,Bihar,103804637,1667,4,24967,177
2020-07-19,India,NA,Bihar,103804637,1412,2,26379,179
2020-07-20,India,NA,Bihar,103804637,1076,8,27455,187
2020-07-21,India,NA,Bihar,103804637,1109,11,28564,198
2020-07-22,India,NA,Bihar,103804637,1502,10,30066,208
2020-07-23,India,NA,Bihar,103804637,1625,4,31691,212
2020-07-24,India,NA,Bihar,103804637,1820,9,33511,221
2020-07-25,India,NA,Bihar,103804637,2803,11,36314,232
2020-07-26,India,NA,Bihar,103804637,2605,17,38919,249
2020-07-27,India,NA,Bihar,103804637,2192,6,41111,255
2020-07-28,India,NA,Bihar,103804637,2480,14,43591,269
2020-07-29,India,NA,Bihar,103804637,2328,4,45919,273
2020-07-30,India,NA,Bihar,103804637,2082,12,48001,285
2020-07-31,India,NA,Bihar,103804637,2986,13,50987,298
2020-08-01,India,NA,Bihar,103804637,3521,14,54508,312
2020-08-02,India,NA,Bihar,103804637,2762,10,57270,322
2020-08-03,India,NA,Bihar,103804637,2297,14,59567,336
2020-08-04,India,NA,Bihar,103804637,2464,13,62031,349
2020-08-05,India,NA,Bihar,103804637,2701,20,64732,369
2020-08-06,India,NA,Bihar,103804637,3416,19,68148,388
2020-08-07,India,NA,Bihar,103804637,3646,12,71794,400
2020-08-08,India,NA,Bihar,103804637,3992,19,75786,419
2020-08-09,India,NA,Bihar,103804637,3934,10,79720,429
2020-08-10,India,NA,Bihar,103804637,3021,21,82741,450
2020-08-11,India,NA,Bihar,103804637,4071,15,86812,465
2020-08-12,India,NA,Bihar,103804637,3741,9,90553,474
2020-08-13,India,NA,Bihar,103804637,3906,10,94459,484
2020-08-14,India,NA,Bihar,103804637,3911,16,98370,500
2020-08-15,India,NA,Bihar,103804637,3536,15,101906,515
2020-08-16,India,NA,Bihar,103804637,2187,22,104093,537
2020-08-17,India,NA,Bihar,103804637,2525,5,106618,542
2020-08-18,India,NA,Bihar,103804637,3257,16,109875,558
2020-08-19,India,NA,Bihar,103804637,2884,10,112759,568
2020-08-20,India,NA,Bihar,103804637,2451,6,115210,574
2020-08-21,India,NA,Bihar,103804637,2461,14,117671,588
2020-08-22,India,NA,Bihar,103804637,2238,13,119909,601
2020-08-23,India,NA,Bihar,103804637,2247,9,122156,610
2020-08-24,India,NA,Bihar,103804637,1227,17,123383,627
2020-08-25,India,NA,Bihar,103804637,1444,17,124827,644
2020-08-26,India,NA,Bihar,103804637,2163,9,126990,653
2020-08-27,India,NA,Bihar,103804637,1860,9,128850,662
2020-08-28,India,NA,Bihar,103804637,1998,12,130848,674
2020-08-29,India,NA,Bihar,103804637,2087,5,132935,679
2020-08-30,India,NA,Bihar,103804637,2078,9,135013,688
2020-08-31,India,NA,Bihar,103804637,1324,6,136337,694
2020-09-01,India,NA,Bihar,103804637,1928,15,138265,709
2020-09-02,India,NA,Bihar,103804637,1969,13,140234,722
2020-09-03,India,NA,Bihar,103804637,1922,6,142156,728
2020-09-04,India,NA,Bihar,103804637,1978,13,144134,741
2020-09-05,India,NA,Bihar,103804637,1727,9,145861,750
2020-09-06,India,NA,Bihar,103804637,1797,4,147658,754
2020-09-07,India,NA,Bihar,103804637,1369,7,149027,761
2020-09-08,India,NA,Bihar,103804637,1667,4,150694,765
2020-09-09,India,NA,Bihar,103804637,1498,10,152192,775
2020-09-10,India,NA,Bihar,103804637,1543,10,153735,785
2020-09-11,India,NA,Bihar,103804637,1710,12,155445,797
2020-09-12,India,NA,Bihar,103804637,1421,11,156866,808
2020-09-13,India,NA,Bihar,103804637,1523,14,158389,822
2020-09-14,India,NA,Bihar,103804637,1137,9,159526,831
2020-09-15,India,NA,Bihar,103804637,1575,5,161101,836
2020-09-16,India,NA,Bihar,103804637,1531,12,162632,848
2020-09-17,India,NA,Bihar,103804637,1592,7,164224,855
2020-09-18,India,NA,Bihar,103804637,1147,4,165371,859
2020-09-19,India,NA,Bihar,103804637,1616,2,166987,861
2020-09-20,India,NA,Bihar,103804637,1555,3,168542,864
2020-09-21,India,NA,Bihar,103804637,1314,6,169856,870
2020-09-22,India,NA,Bihar,103804637,1609,3,171465,873
2020-09-23,India,NA,Bihar,103804637,1598,1,173063,874
2020-03-30,India,NA,Chandigarh,1055450,5,0,13,0
2020-03-31,India,NA,Chandigarh,1055450,2,0,15,0
2020-04-01,India,NA,Chandigarh,1055450,2,0,17,0
2020-04-02,India,NA,Chandigarh,1055450,1,0,18,0
2020-04-03,India,NA,Chandigarh,1055450,0,0,18,0
2020-04-04,India,NA,Chandigarh,1055450,0,0,18,0
2020-04-05,India,NA,Chandigarh,1055450,0,0,18,0
2020-04-06,India,NA,Chandigarh,1055450,0,0,18,0
2020-04-07,India,NA,Chandigarh,1055450,0,0,18,0
2020-04-08,India,NA,Chandigarh,1055450,0,0,18,0
2020-04-09,India,NA,Chandigarh,1055450,0,0,18,0
2020-04-10,India,NA,Chandigarh,1055450,1,0,19,0
2020-04-11,India,NA,Chandigarh,1055450,0,0,19,0
2020-04-12,India,NA,Chandigarh,1055450,2,0,21,0
2020-04-13,India,NA,Chandigarh,1055450,0,0,21,0
2020-04-14,India,NA,Chandigarh,1055450,0,0,21,0
2020-04-15,India,NA,Chandigarh,1055450,0,0,21,0
2020-04-16,India,NA,Chandigarh,1055450,0,0,21,0
2020-04-17,India,NA,Chandigarh,1055450,0,0,21,0
2020-04-18,India,NA,Chandigarh,1055450,2,0,23,0
2020-04-19,India,NA,Chandigarh,1055450,3,0,26,0
2020-04-20,India,NA,Chandigarh,1055450,0,0,26,0
2020-04-21,India,NA,Chandigarh,1055450,1,0,27,0
2020-04-22,India,NA,Chandigarh,1055450,0,0,27,0
2020-04-23,India,NA,Chandigarh,1055450,0,0,27,0
2020-04-24,India,NA,Chandigarh,1055450,0,0,27,0
2020-04-25,India,NA,Chandigarh,1055450,1,0,28,0
2020-04-26,India,NA,Chandigarh,1055450,8,0,36,0
2020-04-27,India,NA,Chandigarh,1055450,9,0,45,0
2020-04-28,India,NA,Chandigarh,1055450,11,0,56,0
2020-04-29,India,NA,Chandigarh,1055450,12,0,68,0
2020-04-30,India,NA,Chandigarh,1055450,6,0,74,0
2020-05-01,India,NA,Chandigarh,1055450,14,0,88,0
2020-05-02,India,NA,Chandigarh,1055450,6,0,94,0
2020-05-03,India,NA,Chandigarh,1055450,3,1,97,1
2020-05-04,India,NA,Chandigarh,1055450,5,0,102,1
2020-05-05,India,NA,Chandigarh,1055450,17,0,119,1
2020-05-06,India,NA,Chandigarh,1055450,5,0,124,1
2020-05-07,India,NA,Chandigarh,1055450,11,0,135,1
2020-05-08,India,NA,Chandigarh,1055450,11,1,146,2
2020-05-09,India,NA,Chandigarh,1055450,23,0,169,2
2020-05-10,India,NA,Chandigarh,1055450,4,1,173,3
2020-05-11,India,NA,Chandigarh,1055450,8,0,181,3
2020-05-12,India,NA,Chandigarh,1055450,6,0,187,3
2020-05-13,India,NA,Chandigarh,1055450,4,0,191,3
2020-05-14,India,NA,Chandigarh,1055450,0,0,191,3
2020-05-15,India,NA,Chandigarh,1055450,0,0,191,3
2020-05-16,India,NA,Chandigarh,1055450,0,0,191,3
2020-05-17,India,NA,Chandigarh,1055450,0,0,191,3
2020-05-18,India,NA,Chandigarh,1055450,5,0,196,3
2020-05-19,India,NA,Chandigarh,1055450,3,0,199,3
2020-05-20,India,NA,Chandigarh,1055450,3,0,202,3
2020-05-21,India,NA,Chandigarh,1055450,16,0,218,3
2020-05-22,India,NA,Chandigarh,1055450,1,0,219,3
2020-05-23,India,NA,Chandigarh,1055450,6,0,225,3
2020-05-24,India,NA,Chandigarh,1055450,37,1,262,4
2020-05-25,India,NA,Chandigarh,1055450,4,0,266,4
2020-05-26,India,NA,Chandigarh,1055450,12,0,278,4
2020-05-27,India,NA,Chandigarh,1055450,1,0,279,4
2020-05-28,India,NA,Chandigarh,1055450,10,0,289,4
2020-05-29,India,NA,Chandigarh,1055450,0,0,289,4
2020-05-30,India,NA,Chandigarh,1055450,0,0,289,4
2020-05-31,India,NA,Chandigarh,1055450,4,0,293,4
2020-06-01,India,NA,Chandigarh,1055450,4,0,297,4
2020-06-02,India,NA,Chandigarh,1055450,4,1,301,5
2020-06-03,India,NA,Chandigarh,1055450,0,0,301,5
2020-06-04,India,NA,Chandigarh,1055450,1,0,302,5
2020-06-05,India,NA,Chandigarh,1055450,7,0,309,5
2020-06-06,India,NA,Chandigarh,1055450,3,0,312,5
2020-06-07,India,NA,Chandigarh,1055450,2,0,314,5
2020-06-08,India,NA,Chandigarh,1055450,6,0,320,5
2020-06-09,India,NA,Chandigarh,1055450,6,0,326,5
2020-06-10,India,NA,Chandigarh,1055450,2,0,328,5
2020-06-11,India,NA,Chandigarh,1055450,4,0,332,5
2020-06-12,India,NA,Chandigarh,1055450,13,0,345,5
2020-06-13,India,NA,Chandigarh,1055450,5,0,350,5
2020-06-14,India,NA,Chandigarh,1055450,2,0,352,5
2020-06-15,India,NA,Chandigarh,1055450,5,1,357,6
2020-06-16,India,NA,Chandigarh,1055450,8,0,365,6
2020-06-17,India,NA,Chandigarh,1055450,5,0,370,6
2020-06-18,India,NA,Chandigarh,1055450,4,0,374,6
2020-06-19,India,NA,Chandigarh,1055450,7,0,381,6
2020-06-20,India,NA,Chandigarh,1055450,23,0,404,6
2020-06-21,India,NA,Chandigarh,1055450,2,0,406,6
2020-06-22,India,NA,Chandigarh,1055450,5,0,411,6
2020-06-23,India,NA,Chandigarh,1055450,7,0,418,6
2020-06-24,India,NA,Chandigarh,1055450,2,0,420,6
2020-06-25,India,NA,Chandigarh,1055450,3,0,423,6
2020-06-26,India,NA,Chandigarh,1055450,2,0,425,6
2020-06-27,India,NA,Chandigarh,1055450,3,0,428,6
2020-06-28,India,NA,Chandigarh,1055450,3,0,431,6
2020-06-29,India,NA,Chandigarh,1055450,3,0,434,6
2020-06-30,India,NA,Chandigarh,1055450,6,0,440,6
2020-07-01,India,NA,Chandigarh,1055450,6,0,446,6
2020-07-02,India,NA,Chandigarh,1055450,4,0,450,6
2020-07-03,India,NA,Chandigarh,1055450,4,0,454,6
2020-07-04,India,NA,Chandigarh,1055450,5,0,459,6
2020-07-05,India,NA,Chandigarh,1055450,7,0,466,6
2020-07-06,India,NA,Chandigarh,1055450,21,0,487,6
2020-07-07,India,NA,Chandigarh,1055450,5,1,492,7
2020-07-08,India,NA,Chandigarh,1055450,15,0,507,7
2020-07-09,India,NA,Chandigarh,1055450,16,0,523,7
2020-07-10,India,NA,Chandigarh,1055450,13,0,536,7
2020-07-11,India,NA,Chandigarh,1055450,13,1,549,8
2020-07-12,India,NA,Chandigarh,1055450,10,0,559,8
2020-07-13,India,NA,Chandigarh,1055450,29,0,588,8
2020-07-14,India,NA,Chandigarh,1055450,12,2,600,10
2020-07-15,India,NA,Chandigarh,1055450,19,1,619,11
2020-07-16,India,NA,Chandigarh,1055450,16,0,635,11
2020-07-17,India,NA,Chandigarh,1055450,25,0,660,11
2020-07-18,India,NA,Chandigarh,1055450,31,1,691,12
2020-07-19,India,NA,Chandigarh,1055450,26,0,717,12
2020-07-20,India,NA,Chandigarh,1055450,20,0,737,12
2020-07-21,India,NA,Chandigarh,1055450,14,0,751,12
2020-07-22,India,NA,Chandigarh,1055450,29,1,780,13
2020-07-23,India,NA,Chandigarh,1055450,20,0,800,13
2020-07-24,India,NA,Chandigarh,1055450,23,0,823,13
2020-07-25,India,NA,Chandigarh,1055450,29,0,852,13
2020-07-26,India,NA,Chandigarh,1055450,35,0,887,13
2020-07-27,India,NA,Chandigarh,1055450,23,1,910,14
2020-07-28,India,NA,Chandigarh,1055450,24,0,934,14
2020-07-29,India,NA,Chandigarh,1055450,44,0,978,14
2020-07-30,India,NA,Chandigarh,1055450,38,0,1016,14
2020-07-31,India,NA,Chandigarh,1055450,35,1,1051,15
2020-08-01,India,NA,Chandigarh,1055450,28,3,1079,18
2020-08-02,India,NA,Chandigarh,1055450,38,1,1117,19
2020-08-03,India,NA,Chandigarh,1055450,43,0,1160,19
2020-08-04,India,NA,Chandigarh,1055450,46,1,1206,20
2020-08-05,India,NA,Chandigarh,1055450,64,0,1270,20
2020-08-06,India,NA,Chandigarh,1055450,57,0,1327,20
2020-08-07,India,NA,Chandigarh,1055450,47,3,1374,23
2020-08-08,India,NA,Chandigarh,1055450,52,1,1426,24
2020-08-09,India,NA,Chandigarh,1055450,89,1,1515,25
2020-08-10,India,NA,Chandigarh,1055450,80,0,1595,25
2020-08-11,India,NA,Chandigarh,1055450,75,1,1670,26
2020-08-12,India,NA,Chandigarh,1055450,81,1,1751,27
2020-08-13,India,NA,Chandigarh,1055450,91,1,1842,28
2020-08-14,India,NA,Chandigarh,1055450,86,0,1928,28
2020-08-15,India,NA,Chandigarh,1055450,81,0,2009,28
2020-08-16,India,NA,Chandigarh,1055450,93,1,2102,29
2020-08-17,India,NA,Chandigarh,1055450,114,1,2216,30
2020-08-18,India,NA,Chandigarh,1055450,89,0,2305,30
2020-08-19,India,NA,Chandigarh,1055450,91,1,2396,31
2020-08-20,India,NA,Chandigarh,1055450,119,0,2515,31
2020-08-21,India,NA,Chandigarh,1055450,116,2,2631,33
2020-08-22,India,NA,Chandigarh,1055450,145,0,2776,33
2020-08-23,India,NA,Chandigarh,1055450,142,4,2918,37
2020-08-24,India,NA,Chandigarh,1055450,117,0,3035,37
2020-08-25,India,NA,Chandigarh,1055450,174,3,3209,40
2020-08-26,India,NA,Chandigarh,1055450,167,1,3376,41
2020-08-27,India,NA,Chandigarh,1055450,188,2,3564,43
2020-08-28,India,NA,Chandigarh,1055450,160,2,3724,45
2020-08-29,India,NA,Chandigarh,1055450,261,0,3985,45
2020-08-30,India,NA,Chandigarh,1055450,170,7,4155,52
2020-08-31,India,NA,Chandigarh,1055450,191,4,4346,56
2020-09-01,India,NA,Chandigarh,1055450,204,1,4550,57
2020-09-02,India,NA,Chandigarh,1055450,239,2,4789,59
2020-09-03,India,NA,Chandigarh,1055450,276,4,5065,63
2020-09-04,India,NA,Chandigarh,1055450,203,5,5268,68
2020-09-05,India,NA,Chandigarh,1055450,234,1,5502,69
2020-09-06,India,NA,Chandigarh,1055450,261,2,5763,71
2020-09-07,India,NA,Chandigarh,1055450,232,3,5995,74
2020-09-08,India,NA,Chandigarh,1055450,377,1,6372,75
2020-09-09,India,NA,Chandigarh,1055450,332,2,6704,77
2020-09-10,India,NA,Chandigarh,1055450,283,3,6987,80
2020-09-11,India,NA,Chandigarh,1055450,305,3,7292,83
2020-09-12,India,NA,Chandigarh,1055450,250,6,7542,89
2020-09-13,India,NA,Chandigarh,1055450,449,1,7991,90
2020-09-14,India,NA,Chandigarh,1055450,254,5,8245,95
2020-09-15,India,NA,Chandigarh,1055450,347,1,8592,96
2020-09-16,India,NA,Chandigarh,1055450,366,5,8958,101
2020-09-17,India,NA,Chandigarh,1055450,288,5,9246,106
2020-09-18,India,NA,Chandigarh,1055450,260,4,9506,110
2020-09-19,India,NA,Chandigarh,1055450,290,6,9796,116
2020-09-20,India,NA,Chandigarh,1055450,286,4,10082,120
2020-09-21,India,NA,Chandigarh,1055450,216,3,10298,123
2020-09-22,India,NA,Chandigarh,1055450,248,4,10546,127
2020-09-23,India,NA,Chandigarh,1055450,180,10,10726,137
2020-04-09,India,NA,Chhattisgarh,25545198,8,0,18,0
2020-04-10,India,NA,Chhattisgarh,25545198,0,0,18,0
2020-04-11,India,NA,Chhattisgarh,25545198,7,0,25,0
2020-04-12,India,NA,Chhattisgarh,25545198,6,0,31,0
2020-04-13,India,NA,Chhattisgarh,25545198,0,0,31,0
2020-04-14,India,NA,Chhattisgarh,25545198,2,0,33,0
2020-04-15,India,NA,Chhattisgarh,25545198,0,0,33,0
2020-04-16,India,NA,Chhattisgarh,25545198,3,0,36,0
2020-04-17,India,NA,Chhattisgarh,25545198,0,0,36,0
2020-04-18,India,NA,Chhattisgarh,25545198,0,0,36,0
2020-04-19,India,NA,Chhattisgarh,25545198,0,0,36,0
2020-04-20,India,NA,Chhattisgarh,25545198,0,0,36,0
2020-04-21,India,NA,Chhattisgarh,25545198,0,0,36,0
2020-04-22,India,NA,Chhattisgarh,25545198,0,0,36,0
2020-04-23,India,NA,Chhattisgarh,25545198,0,0,36,0
2020-04-24,India,NA,Chhattisgarh,25545198,0,0,36,0
2020-04-25,India,NA,Chhattisgarh,25545198,1,0,37,0
2020-04-26,India,NA,Chhattisgarh,25545198,0,0,37,0
2020-04-27,India,NA,Chhattisgarh,25545198,0,0,37,0
2020-04-28,India,NA,Chhattisgarh,25545198,1,0,38,0
2020-04-29,India,NA,Chhattisgarh,25545198,0,0,38,0
2020-04-30,India,NA,Chhattisgarh,25545198,2,0,40,0
2020-05-01,India,NA,Chhattisgarh,25545198,3,0,43,0
2020-05-02,India,NA,Chhattisgarh,25545198,0,0,43,0
2020-05-03,India,NA,Chhattisgarh,25545198,14,0,57,0
2020-05-04,India,NA,Chhattisgarh,25545198,1,0,58,0
2020-05-05,India,NA,Chhattisgarh,25545198,1,0,59,0
2020-05-06,India,NA,Chhattisgarh,25545198,0,0,59,0
2020-05-07,India,NA,Chhattisgarh,25545198,0,0,59,0
2020-05-08,India,NA,Chhattisgarh,25545198,0,0,59,0
2020-05-09,India,NA,Chhattisgarh,25545198,0,0,59,0
2020-05-10,India,NA,Chhattisgarh,25545198,0,0,59,0
2020-05-11,India,NA,Chhattisgarh,25545198,0,0,59,0
2020-05-12,India,NA,Chhattisgarh,25545198,0,0,59,0
2020-05-13,India,NA,Chhattisgarh,25545198,0,0,59,0
2020-05-14,India,NA,Chhattisgarh,25545198,1,0,60,0
2020-05-15,India,NA,Chhattisgarh,25545198,6,0,66,0
2020-05-16,India,NA,Chhattisgarh,25545198,1,0,67,0
2020-05-17,India,NA,Chhattisgarh,25545198,18,0,85,0
2020-05-18,India,NA,Chhattisgarh,25545198,10,0,95,0
2020-05-19,India,NA,Chhattisgarh,25545198,5,0,100,0
2020-05-20,India,NA,Chhattisgarh,25545198,14,0,114,0
2020-05-21,India,NA,Chhattisgarh,25545198,14,0,128,0
2020-05-22,India,NA,Chhattisgarh,25545198,44,0,172,0
2020-05-23,India,NA,Chhattisgarh,25545198,42,0,214,0
2020-05-24,India,NA,Chhattisgarh,25545198,38,0,252,0
2020-05-25,India,NA,Chhattisgarh,25545198,40,0,292,0
2020-05-26,India,NA,Chhattisgarh,25545198,68,0,360,0
2020-05-27,India,NA,Chhattisgarh,25545198,4,0,364,0
2020-05-28,India,NA,Chhattisgarh,25545198,34,0,398,0
2020-05-29,India,NA,Chhattisgarh,25545198,17,1,415,1
2020-05-30,India,NA,Chhattisgarh,25545198,32,0,447,1
2020-05-31,India,NA,Chhattisgarh,25545198,51,0,498,1
2020-06-01,India,NA,Chhattisgarh,25545198,49,0,547,1
2020-06-02,India,NA,Chhattisgarh,25545198,15,1,562,2
2020-06-03,India,NA,Chhattisgarh,25545198,64,0,626,2
2020-06-04,India,NA,Chhattisgarh,25545198,147,0,773,2
2020-06-05,India,NA,Chhattisgarh,25545198,90,0,863,2
2020-06-06,India,NA,Chhattisgarh,25545198,60,2,923,4
2020-06-07,India,NA,Chhattisgarh,25545198,150,0,1073,4
2020-06-08,India,NA,Chhattisgarh,25545198,124,0,1197,4
2020-06-09,India,NA,Chhattisgarh,25545198,14,1,1211,5
2020-06-10,India,NA,Chhattisgarh,25545198,51,1,1262,6
2020-06-11,India,NA,Chhattisgarh,25545198,136,0,1398,6
2020-06-12,India,NA,Chhattisgarh,25545198,47,0,1445,6
2020-06-13,India,NA,Chhattisgarh,25545198,105,0,1550,6
2020-06-14,India,NA,Chhattisgarh,25545198,121,3,1671,9
2020-06-15,India,NA,Chhattisgarh,25545198,44,0,1715,9
2020-06-16,India,NA,Chhattisgarh,25545198,69,0,1784,9
2020-06-17,India,NA,Chhattisgarh,25545198,80,0,1864,9
2020-06-18,India,NA,Chhattisgarh,25545198,82,0,1946,9
2020-06-19,India,NA,Chhattisgarh,25545198,72,1,2018,10
2020-06-20,India,NA,Chhattisgarh,25545198,116,1,2134,11
2020-06-21,India,NA,Chhattisgarh,25545198,121,0,2255,11
2020-06-22,India,NA,Chhattisgarh,25545198,47,1,2302,12
2020-06-23,India,NA,Chhattisgarh,25545198,83,0,2385,12
2020-06-24,India,NA,Chhattisgarh,25545198,34,0,2419,12
2020-06-25,India,NA,Chhattisgarh,25545198,37,0,2456,12
2020-06-26,India,NA,Chhattisgarh,25545198,89,1,2545,13
2020-06-27,India,NA,Chhattisgarh,25545198,65,0,2610,13
2020-06-28,India,NA,Chhattisgarh,25545198,84,0,2694,13
2020-06-29,India,NA,Chhattisgarh,25545198,101,0,2795,13
2020-06-30,India,NA,Chhattisgarh,25545198,63,0,2858,13
2020-07-01,India,NA,Chhattisgarh,25545198,82,1,2940,14
2020-07-02,India,NA,Chhattisgarh,25545198,73,0,3013,14
2020-07-03,India,NA,Chhattisgarh,25545198,52,0,3065,14
2020-07-04,India,NA,Chhattisgarh,25545198,96,0,3161,14
2020-07-05,India,NA,Chhattisgarh,25545198,46,0,3207,14
2020-07-06,India,NA,Chhattisgarh,25545198,98,0,3305,14
2020-07-07,India,NA,Chhattisgarh,25545198,110,0,3415,14
2020-07-08,India,NA,Chhattisgarh,25545198,111,0,3526,14
2020-07-09,India,NA,Chhattisgarh,25545198,140,1,3666,15
2020-07-10,India,NA,Chhattisgarh,25545198,166,2,3832,17
2020-07-11,India,NA,Chhattisgarh,25545198,65,0,3897,17
2020-07-12,India,NA,Chhattisgarh,25545198,184,2,4081,19
2020-07-13,India,NA,Chhattisgarh,25545198,184,0,4265,19
2020-07-14,India,NA,Chhattisgarh,25545198,114,1,4379,20
2020-07-15,India,NA,Chhattisgarh,25545198,177,0,4556,20
2020-07-16,India,NA,Chhattisgarh,25545198,198,1,4754,21
2020-07-17,India,NA,Chhattisgarh,25545198,249,3,5003,24
2020-07-18,India,NA,Chhattisgarh,25545198,243,0,5246,24
2020-07-19,India,NA,Chhattisgarh,25545198,161,0,5407,24
2020-07-20,India,NA,Chhattisgarh,25545198,191,4,5598,28
2020-07-21,India,NA,Chhattisgarh,25545198,133,1,5731,29
2020-07-22,India,NA,Chhattisgarh,25545198,268,0,5999,29
2020-07-23,India,NA,Chhattisgarh,25545198,371,5,6370,34
2020-07-24,India,NA,Chhattisgarh,25545198,449,2,6819,36
2020-07-25,India,NA,Chhattisgarh,25545198,363,3,7182,39
2020-07-26,India,NA,Chhattisgarh,25545198,431,4,7613,43
2020-07-27,India,NA,Chhattisgarh,25545198,367,2,7980,45
2020-07-28,India,NA,Chhattisgarh,25545198,306,1,8286,46
2020-07-29,India,NA,Chhattisgarh,25545198,314,4,8600,50
2020-07-30,India,NA,Chhattisgarh,25545198,256,1,8856,51
2020-07-31,India,NA,Chhattisgarh,25545198,336,3,9192,54
2020-08-01,India,NA,Chhattisgarh,25545198,235,1,9427,55
2020-08-02,India,NA,Chhattisgarh,25545198,181,3,9608,58
2020-08-03,India,NA,Chhattisgarh,25545198,212,3,9820,61
2020-08-04,India,NA,Chhattisgarh,25545198,382,8,10202,69
2020-08-05,India,NA,Chhattisgarh,25545198,295,2,10497,71
2020-08-06,India,NA,Chhattisgarh,25545198,523,6,11020,77
2020-08-07,India,NA,Chhattisgarh,25545198,388,10,11408,87
2020-08-08,India,NA,Chhattisgarh,25545198,447,3,11855,90
2020-08-09,India,NA,Chhattisgarh,25545198,293,6,12148,96
2020-08-10,India,NA,Chhattisgarh,25545198,477,3,12625,99
2020-08-11,India,NA,Chhattisgarh,25545198,360,5,12985,104
2020-08-12,India,NA,Chhattisgarh,25545198,567,5,13552,109
2020-08-13,India,NA,Chhattisgarh,25545198,478,8,14030,117
2020-08-14,India,NA,Chhattisgarh,25545198,529,13,14559,130
2020-08-15,India,NA,Chhattisgarh,25545198,486,4,15045,134
2020-08-16,India,NA,Chhattisgarh,25545198,576,8,15621,142
2020-08-17,India,NA,Chhattisgarh,25545198,404,8,16025,150
2020-08-18,India,NA,Chhattisgarh,25545198,808,8,16833,158
2020-08-19,India,NA,Chhattisgarh,25545198,752,6,17585,164
2020-08-20,India,NA,Chhattisgarh,25545198,1052,8,18637,172
2020-08-21,India,NA,Chhattisgarh,25545198,873,8,19510,180
2020-08-22,India,NA,Chhattisgarh,25545198,704,10,20214,190
2020-08-23,India,NA,Chhattisgarh,25545198,704,7,20918,197
2020-08-24,India,NA,Chhattisgarh,25545198,1136,9,22054,206
2020-08-25,India,NA,Chhattisgarh,25545198,1287,15,23341,221
2020-08-26,India,NA,Chhattisgarh,25545198,1209,10,24550,231
2020-08-27,India,NA,Chhattisgarh,25545198,1438,14,25988,245
2020-08-28,India,NA,Chhattisgarh,25545198,1245,6,27233,251
2020-08-29,India,NA,Chhattisgarh,25545198,1513,11,28746,262
2020-08-30,India,NA,Chhattisgarh,25545198,1346,7,30092,269
2020-08-31,India,NA,Chhattisgarh,25545198,1411,8,31503,277
2020-09-01,India,NA,Chhattisgarh,25545198,1884,10,33387,287
2020-09-02,India,NA,Chhattisgarh,25545198,2296,12,35683,299
2020-09-03,India,NA,Chhattisgarh,25545198,2284,16,37967,315
2020-09-04,India,NA,Chhattisgarh,25545198,2667,22,40634,337
2020-09-05,India,NA,Chhattisgarh,25545198,2529,19,43163,356
2020-09-06,India,NA,Chhattisgarh,25545198,2100,24,45263,380
2020-09-07,India,NA,Chhattisgarh,25545198,2017,15,47280,395
2020-09-08,India,NA,Chhattisgarh,25545198,2834,12,50114,407
2020-09-09,India,NA,Chhattisgarh,25545198,2818,70,52932,477
2020-09-10,India,NA,Chhattisgarh,25545198,2748,16,55680,493
2020-09-11,India,NA,Chhattisgarh,25545198,2963,25,58643,518
2020-09-12,India,NA,Chhattisgarh,25545198,3120,21,61763,539
2020-09-13,India,NA,Chhattisgarh,25545198,2228,16,63991,555
2020-09-14,India,NA,Chhattisgarh,25545198,3336,18,67327,573
2020-09-15,India,NA,Chhattisgarh,25545198,3450,15,70777,588
2020-09-16,India,NA,Chhattisgarh,25545198,3189,23,73966,611
2020-09-17,India,NA,Chhattisgarh,25545198,3809,17,77775,628
2020-09-18,India,NA,Chhattisgarh,25545198,3842,17,81617,645
2020-09-19,India,NA,Chhattisgarh,25545198,2617,19,84234,664
2020-09-20,India,NA,Chhattisgarh,25545198,1949,13,86183,677
2020-09-21,India,NA,Chhattisgarh,25545198,1998,13,88181,690
2020-09-22,India,NA,Chhattisgarh,25545198,2736,28,90917,718
2020-09-23,India,NA,Chhattisgarh,25545198,2434,10,93351,728
2020-06-03,India,NA,Dadra and Nagar Haveli and Daman and Diu,342853,8,0,11,0
2020-06-04,India,NA,Dadra and Nagar Haveli and Daman and Diu,342853,3,0,14,0
2020-06-05,India,NA,Dadra and Nagar Haveli and Daman and Diu,342853,0,0,14,0
2020-06-06,India,NA,Dadra and Nagar Haveli and Daman and Diu,342853,5,0,19,0
2020-06-07,India,NA,Dadra and Nagar Haveli and Daman and Diu,342853,1,0,20,0
2020-06-08,India,NA,Dadra and Nagar Haveli and Daman and Diu,342853,2,0,22,0
2020-06-09,India,NA,Dadra and Nagar Haveli and Daman and Diu,342853,2,0,24,0
2020-06-10,India,NA,Dadra and Nagar Haveli and Daman and Diu,342853,5,0,29,0
2020-06-11,India,NA,Dadra and Nagar Haveli and Daman and Diu,342853,1,0,30,0
2020-06-12,India,NA,Dadra and Nagar Haveli and Daman and Diu,342853,0,0,30,0
2020-06-13,India,NA,Dadra and Nagar Haveli and Daman and Diu,342853,5,0,35,0
2020-06-14,India,NA,Dadra and Nagar Haveli and Daman and Diu,342853,4,0,39,0
2020-06-15,India,NA,Dadra and Nagar Haveli and Daman and Diu,342853,0,0,39,0
2020-06-16,India,NA,Dadra and Nagar Haveli and Daman and Diu,342853,15,0,54,0
2020-06-17,India,NA,Dadra and Nagar Haveli and Daman and Diu,342853,5,0,59,0
2020-06-18,India,NA,Dadra and Nagar Haveli and Daman and Diu,342853,4,0,63,0
2020-06-19,India,NA,Dadra and Nagar Haveli and Daman and Diu,342853,14,0,77,0
2020-06-20,India,NA,Dadra and Nagar Haveli and Daman and Diu,342853,17,0,94,0
2020-06-21,India,NA,Dadra and Nagar Haveli and Daman and Diu,342853,5,0,99,0
2020-06-22,India,NA,Dadra and Nagar Haveli and Daman and Diu,342853,15,0,114,0
2020-06-23,India,NA,Dadra and Nagar Haveli and Daman and Diu,342853,9,0,123,0
2020-06-24,India,NA,Dadra and Nagar Haveli and Daman and Diu,342853,13,0,136,0
2020-06-25,India,NA,Dadra and Nagar Haveli and Daman and Diu,342853,20,0,156,0
2020-06-26,India,NA,Dadra and Nagar Haveli and Daman and Diu,342853,15,0,171,0
2020-06-27,India,NA,Dadra and Nagar Haveli and Daman and Diu,342853,15,0,186,0
2020-06-28,India,NA,Dadra and Nagar Haveli and Daman and Diu,342853,4,0,190,0
2020-06-29,India,NA,Dadra and Nagar Haveli and Daman and Diu,342853,15,0,205,0
2020-06-30,India,NA,Dadra and Nagar Haveli and Daman and Diu,342853,10,0,215,0
2020-07-01,India,NA,Dadra and Nagar Haveli and Daman and Diu,342853,16,0,231,0
2020-07-02,India,NA,Dadra and Nagar Haveli and Daman and Diu,342853,25,0,256,0
2020-07-03,India,NA,Dadra and Nagar Haveli and Daman and Diu,342853,50,0,306,0
2020-07-04,India,NA,Dadra and Nagar Haveli and Daman and Diu,342853,37,0,343,0
2020-07-05,India,NA,Dadra and Nagar Haveli and Daman and Diu,342853,32,0,375,0
2020-07-06,India,NA,Dadra and Nagar Haveli and Daman and Diu,342853,27,0,402,0
2020-07-07,India,NA,Dadra and Nagar Haveli and Daman and Diu,342853,27,1,429,1
2020-07-08,India,NA,Dadra and Nagar Haveli and Daman and Diu,342853,15,0,444,1
2020-07-09,India,NA,Dadra and Nagar Haveli and Daman and Diu,342853,14,0,458,1
2020-07-10,India,NA,Dadra and Nagar Haveli and Daman and Diu,342853,14,0,472,1
2020-07-11,India,NA,Dadra and Nagar Haveli and Daman and Diu,342853,14,0,486,1
2020-07-12,India,NA,Dadra and Nagar Haveli and Daman and Diu,342853,16,0,502,1
2020-07-13,India,NA,Dadra and Nagar Haveli and Daman and Diu,342853,25,0,527,1
2020-07-14,India,NA,Dadra and Nagar Haveli and Daman and Diu,342853,16,0,543,1
2020-07-15,India,NA,Dadra and Nagar Haveli and Daman and Diu,342853,17,1,560,2
2020-07-16,India,NA,Dadra and Nagar Haveli and Daman and Diu,342853,18,0,578,2
2020-07-17,India,NA,Dadra and Nagar Haveli and Daman and Diu,342853,32,0,610,2
2020-07-18,India,NA,Dadra and Nagar Haveli and Daman and Diu,342853,45,0,655,2
2020-07-19,India,NA,Dadra and Nagar Haveli and Daman and Diu,342853,37,0,692,2
2020-07-20,India,NA,Dadra and Nagar Haveli and Daman and Diu,342853,21,0,713,2
2020-07-21,India,NA,Dadra and Nagar Haveli and Daman and Diu,342853,28,0,741,2
2020-07-22,India,NA,Dadra and Nagar Haveli and Daman and Diu,342853,36,0,777,2
2020-07-23,India,NA,Dadra and Nagar Haveli and Daman and Diu,342853,45,0,822,2
2020-07-24,India,NA,Dadra and Nagar Haveli and Daman and Diu,342853,44,0,866,2
2020-07-25,India,NA,Dadra and Nagar Haveli and Daman and Diu,342853,37,0,903,2
2020-07-26,India,NA,Dadra and Nagar Haveli and Daman and Diu,342853,49,0,952,2
2020-07-27,India,NA,Dadra and Nagar Haveli and Daman and Diu,342853,36,0,988,2
2020-07-28,India,NA,Dadra and Nagar Haveli and Daman and Diu,342853,44,0,1032,2
2020-07-29,India,NA,Dadra and Nagar Haveli and Daman and Diu,342853,38,0,1070,2
2020-07-30,India,NA,Dadra and Nagar Haveli and Daman and Diu,342853,35,0,1105,2
2020-07-31,India,NA,Dadra and Nagar Haveli and Daman and Diu,342853,46,0,1151,2
2020-08-01,India,NA,Dadra and Nagar Haveli and Daman and Diu,342853,45,0,1196,2
2020-08-02,India,NA,Dadra and Nagar Haveli and Daman and Diu,342853,55,0,1251,2
2020-08-03,India,NA,Dadra and Nagar Haveli and Daman and Diu,342853,35,0,1286,2
2020-08-04,India,NA,Dadra and Nagar Haveli and Daman and Diu,342853,43,0,1329,2
2020-08-05,India,NA,Dadra and Nagar Haveli and Daman and Diu,342853,45,0,1374,2
2020-08-06,India,NA,Dadra and Nagar Haveli and Daman and Diu,342853,43,0,1417,2
2020-08-07,India,NA,Dadra and Nagar Haveli and Daman and Diu,342853,44,0,1461,2
2020-08-08,India,NA,Dadra and Nagar Haveli and Daman and Diu,342853,51,0,1512,2
2020-08-09,India,NA,Dadra and Nagar Haveli and Daman and Diu,342853,45,0,1557,2
2020-08-10,India,NA,Dadra and Nagar Haveli and Daman and Diu,342853,62,0,1619,2
2020-08-11,India,NA,Dadra and Nagar Haveli and Daman and Diu,342853,39,0,1658,2
2020-08-12,India,NA,Dadra and Nagar Haveli and Daman and Diu,342853,39,0,1697,2
2020-08-13,India,NA,Dadra and Nagar Haveli and Daman and Diu,342853,46,0,1743,2
2020-08-14,India,NA,Dadra and Nagar Haveli and Daman and Diu,342853,41,0,1784,2
2020-08-15,India,NA,Dadra and Nagar Haveli and Daman and Diu,342853,64,0,1848,2
2020-08-16,India,NA,Dadra and Nagar Haveli and Daman and Diu,342853,35,0,1883,2
2020-08-17,India,NA,Dadra and Nagar Haveli and Daman and Diu,342853,27,0,1910,2
2020-08-18,India,NA,Dadra and Nagar Haveli and Daman and Diu,342853,51,0,1961,2
2020-08-19,India,NA,Dadra and Nagar Haveli and Daman and Diu,342853,37,0,1998,2
2020-08-20,India,NA,Dadra and Nagar Haveli and Daman and Diu,342853,34,0,2032,2
2020-08-21,India,NA,Dadra and Nagar Haveli and Daman and Diu,342853,53,0,2085,2
2020-08-22,India,NA,Dadra and Nagar Haveli and Daman and Diu,342853,40,0,2125,2
2020-08-23,India,NA,Dadra and Nagar Haveli and Daman and Diu,342853,36,0,2161,2
2020-08-24,India,NA,Dadra and Nagar Haveli and Daman and Diu,342853,18,0,2179,2
2020-08-25,India,NA,Dadra and Nagar Haveli and Daman and Diu,342853,21,0,2200,2
2020-08-26,India,NA,Dadra and Nagar Haveli and Daman and Diu,342853,22,0,2222,2
2020-08-27,India,NA,Dadra and Nagar Haveli and Daman and Diu,342853,42,0,2264,2
2020-08-28,India,NA,Dadra and Nagar Haveli and Daman and Diu,342853,31,0,2295,2
2020-08-29,India,NA,Dadra and Nagar Haveli and Daman and Diu,342853,15,0,2310,2
2020-08-30,India,NA,Dadra and Nagar Haveli and Daman and Diu,342853,32,0,2342,2
2020-08-31,India,NA,Dadra and Nagar Haveli and Daman and Diu,342853,27,0,2369,2
2020-09-01,India,NA,Dadra and Nagar Haveli and Daman and Diu,342853,19,0,2388,2
2020-09-02,India,NA,Dadra and Nagar Haveli and Daman and Diu,342853,44,0,2432,2
2020-09-03,India,NA,Dadra and Nagar Haveli and Daman and Diu,342853,29,0,2461,2
2020-09-04,India,NA,Dadra and Nagar Haveli and Daman and Diu,342853,51,0,2512,2
2020-09-05,India,NA,Dadra and Nagar Haveli and Daman and Diu,342853,21,0,2533,2
2020-09-06,India,NA,Dadra and Nagar Haveli and Daman and Diu,342853,38,0,2571,2
2020-09-07,India,NA,Dadra and Nagar Haveli and Daman and Diu,342853,15,0,2586,2
2020-09-08,India,NA,Dadra and Nagar Haveli and Daman and Diu,342853,27,0,2613,2
2020-09-09,India,NA,Dadra and Nagar Haveli and Daman and Diu,342853,26,0,2639,2
2020-09-10,India,NA,Dadra and Nagar Haveli and Daman and Diu,342853,28,0,2667,2
2020-09-11,India,NA,Dadra and Nagar Haveli and Daman and Diu,342853,25,0,2692,2
2020-09-12,India,NA,Dadra and Nagar Haveli and Daman and Diu,342853,29,0,2721,2
2020-09-13,India,NA,Dadra and Nagar Haveli and Daman and Diu,342853,20,0,2741,2
2020-09-14,India,NA,Dadra and Nagar Haveli and Daman and Diu,342853,24,0,2765,2
2020-09-15,India,NA,Dadra and Nagar Haveli and Daman and Diu,342853,18,0,2783,2
2020-09-16,India,NA,Dadra and Nagar Haveli and Daman and Diu,342853,27,0,2810,2
2020-09-17,India,NA,Dadra and Nagar Haveli and Daman and Diu,342853,21,0,2831,2
2020-09-18,India,NA,Dadra and Nagar Haveli and Daman and Diu,342853,28,0,2859,2
2020-09-19,India,NA,Dadra and Nagar Haveli and Daman and Diu,342853,28,0,2887,2
2020-09-20,India,NA,Dadra and Nagar Haveli and Daman and Diu,342853,37,0,2924,2
2020-09-21,India,NA,Dadra and Nagar Haveli and Daman and Diu,342853,9,0,2933,2
2020-09-22,India,NA,Dadra and Nagar Haveli and Daman and Diu,342853,11,0,2944,2
2020-09-23,India,NA,Dadra and Nagar Haveli and Daman and Diu,342853,18,0,2962,2
2020-03-19,India,NA,Delhi,26495000,4,0,14,1
2020-03-20,India,NA,Delhi,26495000,6,0,20,1
2020-03-21,India,NA,Delhi,26495000,7,0,27,1
2020-03-22,India,NA,Delhi,26495000,0,0,27,1
2020-03-23,India,NA,Delhi,26495000,3,0,30,1
2020-03-24,India,NA,Delhi,26495000,0,0,30,1
2020-03-25,India,NA,Delhi,26495000,5,0,35,1
2020-03-26,India,NA,Delhi,26495000,1,0,36,1
2020-03-27,India,NA,Delhi,26495000,4,0,40,1
2020-03-28,India,NA,Delhi,26495000,9,0,49,1
2020-03-29,India,NA,Delhi,26495000,23,1,72,2
2020-03-30,India,NA,Delhi,26495000,25,0,97,2
2020-03-31,India,NA,Delhi,26495000,23,0,120,2
2020-04-01,India,NA,Delhi,26495000,32,0,152,2
2020-04-02,India,NA,Delhi,26495000,141,2,293,4
2020-04-03,India,NA,Delhi,26495000,93,2,386,6
2020-04-04,India,NA,Delhi,26495000,59,0,445,6
2020-04-05,India,NA,Delhi,26495000,58,1,503,7
2020-04-06,India,NA,Delhi,26495000,22,0,525,7
2020-04-07,India,NA,Delhi,26495000,51,2,576,9
2020-04-08,India,NA,Delhi,26495000,93,0,669,9
2020-04-09,India,NA,Delhi,26495000,51,3,720,12
2020-04-10,India,NA,Delhi,26495000,183,2,903,14
2020-04-11,India,NA,Delhi,26495000,166,5,1069,19
2020-04-12,India,NA,Delhi,26495000,85,5,1154,24
2020-04-13,India,NA,Delhi,26495000,356,4,1510,28
2020-04-14,India,NA,Delhi,26495000,51,2,1561,30
2020-04-15,India,NA,Delhi,26495000,17,2,1578,32
2020-04-16,India,NA,Delhi,26495000,62,6,1640,38
2020-04-17,India,NA,Delhi,26495000,67,4,1707,42
2020-04-18,India,NA,Delhi,26495000,186,1,1893,43
2020-04-19,India,NA,Delhi,26495000,110,2,2003,45
2020-04-20,India,NA,Delhi,26495000,78,2,2081,47
2020-04-21,India,NA,Delhi,26495000,75,0,2156,47
2020-04-22,India,NA,Delhi,26495000,92,1,2248,48
2020-04-23,India,NA,Delhi,26495000,128,2,2376,50
2020-04-24,India,NA,Delhi,26495000,138,3,2514,53
2020-04-25,India,NA,Delhi,26495000,111,1,2625,54
2020-04-26,India,NA,Delhi,26495000,293,0,2918,54
2020-04-27,India,NA,Delhi,26495000,190,0,3108,54
2020-04-28,India,NA,Delhi,26495000,206,0,3314,54
2020-04-29,India,NA,Delhi,26495000,125,2,3439,56
2020-04-30,India,NA,Delhi,26495000,76,3,3515,59
2020-05-01,India,NA,Delhi,26495000,223,2,3738,61
2020-05-02,India,NA,Delhi,26495000,384,3,4122,64
2020-05-03,India,NA,Delhi,26495000,427,0,4549,64
2020-05-04,India,NA,Delhi,26495000,349,0,4898,64
2020-05-05,India,NA,Delhi,26495000,206,0,5104,64
2020-05-06,India,NA,Delhi,26495000,428,1,5532,65
2020-05-07,India,NA,Delhi,26495000,448,1,5980,66
2020-05-08,India,NA,Delhi,26495000,338,2,6318,68
2020-05-09,India,NA,Delhi,26495000,224,0,6542,68
2020-05-10,India,NA,Delhi,26495000,381,5,6923,73
2020-05-11,India,NA,Delhi,26495000,310,0,7233,73
2020-05-12,India,NA,Delhi,26495000,406,13,7639,86
2020-05-13,India,NA,Delhi,26495000,359,20,7998,106
2020-05-14,India,NA,Delhi,26495000,472,9,8470,115
2020-05-15,India,NA,Delhi,26495000,425,8,8895,123
2020-05-16,India,NA,Delhi,26495000,438,6,9333,129
2020-05-17,India,NA,Delhi,26495000,422,19,9755,148
2020-05-18,India,NA,Delhi,26495000,299,12,10054,160
2020-05-19,India,NA,Delhi,26495000,500,6,10554,166
2020-05-20,India,NA,Delhi,26495000,534,10,11088,176
2020-05-21,India,NA,Delhi,26495000,571,18,11659,194
2020-05-22,India,NA,Delhi,26495000,660,14,12319,208
2020-05-23,India,NA,Delhi,26495000,591,23,12910,231
2020-05-24,India,NA,Delhi,26495000,508,30,13418,261
2020-05-25,India,NA,Delhi,26495000,635,15,14053,276
2020-05-26,India,NA,Delhi,26495000,412,12,14465,288
2020-05-27,India,NA,Delhi,26495000,792,15,15257,303
2020-05-28,India,NA,Delhi,26495000,1024,13,16281,316
2020-05-29,India,NA,Delhi,26495000,1105,82,17386,398
2020-05-30,India,NA,Delhi,26495000,1163,18,18549,416
2020-05-31,India,NA,Delhi,26495000,1295,57,19844,473
2020-06-01,India,NA,Delhi,26495000,990,50,20834,523
2020-06-02,India,NA,Delhi,26495000,1298,33,22132,556
2020-06-03,India,NA,Delhi,26495000,1513,59,23645,615
2020-06-04,India,NA,Delhi,26495000,1359,44,25004,659
2020-06-05,India,NA,Delhi,26495000,1330,49,26334,708
2020-06-06,India,NA,Delhi,26495000,1320,53,27654,761
2020-06-07,India,NA,Delhi,26495000,1282,51,28936,812
2020-06-08,India,NA,Delhi,26495000,1007,62,29943,874
2020-06-09,India,NA,Delhi,26495000,1366,31,31309,905
2020-06-10,India,NA,Delhi,26495000,1501,79,32810,984
2020-06-11,India,NA,Delhi,26495000,1877,101,34687,1085
2020-06-12,India,NA,Delhi,26495000,2137,129,36824,1214
2020-06-13,India,NA,Delhi,26495000,2134,57,38958,1271
2020-06-14,India,NA,Delhi,26495000,2224,56,41182,1327
2020-06-15,India,NA,Delhi,26495000,1647,73,42829,1400
2020-06-16,India,NA,Delhi,26495000,1859,437,44688,1837
2020-06-17,India,NA,Delhi,26495000,2414,67,47102,1904
2020-06-18,India,NA,Delhi,26495000,2877,65,49979,1969
2020-06-19,India,NA,Delhi,26495000,3137,66,53116,2035
2020-06-20,India,NA,Delhi,26495000,3630,77,56746,2112
2020-06-21,India,NA,Delhi,26495000,3000,63,59746,2175
2020-06-22,India,NA,Delhi,26495000,2909,58,62655,2233
2020-06-23,India,NA,Delhi,26495000,3947,68,66602,2301
2020-06-24,India,NA,Delhi,26495000,3788,64,70390,2365
2020-06-25,India,NA,Delhi,26495000,3390,64,73780,2429
2020-06-26,India,NA,Delhi,26495000,3460,63,77240,2492
2020-06-27,India,NA,Delhi,26495000,2948,66,80188,2558
2020-06-28,India,NA,Delhi,26495000,2889,65,83077,2623
2020-06-29,India,NA,Delhi,26495000,2084,57,85161,2680
2020-06-30,India,NA,Delhi,26495000,2199,62,87360,2742
2020-07-01,India,NA,Delhi,26495000,2442,61,89802,2803
2020-07-02,India,NA,Delhi,26495000,2373,61,92175,2864
2020-07-03,India,NA,Delhi,26495000,2520,59,94695,2923
2020-07-04,India,NA,Delhi,26495000,2505,81,97200,3004
2020-07-05,India,NA,Delhi,26495000,2244,63,99444,3067
2020-07-06,India,NA,Delhi,26495000,1379,48,100823,3115
2020-07-07,India,NA,Delhi,26495000,2008,50,102831,3165
2020-07-08,India,NA,Delhi,26495000,2033,48,104864,3213
2020-07-09,India,NA,Delhi,26495000,2187,45,107051,3258
2020-07-10,India,NA,Delhi,26495000,2089,42,109140,3300
2020-07-11,India,NA,Delhi,26495000,1781,34,110921,3334
2020-07-12,India,NA,Delhi,26495000,1573,37,112494,3371
2020-07-13,India,NA,Delhi,26495000,1246,40,113740,3411
2020-07-14,India,NA,Delhi,26495000,1606,35,115346,3446
2020-07-15,India,NA,Delhi,26495000,1647,41,116993,3487
2020-07-16,India,NA,Delhi,26495000,1652,58,118645,3545
2020-07-17,India,NA,Delhi,26495000,1462,26,120107,3571
2020-07-18,India,NA,Delhi,26495000,1475,26,121582,3597
2020-07-19,India,NA,Delhi,26495000,1211,31,122793,3628
2020-07-20,India,NA,Delhi,26495000,954,35,123747,3663
2020-07-21,India,NA,Delhi,26495000,1349,27,125096,3690
2020-07-22,India,NA,Delhi,26495000,1227,29,126323,3719
2020-07-23,India,NA,Delhi,26495000,1041,26,127364,3745
2020-07-24,India,NA,Delhi,26495000,1025,32,128389,3777
2020-07-25,India,NA,Delhi,26495000,1142,29,129531,3806
2020-07-26,India,NA,Delhi,26495000,1075,21,130606,3827
2020-07-27,India,NA,Delhi,26495000,613,26,131219,3853
2020-07-28,India,NA,Delhi,26495000,1056,28,132275,3881
2020-07-29,India,NA,Delhi,26495000,1035,26,133310,3907
2020-07-30,India,NA,Delhi,26495000,1093,29,134403,3936
2020-07-31,India,NA,Delhi,26495000,1195,27,135598,3963
2020-08-01,India,NA,Delhi,26495000,1118,26,136716,3989
2020-08-02,India,NA,Delhi,26495000,961,15,137677,4004
2020-08-03,India,NA,Delhi,26495000,805,17,138482,4021
2020-08-04,India,NA,Delhi,26495000,674,12,139156,4033
2020-08-05,India,NA,Delhi,26495000,1076,11,140232,4044
2020-08-06,India,NA,Delhi,26495000,1299,15,141531,4059
2020-08-07,India,NA,Delhi,26495000,1192,23,142723,4082
2020-08-08,India,NA,Delhi,26495000,1404,16,144127,4098
2020-08-09,India,NA,Delhi,26495000,1300,13,145427,4111
2020-08-10,India,NA,Delhi,26495000,707,20,146134,4131
2020-08-11,India,NA,Delhi,26495000,1257,8,147391,4139
2020-08-12,India,NA,Delhi,26495000,1113,14,148504,4153
2020-08-13,India,NA,Delhi,26495000,956,14,149460,4167
2020-08-14,India,NA,Delhi,26495000,1192,11,150652,4178
2020-08-15,India,NA,Delhi,26495000,1276,10,151928,4188
2020-08-16,India,NA,Delhi,26495000,652,8,152580,4196
2020-08-17,India,NA,Delhi,26495000,787,18,153367,4214
2020-08-18,India,NA,Delhi,26495000,1374,12,154741,4226
2020-08-19,India,NA,Delhi,26495000,1398,9,156139,4235
2020-08-20,India,NA,Delhi,26495000,1215,22,157354,4257
2020-08-21,India,NA,Delhi,26495000,1250,13,158604,4270
2020-08-22,India,NA,Delhi,26495000,1412,14,160016,4284
2020-08-23,India,NA,Delhi,26495000,1450,16,161466,4300
2020-08-24,India,NA,Delhi,26495000,1061,13,162527,4313
2020-08-25,India,NA,Delhi,26495000,1544,17,164071,4330
2020-08-26,India,NA,Delhi,26495000,1693,17,165764,4347
2020-08-27,India,NA,Delhi,26495000,1840,22,167604,4369
2020-08-28,India,NA,Delhi,26495000,1808,20,169412,4389
2020-08-29,India,NA,Delhi,26495000,1954,15,171366,4404
2020-08-30,India,NA,Delhi,26495000,2024,22,173390,4426
2020-08-31,India,NA,Delhi,26495000,1358,18,174748,4444
2020-09-01,India,NA,Delhi,26495000,2312,18,177060,4462
2020-09-02,India,NA,Delhi,26495000,2509,19,179569,4481
2020-09-03,India,NA,Delhi,26495000,2737,19,182306,4500
2020-09-04,India,NA,Delhi,26495000,2914,13,185220,4513
2020-09-05,India,NA,Delhi,26495000,2973,25,188193,4538
2020-09-06,India,NA,Delhi,26495000,3256,29,191449,4567
2020-09-07,India,NA,Delhi,26495000,2077,32,193526,4599
2020-09-08,India,NA,Delhi,26495000,3609,19,197135,4618
2020-09-09,India,NA,Delhi,26495000,4039,20,201174,4638
2020-09-10,India,NA,Delhi,26495000,4308,28,205482,4666
2020-09-11,India,NA,Delhi,26495000,4266,21,209748,4687
2020-09-12,India,NA,Delhi,26495000,4321,28,214069,4715
2020-09-13,India,NA,Delhi,26495000,4235,29,218304,4744
2020-09-14,India,NA,Delhi,26495000,3229,26,221533,4770
2020-09-15,India,NA,Delhi,26495000,4263,36,225796,4806
2020-09-16,India,NA,Delhi,26495000,4473,33,230269,4839
2020-09-17,India,NA,Delhi,26495000,4432,38,234701,4877
2020-09-18,India,NA,Delhi,26495000,4127,30,238828,4907
2020-09-19,India,NA,Delhi,26495000,4071,38,242899,4945
2020-09-20,India,NA,Delhi,26495000,3812,37,246711,4982
2020-09-21,India,NA,Delhi,26495000,2548,32,249259,5014
2020-09-22,India,NA,Delhi,26495000,3816,37,253075,5051
2020-09-23,India,NA,Delhi,26495000,3714,36,256789,5087
2020-05-14,India,NA,Goa,1458545,8,0,15,0
2020-05-15,India,NA,Goa,1458545,0,0,15,0
2020-05-16,India,NA,Goa,1458545,5,0,20,0
2020-05-17,India,NA,Goa,1458545,9,0,29,0
2020-05-18,India,NA,Goa,1458545,9,0,38,0
2020-05-19,India,NA,Goa,1458545,8,0,46,0
2020-05-20,India,NA,Goa,1458545,4,0,50,0
2020-05-21,India,NA,Goa,1458545,2,0,52,0
2020-05-22,India,NA,Goa,1458545,2,0,54,0
2020-05-23,India,NA,Goa,1458545,1,0,55,0
2020-05-24,India,NA,Goa,1458545,11,0,66,0
2020-05-25,India,NA,Goa,1458545,1,0,67,0
2020-05-26,India,NA,Goa,1458545,0,0,67,0
2020-05-27,India,NA,Goa,1458545,1,0,68,0
2020-05-28,India,NA,Goa,1458545,1,0,69,0
2020-05-29,India,NA,Goa,1458545,0,0,69,0
2020-05-30,India,NA,Goa,1458545,1,0,70,0
2020-05-31,India,NA,Goa,1458545,1,0,71,0
2020-06-01,India,NA,Goa,1458545,2,0,73,0
2020-06-02,India,NA,Goa,1458545,6,0,79,0
2020-06-03,India,NA,Goa,1458545,47,0,126,0
2020-06-04,India,NA,Goa,1458545,40,0,166,0
2020-06-05,India,NA,Goa,1458545,30,0,196,0
2020-06-06,India,NA,Goa,1458545,71,0,267,0
2020-06-07,India,NA,Goa,1458545,33,0,300,0
2020-06-08,India,NA,Goa,1458545,30,0,330,0
2020-06-09,India,NA,Goa,1458545,29,0,359,0
2020-06-10,India,NA,Goa,1458545,28,0,387,0
2020-06-11,India,NA,Goa,1458545,30,0,417,0
2020-06-12,India,NA,Goa,1458545,46,0,463,0
2020-06-13,India,NA,Goa,1458545,60,0,523,0
2020-06-14,India,NA,Goa,1458545,41,0,564,0
2020-06-15,India,NA,Goa,1458545,28,0,592,0
2020-06-16,India,NA,Goa,1458545,37,0,629,0
2020-06-17,India,NA,Goa,1458545,27,0,656,0
2020-06-18,India,NA,Goa,1458545,49,0,705,0
2020-06-19,India,NA,Goa,1458545,20,0,725,0
2020-06-20,India,NA,Goa,1458545,29,0,754,0
2020-06-21,India,NA,Goa,1458545,64,0,818,0
2020-06-22,India,NA,Goa,1458545,46,1,864,1
2020-06-23,India,NA,Goa,1458545,45,1,909,2
2020-06-24,India,NA,Goa,1458545,42,0,951,2
2020-06-25,India,NA,Goa,1458545,44,0,995,2
2020-06-26,India,NA,Goa,1458545,44,0,1039,2
2020-06-27,India,NA,Goa,1458545,89,0,1128,2
2020-06-28,India,NA,Goa,1458545,70,1,1198,3
2020-06-29,India,NA,Goa,1458545,53,0,1251,3
2020-06-30,India,NA,Goa,1458545,64,0,1315,3
2020-07-01,India,NA,Goa,1458545,72,1,1387,4
2020-07-02,India,NA,Goa,1458545,95,0,1482,4
2020-07-03,India,NA,Goa,1458545,94,0,1576,4
2020-07-04,India,NA,Goa,1458545,108,2,1684,6
2020-07-05,India,NA,Goa,1458545,77,1,1761,7
2020-07-06,India,NA,Goa,1458545,52,0,1813,7
2020-07-07,India,NA,Goa,1458545,90,1,1903,8
2020-07-08,India,NA,Goa,1458545,136,0,2039,8
2020-07-09,India,NA,Goa,1458545,112,1,2151,9
2020-07-10,India,NA,Goa,1458545,100,0,2251,9
2020-07-11,India,NA,Goa,1458545,117,3,2368,12
2020-07-12,India,NA,Goa,1458545,85,2,2453,14
2020-07-13,India,NA,Goa,1458545,130,3,2583,17
2020-07-14,India,NA,Goa,1458545,170,1,2753,18
2020-07-15,India,NA,Goa,1458545,198,0,2951,18
2020-07-16,India,NA,Goa,1458545,157,1,3108,19
2020-07-17,India,NA,Goa,1458545,196,2,3304,21
2020-07-18,India,NA,Goa,1458545,180,0,3484,21
2020-07-19,India,NA,Goa,1458545,173,1,3657,22
2020-07-20,India,NA,Goa,1458545,196,1,3853,23
2020-07-21,India,NA,Goa,1458545,174,3,4027,26
2020-07-22,India,NA,Goa,1458545,149,2,4176,28
2020-07-23,India,NA,Goa,1458545,174,1,4350,29
2020-07-24,India,NA,Goa,1458545,190,0,4540,29
2020-07-25,India,NA,Goa,1458545,146,4,4686,33
2020-07-26,India,NA,Goa,1458545,175,2,4861,35
2020-07-27,India,NA,Goa,1458545,258,1,5119,36
2020-07-28,India,NA,Goa,1458545,168,0,5287,36
2020-07-29,India,NA,Goa,1458545,202,3,5489,39
2020-07-30,India,NA,Goa,1458545,215,3,5704,42
2020-07-31,India,NA,Goa,1458545,209,3,5913,45
2020-08-01,India,NA,Goa,1458545,280,3,6193,48
2020-08-02,India,NA,Goa,1458545,337,5,6530,53
2020-08-03,India,NA,Goa,1458545,286,3,6816,56
2020-08-04,India,NA,Goa,1458545,259,4,7075,60
2020-08-05,India,NA,Goa,1458545,348,4,7423,64
2020-08-06,India,NA,Goa,1458545,191,2,7614,66
2020-08-07,India,NA,Goa,1458545,333,4,7947,70
2020-08-08,India,NA,Goa,1458545,259,2,8206,72
2020-08-09,India,NA,Goa,1458545,506,3,8712,75
2020-08-10,India,NA,Goa,1458545,317,5,9029,80
2020-08-11,India,NA,Goa,1458545,415,6,9444,86
2020-08-12,India,NA,Goa,1458545,480,3,9924,89
2020-08-13,India,NA,Goa,1458545,570,2,10494,91
2020-08-14,India,NA,Goa,1458545,476,2,10970,93
2020-08-15,India,NA,Goa,1458545,369,5,11339,98
2020-08-16,India,NA,Goa,1458545,300,6,11639,104
2020-08-17,India,NA,Goa,1458545,355,7,11994,111
2020-08-18,India,NA,Goa,1458545,339,5,12333,116
2020-08-19,India,NA,Goa,1458545,342,8,12675,124
2020-08-20,India,NA,Goa,1458545,424,2,13099,126
2020-08-21,India,NA,Goa,1458545,385,9,13484,135
2020-08-22,India,NA,Goa,1458545,306,5,13790,140
2020-08-23,India,NA,Goa,1458545,209,4,13999,144
2020-08-24,India,NA,Goa,1458545,139,4,14138,148
2020-08-25,India,NA,Goa,1458545,392,9,14530,157
2020-08-26,India,NA,Goa,1458545,497,8,15027,165
2020-08-27,India,NA,Goa,1458545,456,6,15483,171
2020-08-28,India,NA,Goa,1458545,523,4,16006,175
2020-08-29,India,NA,Goa,1458545,547,3,16553,178
2020-08-30,India,NA,Goa,1458545,451,5,17004,183
2020-08-31,India,NA,Goa,1458545,414,9,17418,192
2020-09-01,India,NA,Goa,1458545,588,2,18006,194
2020-09-02,India,NA,Goa,1458545,636,10,18642,204
2020-09-03,India,NA,Goa,1458545,713,8,19355,212
2020-09-04,India,NA,Goa,1458545,508,8,19863,220
2020-09-05,India,NA,Goa,1458545,592,9,20455,229
2020-09-06,India,NA,Goa,1458545,374,7,20829,236
2020-09-07,India,NA,Goa,1458545,344,9,21173,245
2020-09-08,India,NA,Goa,1458545,457,11,21630,256
2020-09-09,India,NA,Goa,1458545,621,6,22251,262
2020-09-10,India,NA,Goa,1458545,639,6,22890,268
2020-09-11,India,NA,Goa,1458545,555,8,23445,276
2020-09-12,India,NA,Goa,1458545,740,10,24185,286
2020-09-13,India,NA,Goa,1458545,407,4,24592,290
2020-09-14,India,NA,Goa,1458545,306,14,24898,304
2020-09-15,India,NA,Goa,1458545,613,11,25511,315
2020-09-16,India,NA,Goa,1458545,628,4,26139,319
2020-09-17,India,NA,Goa,1458545,644,8,26783,327
2020-09-18,India,NA,Goa,1458545,596,8,27379,335
2020-09-19,India,NA,Goa,1458545,643,7,28022,342
2020-09-20,India,NA,Goa,1458545,407,9,28429,351
2020-09-21,India,NA,Goa,1458545,324,9,28753,360
2020-09-22,India,NA,Goa,1458545,590,8,29343,368
2020-09-23,India,NA,Goa,1458545,536,8,29879,376
2020-03-21,India,NA,Gujarat,60383628,7,0,14,0
2020-03-22,India,NA,Gujarat,60383628,4,1,18,1
2020-03-23,India,NA,Gujarat,60383628,12,0,30,1
2020-03-24,India,NA,Gujarat,60383628,4,0,34,1
2020-03-25,India,NA,Gujarat,60383628,4,0,38,1
2020-03-26,India,NA,Gujarat,60383628,5,2,43,3
2020-03-27,India,NA,Gujarat,60383628,4,0,47,3
2020-03-28,India,NA,Gujarat,60383628,8,1,55,4
2020-03-29,India,NA,Gujarat,60383628,8,1,63,5
2020-03-30,India,NA,Gujarat,60383628,7,1,70,6
2020-03-31,India,NA,Gujarat,60383628,4,0,74,6
2020-04-01,India,NA,Gujarat,60383628,13,0,87,6
2020-04-02,India,NA,Gujarat,60383628,1,1,88,7
2020-04-03,India,NA,Gujarat,60383628,7,2,95,9
2020-04-04,India,NA,Gujarat,60383628,13,1,108,10
2020-04-05,India,NA,Gujarat,60383628,20,1,128,11
2020-04-06,India,NA,Gujarat,60383628,18,1,146,12
2020-04-07,India,NA,Gujarat,60383628,29,2,175,14
2020-04-08,India,NA,Gujarat,60383628,11,2,186,16
2020-04-09,India,NA,Gujarat,60383628,76,2,262,18
2020-04-10,India,NA,Gujarat,60383628,116,1,378,19
2020-04-11,India,NA,Gujarat,60383628,90,3,468,22
2020-04-12,India,NA,Gujarat,60383628,48,2,516,24
2020-04-13,India,NA,Gujarat,60383628,56,2,572,26
2020-04-14,India,NA,Gujarat,60383628,78,2,650,28
2020-04-15,India,NA,Gujarat,60383628,116,5,766,33
2020-04-16,India,NA,Gujarat,60383628,163,3,929,36
2020-04-17,India,NA,Gujarat,60383628,170,5,1099,41
2020-04-18,India,NA,Gujarat,60383628,277,12,1376,53
2020-04-19,India,NA,Gujarat,60383628,367,10,1743,63
2020-04-20,India,NA,Gujarat,60383628,196,8,1939,71
2020-04-21,India,NA,Gujarat,60383628,239,19,2178,90
2020-04-22,India,NA,Gujarat,60383628,229,13,2407,103
2020-04-23,India,NA,Gujarat,60383628,217,9,2624,112
2020-04-24,India,NA,Gujarat,60383628,191,15,2815,127
2020-04-25,India,NA,Gujarat,60383628,256,6,3071,133
2020-04-26,India,NA,Gujarat,60383628,230,18,3301,151
2020-04-27,India,NA,Gujarat,60383628,247,11,3548,162
2020-04-28,India,NA,Gujarat,60383628,226,19,3774,181
2020-04-29,India,NA,Gujarat,60383628,308,16,4082,197
2020-04-30,India,NA,Gujarat,60383628,313,17,4395,214
2020-05-01,India,NA,Gujarat,60383628,326,22,4721,236
2020-05-02,India,NA,Gujarat,60383628,333,26,5054,262
2020-05-03,India,NA,Gujarat,60383628,374,28,5428,290
2020-05-04,India,NA,Gujarat,60383628,376,29,5804,319
2020-05-05,India,NA,Gujarat,60383628,441,49,6245,368
2020-05-06,India,NA,Gujarat,60383628,380,28,6625,396
2020-05-07,India,NA,Gujarat,60383628,388,29,7013,425
2020-05-08,India,NA,Gujarat,60383628,390,24,7403,449
2020-05-09,India,NA,Gujarat,60383628,394,23,7797,472
2020-05-10,India,NA,Gujarat,60383628,398,21,8195,493
2020-05-11,India,NA,Gujarat,60383628,347,20,8542,513
2020-05-12,India,NA,Gujarat,60383628,362,24,8904,537
2020-05-13,India,NA,Gujarat,60383628,364,29,9268,566
2020-05-14,India,NA,Gujarat,60383628,324,20,9592,586
2020-05-15,India,NA,Gujarat,60383628,340,20,9932,606
2020-05-16,India,NA,Gujarat,60383628,1057,19,10989,625
2020-05-17,India,NA,Gujarat,60383628,391,34,11380,659
2020-05-18,India,NA,Gujarat,60383628,366,35,11746,694
2020-05-19,India,NA,Gujarat,60383628,395,25,12141,719
2020-05-20,India,NA,Gujarat,60383628,398,30,12539,749
2020-05-21,India,NA,Gujarat,60383628,371,24,12910,773
2020-05-22,India,NA,Gujarat,60383628,363,29,13273,802
2020-05-23,India,NA,Gujarat,60383628,396,27,13669,829
2020-05-24,India,NA,Gujarat,60383628,394,29,14063,858
2020-05-25,India,NA,Gujarat,60383628,405,30,14468,888
2020-05-26,India,NA,Gujarat,60383628,361,27,14829,915
2020-05-27,India,NA,Gujarat,60383628,376,23,15205,938
2020-05-28,India,NA,Gujarat,60383628,367,22,15572,960
2020-05-29,India,NA,Gujarat,60383628,372,20,15944,980
2020-05-30,India,NA,Gujarat,60383628,412,27,16356,1007
2020-05-31,India,NA,Gujarat,60383628,438,31,16794,1038
2020-06-01,India,NA,Gujarat,60383628,423,25,17217,1063
2020-06-02,India,NA,Gujarat,60383628,415,29,17632,1092
2020-06-03,India,NA,Gujarat,60383628,485,30,18117,1122
2020-06-04,India,NA,Gujarat,60383628,492,33,18609,1155
2020-06-05,India,NA,Gujarat,60383628,510,35,19119,1190
2020-06-06,India,NA,Gujarat,60383628,498,29,19617,1219
2020-06-07,India,NA,Gujarat,60383628,480,30,20097,1249
2020-06-08,India,NA,Gujarat,60383628,477,31,20574,1280
2020-06-09,India,NA,Gujarat,60383628,470,33,21044,1313
2020-06-10,India,NA,Gujarat,60383628,510,34,21554,1347
2020-06-11,India,NA,Gujarat,60383628,513,38,22067,1385
2020-06-12,India,NA,Gujarat,60383628,495,31,22562,1416
2020-06-13,India,NA,Gujarat,60383628,517,33,23079,1449
2020-06-14,India,NA,Gujarat,60383628,511,29,23590,1478
2020-06-15,India,NA,Gujarat,60383628,514,28,24104,1506
2020-06-16,India,NA,Gujarat,60383628,524,28,24628,1534
2020-06-17,India,NA,Gujarat,60383628,520,27,25148,1561
2020-06-18,India,NA,Gujarat,60383628,510,31,25658,1592
2020-06-19,India,NA,Gujarat,60383628,540,27,26198,1619
2020-06-20,India,NA,Gujarat,60383628,539,20,26737,1639
2020-06-21,India,NA,Gujarat,60383628,580,25,27317,1664
2020-06-22,India,NA,Gujarat,60383628,563,21,27880,1685
2020-06-23,India,NA,Gujarat,60383628,549,26,28429,1711
2020-06-24,India,NA,Gujarat,60383628,572,25,29001,1736
2020-06-25,India,NA,Gujarat,60383628,577,18,29578,1754
2020-06-26,India,NA,Gujarat,60383628,580,18,30158,1772
2020-06-27,India,NA,Gujarat,60383628,615,18,30773,1790
2020-06-28,India,NA,Gujarat,60383628,624,19,31397,1809
2020-06-29,India,NA,Gujarat,60383628,626,19,32023,1828
2020-06-30,India,NA,Gujarat,60383628,620,20,32643,1848
2020-07-01,India,NA,Gujarat,60383628,675,21,33318,1869
2020-07-02,India,NA,Gujarat,60383628,681,19,33999,1888
2020-07-03,India,NA,Gujarat,60383628,687,18,34686,1906
2020-07-04,India,NA,Gujarat,60383628,712,21,35398,1927
2020-07-05,India,NA,Gujarat,60383628,725,18,36123,1945
2020-07-06,India,NA,Gujarat,60383628,735,17,36858,1962
2020-07-07,India,NA,Gujarat,60383628,778,17,37636,1979
2020-07-08,India,NA,Gujarat,60383628,783,16,38419,1995
2020-07-09,India,NA,Gujarat,60383628,861,15,39280,2010
2020-07-10,India,NA,Gujarat,60383628,875,14,40155,2024
2020-07-11,India,NA,Gujarat,60383628,872,10,41027,2034
2020-07-12,India,NA,Gujarat,60383628,879,13,41906,2047
2020-07-13,India,NA,Gujarat,60383628,902,10,42808,2057
2020-07-14,India,NA,Gujarat,60383628,915,14,43723,2071
2020-07-15,India,NA,Gujarat,60383628,925,10,44648,2081
2020-07-16,India,NA,Gujarat,60383628,919,10,45567,2091
2020-07-17,India,NA,Gujarat,60383628,949,17,46516,2108
2020-07-18,India,NA,Gujarat,60383628,960,19,47476,2127
2020-07-19,India,NA,Gujarat,60383628,965,20,48441,2147
2020-07-20,India,NA,Gujarat,60383628,998,20,49439,2167
2020-07-21,India,NA,Gujarat,60383628,1026,34,50465,2201
2020-07-22,India,NA,Gujarat,60383628,1020,28,51485,2229
2020-07-23,India,NA,Gujarat,60383628,1078,28,52563,2257
2020-07-24,India,NA,Gujarat,60383628,1068,26,53631,2283
2020-07-25,India,NA,Gujarat,60383628,1081,22,54712,2305
2020-07-26,India,NA,Gujarat,60383628,1110,21,55822,2326
2020-07-27,India,NA,Gujarat,60383628,1052,22,56874,2348
2020-07-28,India,NA,Gujarat,60383628,1108,24,57982,2372
2020-07-29,India,NA,Gujarat,60383628,1144,24,59126,2396
2020-07-30,India,NA,Gujarat,60383628,1159,22,60285,2418
2020-07-31,India,NA,Gujarat,60383628,1153,22,61438,2440
2020-08-01,India,NA,Gujarat,60383628,1136,24,62574,2464
2020-08-02,India,NA,Gujarat,60383628,1101,22,63675,2486
2020-08-03,India,NA,Gujarat,60383628,1009,22,64684,2508
2020-08-04,India,NA,Gujarat,60383628,1020,25,65704,2533
2020-08-05,India,NA,Gujarat,60383628,1073,23,66777,2556
2020-08-06,India,NA,Gujarat,60383628,1034,27,67811,2583
2020-08-07,India,NA,Gujarat,60383628,1074,22,68885,2605
2020-08-08,India,NA,Gujarat,60383628,1101,23,69986,2628
2020-08-09,India,NA,Gujarat,60383628,1078,25,71064,2653
2020-08-10,India,NA,Gujarat,60383628,1056,20,72120,2673
2020-08-11,India,NA,Gujarat,60383628,1118,23,73238,2696
2020-08-12,India,NA,Gujarat,60383628,1152,18,74390,2714
2020-08-13,India,NA,Gujarat,60383628,1092,18,75482,2732
2020-08-14,India,NA,Gujarat,60383628,1087,15,76569,2747
2020-08-15,India,NA,Gujarat,60383628,1094,19,77663,2766
2020-08-16,India,NA,Gujarat,60383628,1120,20,78783,2786
2020-08-17,India,NA,Gujarat,60383628,1033,15,79816,2801
2020-08-18,India,NA,Gujarat,60383628,1126,20,80942,2821
2020-08-19,India,NA,Gujarat,60383628,1145,17,82087,2838
2020-08-20,India,NA,Gujarat,60383628,1175,16,83262,2854
2020-08-21,India,NA,Gujarat,60383628,1204,14,84466,2868
2020-08-22,India,NA,Gujarat,60383628,1212,14,85678,2882
2020-08-23,India,NA,Gujarat,60383628,1101,14,86779,2896
2020-08-24,India,NA,Gujarat,60383628,1067,13,87846,2909
2020-08-25,India,NA,Gujarat,60383628,1096,20,88942,2929
2020-08-26,India,NA,Gujarat,60383628,1197,17,90139,2946
2020-08-27,India,NA,Gujarat,60383628,1190,17,91329,2963
2020-08-28,India,NA,Gujarat,60383628,1272,14,92601,2977
2020-08-29,India,NA,Gujarat,60383628,1282,13,93883,2990
2020-08-30,India,NA,Gujarat,60383628,1272,17,95155,3007
2020-08-31,India,NA,Gujarat,60383628,1280,14,96435,3021
2020-09-01,India,NA,Gujarat,60383628,1310,14,97745,3035
2020-09-02,India,NA,Gujarat,60383628,1305,12,99050,3047
2020-09-03,India,NA,Gujarat,60383628,1325,16,100375,3063
2020-09-04,India,NA,Gujarat,60383628,1320,14,101695,3077
2020-09-05,India,NA,Gujarat,60383628,1311,16,103006,3093
2020-09-06,India,NA,Gujarat,60383628,1335,14,104341,3107
2020-09-07,India,NA,Gujarat,60383628,1330,15,105671,3122
2020-09-08,India,NA,Gujarat,60383628,1295,13,106966,3135
2020-09-09,India,NA,Gujarat,60383628,1329,16,108295,3151
2020-09-10,India,NA,Gujarat,60383628,1332,15,109627,3166
2020-09-11,India,NA,Gujarat,60383628,1344,16,110971,3182
2020-09-12,India,NA,Gujarat,60383628,1365,15,112336,3197
2020-09-13,India,NA,Gujarat,60383628,1326,15,113662,3212
2020-09-14,India,NA,Gujarat,60383628,1334,17,114996,3229
2020-09-15,India,NA,Gujarat,60383628,1349,17,116345,3246
2020-09-16,India,NA,Gujarat,60383628,1364,12,117709,3258
2020-09-17,India,NA,Gujarat,60383628,1379,14,119088,3272
2020-09-18,India,NA,Gujarat,60383628,1410,16,120498,3288
2020-09-19,India,NA,Gujarat,60383628,1432,16,121930,3304
2020-09-20,India,NA,Gujarat,60383628,1407,17,123337,3321
2020-09-21,India,NA,Gujarat,60383628,1430,17,124767,3338
2020-09-22,India,NA,Gujarat,60383628,1402,16,126169,3354
2020-09-23,India,NA,Gujarat,60383628,1372,15,127541,3369
2020-03-04,India,NA,Haryana,27761063,14,0,14,0
2020-03-14,India,NA,Haryana,27761063,14,0,14,0
2020-03-15,India,NA,Haryana,27761063,0,0,14,0
2020-03-16,India,NA,Haryana,27761063,0,0,14,0
2020-03-17,India,NA,Haryana,27761063,1,0,15,0
2020-03-18,India,NA,Haryana,27761063,1,0,16,0
2020-03-19,India,NA,Haryana,27761063,1,0,17,0
2020-03-20,India,NA,Haryana,27761063,2,0,19,0
2020-03-21,India,NA,Haryana,27761063,2,0,21,0
2020-03-22,India,NA,Haryana,27761063,0,0,21,0
2020-03-23,India,NA,Haryana,27761063,7,0,28,0
2020-03-24,India,NA,Haryana,27761063,2,0,30,0
2020-03-25,India,NA,Haryana,27761063,1,0,31,0
2020-03-26,India,NA,Haryana,27761063,1,0,32,0
2020-03-27,India,NA,Haryana,27761063,1,0,33,0
2020-03-28,India,NA,Haryana,27761063,2,0,35,0
2020-03-29,India,NA,Haryana,27761063,0,0,35,0
2020-03-30,India,NA,Haryana,27761063,1,0,36,0
2020-03-31,India,NA,Haryana,27761063,7,0,43,0
2020-04-01,India,NA,Haryana,27761063,0,0,43,0
2020-04-02,India,NA,Haryana,27761063,6,0,49,0
2020-04-03,India,NA,Haryana,27761063,9,0,58,0
2020-04-04,India,NA,Haryana,27761063,26,0,84,0
2020-04-05,India,NA,Haryana,27761063,6,0,90,0
2020-04-06,India,NA,Haryana,27761063,20,2,110,2
2020-04-07,India,NA,Haryana,27761063,33,0,143,2
2020-04-08,India,NA,Haryana,27761063,24,0,167,2
2020-04-09,India,NA,Haryana,27761063,3,0,170,2
2020-04-10,India,NA,Haryana,27761063,6,0,176,2
2020-04-11,India,NA,Haryana,27761063,3,0,179,2
2020-04-12,India,NA,Haryana,27761063,16,1,195,3
2020-04-13,India,NA,Haryana,27761063,1,0,196,3
2020-04-14,India,NA,Haryana,27761063,2,0,198,3
2020-04-15,India,NA,Haryana,27761063,6,0,204,3
2020-04-16,India,NA,Haryana,27761063,11,0,215,3
2020-04-17,India,NA,Haryana,27761063,8,0,223,3
2020-04-18,India,NA,Haryana,27761063,9,0,232,3
2020-04-19,India,NA,Haryana,27761063,18,0,250,3
2020-04-20,India,NA,Haryana,27761063,1,0,251,3
2020-04-21,India,NA,Haryana,27761063,4,0,255,3
2020-04-22,India,NA,Haryana,27761063,9,0,264,3
2020-04-23,India,NA,Haryana,27761063,6,0,270,3
2020-04-24,India,NA,Haryana,27761063,5,0,275,3
2020-04-25,India,NA,Haryana,27761063,12,0,287,3
2020-04-26,India,NA,Haryana,27761063,9,0,296,3
2020-04-27,India,NA,Haryana,27761063,5,0,301,3
2020-04-28,India,NA,Haryana,27761063,7,0,308,3
2020-04-29,India,NA,Haryana,27761063,3,0,311,3
2020-04-30,India,NA,Haryana,27761063,28,1,339,4
2020-05-01,India,NA,Haryana,27761063,18,0,357,4
2020-05-02,India,NA,Haryana,27761063,19,1,376,5
2020-05-03,India,NA,Haryana,27761063,66,0,442,5
2020-05-04,India,NA,Haryana,27761063,75,1,517,6
2020-05-05,India,NA,Haryana,27761063,31,0,548,6
2020-05-06,India,NA,Haryana,27761063,46,1,594,7
2020-05-07,India,NA,Haryana,27761063,31,0,625,7
2020-05-08,India,NA,Haryana,27761063,22,1,647,8
2020-05-09,India,NA,Haryana,27761063,28,1,675,9
2020-05-10,India,NA,Haryana,27761063,28,1,703,10
2020-05-11,India,NA,Haryana,27761063,27,1,730,11
2020-05-12,India,NA,Haryana,27761063,50,0,780,11
2020-05-13,India,NA,Haryana,27761063,13,0,793,11
2020-05-14,India,NA,Haryana,27761063,25,0,818,11
2020-05-15,India,NA,Haryana,27761063,36,2,854,13
2020-05-16,India,NA,Haryana,27761063,33,0,887,13
2020-05-17,India,NA,Haryana,27761063,23,1,910,14
2020-05-18,India,NA,Haryana,27761063,18,0,928,14
2020-05-19,India,NA,Haryana,27761063,36,0,964,14
2020-05-20,India,NA,Haryana,27761063,29,0,993,14
2020-05-21,India,NA,Haryana,27761063,37,0,1030,14
2020-05-22,India,NA,Haryana,27761063,37,2,1067,16
2020-05-23,India,NA,Haryana,27761063,64,0,1131,16
2020-05-24,India,NA,Haryana,27761063,53,0,1184,16
2020-05-25,India,NA,Haryana,27761063,29,0,1213,16
2020-05-26,India,NA,Haryana,27761063,92,0,1305,16
2020-05-27,India,NA,Haryana,27761063,76,2,1381,18
2020-05-28,India,NA,Haryana,27761063,123,1,1504,19
2020-05-29,India,NA,Haryana,27761063,217,0,1721,19
2020-05-30,India,NA,Haryana,27761063,202,1,1923,20
2020-05-31,India,NA,Haryana,27761063,168,0,2091,20
2020-06-01,India,NA,Haryana,27761063,265,1,2356,21
2020-06-02,India,NA,Haryana,27761063,296,2,2652,23
2020-06-03,India,NA,Haryana,27761063,302,0,2954,23
2020-06-04,India,NA,Haryana,27761063,327,1,3281,24
2020-06-05,India,NA,Haryana,27761063,316,0,3597,24
2020-06-06,India,NA,Haryana,27761063,355,0,3952,24
2020-06-07,India,NA,Haryana,27761063,496,4,4448,28
2020-06-08,India,NA,Haryana,27761063,406,11,4854,39
2020-06-09,India,NA,Haryana,27761063,355,6,5209,45
2020-06-10,India,NA,Haryana,27761063,370,7,5579,52
2020-06-11,India,NA,Haryana,27761063,389,12,5968,64
2020-06-12,India,NA,Haryana,27761063,366,6,6334,70
2020-06-13,India,NA,Haryana,27761063,415,8,6749,78
2020-06-14,India,NA,Haryana,27761063,459,10,7208,88
2020-06-15,India,NA,Haryana,27761063,514,12,7722,100
2020-06-16,India,NA,Haryana,27761063,550,18,8272,118
2020-06-17,India,NA,Haryana,27761063,560,12,8832,130
2020-06-18,India,NA,Haryana,27761063,386,4,9218,134
2020-06-19,India,NA,Haryana,27761063,525,10,9743,144
2020-06-20,India,NA,Haryana,27761063,480,5,10223,149
2020-06-21,India,NA,Haryana,27761063,412,11,10635,160
2020-06-22,India,NA,Haryana,27761063,390,9,11025,169
2020-06-23,India,NA,Haryana,27761063,495,9,11520,178
2020-06-24,India,NA,Haryana,27761063,490,10,12010,188
2020-06-25,India,NA,Haryana,27761063,453,10,12463,198
2020-06-26,India,NA,Haryana,27761063,421,13,12884,211
2020-06-27,India,NA,Haryana,27761063,543,7,13427,218
2020-06-28,India,NA,Haryana,27761063,402,5,13829,223
2020-06-29,India,NA,Haryana,27761063,381,9,14210,232
2020-06-30,India,NA,Haryana,27761063,338,4,14548,236
2020-07-01,India,NA,Haryana,27761063,393,4,14941,240
2020-07-02,India,NA,Haryana,27761063,568,11,15509,251
2020-07-03,India,NA,Haryana,27761063,494,4,16003,255
2020-07-04,India,NA,Haryana,27761063,545,5,16548,260
2020-07-05,India,NA,Haryana,27761063,457,5,17005,265
2020-07-06,India,NA,Haryana,27761063,499,11,17504,276
2020-07-07,India,NA,Haryana,27761063,495,3,17999,279
2020-07-08,India,NA,Haryana,27761063,691,3,18690,282
2020-07-09,India,NA,Haryana,27761063,674,5,19364,287
2020-07-10,India,NA,Haryana,27761063,570,3,19934,290
2020-07-11,India,NA,Haryana,27761063,648,7,20582,297
2020-07-12,India,NA,Haryana,27761063,658,4,21240,301
2020-07-13,India,NA,Haryana,27761063,689,7,21929,308
2020-07-14,India,NA,Haryana,27761063,699,4,22628,312
2020-07-15,India,NA,Haryana,27761063,678,7,23306,319
2020-07-16,India,NA,Haryana,27761063,696,3,24002,322
2020-07-17,India,NA,Haryana,27761063,795,5,24797,327
2020-07-18,India,NA,Haryana,27761063,750,17,25547,344
2020-07-19,India,NA,Haryana,27761063,617,5,26164,349
2020-07-20,India,NA,Haryana,27761063,694,6,26858,355
2020-07-21,India,NA,Haryana,27761063,604,9,27462,364
2020-07-22,India,NA,Haryana,27761063,724,8,28186,372
2020-07-23,India,NA,Haryana,27761063,789,6,28975,378
2020-07-24,India,NA,Haryana,27761063,780,4,29755,382
2020-07-25,India,NA,Haryana,27761063,783,7,30538,389
2020-07-26,India,NA,Haryana,27761063,794,3,31332,392
2020-07-27,India,NA,Haryana,27761063,795,5,32127,397
2020-07-28,India,NA,Haryana,27761063,749,9,32876,406
2020-07-29,India,NA,Haryana,27761063,755,7,33631,413
2020-07-30,India,NA,Haryana,27761063,623,4,34254,417
2020-07-31,India,NA,Haryana,27761063,711,4,34965,421
2020-08-01,India,NA,Haryana,27761063,793,7,35758,428
2020-08-02,India,NA,Haryana,27761063,761,5,36519,433
2020-08-03,India,NA,Haryana,27761063,654,7,37173,440
2020-08-04,India,NA,Haryana,27761063,623,8,37796,448
2020-08-05,India,NA,Haryana,27761063,752,7,38548,455
2020-08-06,India,NA,Haryana,27761063,755,3,39303,458
2020-08-07,India,NA,Haryana,27761063,751,9,40054,467
2020-08-08,India,NA,Haryana,27761063,789,7,40843,474
2020-08-09,India,NA,Haryana,27761063,792,9,41635,483
2020-08-10,India,NA,Haryana,27761063,794,6,42429,489
2020-08-11,India,NA,Haryana,27761063,798,11,43227,500
2020-08-12,India,NA,Haryana,27761063,797,3,44024,503
2020-08-13,India,NA,Haryana,27761063,793,8,44817,511
2020-08-14,India,NA,Haryana,27761063,797,7,45614,518
2020-08-15,India,NA,Haryana,27761063,796,10,46410,528
2020-08-16,India,NA,Haryana,27761063,743,10,47153,538
2020-08-17,India,NA,Haryana,27761063,887,12,48040,550
2020-08-18,India,NA,Haryana,27761063,896,7,48936,557
2020-08-19,India,NA,Haryana,27761063,994,10,49930,567
2020-08-20,India,NA,Haryana,27761063,996,11,50926,578
2020-08-21,India,NA,Haryana,27761063,1203,7,52129,585
2020-08-22,India,NA,Haryana,27761063,1161,12,53290,597
2020-08-23,India,NA,Haryana,27761063,1096,6,54386,603
2020-08-24,India,NA,Haryana,27761063,1074,10,55460,613
2020-08-25,India,NA,Haryana,27761063,1148,10,56608,623
2020-08-26,India,NA,Haryana,27761063,1397,11,58005,634
2020-08-27,India,NA,Haryana,27761063,1293,12,59298,646
2020-08-28,India,NA,Haryana,27761063,1298,15,60596,661
2020-08-29,India,NA,Haryana,27761063,1391,9,61987,670
2020-08-30,India,NA,Haryana,27761063,1295,12,63282,682
2020-08-31,India,NA,Haryana,27761063,1450,7,64732,689
2020-09-01,India,NA,Haryana,27761063,1694,17,66426,706
2020-09-02,India,NA,Haryana,27761063,1792,15,68218,721
2020-09-03,India,NA,Haryana,27761063,1881,19,70099,740
2020-09-04,India,NA,Haryana,27761063,1884,19,71983,759
2020-09-05,India,NA,Haryana,27761063,2289,22,74272,781
2020-09-06,India,NA,Haryana,27761063,2277,25,76549,806
2020-09-07,India,NA,Haryana,27761063,2224,23,78773,829
2020-09-08,India,NA,Haryana,27761063,2286,25,81059,854
2020-09-09,India,NA,Haryana,27761063,2294,28,83353,882
2020-09-10,India,NA,Haryana,27761063,2591,25,85944,907
2020-09-11,India,NA,Haryana,27761063,2388,25,88332,932
2020-09-12,India,NA,Haryana,27761063,2783,24,91115,956
2020-09-13,India,NA,Haryana,27761063,2526,19,93641,975
2020-09-14,India,NA,Haryana,27761063,2488,25,96129,1000
2020-09-15,India,NA,Haryana,27761063,2493,26,98622,1026
2020-09-16,India,NA,Haryana,27761063,2694,19,101316,1045
2020-09-17,India,NA,Haryana,27761063,2457,24,103773,1069
2020-09-18,India,NA,Haryana,27761063,2488,23,106261,1092
2020-09-19,India,NA,Haryana,27761063,2691,28,108952,1120
2020-09-20,India,NA,Haryana,27761063,2305,29,111257,1149
2020-09-21,India,NA,Haryana,27761063,1818,28,113075,1177
2020-09-22,India,NA,Haryana,27761063,1795,29,114870,1206
2020-09-23,India,NA,Haryana,27761063,1986,27,116856,1233
2020-04-04,India,NA,Himachal Pradesh,6864602,7,0,13,2
2020-04-05,India,NA,Himachal Pradesh,6864602,1,0,14,2
2020-04-06,India,NA,Himachal Pradesh,6864602,4,0,18,2
2020-04-07,India,NA,Himachal Pradesh,6864602,9,0,27,2
2020-04-08,India,NA,Himachal Pradesh,6864602,0,0,27,2
2020-04-09,India,NA,Himachal Pradesh,6864602,1,0,28,2
2020-04-10,India,NA,Himachal Pradesh,6864602,0,0,28,2
2020-04-11,India,NA,Himachal Pradesh,6864602,4,0,32,2
2020-04-12,India,NA,Himachal Pradesh,6864602,0,0,32,2
2020-04-13,India,NA,Himachal Pradesh,6864602,0,0,32,2
2020-04-14,India,NA,Himachal Pradesh,6864602,1,0,33,2
2020-04-15,India,NA,Himachal Pradesh,6864602,2,0,35,2
2020-04-16,India,NA,Himachal Pradesh,6864602,0,0,35,2
2020-04-17,India,NA,Himachal Pradesh,6864602,3,0,38,2
2020-04-18,India,NA,Himachal Pradesh,6864602,1,0,39,2
2020-04-19,India,NA,Himachal Pradesh,6864602,0,0,39,2
2020-04-20,India,NA,Himachal Pradesh,6864602,0,0,39,2
2020-04-21,India,NA,Himachal Pradesh,6864602,0,0,39,2
2020-04-22,India,NA,Himachal Pradesh,6864602,0,0,39,2
2020-04-23,India,NA,Himachal Pradesh,6864602,1,0,40,2
2020-04-24,India,NA,Himachal Pradesh,6864602,0,0,40,2
2020-04-25,India,NA,Himachal Pradesh,6864602,0,0,40,2
2020-04-26,India,NA,Himachal Pradesh,6864602,0,0,40,2
2020-04-27,India,NA,Himachal Pradesh,6864602,0,0,40,2
2020-04-28,India,NA,Himachal Pradesh,6864602,0,0,40,2
2020-04-29,India,NA,Himachal Pradesh,6864602,0,0,40,2
2020-04-30,India,NA,Himachal Pradesh,6864602,0,0,40,2
2020-05-01,India,NA,Himachal Pradesh,6864602,0,0,40,2
2020-05-02,India,NA,Himachal Pradesh,6864602,0,0,40,2
2020-05-03,India,NA,Himachal Pradesh,6864602,0,0,40,2
2020-05-04,India,NA,Himachal Pradesh,6864602,1,0,41,2
2020-05-05,India,NA,Himachal Pradesh,6864602,1,1,42,3
2020-05-06,India,NA,Himachal Pradesh,6864602,1,0,43,3
2020-05-07,India,NA,Himachal Pradesh,6864602,3,0,46,3
2020-05-08,India,NA,Himachal Pradesh,6864602,4,0,50,3
2020-05-09,India,NA,Himachal Pradesh,6864602,2,0,52,3
2020-05-10,India,NA,Himachal Pradesh,6864602,6,0,58,3
2020-05-11,India,NA,Himachal Pradesh,6864602,1,0,59,3
2020-05-12,India,NA,Himachal Pradesh,6864602,8,0,67,3
2020-05-13,India,NA,Himachal Pradesh,6864602,1,0,68,3
2020-05-14,India,NA,Himachal Pradesh,6864602,6,0,74,3
2020-05-15,India,NA,Himachal Pradesh,6864602,2,0,76,3
2020-05-16,India,NA,Himachal Pradesh,6864602,2,0,78,3
2020-05-17,India,NA,Himachal Pradesh,6864602,2,0,80,3
2020-05-18,India,NA,Himachal Pradesh,6864602,10,0,90,3
2020-05-19,India,NA,Himachal Pradesh,6864602,2,1,92,4
2020-05-20,India,NA,Himachal Pradesh,6864602,18,0,110,4
2020-05-21,India,NA,Himachal Pradesh,6864602,42,0,152,4
2020-05-22,India,NA,Himachal Pradesh,6864602,16,0,168,4
2020-05-23,India,NA,Himachal Pradesh,6864602,17,0,185,4
2020-05-24,India,NA,Himachal Pradesh,6864602,18,0,203,4
2020-05-25,India,NA,Himachal Pradesh,6864602,20,0,223,4
2020-05-26,India,NA,Himachal Pradesh,6864602,24,0,247,4
2020-05-27,India,NA,Himachal Pradesh,6864602,26,2,273,6
2020-05-28,India,NA,Himachal Pradesh,6864602,8,0,281,6
2020-05-29,India,NA,Himachal Pradesh,6864602,14,0,295,6
2020-05-30,India,NA,Himachal Pradesh,6864602,18,0,313,6
2020-05-31,India,NA,Himachal Pradesh,6864602,18,0,331,6
2020-06-01,India,NA,Himachal Pradesh,6864602,9,0,340,6
2020-06-02,India,NA,Himachal Pradesh,6864602,5,0,345,6
2020-06-03,India,NA,Himachal Pradesh,6864602,14,0,359,6
2020-06-04,India,NA,Himachal Pradesh,6864602,24,0,383,6
2020-06-05,India,NA,Himachal Pradesh,6864602,10,0,393,6
2020-06-06,India,NA,Himachal Pradesh,6864602,7,0,400,6
2020-06-07,India,NA,Himachal Pradesh,6864602,11,0,411,6
2020-06-08,India,NA,Himachal Pradesh,6864602,10,0,421,6
2020-06-09,India,NA,Himachal Pradesh,6864602,16,0,437,6
2020-06-10,India,NA,Himachal Pradesh,6864602,14,1,451,7
2020-06-11,India,NA,Himachal Pradesh,6864602,19,0,470,7
2020-06-12,India,NA,Himachal Pradesh,6864602,16,0,486,7
2020-06-13,India,NA,Himachal Pradesh,6864602,16,0,502,7
2020-06-14,India,NA,Himachal Pradesh,6864602,16,0,518,7
2020-06-15,India,NA,Himachal Pradesh,6864602,38,0,556,7
2020-06-16,India,NA,Himachal Pradesh,6864602,4,0,560,7
2020-06-17,India,NA,Himachal Pradesh,6864602,25,0,585,7
2020-06-18,India,NA,Himachal Pradesh,6864602,10,0,595,7
2020-06-19,India,NA,Himachal Pradesh,6864602,32,0,627,7
2020-06-20,India,NA,Himachal Pradesh,6864602,29,0,656,7
2020-06-21,India,NA,Himachal Pradesh,6864602,17,0,673,7
2020-06-22,India,NA,Himachal Pradesh,6864602,54,0,727,7
2020-06-23,India,NA,Himachal Pradesh,6864602,48,0,775,7
2020-06-24,India,NA,Himachal Pradesh,6864602,31,0,806,7
2020-06-25,India,NA,Himachal Pradesh,6864602,33,1,839,8
2020-06-26,India,NA,Himachal Pradesh,6864602,25,0,864,8
2020-06-27,India,NA,Himachal Pradesh,6864602,30,0,894,8
2020-06-28,India,NA,Himachal Pradesh,6864602,22,0,916,8
2020-06-29,India,NA,Himachal Pradesh,6864602,26,0,942,8
2020-06-30,India,NA,Himachal Pradesh,6864602,11,1,953,9
2020-07-01,India,NA,Himachal Pradesh,6864602,26,0,979,9
2020-07-02,India,NA,Himachal Pradesh,6864602,35,0,1014,9
2020-07-03,India,NA,Himachal Pradesh,6864602,19,0,1033,9
2020-07-04,India,NA,Himachal Pradesh,6864602,13,1,1046,10
2020-07-05,India,NA,Himachal Pradesh,6864602,17,0,1063,10
2020-07-06,India,NA,Himachal Pradesh,6864602,14,0,1077,10
2020-07-07,India,NA,Himachal Pradesh,6864602,6,0,1083,10
2020-07-08,India,NA,Himachal Pradesh,6864602,18,0,1101,10
2020-07-09,India,NA,Himachal Pradesh,6864602,39,0,1140,10
2020-07-10,India,NA,Himachal Pradesh,6864602,31,0,1171,10
2020-07-11,India,NA,Himachal Pradesh,6864602,11,0,1182,10
2020-07-12,India,NA,Himachal Pradesh,6864602,31,0,1213,10
2020-07-13,India,NA,Himachal Pradesh,6864602,30,0,1243,10
2020-07-14,India,NA,Himachal Pradesh,6864602,66,0,1309,10
2020-07-15,India,NA,Himachal Pradesh,6864602,32,0,1341,10
2020-07-16,India,NA,Himachal Pradesh,6864602,36,0,1377,10
2020-07-17,India,NA,Himachal Pradesh,6864602,40,0,1417,10
2020-07-18,India,NA,Himachal Pradesh,6864602,40,0,1457,10
2020-07-19,India,NA,Himachal Pradesh,6864602,64,0,1521,10
2020-07-20,India,NA,Himachal Pradesh,6864602,110,0,1631,10
2020-07-21,India,NA,Himachal Pradesh,6864602,33,1,1664,11
2020-07-22,India,NA,Himachal Pradesh,6864602,61,0,1725,11
2020-07-23,India,NA,Himachal Pradesh,6864602,109,0,1834,11
2020-07-24,India,NA,Himachal Pradesh,6864602,120,1,1954,12
2020-07-25,India,NA,Himachal Pradesh,6864602,95,0,2049,12
2020-07-26,India,NA,Himachal Pradesh,6864602,127,1,2176,13
2020-07-27,India,NA,Himachal Pradesh,6864602,94,0,2270,13
2020-07-28,India,NA,Himachal Pradesh,6864602,60,0,2330,13
2020-07-29,India,NA,Himachal Pradesh,6864602,73,0,2403,13
2020-07-30,India,NA,Himachal Pradesh,6864602,103,0,2506,13
2020-07-31,India,NA,Himachal Pradesh,6864602,58,0,2564,13
2020-08-01,India,NA,Himachal Pradesh,6864602,70,0,2634,13
2020-08-02,India,NA,Himachal Pradesh,6864602,69,0,2703,13
2020-08-03,India,NA,Himachal Pradesh,6864602,115,0,2818,13
2020-08-04,India,NA,Himachal Pradesh,6864602,61,0,2879,13
2020-08-05,India,NA,Himachal Pradesh,6864602,37,0,2916,13
2020-08-06,India,NA,Himachal Pradesh,6864602,131,0,3047,13
2020-08-07,India,NA,Himachal Pradesh,6864602,103,0,3150,13
2020-08-08,India,NA,Himachal Pradesh,6864602,114,0,3264,13
2020-08-09,India,NA,Himachal Pradesh,6864602,107,1,3371,14
2020-08-10,India,NA,Himachal Pradesh,6864602,92,2,3463,16
2020-08-11,India,NA,Himachal Pradesh,6864602,34,1,3497,17
2020-08-12,India,NA,Himachal Pradesh,6864602,139,0,3636,17
2020-08-13,India,NA,Himachal Pradesh,6864602,180,1,3816,18
2020-08-14,India,NA,Himachal Pradesh,6864602,58,0,3874,18
2020-08-15,India,NA,Himachal Pradesh,6864602,119,0,3993,18
2020-08-16,India,NA,Himachal Pradesh,6864602,163,0,4156,18
2020-08-17,India,NA,Himachal Pradesh,6864602,18,0,4174,18
2020-08-18,India,NA,Himachal Pradesh,6864602,61,0,4235,18
2020-08-19,India,NA,Himachal Pradesh,6864602,176,2,4411,20
2020-08-20,India,NA,Himachal Pradesh,6864602,127,2,4538,22
2020-08-21,India,NA,Himachal Pradesh,6864602,190,2,4728,24
2020-08-22,India,NA,Himachal Pradesh,6864602,167,4,4895,28
2020-08-23,India,NA,Himachal Pradesh,6864602,106,0,5001,28
2020-08-24,India,NA,Himachal Pradesh,6864602,100,0,5101,28
2020-08-25,India,NA,Himachal Pradesh,6864602,53,1,5154,29
2020-08-26,India,NA,Himachal Pradesh,6864602,167,2,5321,31
2020-08-27,India,NA,Himachal Pradesh,6864602,180,1,5501,32
2020-08-28,India,NA,Himachal Pradesh,6864602,136,0,5637,32
2020-08-29,India,NA,Himachal Pradesh,6864602,144,1,5781,33
2020-08-30,India,NA,Himachal Pradesh,6864602,164,1,5945,34
2020-08-31,India,NA,Himachal Pradesh,6864602,171,3,6116,37
2020-09-01,India,NA,Himachal Pradesh,6864602,139,4,6255,41
2020-09-02,India,NA,Himachal Pradesh,6864602,161,1,6416,42
2020-09-03,India,NA,Himachal Pradesh,6864602,199,5,6615,47
2020-09-04,India,NA,Himachal Pradesh,6864602,215,2,6830,49
2020-09-05,India,NA,Himachal Pradesh,6864602,188,4,7018,53
2020-09-06,India,NA,Himachal Pradesh,6864602,397,1,7415,54
2020-09-07,India,NA,Himachal Pradesh,6864602,245,1,7660,55
2020-09-08,India,NA,Himachal Pradesh,6864602,171,4,7831,59
2020-09-09,India,NA,Himachal Pradesh,6864602,316,3,8147,62
2020-09-10,India,NA,Himachal Pradesh,6864602,319,3,8466,65
2020-09-11,India,NA,Himachal Pradesh,6864602,318,5,8784,70
2020-09-12,India,NA,Himachal Pradesh,6864602,445,2,9229,72
2020-09-13,India,NA,Himachal Pradesh,6864602,326,4,9555,76
2020-09-14,India,NA,Himachal Pradesh,6864602,368,5,9923,81
2020-09-15,India,NA,Himachal Pradesh,6864602,412,8,10335,89
2020-09-16,India,NA,Himachal Pradesh,6864602,460,1,10795,90
2020-09-17,India,NA,Himachal Pradesh,6864602,395,7,11190,97
2020-09-18,India,NA,Himachal Pradesh,6864602,432,12,11622,109
2020-09-19,India,NA,Himachal Pradesh,6864602,286,5,11908,114
2020-09-20,India,NA,Himachal Pradesh,6864602,221,4,12129,118
2020-09-21,India,NA,Himachal Pradesh,6864602,309,7,12438,125
2020-09-22,India,NA,Himachal Pradesh,6864602,331,5,12769,130
2020-09-23,India,NA,Himachal Pradesh,6864602,280,5,13049,135
2020-03-25,India,NA,Jammu and Kashmir,12258433,5,0,11,0
2020-03-26,India,NA,Jammu and Kashmir,12258433,3,1,14,1
2020-03-27,India,NA,Jammu and Kashmir,12258433,6,0,20,1
2020-03-28,India,NA,Jammu and Kashmir,12258433,13,0,33,1
2020-03-29,India,NA,Jammu and Kashmir,12258433,5,0,38,1
2020-03-30,India,NA,Jammu and Kashmir,12258433,11,0,49,1
2020-03-31,India,NA,Jammu and Kashmir,12258433,6,1,55,2
2020-04-01,India,NA,Jammu and Kashmir,12258433,7,0,62,2
2020-04-02,India,NA,Jammu and Kashmir,12258433,8,0,70,2
2020-04-03,India,NA,Jammu and Kashmir,12258433,5,0,75,2
2020-04-04,India,NA,Jammu and Kashmir,12258433,17,0,92,2
2020-04-05,India,NA,Jammu and Kashmir,12258433,14,0,106,2
2020-04-06,India,NA,Jammu and Kashmir,12258433,3,0,109,2
2020-04-07,India,NA,Jammu and Kashmir,12258433,16,1,125,3
2020-04-08,India,NA,Jammu and Kashmir,12258433,33,0,158,3
2020-04-09,India,NA,Jammu and Kashmir,12258433,26,1,184,4
2020-04-10,India,NA,Jammu and Kashmir,12258433,23,0,207,4
2020-04-11,India,NA,Jammu and Kashmir,12258433,17,0,224,4
2020-04-12,India,NA,Jammu and Kashmir,12258433,21,0,245,4
2020-04-13,India,NA,Jammu and Kashmir,12258433,25,0,270,4
2020-04-14,India,NA,Jammu and Kashmir,12258433,8,0,278,4
2020-04-15,India,NA,Jammu and Kashmir,12258433,22,0,300,4
2020-04-16,India,NA,Jammu and Kashmir,12258433,14,0,314,4
2020-04-17,India,NA,Jammu and Kashmir,12258433,14,1,328,5
2020-04-18,India,NA,Jammu and Kashmir,12258433,13,0,341,5
2020-04-19,India,NA,Jammu and Kashmir,12258433,13,0,354,5
2020-04-20,India,NA,Jammu and Kashmir,12258433,14,0,368,5
2020-04-21,India,NA,Jammu and Kashmir,12258433,12,0,380,5
2020-04-22,India,NA,Jammu and Kashmir,12258433,27,0,407,5
2020-04-23,India,NA,Jammu and Kashmir,12258433,27,0,434,5
2020-04-24,India,NA,Jammu and Kashmir,12258433,20,0,454,5
2020-04-25,India,NA,Jammu and Kashmir,12258433,40,1,494,6
2020-04-26,India,NA,Jammu and Kashmir,12258433,29,0,523,6
2020-04-27,India,NA,Jammu and Kashmir,12258433,23,1,546,7
2020-04-28,India,NA,Jammu and Kashmir,12258433,19,1,565,8
2020-04-29,India,NA,Jammu and Kashmir,12258433,16,0,581,8
2020-04-30,India,NA,Jammu and Kashmir,12258433,33,0,614,8
2020-05-01,India,NA,Jammu and Kashmir,12258433,25,0,639,8
2020-05-02,India,NA,Jammu and Kashmir,12258433,27,0,666,8
2020-05-03,India,NA,Jammu and Kashmir,12258433,35,0,701,8
2020-05-04,India,NA,Jammu and Kashmir,12258433,25,0,726,8
2020-05-05,India,NA,Jammu and Kashmir,12258433,15,0,741,8
2020-05-06,India,NA,Jammu and Kashmir,12258433,34,0,775,8
2020-05-07,India,NA,Jammu and Kashmir,12258433,18,1,793,9
2020-05-08,India,NA,Jammu and Kashmir,12258433,30,0,823,9
2020-05-09,India,NA,Jammu and Kashmir,12258433,13,0,836,9
2020-05-10,India,NA,Jammu and Kashmir,12258433,25,0,861,9
2020-05-11,India,NA,Jammu and Kashmir,12258433,18,1,879,10
2020-05-12,India,NA,Jammu and Kashmir,12258433,55,0,934,10
2020-05-13,India,NA,Jammu and Kashmir,12258433,37,1,971,11
2020-05-14,India,NA,Jammu and Kashmir,12258433,12,0,983,11
2020-05-15,India,NA,Jammu and Kashmir,12258433,30,0,1013,11
2020-05-16,India,NA,Jammu and Kashmir,12258433,108,1,1121,12
2020-05-17,India,NA,Jammu and Kashmir,12258433,62,1,1183,13
2020-05-18,India,NA,Jammu and Kashmir,12258433,106,2,1289,15
2020-05-19,India,NA,Jammu and Kashmir,12258433,28,2,1317,17
2020-05-20,India,NA,Jammu and Kashmir,12258433,73,1,1390,18
2020-05-21,India,NA,Jammu and Kashmir,12258433,59,2,1449,20
2020-05-22,India,NA,Jammu and Kashmir,12258433,40,0,1489,20
2020-05-23,India,NA,Jammu and Kashmir,12258433,80,1,1569,21
2020-05-24,India,NA,Jammu and Kashmir,12258433,52,0,1621,21
2020-05-25,India,NA,Jammu and Kashmir,12258433,47,2,1668,23
2020-05-26,India,NA,Jammu and Kashmir,12258433,91,1,1759,24
2020-05-27,India,NA,Jammu and Kashmir,12258433,162,2,1921,26
2020-05-28,India,NA,Jammu and Kashmir,12258433,115,1,2036,27
2020-05-29,India,NA,Jammu and Kashmir,12258433,128,1,2164,28
2020-05-30,India,NA,Jammu and Kashmir,12258433,177,0,2341,28
2020-05-31,India,NA,Jammu and Kashmir,12258433,105,0,2446,28
2020-06-01,India,NA,Jammu and Kashmir,12258433,155,3,2601,31
2020-06-02,India,NA,Jammu and Kashmir,12258433,117,2,2718,33
2020-06-03,India,NA,Jammu and Kashmir,12258433,139,1,2857,34
2020-06-04,India,NA,Jammu and Kashmir,12258433,285,1,3142,35
2020-06-05,India,NA,Jammu and Kashmir,12258433,182,1,3324,36
2020-06-06,India,NA,Jammu and Kashmir,12258433,143,3,3467,39
2020-06-07,India,NA,Jammu and Kashmir,12258433,620,2,4087,41
2020-06-08,India,NA,Jammu and Kashmir,12258433,198,4,4285,45
2020-06-09,India,NA,Jammu and Kashmir,12258433,61,3,4346,48
2020-06-10,India,NA,Jammu and Kashmir,12258433,161,3,4507,51
2020-06-11,India,NA,Jammu and Kashmir,12258433,67,1,4574,52
2020-06-12,India,NA,Jammu and Kashmir,12258433,156,1,4730,53
2020-06-13,India,NA,Jammu and Kashmir,12258433,148,2,4878,55
2020-06-14,India,NA,Jammu and Kashmir,12258433,163,4,5041,59
2020-06-15,India,NA,Jammu and Kashmir,12258433,179,3,5220,62
2020-06-16,India,NA,Jammu and Kashmir,12258433,78,1,5298,63
2020-06-17,India,NA,Jammu and Kashmir,12258433,108,1,5406,64
2020-06-18,India,NA,Jammu and Kashmir,12258433,149,7,5555,71
2020-06-19,India,NA,Jammu and Kashmir,12258433,125,4,5680,75
2020-06-20,India,NA,Jammu and Kashmir,12258433,154,6,5834,81
2020-06-21,India,NA,Jammu and Kashmir,12258433,122,1,5956,82
2020-06-22,India,NA,Jammu and Kashmir,12258433,132,3,6088,85
2020-06-23,India,NA,Jammu and Kashmir,12258433,148,2,6236,87
2020-06-24,India,NA,Jammu and Kashmir,12258433,186,1,6422,88
2020-06-25,India,NA,Jammu and Kashmir,12258433,127,2,6549,90
2020-06-26,India,NA,Jammu and Kashmir,12258433,213,1,6762,91
2020-06-27,India,NA,Jammu and Kashmir,12258433,204,2,6966,93
2020-06-28,India,NA,Jammu and Kashmir,12258433,127,1,7093,94
2020-06-29,India,NA,Jammu and Kashmir,12258433,144,1,7237,95
2020-06-30,India,NA,Jammu and Kashmir,12258433,260,6,7497,101
2020-07-01,India,NA,Jammu and Kashmir,12258433,198,4,7695,105
2020-07-02,India,NA,Jammu and Kashmir,12258433,154,10,7849,115
2020-07-03,India,NA,Jammu and Kashmir,12258433,170,4,8019,119
2020-07-04,India,NA,Jammu and Kashmir,12258433,227,8,8246,127
2020-07-05,India,NA,Jammu and Kashmir,12258433,183,5,8429,132
2020-07-06,India,NA,Jammu and Kashmir,12258433,246,6,8675,138
2020-07-07,India,NA,Jammu and Kashmir,12258433,256,5,8931,143
2020-07-08,India,NA,Jammu and Kashmir,12258433,330,6,9261,149
2020-07-09,India,NA,Jammu and Kashmir,12258433,240,5,9501,154
2020-07-10,India,NA,Jammu and Kashmir,12258433,387,5,9888,159
2020-07-11,India,NA,Jammu and Kashmir,12258433,268,10,10156,169
2020-07-12,India,NA,Jammu and Kashmir,12258433,357,10,10513,179
2020-07-13,India,NA,Jammu and Kashmir,12258433,314,8,10827,187
2020-07-14,India,NA,Jammu and Kashmir,12258433,346,8,11173,195
2020-07-15,India,NA,Jammu and Kashmir,12258433,493,11,11666,206
2020-07-16,India,NA,Jammu and Kashmir,12258433,490,16,12156,222
2020-07-17,India,NA,Jammu and Kashmir,12258433,601,9,12757,231
2020-07-18,India,NA,Jammu and Kashmir,12258433,441,5,13198,236
2020-07-19,India,NA,Jammu and Kashmir,12258433,701,8,13899,244
2020-07-20,India,NA,Jammu and Kashmir,12258433,751,10,14650,254
2020-07-21,India,NA,Jammu and Kashmir,12258433,608,9,15258,263
2020-07-22,India,NA,Jammu and Kashmir,12258433,453,10,15711,273
2020-07-23,India,NA,Jammu and Kashmir,12258433,718,9,16429,282
2020-07-24,India,NA,Jammu and Kashmir,12258433,353,14,16782,296
2020-07-25,India,NA,Jammu and Kashmir,12258433,523,9,17305,305
2020-07-26,India,NA,Jammu and Kashmir,12258433,615,7,17920,312
2020-07-27,India,NA,Jammu and Kashmir,12258433,470,9,18390,321
2020-07-28,India,NA,Jammu and Kashmir,12258433,489,12,18879,333
2020-07-29,India,NA,Jammu and Kashmir,12258433,540,15,19419,348
2020-07-30,India,NA,Jammu and Kashmir,12258433,450,17,19869,365
2020-07-31,India,NA,Jammu and Kashmir,12258433,490,12,20359,377
2020-08-01,India,NA,Jammu and Kashmir,12258433,613,11,20972,388
2020-08-02,India,NA,Jammu and Kashmir,12258433,444,8,21416,396
2020-08-03,India,NA,Jammu and Kashmir,12258433,590,11,22006,407
2020-08-04,India,NA,Jammu and Kashmir,12258433,390,10,22396,417
2020-08-05,India,NA,Jammu and Kashmir,12258433,559,9,22955,426
2020-08-06,India,NA,Jammu and Kashmir,12258433,499,10,23454,436
2020-08-07,India,NA,Jammu and Kashmir,12258433,473,13,23927,449
2020-08-08,India,NA,Jammu and Kashmir,12258433,463,10,24390,459
2020-08-09,India,NA,Jammu and Kashmir,12258433,507,13,24897,472
2020-08-10,India,NA,Jammu and Kashmir,12258433,470,6,25367,478
2020-08-11,India,NA,Jammu and Kashmir,12258433,564,12,25931,490
2020-08-12,India,NA,Jammu and Kashmir,12258433,482,8,26413,498
2020-08-13,India,NA,Jammu and Kashmir,12258433,536,11,26949,509
2020-08-14,India,NA,Jammu and Kashmir,12258433,540,11,27489,520
2020-08-15,India,NA,Jammu and Kashmir,12258433,532,7,28021,527
2020-08-16,India,NA,Jammu and Kashmir,12258433,449,15,28470,542
2020-08-17,India,NA,Jammu and Kashmir,12258433,422,6,28892,548
2020-08-18,India,NA,Jammu and Kashmir,12258433,434,13,29326,561
2020-08-19,India,NA,Jammu and Kashmir,12258433,708,11,30034,572
2020-08-20,India,NA,Jammu and Kashmir,12258433,683,6,30717,578
2020-08-21,India,NA,Jammu and Kashmir,12258433,654,15,31371,593
2020-08-22,India,NA,Jammu and Kashmir,12258433,610,15,31981,608
2020-08-23,India,NA,Jammu and Kashmir,12258433,666,9,32647,617
2020-08-24,India,NA,Jammu and Kashmir,12258433,428,7,33075,624
2020-08-25,India,NA,Jammu and Kashmir,12258433,701,14,33776,638
2020-08-26,India,NA,Jammu and Kashmir,12258433,704,19,34480,657
2020-08-27,India,NA,Jammu and Kashmir,12258433,655,14,35135,671
2020-08-28,India,NA,Jammu and Kashmir,12258433,696,7,35831,678
2020-08-29,India,NA,Jammu and Kashmir,12258433,546,7,36377,685
2020-08-30,India,NA,Jammu and Kashmir,12258433,786,9,37163,694
2020-08-31,India,NA,Jammu and Kashmir,12258433,535,9,37698,703
2020-09-01,India,NA,Jammu and Kashmir,12258433,525,14,38223,717
2020-09-02,India,NA,Jammu and Kashmir,12258433,641,15,38864,732
2020-09-03,India,NA,Jammu and Kashmir,12258433,1079,11,39943,743
2020-09-04,India,NA,Jammu and Kashmir,12258433,1047,12,40990,755
2020-09-05,India,NA,Jammu and Kashmir,12258433,1251,15,42241,770
2020-09-06,India,NA,Jammu and Kashmir,12258433,1316,14,43557,784
2020-09-07,India,NA,Jammu and Kashmir,12258433,1013,17,44570,801
2020-09-08,India,NA,Jammu and Kashmir,12258433,1355,14,45925,815
2020-09-09,India,NA,Jammu and Kashmir,12258433,1617,17,47542,832
2020-09-10,India,NA,Jammu and Kashmir,12258433,1592,13,49134,845
2020-09-11,India,NA,Jammu and Kashmir,12258433,1578,9,50712,854
2020-09-12,India,NA,Jammu and Kashmir,12258433,1698,10,52410,864
2020-09-13,India,NA,Jammu and Kashmir,12258433,1686,14,54096,878
2020-09-14,India,NA,Jammu and Kashmir,12258433,1229,17,55325,895
2020-09-15,India,NA,Jammu and Kashmir,12258433,1329,19,56654,914
2020-09-16,India,NA,Jammu and Kashmir,12258433,1590,18,58244,932
2020-09-17,India,NA,Jammu and Kashmir,12258433,1467,19,59711,951
2020-09-18,India,NA,Jammu and Kashmir,12258433,1330,15,61041,966
2020-09-19,India,NA,Jammu and Kashmir,12258433,1492,21,62533,987
2020-09-20,India,NA,Jammu and Kashmir,12258433,1457,14,63990,1001
2020-09-21,India,NA,Jammu and Kashmir,12258433,1036,23,65026,1024
2020-09-22,India,NA,Jammu and Kashmir,12258433,1235,18,66261,1042
2020-09-23,India,NA,Jammu and Kashmir,12258433,1249,20,67510,1062
2020-04-09,India,NA,Jharkhand,32988134,9,1,13,1
2020-04-10,India,NA,Jharkhand,32988134,1,0,14,1
2020-04-11,India,NA,Jharkhand,32988134,3,0,17,1
2020-04-12,India,NA,Jharkhand,32988134,2,1,19,2
2020-04-13,India,NA,Jharkhand,32988134,5,0,24,2
2020-04-14,India,NA,Jharkhand,32988134,3,0,27,2
2020-04-15,India,NA,Jharkhand,32988134,1,0,28,2
2020-04-16,India,NA,Jharkhand,32988134,1,0,29,2
2020-04-17,India,NA,Jharkhand,32988134,3,0,32,2
2020-04-18,India,NA,Jharkhand,32988134,1,0,33,2
2020-04-19,India,NA,Jharkhand,32988134,8,0,41,2
2020-04-20,India,NA,Jharkhand,32988134,5,0,46,2
2020-04-21,India,NA,Jharkhand,32988134,0,0,46,2
2020-04-22,India,NA,Jharkhand,32988134,0,0,46,2
2020-04-23,India,NA,Jharkhand,32988134,7,1,53,3
2020-04-24,India,NA,Jharkhand,32988134,6,0,59,3
2020-04-25,India,NA,Jharkhand,32988134,8,0,67,3
2020-04-26,India,NA,Jharkhand,32988134,15,0,82,3
2020-04-27,India,NA,Jharkhand,32988134,21,0,103,3
2020-04-28,India,NA,Jharkhand,32988134,2,0,105,3
2020-04-29,India,NA,Jharkhand,32988134,2,0,107,3
2020-04-30,India,NA,Jharkhand,32988134,3,0,110,3
2020-05-01,India,NA,Jharkhand,32988134,3,0,113,3
2020-05-02,India,NA,Jharkhand,32988134,2,0,115,3
2020-05-03,India,NA,Jharkhand,32988134,0,0,115,3
2020-05-04,India,NA,Jharkhand,32988134,0,0,115,3
2020-05-05,India,NA,Jharkhand,32988134,10,0,125,3
2020-05-06,India,NA,Jharkhand,32988134,2,0,127,3
2020-05-07,India,NA,Jharkhand,32988134,5,0,132,3
2020-05-08,India,NA,Jharkhand,32988134,22,0,154,3
2020-05-09,India,NA,Jharkhand,32988134,2,0,156,3
2020-05-10,India,NA,Jharkhand,32988134,1,0,157,3
2020-05-11,India,NA,Jharkhand,32988134,4,0,161,3
2020-05-12,India,NA,Jharkhand,32988134,11,0,172,3
2020-05-13,India,NA,Jharkhand,32988134,5,0,177,3
2020-05-14,India,NA,Jharkhand,32988134,26,0,203,3
2020-05-15,India,NA,Jharkhand,32988134,8,0,211,3
2020-05-16,India,NA,Jharkhand,32988134,6,0,217,3
2020-05-17,India,NA,Jharkhand,32988134,6,0,223,3
2020-05-18,India,NA,Jharkhand,32988134,5,0,228,3
2020-05-19,India,NA,Jharkhand,32988134,20,0,248,3
2020-05-20,India,NA,Jharkhand,32988134,42,0,290,3
2020-05-21,India,NA,Jharkhand,32988134,13,0,303,3
2020-05-22,India,NA,Jharkhand,32988134,20,0,323,3
2020-05-23,India,NA,Jharkhand,32988134,27,0,350,3
2020-05-24,India,NA,Jharkhand,32988134,20,1,370,4
2020-05-25,India,NA,Jharkhand,32988134,35,0,405,4
2020-05-26,India,NA,Jharkhand,32988134,21,0,426,4
2020-05-27,India,NA,Jharkhand,32988134,7,0,433,4
2020-05-28,India,NA,Jharkhand,32988134,6,0,439,4
2020-05-29,India,NA,Jharkhand,32988134,82,1,521,5
2020-05-30,India,NA,Jharkhand,32988134,73,0,594,5
2020-05-31,India,NA,Jharkhand,32988134,41,0,635,5
2020-06-01,India,NA,Jharkhand,32988134,26,0,661,5
2020-06-02,India,NA,Jharkhand,32988134,61,0,722,5
2020-06-03,India,NA,Jharkhand,32988134,42,0,764,5
2020-06-04,India,NA,Jharkhand,32988134,63,1,827,6
2020-06-05,India,NA,Jharkhand,32988134,95,1,922,7
2020-06-06,India,NA,Jharkhand,32988134,106,0,1028,7
2020-06-07,India,NA,Jharkhand,32988134,75,0,1103,7
2020-06-08,India,NA,Jharkhand,32988134,187,0,1290,7
2020-06-09,India,NA,Jharkhand,32988134,126,1,1416,8
2020-06-10,India,NA,Jharkhand,32988134,135,0,1551,8
2020-06-11,India,NA,Jharkhand,32988134,48,0,1599,8
2020-06-12,India,NA,Jharkhand,32988134,57,0,1656,8
2020-06-13,India,NA,Jharkhand,32988134,55,0,1711,8
2020-06-14,India,NA,Jharkhand,32988134,52,0,1763,8
2020-06-15,India,NA,Jharkhand,32988134,30,1,1793,9
2020-06-16,India,NA,Jharkhand,32988134,46,0,1839,9
2020-06-17,India,NA,Jharkhand,32988134,57,1,1896,10
2020-06-18,India,NA,Jharkhand,32988134,23,1,1919,11
2020-06-19,India,NA,Jharkhand,32988134,42,0,1961,11
2020-06-20,India,NA,Jharkhand,32988134,63,0,2024,11
2020-06-21,India,NA,Jharkhand,32988134,74,0,2098,11
2020-06-22,India,NA,Jharkhand,32988134,42,0,2140,11
2020-06-23,India,NA,Jharkhand,32988134,53,0,2193,11
2020-06-24,India,NA,Jharkhand,32988134,26,1,2219,12
2020-06-25,India,NA,Jharkhand,32988134,44,0,2263,12
2020-06-26,India,NA,Jharkhand,32988134,31,0,2294,12
2020-06-27,India,NA,Jharkhand,32988134,45,0,2339,12
2020-06-28,India,NA,Jharkhand,32988134,25,0,2364,12
2020-06-29,India,NA,Jharkhand,32988134,62,3,2426,15
2020-06-30,India,NA,Jharkhand,32988134,64,0,2490,15
2020-07-01,India,NA,Jharkhand,32988134,35,0,2525,15
2020-07-02,India,NA,Jharkhand,32988134,60,0,2585,15
2020-07-03,India,NA,Jharkhand,32988134,112,0,2697,15
2020-07-04,India,NA,Jharkhand,32988134,42,3,2739,18
2020-07-05,India,NA,Jharkhand,32988134,68,1,2807,19
2020-07-06,India,NA,Jharkhand,32988134,47,1,2854,20
2020-07-07,India,NA,Jharkhand,32988134,164,2,3018,22
2020-07-08,India,NA,Jharkhand,32988134,116,0,3134,22
2020-07-09,India,NA,Jharkhand,32988134,134,1,3268,23
2020-07-10,India,NA,Jharkhand,32988134,250,0,3518,23
2020-07-11,India,NA,Jharkhand,32988134,145,1,3663,24
2020-07-12,India,NA,Jharkhand,32988134,97,7,3760,31
2020-07-13,India,NA,Jharkhand,32988134,203,2,3963,33
2020-07-14,India,NA,Jharkhand,32988134,262,3,4225,36
2020-07-15,India,NA,Jharkhand,32988134,337,2,4562,38
2020-07-16,India,NA,Jharkhand,32988134,221,4,4783,42
2020-07-17,India,NA,Jharkhand,32988134,313,4,5096,46
2020-07-18,India,NA,Jharkhand,32988134,289,2,5385,48
2020-07-19,India,NA,Jharkhand,32988134,167,1,5552,49
2020-07-20,India,NA,Jharkhand,32988134,225,4,5777,53
2020-07-21,India,NA,Jharkhand,32988134,418,8,6195,61
2020-07-22,India,NA,Jharkhand,32988134,487,3,6682,64
2020-07-23,India,NA,Jharkhand,32988134,482,3,7164,67
2020-07-24,India,NA,Jharkhand,32988134,400,9,7564,76
2020-07-25,India,NA,Jharkhand,32988134,277,7,7841,83
2020-07-26,India,NA,Jharkhand,32988134,508,0,8349,83
2020-07-27,India,NA,Jharkhand,32988134,454,7,8803,90
2020-07-28,India,NA,Jharkhand,32988134,760,4,9563,94
2020-07-29,India,NA,Jharkhand,32988134,331,5,9894,99
2020-07-30,India,NA,Jharkhand,32988134,505,4,10399,103
2020-07-31,India,NA,Jharkhand,32988134,915,3,11314,106
2020-08-01,India,NA,Jharkhand,32988134,790,8,12104,114
2020-08-02,India,NA,Jharkhand,32988134,455,4,12559,118
2020-08-03,India,NA,Jharkhand,32988134,941,7,13500,125
2020-08-04,India,NA,Jharkhand,32988134,570,4,14070,129
2020-08-05,India,NA,Jharkhand,32988134,978,7,15048,136
2020-08-06,India,NA,Jharkhand,32988134,708,9,15756,145
2020-08-07,India,NA,Jharkhand,32988134,726,6,16482,151
2020-08-08,India,NA,Jharkhand,32988134,986,9,17468,160
2020-08-09,India,NA,Jharkhand,32988134,688,17,18156,177
2020-08-10,India,NA,Jharkhand,32988134,630,12,18786,189
2020-08-11,India,NA,Jharkhand,32988134,683,5,19469,194
2020-08-12,India,NA,Jharkhand,32988134,788,8,20257,202
2020-08-13,India,NA,Jharkhand,32988134,693,7,20950,209
2020-08-14,India,NA,Jharkhand,32988134,1175,15,22125,224
2020-08-15,India,NA,Jharkhand,32988134,547,5,22672,229
2020-08-16,India,NA,Jharkhand,32988134,552,15,23224,244
2020-08-17,India,NA,Jharkhand,32988134,843,11,24067,255
2020-08-18,India,NA,Jharkhand,32988134,1241,10,25308,265
2020-08-19,India,NA,Jharkhand,32988134,967,13,26275,278
2020-08-20,India,NA,Jharkhand,32988134,638,8,26913,286
2020-08-21,India,NA,Jharkhand,32988134,1258,11,28171,297
2020-08-22,India,NA,Jharkhand,32988134,907,13,29078,310
2020-08-23,India,NA,Jharkhand,32988134,1075,8,30153,318
2020-08-24,India,NA,Jharkhand,32988134,940,17,31093,335
2020-08-25,India,NA,Jharkhand,32988134,1056,12,32149,347
2020-08-26,India,NA,Jharkhand,32988134,1137,15,33286,362
2020-08-27,India,NA,Jharkhand,32988134,1365,15,34651,377
2020-08-28,India,NA,Jharkhand,32988134,1137,12,35788,389
2020-08-29,India,NA,Jharkhand,32988134,1299,9,37087,398
2020-08-30,India,NA,Jharkhand,32988134,1323,12,38410,410
2020-08-31,India,NA,Jharkhand,32988134,3221,7,41631,417
2020-09-01,India,NA,Jharkhand,32988134,2177,11,43808,428
2020-09-02,India,NA,Jharkhand,32988134,1029,10,44837,438
2020-09-03,India,NA,Jharkhand,32988134,1618,6,46455,444
2020-09-04,India,NA,Jharkhand,32988134,1559,3,48014,447
2020-09-05,India,NA,Jharkhand,32988134,1758,15,49772,462
2020-09-06,India,NA,Jharkhand,32988134,1266,7,51038,469
2020-09-07,India,NA,Jharkhand,32988134,1557,13,52595,482
2020-09-08,India,NA,Jharkhand,32988134,2676,14,55271,496
2020-09-09,India,NA,Jharkhand,32988134,1601,16,56872,512
2020-09-10,India,NA,Jharkhand,32988134,1182,5,58054,517
2020-09-11,India,NA,Jharkhand,32988134,961,15,59015,532
2020-09-12,India,NA,Jharkhand,32988134,1420,10,60435,542
2020-09-13,India,NA,Jharkhand,32988134,1014,13,61449,555
2020-09-14,India,NA,Jharkhand,32988134,1263,6,62712,561
2020-09-15,India,NA,Jharkhand,32988134,1702,10,64414,571
2020-09-16,India,NA,Jharkhand,32988134,1635,8,66049,579
2020-09-17,India,NA,Jharkhand,32988134,1026,11,67075,590
2020-09-18,India,NA,Jharkhand,32988134,1478,12,68553,602
2020-09-19,India,NA,Jharkhand,32988134,1282,13,69835,615
2020-09-20,India,NA,Jharkhand,32988134,1492,2,71327,617
2020-09-21,India,NA,Jharkhand,32988134,1321,9,72648,626
2020-09-22,India,NA,Jharkhand,32988134,1275,15,73923,641
2020-09-23,India,NA,Jharkhand,32988134,1141,7,75064,648
2020-03-18,India,NA,Karnataka,61130704,5,0,14,1
2020-03-19,India,NA,Karnataka,61130704,1,0,15,1
2020-03-20,India,NA,Karnataka,61130704,0,0,15,1
2020-03-21,India,NA,Karnataka,61130704,5,0,20,1
2020-03-22,India,NA,Karnataka,61130704,6,0,26,1
2020-03-23,India,NA,Karnataka,61130704,7,0,33,1
2020-03-24,India,NA,Karnataka,61130704,8,0,41,1
2020-03-25,India,NA,Karnataka,61130704,10,0,51,1
2020-03-26,India,NA,Karnataka,61130704,4,1,55,2
2020-03-27,India,NA,Karnataka,61130704,9,1,64,3
2020-03-28,India,NA,Karnataka,61130704,17,0,81,3
2020-03-29,India,NA,Karnataka,61130704,2,0,83,3
2020-03-30,India,NA,Karnataka,61130704,5,0,88,3
2020-03-31,India,NA,Karnataka,61130704,13,0,101,3
2020-04-01,India,NA,Karnataka,61130704,9,0,110,3
2020-04-02,India,NA,Karnataka,61130704,14,0,124,3
2020-04-03,India,NA,Karnataka,61130704,4,1,128,4
2020-04-04,India,NA,Karnataka,61130704,16,0,144,4
2020-04-05,India,NA,Karnataka,61130704,7,0,151,4
2020-04-06,India,NA,Karnataka,61130704,12,0,163,4
2020-04-07,India,NA,Karnataka,61130704,12,0,175,4
2020-04-08,India,NA,Karnataka,61130704,6,1,181,5
2020-04-09,India,NA,Karnataka,61130704,16,1,197,6
2020-04-10,India,NA,Karnataka,61130704,10,0,207,6
2020-04-11,India,NA,Karnataka,61130704,8,0,215,6
2020-04-12,India,NA,Karnataka,61130704,17,0,232,6
2020-04-13,India,NA,Karnataka,61130704,15,2,247,8
2020-04-14,India,NA,Karnataka,61130704,13,2,260,10
2020-04-15,India,NA,Karnataka,61130704,19,2,279,12
2020-04-16,India,NA,Karnataka,61130704,36,1,315,13
2020-04-17,India,NA,Karnataka,61130704,44,0,359,13
2020-04-18,India,NA,Karnataka,61130704,25,1,384,14
2020-04-19,India,NA,Karnataka,61130704,6,2,390,16
2020-04-20,India,NA,Karnataka,61130704,18,0,408,16
2020-04-21,India,NA,Karnataka,61130704,10,1,418,17
2020-04-22,India,NA,Karnataka,61130704,9,0,427,17
2020-04-23,India,NA,Karnataka,61130704,18,0,445,17
2020-04-24,India,NA,Karnataka,61130704,29,1,474,18
2020-04-25,India,NA,Karnataka,61130704,26,0,500,18
2020-04-26,India,NA,Karnataka,61130704,3,1,503,19
2020-04-27,India,NA,Karnataka,61130704,9,1,512,20
2020-04-28,India,NA,Karnataka,61130704,11,0,523,20
2020-04-29,India,NA,Karnataka,61130704,12,1,535,21
2020-04-30,India,NA,Karnataka,61130704,30,1,565,22
2020-05-01,India,NA,Karnataka,61130704,24,0,589,22
2020-05-02,India,NA,Karnataka,61130704,12,3,601,25
2020-05-03,India,NA,Karnataka,61130704,13,0,614,25
2020-05-04,India,NA,Karnataka,61130704,37,2,651,27
2020-05-05,India,NA,Karnataka,61130704,22,2,673,29
2020-05-06,India,NA,Karnataka,61130704,20,0,693,29
2020-05-07,India,NA,Karnataka,61130704,12,1,705,30
2020-05-08,India,NA,Karnataka,61130704,48,0,753,30
2020-05-09,India,NA,Karnataka,61130704,41,0,794,30
2020-05-10,India,NA,Karnataka,61130704,54,1,848,31
2020-05-11,India,NA,Karnataka,61130704,14,0,862,31
2020-05-12,India,NA,Karnataka,61130704,63,0,925,31
2020-05-13,India,NA,Karnataka,61130704,34,2,959,33
2020-05-14,India,NA,Karnataka,61130704,28,2,987,35
2020-05-15,India,NA,Karnataka,61130704,69,1,1056,36
2020-05-16,India,NA,Karnataka,61130704,36,0,1092,36
2020-05-17,India,NA,Karnataka,61130704,55,1,1147,37
2020-05-18,India,NA,Karnataka,61130704,99,0,1246,37
2020-05-19,India,NA,Karnataka,61130704,149,3,1395,40
2020-05-20,India,NA,Karnataka,61130704,67,1,1462,41
2020-05-21,India,NA,Karnataka,61130704,143,0,1605,41
2020-05-22,India,NA,Karnataka,61130704,138,0,1743,41
2020-05-23,India,NA,Karnataka,61130704,216,1,1959,42
2020-05-24,India,NA,Karnataka,61130704,130,0,2089,42
2020-05-25,India,NA,Karnataka,61130704,93,2,2182,44
2020-05-26,India,NA,Karnataka,61130704,101,0,2283,44
2020-05-27,India,NA,Karnataka,61130704,135,3,2418,47
2020-05-28,India,NA,Karnataka,61130704,115,0,2533,47
2020-05-29,India,NA,Karnataka,61130704,248,1,2781,48
2020-05-30,India,NA,Karnataka,61130704,141,1,2922,49
2020-05-31,India,NA,Karnataka,61130704,299,2,3221,51
2020-06-01,India,NA,Karnataka,61130704,187,1,3408,52
2020-06-02,India,NA,Karnataka,61130704,388,0,3796,52
2020-06-03,India,NA,Karnataka,61130704,267,1,4063,53
2020-06-04,India,NA,Karnataka,61130704,257,4,4320,57
2020-06-05,India,NA,Karnataka,61130704,515,0,4835,57
2020-06-06,India,NA,Karnataka,61130704,378,2,5213,59
2020-06-07,India,NA,Karnataka,61130704,239,2,5452,61
2020-06-08,India,NA,Karnataka,61130704,308,3,5760,64
2020-06-09,India,NA,Karnataka,61130704,161,2,5921,66
2020-06-10,India,NA,Karnataka,61130704,120,3,6041,69
2020-06-11,India,NA,Karnataka,61130704,204,3,6245,72
2020-06-12,India,NA,Karnataka,61130704,271,7,6516,79
2020-06-13,India,NA,Karnataka,61130704,308,3,6824,82
2020-06-14,India,NA,Karnataka,61130704,176,5,7000,87
2020-06-15,India,NA,Karnataka,61130704,213,2,7213,89
2020-06-16,India,NA,Karnataka,61130704,317,7,7530,96
2020-06-17,India,NA,Karnataka,61130704,204,8,7734,104
2020-06-18,India,NA,Karnataka,61130704,210,12,7944,116
2020-06-19,India,NA,Karnataka,61130704,337,9,8281,125
2020-06-20,India,NA,Karnataka,61130704,416,9,8697,134
2020-06-21,India,NA,Karnataka,61130704,453,5,9150,139
2020-06-22,India,NA,Karnataka,61130704,249,5,9399,144
2020-06-23,India,NA,Karnataka,61130704,322,8,9721,152
2020-06-24,India,NA,Karnataka,61130704,397,14,10118,166
2020-06-25,India,NA,Karnataka,61130704,442,6,10560,172
2020-06-26,India,NA,Karnataka,61130704,445,10,11005,182
2020-06-27,India,NA,Karnataka,61130704,918,11,11923,193
2020-06-28,India,NA,Karnataka,61130704,1267,16,13190,209
2020-06-29,India,NA,Karnataka,61130704,1105,19,14295,228
2020-06-30,India,NA,Karnataka,61130704,947,20,15242,248
2020-07-01,India,NA,Karnataka,61130704,1272,7,16514,255
2020-07-02,India,NA,Karnataka,61130704,1502,19,18016,274
2020-07-03,India,NA,Karnataka,61130704,1694,21,19710,295
2020-07-04,India,NA,Karnataka,61130704,1839,42,21549,337
2020-07-05,India,NA,Karnataka,61130704,1925,37,23474,374
2020-07-06,India,NA,Karnataka,61130704,1843,30,25317,404
2020-07-07,India,NA,Karnataka,61130704,1498,15,26815,419
2020-07-08,India,NA,Karnataka,61130704,2062,54,28877,473
2020-07-09,India,NA,Karnataka,61130704,2228,17,31105,490
2020-07-10,India,NA,Karnataka,61130704,2313,57,33418,547
2020-07-11,India,NA,Karnataka,61130704,2798,70,36216,617
2020-07-12,India,NA,Karnataka,61130704,2627,71,38843,688
2020-07-13,India,NA,Karnataka,61130704,2738,73,41581,761
2020-07-14,India,NA,Karnataka,61130704,2496,87,44077,848
2020-07-15,India,NA,Karnataka,61130704,3176,87,47253,935
2020-07-16,India,NA,Karnataka,61130704,4169,104,51422,1039
2020-07-17,India,NA,Karnataka,61130704,3693,115,55115,1154
2020-07-18,India,NA,Karnataka,61130704,4537,93,59652,1247
2020-07-19,India,NA,Karnataka,61130704,4120,91,63772,1338
2020-07-20,India,NA,Karnataka,61130704,3648,72,67420,1410
2020-07-21,India,NA,Karnataka,61130704,3649,61,71069,1471
2020-07-22,India,NA,Karnataka,61130704,4764,55,75833,1526
2020-07-23,India,NA,Karnataka,61130704,5030,97,80863,1623
2020-07-24,India,NA,Karnataka,61130704,5007,110,85870,1733
2020-07-25,India,NA,Karnataka,61130704,5072,72,90942,1805
2020-07-26,India,NA,Karnataka,61130704,5199,82,96141,1887
2020-07-27,India,NA,Karnataka,61130704,5324,75,101465,1962
2020-07-28,India,NA,Karnataka,61130704,5536,102,107001,2064
2020-07-29,India,NA,Karnataka,61130704,5503,90,112504,2154
2020-07-30,India,NA,Karnataka,61130704,6128,83,118632,2237
2020-07-31,India,NA,Karnataka,61130704,5483,84,124115,2321
2020-08-01,India,NA,Karnataka,61130704,5172,98,129287,2419
2020-08-02,India,NA,Karnataka,61130704,5532,84,134819,2503
2020-08-03,India,NA,Karnataka,61130704,4752,98,139571,2601
2020-08-04,India,NA,Karnataka,61130704,6259,110,145830,2711
2020-08-05,India,NA,Karnataka,61130704,5619,100,151449,2811
2020-08-06,India,NA,Karnataka,61130704,6805,93,158254,2904
2020-08-07,India,NA,Karnataka,61130704,6670,100,164924,3004
2020-08-08,India,NA,Karnataka,61130704,7178,93,172102,3097
2020-08-09,India,NA,Karnataka,61130704,5985,107,178087,3204
2020-08-10,India,NA,Karnataka,61130704,4267,114,182354,3318
2020-08-11,India,NA,Karnataka,61130704,6257,86,188611,3404
2020-08-12,India,NA,Karnataka,61130704,7883,113,196494,3517
2020-08-13,India,NA,Karnataka,61130704,6706,103,203200,3620
2020-08-14,India,NA,Karnataka,61130704,7908,104,211108,3724
2020-08-15,India,NA,Karnataka,61130704,8818,114,219926,3838
2020-08-16,India,NA,Karnataka,61130704,7040,116,226966,3954
2020-08-17,India,NA,Karnataka,61130704,6317,115,233283,4069
2020-08-18,India,NA,Karnataka,61130704,7665,139,240948,4208
2020-08-19,India,NA,Karnataka,61130704,8642,126,249590,4334
2020-08-20,India,NA,Karnataka,61130704,7385,102,256975,4436
2020-08-21,India,NA,Karnataka,61130704,7571,93,264546,4529
2020-08-22,India,NA,Karnataka,61130704,7330,93,271876,4622
2020-08-23,India,NA,Karnataka,61130704,5938,68,277814,4690
2020-08-24,India,NA,Karnataka,61130704,5851,127,283665,4817
2020-08-25,India,NA,Karnataka,61130704,8161,148,291826,4965
2020-08-26,India,NA,Karnataka,61130704,8580,133,300406,5098
2020-08-27,India,NA,Karnataka,61130704,9386,141,309792,5239
2020-08-28,India,NA,Karnataka,61130704,8960,136,318752,5375
2020-08-29,India,NA,Karnataka,61130704,8324,115,327076,5490
2020-08-30,India,NA,Karnataka,61130704,8852,106,335928,5596
2020-08-31,India,NA,Karnataka,61130704,6495,113,342423,5709
2020-09-01,India,NA,Karnataka,61130704,9058,0,351481,5709
2020-09-02,India,NA,Karnataka,61130704,9860,0,361341,5709
2020-09-03,India,NA,Karnataka,61130704,8865,0,370206,5709
2020-09-04,India,NA,Karnataka,61130704,9280,0,379486,5709
2020-09-05,India,NA,Karnataka,61130704,9746,0,389232,5709
2020-09-06,India,NA,Karnataka,61130704,9319,95,398551,5804
2020-09-07,India,NA,Karnataka,61130704,5773,141,404324,5945
2020-09-08,India,NA,Karnataka,61130704,7866,146,412190,6091
2020-09-09,India,NA,Karnataka,61130704,9540,128,421730,6219
2020-09-10,India,NA,Karnataka,61130704,9217,129,430947,6348
2020-09-11,India,NA,Karnataka,61130704,9464,130,440411,6478
2020-09-12,India,NA,Karnataka,61130704,9140,94,449551,6572
2020-09-13,India,NA,Karnataka,61130704,9894,104,459445,6676
2020-09-14,India,NA,Karnataka,61130704,8244,119,467689,6795
2020-09-15,India,NA,Karnataka,61130704,7576,97,475265,6892
2020-09-16,India,NA,Karnataka,61130704,9725,55,484990,6947
2020-09-17,India,NA,Karnataka,61130704,9366,93,494356,7040
2020-09-18,India,NA,Karnataka,61130704,8626,179,502982,7219
2020-09-19,India,NA,Karnataka,61130704,8364,114,511346,7333
2020-09-20,India,NA,Karnataka,61130704,8191,101,519537,7434
2020-09-21,India,NA,Karnataka,61130704,7339,122,526876,7556
2020-09-22,India,NA,Karnataka,61130704,6974,83,533850,7639
2020-09-23,India,NA,Karnataka,61130704,6997,38,540847,7677
2020-03-11,India,NA,Kerala,34523726,8,0,17,0
2020-03-13,India,NA,Kerala,34523726,2,0,19,0
2020-03-14,India,NA,Kerala,34523726,19,0,19,0
2020-03-15,India,NA,Kerala,34523726,5,0,24,0
2020-03-16,India,NA,Kerala,34523726,3,0,27,0
2020-03-17,India,NA,Kerala,34523726,0,0,27,0
2020-03-18,India,NA,Kerala,34523726,0,0,27,0
2020-03-19,India,NA,Kerala,34523726,1,0,28,0
2020-03-20,India,NA,Kerala,34523726,12,0,40,0
2020-03-21,India,NA,Kerala,34523726,12,0,52,0
2020-03-22,India,NA,Kerala,34523726,15,0,67,0
2020-03-23,India,NA,Kerala,34523726,28,0,95,0
2020-03-24,India,NA,Kerala,34523726,14,0,109,0
2020-03-25,India,NA,Kerala,34523726,9,0,118,0
2020-03-26,India,NA,Kerala,34523726,19,0,137,0
2020-03-27,India,NA,Kerala,34523726,39,0,176,0
2020-03-28,India,NA,Kerala,34523726,6,1,182,1
2020-03-29,India,NA,Kerala,34523726,20,0,202,1
2020-03-30,India,NA,Kerala,34523726,32,0,234,1
2020-03-31,India,NA,Kerala,34523726,7,1,241,2
2020-04-01,India,NA,Kerala,34523726,24,0,265,2
2020-04-02,India,NA,Kerala,34523726,21,0,286,2
2020-04-03,India,NA,Kerala,34523726,9,0,295,2
2020-04-04,India,NA,Kerala,34523726,11,0,306,2
2020-04-05,India,NA,Kerala,34523726,8,0,314,2
2020-04-06,India,NA,Kerala,34523726,13,0,327,2
2020-04-07,India,NA,Kerala,34523726,9,0,336,2
2020-04-08,India,NA,Kerala,34523726,9,0,345,2
2020-04-09,India,NA,Kerala,34523726,12,0,357,2
2020-04-10,India,NA,Kerala,34523726,7,0,364,2
2020-04-11,India,NA,Kerala,34523726,10,1,374,3
2020-04-12,India,NA,Kerala,34523726,2,0,376,3
2020-04-13,India,NA,Kerala,34523726,3,0,379,3
2020-04-14,India,NA,Kerala,34523726,8,0,387,3
2020-04-15,India,NA,Kerala,34523726,1,0,388,3
2020-04-16,India,NA,Kerala,34523726,7,0,395,3
2020-04-17,India,NA,Kerala,34523726,1,0,396,3
2020-04-18,India,NA,Kerala,34523726,4,0,400,3
2020-04-19,India,NA,Kerala,34523726,2,0,402,3
2020-04-20,India,NA,Kerala,34523726,6,0,408,3
2020-04-21,India,NA,Kerala,34523726,19,0,427,3
2020-04-22,India,NA,Kerala,34523726,11,0,438,3
2020-04-23,India,NA,Kerala,34523726,10,0,448,3
2020-04-24,India,NA,Kerala,34523726,3,1,451,4
2020-04-25,India,NA,Kerala,34523726,7,0,458,4
2020-04-26,India,NA,Kerala,34523726,11,0,469,4
2020-04-27,India,NA,Kerala,34523726,13,0,482,4
2020-04-28,India,NA,Kerala,34523726,4,0,486,4
2020-04-29,India,NA,Kerala,34523726,10,0,496,4
2020-04-30,India,NA,Kerala,34523726,2,0,498,4
2020-05-01,India,NA,Kerala,34523726,0,0,498,4
2020-05-02,India,NA,Kerala,34523726,2,0,500,4
2020-05-03,India,NA,Kerala,34523726,0,0,500,4
2020-05-04,India,NA,Kerala,34523726,0,0,500,4
2020-05-05,India,NA,Kerala,34523726,3,0,503,4
2020-05-06,India,NA,Kerala,34523726,0,0,503,4
2020-05-07,India,NA,Kerala,34523726,0,0,503,4
2020-05-08,India,NA,Kerala,34523726,1,0,504,4
2020-05-09,India,NA,Kerala,34523726,2,0,506,4
2020-05-10,India,NA,Kerala,34523726,7,0,513,4
2020-05-11,India,NA,Kerala,34523726,7,0,520,4
2020-05-12,India,NA,Kerala,34523726,5,0,525,4
2020-05-13,India,NA,Kerala,34523726,10,0,535,4
2020-05-14,India,NA,Kerala,34523726,26,0,561,4
2020-05-15,India,NA,Kerala,34523726,16,0,577,4
2020-05-16,India,NA,Kerala,34523726,11,0,588,4
2020-05-17,India,NA,Kerala,34523726,14,0,602,4
2020-05-18,India,NA,Kerala,34523726,29,0,631,4
2020-05-19,India,NA,Kerala,34523726,12,0,643,4
2020-05-20,India,NA,Kerala,34523726,24,0,667,4
2020-05-21,India,NA,Kerala,34523726,24,0,691,4
2020-05-22,India,NA,Kerala,34523726,42,1,733,5
2020-05-23,India,NA,Kerala,34523726,62,0,795,5
2020-05-24,India,NA,Kerala,34523726,53,1,848,6
2020-05-25,India,NA,Kerala,34523726,49,0,897,6
2020-05-26,India,NA,Kerala,34523726,67,1,964,7
2020-05-27,India,NA,Kerala,34523726,40,0,1004,7
2020-05-28,India,NA,Kerala,34523726,85,1,1089,8
2020-05-29,India,NA,Kerala,34523726,62,1,1151,9
2020-05-30,India,NA,Kerala,34523726,58,1,1209,10
2020-05-31,India,NA,Kerala,34523726,61,0,1270,10
2020-06-01,India,NA,Kerala,34523726,57,1,1327,11
2020-06-02,India,NA,Kerala,34523726,86,1,1413,12
2020-06-03,India,NA,Kerala,34523726,82,0,1495,12
2020-06-04,India,NA,Kerala,34523726,94,3,1589,15
2020-06-05,India,NA,Kerala,34523726,111,0,1700,15
2020-06-06,India,NA,Kerala,34523726,108,1,1808,16
2020-06-07,India,NA,Kerala,34523726,107,0,1915,16
2020-06-08,India,NA,Kerala,34523726,91,1,2006,17
2020-06-09,India,NA,Kerala,34523726,91,0,2097,17
2020-06-10,India,NA,Kerala,34523726,65,1,2162,18
2020-06-11,India,NA,Kerala,34523726,83,1,2245,19
2020-06-12,India,NA,Kerala,34523726,78,1,2323,20
2020-06-13,India,NA,Kerala,34523726,85,0,2408,20
2020-06-14,India,NA,Kerala,34523726,54,0,2462,20
2020-06-15,India,NA,Kerala,34523726,82,1,2544,21
2020-06-16,India,NA,Kerala,34523726,79,0,2623,21
2020-06-17,India,NA,Kerala,34523726,75,0,2698,21
2020-06-18,India,NA,Kerala,34523726,97,1,2795,22
2020-06-19,India,NA,Kerala,34523726,118,0,2913,22
2020-06-20,India,NA,Kerala,34523726,127,0,3040,22
2020-06-21,India,NA,Kerala,34523726,133,0,3173,22
2020-06-22,India,NA,Kerala,34523726,138,0,3311,22
2020-06-23,India,NA,Kerala,34523726,141,1,3452,23
2020-06-24,India,NA,Kerala,34523726,152,0,3604,23
2020-06-25,India,NA,Kerala,34523726,123,0,3727,23
2020-06-26,India,NA,Kerala,34523726,150,0,3877,23
2020-06-27,India,NA,Kerala,34523726,195,0,4072,23
2020-06-28,India,NA,Kerala,34523726,118,0,4190,23
2020-06-29,India,NA,Kerala,34523726,122,1,4312,24
2020-06-30,India,NA,Kerala,34523726,131,1,4443,25
2020-07-01,India,NA,Kerala,34523726,151,1,4594,26
2020-07-02,India,NA,Kerala,34523726,160,0,4754,26
2020-07-03,India,NA,Kerala,34523726,211,0,4965,26
2020-07-04,India,NA,Kerala,34523726,240,0,5205,26
2020-07-05,India,NA,Kerala,34523726,225,0,5430,26
2020-07-06,India,NA,Kerala,34523726,193,2,5623,28
2020-07-07,India,NA,Kerala,34523726,272,0,5895,28
2020-07-08,India,NA,Kerala,34523726,301,0,6196,28
2020-07-09,India,NA,Kerala,34523726,339,0,6535,28
2020-07-10,India,NA,Kerala,34523726,416,0,6951,28
2020-07-11,India,NA,Kerala,34523726,488,2,7439,30
2020-07-12,India,NA,Kerala,34523726,435,2,7874,32
2020-07-13,India,NA,Kerala,34523726,449,2,8323,34
2020-07-14,India,NA,Kerala,34523726,608,1,8931,35
2020-07-15,India,NA,Kerala,34523726,623,1,9554,36
2020-07-16,India,NA,Kerala,34523726,722,2,10276,38
2020-07-17,India,NA,Kerala,34523726,791,1,11067,39
2020-07-18,India,NA,Kerala,34523726,593,2,11660,41
2020-07-19,India,NA,Kerala,34523726,821,2,12481,43
2020-07-20,India,NA,Kerala,34523726,794,1,13275,44
2020-07-21,India,NA,Kerala,34523726,720,1,13995,45
2020-07-22,India,NA,Kerala,34523726,1038,1,15033,46
2020-07-23,India,NA,Kerala,34523726,1078,5,16111,51
2020-07-24,India,NA,Kerala,34523726,885,4,16996,55
2020-07-25,India,NA,Kerala,34523726,1103,5,18099,60
2020-07-26,India,NA,Kerala,34523726,927,2,19026,62
2020-07-27,India,NA,Kerala,34523726,702,2,19728,64
2020-07-28,India,NA,Kerala,34523726,1167,4,20895,68
2020-07-29,India,NA,Kerala,34523726,903,1,21798,69
2020-07-30,India,NA,Kerala,34523726,506,2,22304,71
2020-07-31,India,NA,Kerala,34523726,1310,3,23614,74
2020-08-01,India,NA,Kerala,34523726,1129,8,24743,82
2020-08-02,India,NA,Kerala,34523726,1169,1,25912,83
2020-08-03,India,NA,Kerala,34523726,961,2,26873,85
2020-08-04,India,NA,Kerala,34523726,1083,3,27956,88
2020-08-05,India,NA,Kerala,34523726,1195,7,29151,95
2020-08-06,India,NA,Kerala,34523726,1298,3,30449,98
2020-08-07,India,NA,Kerala,34523726,1251,5,31700,103
2020-08-08,India,NA,Kerala,34523726,1420,4,33120,107
2020-08-09,India,NA,Kerala,34523726,1211,2,34331,109
2020-08-10,India,NA,Kerala,34523726,1184,7,35515,116
2020-08-11,India,NA,Kerala,34523726,1417,5,36932,121
2020-08-12,India,NA,Kerala,34523726,1212,6,38144,127
2020-08-13,India,NA,Kerala,34523726,1564,3,39708,130
2020-08-14,India,NA,Kerala,34523726,1569,10,41277,140
2020-08-15,India,NA,Kerala,34523726,1608,7,42885,147
2020-08-16,India,NA,Kerala,34523726,1530,10,44415,157
2020-08-17,India,NA,Kerala,34523726,1725,13,46140,170
2020-08-18,India,NA,Kerala,34523726,1758,6,47898,176
2020-08-19,India,NA,Kerala,34523726,2333,7,50231,183
2020-08-20,India,NA,Kerala,34523726,1968,9,52199,192
2020-08-21,India,NA,Kerala,34523726,1983,12,54182,204
2020-08-22,India,NA,Kerala,34523726,2172,15,56354,219
2020-08-23,India,NA,Kerala,34523726,1908,5,58262,224
2020-08-24,India,NA,Kerala,34523726,1242,11,59504,235
2020-08-25,India,NA,Kerala,34523726,2375,10,61879,245
2020-08-26,India,NA,Kerala,34523726,2476,13,64355,258
2020-08-27,India,NA,Kerala,34523726,2406,10,66761,268
2020-08-28,India,NA,Kerala,34523726,2543,7,69304,275
2020-08-29,India,NA,Kerala,34523726,2397,6,71701,281
2020-08-30,India,NA,Kerala,34523726,2154,7,73855,288
2020-08-31,India,NA,Kerala,34523726,1530,7,75385,295
2020-09-01,India,NA,Kerala,34523726,1140,4,76525,299
2020-09-02,India,NA,Kerala,34523726,1547,7,78072,306
2020-09-03,India,NA,Kerala,34523726,1553,10,79625,316
2020-09-04,India,NA,Kerala,34523726,2479,11,82104,327
2020-09-05,India,NA,Kerala,34523726,2655,11,84759,338
2020-09-06,India,NA,Kerala,34523726,3082,10,87841,348
2020-09-07,India,NA,Kerala,34523726,1648,12,89489,360
2020-09-08,India,NA,Kerala,34523726,3026,13,92515,373
2020-09-09,India,NA,Kerala,34523726,3402,12,95917,385
2020-09-10,India,NA,Kerala,34523726,3349,12,99266,397
2020-09-11,India,NA,Kerala,34523726,2988,14,102254,411
2020-09-12,India,NA,Kerala,34523726,2885,15,105139,426
2020-09-13,India,NA,Kerala,34523726,3139,14,108278,440
2020-09-14,India,NA,Kerala,34523726,2540,15,110818,455
2020-09-15,India,NA,Kerala,34523726,3216,11,114034,466
2020-09-16,India,NA,Kerala,34523726,3830,14,117864,480
2020-09-17,India,NA,Kerala,34523726,4351,10,122215,490
2020-09-18,India,NA,Kerala,34523726,4167,12,126382,502
2020-09-19,India,NA,Kerala,34523726,4644,18,131026,520
2020-09-20,India,NA,Kerala,34523726,4696,16,135722,536
2020-09-21,India,NA,Kerala,34523726,2910,18,138632,554
2020-09-22,India,NA,Kerala,34523726,4125,19,142757,573
2020-09-23,India,NA,Kerala,34523726,5376,20,148133,593
2020-03-21,India,NA,Ladakh,274289,3,0,13,0
2020-03-22,India,NA,Ladakh,274289,0,0,13,0
2020-03-23,India,NA,Ladakh,274289,0,0,13,0
2020-03-24,India,NA,Ladakh,274289,0,0,13,0
2020-03-25,India,NA,Ladakh,274289,0,0,13,0
2020-03-26,India,NA,Ladakh,274289,0,0,13,0
2020-03-27,India,NA,Ladakh,274289,0,0,13,0
2020-03-28,India,NA,Ladakh,274289,0,0,13,0
2020-03-29,India,NA,Ladakh,274289,0,0,13,0
2020-03-30,India,NA,Ladakh,274289,0,0,13,0
2020-03-31,India,NA,Ladakh,274289,0,0,13,0
2020-04-01,India,NA,Ladakh,274289,0,0,13,0
2020-04-02,India,NA,Ladakh,274289,0,0,13,0
2020-04-03,India,NA,Ladakh,274289,1,0,14,0
2020-04-04,India,NA,Ladakh,274289,0,0,14,0
2020-04-05,India,NA,Ladakh,274289,0,0,14,0
2020-04-06,India,NA,Ladakh,274289,0,0,14,0
2020-04-07,India,NA,Ladakh,274289,0,0,14,0
2020-04-08,India,NA,Ladakh,274289,0,0,14,0
2020-04-09,India,NA,Ladakh,274289,0,0,14,0
2020-04-10,India,NA,Ladakh,274289,1,0,15,0
2020-04-11,India,NA,Ladakh,274289,0,0,15,0
2020-04-12,India,NA,Ladakh,274289,0,0,15,0
2020-04-13,India,NA,Ladakh,274289,2,0,17,0
2020-04-14,India,NA,Ladakh,274289,0,0,17,0
2020-04-15,India,NA,Ladakh,274289,1,0,18,0
2020-04-16,India,NA,Ladakh,274289,0,0,18,0
2020-04-17,India,NA,Ladakh,274289,0,0,18,0
2020-04-18,India,NA,Ladakh,274289,0,0,18,0
2020-04-19,India,NA,Ladakh,274289,0,0,18,0
2020-04-20,India,NA,Ladakh,274289,0,0,18,0
2020-04-21,India,NA,Ladakh,274289,0,0,18,0
2020-04-22,India,NA,Ladakh,274289,0,0,18,0
2020-04-23,India,NA,Ladakh,274289,0,0,18,0
2020-04-24,India,NA,Ladakh,274289,0,0,18,0
2020-04-25,India,NA,Ladakh,274289,2,0,20,0
2020-04-26,India,NA,Ladakh,274289,0,0,20,0
2020-04-27,India,NA,Ladakh,274289,0,0,20,0
2020-04-28,India,NA,Ladakh,274289,2,0,22,0
2020-04-29,India,NA,Ladakh,274289,0,0,22,0
2020-04-30,India,NA,Ladakh,274289,0,0,22,0
2020-05-01,India,NA,Ladakh,274289,0,0,22,0
2020-05-02,India,NA,Ladakh,274289,1,0,23,0
2020-05-03,India,NA,Ladakh,274289,19,0,42,0
2020-05-04,India,NA,Ladakh,274289,0,0,42,0
2020-05-05,India,NA,Ladakh,274289,0,0,42,0
2020-05-06,India,NA,Ladakh,274289,0,0,42,0
2020-05-07,India,NA,Ladakh,274289,0,0,42,0
2020-05-08,India,NA,Ladakh,274289,0,0,42,0
2020-05-09,India,NA,Ladakh,274289,0,0,42,0
2020-05-10,India,NA,Ladakh,274289,0,0,42,0
2020-05-11,India,NA,Ladakh,274289,0,0,42,0
2020-05-12,India,NA,Ladakh,274289,0,0,42,0
2020-05-13,India,NA,Ladakh,274289,1,0,43,0
2020-05-14,India,NA,Ladakh,274289,0,0,43,0
2020-05-15,India,NA,Ladakh,274289,0,0,43,0
2020-05-16,India,NA,Ladakh,274289,0,0,43,0
2020-05-17,India,NA,Ladakh,274289,0,0,43,0
2020-05-18,India,NA,Ladakh,274289,0,0,43,0
2020-05-19,India,NA,Ladakh,274289,0,0,43,0
2020-05-20,India,NA,Ladakh,274289,1,0,44,0
2020-05-21,India,NA,Ladakh,274289,0,0,44,0
2020-05-22,India,NA,Ladakh,274289,2,0,46,0
2020-05-23,India,NA,Ladakh,274289,3,0,49,0
2020-05-24,India,NA,Ladakh,274289,3,0,52,0
2020-05-25,India,NA,Ladakh,274289,1,0,53,0
2020-05-26,India,NA,Ladakh,274289,0,0,53,0
2020-05-27,India,NA,Ladakh,274289,1,0,54,0
2020-05-28,India,NA,Ladakh,274289,20,0,74,0
2020-05-29,India,NA,Ladakh,274289,0,0,74,0
2020-05-30,India,NA,Ladakh,274289,3,0,77,0
2020-05-31,India,NA,Ladakh,274289,0,0,77,0
2020-06-01,India,NA,Ladakh,274289,0,0,77,0
2020-06-02,India,NA,Ladakh,274289,4,1,81,1
2020-06-03,India,NA,Ladakh,274289,9,0,90,1
2020-06-04,India,NA,Ladakh,274289,4,0,94,1
2020-06-05,India,NA,Ladakh,274289,3,0,97,1
2020-06-06,India,NA,Ladakh,274289,2,0,99,1
2020-06-07,India,NA,Ladakh,274289,4,0,103,1
2020-06-08,India,NA,Ladakh,274289,0,0,103,1
2020-06-09,India,NA,Ladakh,274289,5,0,108,1
2020-06-10,India,NA,Ladakh,274289,7,0,115,1
2020-06-11,India,NA,Ladakh,274289,20,0,135,1
2020-06-12,India,NA,Ladakh,274289,104,0,239,1
2020-06-13,India,NA,Ladakh,274289,198,0,437,1
2020-06-14,India,NA,Ladakh,274289,112,0,549,1
2020-06-15,India,NA,Ladakh,274289,6,0,555,1
2020-06-16,India,NA,Ladakh,274289,94,0,649,1
2020-06-17,India,NA,Ladakh,274289,38,0,687,1
2020-06-18,India,NA,Ladakh,274289,0,0,687,1
2020-06-19,India,NA,Ladakh,274289,57,0,744,1
2020-06-20,India,NA,Ladakh,274289,92,0,836,1
2020-06-21,India,NA,Ladakh,274289,1,0,837,1
2020-06-22,India,NA,Ladakh,274289,10,0,847,1
2020-06-23,India,NA,Ladakh,274289,85,0,932,1
2020-06-24,India,NA,Ladakh,274289,0,0,932,1
2020-06-25,India,NA,Ladakh,274289,9,0,941,1
2020-06-26,India,NA,Ladakh,274289,5,0,946,1
2020-06-27,India,NA,Ladakh,274289,14,0,960,1
2020-06-28,India,NA,Ladakh,274289,3,0,963,1
2020-06-29,India,NA,Ladakh,274289,1,0,964,1
2020-06-30,India,NA,Ladakh,274289,9,0,973,1
2020-07-01,India,NA,Ladakh,274289,17,0,990,1
2020-07-02,India,NA,Ladakh,274289,1,0,991,1
2020-07-03,India,NA,Ladakh,274289,11,0,1002,1
2020-07-04,India,NA,Ladakh,274289,3,0,1005,1
2020-07-05,India,NA,Ladakh,274289,0,0,1005,1
2020-07-06,India,NA,Ladakh,274289,0,0,1005,1
2020-07-07,India,NA,Ladakh,274289,36,0,1041,1
2020-07-08,India,NA,Ladakh,274289,6,0,1047,1
2020-07-09,India,NA,Ladakh,274289,8,0,1055,1
2020-07-10,India,NA,Ladakh,274289,9,0,1064,1
2020-07-11,India,NA,Ladakh,274289,13,0,1077,1
2020-07-12,India,NA,Ladakh,274289,9,0,1086,1
2020-07-13,India,NA,Ladakh,274289,7,0,1093,1
2020-07-14,India,NA,Ladakh,274289,35,0,1128,1
2020-07-15,India,NA,Ladakh,274289,14,0,1142,1
2020-07-16,India,NA,Ladakh,274289,5,0,1147,1
2020-07-17,India,NA,Ladakh,274289,4,1,1151,2
2020-07-18,India,NA,Ladakh,274289,8,0,1159,2
2020-07-19,India,NA,Ladakh,274289,19,0,1178,2
2020-07-20,India,NA,Ladakh,274289,17,0,1195,2
2020-07-21,India,NA,Ladakh,274289,3,0,1198,2
2020-07-22,India,NA,Ladakh,274289,8,0,1206,2
2020-07-23,India,NA,Ladakh,274289,4,0,1210,2
2020-07-24,India,NA,Ladakh,274289,36,0,1246,2
2020-07-25,India,NA,Ladakh,274289,30,1,1276,3
2020-07-26,India,NA,Ladakh,274289,9,1,1285,4
2020-07-27,India,NA,Ladakh,274289,21,0,1306,4
2020-07-28,India,NA,Ladakh,274289,21,0,1327,4
2020-07-29,India,NA,Ladakh,274289,20,2,1347,6
2020-07-30,India,NA,Ladakh,274289,31,1,1378,7
2020-07-31,India,NA,Ladakh,274289,26,0,1404,7
2020-08-01,India,NA,Ladakh,274289,58,0,1462,7
2020-08-02,India,NA,Ladakh,274289,4,0,1466,7
2020-08-03,India,NA,Ladakh,274289,19,0,1485,7
2020-08-04,India,NA,Ladakh,274289,49,0,1534,7
2020-08-05,India,NA,Ladakh,274289,58,0,1592,7
2020-08-06,India,NA,Ladakh,274289,3,0,1595,7
2020-08-07,India,NA,Ladakh,274289,19,2,1614,9
2020-08-08,India,NA,Ladakh,274289,25,0,1639,9
2020-08-09,India,NA,Ladakh,274289,49,0,1688,9
2020-08-10,India,NA,Ladakh,274289,29,0,1717,9
2020-08-11,India,NA,Ladakh,274289,53,0,1770,9
2020-08-12,India,NA,Ladakh,274289,41,0,1811,9
2020-08-13,India,NA,Ladakh,274289,38,0,1849,9
2020-08-14,India,NA,Ladakh,274289,30,0,1879,9
2020-08-15,India,NA,Ladakh,274289,30,1,1909,10
2020-08-16,India,NA,Ladakh,274289,39,4,1948,14
2020-08-17,India,NA,Ladakh,274289,18,0,1966,14
2020-08-18,India,NA,Ladakh,274289,44,3,2010,17
2020-08-19,India,NA,Ladakh,274289,38,1,2048,18
2020-08-20,India,NA,Ladakh,274289,29,0,2077,18
2020-08-21,India,NA,Ladakh,274289,56,1,2133,19
2020-08-22,India,NA,Ladakh,274289,77,2,2210,21
2020-08-23,India,NA,Ladakh,274289,69,2,2279,23
2020-08-24,India,NA,Ladakh,274289,51,0,2330,23
2020-08-25,India,NA,Ladakh,274289,90,1,2420,24
2020-08-26,India,NA,Ladakh,274289,31,1,2451,25
2020-08-27,India,NA,Ladakh,274289,41,2,2492,27
2020-08-28,India,NA,Ladakh,274289,48,1,2540,28
2020-08-29,India,NA,Ladakh,274289,63,4,2603,32
2020-08-30,India,NA,Ladakh,274289,35,2,2638,34
2020-08-31,India,NA,Ladakh,274289,43,0,2681,34
2020-09-01,India,NA,Ladakh,274289,52,1,2733,35
2020-09-02,India,NA,Ladakh,274289,52,0,2785,35
2020-09-03,India,NA,Ladakh,274289,55,0,2840,35
2020-09-04,India,NA,Ladakh,274289,95,0,2935,35
2020-09-05,India,NA,Ladakh,274289,61,0,2996,35
2020-09-06,India,NA,Ladakh,274289,40,0,3036,35
2020-09-07,India,NA,Ladakh,274289,28,0,3064,35
2020-09-08,India,NA,Ladakh,274289,38,0,3102,35
2020-09-09,India,NA,Ladakh,274289,40,0,3142,35
2020-09-10,India,NA,Ladakh,274289,35,1,3177,36
2020-09-11,India,NA,Ladakh,274289,51,2,3228,38
2020-09-12,India,NA,Ladakh,274289,66,1,3294,39
2020-09-13,India,NA,Ladakh,274289,51,1,3345,40
2020-09-14,India,NA,Ladakh,274289,74,1,3419,41
2020-09-15,India,NA,Ladakh,274289,80,3,3499,44
2020-09-16,India,NA,Ladakh,274289,36,2,3535,46
2020-09-17,India,NA,Ladakh,274289,41,1,3576,47
2020-09-18,India,NA,Ladakh,274289,59,1,3635,48
2020-09-19,India,NA,Ladakh,274289,73,1,3708,49
2020-09-20,India,NA,Ladakh,274289,45,0,3753,49
2020-09-21,India,NA,Ladakh,274289,79,1,3832,50
2020-09-22,India,NA,Ladakh,274289,55,0,3887,50
2020-09-23,India,NA,Ladakh,274289,46,1,3933,51
2020-03-25,India,NA,Madhya Pradesh,72597565,8,1,15,1
2020-03-26,India,NA,Madhya Pradesh,72597565,5,0,20,1
2020-03-27,India,NA,Madhya Pradesh,72597565,9,1,29,2
2020-03-28,India,NA,Madhya Pradesh,72597565,10,0,39,2
2020-03-29,India,NA,Madhya Pradesh,72597565,0,0,39,2
2020-03-30,India,NA,Madhya Pradesh,72597565,8,2,47,4
2020-03-31,India,NA,Madhya Pradesh,72597565,19,1,66,5
2020-04-01,India,NA,Madhya Pradesh,72597565,32,1,98,6
2020-04-02,India,NA,Madhya Pradesh,72597565,9,2,107,8
2020-04-03,India,NA,Madhya Pradesh,72597565,47,0,154,8
2020-04-04,India,NA,Madhya Pradesh,72597565,25,3,179,11
2020-04-05,India,NA,Madhya Pradesh,72597565,14,2,193,13
2020-04-06,India,NA,Madhya Pradesh,72597565,63,2,256,15
2020-04-07,India,NA,Madhya Pradesh,72597565,34,6,290,21
2020-04-08,India,NA,Madhya Pradesh,72597565,51,3,341,24
2020-04-09,India,NA,Madhya Pradesh,72597565,70,9,411,33
2020-04-10,India,NA,Madhya Pradesh,72597565,40,4,451,37
2020-04-11,India,NA,Madhya Pradesh,72597565,78,4,529,41
2020-04-12,India,NA,Madhya Pradesh,72597565,33,3,562,44
2020-04-13,India,NA,Madhya Pradesh,72597565,52,7,614,51
2020-04-14,India,NA,Madhya Pradesh,72597565,127,3,741,54
2020-04-15,India,NA,Madhya Pradesh,72597565,197,0,938,54
2020-04-16,India,NA,Madhya Pradesh,72597565,226,2,1164,56
2020-04-17,India,NA,Madhya Pradesh,72597565,146,14,1310,70
2020-04-18,India,NA,Madhya Pradesh,72597565,92,0,1402,70
2020-04-19,India,NA,Madhya Pradesh,72597565,5,3,1407,73
2020-04-20,India,NA,Madhya Pradesh,72597565,78,4,1485,77
2020-04-21,India,NA,Madhya Pradesh,72597565,67,4,1552,81
2020-04-22,India,NA,Madhya Pradesh,72597565,35,0,1587,81
2020-04-23,India,NA,Madhya Pradesh,72597565,100,3,1687,84
2020-04-24,India,NA,Madhya Pradesh,72597565,159,9,1846,93
2020-04-25,India,NA,Madhya Pradesh,72597565,99,7,1945,100
2020-04-26,India,NA,Madhya Pradesh,72597565,145,4,2090,104
2020-04-27,India,NA,Madhya Pradesh,72597565,75,7,2165,111
2020-04-28,India,NA,Madhya Pradesh,72597565,222,10,2387,121
2020-04-29,India,NA,Madhya Pradesh,72597565,173,10,2560,131
2020-04-30,India,NA,Madhya Pradesh,72597565,65,7,2625,138
2020-05-01,India,NA,Madhya Pradesh,72597565,90,8,2715,146
2020-05-02,India,NA,Madhya Pradesh,72597565,73,6,2788,152
2020-05-03,India,NA,Madhya Pradesh,72597565,49,5,2837,157
2020-05-04,India,NA,Madhya Pradesh,72597565,105,9,2942,166
2020-05-05,India,NA,Madhya Pradesh,72597565,107,11,3049,177
2020-05-06,India,NA,Madhya Pradesh,72597565,89,9,3138,186
2020-05-07,India,NA,Madhya Pradesh,72597565,114,8,3252,194
2020-05-08,India,NA,Madhya Pradesh,72597565,89,7,3341,201
2020-05-09,India,NA,Madhya Pradesh,72597565,116,11,3457,212
2020-05-10,India,NA,Madhya Pradesh,72597565,157,4,3614,216
2020-05-11,India,NA,Madhya Pradesh,72597565,171,6,3785,222
2020-05-12,India,NA,Madhya Pradesh,72597565,201,4,3986,226
2020-05-13,India,NA,Madhya Pradesh,72597565,187,7,4173,233
2020-05-14,India,NA,Madhya Pradesh,72597565,253,5,4426,238
2020-05-15,India,NA,Madhya Pradesh,72597565,169,2,4595,240
2020-05-16,India,NA,Madhya Pradesh,72597565,195,4,4790,244
2020-05-17,India,NA,Madhya Pradesh,72597565,187,5,4977,249
2020-05-18,India,NA,Madhya Pradesh,72597565,259,4,5236,253
2020-05-19,India,NA,Madhya Pradesh,72597565,229,6,5465,259
2020-05-20,India,NA,Madhya Pradesh,72597565,270,9,5735,268
2020-05-21,India,NA,Madhya Pradesh,72597565,246,4,5981,272
2020-05-22,India,NA,Madhya Pradesh,72597565,189,1,6170,273
2020-05-23,India,NA,Madhya Pradesh,72597565,201,9,6371,282
2020-05-24,India,NA,Madhya Pradesh,72597565,294,9,6665,291
2020-05-25,India,NA,Madhya Pradesh,72597565,194,10,6859,301
2020-05-26,India,NA,Madhya Pradesh,72597565,165,5,7024,306
2020-05-27,India,NA,Madhya Pradesh,72597565,237,8,7261,314
2020-05-28,India,NA,Madhya Pradesh,72597565,192,8,7453,322
2020-05-29,India,NA,Madhya Pradesh,72597565,192,13,7645,335
2020-05-30,India,NA,Madhya Pradesh,72597565,246,9,7891,344
2020-05-31,India,NA,Madhya Pradesh,72597565,198,7,8089,351
2020-06-01,India,NA,Madhya Pradesh,72597565,194,8,8283,359
2020-06-02,India,NA,Madhya Pradesh,72597565,137,6,8420,365
2020-06-03,India,NA,Madhya Pradesh,72597565,168,7,8588,372
2020-06-04,India,NA,Madhya Pradesh,72597565,174,6,8762,378
2020-06-05,India,NA,Madhya Pradesh,72597565,234,7,8996,385
2020-06-06,India,NA,Madhya Pradesh,72597565,232,15,9228,400
2020-06-07,India,NA,Madhya Pradesh,72597565,173,13,9401,413
2020-06-08,India,NA,Madhya Pradesh,72597565,237,2,9638,415
2020-06-09,India,NA,Madhya Pradesh,72597565,211,6,9849,421
2020-06-10,India,NA,Madhya Pradesh,72597565,200,7,10049,428
2020-06-11,India,NA,Madhya Pradesh,72597565,192,4,10241,432
2020-06-12,India,NA,Madhya Pradesh,72597565,202,9,10443,441
2020-06-13,India,NA,Madhya Pradesh,72597565,198,7,10641,448
2020-06-14,India,NA,Madhya Pradesh,72597565,161,12,10802,460
2020-06-15,India,NA,Madhya Pradesh,72597565,133,6,10935,466
2020-06-16,India,NA,Madhya Pradesh,72597565,148,11,11083,477
2020-06-17,India,NA,Madhya Pradesh,72597565,161,6,11244,483
2020-06-18,India,NA,Madhya Pradesh,72597565,182,4,11426,487
2020-06-19,India,NA,Madhya Pradesh,72597565,156,9,11582,496
2020-06-20,India,NA,Madhya Pradesh,72597565,142,6,11724,502
2020-06-21,India,NA,Madhya Pradesh,72597565,179,14,11903,516
2020-06-22,India,NA,Madhya Pradesh,72597565,175,6,12078,522
2020-06-23,India,NA,Madhya Pradesh,72597565,183,4,12261,526
2020-06-24,India,NA,Madhya Pradesh,72597565,187,9,12448,535
2020-06-25,India,NA,Madhya Pradesh,72597565,147,8,12595,543
2020-06-26,India,NA,Madhya Pradesh,72597565,203,4,12798,547
2020-06-27,India,NA,Madhya Pradesh,72597565,167,4,12965,551
2020-06-28,India,NA,Madhya Pradesh,72597565,221,7,13186,558
2020-06-29,India,NA,Madhya Pradesh,72597565,184,7,13370,565
2020-06-30,India,NA,Madhya Pradesh,72597565,223,8,13593,573
2020-07-01,India,NA,Madhya Pradesh,72597565,268,9,13861,582
2020-07-02,India,NA,Madhya Pradesh,72597565,245,8,14106,590
2020-07-03,India,NA,Madhya Pradesh,72597565,191,4,14297,594
2020-07-04,India,NA,Madhya Pradesh,72597565,307,5,14604,599
2020-07-05,India,NA,Madhya Pradesh,72597565,326,10,14930,609
2020-07-06,India,NA,Madhya Pradesh,72597565,354,9,15284,618
2020-07-07,India,NA,Madhya Pradesh,72597565,343,5,15627,623
2020-07-08,India,NA,Madhya Pradesh,72597565,409,7,16036,630
2020-07-09,India,NA,Madhya Pradesh,72597565,305,5,16341,635
2020-07-10,India,NA,Madhya Pradesh,72597565,316,4,16657,639
2020-07-11,India,NA,Madhya Pradesh,72597565,544,6,17201,645
2020-07-12,India,NA,Madhya Pradesh,72597565,431,9,17632,654
2020-07-13,India,NA,Madhya Pradesh,72597565,575,10,18207,664
2020-07-14,India,NA,Madhya Pradesh,72597565,798,10,19005,674
2020-07-15,India,NA,Madhya Pradesh,72597565,638,9,19643,683
2020-07-16,India,NA,Madhya Pradesh,72597565,735,7,20378,690
2020-07-17,India,NA,Madhya Pradesh,72597565,704,9,21082,699
2020-07-18,India,NA,Madhya Pradesh,72597565,681,8,21763,707
2020-07-19,India,NA,Madhya Pradesh,72597565,837,15,22600,722
2020-07-20,India,NA,Madhya Pradesh,72597565,710,17,23310,739
2020-07-21,India,NA,Madhya Pradesh,72597565,785,18,24095,757
2020-07-22,India,NA,Madhya Pradesh,72597565,747,14,24842,771
2020-07-23,India,NA,Madhya Pradesh,72597565,632,10,25474,781
2020-07-24,India,NA,Madhya Pradesh,72597565,736,11,26210,792
2020-07-25,India,NA,Madhya Pradesh,72597565,716,8,26926,800
2020-07-26,India,NA,Madhya Pradesh,72597565,874,12,27800,812
2020-07-27,India,NA,Madhya Pradesh,72597565,789,9,28589,821
2020-07-28,India,NA,Madhya Pradesh,72597565,628,10,29217,831
2020-07-29,India,NA,Madhya Pradesh,72597565,917,14,30134,845
2020-07-30,India,NA,Madhya Pradesh,72597565,834,13,30968,858
2020-07-31,India,NA,Madhya Pradesh,72597565,838,10,31806,868
2020-08-01,India,NA,Madhya Pradesh,72597565,808,9,32614,877
2020-08-02,India,NA,Madhya Pradesh,72597565,921,10,33535,887
2020-08-03,India,NA,Madhya Pradesh,72597565,750,14,34285,901
2020-08-04,India,NA,Madhya Pradesh,72597565,797,12,35082,913
2020-08-05,India,NA,Madhya Pradesh,72597565,652,17,35734,930
2020-08-06,India,NA,Madhya Pradesh,72597565,830,17,36564,947
2020-08-07,India,NA,Madhya Pradesh,72597565,734,16,37298,963
2020-08-08,India,NA,Madhya Pradesh,72597565,859,15,38157,978
2020-08-09,India,NA,Madhya Pradesh,72597565,868,19,39025,997
2020-08-10,India,NA,Madhya Pradesh,72597565,866,19,39891,1016
2020-08-11,India,NA,Madhya Pradesh,72597565,843,18,40734,1034
2020-08-12,India,NA,Madhya Pradesh,72597565,870,15,41604,1049
2020-08-13,India,NA,Madhya Pradesh,72597565,1014,17,42618,1066
2020-08-14,India,NA,Madhya Pradesh,72597565,796,16,43414,1082
2020-08-15,India,NA,Madhya Pradesh,72597565,1019,13,44433,1095
2020-08-16,India,NA,Madhya Pradesh,72597565,1022,11,45455,1106
2020-08-17,India,NA,Madhya Pradesh,72597565,930,23,46385,1129
2020-08-18,India,NA,Madhya Pradesh,72597565,990,13,47375,1142
2020-08-19,India,NA,Madhya Pradesh,72597565,976,18,48351,1160
2020-08-20,India,NA,Madhya Pradesh,72597565,1142,12,49493,1172
2020-08-21,India,NA,Madhya Pradesh,72597565,1147,14,50640,1186
2020-08-22,India,NA,Madhya Pradesh,72597565,1226,21,51866,1207
2020-08-23,India,NA,Madhya Pradesh,72597565,1263,23,53129,1230
2020-08-24,India,NA,Madhya Pradesh,72597565,1292,17,54421,1247
2020-08-25,India,NA,Madhya Pradesh,72597565,1379,19,55800,1266
2020-08-26,India,NA,Madhya Pradesh,72597565,1064,17,56864,1283
2020-08-27,India,NA,Madhya Pradesh,72597565,1317,24,58181,1307
2020-08-28,India,NA,Madhya Pradesh,72597565,1252,17,59433,1324
2020-08-29,India,NA,Madhya Pradesh,72597565,1442,22,60875,1346
2020-08-30,India,NA,Madhya Pradesh,72597565,1558,29,62433,1375
2020-08-31,India,NA,Madhya Pradesh,72597565,1532,20,63965,1395
2020-09-01,India,NA,Madhya Pradesh,72597565,1525,32,65490,1427
2020-09-02,India,NA,Madhya Pradesh,72597565,1424,27,66914,1454
2020-09-03,India,NA,Madhya Pradesh,72597565,1672,30,68586,1484
2020-09-04,India,NA,Madhya Pradesh,72597565,1658,30,70244,1514
2020-09-05,India,NA,Madhya Pradesh,72597565,1636,30,71880,1544
2020-09-06,India,NA,Madhya Pradesh,72597565,1694,29,73574,1573
2020-09-07,India,NA,Madhya Pradesh,72597565,1885,17,75459,1590
2020-09-08,India,NA,Madhya Pradesh,72597565,1864,20,77323,1610
2020-09-09,India,NA,Madhya Pradesh,72597565,1869,31,79192,1641
2020-09-10,India,NA,Madhya Pradesh,72597565,2187,21,81379,1662
2020-09-11,India,NA,Madhya Pradesh,72597565,2240,30,83619,1692
2020-09-12,India,NA,Madhya Pradesh,72597565,2347,37,85966,1729
2020-09-13,India,NA,Madhya Pradesh,72597565,2281,34,88247,1763
2020-09-14,India,NA,Madhya Pradesh,72597565,2483,29,90730,1792
2020-09-15,India,NA,Madhya Pradesh,72597565,2323,29,93053,1821
2020-09-16,India,NA,Madhya Pradesh,72597565,2462,24,95515,1845
2020-09-17,India,NA,Madhya Pradesh,72597565,2391,33,97906,1878
2020-09-18,India,NA,Madhya Pradesh,72597565,2552,24,100458,1902
2020-09-19,India,NA,Madhya Pradesh,72597565,2607,42,103065,1944
2020-09-20,India,NA,Madhya Pradesh,72597565,2579,27,105644,1971
2020-09-21,India,NA,Madhya Pradesh,72597565,2523,37,108167,2008
2020-09-22,India,NA,Madhya Pradesh,72597565,2544,28,110711,2036
2020-09-23,India,NA,Madhya Pradesh,72597565,2346,42,113057,2078
2020-03-13,India,NA,Maharashtra,112372972,3,0,11,0
2020-03-14,India,NA,Maharashtra,112372972,14,0,14,0
2020-03-15,India,NA,Maharashtra,112372972,18,0,32,0
2020-03-16,India,NA,Maharashtra,112372972,6,0,38,0
2020-03-17,India,NA,Maharashtra,112372972,3,1,41,1
2020-03-18,India,NA,Maharashtra,112372972,3,0,44,1
2020-03-19,India,NA,Maharashtra,112372972,4,0,48,1
2020-03-20,India,NA,Maharashtra,112372972,4,0,52,1
2020-03-21,India,NA,Maharashtra,112372972,12,0,64,1
2020-03-22,India,NA,Maharashtra,112372972,10,1,74,2
2020-03-23,India,NA,Maharashtra,112372972,23,0,97,2
2020-03-24,India,NA,Maharashtra,112372972,10,0,107,2
2020-03-25,India,NA,Maharashtra,112372972,15,0,122,2
2020-03-26,India,NA,Maharashtra,112372972,3,1,125,3
2020-03-27,India,NA,Maharashtra,112372972,31,1,156,4
2020-03-28,India,NA,Maharashtra,112372972,30,2,186,6
2020-03-29,India,NA,Maharashtra,112372972,17,1,203,7
2020-03-30,India,NA,Maharashtra,112372972,17,2,220,9
2020-03-31,India,NA,Maharashtra,112372972,82,1,302,10
2020-04-01,India,NA,Maharashtra,112372972,33,3,335,13
2020-04-02,India,NA,Maharashtra,112372972,88,8,423,21
2020-04-03,India,NA,Maharashtra,112372972,64,5,487,26
2020-04-04,India,NA,Maharashtra,112372972,148,6,635,32
2020-04-05,India,NA,Maharashtra,112372972,112,13,747,45
2020-04-06,India,NA,Maharashtra,112372972,121,7,868,52
2020-04-07,India,NA,Maharashtra,112372972,150,12,1018,64
2020-04-08,India,NA,Maharashtra,112372972,117,8,1135,72
2020-04-09,India,NA,Maharashtra,112372972,229,25,1364,97
2020-04-10,India,NA,Maharashtra,112372972,210,12,1574,109
2020-04-11,India,NA,Maharashtra,112372972,187,17,1761,126
2020-04-12,India,NA,Maharashtra,112372972,221,22,1982,148
2020-04-13,India,NA,Maharashtra,112372972,352,11,2334,159
2020-04-14,India,NA,Maharashtra,112372972,346,18,2680,177
2020-04-15,India,NA,Maharashtra,112372972,236,9,2916,186
2020-04-16,India,NA,Maharashtra,112372972,285,7,3201,193
2020-04-17,India,NA,Maharashtra,112372972,120,7,3321,200
2020-04-18,India,NA,Maharashtra,112372972,327,10,3648,210
2020-04-19,India,NA,Maharashtra,112372972,552,12,4200,222
2020-04-20,India,NA,Maharashtra,112372972,466,9,4666,231
2020-04-21,India,NA,Maharashtra,112372972,552,19,5218,250
2020-04-22,India,NA,Maharashtra,112372972,431,18,5649,268
2020-04-23,India,NA,Maharashtra,112372972,778,14,6427,282
2020-04-24,India,NA,Maharashtra,112372972,390,18,6817,300
2020-04-25,India,NA,Maharashtra,112372972,811,22,7628,322
2020-04-26,India,NA,Maharashtra,112372972,440,19,8068,341
2020-04-27,India,NA,Maharashtra,112372972,522,27,8590,368
2020-04-28,India,NA,Maharashtra,112372972,728,31,9318,399
2020-04-29,India,NA,Maharashtra,112372972,597,32,9915,431
2020-04-30,India,NA,Maharashtra,112372972,583,27,10498,458
2020-05-01,India,NA,Maharashtra,112372972,1008,26,11506,484
2020-05-02,India,NA,Maharashtra,112372972,790,36,12296,520
2020-05-03,India,NA,Maharashtra,112372972,678,27,12974,547
2020-05-04,India,NA,Maharashtra,112372972,1567,35,14541,582
2020-05-05,India,NA,Maharashtra,112372972,984,34,15525,616
2020-05-06,India,NA,Maharashtra,112372972,1233,34,16758,650
2020-05-07,India,NA,Maharashtra,112372972,1216,43,17974,693
2020-05-08,India,NA,Maharashtra,112372972,1089,37,19063,730
2020-05-09,India,NA,Maharashtra,112372972,1165,48,20228,778
2020-05-10,India,NA,Maharashtra,112372972,1943,53,22171,831
2020-05-11,India,NA,Maharashtra,112372972,1230,36,23401,867
2020-05-12,India,NA,Maharashtra,112372972,1026,53,24427,920
2020-05-13,India,NA,Maharashtra,112372972,1495,54,25922,974
2020-05-14,India,NA,Maharashtra,112372972,1602,44,27524,1018
2020-05-15,India,NA,Maharashtra,112372972,1576,49,29100,1067
2020-05-16,India,NA,Maharashtra,112372972,1606,67,30706,1134
2020-05-17,India,NA,Maharashtra,112372972,2347,63,33053,1197
2020-05-18,India,NA,Maharashtra,112372972,2005,51,35058,1248
2020-05-19,India,NA,Maharashtra,112372972,2078,76,37136,1324
2020-05-20,India,NA,Maharashtra,112372972,2161,65,39297,1389
2020-05-21,India,NA,Maharashtra,112372972,2345,64,41642,1453
2020-05-22,India,NA,Maharashtra,112372972,2940,63,44582,1516
2020-05-23,India,NA,Maharashtra,112372972,2608,60,47190,1576
2020-05-24,India,NA,Maharashtra,112372972,3041,58,50231,1634
2020-05-25,India,NA,Maharashtra,112372972,2436,60,52667,1694
2020-05-26,India,NA,Maharashtra,112372972,2091,97,54758,1791
2020-05-27,India,NA,Maharashtra,112372972,2190,105,56948,1896
2020-05-28,India,NA,Maharashtra,112372972,2598,85,59546,1981
2020-05-29,India,NA,Maharashtra,112372972,2682,116,62228,2097
2020-05-30,India,NA,Maharashtra,112372972,2940,99,65168,2196
2020-05-31,India,NA,Maharashtra,112372972,2487,89,67655,2285
2020-06-01,India,NA,Maharashtra,112372972,2358,76,70013,2361
2020-06-02,India,NA,Maharashtra,112372972,2287,103,72300,2464
2020-06-03,India,NA,Maharashtra,112372972,2560,122,74860,2586
2020-06-04,India,NA,Maharashtra,112372972,2933,123,77793,2709
2020-06-05,India,NA,Maharashtra,112372972,2436,139,80229,2848
2020-06-06,India,NA,Maharashtra,112372972,2739,120,82968,2968
2020-06-07,India,NA,Maharashtra,112372972,3007,91,85975,3059
2020-06-08,India,NA,Maharashtra,112372972,2554,109,88529,3168
2020-06-09,India,NA,Maharashtra,112372972,2258,120,90787,3288
2020-06-10,India,NA,Maharashtra,112372972,3254,149,94041,3437
2020-06-11,India,NA,Maharashtra,112372972,3607,152,97648,3589
2020-06-12,India,NA,Maharashtra,112372972,3493,127,101141,3716
2020-06-13,India,NA,Maharashtra,112372972,3427,113,104568,3829
2020-06-14,India,NA,Maharashtra,112372972,3390,120,107958,3949
2020-06-15,India,NA,Maharashtra,112372972,2786,178,110744,4127
2020-06-16,India,NA,Maharashtra,112372972,2701,1409,113445,5536
2020-06-17,India,NA,Maharashtra,112372972,3307,114,116752,5650
2020-06-18,India,NA,Maharashtra,112372972,3752,100,120504,5750
2020-06-19,India,NA,Maharashtra,112372972,3827,142,124331,5892
2020-06-20,India,NA,Maharashtra,112372972,3874,91,128205,5983
2020-06-21,India,NA,Maharashtra,112372972,3870,186,132075,6169
2020-06-22,India,NA,Maharashtra,112372972,3721,113,135796,6282
2020-06-23,India,NA,Maharashtra,112372972,3214,248,139010,6530
2020-06-24,India,NA,Maharashtra,112372972,3889,208,142899,6738
2020-06-25,India,NA,Maharashtra,112372972,4842,192,147741,6930
2020-06-26,India,NA,Maharashtra,112372972,5024,175,152765,7105
2020-06-27,India,NA,Maharashtra,112372972,6368,167,159133,7272
2020-06-28,India,NA,Maharashtra,112372972,5493,156,164626,7428
2020-06-29,India,NA,Maharashtra,112372972,5257,181,169883,7609
2020-06-30,India,NA,Maharashtra,112372972,4878,245,174761,7854
2020-07-01,India,NA,Maharashtra,112372972,5537,198,180298,8052
2020-07-02,India,NA,Maharashtra,112372972,6328,125,186626,8177
2020-07-03,India,NA,Maharashtra,112372972,6364,198,192990,8375
2020-07-04,India,NA,Maharashtra,112372972,7074,295,200064,8670
2020-07-05,India,NA,Maharashtra,112372972,6555,151,206619,8821
2020-07-06,India,NA,Maharashtra,112372972,5368,204,211987,9025
2020-07-07,India,NA,Maharashtra,112372972,5134,224,217121,9249
2020-07-08,India,NA,Maharashtra,112372972,6603,198,223724,9447
2020-07-09,India,NA,Maharashtra,112372972,6875,219,230599,9666
2020-07-10,India,NA,Maharashtra,112372972,7862,226,238461,9892
2020-07-11,India,NA,Maharashtra,112372972,8139,223,246600,10115
2020-07-12,India,NA,Maharashtra,112372972,7827,173,254427,10288
2020-07-13,India,NA,Maharashtra,112372972,6497,193,260924,10481
2020-07-14,India,NA,Maharashtra,112372972,6741,213,267665,10694
2020-07-15,India,NA,Maharashtra,112372972,7975,233,275640,10927
2020-07-16,India,NA,Maharashtra,112372972,8641,266,284281,11193
2020-07-17,India,NA,Maharashtra,112372972,8308,258,292589,11451
2020-07-18,India,NA,Maharashtra,112372972,8348,144,300937,11595
2020-07-19,India,NA,Maharashtra,112372972,9518,258,310455,11853
2020-07-20,India,NA,Maharashtra,112372972,8240,176,318695,12029
2020-07-21,India,NA,Maharashtra,112372972,8336,246,327031,12275
2020-07-22,India,NA,Maharashtra,112372972,10576,280,337607,12555
2020-07-23,India,NA,Maharashtra,112372972,9895,298,347502,12853
2020-07-24,India,NA,Maharashtra,112372972,9615,278,357117,13131
2020-07-25,India,NA,Maharashtra,112372972,9251,257,366368,13388
2020-07-26,India,NA,Maharashtra,112372972,9431,267,375799,13655
2020-07-27,India,NA,Maharashtra,112372972,7924,227,383723,13882
2020-07-28,India,NA,Maharashtra,112372972,7717,282,391440,14164
2020-07-29,India,NA,Maharashtra,112372972,9211,298,400651,14462
2020-07-30,India,NA,Maharashtra,112372972,11147,266,411798,14728
2020-07-31,India,NA,Maharashtra,112372972,10320,265,422118,14993
2020-08-01,India,NA,Maharashtra,112372972,9601,322,431719,15315
2020-08-02,India,NA,Maharashtra,112372972,9509,260,441228,15575
2020-08-03,India,NA,Maharashtra,112372972,8968,266,450196,15841
2020-08-04,India,NA,Maharashtra,112372972,7760,300,457956,16141
2020-08-05,India,NA,Maharashtra,112372972,10309,334,468265,16475
2020-08-06,India,NA,Maharashtra,112372972,11514,316,479779,16791
2020-08-07,India,NA,Maharashtra,112372972,10483,300,490262,17091
2020-08-08,India,NA,Maharashtra,112372972,12822,275,503084,17366
2020-08-09,India,NA,Maharashtra,112372972,12248,390,515332,17756
2020-08-10,India,NA,Maharashtra,112372972,9181,293,524513,18049
2020-08-11,India,NA,Maharashtra,112372972,11088,256,535601,18305
2020-08-12,India,NA,Maharashtra,112372972,12712,344,548313,18649
2020-08-13,India,NA,Maharashtra,112372972,11813,413,560126,19062
2020-08-14,India,NA,Maharashtra,112372972,12608,364,572734,19426
2020-08-15,India,NA,Maharashtra,112372972,12020,322,584754,19748
2020-08-16,India,NA,Maharashtra,112372972,11111,288,595865,20036
2020-08-17,India,NA,Maharashtra,112372972,8493,228,604358,20264
2020-08-18,India,NA,Maharashtra,112372972,11119,422,615477,20686
2020-08-19,India,NA,Maharashtra,112372972,13165,346,628642,21032
2020-08-20,India,NA,Maharashtra,112372972,14647,326,643289,21358
2020-08-21,India,NA,Maharashtra,112372972,14161,339,657450,21697
2020-08-22,India,NA,Maharashtra,112372972,14492,297,671942,21994
2020-08-23,India,NA,Maharashtra,112372972,10441,258,682383,22252
2020-08-24,India,NA,Maharashtra,112372972,11015,212,693398,22464
2020-08-25,India,NA,Maharashtra,112372972,10425,329,703823,22793
2020-08-26,India,NA,Maharashtra,112372972,14888,295,718711,23088
2020-08-27,India,NA,Maharashtra,112372972,14857,355,733568,23443
2020-08-28,India,NA,Maharashtra,112372972,14427,331,747995,23774
2020-08-29,India,NA,Maharashtra,112372972,16286,328,764281,24102
2020-08-30,India,NA,Maharashtra,112372972,16408,296,780689,24398
2020-08-31,India,NA,Maharashtra,112372972,11852,184,792541,24582
2020-09-01,India,NA,Maharashtra,112372972,15765,320,808306,24902
2020-09-02,India,NA,Maharashtra,112372972,17433,292,825739,25194
2020-09-03,India,NA,Maharashtra,112372972,18105,391,843844,25585
2020-09-04,India,NA,Maharashtra,112372972,19218,378,863062,25963
2020-09-05,India,NA,Maharashtra,112372972,20800,312,883862,26275
2020-09-06,India,NA,Maharashtra,112372972,23350,328,907212,26603
2020-09-07,India,NA,Maharashtra,112372972,16429,423,923641,27026
2020-09-08,India,NA,Maharashtra,112372972,20131,380,943772,27406
2020-09-09,India,NA,Maharashtra,112372972,23577,380,967349,27786
2020-09-10,India,NA,Maharashtra,112372972,23446,495,990795,28281
2020-09-11,India,NA,Maharashtra,112372972,24886,442,1015681,28723
2020-09-12,India,NA,Maharashtra,112372972,22084,391,1037765,29114
2020-09-13,India,NA,Maharashtra,112372972,22543,416,1060308,29530
2020-09-14,India,NA,Maharashtra,112372972,17066,363,1077374,29893
2020-09-15,India,NA,Maharashtra,112372972,20482,515,1097856,30408
2020-09-16,India,NA,Maharashtra,112372972,23365,474,1121221,30882
2020-09-17,India,NA,Maharashtra,112372972,24619,468,1145840,31350
2020-09-18,India,NA,Maharashtra,112372972,21656,440,1167496,31790
2020-09-19,India,NA,Maharashtra,112372972,20519,425,1188015,32215
2020-09-20,India,NA,Maharashtra,112372972,20627,455,1208642,32670
2020-09-21,India,NA,Maharashtra,112372972,15738,344,1224380,33014
2020-09-22,India,NA,Maharashtra,112372972,18390,392,1242770,33406
2020-09-23,India,NA,Maharashtra,112372972,21029,479,1263799,33885
2020-05-20,India,NA,Manipur,2855794,16,0,25,0
2020-05-21,India,NA,Manipur,2855794,0,0,25,0
2020-05-22,India,NA,Manipur,2855794,1,0,26,0
2020-05-23,India,NA,Manipur,2855794,3,0,29,0
2020-05-24,India,NA,Manipur,2855794,3,0,32,0
2020-05-25,India,NA,Manipur,2855794,4,0,36,0
2020-05-26,India,NA,Manipur,2855794,3,0,39,0
2020-05-27,India,NA,Manipur,2855794,5,0,44,0
2020-05-28,India,NA,Manipur,2855794,11,0,55,0
2020-05-29,India,NA,Manipur,2855794,4,0,59,0
2020-05-30,India,NA,Manipur,2855794,1,0,60,0
2020-05-31,India,NA,Manipur,2855794,11,0,71,0
2020-06-01,India,NA,Manipur,2855794,12,0,83,0
2020-06-02,India,NA,Manipur,2855794,6,0,89,0
2020-06-03,India,NA,Manipur,2855794,19,0,108,0
2020-06-04,India,NA,Manipur,2855794,16,0,124,0
2020-06-05,India,NA,Manipur,2855794,8,0,132,0
2020-06-06,India,NA,Manipur,2855794,25,0,157,0
2020-06-07,India,NA,Manipur,2855794,15,0,172,0
2020-06-08,India,NA,Manipur,2855794,100,0,272,0
2020-06-09,India,NA,Manipur,2855794,32,0,304,0
2020-06-10,India,NA,Manipur,2855794,7,0,311,0
2020-06-11,India,NA,Manipur,2855794,55,0,366,0
2020-06-12,India,NA,Manipur,2855794,19,0,385,0
2020-06-13,India,NA,Manipur,2855794,64,0,449,0
2020-06-14,India,NA,Manipur,2855794,9,0,458,0
2020-06-15,India,NA,Manipur,2855794,32,0,490,0
2020-06-16,India,NA,Manipur,2855794,10,0,500,0
2020-06-17,India,NA,Manipur,2855794,52,0,552,0
2020-06-18,India,NA,Manipur,2855794,54,0,606,0
2020-06-19,India,NA,Manipur,2855794,75,0,681,0
2020-06-20,India,NA,Manipur,2855794,96,0,777,0
2020-06-21,India,NA,Manipur,2855794,64,0,841,0
2020-06-22,India,NA,Manipur,2855794,57,0,898,0
2020-06-23,India,NA,Manipur,2855794,23,0,921,0
2020-06-24,India,NA,Manipur,2855794,49,0,970,0
2020-06-25,India,NA,Manipur,2855794,86,0,1056,0
2020-06-26,India,NA,Manipur,2855794,19,0,1075,0
2020-06-27,India,NA,Manipur,2855794,17,0,1092,0
2020-06-28,India,NA,Manipur,2855794,93,0,1185,0
2020-06-29,India,NA,Manipur,2855794,42,0,1227,0
2020-06-30,India,NA,Manipur,2855794,7,0,1234,0
2020-07-01,India,NA,Manipur,2855794,26,0,1260,0
2020-07-02,India,NA,Manipur,2855794,19,0,1279,0
2020-07-03,India,NA,Manipur,2855794,37,0,1316,0
2020-07-04,India,NA,Manipur,2855794,9,0,1325,0
2020-07-05,India,NA,Manipur,2855794,41,0,1366,0
2020-07-06,India,NA,Manipur,2855794,24,0,1390,0
2020-07-07,India,NA,Manipur,2855794,40,0,1430,0
2020-07-08,India,NA,Manipur,2855794,5,0,1435,0
2020-07-09,India,NA,Manipur,2855794,15,0,1450,0
2020-07-10,India,NA,Manipur,2855794,132,0,1582,0
2020-07-11,India,NA,Manipur,2855794,11,0,1593,0
2020-07-12,India,NA,Manipur,2855794,16,0,1609,0
2020-07-13,India,NA,Manipur,2855794,17,0,1626,0
2020-07-14,India,NA,Manipur,2855794,46,0,1672,0
2020-07-15,India,NA,Manipur,2855794,28,0,1700,0
2020-07-16,India,NA,Manipur,2855794,64,0,1764,0
2020-07-17,India,NA,Manipur,2855794,36,0,1800,0
2020-07-18,India,NA,Manipur,2855794,91,0,1891,0
2020-07-19,India,NA,Manipur,2855794,20,0,1911,0
2020-07-20,India,NA,Manipur,2855794,14,0,1925,0
2020-07-21,India,NA,Manipur,2855794,90,0,2015,0
2020-07-22,India,NA,Manipur,2855794,45,0,2060,0
2020-07-23,India,NA,Manipur,2855794,55,0,2115,0
2020-07-24,India,NA,Manipur,2855794,31,0,2146,0
2020-07-25,India,NA,Manipur,2855794,30,0,2176,0
2020-07-26,India,NA,Manipur,2855794,59,0,2235,0
2020-07-27,India,NA,Manipur,2855794,51,0,2286,0
2020-07-28,India,NA,Manipur,2855794,31,0,2317,0
2020-07-29,India,NA,Manipur,2855794,141,1,2458,1
2020-07-30,India,NA,Manipur,2855794,47,3,2505,4
2020-07-31,India,NA,Manipur,2855794,116,1,2621,5
2020-08-01,India,NA,Manipur,2855794,135,1,2756,6
2020-08-02,India,NA,Manipur,2855794,75,1,2831,7
2020-08-03,India,NA,Manipur,2855794,89,0,2920,7
2020-08-04,India,NA,Manipur,2855794,98,0,3018,7
2020-08-05,India,NA,Manipur,2855794,75,0,3093,7
2020-08-06,India,NA,Manipur,2855794,124,1,3217,8
2020-08-07,India,NA,Manipur,2855794,249,2,3466,10
2020-08-08,India,NA,Manipur,2855794,169,1,3635,11
2020-08-09,India,NA,Manipur,2855794,118,0,3753,11
2020-08-10,India,NA,Manipur,2855794,100,0,3853,11
2020-08-11,India,NA,Manipur,2855794,88,1,3941,12
2020-08-12,India,NA,Manipur,2855794,41,0,3982,12
2020-08-13,India,NA,Manipur,2855794,130,1,4112,13
2020-08-14,India,NA,Manipur,2855794,86,0,4198,13
2020-08-15,India,NA,Manipur,2855794,192,0,4390,13
2020-08-16,India,NA,Manipur,2855794,179,3,4569,16
2020-08-17,India,NA,Manipur,2855794,118,1,4687,17
2020-08-18,India,NA,Manipur,2855794,78,1,4765,18
2020-08-19,India,NA,Manipur,2855794,111,0,4876,18
2020-08-20,India,NA,Manipur,2855794,49,0,4925,18
2020-08-21,India,NA,Manipur,2855794,124,2,5049,20
2020-08-22,India,NA,Manipur,2855794,83,2,5132,22
2020-08-23,India,NA,Manipur,2855794,114,0,5246,22
2020-08-24,India,NA,Manipur,2855794,116,0,5362,22
2020-08-25,India,NA,Manipur,2855794,82,2,5444,24
2020-08-26,India,NA,Manipur,2855794,141,1,5585,25
2020-08-27,India,NA,Manipur,2855794,140,0,5725,25
2020-08-28,India,NA,Manipur,2855794,118,2,5843,27
2020-08-29,India,NA,Manipur,2855794,117,1,5960,28
2020-08-30,India,NA,Manipur,2855794,152,0,6112,28
2020-08-31,India,NA,Manipur,2855794,140,0,6252,28
2020-09-01,India,NA,Manipur,2855794,130,1,6382,29
2020-09-02,India,NA,Manipur,2855794,125,0,6507,29
2020-09-03,India,NA,Manipur,2855794,102,3,6609,32
2020-09-04,India,NA,Manipur,2855794,90,3,6699,35
2020-09-05,India,NA,Manipur,2855794,184,1,6883,36
2020-09-06,India,NA,Manipur,2855794,139,2,7022,38
2020-09-07,India,NA,Manipur,2855794,84,0,7106,38
2020-09-08,India,NA,Manipur,2855794,96,1,7202,39
2020-09-09,India,NA,Manipur,2855794,160,1,7362,40
2020-09-10,India,NA,Manipur,2855794,108,4,7470,44
2020-09-11,India,NA,Manipur,2855794,109,0,7579,44
2020-09-12,India,NA,Manipur,2855794,152,1,7731,45
2020-09-13,India,NA,Manipur,2855794,144,1,7875,46
2020-09-14,India,NA,Manipur,2855794,96,0,7971,46
2020-09-15,India,NA,Manipur,2855794,239,1,8210,47
2020-09-16,India,NA,Manipur,2855794,110,1,8320,48
2020-09-17,India,NA,Manipur,2855794,110,3,8430,51
2020-09-18,India,NA,Manipur,2855794,177,1,8607,52
2020-09-19,India,NA,Manipur,2855794,117,3,8724,55
2020-09-20,India,NA,Manipur,2855794,170,2,8894,57
2020-09-21,India,NA,Manipur,2855794,116,2,9010,59
2020-09-22,India,NA,Manipur,2855794,270,1,9280,60
2020-09-23,India,NA,Manipur,2855794,96,2,9376,62
2020-04-18,India,NA,Meghalaya,3211000,2,0,11,1
2020-04-19,India,NA,Meghalaya,3211000,0,0,11,1
2020-04-20,India,NA,Meghalaya,3211000,0,0,11,1
2020-04-21,India,NA,Meghalaya,3211000,1,0,12,1
2020-04-22,India,NA,Meghalaya,3211000,0,0,12,1
2020-04-23,India,NA,Meghalaya,3211000,0,0,12,1
2020-04-24,India,NA,Meghalaya,3211000,0,0,12,1
2020-04-25,India,NA,Meghalaya,3211000,0,0,12,1
2020-04-26,India,NA,Meghalaya,3211000,0,0,12,1
2020-04-27,India,NA,Meghalaya,3211000,0,0,12,1
2020-04-28,India,NA,Meghalaya,3211000,0,0,12,1
2020-04-29,India,NA,Meghalaya,3211000,0,0,12,1
2020-04-30,India,NA,Meghalaya,3211000,0,0,12,1
2020-05-01,India,NA,Meghalaya,3211000,0,0,12,1
2020-05-02,India,NA,Meghalaya,3211000,0,0,12,1
2020-05-03,India,NA,Meghalaya,3211000,0,0,12,1
2020-05-04,India,NA,Meghalaya,3211000,0,0,12,1
2020-05-05,India,NA,Meghalaya,3211000,0,0,12,1
2020-05-06,India,NA,Meghalaya,3211000,0,0,12,1
2020-05-07,India,NA,Meghalaya,3211000,0,0,12,1
2020-05-08,India,NA,Meghalaya,3211000,0,0,12,1
2020-05-09,India,NA,Meghalaya,3211000,1,0,13,1
2020-05-10,India,NA,Meghalaya,3211000,0,0,13,1
2020-05-11,India,NA,Meghalaya,3211000,0,0,13,1
2020-05-12,India,NA,Meghalaya,3211000,0,0,13,1
2020-05-13,India,NA,Meghalaya,3211000,0,0,13,1
2020-05-14,India,NA,Meghalaya,3211000,0,0,13,1
2020-05-15,India,NA,Meghalaya,3211000,0,0,13,1
2020-05-16,India,NA,Meghalaya,3211000,0,0,13,1
2020-05-17,India,NA,Meghalaya,3211000,0,0,13,1
2020-05-18,India,NA,Meghalaya,3211000,0,0,13,1
2020-05-19,India,NA,Meghalaya,3211000,0,0,13,1
2020-05-20,India,NA,Meghalaya,3211000,1,0,14,1
2020-05-21,India,NA,Meghalaya,3211000,0,0,14,1
2020-05-22,India,NA,Meghalaya,3211000,0,0,14,1
2020-05-23,India,NA,Meghalaya,3211000,0,0,14,1
2020-05-24,India,NA,Meghalaya,3211000,0,0,14,1
2020-05-25,India,NA,Meghalaya,3211000,1,0,15,1
2020-05-26,India,NA,Meghalaya,3211000,5,0,20,1
2020-05-27,India,NA,Meghalaya,3211000,0,0,20,1
2020-05-28,India,NA,Meghalaya,3211000,1,0,21,1
2020-05-29,India,NA,Meghalaya,3211000,6,0,27,1
2020-05-30,India,NA,Meghalaya,3211000,0,0,27,1
2020-05-31,India,NA,Meghalaya,3211000,0,0,27,1
2020-06-01,India,NA,Meghalaya,3211000,1,0,28,1
2020-06-02,India,NA,Meghalaya,3211000,2,0,30,1
2020-06-03,India,NA,Meghalaya,3211000,3,0,33,1
2020-06-04,India,NA,Meghalaya,3211000,0,0,33,1
2020-06-05,India,NA,Meghalaya,3211000,0,0,33,1
2020-06-06,India,NA,Meghalaya,3211000,0,0,33,1
2020-06-07,India,NA,Meghalaya,3211000,3,0,36,1
2020-06-08,India,NA,Meghalaya,3211000,3,0,39,1
2020-06-09,India,NA,Meghalaya,3211000,4,0,43,1
2020-06-10,India,NA,Meghalaya,3211000,1,0,44,1
2020-06-11,India,NA,Meghalaya,3211000,0,0,44,1
2020-06-12,India,NA,Meghalaya,3211000,0,0,44,1
2020-06-13,India,NA,Meghalaya,3211000,0,0,44,1
2020-06-14,India,NA,Meghalaya,3211000,0,0,44,1
2020-06-15,India,NA,Meghalaya,3211000,0,0,44,1
2020-06-16,India,NA,Meghalaya,3211000,0,0,44,1
2020-06-17,India,NA,Meghalaya,3211000,0,0,44,1
2020-06-18,India,NA,Meghalaya,3211000,0,0,44,1
2020-06-19,India,NA,Meghalaya,3211000,0,0,44,1
2020-06-20,India,NA,Meghalaya,3211000,0,0,44,1
2020-06-21,India,NA,Meghalaya,3211000,0,0,44,1
2020-06-22,India,NA,Meghalaya,3211000,2,0,45,1
2020-06-23,India,NA,Meghalaya,3211000,1,0,46,1
2020-06-24,India,NA,Meghalaya,3211000,0,0,46,1
2020-06-25,India,NA,Meghalaya,3211000,0,0,46,1
2020-06-26,India,NA,Meghalaya,3211000,2,0,48,1
2020-06-27,India,NA,Meghalaya,3211000,0,0,48,1
2020-06-28,India,NA,Meghalaya,3211000,2,0,50,1
2020-06-29,India,NA,Meghalaya,3211000,1,0,51,1
2020-06-30,India,NA,Meghalaya,3211000,2,0,53,1
2020-07-01,India,NA,Meghalaya,3211000,2,0,55,1
2020-07-02,India,NA,Meghalaya,3211000,3,0,58,1
2020-07-03,India,NA,Meghalaya,3211000,4,0,62,1
2020-07-04,India,NA,Meghalaya,3211000,8,0,70,1
2020-07-05,India,NA,Meghalaya,3211000,2,0,72,1
2020-07-06,India,NA,Meghalaya,3211000,16,0,88,1
2020-07-07,India,NA,Meghalaya,3211000,6,0,94,1
2020-07-08,India,NA,Meghalaya,3211000,6,1,100,2
2020-07-09,India,NA,Meghalaya,3211000,13,0,113,2
2020-07-10,India,NA,Meghalaya,3211000,73,0,186,2
2020-07-11,India,NA,Meghalaya,3211000,76,0,262,2
2020-07-12,India,NA,Meghalaya,3211000,33,0,295,2
2020-07-13,India,NA,Meghalaya,3211000,21,0,316,2
2020-07-14,India,NA,Meghalaya,3211000,2,0,318,2
2020-07-15,India,NA,Meghalaya,3211000,19,0,337,2
2020-07-16,India,NA,Meghalaya,3211000,40,0,377,2
2020-07-17,India,NA,Meghalaya,3211000,26,0,403,2
2020-07-18,India,NA,Meghalaya,3211000,15,0,418,2
2020-07-19,India,NA,Meghalaya,3211000,32,2,450,4
2020-07-20,India,NA,Meghalaya,3211000,19,0,469,4
2020-07-21,India,NA,Meghalaya,3211000,21,0,490,4
2020-07-22,India,NA,Meghalaya,3211000,24,0,514,4
2020-07-23,India,NA,Meghalaya,3211000,20,0,534,4
2020-07-24,India,NA,Meghalaya,3211000,53,1,587,5
2020-07-25,India,NA,Meghalaya,3211000,59,0,646,5
2020-07-26,India,NA,Meghalaya,3211000,56,0,702,5
2020-07-27,India,NA,Meghalaya,3211000,36,0,738,5
2020-07-28,India,NA,Meghalaya,3211000,41,0,779,5
2020-07-29,India,NA,Meghalaya,3211000,5,0,784,5
2020-07-30,India,NA,Meghalaya,3211000,19,0,803,5
2020-07-31,India,NA,Meghalaya,3211000,20,0,823,5
2020-08-01,India,NA,Meghalaya,3211000,33,0,856,5
2020-08-02,India,NA,Meghalaya,3211000,18,0,874,5
2020-08-03,India,NA,Meghalaya,3211000,28,0,902,5
2020-08-04,India,NA,Meghalaya,3211000,15,0,917,5
2020-08-05,India,NA,Meghalaya,3211000,22,0,939,5
2020-08-06,India,NA,Meghalaya,3211000,51,0,990,5
2020-08-07,India,NA,Meghalaya,3211000,16,0,1006,5
2020-08-08,India,NA,Meghalaya,3211000,17,1,1023,6
2020-08-09,India,NA,Meghalaya,3211000,39,0,1062,6
2020-08-10,India,NA,Meghalaya,3211000,53,0,1115,6
2020-08-11,India,NA,Meghalaya,3211000,27,0,1142,6
2020-08-12,India,NA,Meghalaya,3211000,37,0,1179,6
2020-08-13,India,NA,Meghalaya,3211000,14,0,1193,6
2020-08-14,India,NA,Meghalaya,3211000,35,0,1228,6
2020-08-15,India,NA,Meghalaya,3211000,64,0,1292,6
2020-08-16,India,NA,Meghalaya,3211000,82,0,1374,6
2020-08-17,India,NA,Meghalaya,3211000,44,0,1418,6
2020-08-18,India,NA,Meghalaya,3211000,39,0,1457,6
2020-08-19,India,NA,Meghalaya,3211000,78,0,1535,6
2020-08-20,India,NA,Meghalaya,3211000,126,0,1661,6
2020-08-21,India,NA,Meghalaya,3211000,57,0,1718,6
2020-08-22,India,NA,Meghalaya,3211000,93,1,1811,7
2020-08-23,India,NA,Meghalaya,3211000,106,1,1917,8
2020-08-24,India,NA,Meghalaya,3211000,59,0,1976,8
2020-08-25,India,NA,Meghalaya,3211000,42,0,2018,8
2020-08-26,India,NA,Meghalaya,3211000,32,0,2050,8
2020-08-27,India,NA,Meghalaya,3211000,80,1,2130,9
2020-08-28,India,NA,Meghalaya,3211000,110,1,2240,10
2020-08-29,India,NA,Meghalaya,3211000,43,0,2283,10
2020-08-30,India,NA,Meghalaya,3211000,60,0,2343,10
2020-08-31,India,NA,Meghalaya,3211000,25,0,2368,10
2020-09-01,India,NA,Meghalaya,3211000,72,2,2440,12
2020-09-02,India,NA,Meghalaya,3211000,77,1,2517,13
2020-09-03,India,NA,Meghalaya,3211000,109,0,2626,13
2020-09-04,India,NA,Meghalaya,3211000,108,1,2734,14
2020-09-05,India,NA,Meghalaya,3211000,182,1,2916,15
2020-09-06,India,NA,Meghalaya,3211000,89,1,3005,16
2020-09-07,India,NA,Meghalaya,3211000,29,1,3034,17
2020-09-08,India,NA,Meghalaya,3211000,42,0,3076,17
2020-09-09,India,NA,Meghalaya,3211000,121,2,3197,19
2020-09-10,India,NA,Meghalaya,3211000,99,1,3296,20
2020-09-11,India,NA,Meghalaya,3211000,151,4,3447,24
2020-09-12,India,NA,Meghalaya,3211000,168,1,3615,25
2020-09-13,India,NA,Meghalaya,3211000,109,1,3724,26
2020-09-14,India,NA,Meghalaya,3211000,139,2,3863,28
2020-09-15,India,NA,Meghalaya,3211000,174,1,4037,29
2020-09-16,India,NA,Meghalaya,3211000,158,0,4195,29
2020-09-17,India,NA,Meghalaya,3211000,162,3,4357,32
2020-09-18,India,NA,Meghalaya,3211000,90,2,4447,34
2020-09-19,India,NA,Meghalaya,3211000,112,2,4559,36
2020-09-20,India,NA,Meghalaya,3211000,101,0,4660,36
2020-09-21,India,NA,Meghalaya,3211000,73,2,4733,38
2020-09-22,India,NA,Meghalaya,3211000,58,2,4791,40
2020-09-23,India,NA,Meghalaya,3211000,170,2,4961,42
2020-06-02,India,NA,Mizoram,1097206,12,0,13,0
2020-06-03,India,NA,Mizoram,1097206,1,0,14,0
2020-06-04,India,NA,Mizoram,1097206,3,0,17,0
2020-06-05,India,NA,Mizoram,1097206,7,0,24,0
2020-06-06,India,NA,Mizoram,1097206,0,0,24,0
2020-06-07,India,NA,Mizoram,1097206,10,0,34,0
2020-06-08,India,NA,Mizoram,1097206,8,0,42,0
2020-06-09,India,NA,Mizoram,1097206,46,0,88,0
2020-06-10,India,NA,Mizoram,1097206,5,0,93,0
2020-06-11,India,NA,Mizoram,1097206,9,0,102,0
2020-06-12,India,NA,Mizoram,1097206,2,0,104,0
2020-06-13,India,NA,Mizoram,1097206,6,0,110,0
2020-06-14,India,NA,Mizoram,1097206,2,0,112,0
2020-06-15,India,NA,Mizoram,1097206,5,0,117,0
2020-06-16,India,NA,Mizoram,1097206,4,0,121,0
2020-06-17,India,NA,Mizoram,1097206,0,0,121,0
2020-06-18,India,NA,Mizoram,1097206,9,0,130,0
2020-06-19,India,NA,Mizoram,1097206,0,0,130,0
2020-06-20,India,NA,Mizoram,1097206,10,0,140,0
2020-06-21,India,NA,Mizoram,1097206,1,0,141,0
2020-06-22,India,NA,Mizoram,1097206,1,0,142,0
2020-06-23,India,NA,Mizoram,1097206,0,0,142,0
2020-06-24,India,NA,Mizoram,1097206,3,0,145,0
2020-06-25,India,NA,Mizoram,1097206,0,0,145,0
2020-06-26,India,NA,Mizoram,1097206,2,0,147,0
2020-06-27,India,NA,Mizoram,1097206,3,0,150,0
2020-06-28,India,NA,Mizoram,1097206,1,0,151,0
2020-06-29,India,NA,Mizoram,1097206,0,0,151,0
2020-06-30,India,NA,Mizoram,1097206,9,0,160,0
2020-07-01,India,NA,Mizoram,1097206,0,0,160,0
2020-07-02,India,NA,Mizoram,1097206,2,0,162,0
2020-07-03,India,NA,Mizoram,1097206,0,0,162,0
2020-07-04,India,NA,Mizoram,1097206,2,0,164,0
2020-07-05,India,NA,Mizoram,1097206,22,0,186,0
2020-07-06,India,NA,Mizoram,1097206,11,0,197,0
2020-07-07,India,NA,Mizoram,1097206,1,0,198,0
2020-07-08,India,NA,Mizoram,1097206,5,0,203,0
2020-07-09,India,NA,Mizoram,1097206,0,0,203,0
2020-07-10,India,NA,Mizoram,1097206,23,0,226,0
2020-07-11,India,NA,Mizoram,1097206,1,0,227,0
2020-07-12,India,NA,Mizoram,1097206,4,0,231,0
2020-07-13,India,NA,Mizoram,1097206,2,0,233,0
2020-07-14,India,NA,Mizoram,1097206,5,0,238,0
2020-07-15,India,NA,Mizoram,1097206,0,0,238,0
2020-07-16,India,NA,Mizoram,1097206,34,0,272,0
2020-07-17,India,NA,Mizoram,1097206,10,0,282,0
2020-07-18,India,NA,Mizoram,1097206,2,0,284,0
2020-07-19,India,NA,Mizoram,1097206,0,0,284,0
2020-07-20,India,NA,Mizoram,1097206,13,0,297,0
2020-07-21,India,NA,Mizoram,1097206,0,0,297,0
2020-07-22,India,NA,Mizoram,1097206,20,0,317,0
2020-07-23,India,NA,Mizoram,1097206,9,0,326,0
2020-07-24,India,NA,Mizoram,1097206,6,0,332,0
2020-07-25,India,NA,Mizoram,1097206,29,0,361,0
2020-07-26,India,NA,Mizoram,1097206,0,0,361,0
2020-07-27,India,NA,Mizoram,1097206,0,0,361,0
2020-07-28,India,NA,Mizoram,1097206,23,0,384,0
2020-07-29,India,NA,Mizoram,1097206,11,0,395,0
2020-07-30,India,NA,Mizoram,1097206,13,0,408,0
2020-07-31,India,NA,Mizoram,1097206,0,0,408,0
2020-08-01,India,NA,Mizoram,1097206,5,0,413,0
2020-08-02,India,NA,Mizoram,1097206,57,0,470,0
2020-08-03,India,NA,Mizoram,1097206,26,0,496,0
2020-08-04,India,NA,Mizoram,1097206,6,0,502,0
2020-08-05,India,NA,Mizoram,1097206,3,0,505,0
2020-08-06,India,NA,Mizoram,1097206,33,0,538,0
2020-08-07,India,NA,Mizoram,1097206,21,0,559,0
2020-08-08,India,NA,Mizoram,1097206,8,0,567,0
2020-08-09,India,NA,Mizoram,1097206,41,0,608,0
2020-08-10,India,NA,Mizoram,1097206,12,0,620,0
2020-08-11,India,NA,Mizoram,1097206,3,0,623,0
2020-08-12,India,NA,Mizoram,1097206,25,0,648,0
2020-08-13,India,NA,Mizoram,1097206,1,0,649,0
2020-08-14,India,NA,Mizoram,1097206,8,0,657,0
2020-08-15,India,NA,Mizoram,1097206,56,0,713,0
2020-08-16,India,NA,Mizoram,1097206,64,0,777,0
2020-08-17,India,NA,Mizoram,1097206,12,0,789,0
2020-08-18,India,NA,Mizoram,1097206,26,0,815,0
2020-08-19,India,NA,Mizoram,1097206,45,0,860,0
2020-08-20,India,NA,Mizoram,1097206,14,0,874,0
2020-08-21,India,NA,Mizoram,1097206,21,0,895,0
2020-08-22,India,NA,Mizoram,1097206,8,0,903,0
2020-08-23,India,NA,Mizoram,1097206,15,0,918,0
2020-08-24,India,NA,Mizoram,1097206,0,0,918,0
2020-08-25,India,NA,Mizoram,1097206,35,0,953,0
2020-08-26,India,NA,Mizoram,1097206,14,0,967,0
2020-08-27,India,NA,Mizoram,1097206,7,0,974,0
2020-08-28,India,NA,Mizoram,1097206,29,0,1003,0
2020-08-29,India,NA,Mizoram,1097206,0,0,1003,0
2020-08-30,India,NA,Mizoram,1097206,5,0,1008,0
2020-08-31,India,NA,Mizoram,1097206,3,0,1011,0
2020-09-01,India,NA,Mizoram,1097206,1,0,1012,0
2020-09-02,India,NA,Mizoram,1097206,8,0,1020,0
2020-09-03,India,NA,Mizoram,1097206,20,0,1040,0
2020-09-04,India,NA,Mizoram,1097206,6,0,1046,0
2020-09-05,India,NA,Mizoram,1097206,16,0,1062,0
2020-09-06,India,NA,Mizoram,1097206,31,0,1093,0
2020-09-07,India,NA,Mizoram,1097206,21,0,1114,0
2020-09-08,India,NA,Mizoram,1097206,9,0,1123,0
2020-09-09,India,NA,Mizoram,1097206,69,0,1192,0
2020-09-10,India,NA,Mizoram,1097206,141,0,1333,0
2020-09-11,India,NA,Mizoram,1097206,20,0,1353,0
2020-09-12,India,NA,Mizoram,1097206,26,0,1379,0
2020-09-13,India,NA,Mizoram,1097206,35,0,1414,0
2020-09-14,India,NA,Mizoram,1097206,14,0,1428,0
2020-09-15,India,NA,Mizoram,1097206,40,0,1468,0
2020-09-16,India,NA,Mizoram,1097206,12,0,1480,0
2020-09-17,India,NA,Mizoram,1097206,26,0,1506,0
2020-09-18,India,NA,Mizoram,1097206,28,0,1534,0
2020-09-19,India,NA,Mizoram,1097206,14,0,1548,0
2020-09-20,India,NA,Mizoram,1097206,30,0,1578,0
2020-09-21,India,NA,Mizoram,1097206,7,0,1585,0
2020-09-22,India,NA,Mizoram,1097206,106,0,1691,0
2020-09-23,India,NA,Mizoram,1097206,22,0,1713,0
2020-05-28,India,NA,Nagaland,1978502,9,0,18,0
2020-05-29,India,NA,Nagaland,1978502,7,0,25,0
2020-05-30,India,NA,Nagaland,1978502,11,0,36,0
2020-05-31,India,NA,Nagaland,1978502,7,0,43,0
2020-06-01,India,NA,Nagaland,1978502,0,0,43,0
2020-06-02,India,NA,Nagaland,1978502,6,0,49,0
2020-06-03,India,NA,Nagaland,1978502,9,0,58,0
2020-06-04,India,NA,Nagaland,1978502,22,0,80,0
2020-06-05,India,NA,Nagaland,1978502,27,0,107,0
2020-06-06,India,NA,Nagaland,1978502,0,0,107,0
2020-06-07,India,NA,Nagaland,1978502,9,0,116,0
2020-06-08,India,NA,Nagaland,1978502,6,0,122,0
2020-06-09,India,NA,Nagaland,1978502,5,0,127,0
2020-06-10,India,NA,Nagaland,1978502,1,0,128,0
2020-06-11,India,NA,Nagaland,1978502,2,0,130,0
2020-06-12,India,NA,Nagaland,1978502,26,0,156,0
2020-06-13,India,NA,Nagaland,1978502,7,0,163,0
2020-06-14,India,NA,Nagaland,1978502,10,0,173,0
2020-06-15,India,NA,Nagaland,1978502,4,0,177,0
2020-06-16,India,NA,Nagaland,1978502,2,0,179,0
2020-06-17,India,NA,Nagaland,1978502,14,0,193,0
2020-06-18,India,NA,Nagaland,1978502,0,0,193,0
2020-06-19,India,NA,Nagaland,1978502,5,0,198,0
2020-06-20,India,NA,Nagaland,1978502,3,0,201,0
2020-06-21,India,NA,Nagaland,1978502,10,0,211,0
2020-06-22,India,NA,Nagaland,1978502,69,0,280,0
2020-06-23,India,NA,Nagaland,1978502,50,0,330,0
2020-06-24,India,NA,Nagaland,1978502,17,0,347,0
2020-06-25,India,NA,Nagaland,1978502,8,0,355,0
2020-06-26,India,NA,Nagaland,1978502,16,0,371,0
2020-06-27,India,NA,Nagaland,1978502,16,0,387,0
2020-06-28,India,NA,Nagaland,1978502,28,0,415,0
2020-06-29,India,NA,Nagaland,1978502,36,0,451,0
2020-06-30,India,NA,Nagaland,1978502,8,0,459,0
2020-07-01,India,NA,Nagaland,1978502,42,0,501,0
2020-07-02,India,NA,Nagaland,1978502,34,0,535,0
2020-07-03,India,NA,Nagaland,1978502,4,0,539,0
2020-07-04,India,NA,Nagaland,1978502,24,0,563,0
2020-07-05,India,NA,Nagaland,1978502,27,0,590,0
2020-07-06,India,NA,Nagaland,1978502,35,0,625,0
2020-07-07,India,NA,Nagaland,1978502,19,0,644,0
2020-07-08,India,NA,Nagaland,1978502,13,0,657,0
2020-07-09,India,NA,Nagaland,1978502,16,0,673,0
2020-07-10,India,NA,Nagaland,1978502,59,0,732,0
2020-07-11,India,NA,Nagaland,1978502,16,0,748,0
2020-07-12,India,NA,Nagaland,1978502,26,0,774,0
2020-07-13,India,NA,Nagaland,1978502,71,0,845,0
2020-07-14,India,NA,Nagaland,1978502,51,0,896,0
2020-07-15,India,NA,Nagaland,1978502,6,0,902,0
2020-07-16,India,NA,Nagaland,1978502,14,0,916,0
2020-07-17,India,NA,Nagaland,1978502,40,0,956,0
2020-07-18,India,NA,Nagaland,1978502,22,0,978,0
2020-07-19,India,NA,Nagaland,1978502,10,0,988,0
2020-07-20,India,NA,Nagaland,1978502,33,0,1021,0
2020-07-21,India,NA,Nagaland,1978502,9,0,1030,0
2020-07-22,India,NA,Nagaland,1978502,54,0,1084,0
2020-07-23,India,NA,Nagaland,1978502,90,0,1174,0
2020-07-24,India,NA,Nagaland,1978502,65,1,1239,1
2020-07-25,India,NA,Nagaland,1978502,50,3,1289,4
2020-07-26,India,NA,Nagaland,1978502,50,0,1339,4
2020-07-27,India,NA,Nagaland,1978502,46,1,1385,5
2020-07-28,India,NA,Nagaland,1978502,75,0,1460,5
2020-07-29,India,NA,Nagaland,1978502,53,0,1513,5
2020-07-30,India,NA,Nagaland,1978502,53,0,1566,5
2020-07-31,India,NA,Nagaland,1978502,127,0,1693,5
2020-08-01,India,NA,Nagaland,1978502,138,0,1831,5
2020-08-02,India,NA,Nagaland,1978502,104,0,1935,5
2020-08-03,India,NA,Nagaland,1978502,194,0,2129,5
2020-08-04,India,NA,Nagaland,1978502,276,0,2405,5
2020-08-05,India,NA,Nagaland,1978502,93,2,2498,6
2020-08-06,India,NA,Nagaland,1978502,82,0,2580,6
2020-08-07,India,NA,Nagaland,1978502,77,1,2657,7
2020-08-08,India,NA,Nagaland,1978502,31,0,2688,7
2020-08-09,India,NA,Nagaland,1978502,93,1,2781,8
2020-08-10,India,NA,Nagaland,1978502,230,0,3011,8
2020-08-11,India,NA,Nagaland,1978502,20,0,3031,8
2020-08-12,India,NA,Nagaland,1978502,87,0,3118,8
2020-08-13,India,NA,Nagaland,1978502,50,0,3168,8
2020-08-14,India,NA,Nagaland,1978502,154,0,3322,8
2020-08-15,India,NA,Nagaland,1978502,18,0,3340,8
2020-08-16,India,NA,Nagaland,1978502,54,0,3394,8
2020-08-17,India,NA,Nagaland,1978502,61,0,3455,8
2020-08-18,India,NA,Nagaland,1978502,65,0,3520,8
2020-08-19,India,NA,Nagaland,1978502,38,0,3558,8
2020-08-20,India,NA,Nagaland,1978502,25,0,3583,8
2020-08-21,India,NA,Nagaland,1978502,36,0,3619,8
2020-08-22,India,NA,Nagaland,1978502,16,1,3635,8
2020-08-23,India,NA,Nagaland,1978502,51,0,3686,8
2020-08-24,India,NA,Nagaland,1978502,28,0,3714,8
2020-08-25,India,NA,Nagaland,1978502,38,0,3752,8
2020-08-26,India,NA,Nagaland,1978502,26,0,3778,8
2020-08-27,India,NA,Nagaland,1978502,6,0,3784,8
2020-08-28,India,NA,Nagaland,1978502,21,0,3805,8
2020-08-29,India,NA,Nagaland,1978502,46,0,3851,8
2020-08-30,India,NA,Nagaland,1978502,71,0,3922,8
2020-08-31,India,NA,Nagaland,1978502,28,0,3950,8
2020-09-01,India,NA,Nagaland,1978502,53,0,4003,8
2020-09-02,India,NA,Nagaland,1978502,14,0,4017,8
2020-09-03,India,NA,Nagaland,1978502,49,0,4066,8
2020-09-04,India,NA,Nagaland,1978502,41,0,4107,8
2020-09-05,India,NA,Nagaland,1978502,21,0,4128,8
2020-09-06,India,NA,Nagaland,1978502,50,0,4178,8
2020-09-07,India,NA,Nagaland,1978502,42,0,4220,8
2020-09-08,India,NA,Nagaland,1978502,25,0,4245,8
2020-09-09,India,NA,Nagaland,1978502,130,0,4375,8
2020-09-10,India,NA,Nagaland,1978502,261,0,4636,8
2020-09-11,India,NA,Nagaland,1978502,310,0,4946,8
2020-09-12,India,NA,Nagaland,1978502,118,0,5064,8
2020-09-13,India,NA,Nagaland,1978502,19,0,5083,8
2020-09-14,India,NA,Nagaland,1978502,131,0,5214,8
2020-09-15,India,NA,Nagaland,1978502,15,2,5229,10
2020-09-16,India,NA,Nagaland,1978502,34,0,5263,10
2020-09-17,India,NA,Nagaland,1978502,43,0,5306,10
2020-09-18,India,NA,Nagaland,1978502,51,0,5357,10
2020-09-19,India,NA,Nagaland,1978502,35,0,5392,10
2020-09-20,India,NA,Nagaland,1978502,59,0,5451,10
2020-09-21,India,NA,Nagaland,1978502,93,0,5544,10
2020-09-22,India,NA,Nagaland,1978502,60,0,5604,10
2020-09-23,India,NA,Nagaland,1978502,67,1,5671,11
2020-04-03,India,NA,Odisha,41974218,15,0,20,0
2020-04-04,India,NA,Odisha,41974218,1,0,21,0
2020-04-05,India,NA,Odisha,41974218,18,0,39,0
2020-04-06,India,NA,Odisha,41974218,1,0,40,0
2020-04-07,India,NA,Odisha,41974218,2,1,42,1
2020-04-08,India,NA,Odisha,41974218,0,0,42,1
2020-04-09,India,NA,Odisha,41974218,6,0,48,1
2020-04-10,India,NA,Odisha,41974218,2,0,50,1
2020-04-11,India,NA,Odisha,41974218,4,0,54,1
2020-04-12,India,NA,Odisha,41974218,0,0,54,1
2020-04-13,India,NA,Odisha,41974218,1,0,55,1
2020-04-14,India,NA,Odisha,41974218,5,0,60,1
2020-04-15,India,NA,Odisha,41974218,0,0,60,1
2020-04-16,India,NA,Odisha,41974218,0,0,60,1
2020-04-17,India,NA,Odisha,41974218,0,0,60,1
2020-04-18,India,NA,Odisha,41974218,1,0,61,1
2020-04-19,India,NA,Odisha,41974218,0,0,61,1
2020-04-20,India,NA,Odisha,41974218,13,0,74,1
2020-04-21,India,NA,Odisha,41974218,5,0,79,1
2020-04-22,India,NA,Odisha,41974218,4,0,83,1
2020-04-23,India,NA,Odisha,41974218,6,0,89,1
2020-04-24,India,NA,Odisha,41974218,5,0,94,1
2020-04-25,India,NA,Odisha,41974218,6,0,100,1
2020-04-26,India,NA,Odisha,41974218,3,0,103,1
2020-04-27,India,NA,Odisha,41974218,15,0,118,1
2020-04-28,India,NA,Odisha,41974218,0,0,118,1
2020-04-29,India,NA,Odisha,41974218,7,0,125,1
2020-04-30,India,NA,Odisha,41974218,18,0,143,1
2020-05-01,India,NA,Odisha,41974218,11,0,154,1
2020-05-02,India,NA,Odisha,41974218,6,0,160,1
2020-05-03,India,NA,Odisha,41974218,2,0,162,1
2020-05-04,India,NA,Odisha,41974218,7,0,169,1
2020-05-05,India,NA,Odisha,41974218,8,1,177,2
2020-05-06,India,NA,Odisha,41974218,28,0,205,2
2020-05-07,India,NA,Odisha,41974218,14,0,219,2
2020-05-08,India,NA,Odisha,41974218,51,0,270,2
2020-05-09,India,NA,Odisha,41974218,82,1,352,3
2020-05-10,India,NA,Odisha,41974218,25,0,377,3
2020-05-11,India,NA,Odisha,41974218,38,0,415,3
2020-05-12,India,NA,Odisha,41974218,22,0,437,3
2020-05-13,India,NA,Odisha,41974218,101,0,538,3
2020-05-14,India,NA,Odisha,41974218,134,0,672,3
2020-05-15,India,NA,Odisha,41974218,65,0,737,3
2020-05-16,India,NA,Odisha,41974218,0,0,737,3
2020-05-17,India,NA,Odisha,41974218,91,1,828,4
2020-05-18,India,NA,Odisha,41974218,48,0,876,4
2020-05-19,India,NA,Odisha,41974218,102,1,978,5
2020-05-20,India,NA,Odisha,41974218,74,1,1052,6
2020-05-21,India,NA,Odisha,41974218,51,1,1103,7
2020-05-22,India,NA,Odisha,41974218,86,0,1189,7
2020-05-23,India,NA,Odisha,41974218,80,0,1269,7
2020-05-24,India,NA,Odisha,41974218,67,0,1336,7
2020-05-25,India,NA,Odisha,41974218,102,0,1438,7
2020-05-26,India,NA,Odisha,41974218,79,0,1517,7
2020-05-27,India,NA,Odisha,41974218,76,0,1593,7
2020-05-28,India,NA,Odisha,41974218,67,0,1660,7
2020-05-29,India,NA,Odisha,41974218,63,2,1723,9
2020-05-30,India,NA,Odisha,41974218,96,0,1819,9
2020-05-31,India,NA,Odisha,41974218,129,0,1948,9
2020-06-01,India,NA,Odisha,41974218,156,0,2104,9
2020-06-02,India,NA,Odisha,41974218,141,0,2245,9
2020-06-03,India,NA,Odisha,41974218,143,0,2388,9
2020-06-04,India,NA,Odisha,41974218,90,0,2478,9
2020-06-05,India,NA,Odisha,41974218,130,1,2608,10
2020-06-06,India,NA,Odisha,41974218,173,0,2781,10
2020-06-07,India,NA,Odisha,41974218,75,1,2856,11
2020-06-08,India,NA,Odisha,41974218,138,0,2994,11
2020-06-09,India,NA,Odisha,41974218,146,0,3140,11
2020-06-10,India,NA,Odisha,41974218,110,0,3250,11
2020-06-11,India,NA,Odisha,41974218,136,1,3386,12
2020-06-12,India,NA,Odisha,41974218,112,1,3498,13
2020-06-13,India,NA,Odisha,41974218,225,0,3723,13
2020-06-14,India,NA,Odisha,41974218,186,1,3909,14
2020-06-15,India,NA,Odisha,41974218,146,0,4055,14
2020-06-16,India,NA,Odisha,41974218,108,0,4163,14
2020-06-17,India,NA,Odisha,41974218,175,0,4338,14
2020-06-18,India,NA,Odisha,41974218,174,0,4512,14
2020-06-19,India,NA,Odisha,41974218,165,0,4677,14
2020-06-20,India,NA,Odisha,41974218,179,1,4856,15
2020-06-21,India,NA,Odisha,41974218,304,4,5160,19
2020-06-22,India,NA,Odisha,41974218,143,2,5303,21
2020-06-23,India,NA,Odisha,41974218,167,3,5470,24
2020-06-24,India,NA,Odisha,41974218,282,0,5752,24
2020-06-25,India,NA,Odisha,41974218,210,0,5962,24
2020-06-26,India,NA,Odisha,41974218,218,0,6180,24
2020-06-27,India,NA,Odisha,41974218,170,1,6350,25
2020-06-28,India,NA,Odisha,41974218,264,3,6614,28
2020-06-29,India,NA,Odisha,41974218,245,2,6859,30
2020-06-30,India,NA,Odisha,41974218,206,2,7065,32
2020-07-01,India,NA,Odisha,41974218,251,1,7316,33
2020-07-02,India,NA,Odisha,41974218,229,2,7545,35
2020-07-03,India,NA,Odisha,41974218,561,2,8106,37
2020-07-04,India,NA,Odisha,41974218,495,6,8601,43
2020-07-05,India,NA,Odisha,41974218,469,3,9070,46
2020-07-06,India,NA,Odisha,41974218,456,2,9526,48
2020-07-07,India,NA,Odisha,41974218,571,6,10097,54
2020-07-08,India,NA,Odisha,41974218,527,7,10624,61
2020-07-09,India,NA,Odisha,41974218,577,6,11201,67
2020-07-10,India,NA,Odisha,41974218,755,6,11956,73
2020-07-11,India,NA,Odisha,41974218,570,6,12526,79
2020-07-12,India,NA,Odisha,41974218,595,5,13121,84
2020-07-13,India,NA,Odisha,41974218,616,7,13737,91
2020-07-14,India,NA,Odisha,41974218,543,5,14280,96
2020-07-15,India,NA,Odisha,41974218,618,5,14898,101
2020-07-16,India,NA,Odisha,41974218,494,2,15392,103
2020-07-17,India,NA,Odisha,41974218,718,6,16110,109
2020-07-18,India,NA,Odisha,41974218,591,3,16701,112
2020-07-19,India,NA,Odisha,41974218,736,7,17437,119
2020-07-20,India,NA,Odisha,41974218,673,6,18110,125
2020-07-21,India,NA,Odisha,41974218,647,8,18757,133
2020-07-22,India,NA,Odisha,41974218,1078,6,19835,139
2020-07-23,India,NA,Odisha,41974218,1264,6,21099,145
2020-07-24,India,NA,Odisha,41974218,1594,8,22693,153
2020-07-25,India,NA,Odisha,41974218,1320,10,24013,163
2020-07-26,India,NA,Odisha,41974218,1376,11,25389,174
2020-07-27,India,NA,Odisha,41974218,1503,7,26892,181
2020-07-28,India,NA,Odisha,41974218,1215,8,28107,189
2020-07-29,India,NA,Odisha,41974218,1068,6,29175,195
2020-07-30,India,NA,Odisha,41974218,1203,10,30378,205
2020-07-31,India,NA,Odisha,41974218,1499,9,31877,214
2020-08-01,India,NA,Odisha,41974218,1602,11,33479,225
2020-08-02,India,NA,Odisha,41974218,1434,11,34913,236
2020-08-03,India,NA,Odisha,41974218,1384,12,36297,248
2020-08-04,India,NA,Odisha,41974218,1384,10,37681,258
2020-08-05,India,NA,Odisha,41974218,1337,11,39018,269
2020-08-06,India,NA,Odisha,41974218,1699,11,40717,280
2020-08-07,India,NA,Odisha,41974218,1833,12,42550,292
2020-08-08,India,NA,Odisha,41974218,1643,15,44193,307
2020-08-09,India,NA,Odisha,41974218,1734,14,45927,321
2020-08-10,India,NA,Odisha,41974218,1528,16,47455,337
2020-08-11,India,NA,Odisha,41974218,1341,12,48796,349
2020-08-12,India,NA,Odisha,41974218,1876,9,50672,358
2020-08-13,India,NA,Odisha,41974218,1981,9,52653,367
2020-08-14,India,NA,Odisha,41974218,1977,10,54630,377
2020-08-15,India,NA,Odisha,41974218,2496,9,57126,386
2020-08-16,India,NA,Odisha,41974218,2924,10,60050,396
2020-08-17,India,NA,Odisha,41974218,2244,10,62294,406
2020-08-18,India,NA,Odisha,41974218,2239,9,64533,415
2020-08-19,India,NA,Odisha,41974218,2589,10,67122,425
2020-08-20,India,NA,Odisha,41974218,2898,8,70020,433
2020-08-21,India,NA,Odisha,41974218,2698,10,72718,443
2020-08-22,India,NA,Odisha,41974218,2819,9,75537,452
2020-08-23,India,NA,Odisha,41974218,2993,10,78530,462
2020-08-24,India,NA,Odisha,41974218,2949,10,81479,472
2020-08-25,India,NA,Odisha,41974218,2752,9,84231,481
2020-08-26,India,NA,Odisha,41974218,3371,13,87602,494
2020-08-27,India,NA,Odisha,41974218,3384,7,90986,501
2020-08-28,India,NA,Odisha,41974218,3682,8,94668,509
2020-08-29,India,NA,Odisha,41974218,3252,14,97920,523
2020-08-30,India,NA,Odisha,41974218,3014,12,100934,535
2020-08-31,India,NA,Odisha,41974218,2602,10,103536,545
2020-09-01,India,NA,Odisha,41974218,3025,11,106561,556
2020-09-02,India,NA,Odisha,41974218,3219,11,109780,567
2020-09-03,India,NA,Odisha,41974218,3631,8,113411,575
2020-09-04,India,NA,Odisha,41974218,3267,9,116678,584
2020-09-05,India,NA,Odisha,41974218,3543,7,120221,591
2020-09-06,India,NA,Odisha,41974218,3810,8,124031,599
2020-09-07,India,NA,Odisha,41974218,3861,10,127892,609
2020-09-08,India,NA,Odisha,41974218,3490,13,131382,622
2020-09-09,India,NA,Odisha,41974218,3748,11,135130,633
2020-09-10,India,NA,Odisha,41974218,3991,11,139121,644
2020-09-11,India,NA,Odisha,41974218,3996,14,143117,658
2020-09-12,India,NA,Odisha,41974218,3777,11,146894,669
2020-09-13,India,NA,Odisha,41974218,3913,10,150807,679
2020-09-14,India,NA,Odisha,41974218,4198,11,155005,690
2020-09-15,India,NA,Odisha,41974218,3645,8,158650,698
2020-09-16,India,NA,Odisha,41974218,4270,11,162920,709
2020-09-17,India,NA,Odisha,41974218,4241,13,167161,722
2020-09-18,India,NA,Odisha,41974218,4180,13,171341,735
2020-09-19,India,NA,Odisha,41974218,4209,9,175550,744
2020-09-20,India,NA,Odisha,41974218,4330,10,179880,754
2020-09-21,India,NA,Odisha,41974218,4242,9,184122,763
2020-09-22,India,NA,Odisha,41974218,4189,11,188311,774
2020-09-23,India,NA,Odisha,41974218,4237,15,192548,789
2020-05-10,India,NA,Puducherry,973829,2,0,12,0
2020-05-11,India,NA,Puducherry,973829,0,0,12,0
2020-05-12,India,NA,Puducherry,973829,0,0,12,0
2020-05-13,India,NA,Puducherry,973829,1,0,13,0
2020-05-14,India,NA,Puducherry,973829,3,0,16,0
2020-05-15,India,NA,Puducherry,973829,0,0,16,0
2020-05-16,India,NA,Puducherry,973829,1,0,17,0
2020-05-17,India,NA,Puducherry,973829,0,0,17,0
2020-05-18,India,NA,Puducherry,973829,0,0,17,0
2020-05-19,India,NA,Puducherry,973829,5,0,22,0
2020-05-20,India,NA,Puducherry,973829,1,0,23,0
2020-05-21,India,NA,Puducherry,973829,0,0,23,0
2020-05-22,India,NA,Puducherry,973829,3,0,26,0
2020-05-23,India,NA,Puducherry,973829,0,0,26,0
2020-05-24,India,NA,Puducherry,973829,15,0,41,0
2020-05-25,India,NA,Puducherry,973829,8,0,49,0
2020-05-26,India,NA,Puducherry,973829,0,0,49,0
2020-05-27,India,NA,Puducherry,973829,0,0,49,0
2020-05-28,India,NA,Puducherry,973829,4,0,53,0
2020-05-29,India,NA,Puducherry,973829,4,0,57,0
2020-05-30,India,NA,Puducherry,973829,0,0,57,0
2020-05-31,India,NA,Puducherry,973829,13,0,70,0
2020-06-01,India,NA,Puducherry,973829,9,0,79,0
2020-06-02,India,NA,Puducherry,973829,0,0,79,0
2020-06-03,India,NA,Puducherry,973829,11,0,90,0
2020-06-04,India,NA,Puducherry,973829,9,0,99,0
2020-06-05,India,NA,Puducherry,973829,5,0,104,0
2020-06-06,India,NA,Puducherry,973829,3,0,107,0
2020-06-07,India,NA,Puducherry,973829,12,0,119,0
2020-06-08,India,NA,Puducherry,973829,9,0,128,0
2020-06-09,India,NA,Puducherry,973829,4,0,132,0
2020-06-10,India,NA,Puducherry,973829,12,0,144,0
2020-06-11,India,NA,Puducherry,973829,13,2,157,2
2020-06-12,India,NA,Puducherry,973829,6,1,163,3
2020-06-13,India,NA,Puducherry,973829,13,0,176,3
2020-06-14,India,NA,Puducherry,973829,18,1,194,4
2020-06-15,India,NA,Puducherry,973829,8,0,202,4
2020-06-16,India,NA,Puducherry,973829,14,0,216,4
2020-06-17,India,NA,Puducherry,973829,29,1,245,5
2020-06-18,India,NA,Puducherry,973829,26,1,271,6
2020-06-19,India,NA,Puducherry,973829,16,1,287,7
2020-06-20,India,NA,Puducherry,973829,51,0,338,7
2020-06-21,India,NA,Puducherry,973829,28,1,366,8
2020-06-22,India,NA,Puducherry,973829,17,0,383,8
2020-06-23,India,NA,Puducherry,973829,19,1,402,9
2020-06-24,India,NA,Puducherry,973829,59,0,461,9
2020-06-25,India,NA,Puducherry,973829,41,0,502,9
2020-06-26,India,NA,Puducherry,973829,32,0,534,9
2020-06-27,India,NA,Puducherry,973829,85,1,619,10
2020-06-28,India,NA,Puducherry,973829,29,1,648,11
2020-06-29,India,NA,Puducherry,973829,42,0,690,11
2020-06-30,India,NA,Puducherry,973829,24,1,714,12
2020-07-01,India,NA,Puducherry,973829,25,0,739,12
2020-07-02,India,NA,Puducherry,973829,63,0,802,12
2020-07-03,India,NA,Puducherry,973829,22,1,824,13
2020-07-04,India,NA,Puducherry,973829,80,1,904,14
2020-07-05,India,NA,Puducherry,973829,42,0,946,14
2020-07-06,India,NA,Puducherry,973829,65,0,1011,14
2020-07-07,India,NA,Puducherry,973829,32,0,1043,14
2020-07-08,India,NA,Puducherry,973829,110,0,1153,14
2020-07-09,India,NA,Puducherry,973829,49,2,1202,16
2020-07-10,India,NA,Puducherry,973829,72,1,1274,17
2020-07-11,India,NA,Puducherry,973829,65,1,1339,18
2020-07-12,India,NA,Puducherry,973829,81,0,1420,18
2020-07-13,India,NA,Puducherry,973829,50,0,1470,18
2020-07-14,India,NA,Puducherry,973829,63,0,1533,18
2020-07-15,India,NA,Puducherry,973829,65,3,1598,21
2020-07-16,India,NA,Puducherry,973829,147,1,1745,22
2020-07-17,India,NA,Puducherry,973829,89,3,1834,25
2020-07-18,India,NA,Puducherry,973829,58,3,1892,28
2020-07-19,India,NA,Puducherry,973829,109,0,2001,28
2020-07-20,India,NA,Puducherry,973829,93,1,2094,29
2020-07-21,India,NA,Puducherry,973829,87,1,2181,30
2020-07-22,India,NA,Puducherry,973829,121,1,2302,31
2020-07-23,India,NA,Puducherry,973829,120,3,2422,34
2020-07-24,India,NA,Puducherry,973829,95,1,2517,35
2020-07-25,India,NA,Puducherry,973829,139,3,2656,38
2020-07-26,India,NA,Puducherry,973829,133,2,2789,40
2020-07-27,India,NA,Puducherry,973829,85,3,2874,43
2020-07-28,India,NA,Puducherry,973829,139,4,3013,47
2020-07-29,India,NA,Puducherry,973829,166,0,3179,47
2020-07-30,India,NA,Puducherry,973829,121,1,3300,48
2020-07-31,India,NA,Puducherry,973829,174,1,3474,49
2020-08-01,India,NA,Puducherry,973829,134,2,3608,51
2020-08-02,India,NA,Puducherry,973829,200,1,3808,52
2020-08-03,India,NA,Puducherry,973829,176,4,3984,56
2020-08-04,India,NA,Puducherry,973829,165,2,4149,58
2020-08-05,India,NA,Puducherry,973829,286,7,4435,65
2020-08-06,India,NA,Puducherry,973829,188,5,4623,70
2020-08-07,India,NA,Puducherry,973829,241,5,4864,75
2020-08-08,India,NA,Puducherry,973829,261,5,5125,80
2020-08-09,India,NA,Puducherry,973829,259,7,5384,87
2020-08-10,India,NA,Puducherry,973829,242,2,5626,89
2020-08-11,India,NA,Puducherry,973829,276,2,5902,91
2020-08-12,India,NA,Puducherry,973829,481,5,6383,96
2020-08-13,India,NA,Puducherry,973829,299,6,6682,102
2020-08-14,India,NA,Puducherry,973829,315,4,6997,106
2020-08-15,India,NA,Puducherry,973829,359,0,7356,106
2020-08-16,India,NA,Puducherry,973829,378,4,7734,110
2020-08-17,India,NA,Puducherry,973829,297,4,8031,114
2020-08-18,India,NA,Puducherry,973829,367,9,8398,123
2020-08-19,India,NA,Puducherry,973829,356,6,8754,129
2020-08-20,India,NA,Puducherry,973829,540,8,9294,137
2020-08-21,India,NA,Puducherry,973829,302,6,9596,143
2020-08-22,India,NA,Puducherry,973829,518,8,10114,151
2020-08-23,India,NA,Puducherry,973829,410,8,10524,159
2020-08-24,India,NA,Puducherry,973829,337,5,10861,164
2020-08-25,India,NA,Puducherry,973829,567,8,11428,172
2020-08-26,India,NA,Puducherry,973829,504,8,11932,180
2020-08-27,India,NA,Puducherry,973829,504,10,12436,190
2020-08-28,India,NA,Puducherry,973829,590,9,13026,199
2020-08-29,India,NA,Puducherry,973829,532,12,13558,211
2020-08-30,India,NA,Puducherry,973829,571,10,14129,221
2020-08-31,India,NA,Puducherry,973829,284,7,14413,228
2020-09-01,India,NA,Puducherry,973829,355,12,14768,240
2020-09-02,India,NA,Puducherry,973829,391,13,15159,253
2020-09-03,India,NA,Puducherry,973829,424,7,15583,260
2020-09-04,India,NA,Puducherry,973829,591,20,16174,280
2020-09-05,India,NA,Puducherry,973829,394,18,16568,298
2020-09-06,India,NA,Puducherry,973829,466,16,17034,314
2020-09-07,India,NA,Puducherry,973829,284,11,17318,325
2020-09-08,India,NA,Puducherry,973829,433,12,17751,337
2020-09-09,India,NA,Puducherry,973829,335,10,18086,347
2020-09-10,India,NA,Puducherry,973829,452,6,18538,353
2020-09-11,India,NA,Puducherry,973829,490,12,19028,365
2020-09-12,India,NA,Puducherry,973829,419,5,19447,370
2020-09-13,India,NA,Puducherry,973829,388,15,19835,385
2020-09-14,India,NA,Puducherry,973829,393,9,20228,394
2020-09-15,India,NA,Puducherry,973829,375,11,20603,405
2020-09-16,India,NA,Puducherry,973829,510,13,21113,418
2020-09-17,India,NA,Puducherry,973829,317,13,21430,431
2020-09-18,India,NA,Puducherry,973829,485,6,21915,437
2020-09-19,India,NA,Puducherry,973829,543,11,22458,448
2020-09-20,India,NA,Puducherry,973829,467,10,22925,458
2020-09-21,India,NA,Puducherry,973829,268,9,23193,467
2020-09-22,India,NA,Puducherry,973829,493,6,23686,473
2020-09-23,India,NA,Puducherry,973829,543,8,24229,481
2020-03-21,India,NA,Punjab,27743338,10,0,13,1
2020-03-22,India,NA,Punjab,27743338,8,0,21,1
2020-03-23,India,NA,Punjab,27743338,2,0,23,1
2020-03-24,India,NA,Punjab,27743338,6,0,29,1
2020-03-25,India,NA,Punjab,27743338,2,0,31,1
2020-03-26,India,NA,Punjab,27743338,2,0,33,1
2020-03-27,India,NA,Punjab,27743338,5,0,38,1
2020-03-28,India,NA,Punjab,27743338,0,0,38,1
2020-03-29,India,NA,Punjab,27743338,0,0,38,1
2020-03-30,India,NA,Punjab,27743338,3,2,41,3
2020-03-31,India,NA,Punjab,27743338,1,1,42,4
2020-04-01,India,NA,Punjab,27743338,4,0,46,4
2020-04-02,India,NA,Punjab,27743338,1,1,47,5
2020-04-03,India,NA,Punjab,27743338,6,0,53,5
2020-04-04,India,NA,Punjab,27743338,12,0,65,5
2020-04-05,India,NA,Punjab,27743338,3,2,68,7
2020-04-06,India,NA,Punjab,27743338,11,0,79,7
2020-04-07,India,NA,Punjab,27743338,20,1,99,8
2020-04-08,India,NA,Punjab,27743338,7,1,106,9
2020-04-09,India,NA,Punjab,27743338,24,1,130,10
2020-04-10,India,NA,Punjab,27743338,21,1,151,11
2020-04-11,India,NA,Punjab,27743338,7,1,158,12
2020-04-12,India,NA,Punjab,27743338,12,0,170,12
2020-04-13,India,NA,Punjab,27743338,6,0,176,12
2020-04-14,India,NA,Punjab,27743338,8,1,184,13
2020-04-15,India,NA,Punjab,27743338,2,0,186,13
2020-04-16,India,NA,Punjab,27743338,11,1,197,14
2020-04-17,India,NA,Punjab,27743338,14,0,211,14
2020-04-18,India,NA,Punjab,27743338,23,2,234,16
2020-04-19,India,NA,Punjab,27743338,10,0,244,16
2020-04-20,India,NA,Punjab,27743338,1,0,245,16
2020-04-21,India,NA,Punjab,27743338,6,0,251,16
2020-04-22,India,NA,Punjab,27743338,27,0,278,16
2020-04-23,India,NA,Punjab,27743338,5,1,283,17
2020-04-24,India,NA,Punjab,27743338,15,0,298,17
2020-04-25,India,NA,Punjab,27743338,10,0,308,17
2020-04-26,India,NA,Punjab,27743338,14,1,322,18
2020-04-27,India,NA,Punjab,27743338,8,1,330,19
2020-04-28,India,NA,Punjab,27743338,12,0,342,19
2020-04-29,India,NA,Punjab,27743338,33,0,375,19
2020-04-30,India,NA,Punjab,27743338,105,1,480,20
2020-05-01,India,NA,Punjab,27743338,105,0,585,20
2020-05-02,India,NA,Punjab,27743338,187,0,772,20
2020-05-03,India,NA,Punjab,27743338,330,1,1102,21
2020-05-04,India,NA,Punjab,27743338,130,2,1232,23
2020-05-05,India,NA,Punjab,27743338,219,2,1451,25
2020-05-06,India,NA,Punjab,27743338,75,2,1526,27
2020-05-07,India,NA,Punjab,27743338,118,1,1644,28
2020-05-08,India,NA,Punjab,27743338,87,1,1731,29
2020-05-09,India,NA,Punjab,27743338,31,2,1762,31
2020-05-10,India,NA,Punjab,27743338,61,0,1823,31
2020-05-11,India,NA,Punjab,27743338,54,0,1877,31
2020-05-12,India,NA,Punjab,27743338,37,1,1914,32
2020-05-13,India,NA,Punjab,27743338,10,0,1924,32
2020-05-14,India,NA,Punjab,27743338,11,0,1935,32
2020-05-15,India,NA,Punjab,27743338,0,0,1935,32
2020-05-16,India,NA,Punjab,27743338,14,0,1946,32
2020-05-17,India,NA,Punjab,27743338,18,3,1964,35
2020-05-18,India,NA,Punjab,27743338,16,2,1980,37
2020-05-19,India,NA,Punjab,27743338,22,1,2002,38
2020-05-20,India,NA,Punjab,27743338,3,0,2005,38
2020-05-21,India,NA,Punjab,27743338,23,1,2028,39
2020-05-22,India,NA,Punjab,27743338,1,0,2029,39
2020-05-23,India,NA,Punjab,27743338,16,0,2045,39
2020-05-24,India,NA,Punjab,27743338,15,1,2060,40
2020-05-25,India,NA,Punjab,27743338,21,0,2081,40
2020-05-26,India,NA,Punjab,27743338,25,0,2106,40
2020-05-27,India,NA,Punjab,27743338,33,0,2139,40
2020-05-28,India,NA,Punjab,27743338,19,0,2158,40
2020-05-29,India,NA,Punjab,27743338,39,2,2197,42
2020-05-30,India,NA,Punjab,27743338,36,2,2233,44
2020-05-31,India,NA,Punjab,27743338,30,1,2263,45
2020-06-01,India,NA,Punjab,27743338,38,0,2301,45
2020-06-02,India,NA,Punjab,27743338,41,2,2342,46
2020-06-03,India,NA,Punjab,27743338,34,1,2376,47
2020-06-04,India,NA,Punjab,27743338,39,0,2415,47
2020-06-05,India,NA,Punjab,27743338,46,1,2461,48
2020-06-06,India,NA,Punjab,27743338,54,2,2515,50
2020-06-07,India,NA,Punjab,27743338,93,1,2608,51
2020-06-08,India,NA,Punjab,27743338,55,2,2663,53
2020-06-09,India,NA,Punjab,27743338,56,2,2719,55
2020-06-10,India,NA,Punjab,27743338,86,0,2805,55
2020-06-11,India,NA,Punjab,27743338,82,4,2887,59
2020-06-12,India,NA,Punjab,27743338,99,4,2986,63
2020-06-13,India,NA,Punjab,27743338,77,2,3063,65
2020-06-14,India,NA,Punjab,27743338,77,2,3140,67
2020-06-15,India,NA,Punjab,27743338,127,4,3267,71
2020-06-16,India,NA,Punjab,27743338,104,1,3371,72
2020-06-17,India,NA,Punjab,27743338,126,6,3497,78
2020-06-18,India,NA,Punjab,27743338,118,5,3615,83
2020-06-19,India,NA,Punjab,27743338,217,9,3832,92
2020-06-20,India,NA,Punjab,27743338,120,6,3952,98
2020-06-21,India,NA,Punjab,27743338,122,1,4074,99
2020-06-22,India,NA,Punjab,27743338,161,2,4235,101
2020-06-23,India,NA,Punjab,27743338,162,4,4397,105
2020-06-24,India,NA,Punjab,27743338,230,8,4627,113
2020-06-25,India,NA,Punjab,27743338,142,7,4769,120
2020-06-26,India,NA,Punjab,27743338,188,2,4957,122
2020-06-27,India,NA,Punjab,27743338,99,6,5056,128
2020-06-28,India,NA,Punjab,27743338,160,5,5216,133
2020-06-29,India,NA,Punjab,27743338,202,5,5418,138
2020-06-30,India,NA,Punjab,27743338,150,6,5568,144
2020-07-01,India,NA,Punjab,27743338,100,5,5668,149
2020-07-02,India,NA,Punjab,27743338,116,3,5784,152
2020-07-03,India,NA,Punjab,27743338,153,5,5937,157
2020-07-04,India,NA,Punjab,27743338,172,5,6109,162
2020-07-05,India,NA,Punjab,27743338,174,2,6283,164
2020-07-06,India,NA,Punjab,27743338,208,5,6491,169
2020-07-07,India,NA,Punjab,27743338,258,6,6749,175
2020-07-08,India,NA,Punjab,27743338,158,3,6907,178
2020-07-09,India,NA,Punjab,27743338,233,5,7140,183
2020-07-10,India,NA,Punjab,27743338,217,4,7357,187
2020-07-11,India,NA,Punjab,27743338,230,8,7587,195
2020-07-12,India,NA,Punjab,27743338,234,4,7821,199
2020-07-13,India,NA,Punjab,27743338,357,5,8178,204
2020-07-14,India,NA,Punjab,27743338,333,9,8511,213
2020-07-15,India,NA,Punjab,27743338,288,8,8799,221
2020-07-16,India,NA,Punjab,27743338,295,9,9094,230
2020-07-17,India,NA,Punjab,27743338,348,9,9442,239
2020-07-18,India,NA,Punjab,27743338,350,7,9792,246
2020-07-19,India,NA,Punjab,27743338,308,8,10100,254
2020-07-20,India,NA,Punjab,27743338,410,8,10510,262
2020-07-21,India,NA,Punjab,27743338,379,1,10889,263
2020-07-22,India,NA,Punjab,27743338,412,6,11301,269
2020-07-23,India,NA,Punjab,27743338,438,8,11739,277
2020-07-24,India,NA,Punjab,27743338,477,5,12216,282
2020-07-25,India,NA,Punjab,27743338,468,9,12684,291
2020-07-26,India,NA,Punjab,27743338,534,15,13218,306
2020-07-27,India,NA,Punjab,27743338,551,12,13769,318
2020-07-28,India,NA,Punjab,27743338,609,18,14378,336
2020-07-29,India,NA,Punjab,27743338,568,25,14946,361
2020-07-30,India,NA,Punjab,27743338,510,9,15456,370
2020-07-31,India,NA,Punjab,27743338,663,16,16119,386
2020-08-01,India,NA,Punjab,27743338,944,19,17063,405
2020-08-02,India,NA,Punjab,27743338,790,18,17853,423
2020-08-03,India,NA,Punjab,27743338,674,19,18527,442
2020-08-04,India,NA,Punjab,27743338,488,20,19015,462
2020-08-05,India,NA,Punjab,27743338,841,29,19856,491
2020-08-06,India,NA,Punjab,27743338,1035,26,20891,517
2020-08-07,India,NA,Punjab,27743338,1039,22,21930,539
2020-08-08,India,NA,Punjab,27743338,998,23,22928,562
2020-08-09,India,NA,Punjab,27743338,975,24,23903,586
2020-08-10,India,NA,Punjab,27743338,986,18,24889,604
2020-08-11,India,NA,Punjab,27743338,1000,32,25889,636
2020-08-12,India,NA,Punjab,27743338,1020,39,26909,675
2020-08-13,India,NA,Punjab,27743338,1027,31,27936,706
2020-08-14,India,NA,Punjab,27743338,1077,25,29013,731
2020-08-15,India,NA,Punjab,27743338,1028,40,30041,771
2020-08-16,India,NA,Punjab,27743338,1165,41,31206,812
2020-08-17,India,NA,Punjab,27743338,1489,50,32695,862
2020-08-18,India,NA,Punjab,27743338,1705,36,34400,898
2020-08-19,India,NA,Punjab,27743338,1683,22,36083,920
2020-08-20,India,NA,Punjab,27743338,1741,37,37824,957
2020-08-21,India,NA,Punjab,27743338,1503,34,39327,991
2020-08-22,India,NA,Punjab,27743338,1316,45,40643,1036
2020-08-23,India,NA,Punjab,27743338,1136,50,41779,1086
2020-08-24,India,NA,Punjab,27743338,1505,43,43284,1129
2020-08-25,India,NA,Punjab,27743338,1293,49,44577,1178
2020-08-26,India,NA,Punjab,27743338,1513,41,46090,1219
2020-08-27,India,NA,Punjab,27743338,1746,37,47836,1256
2020-08-28,India,NA,Punjab,27743338,1542,51,49378,1307
2020-08-29,India,NA,Punjab,27743338,1470,41,50848,1348
2020-08-30,India,NA,Punjab,27743338,1678,56,52526,1404
2020-08-31,India,NA,Punjab,27743338,1466,49,53992,1453
2020-09-01,India,NA,Punjab,27743338,1516,59,55508,1512
2020-09-02,India,NA,Punjab,27743338,1481,106,56989,1618
2020-09-03,India,NA,Punjab,27743338,1526,72,58515,1690
2020-09-04,India,NA,Punjab,27743338,1498,49,60013,1739
2020-09-05,India,NA,Punjab,27743338,1514,69,61527,1808
2020-09-06,India,NA,Punjab,27743338,1946,54,63473,1862
2020-09-07,India,NA,Punjab,27743338,2110,61,65583,1923
2020-09-08,India,NA,Punjab,27743338,1964,67,67547,1990
2020-09-09,India,NA,Punjab,27743338,2137,71,69684,2061
2020-09-10,India,NA,Punjab,27743338,2459,88,72143,2149
2020-09-11,India,NA,Punjab,27743338,2473,63,74616,2212
2020-09-12,India,NA,Punjab,27743338,2441,76,77057,2288
2020-09-13,India,NA,Punjab,27743338,2622,68,79679,2356
2020-09-14,India,NA,Punjab,27743338,2421,67,82100,2423
2020-09-15,India,NA,Punjab,27743338,2382,91,84482,2514
2020-09-16,India,NA,Punjab,27743338,2702,78,87184,2592
2020-09-17,India,NA,Punjab,27743338,2848,54,90032,2646
2020-09-18,India,NA,Punjab,27743338,2774,60,92806,2706
2020-09-19,India,NA,Punjab,27743338,2723,51,95529,2757
2020-09-20,India,NA,Punjab,27743338,2160,56,97689,2813
2020-09-21,India,NA,Punjab,27743338,2241,47,99930,2860
2020-09-22,India,NA,Punjab,27743338,1411,66,101341,2926
2020-09-23,India,NA,Punjab,27743338,2123,64,103464,2990
2020-03-20,India,NA,Rajasthan,68548437,8,0,17,0
2020-03-21,India,NA,Rajasthan,68548437,7,0,24,0
2020-03-22,India,NA,Rajasthan,68548437,4,0,28,0
2020-03-23,India,NA,Rajasthan,68548437,4,0,32,0
2020-03-24,India,NA,Rajasthan,68548437,0,0,32,0
2020-03-25,India,NA,Rajasthan,68548437,6,0,38,0
2020-03-26,India,NA,Rajasthan,68548437,2,0,40,0
2020-03-27,India,NA,Rajasthan,68548437,10,0,50,0
2020-03-28,India,NA,Rajasthan,68548437,4,0,54,0
2020-03-29,India,NA,Rajasthan,68548437,5,0,59,0
2020-03-30,India,NA,Rajasthan,68548437,20,0,79,0
2020-03-31,India,NA,Rajasthan,68548437,14,0,93,0
2020-04-01,India,NA,Rajasthan,68548437,27,0,120,0
2020-04-02,India,NA,Rajasthan,68548437,13,0,133,0
2020-04-03,India,NA,Rajasthan,68548437,46,0,179,0
2020-04-04,India,NA,Rajasthan,68548437,27,1,206,1
2020-04-05,India,NA,Rajasthan,68548437,60,0,266,1
2020-04-06,India,NA,Rajasthan,68548437,35,1,301,2
2020-04-07,India,NA,Rajasthan,68548437,42,0,343,2
2020-04-08,India,NA,Rajasthan,68548437,40,1,383,3
2020-04-09,India,NA,Rajasthan,68548437,80,0,463,3
2020-04-10,India,NA,Rajasthan,68548437,98,0,561,3
2020-04-11,India,NA,Rajasthan,68548437,139,6,700,9
2020-04-12,India,NA,Rajasthan,68548437,104,2,804,11
2020-04-13,India,NA,Rajasthan,68548437,93,0,897,11
2020-04-14,India,NA,Rajasthan,68548437,108,0,1005,11
2020-04-15,India,NA,Rajasthan,68548437,71,0,1076,11
2020-04-16,India,NA,Rajasthan,68548437,55,0,1131,11
2020-04-17,India,NA,Rajasthan,68548437,98,6,1229,17
2020-04-18,India,NA,Rajasthan,68548437,122,4,1351,21
2020-04-19,India,NA,Rajasthan,68548437,127,2,1478,23
2020-04-20,India,NA,Rajasthan,68548437,98,2,1576,25
2020-04-21,India,NA,Rajasthan,68548437,159,1,1735,26
2020-04-22,India,NA,Rajasthan,68548437,153,1,1888,27
2020-04-23,India,NA,Rajasthan,68548437,76,1,1964,28
2020-04-24,India,NA,Rajasthan,68548437,70,4,2034,32
2020-04-25,India,NA,Rajasthan,68548437,49,2,2083,34
2020-04-26,India,NA,Rajasthan,68548437,102,7,2185,41
2020-04-27,India,NA,Rajasthan,68548437,77,9,2262,50
2020-04-28,India,NA,Rajasthan,68548437,102,2,2364,52
2020-04-29,India,NA,Rajasthan,68548437,76,3,2440,55
2020-04-30,India,NA,Rajasthan,68548437,144,3,2584,58
2020-05-01,India,NA,Rajasthan,68548437,82,4,2666,62
2020-05-02,India,NA,Rajasthan,68548437,106,6,2772,68
2020-05-03,India,NA,Rajasthan,68548437,114,3,2886,71
2020-05-04,India,NA,Rajasthan,68548437,175,6,3061,77
2020-05-05,India,NA,Rajasthan,68548437,97,12,3158,89
2020-05-06,India,NA,Rajasthan,68548437,159,4,3317,93
2020-05-07,India,NA,Rajasthan,68548437,110,6,3427,99
2020-05-08,India,NA,Rajasthan,68548437,152,4,3579,103
2020-05-09,India,NA,Rajasthan,68548437,129,3,3708,106
2020-05-10,India,NA,Rajasthan,68548437,106,2,3814,108
2020-05-11,India,NA,Rajasthan,68548437,174,5,3988,113
2020-05-12,India,NA,Rajasthan,68548437,138,4,4126,117
2020-05-13,India,NA,Rajasthan,68548437,202,4,4328,121
2020-05-14,India,NA,Rajasthan,68548437,206,4,4534,125
2020-05-15,India,NA,Rajasthan,68548437,213,0,4747,125
2020-05-16,India,NA,Rajasthan,68548437,213,1,4960,126
2020-05-17,India,NA,Rajasthan,68548437,242,5,5202,131
2020-05-18,India,NA,Rajasthan,68548437,305,7,5507,138
2020-05-19,India,NA,Rajasthan,68548437,338,5,5845,143
2020-05-20,India,NA,Rajasthan,68548437,170,4,6015,147
2020-05-21,India,NA,Rajasthan,68548437,212,4,6227,151
2020-05-22,India,NA,Rajasthan,68548437,267,2,6494,153
2020-05-23,India,NA,Rajasthan,68548437,248,7,6742,160
2020-05-24,India,NA,Rajasthan,68548437,286,3,7028,163
2020-05-25,India,NA,Rajasthan,68548437,272,4,7300,167
2020-05-26,India,NA,Rajasthan,68548437,236,3,7536,170
2020-05-27,India,NA,Rajasthan,68548437,280,3,7816,173
2020-05-28,India,NA,Rajasthan,68548437,251,7,8067,180
2020-05-29,India,NA,Rajasthan,68548437,298,4,8365,184
2020-05-30,India,NA,Rajasthan,68548437,252,9,8617,193
2020-05-31,India,NA,Rajasthan,68548437,214,1,8831,194
2020-06-01,India,NA,Rajasthan,68548437,269,5,9100,199
2020-06-02,India,NA,Rajasthan,68548437,273,4,9373,203
2020-06-03,India,NA,Rajasthan,68548437,279,6,9652,209
2020-06-04,India,NA,Rajasthan,68548437,210,4,9862,213
2020-06-05,India,NA,Rajasthan,68548437,222,5,10084,218
2020-06-06,India,NA,Rajasthan,68548437,253,13,10337,231
2020-06-07,India,NA,Rajasthan,68548437,262,9,10599,240
2020-06-08,India,NA,Rajasthan,68548437,277,6,10876,246
2020-06-09,India,NA,Rajasthan,68548437,369,9,11245,255
2020-06-10,India,NA,Rajasthan,68548437,355,4,11600,259
2020-06-11,India,NA,Rajasthan,68548437,238,6,11838,265
2020-06-12,India,NA,Rajasthan,68548437,230,7,12068,272
2020-06-13,India,NA,Rajasthan,68548437,333,10,12401,282
2020-06-14,India,NA,Rajasthan,68548437,293,10,12694,292
2020-06-15,India,NA,Rajasthan,68548437,287,9,12981,301
2020-06-16,India,NA,Rajasthan,68548437,235,7,13216,308
2020-06-17,India,NA,Rajasthan,68548437,326,5,13542,313
2020-06-18,India,NA,Rajasthan,68548437,315,17,13857,330
2020-06-19,India,NA,Rajasthan,68548437,299,3,14156,333
2020-06-20,India,NA,Rajasthan,68548437,381,4,14537,337
2020-06-21,India,NA,Rajasthan,68548437,393,12,14930,349
2020-06-22,India,NA,Rajasthan,68548437,302,7,15232,356
2020-06-23,India,NA,Rajasthan,68548437,395,9,15627,365
2020-06-24,India,NA,Rajasthan,68548437,382,10,16009,375
2020-06-25,India,NA,Rajasthan,68548437,287,4,16296,379
2020-06-26,India,NA,Rajasthan,68548437,364,1,16660,380
2020-06-27,India,NA,Rajasthan,68548437,284,11,16944,391
2020-06-28,India,NA,Rajasthan,68548437,327,8,17271,399
2020-06-29,India,NA,Rajasthan,68548437,389,6,17660,405
2020-06-30,India,NA,Rajasthan,68548437,348,8,18008,413
2020-07-01,India,NA,Rajasthan,68548437,304,8,18312,421
2020-07-02,India,NA,Rajasthan,68548437,350,9,18662,430
2020-07-03,India,NA,Rajasthan,68548437,390,10,19052,440
2020-07-04,India,NA,Rajasthan,68548437,480,7,19532,447
2020-07-05,India,NA,Rajasthan,68548437,632,9,20164,456
2020-07-06,India,NA,Rajasthan,68548437,524,5,20688,461
2020-07-07,India,NA,Rajasthan,68548437,716,11,21404,472
2020-07-08,India,NA,Rajasthan,68548437,659,10,22063,482
2020-07-09,India,NA,Rajasthan,68548437,500,9,22563,491
2020-07-10,India,NA,Rajasthan,68548437,611,6,23174,497
2020-07-11,India,NA,Rajasthan,68548437,574,6,23748,503
2020-07-12,India,NA,Rajasthan,68548437,644,7,24392,510
2020-07-13,India,NA,Rajasthan,68548437,544,8,24936,518
2020-07-14,India,NA,Rajasthan,68548437,635,6,25571,524
2020-07-15,India,NA,Rajasthan,68548437,866,6,26437,530
2020-07-16,India,NA,Rajasthan,68548437,737,8,27174,538
2020-07-17,India,NA,Rajasthan,68548437,615,8,27789,546
2020-07-18,India,NA,Rajasthan,68548437,711,7,28500,553
2020-07-19,India,NA,Rajasthan,68548437,934,6,29434,559
2020-07-20,India,NA,Rajasthan,68548437,956,9,30390,568
2020-07-21,India,NA,Rajasthan,68548437,983,9,31373,577
2020-07-22,India,NA,Rajasthan,68548437,961,6,32334,583
2020-07-23,India,NA,Rajasthan,68548437,886,11,33220,594
2020-07-24,India,NA,Rajasthan,68548437,958,8,34178,602
2020-07-25,India,NA,Rajasthan,68548437,1120,11,35298,613
2020-07-26,India,NA,Rajasthan,68548437,1132,11,36430,624
2020-07-27,India,NA,Rajasthan,68548437,1134,9,37564,633
2020-07-28,India,NA,Rajasthan,68548437,1072,11,38636,644
2020-07-29,India,NA,Rajasthan,68548437,1144,10,39780,654
2020-07-30,India,NA,Rajasthan,68548437,1156,13,40936,667
2020-07-31,India,NA,Rajasthan,68548437,1147,13,42083,680
2020-08-01,India,NA,Rajasthan,68548437,1160,14,43243,694
2020-08-02,India,NA,Rajasthan,68548437,1167,12,44410,706
2020-08-03,India,NA,Rajasthan,68548437,1145,13,45555,719
2020-08-04,India,NA,Rajasthan,68548437,1124,13,46679,732
2020-08-05,India,NA,Rajasthan,68548437,1166,13,47845,745
2020-08-06,India,NA,Rajasthan,68548437,1151,12,48996,757
2020-08-07,India,NA,Rajasthan,68548437,1161,10,50157,767
2020-08-08,India,NA,Rajasthan,68548437,1171,11,51328,778
2020-08-09,India,NA,Rajasthan,68548437,1169,11,52497,789
2020-08-10,India,NA,Rajasthan,68548437,1173,11,53670,800
2020-08-11,India,NA,Rajasthan,68548437,1217,11,54887,811
2020-08-12,India,NA,Rajasthan,68548437,1213,11,56100,822
2020-08-13,India,NA,Rajasthan,68548437,1314,11,57414,833
2020-08-14,India,NA,Rajasthan,68548437,1278,13,58692,846
2020-08-15,India,NA,Rajasthan,68548437,1287,16,59979,862
2020-08-16,India,NA,Rajasthan,68548437,1317,14,61296,876
2020-08-17,India,NA,Rajasthan,68548437,1334,11,62630,887
2020-08-18,India,NA,Rajasthan,68548437,1347,11,63977,898
2020-08-19,India,NA,Rajasthan,68548437,1312,12,65289,910
2020-08-20,India,NA,Rajasthan,68548437,1330,11,66619,921
2020-08-21,India,NA,Rajasthan,68548437,1335,12,67954,933
2020-08-22,India,NA,Rajasthan,68548437,1310,11,69264,944
2020-08-23,India,NA,Rajasthan,68548437,1345,11,70609,955
2020-08-24,India,NA,Rajasthan,68548437,1346,12,71955,967
2020-08-25,India,NA,Rajasthan,68548437,1370,13,73325,980
2020-08-26,India,NA,Rajasthan,68548437,1345,12,74670,992
2020-08-27,India,NA,Rajasthan,68548437,1345,13,76015,1005
2020-08-28,India,NA,Rajasthan,68548437,1355,12,77370,1017
2020-08-29,India,NA,Rajasthan,68548437,1407,13,78777,1030
2020-08-30,India,NA,Rajasthan,68548437,1450,13,80227,1043
2020-08-31,India,NA,Rajasthan,68548437,1466,13,81693,1056
2020-09-01,India,NA,Rajasthan,68548437,1470,13,83163,1069
2020-09-02,India,NA,Rajasthan,68548437,1511,12,84674,1081
2020-09-03,India,NA,Rajasthan,68548437,1553,14,86227,1095
2020-09-04,India,NA,Rajasthan,68548437,1570,13,87797,1108
2020-09-05,India,NA,Rajasthan,68548437,1566,14,89363,1122
2020-09-06,India,NA,Rajasthan,68548437,1593,15,90956,1137
2020-09-07,India,NA,Rajasthan,68548437,1580,14,92536,1151
2020-09-08,India,NA,Rajasthan,68548437,1590,13,94126,1164
2020-09-09,India,NA,Rajasthan,68548437,1610,14,95736,1178
2020-09-10,India,NA,Rajasthan,68548437,1640,14,97376,1192
2020-09-11,India,NA,Rajasthan,68548437,1660,15,99036,1207
2020-09-12,India,NA,Rajasthan,68548437,1669,14,100705,1221
2020-09-13,India,NA,Rajasthan,68548437,1703,15,102408,1236
2020-09-14,India,NA,Rajasthan,68548437,1730,14,104138,1250
2020-09-15,India,NA,Rajasthan,68548437,1760,14,105898,1264
2020-09-16,India,NA,Rajasthan,68548437,1782,15,107680,1279
2020-09-17,India,NA,Rajasthan,68548437,1793,14,109473,1293
2020-09-18,India,NA,Rajasthan,68548437,1817,15,111290,1308
2020-09-19,India,NA,Rajasthan,68548437,1834,14,113124,1322
2020-09-20,India,NA,Rajasthan,68548437,1865,14,114989,1336
2020-09-21,India,NA,Rajasthan,68548437,1892,16,116881,1352
2020-09-22,India,NA,Rajasthan,68548437,1912,15,118793,1367
2020-09-23,India,NA,Rajasthan,68548437,1946,15,120739,1382
2020-06-09,India,NA,Sikkim,611000,6,0,13,0
2020-06-10,India,NA,Sikkim,611000,0,0,13,0
2020-06-11,India,NA,Sikkim,611000,0,0,13,0
2020-06-12,India,NA,Sikkim,611000,50,0,63,0
2020-06-13,India,NA,Sikkim,611000,0,0,63,0
2020-06-14,India,NA,Sikkim,611000,5,0,68,0
2020-06-15,India,NA,Sikkim,611000,0,0,68,0
2020-06-16,India,NA,Sikkim,611000,0,0,68,0
2020-06-17,India,NA,Sikkim,611000,2,0,70,0
2020-06-18,India,NA,Sikkim,611000,0,0,70,0
2020-06-19,India,NA,Sikkim,611000,0,0,70,0
2020-06-20,India,NA,Sikkim,611000,0,0,70,0
2020-06-21,India,NA,Sikkim,611000,8,0,78,0
2020-06-22,India,NA,Sikkim,611000,0,0,78,0
2020-06-23,India,NA,Sikkim,611000,1,0,79,0
2020-06-24,India,NA,Sikkim,611000,4,0,83,0
2020-06-25,India,NA,Sikkim,611000,2,0,85,0
2020-06-26,India,NA,Sikkim,611000,2,0,87,0
2020-06-27,India,NA,Sikkim,611000,0,0,87,0
2020-06-28,India,NA,Sikkim,611000,1,0,88,0
2020-06-29,India,NA,Sikkim,611000,0,0,88,0
2020-06-30,India,NA,Sikkim,611000,0,0,88,0
2020-07-01,India,NA,Sikkim,611000,1,0,89,0
2020-07-02,India,NA,Sikkim,611000,12,0,101,0
2020-07-03,India,NA,Sikkim,611000,1,0,102,0
2020-07-04,India,NA,Sikkim,611000,1,0,103,0
2020-07-05,India,NA,Sikkim,611000,22,0,125,0
2020-07-06,India,NA,Sikkim,611000,0,0,125,0
2020-07-07,India,NA,Sikkim,611000,2,0,127,0
2020-07-08,India,NA,Sikkim,611000,6,0,133,0
2020-07-09,India,NA,Sikkim,611000,1,0,134,0
2020-07-10,India,NA,Sikkim,611000,0,0,134,0
2020-07-11,India,NA,Sikkim,611000,26,0,160,0
2020-07-12,India,NA,Sikkim,611000,4,0,164,0
2020-07-13,India,NA,Sikkim,611000,2,0,166,0
2020-07-14,India,NA,Sikkim,611000,45,0,211,0
2020-07-15,India,NA,Sikkim,611000,11,0,222,0
2020-07-16,India,NA,Sikkim,611000,13,0,235,0
2020-07-17,India,NA,Sikkim,611000,32,0,267,0
2020-07-18,India,NA,Sikkim,611000,19,0,286,0
2020-07-19,India,NA,Sikkim,611000,10,0,296,0
2020-07-20,India,NA,Sikkim,611000,22,0,318,0
2020-07-21,India,NA,Sikkim,611000,25,0,343,0
2020-07-22,India,NA,Sikkim,611000,108,0,451,0
2020-07-23,India,NA,Sikkim,611000,22,0,473,0
2020-07-24,India,NA,Sikkim,611000,17,0,490,0
2020-07-25,India,NA,Sikkim,611000,22,0,512,0
2020-07-26,India,NA,Sikkim,611000,46,1,558,1
2020-07-27,India,NA,Sikkim,611000,10,0,568,1
2020-07-28,India,NA,Sikkim,611000,24,0,592,1
2020-07-29,India,NA,Sikkim,611000,17,0,609,1
2020-07-30,India,NA,Sikkim,611000,14,0,623,1
2020-07-31,India,NA,Sikkim,611000,29,0,652,1
2020-08-01,India,NA,Sikkim,611000,11,0,663,1
2020-08-02,India,NA,Sikkim,611000,8,0,671,1
2020-08-03,India,NA,Sikkim,611000,30,0,701,1
2020-08-04,India,NA,Sikkim,611000,95,0,796,1
2020-08-05,India,NA,Sikkim,611000,17,0,813,1
2020-08-06,India,NA,Sikkim,611000,29,0,842,1
2020-08-07,India,NA,Sikkim,611000,25,0,867,1
2020-08-08,India,NA,Sikkim,611000,6,0,873,1
2020-08-09,India,NA,Sikkim,611000,6,0,879,1
2020-08-10,India,NA,Sikkim,611000,44,0,923,1
2020-08-11,India,NA,Sikkim,611000,3,0,926,1
2020-08-12,India,NA,Sikkim,611000,17,0,943,1
2020-08-13,India,NA,Sikkim,611000,1,0,944,1
2020-08-14,India,NA,Sikkim,611000,149,0,1093,1
2020-08-15,India,NA,Sikkim,611000,68,0,1161,1
2020-08-16,India,NA,Sikkim,611000,19,0,1180,1
2020-08-17,India,NA,Sikkim,611000,20,0,1200,1
2020-08-18,India,NA,Sikkim,611000,20,1,1220,2
2020-08-19,India,NA,Sikkim,611000,25,1,1245,3
2020-08-20,India,NA,Sikkim,611000,58,0,1303,3
2020-08-21,India,NA,Sikkim,611000,46,0,1349,3
2020-08-22,India,NA,Sikkim,611000,45,0,1394,3
2020-08-23,India,NA,Sikkim,611000,22,0,1416,3
2020-08-24,India,NA,Sikkim,611000,43,0,1459,3
2020-08-25,India,NA,Sikkim,611000,29,0,1488,3
2020-08-26,India,NA,Sikkim,611000,11,0,1499,3
2020-08-27,India,NA,Sikkim,611000,56,0,1555,3
2020-08-28,India,NA,Sikkim,611000,34,0,1589,3
2020-08-29,India,NA,Sikkim,611000,26,0,1615,3
2020-08-30,India,NA,Sikkim,611000,25,0,1640,3
2020-08-31,India,NA,Sikkim,611000,25,0,1665,3
2020-09-01,India,NA,Sikkim,611000,18,1,1683,4
2020-09-02,India,NA,Sikkim,611000,34,0,1717,4
2020-09-03,India,NA,Sikkim,611000,34,1,1751,5
2020-09-04,India,NA,Sikkim,611000,105,0,1856,5
2020-09-05,India,NA,Sikkim,611000,58,0,1914,5
2020-09-06,India,NA,Sikkim,611000,9,0,1923,5
2020-09-07,India,NA,Sikkim,611000,29,0,1952,5
2020-09-08,India,NA,Sikkim,611000,19,2,1971,7
2020-09-09,India,NA,Sikkim,611000,31,0,2002,7
2020-09-10,India,NA,Sikkim,611000,20,0,2022,7
2020-09-11,India,NA,Sikkim,611000,17,4,2039,11
2020-09-12,India,NA,Sikkim,611000,29,2,2068,13
2020-09-13,India,NA,Sikkim,611000,31,3,2099,16
2020-09-14,India,NA,Sikkim,611000,33,0,2132,16
2020-09-15,India,NA,Sikkim,611000,54,3,2186,19
2020-09-16,India,NA,Sikkim,611000,48,0,2234,19
2020-09-17,India,NA,Sikkim,611000,53,4,2287,23
2020-09-18,India,NA,Sikkim,611000,29,3,2316,26
2020-09-19,India,NA,Sikkim,611000,39,2,2355,28
2020-09-20,India,NA,Sikkim,611000,49,1,2404,29
2020-09-21,India,NA,Sikkim,611000,56,0,2460,29
2020-09-22,India,NA,Sikkim,611000,66,0,2526,29
2020-09-23,India,NA,Sikkim,611000,35,1,2561,30
2020-03-23,India,NA,Tamil Nadu,72147030,3,0,12,0
2020-03-24,India,NA,Tamil Nadu,72147030,6,1,18,1
2020-03-25,India,NA,Tamil Nadu,72147030,8,0,26,1
2020-03-26,India,NA,Tamil Nadu,72147030,3,0,29,1
2020-03-27,India,NA,Tamil Nadu,72147030,9,0,38,1
2020-03-28,India,NA,Tamil Nadu,72147030,4,0,42,1
2020-03-29,India,NA,Tamil Nadu,72147030,8,0,50,1
2020-03-30,India,NA,Tamil Nadu,72147030,17,0,67,1
2020-03-31,India,NA,Tamil Nadu,72147030,57,0,124,1
2020-04-01,India,NA,Tamil Nadu,72147030,110,0,234,1
2020-04-02,India,NA,Tamil Nadu,72147030,75,0,309,1
2020-04-03,India,NA,Tamil Nadu,72147030,102,0,411,1
2020-04-04,India,NA,Tamil Nadu,72147030,74,2,485,3
2020-04-05,India,NA,Tamil Nadu,72147030,86,2,571,5
2020-04-06,India,NA,Tamil Nadu,72147030,50,1,621,6
2020-04-07,India,NA,Tamil Nadu,72147030,69,1,690,7
2020-04-08,India,NA,Tamil Nadu,72147030,48,1,738,8
2020-04-09,India,NA,Tamil Nadu,72147030,96,0,834,8
2020-04-10,India,NA,Tamil Nadu,72147030,77,1,911,9
2020-04-11,India,NA,Tamil Nadu,72147030,58,1,969,10
2020-04-12,India,NA,Tamil Nadu,72147030,106,1,1075,11
2020-04-13,India,NA,Tamil Nadu,72147030,98,0,1173,11
2020-04-14,India,NA,Tamil Nadu,72147030,31,1,1204,12
2020-04-15,India,NA,Tamil Nadu,72147030,38,2,1242,14
2020-04-16,India,NA,Tamil Nadu,72147030,25,1,1267,15
2020-04-17,India,NA,Tamil Nadu,72147030,56,0,1323,15
2020-04-18,India,NA,Tamil Nadu,72147030,49,0,1372,15
2020-04-19,India,NA,Tamil Nadu,72147030,105,0,1477,15
2020-04-20,India,NA,Tamil Nadu,72147030,43,2,1520,17
2020-04-21,India,NA,Tamil Nadu,72147030,76,1,1596,18
2020-04-22,India,NA,Tamil Nadu,72147030,33,0,1629,18
2020-04-23,India,NA,Tamil Nadu,72147030,54,2,1683,20
2020-04-24,India,NA,Tamil Nadu,72147030,72,2,1755,22
2020-04-25,India,NA,Tamil Nadu,72147030,66,1,1821,23
2020-04-26,India,NA,Tamil Nadu,72147030,64,1,1885,24
2020-04-27,India,NA,Tamil Nadu,72147030,52,0,1937,24
2020-04-28,India,NA,Tamil Nadu,72147030,121,1,2058,25
2020-04-29,India,NA,Tamil Nadu,72147030,104,2,2162,27
2020-04-30,India,NA,Tamil Nadu,72147030,161,0,2323,27
2020-05-01,India,NA,Tamil Nadu,72147030,203,1,2526,28
2020-05-02,India,NA,Tamil Nadu,72147030,231,1,2757,29
2020-05-03,India,NA,Tamil Nadu,72147030,266,1,3023,30
2020-05-04,India,NA,Tamil Nadu,72147030,527,1,3550,31
2020-05-05,India,NA,Tamil Nadu,72147030,508,2,4058,33
2020-05-06,India,NA,Tamil Nadu,72147030,771,2,4829,35
2020-05-07,India,NA,Tamil Nadu,72147030,580,2,5409,37
2020-05-08,India,NA,Tamil Nadu,72147030,600,3,6009,40
2020-05-09,India,NA,Tamil Nadu,72147030,526,4,6535,44
2020-05-10,India,NA,Tamil Nadu,72147030,669,3,7204,47
2020-05-11,India,NA,Tamil Nadu,72147030,798,6,8002,53
2020-05-12,India,NA,Tamil Nadu,72147030,716,8,8718,61
2020-05-13,India,NA,Tamil Nadu,72147030,509,3,9227,64
2020-05-14,India,NA,Tamil Nadu,72147030,447,2,9674,66
2020-05-15,India,NA,Tamil Nadu,72147030,434,5,10108,71
2020-05-16,India,NA,Tamil Nadu,72147030,477,4,10585,75
2020-05-17,India,NA,Tamil Nadu,72147030,639,4,11224,79
2020-05-18,India,NA,Tamil Nadu,72147030,536,3,11760,82
2020-05-19,India,NA,Tamil Nadu,72147030,688,3,12448,85
2020-05-20,India,NA,Tamil Nadu,72147030,743,3,13191,88
2020-05-21,India,NA,Tamil Nadu,72147030,776,7,13967,95
2020-05-22,India,NA,Tamil Nadu,72147030,786,4,14753,99
2020-05-23,India,NA,Tamil Nadu,72147030,759,5,15512,104
2020-05-24,India,NA,Tamil Nadu,72147030,765,8,16277,112
2020-05-25,India,NA,Tamil Nadu,72147030,805,7,17082,119
2020-05-26,India,NA,Tamil Nadu,72147030,646,11,17728,130
2020-05-27,India,NA,Tamil Nadu,72147030,817,6,18545,136
2020-05-28,India,NA,Tamil Nadu,72147030,827,12,19372,148
2020-05-29,India,NA,Tamil Nadu,72147030,874,9,20246,157
2020-05-30,India,NA,Tamil Nadu,72147030,938,6,21184,163
2020-05-31,India,NA,Tamil Nadu,72147030,1149,13,22333,176
2020-06-01,India,NA,Tamil Nadu,72147030,1162,11,23495,187
2020-06-02,India,NA,Tamil Nadu,72147030,1091,13,24586,200
2020-06-03,India,NA,Tamil Nadu,72147030,1286,8,25872,208
2020-06-04,India,NA,Tamil Nadu,72147030,1384,15,27256,223
2020-06-05,India,NA,Tamil Nadu,72147030,1438,12,28694,235
2020-06-06,India,NA,Tamil Nadu,72147030,1458,19,30152,254
2020-06-07,India,NA,Tamil Nadu,72147030,1515,18,31667,272
2020-06-08,India,NA,Tamil Nadu,72147030,1562,17,33229,289
2020-06-09,India,NA,Tamil Nadu,72147030,1685,18,34914,307
2020-06-10,India,NA,Tamil Nadu,72147030,1927,19,36841,326
2020-06-11,India,NA,Tamil Nadu,72147030,1875,23,38716,349
2020-06-12,India,NA,Tamil Nadu,72147030,1982,18,40698,367
2020-06-13,India,NA,Tamil Nadu,72147030,1989,30,42687,397
2020-06-14,India,NA,Tamil Nadu,72147030,1974,38,44661,435
2020-06-15,India,NA,Tamil Nadu,72147030,1843,44,46504,479
2020-06-16,India,NA,Tamil Nadu,72147030,1515,49,48019,528
2020-06-17,India,NA,Tamil Nadu,72147030,2174,48,50193,576
2020-06-18,India,NA,Tamil Nadu,72147030,2141,49,52334,625
2020-06-19,India,NA,Tamil Nadu,72147030,2115,41,54449,666
2020-06-20,India,NA,Tamil Nadu,72147030,2396,38,56845,704
2020-06-21,India,NA,Tamil Nadu,72147030,2532,53,59377,757
2020-06-22,India,NA,Tamil Nadu,72147030,2710,37,62087,794
2020-06-23,India,NA,Tamil Nadu,72147030,2516,39,64603,833
2020-06-24,India,NA,Tamil Nadu,72147030,2865,33,67468,866
2020-06-25,India,NA,Tamil Nadu,72147030,3509,45,70977,911
2020-06-26,India,NA,Tamil Nadu,72147030,3645,46,74622,957
2020-06-27,India,NA,Tamil Nadu,72147030,3713,68,78335,1025
2020-06-28,India,NA,Tamil Nadu,72147030,3940,54,82275,1079
2020-06-29,India,NA,Tamil Nadu,72147030,3949,62,86224,1141
2020-06-30,India,NA,Tamil Nadu,72147030,3943,60,90167,1201
2020-07-01,India,NA,Tamil Nadu,72147030,3882,63,94049,1264
2020-07-02,India,NA,Tamil Nadu,72147030,4343,57,98392,1321
2020-07-03,India,NA,Tamil Nadu,72147030,4329,64,102721,1385
2020-07-04,India,NA,Tamil Nadu,72147030,4280,65,107001,1450
2020-07-05,India,NA,Tamil Nadu,72147030,4150,60,111151,1510
2020-07-06,India,NA,Tamil Nadu,72147030,3827,61,114978,1571
2020-07-07,India,NA,Tamil Nadu,72147030,3616,65,118594,1636
2020-07-08,India,NA,Tamil Nadu,72147030,3756,64,122350,1700
2020-07-09,India,NA,Tamil Nadu,72147030,4231,65,126581,1765
2020-07-10,India,NA,Tamil Nadu,72147030,3680,64,130261,1829
2020-07-11,India,NA,Tamil Nadu,72147030,3965,69,134226,1898
2020-07-12,India,NA,Tamil Nadu,72147030,4244,68,138470,1966
2020-07-13,India,NA,Tamil Nadu,72147030,4328,66,142798,2032
2020-07-14,India,NA,Tamil Nadu,72147030,4526,67,147324,2099
2020-07-15,India,NA,Tamil Nadu,72147030,4496,68,151820,2167
2020-07-16,India,NA,Tamil Nadu,72147030,4549,69,156369,2236
2020-07-17,India,NA,Tamil Nadu,72147030,4538,79,160907,2315
2020-07-18,India,NA,Tamil Nadu,72147030,4807,88,165714,2403
2020-07-19,India,NA,Tamil Nadu,72147030,4979,78,170693,2481
2020-07-20,India,NA,Tamil Nadu,72147030,4985,70,175678,2551
2020-07-21,India,NA,Tamil Nadu,72147030,4965,75,180643,2626
2020-07-22,India,NA,Tamil Nadu,72147030,5849,518,186492,3144
2020-07-23,India,NA,Tamil Nadu,72147030,6472,88,192964,3232
2020-07-24,India,NA,Tamil Nadu,72147030,6785,88,199749,3320
2020-07-25,India,NA,Tamil Nadu,72147030,6988,89,206737,3409
2020-07-26,India,NA,Tamil Nadu,72147030,6986,85,213723,3494
2020-07-27,India,NA,Tamil Nadu,72147030,6993,77,220716,3571
2020-07-28,India,NA,Tamil Nadu,72147030,6972,88,227688,3659
2020-07-29,India,NA,Tamil Nadu,72147030,6426,82,234114,3741
2020-07-30,India,NA,Tamil Nadu,72147030,5864,100,239978,3841
2020-07-31,India,NA,Tamil Nadu,72147030,5881,94,245859,3935
2020-08-01,India,NA,Tamil Nadu,72147030,5879,99,251738,4034
2020-08-02,India,NA,Tamil Nadu,72147030,5875,98,257613,4132
2020-08-03,India,NA,Tamil Nadu,72147030,5609,109,263222,4241
2020-08-04,India,NA,Tamil Nadu,72147030,5063,108,268285,4349
2020-08-05,India,NA,Tamil Nadu,72147030,5175,112,273460,4461
2020-08-06,India,NA,Tamil Nadu,72147030,5684,110,279144,4571
2020-08-07,India,NA,Tamil Nadu,72147030,5880,119,285024,4690
2020-08-08,India,NA,Tamil Nadu,72147030,5883,118,290907,4808
2020-08-09,India,NA,Tamil Nadu,72147030,5994,119,296901,4927
2020-08-10,India,NA,Tamil Nadu,72147030,5914,114,302815,5041
2020-08-11,India,NA,Tamil Nadu,72147030,5834,118,308649,5159
2020-08-12,India,NA,Tamil Nadu,72147030,5871,119,314520,5278
2020-08-13,India,NA,Tamil Nadu,72147030,5835,119,320355,5397
2020-08-14,India,NA,Tamil Nadu,72147030,5890,117,326245,5514
2020-08-15,India,NA,Tamil Nadu,72147030,5860,127,332105,5641
2020-08-16,India,NA,Tamil Nadu,72147030,5950,125,338055,5766
2020-08-17,India,NA,Tamil Nadu,72147030,5890,120,343945,5886
2020-08-18,India,NA,Tamil Nadu,72147030,5709,121,349654,6007
2020-08-19,India,NA,Tamil Nadu,72147030,5795,116,355449,6123
2020-08-20,India,NA,Tamil Nadu,72147030,5986,116,361435,6239
2020-08-21,India,NA,Tamil Nadu,72147030,5995,101,367430,6340
2020-08-22,India,NA,Tamil Nadu,72147030,5980,80,373410,6420
2020-08-23,India,NA,Tamil Nadu,72147030,5975,97,379385,6517
2020-08-24,India,NA,Tamil Nadu,72147030,5967,97,385352,6614
2020-08-25,India,NA,Tamil Nadu,72147030,5951,107,391303,6721
2020-08-26,India,NA,Tamil Nadu,72147030,5958,118,397261,6839
2020-08-27,India,NA,Tamil Nadu,72147030,5981,109,403242,6948
2020-08-28,India,NA,Tamil Nadu,72147030,5996,102,409238,7050
2020-08-29,India,NA,Tamil Nadu,72147030,6352,87,415590,7137
2020-08-30,India,NA,Tamil Nadu,72147030,6495,94,422085,7231
2020-08-31,India,NA,Tamil Nadu,72147030,5956,91,428041,7322
2020-09-01,India,NA,Tamil Nadu,72147030,5928,96,433969,7418
2020-09-02,India,NA,Tamil Nadu,72147030,5990,98,439959,7516
2020-09-03,India,NA,Tamil Nadu,72147030,5892,92,445851,7608
2020-09-04,India,NA,Tamil Nadu,72147030,5976,79,451827,7687
2020-09-05,India,NA,Tamil Nadu,72147030,5870,64,457697,7751
2020-09-06,India,NA,Tamil Nadu,72147030,5783,85,463480,7836
2020-09-07,India,NA,Tamil Nadu,72147030,5776,89,469256,7925
2020-09-08,India,NA,Tamil Nadu,72147030,5684,87,474940,8012
2020-09-09,India,NA,Tamil Nadu,72147030,5584,78,480524,8090
2020-09-10,India,NA,Tamil Nadu,72147030,5528,64,486052,8154
2020-09-11,India,NA,Tamil Nadu,72147030,5519,77,491571,8231
2020-09-12,India,NA,Tamil Nadu,72147030,5495,76,497066,8307
2020-09-13,India,NA,Tamil Nadu,72147030,5693,74,502759,8381
2020-09-14,India,NA,Tamil Nadu,72147030,5752,53,508511,8434
2020-09-15,India,NA,Tamil Nadu,72147030,5697,68,514208,8502
2020-09-16,India,NA,Tamil Nadu,72147030,5652,57,519860,8559
2020-09-17,India,NA,Tamil Nadu,72147030,5560,59,525420,8618
2020-09-18,India,NA,Tamil Nadu,72147030,5488,67,530908,8685
2020-09-19,India,NA,Tamil Nadu,72147030,5569,66,536477,8751
2020-09-20,India,NA,Tamil Nadu,72147030,5516,60,541993,8811
2020-09-21,India,NA,Tamil Nadu,72147030,5344,60,547337,8871
2020-09-22,India,NA,Tamil Nadu,72147030,5337,76,552674,8947
2020-09-23,India,NA,Tamil Nadu,72147030,5325,63,557999,9010
2020-03-18,India,NA,Telangana,35193978,8,0,13,0
2020-03-19,India,NA,Telangana,35193978,3,0,16,0
2020-03-20,India,NA,Telangana,35193978,3,0,19,0
2020-03-21,India,NA,Telangana,35193978,2,0,21,0
2020-03-22,India,NA,Telangana,35193978,6,0,27,0
2020-03-23,India,NA,Telangana,35193978,6,0,33,0
2020-03-24,India,NA,Telangana,35193978,4,0,37,0
2020-03-25,India,NA,Telangana,35193978,4,0,41,0
2020-03-26,India,NA,Telangana,35193978,3,0,44,0
2020-03-27,India,NA,Telangana,35193978,15,0,59,0
2020-03-28,India,NA,Telangana,35193978,8,1,67,1
2020-03-29,India,NA,Telangana,35193978,3,0,70,1
2020-03-30,India,NA,Telangana,35193978,7,5,77,6
2020-03-31,India,NA,Telangana,35193978,20,0,97,6
2020-04-01,India,NA,Telangana,35193978,30,3,127,9
2020-04-02,India,NA,Telangana,35193978,27,0,154,9
2020-04-03,India,NA,Telangana,35193978,75,2,229,11
2020-04-04,India,NA,Telangana,35193978,43,0,272,11
2020-04-05,India,NA,Telangana,35193978,62,0,334,11
2020-04-06,India,NA,Telangana,35193978,30,0,364,11
2020-04-07,India,NA,Telangana,35193978,40,0,404,11
2020-04-08,India,NA,Telangana,35193978,49,0,453,11
2020-04-09,India,NA,Telangana,35193978,18,1,471,12
2020-04-10,India,NA,Telangana,35193978,16,0,487,12
2020-04-11,India,NA,Telangana,35193978,16,2,503,14
2020-04-12,India,NA,Telangana,35193978,28,2,531,16
2020-04-13,India,NA,Telangana,35193978,61,1,592,17
2020-04-14,India,NA,Telangana,35193978,52,1,644,18
2020-04-15,India,NA,Telangana,35193978,6,0,650,18
2020-04-16,India,NA,Telangana,35193978,50,0,700,18
2020-04-17,India,NA,Telangana,35193978,66,0,766,18
2020-04-18,India,NA,Telangana,35193978,43,0,809,18
2020-04-19,India,NA,Telangana,35193978,49,3,858,21
2020-04-20,India,NA,Telangana,35193978,14,2,872,23
2020-04-21,India,NA,Telangana,35193978,56,0,928,23
2020-04-22,India,NA,Telangana,35193978,15,1,943,24
2020-04-23,India,NA,Telangana,35193978,27,1,970,25
2020-04-24,India,NA,Telangana,35193978,13,0,983,25
2020-04-25,India,NA,Telangana,35193978,7,0,990,25
2020-04-26,India,NA,Telangana,35193978,11,0,1001,25
2020-04-27,India,NA,Telangana,35193978,2,0,1003,25
2020-04-28,India,NA,Telangana,35193978,6,0,1009,25
2020-04-29,India,NA,Telangana,35193978,7,0,1016,25
2020-04-30,India,NA,Telangana,35193978,22,3,1038,28
2020-05-01,India,NA,Telangana,35193978,6,0,1044,28
2020-05-02,India,NA,Telangana,35193978,17,1,1061,29
2020-05-03,India,NA,Telangana,35193978,21,0,1082,29
2020-05-04,India,NA,Telangana,35193978,3,0,1085,29
2020-05-05,India,NA,Telangana,35193978,11,0,1096,29
2020-05-06,India,NA,Telangana,35193978,11,0,1107,29
2020-05-07,India,NA,Telangana,35193978,15,0,1122,29
2020-05-08,India,NA,Telangana,35193978,10,0,1132,29
2020-05-09,India,NA,Telangana,35193978,31,1,1163,30
2020-05-10,India,NA,Telangana,35193978,33,0,1196,30
2020-05-11,India,NA,Telangana,35193978,79,0,1275,30
2020-05-12,India,NA,Telangana,35193978,51,2,1326,32
2020-05-13,India,NA,Telangana,35193978,41,2,1367,34
2020-05-14,India,NA,Telangana,35193978,47,0,1414,34
2020-05-15,India,NA,Telangana,35193978,40,0,1454,34
2020-05-16,India,NA,Telangana,35193978,55,0,1509,34
2020-05-17,India,NA,Telangana,35193978,42,0,1551,34
2020-05-18,India,NA,Telangana,35193978,41,0,1592,34
2020-05-19,India,NA,Telangana,35193978,42,4,1634,38
2020-05-20,India,NA,Telangana,35193978,27,2,1661,40
2020-05-21,India,NA,Telangana,35193978,38,5,1699,45
2020-05-22,India,NA,Telangana,35193978,62,3,1761,48
2020-05-23,India,NA,Telangana,35193978,52,1,1813,49
2020-05-24,India,NA,Telangana,35193978,41,4,1854,53
2020-05-25,India,NA,Telangana,35193978,66,3,1920,56
2020-05-26,India,NA,Telangana,35193978,112,1,2032,57
2020-05-27,India,NA,Telangana,35193978,107,6,2139,63
2020-05-28,India,NA,Telangana,35193978,117,4,2256,67
2020-05-29,India,NA,Telangana,35193978,169,4,2425,71
2020-05-30,India,NA,Telangana,35193978,74,6,2499,77
2020-05-31,India,NA,Telangana,35193978,199,5,2698,82
2020-06-01,India,NA,Telangana,35193978,94,6,2792,88
2020-06-02,India,NA,Telangana,35193978,99,4,2891,92
2020-06-03,India,NA,Telangana,35193978,129,7,3020,99
2020-06-04,India,NA,Telangana,35193978,127,6,3147,105
2020-06-05,India,NA,Telangana,35193978,143,8,3290,113
2020-06-06,India,NA,Telangana,35193978,206,10,3496,123
2020-06-07,India,NA,Telangana,35193978,154,14,3650,137
2020-06-08,India,NA,Telangana,35193978,92,5,3742,142
2020-06-09,India,NA,Telangana,35193978,178,6,3920,148
2020-06-10,India,NA,Telangana,35193978,191,8,4111,156
2020-06-11,India,NA,Telangana,35193978,209,9,4320,165
2020-06-12,India,NA,Telangana,35193978,164,9,4484,174
2020-06-13,India,NA,Telangana,35193978,253,8,4737,182
2020-06-14,India,NA,Telangana,35193978,237,3,4974,185
2020-06-15,India,NA,Telangana,35193978,219,2,5193,187
2020-06-16,India,NA,Telangana,35193978,213,4,5406,191
2020-06-17,India,NA,Telangana,35193978,269,1,5675,192
2020-06-18,India,NA,Telangana,35193978,352,3,6027,195
2020-06-19,India,NA,Telangana,35193978,499,3,6526,198
2020-06-20,India,NA,Telangana,35193978,546,5,7072,203
2020-06-21,India,NA,Telangana,35193978,730,7,7802,210
2020-06-22,India,NA,Telangana,35193978,872,7,8674,217
2020-06-23,India,NA,Telangana,35193978,879,3,9553,220
2020-06-24,India,NA,Telangana,35193978,891,5,10444,225
2020-06-25,India,NA,Telangana,35193978,920,5,11364,230
2020-06-26,India,NA,Telangana,35193978,985,7,12349,237
2020-06-27,India,NA,Telangana,35193978,1087,6,13436,243
2020-06-28,India,NA,Telangana,35193978,983,4,14419,247
2020-06-29,India,NA,Telangana,35193978,975,6,15394,253
2020-06-30,India,NA,Telangana,35193978,945,7,16339,260
2020-07-01,India,NA,Telangana,35193978,1018,7,17357,267
2020-07-02,India,NA,Telangana,35193978,1213,8,18570,275
2020-07-03,India,NA,Telangana,35193978,1892,8,20462,283
2020-07-04,India,NA,Telangana,35193978,1850,5,22312,288
2020-07-05,India,NA,Telangana,35193978,1590,7,23902,295
2020-07-06,India,NA,Telangana,35193978,1831,11,25733,306
2020-07-07,India,NA,Telangana,35193978,1879,7,27612,313
2020-07-08,India,NA,Telangana,35193978,1924,11,29536,324
2020-07-09,India,NA,Telangana,35193978,1410,7,30946,331
2020-07-10,India,NA,Telangana,35193978,1278,8,32224,339
2020-07-11,India,NA,Telangana,35193978,1178,9,33402,348
2020-07-12,India,NA,Telangana,35193978,1269,8,34671,356
2020-07-13,India,NA,Telangana,35193978,1550,9,36221,365
2020-07-14,India,NA,Telangana,35193978,1524,10,37745,375
2020-07-15,India,NA,Telangana,35193978,1597,11,39342,386
2020-07-16,India,NA,Telangana,35193978,1676,10,41018,396
2020-07-17,India,NA,Telangana,35193978,1478,7,42496,403
2020-07-18,India,NA,Telangana,35193978,1284,6,43780,409
2020-07-19,India,NA,Telangana,35193978,1296,6,45076,415
2020-07-20,India,NA,Telangana,35193978,1198,7,46274,422
2020-07-21,India,NA,Telangana,35193978,1430,7,47704,429
2020-07-22,India,NA,Telangana,35193978,1555,9,49259,438
2020-07-23,India,NA,Telangana,35193978,1567,9,50826,447
2020-07-24,India,NA,Telangana,35193978,1640,8,52466,455
2020-07-25,India,NA,Telangana,35193978,1593,8,54059,463
2020-07-26,India,NA,Telangana,35193978,0,0,54059,463
2020-07-27,India,NA,Telangana,35193978,1473,8,55532,471
2020-07-28,India,NA,Telangana,35193978,1610,9,57142,480
2020-07-29,India,NA,Telangana,35193978,1764,12,58906,492
2020-07-30,India,NA,Telangana,35193978,1811,13,60717,505
2020-07-31,India,NA,Telangana,35193978,1986,14,62703,519
2020-08-01,India,NA,Telangana,35193978,2083,11,64786,530
2020-08-02,India,NA,Telangana,35193978,1891,10,66677,540
2020-08-03,India,NA,Telangana,35193978,983,11,67660,551
2020-08-04,India,NA,Telangana,35193978,1286,12,68946,563
2020-08-05,India,NA,Telangana,35193978,2012,13,70958,576
2020-08-06,India,NA,Telangana,35193978,2092,13,73050,589
2020-08-07,India,NA,Telangana,35193978,2207,12,75257,601
2020-08-08,India,NA,Telangana,35193978,2256,14,77513,615
2020-08-09,India,NA,Telangana,35193978,1982,12,79495,627
2020-08-10,India,NA,Telangana,35193978,1256,10,80751,637
2020-08-11,India,NA,Telangana,35193978,1896,8,82647,645
2020-08-12,India,NA,Telangana,35193978,1897,9,84544,654
2020-08-13,India,NA,Telangana,35193978,1931,11,86475,665
2020-08-14,India,NA,Telangana,35193978,1921,9,88396,674
2020-08-15,India,NA,Telangana,35193978,1863,10,90259,684
2020-08-16,India,NA,Telangana,35193978,1102,9,91361,693
2020-08-17,India,NA,Telangana,35193978,894,10,92255,703
2020-08-18,India,NA,Telangana,35193978,1682,8,93937,711
2020-08-19,India,NA,Telangana,35193978,1763,8,95700,719
2020-08-20,India,NA,Telangana,35193978,1724,10,97424,729
2020-08-21,India,NA,Telangana,35193978,1457,8,98881,737
2020-08-22,India,NA,Telangana,35193978,2474,7,101355,744
2020-08-23,India,NA,Telangana,35193978,2384,11,103739,755
2020-08-24,India,NA,Telangana,35193978,1842,6,105581,761
2020-08-25,India,NA,Telangana,35193978,2579,9,108160,770
2020-08-26,India,NA,Telangana,35193978,3018,10,111178,780
2020-08-27,India,NA,Telangana,35193978,2795,8,113973,788
2020-08-28,India,NA,Telangana,35193978,2932,11,116905,799
2020-08-29,India,NA,Telangana,35193978,2751,9,119656,808
2020-08-30,India,NA,Telangana,35193978,2924,10,122580,818
2020-08-31,India,NA,Telangana,35193978,1873,9,124453,827
2020-09-01,India,NA,Telangana,35193978,2734,9,127187,836
2020-09-02,India,NA,Telangana,35193978,2892,10,130079,846
2020-09-03,India,NA,Telangana,35193978,2817,10,132896,856
2020-09-04,India,NA,Telangana,35193978,2478,10,135374,866
2020-09-05,India,NA,Telangana,35193978,2511,11,137885,877
2020-09-06,India,NA,Telangana,35193978,2574,9,140459,886
2020-09-07,India,NA,Telangana,35193978,1802,9,142261,895
2020-09-08,India,NA,Telangana,35193978,2392,11,144653,906
2020-09-09,India,NA,Telangana,35193978,2479,10,147132,916
2020-09-10,India,NA,Telangana,35193978,2534,11,149666,927
2020-09-11,India,NA,Telangana,35193978,2426,13,152092,940
2020-09-12,India,NA,Telangana,35193978,2278,10,154370,950
2020-09-13,India,NA,Telangana,35193978,2216,11,156586,961
2020-09-14,India,NA,Telangana,35193978,1417,13,158003,974
2020-09-15,India,NA,Telangana,35193978,2058,10,160061,984
2020-09-16,India,NA,Telangana,35193978,2273,12,162334,996
2020-09-17,India,NA,Telangana,35193978,2159,9,164493,1005
2020-09-18,India,NA,Telangana,35193978,2043,11,166536,1016
2020-09-19,India,NA,Telangana,35193978,2123,9,168659,1025
2020-09-20,India,NA,Telangana,35193978,2137,8,170796,1033
2020-09-21,India,NA,Telangana,35193978,1302,9,172098,1042
2020-09-22,India,NA,Telangana,35193978,2166,10,174264,1052
2020-09-23,India,NA,Telangana,35193978,2296,10,176560,1062
2020-05-03,India,NA,Tripura,3673917,12,0,17,0
2020-05-04,India,NA,Tripura,3673917,13,0,30,0
2020-05-05,India,NA,Tripura,3673917,13,0,43,0
2020-05-06,India,NA,Tripura,3673917,22,0,65,0
2020-05-07,India,NA,Tripura,3673917,24,0,89,0
2020-05-08,India,NA,Tripura,3673917,30,0,119,0
2020-05-09,India,NA,Tripura,3673917,17,0,136,0
2020-05-10,India,NA,Tripura,3673917,16,0,152,0
2020-05-11,India,NA,Tripura,3673917,0,0,152,0
2020-05-12,India,NA,Tripura,3673917,2,0,154,0
2020-05-13,India,NA,Tripura,3673917,1,0,155,0
2020-05-14,India,NA,Tripura,3673917,1,0,156,0
2020-05-15,India,NA,Tripura,3673917,0,0,156,0
2020-05-16,India,NA,Tripura,3673917,11,0,167,0
2020-05-17,India,NA,Tripura,3673917,0,0,167,0
2020-05-18,India,NA,Tripura,3673917,0,0,167,0
2020-05-19,India,NA,Tripura,3673917,8,0,173,0
2020-05-20,India,NA,Tripura,3673917,0,0,173,0
2020-05-21,India,NA,Tripura,3673917,2,0,175,0
2020-05-22,India,NA,Tripura,3673917,0,0,175,0
2020-05-23,India,NA,Tripura,3673917,16,0,191,0
2020-05-24,India,NA,Tripura,3673917,3,0,194,0
2020-05-25,India,NA,Tripura,3673917,4,0,198,0
2020-05-26,India,NA,Tripura,3673917,34,0,232,0
2020-05-27,India,NA,Tripura,3673917,10,0,242,0
2020-05-28,India,NA,Tripura,3673917,2,0,244,0
2020-05-29,India,NA,Tripura,3673917,10,0,254,0
2020-05-30,India,NA,Tripura,3673917,17,0,271,0
2020-05-31,India,NA,Tripura,3673917,45,0,316,0
2020-06-01,India,NA,Tripura,3673917,107,0,423,0
2020-06-02,India,NA,Tripura,3673917,48,0,471,0
2020-06-03,India,NA,Tripura,3673917,151,0,622,0
2020-06-04,India,NA,Tripura,3673917,24,0,646,0
2020-06-05,India,NA,Tripura,3673917,48,0,694,0
2020-06-06,India,NA,Tripura,3673917,55,0,749,0
2020-06-07,India,NA,Tripura,3673917,53,0,802,0
2020-06-08,India,NA,Tripura,3673917,38,0,840,0
2020-06-09,India,NA,Tripura,3673917,26,1,866,1
2020-06-10,India,NA,Tripura,3673917,31,0,897,1
2020-06-11,India,NA,Tripura,3673917,25,0,922,1
2020-06-12,India,NA,Tripura,3673917,41,0,963,1
2020-06-13,India,NA,Tripura,3673917,83,0,1046,1
2020-06-14,India,NA,Tripura,3673917,33,0,1079,1
2020-06-15,India,NA,Tripura,3673917,10,0,1089,1
2020-06-16,India,NA,Tripura,3673917,1,0,1090,1
2020-06-17,India,NA,Tripura,3673917,43,0,1133,1
2020-06-18,India,NA,Tripura,3673917,21,0,1154,1
2020-06-19,India,NA,Tripura,3673917,27,0,1181,1
2020-06-20,India,NA,Tripura,3673917,8,0,1189,1
2020-06-21,India,NA,Tripura,3673917,35,0,1224,1
2020-06-22,India,NA,Tripura,3673917,16,0,1240,1
2020-06-23,India,NA,Tripura,3673917,23,0,1263,1
2020-06-24,India,NA,Tripura,3673917,0,0,1263,1
2020-06-25,India,NA,Tripura,3673917,32,0,1295,1
2020-06-26,India,NA,Tripura,3673917,35,0,1330,1
2020-06-27,India,NA,Tripura,3673917,9,0,1339,1
2020-06-28,India,NA,Tripura,3673917,12,0,1351,1
2020-06-29,India,NA,Tripura,3673917,34,0,1385,1
2020-06-30,India,NA,Tripura,3673917,8,0,1393,1
2020-07-01,India,NA,Tripura,3673917,8,0,1401,1
2020-07-02,India,NA,Tripura,3673917,39,0,1440,1
2020-07-03,India,NA,Tripura,3673917,93,0,1533,1
2020-07-04,India,NA,Tripura,3673917,25,0,1558,1
2020-07-05,India,NA,Tripura,3673917,23,0,1581,1
2020-07-06,India,NA,Tripura,3673917,111,0,1692,1
2020-07-07,India,NA,Tripura,3673917,24,0,1716,1
2020-07-08,India,NA,Tripura,3673917,57,0,1773,1
2020-07-09,India,NA,Tripura,3673917,16,0,1789,1
2020-07-10,India,NA,Tripura,3673917,142,0,1931,1
2020-07-11,India,NA,Tripura,3673917,31,1,1962,2
2020-07-12,India,NA,Tripura,3673917,105,0,2067,2
2020-07-13,India,NA,Tripura,3673917,26,0,2093,2
2020-07-14,India,NA,Tripura,3673917,90,0,2183,2
2020-07-15,India,NA,Tripura,3673917,98,1,2281,3
2020-07-16,India,NA,Tripura,3673917,98,0,2379,3
2020-07-17,India,NA,Tripura,3673917,118,0,2497,3
2020-07-18,India,NA,Tripura,3673917,171,2,2668,5
2020-07-19,India,NA,Tripura,3673917,223,0,2891,5
2020-07-20,India,NA,Tripura,3673917,202,2,3093,7
2020-07-21,India,NA,Tripura,3673917,252,1,3345,8
2020-07-22,India,NA,Tripura,3673917,126,1,3471,9
2020-07-23,India,NA,Tripura,3673917,206,1,3677,10
2020-07-24,India,NA,Tripura,3673917,100,1,3777,11
2020-07-25,India,NA,Tripura,3673917,105,0,3882,11
2020-07-26,India,NA,Tripura,3673917,37,2,3919,13
2020-07-27,India,NA,Tripura,3673917,147,4,4066,17
2020-07-28,India,NA,Tripura,3673917,221,4,4287,21
2020-07-29,India,NA,Tripura,3673917,216,0,4503,21
2020-07-30,India,NA,Tripura,3673917,219,0,4722,21
2020-07-31,India,NA,Tripura,3673917,274,0,4996,21
2020-08-01,India,NA,Tripura,3673917,252,2,5248,23
2020-08-02,India,NA,Tripura,3673917,141,4,5389,27
2020-08-03,India,NA,Tripura,3673917,0,0,5389,27
2020-08-04,India,NA,Tripura,3673917,131,1,5520,28
2020-08-05,India,NA,Tripura,3673917,122,2,5642,30
2020-08-06,India,NA,Tripura,3673917,98,1,5740,31
2020-08-07,India,NA,Tripura,3673917,128,5,5868,36
2020-08-08,India,NA,Tripura,3673917,146,1,6014,37
2020-08-09,India,NA,Tripura,3673917,147,4,6161,41
2020-08-10,India,NA,Tripura,3673917,62,1,6223,42
2020-08-11,India,NA,Tripura,3673917,164,1,6387,43
2020-08-12,India,NA,Tripura,3673917,110,0,6497,43
2020-08-13,India,NA,Tripura,3673917,121,1,6618,44
2020-08-14,India,NA,Tripura,3673917,164,2,6782,46
2020-08-15,India,NA,Tripura,3673917,167,4,6949,50
2020-08-16,India,NA,Tripura,3673917,127,5,7076,55
2020-08-17,India,NA,Tripura,3673917,143,4,7219,59
2020-08-18,India,NA,Tripura,3673917,205,3,7424,62
2020-08-19,India,NA,Tripura,3673917,236,3,7660,65
2020-08-20,India,NA,Tripura,3673917,190,0,7850,65
2020-08-21,India,NA,Tripura,3673917,256,4,8106,69
2020-08-22,India,NA,Tripura,3673917,280,1,8386,70
2020-08-23,India,NA,Tripura,3673917,331,2,8717,72
2020-08-24,India,NA,Tripura,3673917,200,1,8917,73
2020-08-25,India,NA,Tripura,3673917,293,6,9210,79
2020-08-26,India,NA,Tripura,3673917,329,4,9539,83
2020-08-27,India,NA,Tripura,3673917,385,2,9924,85
2020-08-28,India,NA,Tripura,3673917,509,4,10433,89
2020-08-29,India,NA,Tripura,3673917,443,5,10876,94
2020-08-30,India,NA,Tripura,3673917,447,4,11323,98
2020-08-31,India,NA,Tripura,3673917,321,5,11644,103
2020-09-01,India,NA,Tripura,3673917,509,10,12153,113
2020-09-02,India,NA,Tripura,3673917,566,5,12719,118
2020-09-03,India,NA,Tripura,3673917,590,8,13309,126
2020-09-04,India,NA,Tripura,3673917,524,3,13833,129
2020-09-05,India,NA,Tripura,3673917,691,7,14524,136
2020-09-06,India,NA,Tripura,3673917,603,8,15127,144
2020-09-07,India,NA,Tripura,3673917,399,5,15526,149
2020-09-08,India,NA,Tripura,3673917,628,3,16154,152
2020-09-09,India,NA,Tripura,3673917,582,9,16736,161
2020-09-10,India,NA,Tripura,3673917,535,6,17271,167
2020-09-11,India,NA,Tripura,3673917,559,5,17830,172
2020-09-12,India,NA,Tripura,3673917,470,10,18300,182
2020-09-13,India,NA,Tripura,3673917,629,12,18929,194
2020-09-14,India,NA,Tripura,3673917,255,6,19184,200
2020-09-15,India,NA,Tripura,3673917,531,7,19715,207
2020-09-16,India,NA,Tripura,3673917,454,10,20169,217
2020-09-17,India,NA,Tripura,3673917,527,5,20696,222
2020-09-18,India,NA,Tripura,3673917,273,6,20969,228
2020-09-19,India,NA,Tripura,3673917,535,7,21504,235
2020-09-20,India,NA,Tripura,3673917,525,4,22029,239
2020-09-21,India,NA,Tripura,3673917,243,6,22272,245
2020-09-22,India,NA,Tripura,3673917,559,3,22831,248
2020-09-23,India,NA,Tripura,3673917,504,2,23335,250
2020-03-13,India,NA,Uttar Pradesh,199581477,1,0,11,0
2020-03-14,India,NA,Uttar Pradesh,199581477,12,0,12,0
2020-03-15,India,NA,Uttar Pradesh,199581477,1,0,13,0
2020-03-16,India,NA,Uttar Pradesh,199581477,0,0,13,0
2020-03-17,India,NA,Uttar Pradesh,199581477,2,0,15,0
2020-03-18,India,NA,Uttar Pradesh,199581477,2,0,17,0
2020-03-19,India,NA,Uttar Pradesh,199581477,3,0,20,0
2020-03-20,India,NA,Uttar Pradesh,199581477,4,0,24,0
2020-03-21,India,NA,Uttar Pradesh,199581477,4,0,28,0
2020-03-22,India,NA,Uttar Pradesh,199581477,2,0,30,0
2020-03-23,India,NA,Uttar Pradesh,199581477,2,0,32,0
2020-03-24,India,NA,Uttar Pradesh,199581477,3,0,35,0
2020-03-25,India,NA,Uttar Pradesh,199581477,3,0,38,0
2020-03-26,India,NA,Uttar Pradesh,199581477,4,0,42,0
2020-03-27,India,NA,Uttar Pradesh,199581477,7,0,49,0
2020-03-28,India,NA,Uttar Pradesh,199581477,16,0,65,0
2020-03-29,India,NA,Uttar Pradesh,199581477,7,0,72,0
2020-03-30,India,NA,Uttar Pradesh,199581477,24,0,96,0
2020-03-31,India,NA,Uttar Pradesh,199581477,8,0,104,0
2020-04-01,India,NA,Uttar Pradesh,199581477,13,2,117,2
2020-04-02,India,NA,Uttar Pradesh,199581477,11,0,128,2
2020-04-03,India,NA,Uttar Pradesh,199581477,46,0,174,2
2020-04-04,India,NA,Uttar Pradesh,199581477,60,0,234,2
2020-04-05,India,NA,Uttar Pradesh,199581477,44,1,278,3
2020-04-06,India,NA,Uttar Pradesh,199581477,27,0,305,3
2020-04-07,India,NA,Uttar Pradesh,199581477,27,0,332,3
2020-04-08,India,NA,Uttar Pradesh,199581477,29,1,361,4
2020-04-09,India,NA,Uttar Pradesh,199581477,49,0,410,4
2020-04-10,India,NA,Uttar Pradesh,199581477,23,0,433,4
2020-04-11,India,NA,Uttar Pradesh,199581477,19,1,452,5
2020-04-12,India,NA,Uttar Pradesh,199581477,31,0,483,5
2020-04-13,India,NA,Uttar Pradesh,199581477,75,0,558,5
2020-04-14,India,NA,Uttar Pradesh,199581477,102,3,660,8
2020-04-15,India,NA,Uttar Pradesh,199581477,75,3,735,11
2020-04-16,India,NA,Uttar Pradesh,199581477,70,2,805,13
2020-04-17,India,NA,Uttar Pradesh,199581477,44,1,849,14
2020-04-18,India,NA,Uttar Pradesh,199581477,126,0,975,14
2020-04-19,India,NA,Uttar Pradesh,199581477,125,3,1100,17
2020-04-20,India,NA,Uttar Pradesh,199581477,84,1,1184,18
2020-04-21,India,NA,Uttar Pradesh,199581477,153,3,1337,21
2020-04-22,India,NA,Uttar Pradesh,199581477,112,0,1449,21
2020-04-23,India,NA,Uttar Pradesh,199581477,61,3,1510,24
2020-04-24,India,NA,Uttar Pradesh,199581477,111,1,1621,25
2020-04-25,India,NA,Uttar Pradesh,199581477,172,2,1793,27
2020-04-26,India,NA,Uttar Pradesh,199581477,80,3,1873,30
2020-04-27,India,NA,Uttar Pradesh,199581477,113,1,1986,31
2020-04-28,India,NA,Uttar Pradesh,199581477,67,3,2053,34
2020-04-29,India,NA,Uttar Pradesh,199581477,81,5,2134,39
2020-04-30,India,NA,Uttar Pradesh,199581477,77,1,2211,40
2020-05-01,India,NA,Uttar Pradesh,199581477,117,2,2328,42
2020-05-02,India,NA,Uttar Pradesh,199581477,159,1,2487,43
2020-05-03,India,NA,Uttar Pradesh,199581477,158,0,2645,43
2020-05-04,India,NA,Uttar Pradesh,199581477,121,7,2766,50
2020-05-05,India,NA,Uttar Pradesh,199581477,114,6,2880,56
2020-05-06,India,NA,Uttar Pradesh,199581477,118,4,2998,60
2020-05-07,India,NA,Uttar Pradesh,199581477,73,2,3071,62
2020-05-08,India,NA,Uttar Pradesh,199581477,143,4,3214,66
2020-05-09,India,NA,Uttar Pradesh,199581477,159,8,3373,74
2020-05-10,India,NA,Uttar Pradesh,199581477,94,5,3467,79
2020-05-11,India,NA,Uttar Pradesh,199581477,106,1,3573,80
2020-05-12,India,NA,Uttar Pradesh,199581477,91,2,3664,82
2020-05-13,India,NA,Uttar Pradesh,199581477,94,4,3758,86
2020-05-14,India,NA,Uttar Pradesh,199581477,144,2,3902,88
2020-05-15,India,NA,Uttar Pradesh,199581477,155,7,4057,95
2020-05-16,India,NA,Uttar Pradesh,199581477,201,9,4258,104
2020-05-17,India,NA,Uttar Pradesh,199581477,206,8,4464,112
2020-05-18,India,NA,Uttar Pradesh,199581477,141,6,4605,118
2020-05-19,India,NA,Uttar Pradesh,199581477,321,5,4926,123
2020-05-20,India,NA,Uttar Pradesh,199581477,249,4,5175,127
2020-05-21,India,NA,Uttar Pradesh,199581477,340,11,5515,138
2020-05-22,India,NA,Uttar Pradesh,199581477,220,14,5735,152
2020-05-23,India,NA,Uttar Pradesh,199581477,282,3,6017,155
2020-05-24,India,NA,Uttar Pradesh,199581477,251,6,6268,161
2020-05-25,India,NA,Uttar Pradesh,199581477,229,8,6497,169
2020-05-26,India,NA,Uttar Pradesh,199581477,227,8,6724,177
2020-05-27,India,NA,Uttar Pradesh,199581477,267,5,6991,182
2020-05-28,India,NA,Uttar Pradesh,199581477,179,15,7170,197
2020-05-29,India,NA,Uttar Pradesh,199581477,275,4,7445,201
2020-05-30,India,NA,Uttar Pradesh,199581477,256,12,7701,213
2020-05-31,India,NA,Uttar Pradesh,199581477,374,4,8075,217
2020-06-01,India,NA,Uttar Pradesh,199581477,286,5,8361,222
2020-06-02,India,NA,Uttar Pradesh,199581477,368,7,8729,229
2020-06-03,India,NA,Uttar Pradesh,199581477,141,1,8870,230
2020-06-04,India,NA,Uttar Pradesh,199581477,367,15,9237,245
2020-06-05,India,NA,Uttar Pradesh,199581477,496,12,9733,257
2020-06-06,India,NA,Uttar Pradesh,199581477,370,11,10103,268
2020-06-07,India,NA,Uttar Pradesh,199581477,433,7,10536,275
2020-06-08,India,NA,Uttar Pradesh,199581477,411,8,10947,283
2020-06-09,India,NA,Uttar Pradesh,199581477,388,18,11335,301
2020-06-10,India,NA,Uttar Pradesh,199581477,275,20,11610,321
2020-06-11,India,NA,Uttar Pradesh,199581477,478,24,12088,345
2020-06-12,India,NA,Uttar Pradesh,199581477,528,20,12616,365
2020-06-13,India,NA,Uttar Pradesh,199581477,502,20,13118,385
2020-06-14,India,NA,Uttar Pradesh,199581477,497,14,13615,399
2020-06-15,India,NA,Uttar Pradesh,199581477,476,18,14091,417
2020-06-16,India,NA,Uttar Pradesh,199581477,507,18,14598,435
2020-06-17,India,NA,Uttar Pradesh,199581477,583,30,15181,465
2020-06-18,India,NA,Uttar Pradesh,199581477,604,23,15785,488
2020-06-19,India,NA,Uttar Pradesh,199581477,809,19,16594,507
2020-06-20,India,NA,Uttar Pradesh,199581477,541,22,17135,529
2020-06-21,India,NA,Uttar Pradesh,199581477,596,21,17731,550
2020-06-22,India,NA,Uttar Pradesh,199581477,591,19,18322,569
2020-06-23,India,NA,Uttar Pradesh,199581477,571,19,18893,588
2020-06-24,India,NA,Uttar Pradesh,199581477,664,8,19557,596
2020-06-25,India,NA,Uttar Pradesh,199581477,636,15,20193,611
2020-06-26,India,NA,Uttar Pradesh,199581477,750,19,20943,630
2020-06-27,India,NA,Uttar Pradesh,199581477,606,19,21549,649
2020-06-28,India,NA,Uttar Pradesh,199581477,598,11,22147,660
2020-06-29,India,NA,Uttar Pradesh,199581477,681,12,22828,672
2020-06-30,India,NA,Uttar Pradesh,199581477,664,25,23492,697
2020-07-01,India,NA,Uttar Pradesh,199581477,564,21,24056,718
2020-07-02,India,NA,Uttar Pradesh,199581477,769,17,24825,735
2020-07-03,India,NA,Uttar Pradesh,199581477,972,14,25797,749
2020-07-04,India,NA,Uttar Pradesh,199581477,757,24,26554,773
2020-07-05,India,NA,Uttar Pradesh,199581477,1153,12,27707,785
2020-07-06,India,NA,Uttar Pradesh,199581477,929,24,28636,809
2020-07-07,India,NA,Uttar Pradesh,199581477,1332,18,29968,827
2020-07-08,India,NA,Uttar Pradesh,199581477,1188,18,31156,845
2020-07-09,India,NA,Uttar Pradesh,199581477,1206,17,32362,862
2020-07-10,India,NA,Uttar Pradesh,199581477,1338,27,33700,889
2020-07-11,India,NA,Uttar Pradesh,199581477,1392,24,35092,913
2020-07-12,India,NA,Uttar Pradesh,199581477,1384,21,36476,934
2020-07-13,India,NA,Uttar Pradesh,199581477,1654,21,38130,955
2020-07-14,India,NA,Uttar Pradesh,199581477,1594,28,39724,983
2020-07-15,India,NA,Uttar Pradesh,199581477,1659,29,41383,1012
2020-07-16,India,NA,Uttar Pradesh,199581477,2058,34,43441,1046
2020-07-17,India,NA,Uttar Pradesh,199581477,1722,38,45163,1084
2020-07-18,India,NA,Uttar Pradesh,199581477,1873,24,47036,1108
2020-07-19,India,NA,Uttar Pradesh,199581477,2211,38,49247,1146
2020-07-20,India,NA,Uttar Pradesh,199581477,1913,46,51160,1192
2020-07-21,India,NA,Uttar Pradesh,199581477,2128,37,53288,1229
2020-07-22,India,NA,Uttar Pradesh,199581477,2300,34,55588,1263
2020-07-23,India,NA,Uttar Pradesh,199581477,2516,35,58104,1298
2020-07-24,India,NA,Uttar Pradesh,199581477,2667,50,60771,1348
2020-07-25,India,NA,Uttar Pradesh,199581477,2971,39,63742,1387
2020-07-26,India,NA,Uttar Pradesh,199581477,3246,39,66988,1426
2020-07-27,India,NA,Uttar Pradesh,199581477,3505,30,70493,1456
2020-07-28,India,NA,Uttar Pradesh,199581477,3458,41,73951,1497
2020-07-29,India,NA,Uttar Pradesh,199581477,3383,33,77334,1530
2020-07-30,India,NA,Uttar Pradesh,199581477,3705,57,81039,1587
2020-07-31,India,NA,Uttar Pradesh,199581477,4422,43,85461,1630
2020-08-01,India,NA,Uttar Pradesh,199581477,3587,47,89048,1677
2020-08-02,India,NA,Uttar Pradesh,199581477,3873,53,92921,1730
2020-08-03,India,NA,Uttar Pradesh,199581477,4441,48,97362,1778
2020-08-04,India,NA,Uttar Pradesh,199581477,2948,39,100310,1817
2020-08-05,India,NA,Uttar Pradesh,199581477,4078,40,104388,1857
2020-08-06,India,NA,Uttar Pradesh,199581477,4586,61,108974,1918
2020-08-07,India,NA,Uttar Pradesh,199581477,4404,63,113378,1981
2020-08-08,India,NA,Uttar Pradesh,199581477,4660,47,118038,2028
2020-08-09,India,NA,Uttar Pradesh,199581477,4571,41,122609,2069
2020-08-10,India,NA,Uttar Pradesh,199581477,4113,51,126722,2120
2020-08-11,India,NA,Uttar Pradesh,199581477,5041,56,131763,2176
2020-08-12,India,NA,Uttar Pradesh,199581477,4475,54,136238,2230
2020-08-13,India,NA,Uttar Pradesh,199581477,4537,50,140775,2280
2020-08-14,India,NA,Uttar Pradesh,199581477,4512,55,145287,2335
2020-08-15,India,NA,Uttar Pradesh,199581477,4774,58,150061,2393
2020-08-16,India,NA,Uttar Pradesh,199581477,4357,56,154418,2449
2020-08-17,India,NA,Uttar Pradesh,199581477,3798,66,158216,2515
2020-08-18,India,NA,Uttar Pradesh,199581477,4218,70,162434,2585
2020-08-19,India,NA,Uttar Pradesh,199581477,5076,53,167510,2638
2020-08-20,India,NA,Uttar Pradesh,199581477,4824,95,172334,2733
2020-08-21,India,NA,Uttar Pradesh,199581477,4905,64,177239,2797
2020-08-22,India,NA,Uttar Pradesh,199581477,5217,70,182456,2867
2020-08-23,India,NA,Uttar Pradesh,199581477,5325,59,187781,2926
2020-08-24,India,NA,Uttar Pradesh,199581477,4601,61,192382,2987
2020-08-25,India,NA,Uttar Pradesh,199581477,5006,72,197388,3059
2020-08-26,India,NA,Uttar Pradesh,199581477,5640,82,203028,3141
2020-08-27,India,NA,Uttar Pradesh,199581477,5391,76,208419,3217
2020-08-28,India,NA,Uttar Pradesh,199581477,5405,77,213824,3294
2020-08-29,India,NA,Uttar Pradesh,199581477,5633,62,219457,3356
2020-08-30,India,NA,Uttar Pradesh,199581477,6175,67,225632,3423
2020-08-31,India,NA,Uttar Pradesh,199581477,4782,63,230414,3486
2020-09-01,India,NA,Uttar Pradesh,199581477,5343,56,235757,3542
2020-09-02,India,NA,Uttar Pradesh,199581477,5682,74,241439,3616
2020-09-03,India,NA,Uttar Pradesh,199581477,5662,75,247101,3691
2020-09-04,India,NA,Uttar Pradesh,199581477,6074,71,253175,3762
2020-09-05,India,NA,Uttar Pradesh,199581477,6590,81,259765,3843
2020-09-06,India,NA,Uttar Pradesh,199581477,6518,77,266283,3920
2020-09-07,India,NA,Uttar Pradesh,199581477,5568,56,271851,3976
2020-09-08,India,NA,Uttar Pradesh,199581477,6622,71,278473,4047
2020-09-09,India,NA,Uttar Pradesh,199581477,6568,65,285041,4112
2020-09-10,India,NA,Uttar Pradesh,199581477,6988,94,292029,4206
2020-09-11,India,NA,Uttar Pradesh,199581477,7016,76,299045,4282
2020-09-12,India,NA,Uttar Pradesh,199581477,6786,67,305831,4349
2020-09-13,India,NA,Uttar Pradesh,199581477,6205,80,312036,4429
2020-09-14,India,NA,Uttar Pradesh,199581477,5159,62,317195,4491
2020-09-15,India,NA,Uttar Pradesh,199581477,6841,113,324036,4604
2020-09-16,India,NA,Uttar Pradesh,199581477,6229,86,330265,4690
2020-09-17,India,NA,Uttar Pradesh,199581477,6029,81,336294,4771
2020-09-18,India,NA,Uttar Pradesh,199581477,6494,98,342788,4869
2020-09-19,India,NA,Uttar Pradesh,199581477,5729,84,348517,4953
2020-09-20,India,NA,Uttar Pradesh,199581477,5758,94,354275,5047
2020-09-21,India,NA,Uttar Pradesh,199581477,4618,88,358893,5135
2020-09-22,India,NA,Uttar Pradesh,199581477,5650,77,364543,5212
2020-09-23,India,NA,Uttar Pradesh,199581477,5143,87,369686,5299
2020-04-03,India,NA,Uttarakhand,10086292,6,0,16,0
2020-04-04,India,NA,Uttarakhand,10086292,6,0,22,0
2020-04-05,India,NA,Uttarakhand,10086292,4,0,26,0
2020-04-06,India,NA,Uttarakhand,10086292,5,0,31,0
2020-04-07,India,NA,Uttarakhand,10086292,0,0,31,0
2020-04-08,India,NA,Uttarakhand,10086292,4,0,35,0
2020-04-09,India,NA,Uttarakhand,10086292,0,0,35,0
2020-04-10,India,NA,Uttarakhand,10086292,0,0,35,0
2020-04-11,India,NA,Uttarakhand,10086292,0,0,35,0
2020-04-12,India,NA,Uttarakhand,10086292,0,0,35,0
2020-04-13,India,NA,Uttarakhand,10086292,0,0,35,0
2020-04-14,India,NA,Uttarakhand,10086292,2,0,37,0
2020-04-15,India,NA,Uttarakhand,10086292,0,0,37,0
2020-04-16,India,NA,Uttarakhand,10086292,0,0,37,0
2020-04-17,India,NA,Uttarakhand,10086292,3,0,40,0
2020-04-18,India,NA,Uttarakhand,10086292,2,0,42,0
2020-04-19,India,NA,Uttarakhand,10086292,2,0,44,0
2020-04-20,India,NA,Uttarakhand,10086292,2,0,46,0
2020-04-21,India,NA,Uttarakhand,10086292,0,0,46,0
2020-04-22,India,NA,Uttarakhand,10086292,0,0,46,0
2020-04-23,India,NA,Uttarakhand,10086292,1,0,47,0
2020-04-24,India,NA,Uttarakhand,10086292,1,0,48,0
2020-04-25,India,NA,Uttarakhand,10086292,0,0,48,0
2020-04-26,India,NA,Uttarakhand,10086292,3,0,51,0
2020-04-27,India,NA,Uttarakhand,10086292,0,0,51,0
2020-04-28,India,NA,Uttarakhand,10086292,3,0,54,0
2020-04-29,India,NA,Uttarakhand,10086292,1,0,55,0
2020-04-30,India,NA,Uttarakhand,10086292,2,0,57,0
2020-05-01,India,NA,Uttarakhand,10086292,0,1,57,1
2020-05-02,India,NA,Uttarakhand,10086292,2,0,59,1
2020-05-03,India,NA,Uttarakhand,10086292,1,0,60,1
2020-05-04,India,NA,Uttarakhand,10086292,0,0,60,1
2020-05-05,India,NA,Uttarakhand,10086292,1,0,61,1
2020-05-06,India,NA,Uttarakhand,10086292,0,0,61,1
2020-05-07,India,NA,Uttarakhand,10086292,0,0,61,1
2020-05-08,India,NA,Uttarakhand,10086292,2,0,63,1
2020-05-09,India,NA,Uttarakhand,10086292,4,0,67,1
2020-05-10,India,NA,Uttarakhand,10086292,1,0,68,1
2020-05-11,India,NA,Uttarakhand,10086292,0,0,68,1
2020-05-12,India,NA,Uttarakhand,10086292,1,0,69,1
2020-05-13,India,NA,Uttarakhand,10086292,3,0,72,1
2020-05-14,India,NA,Uttarakhand,10086292,6,0,78,1
2020-05-15,India,NA,Uttarakhand,10086292,4,0,82,1
2020-05-16,India,NA,Uttarakhand,10086292,9,0,91,1
2020-05-17,India,NA,Uttarakhand,10086292,1,0,92,1
2020-05-18,India,NA,Uttarakhand,10086292,4,0,96,1
2020-05-19,India,NA,Uttarakhand,10086292,15,0,111,1
2020-05-20,India,NA,Uttarakhand,10086292,15,0,126,1
2020-05-21,India,NA,Uttarakhand,10086292,19,0,145,1
2020-05-22,India,NA,Uttarakhand,10086292,8,0,153,1
2020-05-23,India,NA,Uttarakhand,10086292,91,0,244,1
2020-05-24,India,NA,Uttarakhand,10086292,73,2,317,3
2020-05-25,India,NA,Uttarakhand,10086292,32,1,349,4
2020-05-26,India,NA,Uttarakhand,10086292,51,0,400,4
2020-05-27,India,NA,Uttarakhand,10086292,69,0,469,4
2020-05-28,India,NA,Uttarakhand,10086292,31,0,500,4
2020-05-29,India,NA,Uttarakhand,10086292,216,0,716,4
2020-05-30,India,NA,Uttarakhand,10086292,33,1,749,5
2020-05-31,India,NA,Uttarakhand,10086292,158,0,907,5
2020-06-01,India,NA,Uttarakhand,10086292,52,0,959,5
2020-06-02,India,NA,Uttarakhand,10086292,84,2,1043,7
2020-06-03,India,NA,Uttarakhand,10086292,42,1,1085,8
2020-06-04,India,NA,Uttarakhand,10086292,68,2,1153,10
2020-06-05,India,NA,Uttarakhand,10086292,62,1,1215,11
2020-06-06,India,NA,Uttarakhand,10086292,88,0,1303,11
2020-06-07,India,NA,Uttarakhand,10086292,52,2,1355,13
2020-06-08,India,NA,Uttarakhand,10086292,56,0,1411,13
2020-06-09,India,NA,Uttarakhand,10086292,126,0,1537,13
2020-06-10,India,NA,Uttarakhand,10086292,25,2,1562,15
2020-06-11,India,NA,Uttarakhand,10086292,93,1,1655,16
2020-06-12,India,NA,Uttarakhand,10086292,69,5,1724,21
2020-06-13,India,NA,Uttarakhand,10086292,61,2,1785,23
2020-06-14,India,NA,Uttarakhand,10086292,34,1,1819,24
2020-06-15,India,NA,Uttarakhand,10086292,26,0,1845,24
2020-06-16,India,NA,Uttarakhand,10086292,97,1,1942,25
2020-06-17,India,NA,Uttarakhand,10086292,81,1,2023,26
2020-06-18,India,NA,Uttarakhand,10086292,80,0,2103,26
2020-06-19,India,NA,Uttarakhand,10086292,74,0,2177,26
2020-06-20,India,NA,Uttarakhand,10086292,124,1,2301,27
2020-06-21,India,NA,Uttarakhand,10086292,43,0,2344,27
2020-06-22,India,NA,Uttarakhand,10086292,58,1,2402,28
2020-06-23,India,NA,Uttarakhand,10086292,133,2,2535,30
2020-06-24,India,NA,Uttarakhand,10086292,88,5,2623,35
2020-06-25,India,NA,Uttarakhand,10086292,68,1,2691,36
2020-06-26,India,NA,Uttarakhand,10086292,34,1,2725,37
2020-06-27,India,NA,Uttarakhand,10086292,66,0,2791,37
2020-06-28,India,NA,Uttarakhand,10086292,32,1,2823,38
2020-06-29,India,NA,Uttarakhand,10086292,8,1,2831,39
2020-06-30,India,NA,Uttarakhand,10086292,50,2,2881,41
2020-07-01,India,NA,Uttarakhand,10086292,66,0,2947,41
2020-07-02,India,NA,Uttarakhand,10086292,37,1,2984,42
2020-07-03,India,NA,Uttarakhand,10086292,64,0,3048,42
2020-07-04,India,NA,Uttarakhand,10086292,45,0,3093,42
2020-07-05,India,NA,Uttarakhand,10086292,31,0,3124,42
2020-07-06,India,NA,Uttarakhand,10086292,37,0,3161,42
2020-07-07,India,NA,Uttarakhand,10086292,69,1,3230,43
2020-07-08,India,NA,Uttarakhand,10086292,28,3,3258,46
2020-07-09,India,NA,Uttarakhand,10086292,47,0,3305,46
2020-07-10,India,NA,Uttarakhand,10086292,68,0,3373,46
2020-07-11,India,NA,Uttarakhand,10086292,44,0,3417,46
2020-07-12,India,NA,Uttarakhand,10086292,120,1,3537,47
2020-07-13,India,NA,Uttarakhand,10086292,71,2,3608,49
2020-07-14,India,NA,Uttarakhand,10086292,78,1,3686,50
2020-07-15,India,NA,Uttarakhand,10086292,99,0,3785,50
2020-07-16,India,NA,Uttarakhand,10086292,197,0,3982,50
2020-07-17,India,NA,Uttarakhand,10086292,120,1,4102,51
2020-07-18,India,NA,Uttarakhand,10086292,174,1,4276,52
2020-07-19,India,NA,Uttarakhand,10086292,239,0,4515,52
2020-07-20,India,NA,Uttarakhand,10086292,127,3,4642,55
2020-07-21,India,NA,Uttarakhand,10086292,207,0,4849,55
2020-07-22,India,NA,Uttarakhand,10086292,451,2,5300,57
2020-07-23,India,NA,Uttarakhand,10086292,145,3,5445,60
2020-07-24,India,NA,Uttarakhand,10086292,272,2,5717,62
2020-07-25,India,NA,Uttarakhand,10086292,244,1,5961,63
2020-07-26,India,NA,Uttarakhand,10086292,143,0,6104,63
2020-07-27,India,NA,Uttarakhand,10086292,224,3,6328,66
2020-07-28,India,NA,Uttarakhand,10086292,259,4,6587,70
2020-07-29,India,NA,Uttarakhand,10086292,279,2,6866,72
2020-07-30,India,NA,Uttarakhand,10086292,199,4,7065,76
2020-07-31,India,NA,Uttarakhand,10086292,118,4,7183,80
2020-08-01,India,NA,Uttarakhand,10086292,264,3,7447,83
2020-08-02,India,NA,Uttarakhand,10086292,146,3,7593,86
2020-08-03,India,NA,Uttarakhand,10086292,207,4,7800,90
2020-08-04,India,NA,Uttarakhand,10086292,208,5,8008,95
2020-08-05,India,NA,Uttarakhand,10086292,246,3,8254,98
2020-08-06,India,NA,Uttarakhand,10086292,369,4,8623,102
2020-08-07,India,NA,Uttarakhand,10086292,278,10,8901,112
2020-08-08,India,NA,Uttarakhand,10086292,501,5,9402,117
2020-08-09,India,NA,Uttarakhand,10086292,230,8,9632,125
2020-08-10,India,NA,Uttarakhand,10086292,389,9,10021,134
2020-08-11,India,NA,Uttarakhand,10086292,411,2,10432,136
2020-08-12,India,NA,Uttarakhand,10086292,454,4,10886,140
2020-08-13,India,NA,Uttarakhand,10086292,416,3,11302,143
2020-08-14,India,NA,Uttarakhand,10086292,313,4,11615,147
2020-08-15,India,NA,Uttarakhand,10086292,325,4,11940,151
2020-08-16,India,NA,Uttarakhand,10086292,235,1,12175,152
2020-08-17,India,NA,Uttarakhand,10086292,318,6,12493,158
2020-08-18,India,NA,Uttarakhand,10086292,468,6,12961,164
2020-08-19,India,NA,Uttarakhand,10086292,264,14,13225,178
2020-08-20,India,NA,Uttarakhand,10086292,411,9,13636,187
2020-08-21,India,NA,Uttarakhand,10086292,447,5,14083,192
2020-08-22,India,NA,Uttarakhand,10086292,483,3,14566,195
2020-08-23,India,NA,Uttarakhand,10086292,558,5,15124,200
2020-08-24,India,NA,Uttarakhand,10086292,405,7,15529,207
2020-08-25,India,NA,Uttarakhand,10086292,485,6,16014,213
2020-08-26,India,NA,Uttarakhand,10086292,535,6,16549,219
2020-08-27,India,NA,Uttarakhand,10086292,728,9,17277,228
2020-08-28,India,NA,Uttarakhand,10086292,588,11,17865,239
2020-08-29,India,NA,Uttarakhand,10086292,706,11,18571,250
2020-08-30,India,NA,Uttarakhand,10086292,664,7,19235,257
2020-08-31,India,NA,Uttarakhand,10086292,592,12,19827,269
2020-09-01,India,NA,Uttarakhand,10086292,571,11,20398,280
2020-09-02,India,NA,Uttarakhand,10086292,836,11,21234,291
2020-09-03,India,NA,Uttarakhand,10086292,946,9,22180,300
2020-09-04,India,NA,Uttarakhand,10086292,831,12,23011,312
2020-09-05,India,NA,Uttarakhand,10086292,950,18,23961,330
2020-09-06,India,NA,Uttarakhand,10086292,668,11,24629,341
2020-09-07,India,NA,Uttarakhand,10086292,807,7,25436,348
2020-09-08,India,NA,Uttarakhand,10086292,658,12,26094,360
2020-09-09,India,NA,Uttarakhand,10086292,1117,12,27211,372
2020-09-10,India,NA,Uttarakhand,10086292,1015,5,28226,377
2020-09-11,India,NA,Uttarakhand,10086292,995,11,29221,388
2020-09-12,India,NA,Uttarakhand,10086292,1115,14,30336,402
2020-09-13,India,NA,Uttarakhand,10086292,1637,12,31973,414
2020-09-14,India,NA,Uttarakhand,10086292,1043,15,33016,429
2020-09-15,India,NA,Uttarakhand,10086292,1391,9,34407,438
2020-09-16,India,NA,Uttarakhand,10086292,1540,9,35947,447
2020-09-17,India,NA,Uttarakhand,10086292,1192,13,37139,460
2020-09-18,India,NA,Uttarakhand,10086292,868,4,38007,464
2020-09-19,India,NA,Uttarakhand,10086292,2078,14,40085,478
2020-09-20,India,NA,Uttarakhand,10086292,878,13,40963,491
2020-09-21,India,NA,Uttarakhand,10086292,814,10,41777,501
2020-09-22,India,NA,Uttarakhand,10086292,874,11,42651,512
2020-09-23,India,NA,Uttarakhand,10086292,1069,17,43720,529
2020-03-27,India,NA,West Bengal,91276115,5,0,15,1
2020-03-28,India,NA,West Bengal,91276115,3,0,18,1
2020-03-29,India,NA,West Bengal,91276115,3,0,21,1
2020-03-30,India,NA,West Bengal,91276115,1,1,22,2
2020-03-31,India,NA,West Bengal,91276115,15,1,37,3
2020-04-01,India,NA,West Bengal,91276115,0,0,37,3
2020-04-02,India,NA,West Bengal,91276115,16,0,53,3
2020-04-03,India,NA,West Bengal,91276115,0,0,53,3
2020-04-04,India,NA,West Bengal,91276115,0,0,53,3
2020-04-05,India,NA,West Bengal,91276115,27,0,80,3
2020-04-06,India,NA,West Bengal,91276115,0,0,80,3
2020-04-07,India,NA,West Bengal,91276115,11,0,91,3
2020-04-08,India,NA,West Bengal,91276115,8,2,99,5
2020-04-09,India,NA,West Bengal,91276115,4,0,103,5
2020-04-10,India,NA,West Bengal,91276115,13,0,116,5
2020-04-11,India,NA,West Bengal,91276115,10,0,126,5
2020-04-12,India,NA,West Bengal,91276115,8,2,134,7
2020-04-13,India,NA,West Bengal,91276115,18,0,152,7
2020-04-14,India,NA,West Bengal,91276115,38,0,190,7
2020-04-15,India,NA,West Bengal,91276115,23,0,213,7
2020-04-16,India,NA,West Bengal,91276115,18,3,231,10
2020-04-17,India,NA,West Bengal,91276115,24,0,255,10
2020-04-18,India,NA,West Bengal,91276115,32,2,287,12
2020-04-19,India,NA,West Bengal,91276115,23,0,310,12
2020-04-20,India,NA,West Bengal,91276115,29,0,339,12
2020-04-21,India,NA,West Bengal,91276115,53,3,392,15
2020-04-22,India,NA,West Bengal,91276115,31,0,423,15
2020-04-23,India,NA,West Bengal,91276115,33,0,456,15
2020-04-24,India,NA,West Bengal,91276115,58,3,514,18
2020-04-25,India,NA,West Bengal,91276115,57,0,571,18
2020-04-26,India,NA,West Bengal,91276115,40,2,611,20
2020-04-27,India,NA,West Bengal,91276115,38,0,649,20
2020-04-28,India,NA,West Bengal,91276115,48,2,697,22
2020-04-29,India,NA,West Bengal,91276115,28,0,725,22
2020-04-30,India,NA,West Bengal,91276115,33,11,758,33
2020-05-01,India,NA,West Bengal,91276115,37,8,795,41
2020-05-02,India,NA,West Bengal,91276115,127,7,922,48
2020-05-03,India,NA,West Bengal,91276115,276,74,1198,122
2020-05-04,India,NA,West Bengal,91276115,61,11,1259,133
2020-05-05,India,NA,West Bengal,91276115,85,7,1344,140
2020-05-06,India,NA,West Bengal,91276115,112,4,1456,144
2020-05-07,India,NA,West Bengal,91276115,92,7,1548,151
2020-05-08,India,NA,West Bengal,91276115,130,9,1678,160
2020-05-09,India,NA,West Bengal,91276115,108,11,1786,171
2020-05-10,India,NA,West Bengal,91276115,153,14,1939,185
2020-05-11,India,NA,West Bengal,91276115,124,5,2063,190
2020-05-12,India,NA,West Bengal,91276115,110,8,2173,198
2020-05-13,India,NA,West Bengal,91276115,117,9,2290,207
2020-05-14,India,NA,West Bengal,91276115,87,8,2377,215
2020-05-15,India,NA,West Bengal,91276115,84,10,2461,225
2020-05-16,India,NA,West Bengal,91276115,115,7,2576,232
2020-05-17,India,NA,West Bengal,91276115,101,6,2677,238
2020-05-18,India,NA,West Bengal,91276115,147,6,2824,244
2020-05-19,India,NA,West Bengal,91276115,137,6,2961,250
2020-05-20,India,NA,West Bengal,91276115,142,3,3103,253
2020-05-21,India,NA,West Bengal,91276115,94,6,3197,259
2020-05-22,India,NA,West Bengal,91276115,135,6,3332,265
2020-05-23,India,NA,West Bengal,91276115,127,4,3459,269
2020-05-24,India,NA,West Bengal,91276115,208,3,3667,272
2020-05-25,India,NA,West Bengal,91276115,149,6,3816,278
2020-05-26,India,NA,West Bengal,91276115,193,5,4009,283
2020-05-27,India,NA,West Bengal,91276115,183,6,4192,289
2020-05-28,India,NA,West Bengal,91276115,344,6,4536,295
2020-05-29,India,NA,West Bengal,91276115,277,7,4813,302
2020-05-30,India,NA,West Bengal,91276115,317,7,5130,309
2020-05-31,India,NA,West Bengal,91276115,371,8,5501,317
2020-06-01,India,NA,West Bengal,91276115,271,8,5772,325
2020-06-02,India,NA,West Bengal,91276115,396,10,6168,335
2020-06-03,India,NA,West Bengal,91276115,340,10,6508,345
2020-06-04,India,NA,West Bengal,91276115,368,10,6876,355
2020-06-05,India,NA,West Bengal,91276115,427,11,7303,366
2020-06-06,India,NA,West Bengal,91276115,435,17,7738,383
2020-06-07,India,NA,West Bengal,91276115,449,13,8187,396
2020-06-08,India,NA,West Bengal,91276115,426,9,8613,405
2020-06-09,India,NA,West Bengal,91276115,372,10,8985,415
2020-06-10,India,NA,West Bengal,91276115,343,17,9328,432
2020-06-11,India,NA,West Bengal,91276115,440,10,9768,442
2020-06-12,India,NA,West Bengal,91276115,476,9,10244,451
2020-06-13,India,NA,West Bengal,91276115,454,12,10698,463
2020-06-14,India,NA,West Bengal,91276115,389,12,11087,475
2020-06-15,India,NA,West Bengal,91276115,407,10,11494,485
2020-06-16,India,NA,West Bengal,91276115,415,10,11909,495
2020-06-17,India,NA,West Bengal,91276115,391,11,12300,506
2020-06-18,India,NA,West Bengal,91276115,435,12,12735,518
2020-06-19,India,NA,West Bengal,91276115,355,11,13090,529
2020-06-20,India,NA,West Bengal,91276115,441,11,13531,540
2020-06-21,India,NA,West Bengal,91276115,414,15,13945,555
2020-06-22,India,NA,West Bengal,91276115,413,14,14358,569
2020-06-23,India,NA,West Bengal,91276115,370,11,14728,580
2020-06-24,India,NA,West Bengal,91276115,445,11,15173,591
2020-06-25,India,NA,West Bengal,91276115,475,15,15648,606
2020-06-26,India,NA,West Bengal,91276115,542,10,16190,616
2020-06-27,India,NA,West Bengal,91276115,521,13,16711,629
2020-06-28,India,NA,West Bengal,91276115,572,10,17283,639
2020-06-29,India,NA,West Bengal,91276115,624,14,17907,653
2020-06-30,India,NA,West Bengal,91276115,652,15,18559,668
2020-07-01,India,NA,West Bengal,91276115,611,15,19170,683
2020-07-02,India,NA,West Bengal,91276115,649,16,19819,699
2020-07-03,India,NA,West Bengal,91276115,669,18,20488,717
2020-07-04,India,NA,West Bengal,91276115,743,19,21231,736
2020-07-05,India,NA,West Bengal,91276115,895,21,22126,757
2020-07-06,India,NA,West Bengal,91276115,861,22,22987,779
2020-07-07,India,NA,West Bengal,91276115,850,25,23837,804
2020-07-08,India,NA,West Bengal,91276115,986,23,24823,827
2020-07-09,India,NA,West Bengal,91276115,1088,27,25911,854
2020-07-10,India,NA,West Bengal,91276115,1198,26,27109,880
2020-07-11,India,NA,West Bengal,91276115,1344,26,28453,906
2020-07-12,India,NA,West Bengal,91276115,1560,26,30013,932
2020-07-13,India,NA,West Bengal,91276115,1435,24,31448,956
2020-07-14,India,NA,West Bengal,91276115,1390,24,32838,980
2020-07-15,India,NA,West Bengal,91276115,1589,20,34427,1000
2020-07-16,India,NA,West Bengal,91276115,1690,23,36117,1023
2020-07-17,India,NA,West Bengal,91276115,1894,26,38011,1049
2020-07-18,India,NA,West Bengal,91276115,2198,27,40209,1076
2020-07-19,India,NA,West Bengal,91276115,2278,36,42487,1112
2020-07-20,India,NA,West Bengal,91276115,2282,35,44769,1147
2020-07-21,India,NA,West Bengal,91276115,2261,35,47030,1182
2020-07-22,India,NA,West Bengal,91276115,2291,39,49321,1221
2020-07-23,India,NA,West Bengal,91276115,2436,34,51757,1255
2020-07-24,India,NA,West Bengal,91276115,2216,35,53973,1290
2020-07-25,India,NA,West Bengal,91276115,2404,42,56377,1332
2020-07-26,India,NA,West Bengal,91276115,2341,40,58718,1372
2020-07-27,India,NA,West Bengal,91276115,2112,39,60830,1411
2020-07-28,India,NA,West Bengal,91276115,2134,38,62964,1449
2020-07-29,India,NA,West Bengal,91276115,2294,41,65258,1490
2020-07-30,India,NA,West Bengal,91276115,2434,46,67692,1536
2020-07-31,India,NA,West Bengal,91276115,2496,45,70188,1581
2020-08-01,India,NA,West Bengal,91276115,2589,48,72777,1629
2020-08-02,India,NA,West Bengal,91276115,2739,49,75516,1678
2020-08-03,India,NA,West Bengal,91276115,2716,53,78232,1731
2020-08-04,India,NA,West Bengal,91276115,2752,54,80984,1785
2020-08-05,India,NA,West Bengal,91276115,2816,61,83800,1846
2020-08-06,India,NA,West Bengal,91276115,2954,56,86754,1902
2020-08-07,India,NA,West Bengal,91276115,2912,52,89666,1954
2020-08-08,India,NA,West Bengal,91276115,2949,51,92615,2005
2020-08-09,India,NA,West Bengal,91276115,2939,54,95554,2059
2020-08-10,India,NA,West Bengal,91276115,2905,41,98459,2100
2020-08-11,India,NA,West Bengal,91276115,2931,49,101390,2149
2020-08-12,India,NA,West Bengal,91276115,2936,54,104326,2203
2020-08-13,India,NA,West Bengal,91276115,2997,56,107323,2259
2020-08-14,India,NA,West Bengal,91276115,3035,60,110358,2319
2020-08-15,India,NA,West Bengal,91276115,3074,58,113432,2377
2020-08-16,India,NA,West Bengal,91276115,3066,51,116498,2428
2020-08-17,India,NA,West Bengal,91276115,3080,45,119578,2473
2020-08-18,India,NA,West Bengal,91276115,3175,55,122753,2528
2020-08-19,India,NA,West Bengal,91276115,3169,53,125922,2581
2020-08-20,India,NA,West Bengal,91276115,3197,53,129119,2634
2020-08-21,India,NA,West Bengal,91276115,3245,55,132364,2689
2020-08-22,India,NA,West Bengal,91276115,3232,48,135596,2737
2020-08-23,India,NA,West Bengal,91276115,3274,57,138870,2794
2020-08-24,India,NA,West Bengal,91276115,2967,57,141837,2851
2020-08-25,India,NA,West Bengal,91276115,2964,58,144801,2909
2020-08-26,India,NA,West Bengal,91276115,2974,55,147775,2964
2020-08-27,India,NA,West Bengal,91276115,2997,53,150772,3017
2020-08-28,India,NA,West Bengal,91276115,2982,56,153754,3073
2020-08-29,India,NA,West Bengal,91276115,3012,53,156766,3126
2020-08-30,India,NA,West Bengal,91276115,3019,50,159785,3176
2020-08-31,India,NA,West Bengal,91276115,2993,52,162778,3228
2020-09-01,India,NA,West Bengal,91276115,2943,55,165721,3283
2020-09-02,India,NA,West Bengal,91276115,2976,56,168697,3339
2020-09-03,India,NA,West Bengal,91276115,2984,55,171681,3394
2020-09-04,India,NA,West Bengal,91276115,2978,58,174659,3452
2020-09-05,India,NA,West Bengal,91276115,3042,58,177701,3510
2020-09-06,India,NA,West Bengal,91276115,3087,52,180788,3562
2020-09-07,India,NA,West Bengal,91276115,3077,58,183865,3620
2020-09-08,India,NA,West Bengal,91276115,3091,57,186956,3677
2020-09-09,India,NA,West Bengal,91276115,3107,53,190063,3730
2020-09-10,India,NA,West Bengal,91276115,3112,41,193175,3771
2020-09-11,India,NA,West Bengal,91276115,3157,57,196332,3828
2020-09-12,India,NA,West Bengal,91276115,3161,59,199493,3887
2020-09-13,India,NA,West Bengal,91276115,3215,58,202708,3945
2020-09-14,India,NA,West Bengal,91276115,3211,58,205919,4003
2020-09-15,India,NA,West Bengal,91276115,3227,59,209146,4062
2020-09-16,India,NA,West Bengal,91276115,3237,61,212383,4123
2020-09-17,India,NA,West Bengal,91276115,3197,60,215580,4183
2020-09-18,India,NA,West Bengal,91276115,3192,59,218772,4242
2020-09-19,India,NA,West Bengal,91276115,3188,56,221960,4298
2020-09-20,India,NA,West Bengal,91276115,3177,61,225137,4359
2020-09-21,India,NA,West Bengal,91276115,3165,62,228302,4421
2020-09-22,India,NA,West Bengal,91276115,3182,62,231484,4483
2020-09-23,India,NA,West Bengal,91276115,3189,61,234673,4544
2020-03-07,Italy,NA,Abruzzo,1311580,2,0,11,0
2020-03-08,Italy,NA,Abruzzo,1311580,6,0,17,0
2020-03-09,Italy,NA,Abruzzo,1311580,13,0,30,0
2020-03-10,Italy,NA,Abruzzo,1311580,8,1,38,1
2020-03-11,Italy,NA,Abruzzo,1311580,0,0,38,1
2020-03-12,Italy,NA,Abruzzo,1311580,46,1,84,2
2020-03-13,Italy,NA,Abruzzo,1311580,5,0,89,2
2020-03-14,Italy,NA,Abruzzo,1311580,23,0,112,2
2020-03-15,Italy,NA,Abruzzo,1311580,25,1,137,3
2020-03-16,Italy,NA,Abruzzo,1311580,39,1,176,4
2020-03-17,Italy,NA,Abruzzo,1311580,53,2,229,6
2020-03-18,Italy,NA,Abruzzo,1311580,34,1,263,7
2020-03-19,Italy,NA,Abruzzo,1311580,122,4,385,11
2020-03-20,Italy,NA,Abruzzo,1311580,64,6,449,17
2020-03-21,Italy,NA,Abruzzo,1311580,80,5,529,22
2020-03-22,Italy,NA,Abruzzo,1311580,58,11,587,33
2020-03-23,Italy,NA,Abruzzo,1311580,76,5,663,38
2020-03-24,Italy,NA,Abruzzo,1311580,26,8,689,46
2020-03-25,Italy,NA,Abruzzo,1311580,124,6,813,52
2020-03-26,Italy,NA,Abruzzo,1311580,133,11,946,63
2020-03-27,Italy,NA,Abruzzo,1311580,71,5,1017,68
2020-03-28,Italy,NA,Abruzzo,1311580,116,8,1133,76
2020-03-29,Italy,NA,Abruzzo,1311580,160,12,1293,88
2020-03-30,Italy,NA,Abruzzo,1311580,52,14,1345,102
2020-03-31,Italy,NA,Abruzzo,1311580,56,13,1401,115
2020-04-01,Italy,NA,Abruzzo,1311580,35,8,1436,123
2020-04-02,Italy,NA,Abruzzo,1311580,61,10,1497,133
2020-04-03,Italy,NA,Abruzzo,1311580,66,13,1563,146
2020-04-04,Italy,NA,Abruzzo,1311580,65,7,1628,153
2020-04-05,Italy,NA,Abruzzo,1311580,75,5,1703,158
2020-04-06,Italy,NA,Abruzzo,1311580,18,11,1721,169
2020-04-07,Italy,NA,Abruzzo,1311580,78,3,1799,172
2020-04-08,Italy,NA,Abruzzo,1311580,60,7,1859,179
2020-04-09,Italy,NA,Abruzzo,1311580,72,15,1931,194
2020-04-10,Italy,NA,Abruzzo,1311580,83,4,2014,198
2020-04-11,Italy,NA,Abruzzo,1311580,106,8,2120,206
2020-04-12,Italy,NA,Abruzzo,1311580,40,6,2160,212
2020-04-13,Italy,NA,Abruzzo,1311580,53,12,2213,224
2020-04-14,Italy,NA,Abruzzo,1311580,32,8,2245,232
2020-04-15,Italy,NA,Abruzzo,1311580,29,8,2274,240
2020-04-16,Italy,NA,Abruzzo,1311580,72,3,2346,243
2020-04-17,Italy,NA,Abruzzo,1311580,97,3,2443,246
2020-04-18,Italy,NA,Abruzzo,1311580,44,7,2487,253
2020-04-19,Italy,NA,Abruzzo,1311580,34,5,2521,258
2020-04-20,Italy,NA,Abruzzo,1311580,91,5,2612,263
2020-04-21,Italy,NA,Abruzzo,1311580,55,8,2667,271
2020-04-22,Italy,NA,Abruzzo,1311580,66,5,2733,276
2020-04-23,Italy,NA,Abruzzo,1311580,52,4,2785,280
2020-04-24,Italy,NA,Abruzzo,1311580,18,6,2803,286
2020-04-25,Italy,NA,Abruzzo,1311580,29,7,2832,293
2020-04-26,Italy,NA,Abruzzo,1311580,27,2,2859,295
2020-04-27,Italy,NA,Abruzzo,1311580,15,4,2874,299
2020-04-28,Italy,NA,Abruzzo,1311580,25,11,2899,310
2020-04-29,Italy,NA,Abruzzo,1311580,24,5,2923,315
2020-04-30,Italy,NA,Abruzzo,1311580,7,5,2930,320
2020-05-01,Italy,NA,Abruzzo,1311580,18,4,2948,324
2020-05-02,Italy,NA,Abruzzo,1311580,16,3,2964,327
2020-05-03,Italy,NA,Abruzzo,1311580,32,3,2996,330
2020-05-04,Italy,NA,Abruzzo,1311580,4,2,3000,332
2020-05-05,Italy,NA,Abruzzo,1311580,25,3,3025,335
2020-05-06,Italy,NA,Abruzzo,1311580,22,6,3047,341
2020-05-07,Italy,NA,Abruzzo,1311580,25,7,3072,348
2020-05-08,Italy,NA,Abruzzo,1311580,6,3,3078,351
2020-05-09,Italy,NA,Abruzzo,1311580,8,4,3086,355
2020-05-10,Italy,NA,Abruzzo,1311580,17,4,3103,359
2020-05-11,Italy,NA,Abruzzo,1311580,4,7,3107,366
2020-05-12,Italy,NA,Abruzzo,1311580,8,4,3115,370
2020-05-13,Italy,NA,Abruzzo,1311580,12,5,3127,375
2020-05-14,Italy,NA,Abruzzo,1311580,9,4,3136,379
2020-05-15,Italy,NA,Abruzzo,1311580,12,2,3148,381
2020-05-16,Italy,NA,Abruzzo,1311580,30,2,3178,383
2020-05-17,Italy,NA,Abruzzo,1311580,8,2,3186,385
2020-05-18,Italy,NA,Abruzzo,1311580,7,3,3193,388
2020-05-19,Italy,NA,Abruzzo,1311580,4,1,3197,389
2020-05-20,Italy,NA,Abruzzo,1311580,8,0,3205,389
2020-05-21,Italy,NA,Abruzzo,1311580,7,2,3212,391
2020-05-22,Italy,NA,Abruzzo,1311580,8,3,3220,394
2020-05-23,Italy,NA,Abruzzo,1311580,1,0,3221,394
2020-05-24,Italy,NA,Abruzzo,1311580,5,4,3226,398
2020-05-25,Italy,NA,Abruzzo,1311580,1,2,3227,400
2020-05-26,Italy,NA,Abruzzo,1311580,3,0,3230,400
2020-05-27,Italy,NA,Abruzzo,1311580,5,0,3235,400
2020-05-28,Italy,NA,Abruzzo,1311580,2,2,3237,402
2020-05-29,Italy,NA,Abruzzo,1311580,0,2,3237,404
2020-05-30,Italy,NA,Abruzzo,1311580,0,0,3237,404
2020-05-31,Italy,NA,Abruzzo,1311580,7,1,3244,405
2020-06-01,Italy,NA,Abruzzo,1311580,1,3,3245,408
2020-06-02,Italy,NA,Abruzzo,1311580,4,5,3249,413
2020-06-03,Italy,NA,Abruzzo,1311580,3,1,3252,414
2020-06-04,Italy,NA,Abruzzo,1311580,3,1,3255,415
2020-06-05,Italy,NA,Abruzzo,1311580,2,0,3257,415
2020-06-06,Italy,NA,Abruzzo,1311580,1,3,3258,418
2020-06-07,Italy,NA,Abruzzo,1311580,7,0,3265,418
2020-06-08,Italy,NA,Abruzzo,1311580,0,0,3265,418
2020-06-09,Italy,NA,Abruzzo,1311580,1,33,3266,451
2020-06-10,Italy,NA,Abruzzo,1311580,0,2,3266,453
2020-06-11,Italy,NA,Abruzzo,1311580,1,0,3267,453
2020-06-12,Italy,NA,Abruzzo,1311580,4,0,3271,453
2020-06-13,Italy,NA,Abruzzo,1311580,4,1,3275,454
2020-06-14,Italy,NA,Abruzzo,1311580,4,2,3279,456
2020-06-15,Italy,NA,Abruzzo,1311580,0,0,3279,456
2020-06-16,Italy,NA,Abruzzo,1311580,1,1,3280,457
2020-06-17,Italy,NA,Abruzzo,1311580,2,0,3281,457
2020-06-18,Italy,NA,Abruzzo,1311580,2,1,3281,458
2020-06-19,Italy,NA,Abruzzo,1311580,1,1,3281,459
2020-06-20,Italy,NA,Abruzzo,1311580,1,0,3281,459
2020-06-21,Italy,NA,Abruzzo,1311580,0,0,3281,459
2020-06-22,Italy,NA,Abruzzo,1311580,1,1,3282,460
2020-06-23,Italy,NA,Abruzzo,1311580,0,0,3282,460
2020-06-24,Italy,NA,Abruzzo,1311580,1,1,3283,461
2020-06-25,Italy,NA,Abruzzo,1311580,1,0,3284,461
2020-06-26,Italy,NA,Abruzzo,1311580,1,0,3285,461
2020-06-27,Italy,NA,Abruzzo,1311580,0,0,3285,461
2020-06-28,Italy,NA,Abruzzo,1311580,1,1,3286,462
2020-06-29,Italy,NA,Abruzzo,1311580,1,0,3287,462
2020-06-30,Italy,NA,Abruzzo,1311580,0,2,3287,464
2020-07-01,Italy,NA,Abruzzo,1311580,2,0,3289,464
2020-07-02,Italy,NA,Abruzzo,1311580,3,0,3292,464
2020-07-03,Italy,NA,Abruzzo,1311580,6,0,3298,464
2020-07-04,Italy,NA,Abruzzo,1311580,7,0,3305,464
2020-07-05,Italy,NA,Abruzzo,1311580,4,0,3309,464
2020-07-06,Italy,NA,Abruzzo,1311580,0,0,3309,464
2020-07-07,Italy,NA,Abruzzo,1311580,0,0,3309,464
2020-07-08,Italy,NA,Abruzzo,1311580,1,0,3310,464
2020-07-09,Italy,NA,Abruzzo,1311580,8,0,3318,464
2020-07-10,Italy,NA,Abruzzo,1311580,3,0,3321,464
2020-07-11,Italy,NA,Abruzzo,1311580,2,0,3323,464
2020-07-12,Italy,NA,Abruzzo,1311580,5,1,3328,465
2020-07-13,Italy,NA,Abruzzo,1311580,0,1,3328,466
2020-07-14,Italy,NA,Abruzzo,1311580,0,1,3328,467
2020-07-15,Italy,NA,Abruzzo,1311580,3,0,3331,467
2020-07-16,Italy,NA,Abruzzo,1311580,2,1,3333,468
2020-07-17,Italy,NA,Abruzzo,1311580,1,0,3334,468
2020-07-18,Italy,NA,Abruzzo,1311580,1,0,3335,468
2020-07-19,Italy,NA,Abruzzo,1311580,1,0,3336,468
2020-07-20,Italy,NA,Abruzzo,1311580,6,0,3342,468
2020-07-21,Italy,NA,Abruzzo,1311580,2,2,3344,470
2020-07-22,Italy,NA,Abruzzo,1311580,0,0,3344,470
2020-07-23,Italy,NA,Abruzzo,1311580,10,0,3352,470
2020-07-24,Italy,NA,Abruzzo,1311580,4,0,3356,470
2020-07-25,Italy,NA,Abruzzo,1311580,3,0,3359,470
2020-07-26,Italy,NA,Abruzzo,1311580,1,0,3359,470
2020-07-27,Italy,NA,Abruzzo,1311580,9,1,3368,471
2020-07-28,Italy,NA,Abruzzo,1311580,1,1,3369,472
2020-07-29,Italy,NA,Abruzzo,1311580,4,0,3373,472
2020-07-30,Italy,NA,Abruzzo,1311580,4,0,3377,472
2020-07-31,Italy,NA,Abruzzo,1311580,5,0,3382,472
2020-08-01,Italy,NA,Abruzzo,1311580,5,0,3387,472
2020-08-02,Italy,NA,Abruzzo,1311580,2,0,3389,472
2020-08-03,Italy,NA,Abruzzo,1311580,9,0,3398,472
2020-08-04,Italy,NA,Abruzzo,1311580,3,0,3401,472
2020-08-05,Italy,NA,Abruzzo,1311580,19,0,3420,472
2020-08-06,Italy,NA,Abruzzo,1311580,15,0,3435,472
2020-08-07,Italy,NA,Abruzzo,1311580,39,0,3474,472
2020-08-08,Italy,NA,Abruzzo,1311580,12,0,3486,472
2020-08-09,Italy,NA,Abruzzo,1311580,16,0,3502,472
2020-08-10,Italy,NA,Abruzzo,1311580,7,0,3509,472
2020-08-11,Italy,NA,Abruzzo,1311580,3,0,3512,472
2020-08-12,Italy,NA,Abruzzo,1311580,9,0,3516,472
2020-08-13,Italy,NA,Abruzzo,1311580,16,0,3532,472
2020-08-14,Italy,NA,Abruzzo,1311580,13,0,3545,472
2020-08-15,Italy,NA,Abruzzo,1311580,13,0,3558,472
2020-08-16,Italy,NA,Abruzzo,1311580,2,0,3560,472
2020-08-17,Italy,NA,Abruzzo,1311580,5,0,3565,472
2020-08-18,Italy,NA,Abruzzo,1311580,5,0,3570,472
2020-08-19,Italy,NA,Abruzzo,1311580,7,0,3577,472
2020-08-20,Italy,NA,Abruzzo,1311580,4,0,3581,472
2020-08-21,Italy,NA,Abruzzo,1311580,23,0,3604,472
2020-08-22,Italy,NA,Abruzzo,1311580,24,0,3628,472
2020-08-23,Italy,NA,Abruzzo,1311580,21,0,3648,472
2020-08-24,Italy,NA,Abruzzo,1311580,4,0,3652,472
2020-08-25,Italy,NA,Abruzzo,1311580,10,0,3662,472
2020-08-26,Italy,NA,Abruzzo,1311580,26,0,3687,472
2020-08-27,Italy,NA,Abruzzo,1311580,18,0,3705,472
2020-08-28,Italy,NA,Abruzzo,1311580,20,0,3725,472
2020-08-29,Italy,NA,Abruzzo,1311580,14,0,3739,472
2020-08-30,Italy,NA,Abruzzo,1311580,34,0,3773,472
2020-08-31,Italy,NA,Abruzzo,1311580,4,0,3777,472
2020-09-01,Italy,NA,Abruzzo,1311580,5,0,3780,472
2020-09-02,Italy,NA,Abruzzo,1311580,24,0,3804,472
2020-09-03,Italy,NA,Abruzzo,1311580,24,0,3828,472
2020-09-04,Italy,NA,Abruzzo,1311580,25,0,3853,472
2020-09-05,Italy,NA,Abruzzo,1311580,13,0,3865,472
2020-09-06,Italy,NA,Abruzzo,1311580,26,0,3891,472
2020-09-07,Italy,NA,Abruzzo,1311580,15,0,3906,472
2020-09-08,Italy,NA,Abruzzo,1311580,14,0,3919,472
2020-09-09,Italy,NA,Abruzzo,1311580,5,0,3921,472
2020-09-10,Italy,NA,Abruzzo,1311580,11,0,3932,472
2020-09-11,Italy,NA,Abruzzo,1311580,35,0,3967,472
2020-09-12,Italy,NA,Abruzzo,1311580,11,0,3978,472
2020-09-13,Italy,NA,Abruzzo,1311580,37,0,4015,472
2020-09-14,Italy,NA,Abruzzo,1311580,1,1,4016,473
2020-09-15,Italy,NA,Abruzzo,1311580,18,0,4034,473
2020-09-16,Italy,NA,Abruzzo,1311580,18,0,4052,473
2020-09-17,Italy,NA,Abruzzo,1311580,33,0,4083,473
2020-09-18,Italy,NA,Abruzzo,1311580,54,1,4137,474
2020-09-19,Italy,NA,Abruzzo,1311580,0,0,4137,474
2020-09-20,Italy,NA,Abruzzo,1311580,0,0,4137,474
2020-09-21,Italy,NA,Abruzzo,1311580,72,1,4209,475
2020-09-22,Italy,NA,Abruzzo,1311580,18,0,4227,475
2020-09-23,Italy,NA,Abruzzo,1311580,22,2,4249,477
2020-03-09,Italy,NA,Aosta Valley,125666,6,0,15,0
2020-03-10,Italy,NA,Aosta Valley,125666,2,0,17,0
2020-03-11,Italy,NA,Aosta Valley,125666,3,1,20,1
2020-03-12,Italy,NA,Aosta Valley,125666,7,0,27,1
2020-03-13,Italy,NA,Aosta Valley,125666,1,0,28,1
2020-03-14,Italy,NA,Aosta Valley,125666,14,0,42,1
2020-03-15,Italy,NA,Aosta Valley,125666,15,0,57,1
2020-03-16,Italy,NA,Aosta Valley,125666,48,1,105,2
2020-03-17,Italy,NA,Aosta Valley,125666,31,0,136,2
2020-03-18,Italy,NA,Aosta Valley,125666,29,1,165,3
2020-03-19,Italy,NA,Aosta Valley,125666,50,3,215,6
2020-03-20,Italy,NA,Aosta Valley,125666,49,1,264,7
2020-03-21,Italy,NA,Aosta Valley,125666,49,1,313,8
2020-03-22,Italy,NA,Aosta Valley,125666,51,1,364,9
2020-03-23,Italy,NA,Aosta Valley,125666,29,3,393,12
2020-03-24,Italy,NA,Aosta Valley,125666,7,7,400,19
2020-03-25,Italy,NA,Aosta Valley,125666,1,5,401,24
2020-03-26,Italy,NA,Aosta Valley,125666,7,4,408,28
2020-03-27,Italy,NA,Aosta Valley,125666,44,9,452,37
2020-03-28,Italy,NA,Aosta Valley,125666,59,4,511,41
2020-03-29,Italy,NA,Aosta Valley,125666,73,2,584,43
2020-03-30,Italy,NA,Aosta Valley,125666,0,7,584,50
2020-03-31,Italy,NA,Aosta Valley,125666,44,6,628,56
2020-04-01,Italy,NA,Aosta Valley,125666,3,3,631,59
2020-04-02,Italy,NA,Aosta Valley,125666,37,4,668,63
2020-04-03,Italy,NA,Aosta Valley,125666,51,7,719,70
2020-04-04,Italy,NA,Aosta Valley,125666,29,12,748,82
2020-04-05,Italy,NA,Aosta Valley,125666,34,9,782,91
2020-04-06,Italy,NA,Aosta Valley,125666,23,5,805,96
2020-04-07,Italy,NA,Aosta Valley,125666,30,4,835,100
2020-04-08,Italy,NA,Aosta Valley,125666,15,2,850,102
2020-04-09,Italy,NA,Aosta Valley,125666,18,3,868,105
2020-04-10,Italy,NA,Aosta Valley,125666,11,2,879,107
2020-04-11,Italy,NA,Aosta Valley,125666,23,0,902,107
2020-04-12,Italy,NA,Aosta Valley,125666,19,5,921,112
2020-04-13,Italy,NA,Aosta Valley,125666,6,3,927,115
2020-04-14,Italy,NA,Aosta Valley,125666,20,3,947,118
2020-04-15,Italy,NA,Aosta Valley,125666,11,3,958,121
2020-04-16,Italy,NA,Aosta Valley,125666,13,1,971,122
2020-04-17,Italy,NA,Aosta Valley,125666,22,1,993,123
2020-04-18,Italy,NA,Aosta Valley,125666,80,1,1073,124
2020-04-19,Italy,NA,Aosta Valley,125666,15,1,1088,125
2020-04-20,Italy,NA,Aosta Valley,125666,0,2,1088,127
2020-04-21,Italy,NA,Aosta Valley,125666,5,0,1093,127
2020-04-22,Italy,NA,Aosta Valley,125666,2,1,1095,127
2020-04-23,Italy,NA,Aosta Valley,125666,1,0,1096,127
2020-04-24,Italy,NA,Aosta Valley,125666,4,2,1100,129
2020-04-25,Italy,NA,Aosta Valley,125666,0,1,1100,130
2020-04-26,Italy,NA,Aosta Valley,125666,6,1,1106,131
2020-04-27,Italy,NA,Aosta Valley,125666,5,2,1111,133
2020-04-28,Italy,NA,Aosta Valley,125666,8,2,1119,135
2020-04-29,Italy,NA,Aosta Valley,125666,5,2,1124,137
2020-04-30,Italy,NA,Aosta Valley,125666,4,0,1128,137
2020-05-01,Italy,NA,Aosta Valley,125666,5,0,1133,137
2020-05-02,Italy,NA,Aosta Valley,125666,3,0,1136,137
2020-05-03,Italy,NA,Aosta Valley,125666,6,1,1142,138
2020-05-04,Italy,NA,Aosta Valley,125666,1,1,1143,139
2020-05-05,Italy,NA,Aosta Valley,125666,0,0,1143,139
2020-05-06,Italy,NA,Aosta Valley,125666,3,0,1146,139
2020-05-07,Italy,NA,Aosta Valley,125666,4,0,1150,139
2020-05-08,Italy,NA,Aosta Valley,125666,1,0,1151,139
2020-05-09,Italy,NA,Aosta Valley,125666,1,0,1152,139
2020-05-10,Italy,NA,Aosta Valley,125666,5,0,1157,139
2020-05-11,Italy,NA,Aosta Valley,125666,1,0,1158,139
2020-05-12,Italy,NA,Aosta Valley,125666,2,1,1160,140
2020-05-13,Italy,NA,Aosta Valley,125666,3,1,1163,141
2020-05-14,Italy,NA,Aosta Valley,125666,3,0,1166,141
2020-05-15,Italy,NA,Aosta Valley,125666,6,1,1172,142
2020-05-16,Italy,NA,Aosta Valley,125666,1,0,1173,142
2020-05-17,Italy,NA,Aosta Valley,125666,0,1,1173,143
2020-05-18,Italy,NA,Aosta Valley,125666,1,0,1174,143
2020-05-19,Italy,NA,Aosta Valley,125666,1,0,1175,143
2020-05-20,Italy,NA,Aosta Valley,125666,0,0,1175,143
2020-05-21,Italy,NA,Aosta Valley,125666,1,0,1176,143
2020-05-22,Italy,NA,Aosta Valley,125666,1,0,1177,143
2020-05-23,Italy,NA,Aosta Valley,125666,0,0,1177,143
2020-05-24,Italy,NA,Aosta Valley,125666,1,0,1178,143
2020-05-25,Italy,NA,Aosta Valley,125666,1,0,1179,143
2020-05-26,Italy,NA,Aosta Valley,125666,2,0,1181,143
2020-05-27,Italy,NA,Aosta Valley,125666,0,0,1181,143
2020-05-28,Italy,NA,Aosta Valley,125666,1,0,1182,143
2020-05-29,Italy,NA,Aosta Valley,125666,0,0,1182,143
2020-05-30,Italy,NA,Aosta Valley,125666,1,0,1183,143
2020-05-31,Italy,NA,Aosta Valley,125666,1,0,1184,143
2020-06-01,Italy,NA,Aosta Valley,125666,3,0,1187,143
2020-06-02,Italy,NA,Aosta Valley,125666,0,0,1187,143
2020-06-03,Italy,NA,Aosta Valley,125666,0,0,1187,143
2020-06-04,Italy,NA,Aosta Valley,125666,0,0,1187,143
2020-06-05,Italy,NA,Aosta Valley,125666,0,0,1187,143
2020-06-06,Italy,NA,Aosta Valley,125666,2,1,1189,144
2020-06-07,Italy,NA,Aosta Valley,125666,2,0,1191,144
2020-06-08,Italy,NA,Aosta Valley,125666,0,0,1191,144
2020-06-09,Italy,NA,Aosta Valley,125666,0,0,1191,144
2020-06-10,Italy,NA,Aosta Valley,125666,0,0,1191,144
2020-06-11,Italy,NA,Aosta Valley,125666,0,0,1191,144
2020-06-12,Italy,NA,Aosta Valley,125666,0,0,1191,144
2020-06-13,Italy,NA,Aosta Valley,125666,0,0,1191,144
2020-06-14,Italy,NA,Aosta Valley,125666,0,0,1191,144
2020-06-15,Italy,NA,Aosta Valley,125666,0,0,1191,144
2020-06-16,Italy,NA,Aosta Valley,125666,0,0,1191,144
2020-06-17,Italy,NA,Aosta Valley,125666,0,0,1191,144
2020-06-18,Italy,NA,Aosta Valley,125666,0,1,1191,145
2020-06-19,Italy,NA,Aosta Valley,125666,0,1,1191,146
2020-06-20,Italy,NA,Aosta Valley,125666,2,0,1193,146
2020-06-21,Italy,NA,Aosta Valley,125666,0,0,1193,146
2020-06-22,Italy,NA,Aosta Valley,125666,0,0,1193,146
2020-06-23,Italy,NA,Aosta Valley,125666,0,0,1193,146
2020-06-24,Italy,NA,Aosta Valley,125666,1,0,1194,146
2020-06-25,Italy,NA,Aosta Valley,125666,0,0,1194,146
2020-06-26,Italy,NA,Aosta Valley,125666,0,0,1194,146
2020-06-27,Italy,NA,Aosta Valley,125666,0,0,1194,146
2020-06-28,Italy,NA,Aosta Valley,125666,0,0,1194,146
2020-06-29,Italy,NA,Aosta Valley,125666,0,0,1194,146
2020-06-30,Italy,NA,Aosta Valley,125666,1,0,1195,146
2020-07-01,Italy,NA,Aosta Valley,125666,0,0,1195,146
2020-07-02,Italy,NA,Aosta Valley,125666,0,0,1195,146
2020-07-03,Italy,NA,Aosta Valley,125666,1,0,1196,146
2020-07-04,Italy,NA,Aosta Valley,125666,0,0,1196,146
2020-07-05,Italy,NA,Aosta Valley,125666,0,0,1196,146
2020-07-06,Italy,NA,Aosta Valley,125666,0,0,1196,146
2020-07-07,Italy,NA,Aosta Valley,125666,0,0,1196,146
2020-07-08,Italy,NA,Aosta Valley,125666,0,0,1196,146
2020-07-09,Italy,NA,Aosta Valley,125666,0,0,1196,146
2020-07-10,Italy,NA,Aosta Valley,125666,0,0,1196,146
2020-07-11,Italy,NA,Aosta Valley,125666,0,0,1196,146
2020-07-12,Italy,NA,Aosta Valley,125666,0,0,1196,146
2020-07-13,Italy,NA,Aosta Valley,125666,0,0,1196,146
2020-07-14,Italy,NA,Aosta Valley,125666,0,0,1196,146
2020-07-15,Italy,NA,Aosta Valley,125666,0,0,1196,146
2020-07-16,Italy,NA,Aosta Valley,125666,0,0,1196,146
2020-07-17,Italy,NA,Aosta Valley,125666,0,0,1196,146
2020-07-18,Italy,NA,Aosta Valley,125666,0,0,1196,146
2020-07-19,Italy,NA,Aosta Valley,125666,0,0,1196,146
2020-07-20,Italy,NA,Aosta Valley,125666,0,0,1196,146
2020-07-21,Italy,NA,Aosta Valley,125666,0,0,1196,146
2020-07-22,Italy,NA,Aosta Valley,125666,0,0,1196,146
2020-07-23,Italy,NA,Aosta Valley,125666,0,0,1196,146
2020-07-24,Italy,NA,Aosta Valley,125666,0,0,1196,146
2020-07-25,Italy,NA,Aosta Valley,125666,0,0,1196,146
2020-07-26,Italy,NA,Aosta Valley,125666,0,0,1196,146
2020-07-27,Italy,NA,Aosta Valley,125666,0,0,1196,146
2020-07-28,Italy,NA,Aosta Valley,125666,10,0,1206,146
2020-07-29,Italy,NA,Aosta Valley,125666,2,0,1208,146
2020-07-30,Italy,NA,Aosta Valley,125666,0,0,1208,146
2020-07-31,Italy,NA,Aosta Valley,125666,0,0,1208,146
2020-08-01,Italy,NA,Aosta Valley,125666,0,0,1208,146
2020-08-02,Italy,NA,Aosta Valley,125666,1,0,1209,146
2020-08-03,Italy,NA,Aosta Valley,125666,0,0,1209,146
2020-08-04,Italy,NA,Aosta Valley,125666,0,0,1209,146
2020-08-05,Italy,NA,Aosta Valley,125666,0,0,1209,146
2020-08-06,Italy,NA,Aosta Valley,125666,1,0,1210,146
2020-08-07,Italy,NA,Aosta Valley,125666,4,0,1214,146
2020-08-08,Italy,NA,Aosta Valley,125666,2,0,1216,146
2020-08-09,Italy,NA,Aosta Valley,125666,0,0,1216,146
2020-08-10,Italy,NA,Aosta Valley,125666,1,0,1217,146
2020-08-11,Italy,NA,Aosta Valley,125666,0,0,1217,146
2020-08-12,Italy,NA,Aosta Valley,125666,0,0,1217,146
2020-08-13,Italy,NA,Aosta Valley,125666,0,0,1217,146
2020-08-14,Italy,NA,Aosta Valley,125666,0,0,1217,146
2020-08-15,Italy,NA,Aosta Valley,125666,0,0,1217,146
2020-08-16,Italy,NA,Aosta Valley,125666,0,0,1217,146
2020-08-17,Italy,NA,Aosta Valley,125666,1,0,1218,146
2020-08-18,Italy,NA,Aosta Valley,125666,0,0,1218,146
2020-08-19,Italy,NA,Aosta Valley,125666,2,0,1220,146
2020-08-20,Italy,NA,Aosta Valley,125666,1,0,1221,146
2020-08-21,Italy,NA,Aosta Valley,125666,0,0,1221,146
2020-08-22,Italy,NA,Aosta Valley,125666,0,0,1221,146
2020-08-23,Italy,NA,Aosta Valley,125666,0,0,1221,146
2020-08-24,Italy,NA,Aosta Valley,125666,0,0,1221,146
2020-08-25,Italy,NA,Aosta Valley,125666,2,0,1223,146
2020-08-26,Italy,NA,Aosta Valley,125666,0,0,1223,146
2020-08-27,Italy,NA,Aosta Valley,125666,1,0,1224,146
2020-08-28,Italy,NA,Aosta Valley,125666,2,0,1226,146
2020-08-29,Italy,NA,Aosta Valley,125666,4,0,1230,146
2020-08-30,Italy,NA,Aosta Valley,125666,2,0,1232,146
2020-08-31,Italy,NA,Aosta Valley,125666,9,0,1241,146
2020-09-01,Italy,NA,Aosta Valley,125666,0,0,1241,146
2020-09-02,Italy,NA,Aosta Valley,125666,2,0,1243,146
2020-09-03,Italy,NA,Aosta Valley,125666,4,0,1247,146
2020-09-04,Italy,NA,Aosta Valley,125666,2,0,1249,146
2020-09-05,Italy,NA,Aosta Valley,125666,0,0,1249,146
2020-09-06,Italy,NA,Aosta Valley,125666,0,0,1249,146
2020-09-07,Italy,NA,Aosta Valley,125666,0,0,1249,146
2020-09-08,Italy,NA,Aosta Valley,125666,5,0,1254,146
2020-09-09,Italy,NA,Aosta Valley,125666,0,0,1254,146
2020-09-10,Italy,NA,Aosta Valley,125666,0,0,1254,146
2020-09-11,Italy,NA,Aosta Valley,125666,3,0,1257,146
2020-09-12,Italy,NA,Aosta Valley,125666,1,0,1258,146
2020-09-13,Italy,NA,Aosta Valley,125666,2,0,1260,146
2020-09-14,Italy,NA,Aosta Valley,125666,3,0,1263,146
2020-09-15,Italy,NA,Aosta Valley,125666,3,0,1266,146
2020-09-16,Italy,NA,Aosta Valley,125666,1,0,1267,146
2020-09-17,Italy,NA,Aosta Valley,125666,1,0,1268,146
2020-09-18,Italy,NA,Aosta Valley,125666,8,0,1276,146
2020-09-19,Italy,NA,Aosta Valley,125666,0,0,1276,146
2020-09-20,Italy,NA,Aosta Valley,125666,3,0,1279,146
2020-09-21,Italy,NA,Aosta Valley,125666,2,0,1281,146
2020-09-22,Italy,NA,Aosta Valley,125666,1,0,1282,146
2020-09-23,Italy,NA,Aosta Valley,125666,2,0,1284,146
2020-03-05,Italy,NA,Apulia,4029053,5,0,14,1
2020-03-06,Italy,NA,Apulia,4029053,3,0,17,1
2020-03-07,Italy,NA,Apulia,4029053,9,1,26,2
2020-03-08,Italy,NA,Apulia,4029053,14,1,40,3
2020-03-09,Italy,NA,Apulia,4029053,10,0,50,3
2020-03-10,Italy,NA,Apulia,4029053,9,0,59,3
2020-03-11,Italy,NA,Apulia,4029053,18,2,77,5
2020-03-12,Italy,NA,Apulia,4029053,27,0,104,5
2020-03-13,Italy,NA,Apulia,4029053,25,0,129,5
2020-03-14,Italy,NA,Apulia,4029053,37,3,166,8
2020-03-15,Italy,NA,Apulia,4029053,64,8,230,16
2020-03-16,Italy,NA,Apulia,4029053,0,0,230,16
2020-03-17,Italy,NA,Apulia,4029053,110,2,340,18
2020-03-18,Italy,NA,Apulia,4029053,43,1,383,19
2020-03-19,Italy,NA,Apulia,4029053,95,6,478,25
2020-03-20,Italy,NA,Apulia,4029053,103,1,581,26
2020-03-21,Italy,NA,Apulia,4029053,94,3,675,29
2020-03-22,Italy,NA,Apulia,4029053,111,2,786,31
2020-03-23,Italy,NA,Apulia,4029053,120,6,906,37
2020-03-24,Italy,NA,Apulia,4029053,99,7,1005,44
2020-03-25,Italy,NA,Apulia,4029053,88,4,1093,48
2020-03-26,Italy,NA,Apulia,4029053,89,17,1182,65
2020-03-27,Italy,NA,Apulia,4029053,152,4,1334,69
2020-03-28,Italy,NA,Apulia,4029053,124,2,1458,71
2020-03-29,Italy,NA,Apulia,4029053,91,15,1549,86
2020-03-30,Italy,NA,Apulia,4029053,163,5,1712,91
2020-03-31,Italy,NA,Apulia,4029053,91,19,1803,110
2020-04-01,Italy,NA,Apulia,4029053,143,19,1946,129
2020-04-02,Italy,NA,Apulia,4029053,131,15,2077,144
2020-04-03,Italy,NA,Apulia,4029053,105,20,2182,164
2020-04-04,Italy,NA,Apulia,4029053,58,9,2240,173
2020-04-05,Italy,NA,Apulia,4029053,77,9,2317,182
2020-04-06,Italy,NA,Apulia,4029053,127,13,2444,195
2020-04-07,Italy,NA,Apulia,4029053,70,14,2514,209
2020-04-08,Italy,NA,Apulia,4029053,120,10,2634,219
2020-04-09,Italy,NA,Apulia,4029053,82,6,2716,225
2020-04-10,Italy,NA,Apulia,4029053,93,13,2809,238
2020-04-11,Italy,NA,Apulia,4029053,95,15,2904,253
2020-04-12,Italy,NA,Apulia,4029053,85,7,2989,260
2020-04-13,Italy,NA,Apulia,4029053,76,7,3065,267
2020-04-14,Italy,NA,Apulia,4029053,53,11,3118,278
2020-04-15,Italy,NA,Apulia,4029053,66,10,3184,288
2020-04-16,Italy,NA,Apulia,4029053,74,11,3258,299
2020-04-17,Italy,NA,Apulia,4029053,69,8,3327,307
2020-04-18,Italy,NA,Apulia,4029053,82,7,3409,314
2020-04-19,Italy,NA,Apulia,4029053,120,2,3529,316
2020-04-20,Italy,NA,Apulia,4029053,38,10,3567,326
2020-04-21,Italy,NA,Apulia,4029053,55,25,3622,351
2020-04-22,Italy,NA,Apulia,4029053,108,11,3730,362
2020-04-23,Italy,NA,Apulia,4029053,109,10,3839,372
2020-04-24,Italy,NA,Apulia,4029053,42,11,3881,383
2020-04-25,Italy,NA,Apulia,4029053,31,8,3912,391
2020-04-26,Italy,NA,Apulia,4029053,36,8,3948,399
2020-04-27,Italy,NA,Apulia,4029053,10,6,3958,405
2020-04-28,Italy,NA,Apulia,4029053,22,2,3980,407
2020-04-29,Italy,NA,Apulia,4029053,49,3,4029,410
2020-04-30,Italy,NA,Apulia,4029053,43,5,4072,415
2020-05-01,Italy,NA,Apulia,4029053,27,6,4099,421
2020-05-02,Italy,NA,Apulia,4029053,34,1,4133,422
2020-05-03,Italy,NA,Apulia,4029053,11,2,4144,424
2020-05-04,Italy,NA,Apulia,4029053,9,5,4153,429
2020-05-05,Italy,NA,Apulia,4029053,17,4,4170,433
2020-05-06,Italy,NA,Apulia,4029053,26,5,4196,438
2020-05-07,Italy,NA,Apulia,4029053,49,3,4245,441
2020-05-08,Italy,NA,Apulia,4029053,11,2,4256,443
2020-05-09,Italy,NA,Apulia,4029053,30,0,4286,443
2020-05-10,Italy,NA,Apulia,4029053,27,5,4313,448
2020-05-11,Italy,NA,Apulia,4029053,14,3,4327,451
2020-05-12,Italy,NA,Apulia,4029053,10,5,4337,456
2020-05-13,Italy,NA,Apulia,4029053,11,4,4348,460
2020-05-14,Italy,NA,Apulia,4029053,9,1,4357,461
2020-05-15,Italy,NA,Apulia,4029053,9,0,4366,461
2020-05-16,Italy,NA,Apulia,4029053,8,2,4374,463
2020-05-17,Italy,NA,Apulia,4029053,5,7,4379,470
2020-05-18,Italy,NA,Apulia,4029053,7,1,4386,471
2020-05-19,Italy,NA,Apulia,4029053,10,2,4396,473
2020-05-20,Italy,NA,Apulia,4029053,11,5,4407,478
2020-05-21,Italy,NA,Apulia,4029053,6,0,4413,478
2020-05-22,Italy,NA,Apulia,4029053,27,4,4440,482
2020-05-23,Italy,NA,Apulia,4029053,8,4,4448,486
2020-05-24,Italy,NA,Apulia,4029053,10,1,4458,487
2020-05-25,Italy,NA,Apulia,4029053,9,4,4467,491
2020-05-26,Italy,NA,Apulia,4029053,2,3,4469,494
2020-05-27,Italy,NA,Apulia,4029053,10,1,4479,495
2020-05-28,Italy,NA,Apulia,4029053,2,1,4481,496
2020-05-29,Italy,NA,Apulia,4029053,1,4,4482,500
2020-05-30,Italy,NA,Apulia,4029053,8,0,4490,500
2020-05-31,Italy,NA,Apulia,4029053,4,4,4494,504
2020-06-01,Italy,NA,Apulia,4029053,4,2,4498,506
2020-06-02,Italy,NA,Apulia,4029053,0,2,4498,508
2020-06-03,Italy,NA,Apulia,4029053,1,3,4499,511
2020-06-04,Italy,NA,Apulia,4029053,4,3,4503,514
2020-06-05,Italy,NA,Apulia,4029053,4,7,4507,521
2020-06-06,Italy,NA,Apulia,4029053,4,1,4511,522
2020-06-07,Italy,NA,Apulia,4029053,0,3,4511,525
2020-06-08,Italy,NA,Apulia,4029053,1,0,4512,525
2020-06-09,Italy,NA,Apulia,4029053,0,1,4512,526
2020-06-10,Italy,NA,Apulia,4029053,0,3,4512,529
2020-06-11,Italy,NA,Apulia,4029053,1,1,4513,530
2020-06-12,Italy,NA,Apulia,4029053,2,2,4515,532
2020-06-13,Italy,NA,Apulia,4029053,0,0,4515,532
2020-06-14,Italy,NA,Apulia,4029053,0,0,4515,532
2020-06-15,Italy,NA,Apulia,4029053,1,2,4516,534
2020-06-16,Italy,NA,Apulia,4029053,0,1,4516,535
2020-06-17,Italy,NA,Apulia,4029053,0,1,4516,536
2020-06-18,Italy,NA,Apulia,4029053,3,2,4519,538
2020-06-19,Italy,NA,Apulia,4029053,1,0,4520,538
2020-06-20,Italy,NA,Apulia,4029053,5,2,4525,540
2020-06-21,Italy,NA,Apulia,4029053,2,0,4527,540
2020-06-22,Italy,NA,Apulia,4029053,0,0,4527,540
2020-06-23,Italy,NA,Apulia,4029053,2,2,4529,542
2020-06-24,Italy,NA,Apulia,4029053,0,1,4529,543
2020-06-25,Italy,NA,Apulia,4029053,1,0,4530,543
2020-06-26,Italy,NA,Apulia,4029053,1,0,4531,543
2020-06-27,Italy,NA,Apulia,4029053,0,0,4531,543
2020-06-28,Italy,NA,Apulia,4029053,0,0,4531,543
2020-06-29,Italy,NA,Apulia,4029053,0,0,4531,543
2020-06-30,Italy,NA,Apulia,4029053,0,2,4531,545
2020-07-01,Italy,NA,Apulia,4029053,0,0,4531,545
2020-07-02,Italy,NA,Apulia,4029053,0,0,4531,545
2020-07-03,Italy,NA,Apulia,4029053,3,0,4533,545
2020-07-04,Italy,NA,Apulia,4029053,3,0,4536,545
2020-07-05,Italy,NA,Apulia,4029053,0,0,4536,545
2020-07-06,Italy,NA,Apulia,4029053,0,0,4536,545
2020-07-07,Italy,NA,Apulia,4029053,0,1,4536,546
2020-07-08,Italy,NA,Apulia,4029053,1,0,4536,546
2020-07-09,Italy,NA,Apulia,4029053,0,0,4536,546
2020-07-10,Italy,NA,Apulia,4029053,4,0,4540,546
2020-07-11,Italy,NA,Apulia,4029053,1,0,4541,546
2020-07-12,Italy,NA,Apulia,4029053,0,0,4541,546
2020-07-13,Italy,NA,Apulia,4029053,0,1,4541,547
2020-07-14,Italy,NA,Apulia,4029053,0,0,4541,547
2020-07-15,Italy,NA,Apulia,4029053,0,0,4541,547
2020-07-16,Italy,NA,Apulia,4029053,1,1,4542,548
2020-07-17,Italy,NA,Apulia,4029053,5,0,4547,548
2020-07-18,Italy,NA,Apulia,4029053,3,0,4550,548
2020-07-19,Italy,NA,Apulia,4029053,7,0,4557,548
2020-07-20,Italy,NA,Apulia,4029053,0,0,4557,548
2020-07-21,Italy,NA,Apulia,4029053,0,0,4557,548
2020-07-22,Italy,NA,Apulia,4029053,0,0,4557,548
2020-07-23,Italy,NA,Apulia,4029053,9,0,4565,548
2020-07-24,Italy,NA,Apulia,4029053,13,1,4578,549
2020-07-25,Italy,NA,Apulia,4029053,8,0,4586,549
2020-07-26,Italy,NA,Apulia,4029053,3,1,4589,550
2020-07-27,Italy,NA,Apulia,4029053,3,1,4592,551
2020-07-28,Italy,NA,Apulia,4029053,4,0,4596,551
2020-07-29,Italy,NA,Apulia,4029053,10,0,4606,551
2020-07-30,Italy,NA,Apulia,4029053,3,0,4609,551
2020-07-31,Italy,NA,Apulia,4029053,2,1,4611,552
2020-08-01,Italy,NA,Apulia,4029053,20,0,4631,552
2020-08-02,Italy,NA,Apulia,4029053,8,0,4639,552
2020-08-03,Italy,NA,Apulia,4029053,9,1,4648,553
2020-08-04,Italy,NA,Apulia,4029053,7,0,4655,553
2020-08-05,Italy,NA,Apulia,4029053,23,0,4678,553
2020-08-06,Italy,NA,Apulia,4029053,7,0,4685,553
2020-08-07,Italy,NA,Apulia,4029053,11,0,4696,553
2020-08-08,Italy,NA,Apulia,4029053,9,1,4705,554
2020-08-09,Italy,NA,Apulia,4029053,9,0,4714,554
2020-08-10,Italy,NA,Apulia,4029053,26,0,4740,554
2020-08-11,Italy,NA,Apulia,4029053,20,0,4760,554
2020-08-12,Italy,NA,Apulia,4029053,33,0,4793,554
2020-08-13,Italy,NA,Apulia,4029053,16,0,4809,554
2020-08-14,Italy,NA,Apulia,4029053,12,0,4821,554
2020-08-15,Italy,NA,Apulia,4029053,22,0,4843,554
2020-08-16,Italy,NA,Apulia,4029053,15,0,4858,554
2020-08-17,Italy,NA,Apulia,4029053,4,1,4862,555
2020-08-18,Italy,NA,Apulia,4029053,20,0,4882,555
2020-08-19,Italy,NA,Apulia,4029053,33,0,4915,555
2020-08-20,Italy,NA,Apulia,4029053,20,0,4935,555
2020-08-21,Italy,NA,Apulia,4029053,35,0,4970,555
2020-08-22,Italy,NA,Apulia,4029053,22,0,4992,555
2020-08-23,Italy,NA,Apulia,4029053,33,0,5025,555
2020-08-24,Italy,NA,Apulia,4029053,45,0,5070,555
2020-08-25,Italy,NA,Apulia,4029053,49,0,5119,555
2020-08-26,Italy,NA,Apulia,4029053,51,0,5170,555
2020-08-27,Italy,NA,Apulia,4029053,47,1,5217,556
2020-08-28,Italy,NA,Apulia,4029053,51,0,5268,556
2020-08-29,Italy,NA,Apulia,4029053,65,0,5333,556
2020-08-30,Italy,NA,Apulia,4029053,69,0,5402,556
2020-08-31,Italy,NA,Apulia,4029053,38,0,5440,556
2020-09-01,Italy,NA,Apulia,4029053,39,1,5479,557
2020-09-02,Italy,NA,Apulia,4029053,67,0,5546,557
2020-09-03,Italy,NA,Apulia,4029053,78,3,5624,560
2020-09-04,Italy,NA,Apulia,4029053,117,0,5741,560
2020-09-05,Italy,NA,Apulia,4029053,55,2,5796,562
2020-09-06,Italy,NA,Apulia,4029053,60,1,5856,563
2020-09-07,Italy,NA,Apulia,4029053,43,2,5899,565
2020-09-08,Italy,NA,Apulia,4029053,143,2,6042,567
2020-09-09,Italy,NA,Apulia,4029053,97,0,6139,567
2020-09-10,Italy,NA,Apulia,4029053,70,3,6209,570
2020-09-11,Italy,NA,Apulia,4029053,82,0,6291,570
2020-09-12,Italy,NA,Apulia,4029053,76,0,6367,570
2020-09-13,Italy,NA,Apulia,4029053,82,0,6449,570
2020-09-14,Italy,NA,Apulia,4029053,61,2,6510,572
2020-09-15,Italy,NA,Apulia,4029053,76,1,6586,573
2020-09-16,Italy,NA,Apulia,4029053,103,1,6689,574
2020-09-17,Italy,NA,Apulia,4029053,63,1,6752,575
2020-09-18,Italy,NA,Apulia,4029053,84,2,6836,577
2020-09-19,Italy,NA,Apulia,4029053,108,1,6944,578
2020-09-20,Italy,NA,Apulia,4029053,50,1,6994,579
2020-09-21,Italy,NA,Apulia,4029053,81,1,7075,580
2020-09-22,Italy,NA,Apulia,4029053,67,1,7142,581
2020-09-23,Italy,NA,Apulia,4029053,89,2,7231,583
2020-03-15,Italy,NA,Basilicata,562869,1,0,11,0
2020-03-16,Italy,NA,Basilicata,562869,1,0,12,0
2020-03-17,Italy,NA,Basilicata,562869,8,0,20,0
2020-03-18,Italy,NA,Basilicata,562869,7,0,27,0
2020-03-19,Italy,NA,Basilicata,562869,10,0,37,0
2020-03-20,Italy,NA,Basilicata,562869,15,0,52,0
2020-03-21,Italy,NA,Basilicata,562869,14,0,66,0
2020-03-22,Italy,NA,Basilicata,562869,15,0,81,0
2020-03-23,Italy,NA,Basilicata,562869,9,1,90,1
2020-03-24,Italy,NA,Basilicata,562869,2,0,92,1
2020-03-25,Italy,NA,Basilicata,562869,21,0,113,1
2020-03-26,Italy,NA,Basilicata,562869,21,0,134,1
2020-03-27,Italy,NA,Basilicata,562869,17,2,151,3
2020-03-28,Italy,NA,Basilicata,562869,31,0,182,3
2020-03-29,Italy,NA,Basilicata,562869,20,1,202,4
2020-03-30,Italy,NA,Basilicata,562869,12,1,214,5
2020-03-31,Italy,NA,Basilicata,562869,12,2,226,7
2020-04-01,Italy,NA,Basilicata,562869,11,2,237,9
2020-04-02,Italy,NA,Basilicata,562869,9,1,246,10
2020-04-03,Italy,NA,Basilicata,562869,15,1,261,11
2020-04-04,Italy,NA,Basilicata,562869,3,0,264,11
2020-04-05,Italy,NA,Basilicata,562869,14,2,278,13
2020-04-06,Italy,NA,Basilicata,562869,9,0,287,13
2020-04-07,Italy,NA,Basilicata,562869,4,1,291,14
2020-04-08,Italy,NA,Basilicata,562869,6,0,297,14
2020-04-09,Italy,NA,Basilicata,562869,6,1,303,15
2020-04-10,Italy,NA,Basilicata,562869,5,0,308,15
2020-04-11,Italy,NA,Basilicata,562869,4,2,312,17
2020-04-12,Italy,NA,Basilicata,562869,3,1,315,18
2020-04-13,Italy,NA,Basilicata,562869,4,0,319,18
2020-04-14,Italy,NA,Basilicata,562869,0,1,319,19
2020-04-15,Italy,NA,Basilicata,562869,1,2,320,21
2020-04-16,Italy,NA,Basilicata,562869,16,1,336,22
2020-04-17,Italy,NA,Basilicata,562869,1,0,337,22
2020-04-18,Italy,NA,Basilicata,562869,2,1,339,23
2020-04-19,Italy,NA,Basilicata,562869,3,1,342,24
2020-04-20,Italy,NA,Basilicata,562869,0,0,342,24
2020-04-21,Italy,NA,Basilicata,562869,8,0,350,24
2020-04-22,Italy,NA,Basilicata,562869,4,0,354,24
2020-04-23,Italy,NA,Basilicata,562869,2,0,356,24
2020-04-24,Italy,NA,Basilicata,562869,4,0,360,24
2020-04-25,Italy,NA,Basilicata,562869,1,1,361,25
2020-04-26,Italy,NA,Basilicata,562869,5,0,366,25
2020-04-27,Italy,NA,Basilicata,562869,0,0,366,25
2020-04-28,Italy,NA,Basilicata,562869,0,0,366,25
2020-04-29,Italy,NA,Basilicata,562869,0,0,366,25
2020-04-30,Italy,NA,Basilicata,562869,1,0,367,25
2020-05-01,Italy,NA,Basilicata,562869,11,0,378,25
2020-05-02,Italy,NA,Basilicata,562869,2,0,380,25
2020-05-03,Italy,NA,Basilicata,562869,6,0,386,25
2020-05-04,Italy,NA,Basilicata,562869,0,0,386,25
2020-05-05,Italy,NA,Basilicata,562869,10,0,396,25
2020-05-06,Italy,NA,Basilicata,562869,3,0,399,25
2020-05-07,Italy,NA,Basilicata,562869,0,1,399,26
2020-05-08,Italy,NA,Basilicata,562869,0,0,399,26
2020-05-09,Italy,NA,Basilicata,562869,0,1,399,27
2020-05-10,Italy,NA,Basilicata,562869,3,0,399,27
2020-05-11,Italy,NA,Basilicata,562869,1,0,399,27
2020-05-12,Italy,NA,Basilicata,562869,1,0,399,27
2020-05-13,Italy,NA,Basilicata,562869,2,0,399,27
2020-05-14,Italy,NA,Basilicata,562869,0,0,399,27
2020-05-15,Italy,NA,Basilicata,562869,0,0,399,27
2020-05-16,Italy,NA,Basilicata,562869,1,0,399,27
2020-05-17,Italy,NA,Basilicata,562869,2,0,399,27
2020-05-18,Italy,NA,Basilicata,562869,0,0,399,27
2020-05-19,Italy,NA,Basilicata,562869,1,0,399,27
2020-05-20,Italy,NA,Basilicata,562869,0,0,399,27
2020-05-21,Italy,NA,Basilicata,562869,1,0,399,27
2020-05-22,Italy,NA,Basilicata,562869,0,0,399,27
2020-05-23,Italy,NA,Basilicata,562869,4,0,399,27
2020-05-24,Italy,NA,Basilicata,562869,1,0,399,27
2020-05-25,Italy,NA,Basilicata,562869,0,0,399,27
2020-05-26,Italy,NA,Basilicata,562869,0,0,399,27
2020-05-27,Italy,NA,Basilicata,562869,0,0,399,27
2020-05-28,Italy,NA,Basilicata,562869,0,0,399,27
2020-05-29,Italy,NA,Basilicata,562869,0,0,399,27
2020-05-30,Italy,NA,Basilicata,562869,0,0,399,27
2020-05-31,Italy,NA,Basilicata,562869,0,0,399,27
2020-06-01,Italy,NA,Basilicata,562869,0,0,399,27
2020-06-02,Italy,NA,Basilicata,562869,0,0,399,27
2020-06-03,Italy,NA,Basilicata,562869,0,0,399,27
2020-06-04,Italy,NA,Basilicata,562869,0,0,399,27
2020-06-05,Italy,NA,Basilicata,562869,0,0,399,27
2020-06-06,Italy,NA,Basilicata,562869,0,0,399,27
2020-06-07,Italy,NA,Basilicata,562869,0,0,399,27
2020-06-08,Italy,NA,Basilicata,562869,0,0,399,27
2020-06-09,Italy,NA,Basilicata,562869,1,0,400,27
2020-06-10,Italy,NA,Basilicata,562869,0,0,400,27
2020-06-11,Italy,NA,Basilicata,562869,1,0,401,27
2020-06-12,Italy,NA,Basilicata,562869,0,0,401,27
2020-06-13,Italy,NA,Basilicata,562869,0,0,401,27
2020-06-14,Italy,NA,Basilicata,562869,0,0,401,27
2020-06-15,Italy,NA,Basilicata,562869,0,0,401,27
2020-06-16,Italy,NA,Basilicata,562869,0,0,401,27
2020-06-17,Italy,NA,Basilicata,562869,0,0,401,27
2020-06-18,Italy,NA,Basilicata,562869,0,0,401,27
2020-06-19,Italy,NA,Basilicata,562869,0,0,401,27
2020-06-20,Italy,NA,Basilicata,562869,0,0,401,27
2020-06-21,Italy,NA,Basilicata,562869,0,0,401,27
2020-06-22,Italy,NA,Basilicata,562869,0,0,401,27
2020-06-23,Italy,NA,Basilicata,562869,0,0,401,27
2020-06-24,Italy,NA,Basilicata,562869,0,0,401,27
2020-06-25,Italy,NA,Basilicata,562869,0,0,401,27
2020-06-26,Italy,NA,Basilicata,562869,0,0,401,27
2020-06-27,Italy,NA,Basilicata,562869,0,0,401,27
2020-06-28,Italy,NA,Basilicata,562869,0,0,401,27
2020-06-29,Italy,NA,Basilicata,562869,1,0,402,27
2020-06-30,Italy,NA,Basilicata,562869,0,0,402,27
2020-07-01,Italy,NA,Basilicata,562869,0,0,402,27
2020-07-02,Italy,NA,Basilicata,562869,0,0,402,27
2020-07-03,Italy,NA,Basilicata,562869,2,0,404,27
2020-07-04,Italy,NA,Basilicata,562869,0,0,404,27
2020-07-05,Italy,NA,Basilicata,562869,0,0,404,27
2020-07-06,Italy,NA,Basilicata,562869,0,0,404,27
2020-07-07,Italy,NA,Basilicata,562869,0,0,404,27
2020-07-08,Italy,NA,Basilicata,562869,1,0,405,27
2020-07-09,Italy,NA,Basilicata,562869,0,0,405,27
2020-07-10,Italy,NA,Basilicata,562869,0,0,405,27
2020-07-11,Italy,NA,Basilicata,562869,1,0,406,27
2020-07-12,Italy,NA,Basilicata,562869,0,0,406,27
2020-07-13,Italy,NA,Basilicata,562869,0,0,406,27
2020-07-14,Italy,NA,Basilicata,562869,0,0,406,27
2020-07-15,Italy,NA,Basilicata,562869,0,0,406,27
2020-07-16,Italy,NA,Basilicata,562869,0,0,406,27
2020-07-17,Italy,NA,Basilicata,562869,0,0,406,27
2020-07-18,Italy,NA,Basilicata,562869,0,0,406,27
2020-07-19,Italy,NA,Basilicata,562869,3,1,408,28
2020-07-20,Italy,NA,Basilicata,562869,0,0,408,28
2020-07-21,Italy,NA,Basilicata,562869,0,0,408,28
2020-07-22,Italy,NA,Basilicata,562869,36,0,444,28
2020-07-23,Italy,NA,Basilicata,562869,3,0,447,28
2020-07-24,Italy,NA,Basilicata,562869,0,0,447,28
2020-07-25,Italy,NA,Basilicata,562869,1,0,448,28
2020-07-26,Italy,NA,Basilicata,562869,0,0,448,28
2020-07-27,Italy,NA,Basilicata,562869,1,0,449,28
2020-07-28,Italy,NA,Basilicata,562869,0,0,449,28
2020-07-29,Italy,NA,Basilicata,562869,0,0,449,28
2020-07-30,Italy,NA,Basilicata,562869,0,0,449,28
2020-07-31,Italy,NA,Basilicata,562869,3,0,452,28
2020-08-01,Italy,NA,Basilicata,562869,0,0,452,28
2020-08-02,Italy,NA,Basilicata,562869,1,0,453,28
2020-08-03,Italy,NA,Basilicata,562869,0,0,453,28
2020-08-04,Italy,NA,Basilicata,562869,0,0,453,28
2020-08-05,Italy,NA,Basilicata,562869,1,0,454,28
2020-08-06,Italy,NA,Basilicata,562869,0,0,454,28
2020-08-07,Italy,NA,Basilicata,562869,21,0,475,28
2020-08-08,Italy,NA,Basilicata,562869,1,0,476,28
2020-08-09,Italy,NA,Basilicata,562869,0,0,476,28
2020-08-10,Italy,NA,Basilicata,562869,0,0,476,28
2020-08-11,Italy,NA,Basilicata,562869,1,0,477,28
2020-08-12,Italy,NA,Basilicata,562869,0,0,477,28
2020-08-13,Italy,NA,Basilicata,562869,1,0,478,28
2020-08-14,Italy,NA,Basilicata,562869,4,0,482,28
2020-08-15,Italy,NA,Basilicata,562869,4,0,486,28
2020-08-16,Italy,NA,Basilicata,562869,0,0,486,28
2020-08-17,Italy,NA,Basilicata,562869,0,0,486,28
2020-08-18,Italy,NA,Basilicata,562869,8,0,491,28
2020-08-19,Italy,NA,Basilicata,562869,1,0,492,28
2020-08-20,Italy,NA,Basilicata,562869,2,0,494,28
2020-08-21,Italy,NA,Basilicata,562869,0,0,494,28
2020-08-22,Italy,NA,Basilicata,562869,3,0,497,28
2020-08-23,Italy,NA,Basilicata,562869,5,0,502,28
2020-08-24,Italy,NA,Basilicata,562869,0,0,502,28
2020-08-25,Italy,NA,Basilicata,562869,3,0,505,28
2020-08-26,Italy,NA,Basilicata,562869,3,0,508,28
2020-08-27,Italy,NA,Basilicata,562869,6,0,514,28
2020-08-28,Italy,NA,Basilicata,562869,4,0,518,28
2020-08-29,Italy,NA,Basilicata,562869,5,0,523,28
2020-08-30,Italy,NA,Basilicata,562869,1,0,524,28
2020-08-31,Italy,NA,Basilicata,562869,0,0,524,28
2020-09-01,Italy,NA,Basilicata,562869,1,0,524,28
2020-09-02,Italy,NA,Basilicata,562869,2,0,526,28
2020-09-03,Italy,NA,Basilicata,562869,15,0,541,28
2020-09-04,Italy,NA,Basilicata,562869,7,0,548,28
2020-09-05,Italy,NA,Basilicata,562869,7,0,555,28
2020-09-06,Italy,NA,Basilicata,562869,9,0,564,28
2020-09-07,Italy,NA,Basilicata,562869,1,0,565,28
2020-09-08,Italy,NA,Basilicata,562869,8,0,573,28
2020-09-09,Italy,NA,Basilicata,562869,14,0,587,28
2020-09-10,Italy,NA,Basilicata,562869,6,0,593,28
2020-09-11,Italy,NA,Basilicata,562869,12,0,605,28
2020-09-12,Italy,NA,Basilicata,562869,5,0,610,28
2020-09-13,Italy,NA,Basilicata,562869,3,0,613,28
2020-09-14,Italy,NA,Basilicata,562869,0,0,613,28
2020-09-15,Italy,NA,Basilicata,562869,5,0,618,28
2020-09-16,Italy,NA,Basilicata,562869,5,0,623,28
2020-09-17,Italy,NA,Basilicata,562869,5,0,628,28
2020-09-18,Italy,NA,Basilicata,562869,0,0,628,28
2020-09-19,Italy,NA,Basilicata,562869,3,0,631,28
2020-09-20,Italy,NA,Basilicata,562869,6,0,637,28
2020-09-21,Italy,NA,Basilicata,562869,1,0,638,28
2020-09-22,Italy,NA,Basilicata,562869,14,0,652,28
2020-09-23,Italy,NA,Basilicata,562869,17,0,669,28
2020-03-09,Italy,NA,Calabria,1947131,2,0,11,0
2020-03-10,Italy,NA,Calabria,1947131,2,0,13,0
2020-03-11,Italy,NA,Calabria,1947131,6,0,19,0
2020-03-12,Italy,NA,Calabria,1947131,14,0,33,0
2020-03-13,Italy,NA,Calabria,1947131,5,0,38,0
2020-03-14,Italy,NA,Calabria,1947131,22,0,60,0
2020-03-15,Italy,NA,Calabria,1947131,8,1,68,1
2020-03-16,Italy,NA,Calabria,1947131,21,0,89,1
2020-03-17,Italy,NA,Calabria,1947131,25,0,114,1
2020-03-18,Italy,NA,Calabria,1947131,15,0,129,1
2020-03-19,Italy,NA,Calabria,1947131,40,2,169,3
2020-03-20,Italy,NA,Calabria,1947131,38,1,207,4
2020-03-21,Italy,NA,Calabria,1947131,28,1,235,5
2020-03-22,Italy,NA,Calabria,1947131,38,3,273,8
2020-03-23,Italy,NA,Calabria,1947131,19,0,292,8
2020-03-24,Italy,NA,Calabria,1947131,27,3,319,10
2020-03-25,Italy,NA,Calabria,1947131,32,1,351,11
2020-03-26,Italy,NA,Calabria,1947131,42,3,393,14
2020-03-27,Italy,NA,Calabria,1947131,101,4,494,18
2020-03-28,Italy,NA,Calabria,1947131,61,3,555,21
2020-03-29,Italy,NA,Calabria,1947131,59,4,614,25
2020-03-30,Italy,NA,Calabria,1947131,33,6,647,31
2020-03-31,Italy,NA,Calabria,1947131,12,5,659,36
2020-04-01,Italy,NA,Calabria,1947131,10,2,669,38
2020-04-02,Italy,NA,Calabria,1947131,22,3,691,41
2020-04-03,Italy,NA,Calabria,1947131,42,4,733,45
2020-04-04,Italy,NA,Calabria,1947131,8,4,741,49
2020-04-05,Italy,NA,Calabria,1947131,54,7,795,56
2020-04-06,Italy,NA,Calabria,1947131,22,2,817,58
2020-04-07,Italy,NA,Calabria,1947131,16,2,833,60
2020-04-08,Italy,NA,Calabria,1947131,26,0,859,60
2020-04-09,Italy,NA,Calabria,1947131,15,1,874,61
2020-04-10,Italy,NA,Calabria,1947131,27,4,901,65
2020-04-11,Italy,NA,Calabria,1947131,14,1,915,66
2020-04-12,Italy,NA,Calabria,1947131,8,0,923,66
2020-04-13,Italy,NA,Calabria,1947131,5,1,928,67
2020-04-14,Italy,NA,Calabria,1947131,28,1,956,68
2020-04-15,Italy,NA,Calabria,1947131,15,3,971,71
2020-04-16,Italy,NA,Calabria,1947131,38,1,1009,72
2020-04-17,Italy,NA,Calabria,1947131,0,1,1009,73
2020-04-18,Italy,NA,Calabria,1947131,20,0,1011,73
2020-04-19,Italy,NA,Calabria,1947131,24,2,1035,75
2020-04-20,Italy,NA,Calabria,1947131,3,0,1038,75
2020-04-21,Italy,NA,Calabria,1947131,9,1,1047,76
2020-04-22,Italy,NA,Calabria,1947131,13,0,1060,76
2020-04-23,Italy,NA,Calabria,1947131,9,0,1069,76
2020-04-24,Italy,NA,Calabria,1947131,10,4,1079,80
2020-04-25,Italy,NA,Calabria,1947131,9,0,1088,80
2020-04-26,Italy,NA,Calabria,1947131,1,0,1089,80
2020-04-27,Italy,NA,Calabria,1947131,7,3,1096,83
2020-04-28,Italy,NA,Calabria,1947131,1,2,1097,85
2020-04-29,Italy,NA,Calabria,1947131,5,1,1102,86
2020-04-30,Italy,NA,Calabria,1947131,6,0,1108,86
2020-05-01,Italy,NA,Calabria,1947131,4,0,1112,86
2020-05-02,Italy,NA,Calabria,1947131,0,2,1112,88
2020-05-03,Italy,NA,Calabria,1947131,2,0,1114,88
2020-05-04,Italy,NA,Calabria,1947131,4,0,1118,88
2020-05-05,Italy,NA,Calabria,1947131,1,0,1119,88
2020-05-06,Italy,NA,Calabria,1947131,3,1,1122,89
2020-05-07,Italy,NA,Calabria,1947131,3,0,1125,89
2020-05-08,Italy,NA,Calabria,1947131,1,1,1126,90
2020-05-09,Italy,NA,Calabria,1947131,3,0,1129,90
2020-05-10,Italy,NA,Calabria,1947131,3,1,1132,91
2020-05-11,Italy,NA,Calabria,1947131,2,2,1134,93
2020-05-12,Italy,NA,Calabria,1947131,4,0,1138,93
2020-05-13,Italy,NA,Calabria,1947131,2,0,1140,93
2020-05-14,Italy,NA,Calabria,1947131,3,2,1143,95
2020-05-15,Italy,NA,Calabria,1947131,1,0,1144,95
2020-05-16,Italy,NA,Calabria,1947131,7,0,1151,95
2020-05-17,Italy,NA,Calabria,1947131,0,0,1151,95
2020-05-18,Italy,NA,Calabria,1947131,0,0,1151,95
2020-05-19,Italy,NA,Calabria,1947131,2,0,1153,95
2020-05-20,Italy,NA,Calabria,1947131,3,1,1156,96
2020-05-21,Italy,NA,Calabria,1947131,0,0,1156,96
2020-05-22,Italy,NA,Calabria,1947131,1,0,1157,96
2020-05-23,Italy,NA,Calabria,1947131,0,0,1157,96
2020-05-24,Italy,NA,Calabria,1947131,0,0,1157,96
2020-05-25,Italy,NA,Calabria,1947131,0,0,1157,96
2020-05-26,Italy,NA,Calabria,1947131,0,0,1157,96
2020-05-27,Italy,NA,Calabria,1947131,1,0,1158,96
2020-05-28,Italy,NA,Calabria,1947131,0,0,1158,96
2020-05-29,Italy,NA,Calabria,1947131,0,1,1158,97
2020-05-30,Italy,NA,Calabria,1947131,0,0,1158,97
2020-05-31,Italy,NA,Calabria,1947131,0,0,1158,97
2020-06-01,Italy,NA,Calabria,1947131,0,0,1158,97
2020-06-02,Italy,NA,Calabria,1947131,0,0,1158,97
2020-06-03,Italy,NA,Calabria,1947131,0,0,1158,97
2020-06-04,Italy,NA,Calabria,1947131,0,0,1158,97
2020-06-05,Italy,NA,Calabria,1947131,1,0,1159,97
2020-06-06,Italy,NA,Calabria,1947131,0,0,1159,97
2020-06-07,Italy,NA,Calabria,1947131,0,0,1159,97
2020-06-08,Italy,NA,Calabria,1947131,0,0,1159,97
2020-06-09,Italy,NA,Calabria,1947131,0,0,1159,97
2020-06-10,Italy,NA,Calabria,1947131,0,0,1159,97
2020-06-11,Italy,NA,Calabria,1947131,2,0,1161,97
2020-06-12,Italy,NA,Calabria,1947131,0,0,1161,97
2020-06-13,Italy,NA,Calabria,1947131,1,0,1162,97
2020-06-14,Italy,NA,Calabria,1947131,0,0,1162,97
2020-06-15,Italy,NA,Calabria,1947131,0,0,1162,97
2020-06-16,Italy,NA,Calabria,1947131,0,0,1162,97
2020-06-17,Italy,NA,Calabria,1947131,0,0,1162,97
2020-06-18,Italy,NA,Calabria,1947131,3,0,1165,97
2020-06-19,Italy,NA,Calabria,1947131,0,0,1165,97
2020-06-20,Italy,NA,Calabria,1947131,3,0,1167,97
2020-06-21,Italy,NA,Calabria,1947131,6,0,1173,97
2020-06-22,Italy,NA,Calabria,1947131,1,0,1174,97
2020-06-23,Italy,NA,Calabria,1947131,1,0,1175,97
2020-06-24,Italy,NA,Calabria,1947131,0,0,1175,97
2020-06-25,Italy,NA,Calabria,1947131,0,0,1175,97
2020-06-26,Italy,NA,Calabria,1947131,3,0,1178,97
2020-06-27,Italy,NA,Calabria,1947131,1,0,1179,97
2020-06-28,Italy,NA,Calabria,1947131,1,0,1180,97
2020-06-29,Italy,NA,Calabria,1947131,0,0,1180,97
2020-06-30,Italy,NA,Calabria,1947131,1,0,1181,97
2020-07-01,Italy,NA,Calabria,1947131,0,0,1181,97
2020-07-02,Italy,NA,Calabria,1947131,0,0,1181,97
2020-07-03,Italy,NA,Calabria,1947131,1,0,1182,97
2020-07-04,Italy,NA,Calabria,1947131,1,0,1183,97
2020-07-05,Italy,NA,Calabria,1947131,0,0,1183,97
2020-07-06,Italy,NA,Calabria,1947131,0,0,1183,97
2020-07-07,Italy,NA,Calabria,1947131,1,0,1184,97
2020-07-08,Italy,NA,Calabria,1947131,1,0,1185,97
2020-07-09,Italy,NA,Calabria,1947131,0,0,1185,97
2020-07-10,Italy,NA,Calabria,1947131,1,0,1186,97
2020-07-11,Italy,NA,Calabria,1947131,2,0,1188,97
2020-07-12,Italy,NA,Calabria,1947131,28,0,1216,97
2020-07-13,Italy,NA,Calabria,1947131,0,0,1216,97
2020-07-14,Italy,NA,Calabria,1947131,0,0,1216,97
2020-07-15,Italy,NA,Calabria,1947131,2,0,1218,97
2020-07-16,Italy,NA,Calabria,1947131,8,0,1226,97
2020-07-17,Italy,NA,Calabria,1947131,5,0,1231,97
2020-07-18,Italy,NA,Calabria,1947131,7,0,1238,97
2020-07-19,Italy,NA,Calabria,1947131,1,0,1239,97
2020-07-20,Italy,NA,Calabria,1947131,0,0,1239,97
2020-07-21,Italy,NA,Calabria,1947131,0,0,1239,97
2020-07-22,Italy,NA,Calabria,1947131,4,0,1243,97
2020-07-23,Italy,NA,Calabria,1947131,2,0,1245,97
2020-07-24,Italy,NA,Calabria,1947131,1,0,1246,97
2020-07-25,Italy,NA,Calabria,1947131,1,0,1247,97
2020-07-26,Italy,NA,Calabria,1947131,0,0,1247,97
2020-07-27,Italy,NA,Calabria,1947131,0,0,1247,97
2020-07-28,Italy,NA,Calabria,1947131,5,0,1252,97
2020-07-29,Italy,NA,Calabria,1947131,3,0,1255,97
2020-07-30,Italy,NA,Calabria,1947131,7,0,1262,97
2020-07-31,Italy,NA,Calabria,1947131,4,0,1266,97
2020-08-01,Italy,NA,Calabria,1947131,3,0,1269,97
2020-08-02,Italy,NA,Calabria,1947131,1,0,1270,97
2020-08-03,Italy,NA,Calabria,1947131,0,0,1270,97
2020-08-04,Italy,NA,Calabria,1947131,2,0,1272,97
2020-08-05,Italy,NA,Calabria,1947131,2,0,1274,97
2020-08-06,Italy,NA,Calabria,1947131,2,0,1276,97
2020-08-07,Italy,NA,Calabria,1947131,7,0,1283,97
2020-08-08,Italy,NA,Calabria,1947131,4,0,1287,97
2020-08-09,Italy,NA,Calabria,1947131,0,0,1287,97
2020-08-10,Italy,NA,Calabria,1947131,2,0,1289,97
2020-08-11,Italy,NA,Calabria,1947131,11,0,1300,97
2020-08-12,Italy,NA,Calabria,1947131,4,0,1304,97
2020-08-13,Italy,NA,Calabria,1947131,12,0,1316,97
2020-08-14,Italy,NA,Calabria,1947131,19,0,1335,97
2020-08-15,Italy,NA,Calabria,1947131,10,0,1345,97
2020-08-16,Italy,NA,Calabria,1947131,3,0,1348,97
2020-08-17,Italy,NA,Calabria,1947131,4,0,1352,97
2020-08-18,Italy,NA,Calabria,1947131,5,0,1357,97
2020-08-19,Italy,NA,Calabria,1947131,10,0,1367,97
2020-08-20,Italy,NA,Calabria,1947131,10,0,1377,97
2020-08-21,Italy,NA,Calabria,1947131,2,0,1379,97
2020-08-22,Italy,NA,Calabria,1947131,11,0,1390,97
2020-08-23,Italy,NA,Calabria,1947131,8,0,1398,97
2020-08-24,Italy,NA,Calabria,1947131,2,0,1400,97
2020-08-25,Italy,NA,Calabria,1947131,8,0,1408,97
2020-08-26,Italy,NA,Calabria,1947131,8,0,1416,97
2020-08-27,Italy,NA,Calabria,1947131,6,0,1422,97
2020-08-28,Italy,NA,Calabria,1947131,10,0,1432,97
2020-08-29,Italy,NA,Calabria,1947131,11,0,1443,97
2020-08-30,Italy,NA,Calabria,1947131,34,0,1477,97
2020-08-31,Italy,NA,Calabria,1947131,14,0,1491,97
2020-09-01,Italy,NA,Calabria,1947131,22,0,1513,97
2020-09-02,Italy,NA,Calabria,1947131,32,0,1545,97
2020-09-03,Italy,NA,Calabria,1947131,13,0,1558,97
2020-09-04,Italy,NA,Calabria,1947131,19,0,1577,97
2020-09-05,Italy,NA,Calabria,1947131,19,1,1596,98
2020-09-06,Italy,NA,Calabria,1947131,27,0,1623,98
2020-09-07,Italy,NA,Calabria,1947131,17,0,1640,98
2020-09-08,Italy,NA,Calabria,1947131,8,0,1648,98
2020-09-09,Italy,NA,Calabria,1947131,19,0,1667,98
2020-09-10,Italy,NA,Calabria,1947131,8,0,1675,98
2020-09-11,Italy,NA,Calabria,1947131,8,0,1683,98
2020-09-12,Italy,NA,Calabria,1947131,18,0,1701,98
2020-09-13,Italy,NA,Calabria,1947131,14,0,1715,98
2020-09-14,Italy,NA,Calabria,1947131,3,0,1718,98
2020-09-15,Italy,NA,Calabria,1947131,4,0,1722,98
2020-09-16,Italy,NA,Calabria,1947131,19,0,1741,98
2020-09-17,Italy,NA,Calabria,1947131,16,0,1757,98
2020-09-18,Italy,NA,Calabria,1947131,28,0,1785,98
2020-09-19,Italy,NA,Calabria,1947131,25,0,1810,98
2020-09-20,Italy,NA,Calabria,1947131,22,0,1832,98
2020-09-21,Italy,NA,Calabria,1947131,12,0,1844,98
2020-09-22,Italy,NA,Calabria,1947131,24,0,1868,98
2020-09-23,Italy,NA,Calabria,1947131,19,0,1887,98
2020-02-29,Italy,NA,Campania,5801692,9,0,13,0
2020-03-01,Italy,NA,Campania,5801692,4,0,17,0
2020-03-02,Italy,NA,Campania,5801692,0,0,17,0
2020-03-03,Italy,NA,Campania,5801692,13,0,30,0
2020-03-04,Italy,NA,Campania,5801692,1,0,31,0
2020-03-05,Italy,NA,Campania,5801692,14,0,45,0
2020-03-06,Italy,NA,Campania,5801692,12,0,57,0
2020-03-07,Italy,NA,Campania,5801692,4,0,61,0
2020-03-08,Italy,NA,Campania,5801692,40,0,101,0
2020-03-09,Italy,NA,Campania,5801692,19,0,120,0
2020-03-10,Italy,NA,Campania,5801692,7,0,127,0
2020-03-11,Italy,NA,Campania,5801692,27,1,154,1
2020-03-12,Italy,NA,Campania,5801692,25,0,179,1
2020-03-13,Italy,NA,Campania,5801692,41,1,220,2
2020-03-14,Italy,NA,Campania,5801692,52,4,272,6
2020-03-15,Italy,NA,Campania,5801692,61,3,333,9
2020-03-16,Italy,NA,Campania,5801692,67,0,400,9
2020-03-17,Italy,NA,Campania,5801692,60,0,460,9
2020-03-18,Italy,NA,Campania,5801692,0,0,460,9
2020-03-19,Italy,NA,Campania,5801692,192,8,652,17
2020-03-20,Italy,NA,Campania,5801692,97,0,749,17
2020-03-21,Italy,NA,Campania,5801692,95,5,844,22
2020-03-22,Italy,NA,Campania,5801692,92,7,936,29
2020-03-23,Italy,NA,Campania,5801692,90,20,1026,49
2020-03-24,Italy,NA,Campania,5801692,75,7,1101,56
2020-03-25,Italy,NA,Campania,5801692,98,18,1199,74
2020-03-26,Italy,NA,Campania,5801692,111,9,1310,83
2020-03-27,Italy,NA,Campania,5801692,144,15,1454,98
2020-03-28,Italy,NA,Campania,5801692,138,11,1592,109
2020-03-29,Italy,NA,Campania,5801692,167,8,1759,117
2020-03-30,Italy,NA,Campania,5801692,193,8,1952,125
2020-03-31,Italy,NA,Campania,5801692,140,8,2092,133
2020-04-01,Italy,NA,Campania,5801692,139,15,2231,148
2020-04-02,Italy,NA,Campania,5801692,225,19,2456,167
2020-04-03,Italy,NA,Campania,5801692,221,14,2677,181
2020-04-04,Italy,NA,Campania,5801692,151,5,2828,186
2020-04-05,Italy,NA,Campania,5801692,132,3,2960,189
2020-04-06,Italy,NA,Campania,5801692,98,15,3058,204
2020-04-07,Italy,NA,Campania,5801692,90,12,3148,216
2020-04-08,Italy,NA,Campania,5801692,120,5,3268,221
2020-04-09,Italy,NA,Campania,5801692,76,6,3344,227
2020-04-10,Italy,NA,Campania,5801692,98,4,3442,231
2020-04-11,Italy,NA,Campania,5801692,75,7,3517,238
2020-04-12,Italy,NA,Campania,5801692,87,4,3604,242
2020-04-13,Italy,NA,Campania,5801692,66,6,3670,248
2020-04-14,Italy,NA,Campania,5801692,99,12,3769,260
2020-04-15,Italy,NA,Campania,5801692,38,18,3807,278
2020-04-16,Italy,NA,Campania,5801692,80,8,3887,286
2020-04-17,Italy,NA,Campania,5801692,64,7,3951,293
2020-04-18,Italy,NA,Campania,5801692,37,7,3988,300
2020-04-19,Italy,NA,Campania,5801692,41,4,4029,304
2020-04-20,Italy,NA,Campania,5801692,45,5,4074,309
2020-04-21,Italy,NA,Campania,5801692,61,8,4135,317
2020-04-22,Italy,NA,Campania,5801692,50,10,4185,327
2020-04-23,Italy,NA,Campania,5801692,53,5,4238,332
2020-04-24,Italy,NA,Campania,5801692,44,4,4282,336
2020-04-25,Italy,NA,Campania,5801692,17,5,4299,341
2020-04-26,Italy,NA,Campania,5801692,32,4,4331,345
2020-04-27,Italy,NA,Campania,5801692,18,7,4349,352
2020-04-28,Italy,NA,Campania,5801692,31,6,4380,358
2020-04-29,Italy,NA,Campania,5801692,30,1,4410,359
2020-04-30,Italy,NA,Campania,5801692,13,0,4423,359
2020-05-01,Italy,NA,Campania,5801692,21,0,4444,359
2020-05-02,Italy,NA,Campania,5801692,15,3,4459,362
2020-05-03,Italy,NA,Campania,5801692,25,2,4484,364
2020-05-04,Italy,NA,Campania,5801692,14,2,4498,366
2020-05-05,Italy,NA,Campania,5801692,20,3,4518,369
2020-05-06,Italy,NA,Campania,5801692,14,7,4532,376
2020-05-07,Italy,NA,Campania,5801692,9,3,4541,379
2020-05-08,Italy,NA,Campania,5801692,21,7,4562,386
2020-05-09,Italy,NA,Campania,5801692,14,2,4576,388
2020-05-10,Italy,NA,Campania,5801692,12,3,4588,391
2020-05-11,Italy,NA,Campania,5801692,14,1,4602,392
2020-05-12,Italy,NA,Campania,5801692,13,1,4615,393
2020-05-13,Italy,NA,Campania,5801692,15,1,4630,394
2020-05-14,Italy,NA,Campania,5801692,9,0,4639,394
2020-05-15,Italy,NA,Campania,5801692,15,2,4654,396
2020-05-16,Italy,NA,Campania,5801692,14,0,4668,396
2020-05-17,Italy,NA,Campania,5801692,16,0,4684,396
2020-05-18,Italy,NA,Campania,5801692,11,3,4695,399
2020-05-19,Italy,NA,Campania,5801692,12,0,4707,399
2020-05-20,Italy,NA,Campania,5801692,7,2,4714,401
2020-05-21,Italy,NA,Campania,5801692,9,2,4723,403
2020-05-22,Italy,NA,Campania,5801692,10,1,4733,404
2020-05-23,Italy,NA,Campania,5801692,11,0,4744,404
2020-05-24,Italy,NA,Campania,5801692,5,1,4749,405
2020-05-25,Italy,NA,Campania,5801692,6,0,4755,405
2020-05-26,Italy,NA,Campania,5801692,12,0,4767,405
2020-05-27,Italy,NA,Campania,5801692,6,1,4773,406
2020-05-28,Italy,NA,Campania,5801692,4,4,4777,410
2020-05-29,Italy,NA,Campania,5801692,10,1,4787,411
2020-05-30,Italy,NA,Campania,5801692,10,0,4797,411
2020-05-31,Italy,NA,Campania,5801692,5,1,4802,412
2020-06-01,Italy,NA,Campania,5801692,4,1,4806,413
2020-06-02,Italy,NA,Campania,5801692,3,2,4809,415
2020-06-03,Italy,NA,Campania,5801692,12,0,4821,415
2020-06-04,Italy,NA,Campania,5801692,1,5,4822,420
2020-06-05,Italy,NA,Campania,5801692,0,5,4822,425
2020-06-06,Italy,NA,Campania,5801692,0,1,4822,426
2020-06-07,Italy,NA,Campania,5801692,4,0,4826,426
2020-06-08,Italy,NA,Campania,5801692,2,0,4828,426
2020-06-09,Italy,NA,Campania,5801692,5,0,4833,426
2020-06-10,Italy,NA,Campania,5801692,1,2,4834,428
2020-06-11,Italy,NA,Campania,5801692,3,2,4837,430
2020-06-12,Italy,NA,Campania,5801692,0,0,4837,430
2020-06-13,Italy,NA,Campania,5801692,0,0,4837,430
2020-06-14,Italy,NA,Campania,5801692,1,0,4837,430
2020-06-15,Italy,NA,Campania,5801692,4,0,4837,430
2020-06-16,Italy,NA,Campania,5801692,0,0,4837,430
2020-06-17,Italy,NA,Campania,5801692,1,1,4837,431
2020-06-18,Italy,NA,Campania,5801692,1,0,4837,431
2020-06-19,Italy,NA,Campania,5801692,0,0,4837,431
2020-06-20,Italy,NA,Campania,5801692,0,0,4837,431
2020-06-21,Italy,NA,Campania,5801692,2,0,4837,431
2020-06-22,Italy,NA,Campania,5801692,7,0,4837,431
2020-06-23,Italy,NA,Campania,5801692,10,0,4837,431
2020-06-24,Italy,NA,Campania,5801692,11,0,4837,431
2020-06-25,Italy,NA,Campania,5801692,17,0,4837,431
2020-06-26,Italy,NA,Campania,5801692,3,0,4837,431
2020-06-27,Italy,NA,Campania,5801692,0,0,4837,431
2020-06-28,Italy,NA,Campania,5801692,0,0,4837,431
2020-06-29,Italy,NA,Campania,5801692,1,0,4837,431
2020-06-30,Italy,NA,Campania,5801692,24,1,4837,432
2020-07-01,Italy,NA,Campania,5801692,9,0,4837,432
2020-07-02,Italy,NA,Campania,5801692,3,0,4837,432
2020-07-03,Italy,NA,Campania,5801692,10,0,4837,432
2020-07-04,Italy,NA,Campania,5801692,2,0,4837,432
2020-07-05,Italy,NA,Campania,5801692,5,0,4837,432
2020-07-06,Italy,NA,Campania,5801692,27,0,4837,432
2020-07-07,Italy,NA,Campania,5801692,1,0,4837,432
2020-07-08,Italy,NA,Campania,5801692,3,0,4837,432
2020-07-09,Italy,NA,Campania,5801692,5,0,4837,432
2020-07-10,Italy,NA,Campania,5801692,7,0,4837,432
2020-07-11,Italy,NA,Campania,5801692,7,0,4837,432
2020-07-12,Italy,NA,Campania,5801692,3,0,4837,432
2020-07-13,Italy,NA,Campania,5801692,7,0,4837,432
2020-07-14,Italy,NA,Campania,5801692,0,0,4837,432
2020-07-15,Italy,NA,Campania,5801692,8,0,4837,432
2020-07-16,Italy,NA,Campania,5801692,4,0,4837,432
2020-07-17,Italy,NA,Campania,5801692,12,1,4837,433
2020-07-18,Italy,NA,Campania,5801692,15,0,4837,433
2020-07-19,Italy,NA,Campania,5801692,9,0,4837,433
2020-07-20,Italy,NA,Campania,5801692,6,0,4837,433
2020-07-21,Italy,NA,Campania,5801692,6,1,4839,434
2020-07-22,Italy,NA,Campania,5801692,19,0,4858,434
2020-07-23,Italy,NA,Campania,5801692,16,0,4874,434
2020-07-24,Italy,NA,Campania,5801692,6,0,4880,434
2020-07-25,Italy,NA,Campania,5801692,21,0,4901,434
2020-07-26,Italy,NA,Campania,5801692,11,0,4912,434
2020-07-27,Italy,NA,Campania,5801692,14,0,4926,434
2020-07-28,Italy,NA,Campania,5801692,29,0,4955,434
2020-07-29,Italy,NA,Campania,5801692,19,0,4974,434
2020-07-30,Italy,NA,Campania,5801692,16,0,4990,434
2020-07-31,Italy,NA,Campania,5801692,9,1,4999,435
2020-08-01,Italy,NA,Campania,5801692,10,0,5009,435
2020-08-02,Italy,NA,Campania,5801692,7,0,5016,435
2020-08-03,Italy,NA,Campania,5801692,4,1,5020,436
2020-08-04,Italy,NA,Campania,5801692,2,0,5022,436
2020-08-05,Italy,NA,Campania,5801692,8,2,5030,438
2020-08-06,Italy,NA,Campania,5801692,5,0,5035,438
2020-08-07,Italy,NA,Campania,5801692,15,0,5050,438
2020-08-08,Italy,NA,Campania,5801692,5,0,5055,438
2020-08-09,Italy,NA,Campania,5801692,22,0,5077,438
2020-08-10,Italy,NA,Campania,5801692,14,1,5091,439
2020-08-11,Italy,NA,Campania,5801692,23,1,5114,440
2020-08-12,Italy,NA,Campania,5801692,29,0,5143,440
2020-08-13,Italy,NA,Campania,5801692,27,0,5170,440
2020-08-14,Italy,NA,Campania,5801692,44,0,5214,440
2020-08-15,Italy,NA,Campania,5801692,18,0,5232,440
2020-08-16,Italy,NA,Campania,5801692,46,0,5278,440
2020-08-17,Italy,NA,Campania,5801692,34,0,5312,440
2020-08-18,Italy,NA,Campania,5801692,35,0,5347,440
2020-08-19,Italy,NA,Campania,5801692,56,0,5403,440
2020-08-20,Italy,NA,Campania,5801692,53,0,5456,440
2020-08-21,Italy,NA,Campania,5801692,67,0,5523,440
2020-08-22,Italy,NA,Campania,5801692,61,0,5584,440
2020-08-23,Italy,NA,Campania,5801692,138,1,5722,441
2020-08-24,Italy,NA,Campania,5801692,116,0,5838,441
2020-08-25,Italy,NA,Campania,5801692,138,1,5976,442
2020-08-26,Italy,NA,Campania,5801692,135,1,6111,443
2020-08-27,Italy,NA,Campania,5801692,130,2,6241,445
2020-08-28,Italy,NA,Campania,5801692,183,0,6424,445
2020-08-29,Italy,NA,Campania,5801692,188,0,6612,445
2020-08-30,Italy,NA,Campania,5801692,270,0,6882,445
2020-08-31,Italy,NA,Campania,5801692,184,0,7066,445
2020-09-01,Italy,NA,Campania,5801692,102,1,7168,446
2020-09-02,Italy,NA,Campania,5801692,117,0,7285,446
2020-09-03,Italy,NA,Campania,5801692,193,0,7478,446
2020-09-04,Italy,NA,Campania,5801692,171,1,7649,447
2020-09-05,Italy,NA,Campania,5801692,119,1,7768,448
2020-09-06,Italy,NA,Campania,5801692,100,0,7868,448
2020-09-07,Italy,NA,Campania,5801692,218,0,8128,448
2020-09-08,Italy,NA,Campania,5801692,249,0,8377,448
2020-09-09,Italy,NA,Campania,5801692,203,1,8580,449
2020-09-10,Italy,NA,Campania,5801692,180,1,8760,450
2020-09-11,Italy,NA,Campania,5801692,140,1,8900,451
2020-09-12,Italy,NA,Campania,5801692,103,0,9003,451
2020-09-13,Italy,NA,Campania,5801692,122,0,9125,451
2020-09-14,Italy,NA,Campania,5801692,90,1,9215,452
2020-09-15,Italy,NA,Campania,5801692,136,0,9351,452
2020-09-16,Italy,NA,Campania,5801692,186,0,9537,452
2020-09-17,Italy,NA,Campania,5801692,195,3,9732,455
2020-09-18,Italy,NA,Campania,5801692,208,0,9940,455
2020-09-19,Italy,NA,Campania,5801692,149,1,10089,456
2020-09-20,Italy,NA,Campania,5801692,171,0,10260,456
2020-09-21,Italy,NA,Campania,5801692,243,1,10503,457
2020-09-22,Italy,NA,Campania,5801692,156,0,10659,457
2020-09-23,Italy,NA,Campania,5801692,248,0,10907,457
2020-02-24,Italy,NA,Emilia-Romagna,4459477,18,0,18,0
2020-02-25,Italy,NA,Emilia-Romagna,4459477,8,0,26,0
2020-02-26,Italy,NA,Emilia-Romagna,4459477,21,1,47,1
2020-02-27,Italy,NA,Emilia-Romagna,4459477,50,0,97,1
2020-02-28,Italy,NA,Emilia-Romagna,4459477,48,1,145,2
2020-02-29,Italy,NA,Emilia-Romagna,4459477,72,2,217,4
2020-03-01,Italy,NA,Emilia-Romagna,4459477,68,4,285,8
2020-03-02,Italy,NA,Emilia-Romagna,4459477,50,3,335,11
2020-03-03,Italy,NA,Emilia-Romagna,4459477,85,7,420,18
2020-03-04,Italy,NA,Emilia-Romagna,4459477,124,4,544,22
2020-03-05,Italy,NA,Emilia-Romagna,4459477,154,8,698,30
2020-03-06,Italy,NA,Emilia-Romagna,4459477,172,7,870,37
2020-03-07,Italy,NA,Emilia-Romagna,4459477,140,11,1010,48
2020-03-08,Italy,NA,Emilia-Romagna,4459477,170,8,1180,56
2020-03-09,Italy,NA,Emilia-Romagna,4459477,206,14,1386,70
2020-03-10,Italy,NA,Emilia-Romagna,4459477,147,15,1533,85
2020-03-11,Italy,NA,Emilia-Romagna,4459477,206,28,1739,113
2020-03-12,Italy,NA,Emilia-Romagna,4459477,208,33,1947,146
2020-03-13,Italy,NA,Emilia-Romagna,4459477,316,55,2263,201
2020-03-14,Italy,NA,Emilia-Romagna,4459477,381,40,2644,241
2020-03-15,Italy,NA,Emilia-Romagna,4459477,449,43,3093,284
2020-03-16,Italy,NA,Emilia-Romagna,4459477,429,62,3522,346
2020-03-17,Italy,NA,Emilia-Romagna,4459477,409,47,3931,393
2020-03-18,Italy,NA,Emilia-Romagna,4459477,594,65,4525,458
2020-03-19,Italy,NA,Emilia-Romagna,4459477,689,73,5214,531
2020-03-20,Italy,NA,Emilia-Romagna,4459477,754,109,5968,640
2020-03-21,Italy,NA,Emilia-Romagna,4459477,737,75,6705,715
2020-03-22,Italy,NA,Emilia-Romagna,4459477,850,101,7555,816
2020-03-23,Italy,NA,Emilia-Romagna,4459477,980,76,8535,892
2020-03-24,Italy,NA,Emilia-Romagna,4459477,719,93,9254,985
2020-03-25,Italy,NA,Emilia-Romagna,4459477,800,92,10054,1077
2020-03-26,Italy,NA,Emilia-Romagna,4459477,762,97,10816,1174
2020-03-27,Italy,NA,Emilia-Romagna,4459477,772,93,11588,1267
2020-03-28,Italy,NA,Emilia-Romagna,4459477,795,77,12383,1344
2020-03-29,Italy,NA,Emilia-Romagna,4459477,736,99,13119,1443
2020-03-30,Italy,NA,Emilia-Romagna,4459477,412,95,13531,1538
2020-03-31,Italy,NA,Emilia-Romagna,4459477,543,106,14074,1644
2020-04-01,Italy,NA,Emilia-Romagna,4459477,713,88,14787,1732
2020-04-02,Italy,NA,Emilia-Romagna,4459477,546,79,15333,1811
2020-04-03,Italy,NA,Emilia-Romagna,4459477,599,91,15932,1902
2020-04-04,Italy,NA,Emilia-Romagna,4459477,608,75,16540,1977
2020-04-05,Italy,NA,Emilia-Romagna,4459477,549,74,17089,2051
2020-04-06,Italy,NA,Emilia-Romagna,4459477,467,57,17556,2108
2020-04-07,Italy,NA,Emilia-Romagna,4459477,269,72,17825,2180
2020-04-08,Italy,NA,Emilia-Romagna,4459477,409,54,18234,2234
2020-04-09,Italy,NA,Emilia-Romagna,4459477,443,82,18677,2316
2020-04-10,Italy,NA,Emilia-Romagna,4459477,451,81,19128,2397
2020-04-11,Italy,NA,Emilia-Romagna,4459477,507,84,19635,2481
2020-04-12,Italy,NA,Emilia-Romagna,4459477,463,83,20098,2564
2020-04-13,Italy,NA,Emilia-Romagna,4459477,342,51,20440,2615
2020-04-14,Italy,NA,Emilia-Romagna,4459477,312,90,20752,2705
2020-04-15,Italy,NA,Emilia-Romagna,4459477,277,83,21029,2788
2020-04-16,Italy,NA,Emilia-Romagna,4459477,457,55,21486,2843
2020-04-17,Italy,NA,Emilia-Romagna,4459477,348,60,21834,2903
2020-04-18,Italy,NA,Emilia-Romagna,4459477,350,62,22184,2965
2020-04-19,Italy,NA,Emilia-Romagna,4459477,376,58,22560,3023
2020-04-20,Italy,NA,Emilia-Romagna,4459477,307,56,22867,3079
2020-04-21,Italy,NA,Emilia-Romagna,4459477,225,68,23092,3147
2020-04-22,Italy,NA,Emilia-Romagna,4459477,342,57,23434,3204
2020-04-23,Italy,NA,Emilia-Romagna,4459477,289,65,23723,3269
2020-04-24,Italy,NA,Emilia-Romagna,4459477,247,34,23970,3303
2020-04-25,Italy,NA,Emilia-Romagna,4459477,239,44,24209,3347
2020-04-26,Italy,NA,Emilia-Romagna,4459477,241,39,24450,3386
2020-04-27,Italy,NA,Emilia-Romagna,4459477,212,45,24662,3431
2020-04-28,Italy,NA,Emilia-Romagna,4459477,252,41,24914,3472
2020-04-29,Italy,NA,Emilia-Romagna,4459477,263,40,25177,3512
2020-04-30,Italy,NA,Emilia-Romagna,4459477,259,39,25436,3551
2020-05-01,Italy,NA,Emilia-Romagna,4459477,208,28,25644,3579
2020-05-02,Italy,NA,Emilia-Romagna,4459477,206,35,25850,3614
2020-05-03,Italy,NA,Emilia-Romagna,4459477,166,28,26016,3642
2020-05-04,Italy,NA,Emilia-Romagna,4459477,159,24,26175,3666
2020-05-05,Italy,NA,Emilia-Romagna,4459477,100,39,26275,3705
2020-05-06,Italy,NA,Emilia-Romagna,4459477,104,32,26379,3737
2020-05-07,Italy,NA,Emilia-Romagna,4459477,108,29,26487,3766
2020-05-08,Italy,NA,Emilia-Romagna,4459477,111,31,26598,3797
2020-05-09,Italy,NA,Emilia-Romagna,4459477,121,30,26719,3827
2020-05-10,Italy,NA,Emilia-Romagna,4459477,77,18,26796,3845
2020-05-11,Italy,NA,Emilia-Romagna,4459477,80,22,26876,3867
2020-05-12,Italy,NA,Emilia-Romagna,4459477,53,18,26929,3885
2020-05-13,Italy,NA,Emilia-Romagna,4459477,50,20,26979,3905
2020-05-14,Italy,NA,Emilia-Romagna,4459477,77,25,27056,3930
2020-05-15,Italy,NA,Emilia-Romagna,4459477,54,13,27110,3943
2020-05-16,Italy,NA,Emilia-Romagna,4459477,72,17,27182,3960
2020-05-17,Italy,NA,Emilia-Romagna,4459477,50,13,27232,3973
2020-05-18,Italy,NA,Emilia-Romagna,4459477,35,13,27267,3986
2020-05-19,Italy,NA,Emilia-Romagna,4459477,47,11,27314,3997
2020-05-20,Italy,NA,Emilia-Romagna,4459477,50,11,27364,4008
2020-05-21,Italy,NA,Emilia-Romagna,4459477,53,17,27417,4025
2020-05-22,Italy,NA,Emilia-Romagna,4459477,53,12,27470,4037
2020-05-23,Italy,NA,Emilia-Romagna,4459477,43,10,27513,4047
2020-05-24,Italy,NA,Emilia-Romagna,4459477,45,8,27558,4055
2020-05-25,Italy,NA,Emilia-Romagna,4459477,29,13,27587,4068
2020-05-26,Italy,NA,Emilia-Romagna,4459477,24,8,27611,4076
2020-05-27,Italy,NA,Emilia-Romagna,4459477,16,7,27627,4083
2020-05-28,Italy,NA,Emilia-Romagna,4459477,74,11,27701,4094
2020-05-29,Italy,NA,Emilia-Romagna,4459477,38,8,27739,4102
2020-05-30,Italy,NA,Emilia-Romagna,4459477,20,5,27759,4107
2020-05-31,Italy,NA,Emilia-Romagna,4459477,31,7,27790,4114
2020-06-01,Italy,NA,Emilia-Romagna,4459477,19,10,27809,4124
2020-06-02,Italy,NA,Emilia-Romagna,4459477,19,12,27828,4136
2020-06-03,Italy,NA,Emilia-Romagna,4459477,14,11,27842,4147
2020-06-04,Italy,NA,Emilia-Romagna,4459477,18,7,27860,4154
2020-06-05,Italy,NA,Emilia-Romagna,4459477,17,13,27877,4167
2020-06-06,Italy,NA,Emilia-Romagna,4459477,17,4,27894,4171
2020-06-07,Italy,NA,Emilia-Romagna,4459477,14,4,27908,4175
2020-06-08,Italy,NA,Emilia-Romagna,4459477,20,4,27928,4179
2020-06-09,Italy,NA,Emilia-Romagna,4459477,18,6,27946,4185
2020-06-10,Italy,NA,Emilia-Romagna,4459477,24,7,27970,4192
2020-06-11,Italy,NA,Emilia-Romagna,4459477,25,0,27995,4192
2020-06-12,Italy,NA,Emilia-Romagna,4459477,33,4,28028,4196
2020-06-13,Italy,NA,Emilia-Romagna,4459477,28,3,28056,4199
2020-06-14,Italy,NA,Emilia-Romagna,4459477,17,5,28073,4204
2020-06-15,Italy,NA,Emilia-Romagna,4459477,11,3,28084,4207
2020-06-16,Italy,NA,Emilia-Romagna,4459477,13,2,28097,4209
2020-06-17,Italy,NA,Emilia-Romagna,4459477,14,6,28111,4215
2020-06-18,Italy,NA,Emilia-Romagna,4459477,32,4,28143,4219
2020-06-19,Italy,NA,Emilia-Romagna,4459477,27,5,28170,4224
2020-06-20,Italy,NA,Emilia-Romagna,4459477,28,6,28198,4230
2020-06-21,Italy,NA,Emilia-Romagna,4459477,23,1,28221,4231
2020-06-22,Italy,NA,Emilia-Romagna,4459477,22,4,28243,4235
2020-06-23,Italy,NA,Emilia-Romagna,4459477,17,1,28260,4236
2020-06-24,Italy,NA,Emilia-Romagna,4459477,44,9,28304,4245
2020-06-25,Italy,NA,Emilia-Romagna,4459477,47,4,28351,4249
2020-06-26,Italy,NA,Emilia-Romagna,4459477,46,3,28393,4252
2020-06-27,Italy,NA,Emilia-Romagna,4459477,42,0,28435,4252
2020-06-28,Italy,NA,Emilia-Romagna,4459477,21,1,28456,4253
2020-06-29,Italy,NA,Emilia-Romagna,4459477,16,2,28472,4255
2020-06-30,Italy,NA,Emilia-Romagna,4459477,20,5,28492,4260
2020-07-01,Italy,NA,Emilia-Romagna,4459477,16,4,28508,4264
2020-07-02,Italy,NA,Emilia-Romagna,4459477,27,1,28535,4265
2020-07-03,Italy,NA,Emilia-Romagna,4459477,27,2,28562,4267
2020-07-04,Italy,NA,Emilia-Romagna,4459477,51,0,28613,4267
2020-07-05,Italy,NA,Emilia-Romagna,4459477,24,1,28637,4268
2020-07-06,Italy,NA,Emilia-Romagna,4459477,38,0,28675,4268
2020-07-07,Italy,NA,Emilia-Romagna,4459477,31,1,28706,4269
2020-07-08,Italy,NA,Emilia-Romagna,4459477,49,0,28755,4269
2020-07-09,Italy,NA,Emilia-Romagna,4459477,29,0,28769,4269
2020-07-10,Italy,NA,Emilia-Romagna,4459477,53,0,28822,4269
2020-07-11,Italy,NA,Emilia-Romagna,4459477,47,0,28869,4269
2020-07-12,Italy,NA,Emilia-Romagna,4459477,71,0,28940,4269
2020-07-13,Italy,NA,Emilia-Romagna,4459477,18,0,28958,4269
2020-07-14,Italy,NA,Emilia-Romagna,4459477,13,2,28971,4271
2020-07-15,Italy,NA,Emilia-Romagna,4459477,18,0,28989,4271
2020-07-16,Italy,NA,Emilia-Romagna,4459477,46,0,29035,4271
2020-07-17,Italy,NA,Emilia-Romagna,4459477,54,2,29087,4273
2020-07-18,Italy,NA,Emilia-Romagna,4459477,40,1,29127,4274
2020-07-19,Italy,NA,Emilia-Romagna,4459477,51,0,29178,4274
2020-07-20,Italy,NA,Emilia-Romagna,4459477,42,3,29220,4277
2020-07-21,Italy,NA,Emilia-Romagna,4459477,18,2,29238,4279
2020-07-22,Italy,NA,Emilia-Romagna,4459477,57,2,29295,4281
2020-07-23,Italy,NA,Emilia-Romagna,4459477,55,0,29350,4281
2020-07-24,Italy,NA,Emilia-Romagna,4459477,63,2,29413,4283
2020-07-25,Italy,NA,Emilia-Romagna,4459477,49,1,29461,4284
2020-07-26,Italy,NA,Emilia-Romagna,4459477,61,1,29522,4285
2020-07-27,Italy,NA,Emilia-Romagna,4459477,33,0,29555,4285
2020-07-28,Italy,NA,Emilia-Romagna,4459477,20,1,29575,4286
2020-07-29,Italy,NA,Emilia-Romagna,4459477,28,1,29603,4287
2020-07-30,Italy,NA,Emilia-Romagna,4459477,35,2,29634,4289
2020-07-31,Italy,NA,Emilia-Romagna,4459477,36,0,29670,4289
2020-08-01,Italy,NA,Emilia-Romagna,4459477,56,2,29726,4291
2020-08-02,Italy,NA,Emilia-Romagna,4459477,49,0,29774,4291
2020-08-03,Italy,NA,Emilia-Romagna,4459477,34,0,29808,4291
2020-08-04,Italy,NA,Emilia-Romagna,4459477,42,0,29850,4291
2020-08-05,Italy,NA,Emilia-Romagna,4459477,47,0,29897,4291
2020-08-06,Italy,NA,Emilia-Romagna,4459477,58,0,29954,4291
2020-08-07,Italy,NA,Emilia-Romagna,4459477,54,1,30008,4292
2020-08-08,Italy,NA,Emilia-Romagna,4459477,44,2,30052,4294
2020-08-09,Italy,NA,Emilia-Romagna,4459477,69,1,30121,4295
2020-08-10,Italy,NA,Emilia-Romagna,4459477,39,1,30160,4296
2020-08-11,Italy,NA,Emilia-Romagna,4459477,19,2,30179,4298
2020-08-12,Italy,NA,Emilia-Romagna,4459477,41,0,30220,4298
2020-08-13,Italy,NA,Emilia-Romagna,4459477,37,0,30257,4298
2020-08-14,Italy,NA,Emilia-Romagna,4459477,57,0,30314,4298
2020-08-15,Italy,NA,Emilia-Romagna,4459477,71,155,30385,4453
2020-08-16,Italy,NA,Emilia-Romagna,4459477,51,0,30436,4453
2020-08-17,Italy,NA,Emilia-Romagna,4459477,41,0,30477,4453
2020-08-18,Italy,NA,Emilia-Romagna,4459477,21,1,30498,4454
2020-08-19,Italy,NA,Emilia-Romagna,4459477,76,1,30574,4455
2020-08-20,Italy,NA,Emilia-Romagna,4459477,52,0,30626,4455
2020-08-21,Italy,NA,Emilia-Romagna,4459477,82,0,30708,4455
2020-08-22,Italy,NA,Emilia-Romagna,4459477,80,0,30788,4455
2020-08-23,Italy,NA,Emilia-Romagna,4459477,127,1,30915,4456
2020-08-24,Italy,NA,Emilia-Romagna,4459477,116,2,31031,4458
2020-08-25,Italy,NA,Emilia-Romagna,4459477,65,0,31094,4458
2020-08-26,Italy,NA,Emilia-Romagna,4459477,120,0,31214,4458
2020-08-27,Italy,NA,Emilia-Romagna,4459477,171,0,31385,4458
2020-08-28,Italy,NA,Emilia-Romagna,4459477,164,1,31547,4459
2020-08-29,Italy,NA,Emilia-Romagna,4459477,149,0,31696,4459
2020-08-30,Italy,NA,Emilia-Romagna,4459477,109,0,31805,4459
2020-08-31,Italy,NA,Emilia-Romagna,4459477,117,4,31922,4463
2020-09-01,Italy,NA,Emilia-Romagna,4459477,99,0,32021,4463
2020-09-02,Italy,NA,Emilia-Romagna,4459477,107,0,32128,4463
2020-09-03,Italy,NA,Emilia-Romagna,4459477,118,0,32246,4463
2020-09-04,Italy,NA,Emilia-Romagna,4459477,126,0,32371,4463
2020-09-05,Italy,NA,Emilia-Romagna,4459477,133,0,32504,4463
2020-09-06,Italy,NA,Emilia-Romagna,4459477,124,1,32628,4464
2020-09-07,Italy,NA,Emilia-Romagna,4459477,132,0,32760,4464
2020-09-08,Italy,NA,Emilia-Romagna,4459477,94,1,32854,4465
2020-09-09,Italy,NA,Emilia-Romagna,4459477,110,2,32963,4467
2020-09-10,Italy,NA,Emilia-Romagna,4459477,110,1,33073,4468
2020-09-11,Italy,NA,Emilia-Romagna,4459477,152,0,33225,4468
2020-09-12,Italy,NA,Emilia-Romagna,4459477,138,1,33363,4469
2020-09-13,Italy,NA,Emilia-Romagna,4459477,143,0,33504,4469
2020-09-14,Italy,NA,Emilia-Romagna,4459477,127,0,33631,4469
2020-09-15,Italy,NA,Emilia-Romagna,4459477,125,1,33756,4470
2020-09-16,Italy,NA,Emilia-Romagna,4459477,106,0,33862,4470
2020-09-17,Italy,NA,Emilia-Romagna,4459477,110,1,33972,4471
2020-09-18,Italy,NA,Emilia-Romagna,4459477,121,1,34093,4472
2020-09-19,Italy,NA,Emilia-Romagna,4459477,133,2,34225,4474
2020-09-20,Italy,NA,Emilia-Romagna,4459477,115,2,34340,4476
2020-09-21,Italy,NA,Emilia-Romagna,4459477,116,1,34456,4477
2020-09-22,Italy,NA,Emilia-Romagna,4459477,56,1,34511,4478
2020-09-23,Italy,NA,Emilia-Romagna,4459477,101,1,34612,4479
2020-03-03,Italy,NA,Friuli Venezia Giulia,1215220,4,0,13,0
2020-03-04,Italy,NA,Friuli Venezia Giulia,1215220,5,0,18,0
2020-03-05,Italy,NA,Friuli Venezia Giulia,1215220,3,0,21,0
2020-03-06,Italy,NA,Friuli Venezia Giulia,1215220,10,0,31,0
2020-03-07,Italy,NA,Friuli Venezia Giulia,1215220,11,0,42,0
2020-03-08,Italy,NA,Friuli Venezia Giulia,1215220,15,1,57,1
2020-03-09,Italy,NA,Friuli Venezia Giulia,1215220,36,0,93,1
2020-03-10,Italy,NA,Friuli Venezia Giulia,1215220,23,2,116,3
2020-03-11,Italy,NA,Friuli Venezia Giulia,1215220,10,3,126,6
2020-03-12,Italy,NA,Friuli Venezia Giulia,1215220,41,2,167,8
2020-03-13,Italy,NA,Friuli Venezia Giulia,1215220,90,2,257,10
2020-03-14,Italy,NA,Friuli Venezia Giulia,1215220,44,3,301,13
2020-03-15,Italy,NA,Friuli Venezia Giulia,1215220,46,1,347,14
2020-03-16,Italy,NA,Friuli Venezia Giulia,1215220,39,8,386,22
2020-03-17,Italy,NA,Friuli Venezia Giulia,1215220,8,8,394,30
2020-03-18,Italy,NA,Friuli Venezia Giulia,1215220,68,1,462,31
2020-03-19,Italy,NA,Friuli Venezia Giulia,1215220,137,5,599,36
2020-03-20,Italy,NA,Friuli Venezia Giulia,1215220,57,2,656,38
2020-03-21,Italy,NA,Friuli Venezia Giulia,1215220,134,4,790,42
2020-03-22,Italy,NA,Friuli Venezia Giulia,1215220,84,5,874,47
2020-03-23,Italy,NA,Friuli Venezia Giulia,1215220,56,7,930,54
2020-03-24,Italy,NA,Friuli Venezia Giulia,1215220,62,10,992,64
2020-03-25,Italy,NA,Friuli Venezia Giulia,1215220,147,6,1139,70
2020-03-26,Italy,NA,Friuli Venezia Giulia,1215220,84,2,1223,72
2020-03-27,Italy,NA,Friuli Venezia Giulia,1215220,94,4,1317,76
2020-03-28,Italy,NA,Friuli Venezia Giulia,1215220,119,11,1436,87
2020-03-29,Italy,NA,Friuli Venezia Giulia,1215220,44,11,1480,98
2020-03-30,Italy,NA,Friuli Venezia Giulia,1215220,21,9,1501,107
2020-03-31,Italy,NA,Friuli Venezia Giulia,1215220,92,6,1593,113
2020-04-01,Italy,NA,Friuli Venezia Giulia,1215220,92,9,1685,122
2020-04-02,Italy,NA,Friuli Venezia Giulia,1215220,114,7,1799,129
2020-04-03,Italy,NA,Friuli Venezia Giulia,1215220,80,7,1879,136
2020-04-04,Italy,NA,Friuli Venezia Giulia,1215220,107,9,1986,145
2020-04-05,Italy,NA,Friuli Venezia Giulia,1215220,62,9,2048,154
2020-04-06,Italy,NA,Friuli Venezia Giulia,1215220,55,4,2103,158
2020-04-07,Italy,NA,Friuli Venezia Giulia,1215220,50,6,2153,164
2020-04-08,Italy,NA,Friuli Venezia Giulia,1215220,65,5,2218,169
2020-04-09,Italy,NA,Friuli Venezia Giulia,1215220,81,2,2299,171
2020-04-10,Italy,NA,Friuli Venezia Giulia,1215220,50,8,2349,179
2020-04-11,Italy,NA,Friuli Venezia Giulia,1215220,44,6,2393,185
2020-04-12,Italy,NA,Friuli Venezia Giulia,1215220,38,10,2431,195
2020-04-13,Italy,NA,Friuli Venezia Giulia,1215220,51,7,2482,202
2020-04-14,Italy,NA,Friuli Venezia Giulia,1215220,38,4,2520,206
2020-04-15,Italy,NA,Friuli Venezia Giulia,1215220,24,6,2544,212
2020-04-16,Italy,NA,Friuli Venezia Giulia,1215220,72,5,2616,217
2020-04-17,Italy,NA,Friuli Venezia Giulia,1215220,59,3,2675,220
2020-04-18,Italy,NA,Friuli Venezia Giulia,1215220,56,2,2731,222
2020-04-19,Italy,NA,Friuli Venezia Giulia,1215220,14,3,2745,225
2020-04-20,Italy,NA,Friuli Venezia Giulia,1215220,30,14,2775,239
2020-04-21,Italy,NA,Friuli Venezia Giulia,1215220,17,2,2792,241
2020-04-22,Italy,NA,Friuli Venezia Giulia,1215220,25,5,2817,246
2020-04-23,Italy,NA,Friuli Venezia Giulia,1215220,41,10,2858,256
2020-04-24,Italy,NA,Friuli Venezia Giulia,1215220,24,2,2882,258
2020-04-25,Italy,NA,Friuli Venezia Giulia,1215220,21,5,2903,263
2020-04-26,Italy,NA,Friuli Venezia Giulia,1215220,14,1,2917,264
2020-04-27,Italy,NA,Friuli Venezia Giulia,1215220,60,7,2977,271
2020-04-28,Italy,NA,Friuli Venezia Giulia,1215220,18,7,2995,278
2020-04-29,Italy,NA,Friuli Venezia Giulia,1215220,15,7,3010,285
2020-04-30,Italy,NA,Friuli Venezia Giulia,1215220,15,4,3025,289
2020-05-01,Italy,NA,Friuli Venezia Giulia,1215220,16,5,3041,294
2020-05-02,Italy,NA,Friuli Venezia Giulia,1215220,18,1,3059,295
2020-05-03,Italy,NA,Friuli Venezia Giulia,1215220,13,2,3072,297
2020-05-04,Italy,NA,Friuli Venezia Giulia,1215220,4,2,3076,299
2020-05-05,Italy,NA,Friuli Venezia Giulia,1215220,9,4,3085,303
2020-05-06,Italy,NA,Friuli Venezia Giulia,1215220,9,3,3094,306
2020-05-07,Italy,NA,Friuli Venezia Giulia,1215220,13,2,3107,308
2020-05-08,Italy,NA,Friuli Venezia Giulia,1215220,9,0,3116,308
2020-05-09,Italy,NA,Friuli Venezia Giulia,1215220,8,0,3124,308
2020-05-10,Italy,NA,Friuli Venezia Giulia,1215220,6,2,3130,310
2020-05-11,Italy,NA,Friuli Venezia Giulia,1215220,8,2,3138,312
2020-05-12,Italy,NA,Friuli Venezia Giulia,1215220,10,1,3148,313
2020-05-13,Italy,NA,Friuli Venezia Giulia,1215220,8,3,3156,316
2020-05-14,Italy,NA,Friuli Venezia Giulia,1215220,5,1,3161,317
2020-05-15,Italy,NA,Friuli Venezia Giulia,1215220,14,1,3175,318
2020-05-16,Italy,NA,Friuli Venezia Giulia,1215220,8,1,3183,319
2020-05-17,Italy,NA,Friuli Venezia Giulia,1215220,8,0,3191,319
2020-05-18,Italy,NA,Friuli Venezia Giulia,1215220,7,1,3198,320
2020-05-19,Italy,NA,Friuli Venezia Giulia,1215220,5,0,3203,320
2020-05-20,Italy,NA,Friuli Venezia Giulia,1215220,6,2,3209,322
2020-05-21,Italy,NA,Friuli Venezia Giulia,1215220,6,1,3215,323
2020-05-22,Italy,NA,Friuli Venezia Giulia,1215220,12,2,3227,325
2020-05-23,Italy,NA,Friuli Venezia Giulia,1215220,6,2,3233,327
2020-05-24,Italy,NA,Friuli Venezia Giulia,1215220,3,2,3236,329
2020-05-25,Italy,NA,Friuli Venezia Giulia,1215220,4,0,3240,329
2020-05-26,Italy,NA,Friuli Venezia Giulia,1215220,11,0,3251,329
2020-05-27,Italy,NA,Friuli Venezia Giulia,1215220,4,2,3255,331
2020-05-28,Italy,NA,Friuli Venezia Giulia,1215220,7,2,3262,333
2020-05-29,Italy,NA,Friuli Venezia Giulia,1215220,5,0,3267,333
2020-05-30,Italy,NA,Friuli Venezia Giulia,1215220,4,0,3271,333
2020-05-31,Italy,NA,Friuli Venezia Giulia,1215220,2,0,3273,333
2020-06-01,Italy,NA,Friuli Venezia Giulia,1215220,1,2,3274,335
2020-06-02,Italy,NA,Friuli Venezia Giulia,1215220,2,1,3276,336
2020-06-03,Italy,NA,Friuli Venezia Giulia,1215220,0,0,3276,336
2020-06-04,Italy,NA,Friuli Venezia Giulia,1215220,3,0,3279,336
2020-06-05,Italy,NA,Friuli Venezia Giulia,1215220,1,2,3280,338
2020-06-06,Italy,NA,Friuli Venezia Giulia,1215220,3,0,3283,338
2020-06-07,Italy,NA,Friuli Venezia Giulia,1215220,0,1,3283,339
2020-06-08,Italy,NA,Friuli Venezia Giulia,1215220,1,1,3284,340
2020-06-09,Italy,NA,Friuli Venezia Giulia,1215220,0,0,3284,340
2020-06-10,Italy,NA,Friuli Venezia Giulia,1215220,2,1,3286,341
2020-06-11,Italy,NA,Friuli Venezia Giulia,1215220,1,1,3287,342
2020-06-12,Italy,NA,Friuli Venezia Giulia,1215220,3,0,3290,342
2020-06-13,Italy,NA,Friuli Venezia Giulia,1215220,6,1,3296,343
2020-06-14,Italy,NA,Friuli Venezia Giulia,1215220,0,0,3296,343
2020-06-15,Italy,NA,Friuli Venezia Giulia,1215220,0,0,3296,343
2020-06-16,Italy,NA,Friuli Venezia Giulia,1215220,1,0,3297,343
2020-06-17,Italy,NA,Friuli Venezia Giulia,1215220,2,0,3299,343
2020-06-18,Italy,NA,Friuli Venezia Giulia,1215220,2,0,3301,343
2020-06-19,Italy,NA,Friuli Venezia Giulia,1215220,2,0,3303,343
2020-06-20,Italy,NA,Friuli Venezia Giulia,1215220,1,1,3304,344
2020-06-21,Italy,NA,Friuli Venezia Giulia,1215220,1,0,3305,344
2020-06-22,Italy,NA,Friuli Venezia Giulia,1215220,0,0,3305,344
2020-06-23,Italy,NA,Friuli Venezia Giulia,1215220,0,0,3305,344
2020-06-24,Italy,NA,Friuli Venezia Giulia,1215220,0,0,3305,344
2020-06-25,Italy,NA,Friuli Venezia Giulia,1215220,0,1,3305,345
2020-06-26,Italy,NA,Friuli Venezia Giulia,1215220,2,0,3307,345
2020-06-27,Italy,NA,Friuli Venezia Giulia,1215220,0,0,3307,345
2020-06-28,Italy,NA,Friuli Venezia Giulia,1215220,1,0,3308,345
2020-06-29,Italy,NA,Friuli Venezia Giulia,1215220,0,0,3308,345
2020-06-30,Italy,NA,Friuli Venezia Giulia,1215220,0,0,3308,345
2020-07-01,Italy,NA,Friuli Venezia Giulia,1215220,4,0,3312,345
2020-07-02,Italy,NA,Friuli Venezia Giulia,1215220,2,0,3314,345
2020-07-03,Italy,NA,Friuli Venezia Giulia,1215220,4,0,3318,345
2020-07-04,Italy,NA,Friuli Venezia Giulia,1215220,8,0,3326,345
2020-07-05,Italy,NA,Friuli Venezia Giulia,1215220,0,0,3326,345
2020-07-06,Italy,NA,Friuli Venezia Giulia,1215220,0,0,3326,345
2020-07-07,Italy,NA,Friuli Venezia Giulia,1215220,1,0,3327,345
2020-07-08,Italy,NA,Friuli Venezia Giulia,1215220,4,0,3331,345
2020-07-09,Italy,NA,Friuli Venezia Giulia,1215220,1,0,3332,345
2020-07-10,Italy,NA,Friuli Venezia Giulia,1215220,1,0,3333,345
2020-07-11,Italy,NA,Friuli Venezia Giulia,1215220,2,0,3335,345
2020-07-12,Italy,NA,Friuli Venezia Giulia,1215220,0,0,3335,345
2020-07-13,Italy,NA,Friuli Venezia Giulia,1215220,0,0,3335,345
2020-07-14,Italy,NA,Friuli Venezia Giulia,1215220,3,0,3338,345
2020-07-15,Italy,NA,Friuli Venezia Giulia,1215220,1,0,3339,345
2020-07-16,Italy,NA,Friuli Venezia Giulia,1215220,4,0,3343,345
2020-07-17,Italy,NA,Friuli Venezia Giulia,1215220,3,0,3346,345
2020-07-18,Italy,NA,Friuli Venezia Giulia,1215220,4,0,3350,345
2020-07-19,Italy,NA,Friuli Venezia Giulia,1215220,2,0,3352,345
2020-07-20,Italy,NA,Friuli Venezia Giulia,1215220,4,0,3356,345
2020-07-21,Italy,NA,Friuli Venezia Giulia,1215220,2,0,3358,345
2020-07-22,Italy,NA,Friuli Venezia Giulia,1215220,2,0,3360,345
2020-07-23,Italy,NA,Friuli Venezia Giulia,1215220,3,0,3363,345
2020-07-24,Italy,NA,Friuli Venezia Giulia,1215220,5,0,3368,345
2020-07-25,Italy,NA,Friuli Venezia Giulia,1215220,5,0,3373,345
2020-07-26,Italy,NA,Friuli Venezia Giulia,1215220,2,0,3375,345
2020-07-27,Italy,NA,Friuli Venezia Giulia,1215220,0,0,3375,345
2020-07-28,Italy,NA,Friuli Venezia Giulia,1215220,0,0,3375,345
2020-07-29,Italy,NA,Friuli Venezia Giulia,1215220,3,0,3378,345
2020-07-30,Italy,NA,Friuli Venezia Giulia,1215220,13,0,3391,345
2020-07-31,Italy,NA,Friuli Venezia Giulia,1215220,3,0,3394,345
2020-08-01,Italy,NA,Friuli Venezia Giulia,1215220,7,0,3401,345
2020-08-02,Italy,NA,Friuli Venezia Giulia,1215220,10,0,3411,345
2020-08-03,Italy,NA,Friuli Venezia Giulia,1215220,0,1,3411,346
2020-08-04,Italy,NA,Friuli Venezia Giulia,1215220,5,0,3416,346
2020-08-05,Italy,NA,Friuli Venezia Giulia,1215220,9,0,3425,346
2020-08-06,Italy,NA,Friuli Venezia Giulia,1215220,7,0,3432,346
2020-08-07,Italy,NA,Friuli Venezia Giulia,1215220,4,0,3436,346
2020-08-08,Italy,NA,Friuli Venezia Giulia,1215220,6,0,3442,346
2020-08-09,Italy,NA,Friuli Venezia Giulia,1215220,7,0,3449,346
2020-08-10,Italy,NA,Friuli Venezia Giulia,1215220,0,1,3449,347
2020-08-11,Italy,NA,Friuli Venezia Giulia,1215220,3,1,3452,348
2020-08-12,Italy,NA,Friuli Venezia Giulia,1215220,9,0,3461,348
2020-08-13,Italy,NA,Friuli Venezia Giulia,1215220,15,0,3476,348
2020-08-14,Italy,NA,Friuli Venezia Giulia,1215220,8,0,3484,348
2020-08-15,Italy,NA,Friuli Venezia Giulia,1215220,15,0,3499,348
2020-08-16,Italy,NA,Friuli Venezia Giulia,1215220,8,0,3507,348
2020-08-17,Italy,NA,Friuli Venezia Giulia,1215220,5,0,3512,348
2020-08-18,Italy,NA,Friuli Venezia Giulia,1215220,10,0,3522,348
2020-08-19,Italy,NA,Friuli Venezia Giulia,1215220,11,0,3533,348
2020-08-20,Italy,NA,Friuli Venezia Giulia,1215220,14,0,3547,348
2020-08-21,Italy,NA,Friuli Venezia Giulia,1215220,36,0,3583,348
2020-08-22,Italy,NA,Friuli Venezia Giulia,1215220,33,0,3616,348
2020-08-23,Italy,NA,Friuli Venezia Giulia,1215220,24,0,3640,348
2020-08-24,Italy,NA,Friuli Venezia Giulia,1215220,2,0,3642,348
2020-08-25,Italy,NA,Friuli Venezia Giulia,1215220,9,0,3651,348
2020-08-26,Italy,NA,Friuli Venezia Giulia,1215220,33,0,3684,348
2020-08-27,Italy,NA,Friuli Venezia Giulia,1215220,25,0,3709,348
2020-08-28,Italy,NA,Friuli Venezia Giulia,1215220,19,0,3728,348
2020-08-29,Italy,NA,Friuli Venezia Giulia,1215220,20,0,3748,348
2020-08-30,Italy,NA,Friuli Venezia Giulia,1215220,16,0,3764,348
2020-08-31,Italy,NA,Friuli Venezia Giulia,1215220,5,0,3769,348
2020-09-01,Italy,NA,Friuli Venezia Giulia,1215220,17,0,3786,348
2020-09-02,Italy,NA,Friuli Venezia Giulia,1215220,20,1,3806,349
2020-09-03,Italy,NA,Friuli Venezia Giulia,1215220,25,0,3831,349
2020-09-04,Italy,NA,Friuli Venezia Giulia,1215220,23,0,3854,349
2020-09-05,Italy,NA,Friuli Venezia Giulia,1215220,49,0,3903,349
2020-09-06,Italy,NA,Friuli Venezia Giulia,1215220,20,0,3923,349
2020-09-07,Italy,NA,Friuli Venezia Giulia,1215220,11,0,3934,349
2020-09-08,Italy,NA,Friuli Venezia Giulia,1215220,12,0,3946,349
2020-09-09,Italy,NA,Friuli Venezia Giulia,1215220,54,0,4000,349
2020-09-10,Italy,NA,Friuli Venezia Giulia,1215220,39,0,4039,349
2020-09-11,Italy,NA,Friuli Venezia Giulia,1215220,34,0,4073,349
2020-09-12,Italy,NA,Friuli Venezia Giulia,1215220,39,0,4112,349
2020-09-13,Italy,NA,Friuli Venezia Giulia,1215220,45,0,4157,349
2020-09-14,Italy,NA,Friuli Venezia Giulia,1215220,4,0,4161,349
2020-09-15,Italy,NA,Friuli Venezia Giulia,1215220,20,0,4181,349
2020-09-16,Italy,NA,Friuli Venezia Giulia,1215220,29,0,4210,349
2020-09-17,Italy,NA,Friuli Venezia Giulia,1215220,63,0,4273,349
2020-09-18,Italy,NA,Friuli Venezia Giulia,1215220,39,0,4312,349
2020-09-19,Italy,NA,Friuli Venezia Giulia,1215220,33,1,4345,350
2020-09-20,Italy,NA,Friuli Venezia Giulia,1215220,32,0,4377,350
2020-09-21,Italy,NA,Friuli Venezia Giulia,1215220,13,0,4390,350
2020-09-22,Italy,NA,Friuli Venezia Giulia,1215220,14,0,4404,350
2020-09-23,Italy,NA,Friuli Venezia Giulia,1215220,57,0,4461,350
2020-03-03,Italy,NA,Lazio,5879082,7,0,14,0
2020-03-04,Italy,NA,Lazio,5879082,16,0,30,0
2020-03-05,Italy,NA,Lazio,5879082,14,0,44,0
2020-03-06,Italy,NA,Lazio,5879082,10,1,54,1
2020-03-07,Italy,NA,Lazio,5879082,22,0,76,1
2020-03-08,Italy,NA,Lazio,5879082,11,2,87,3
2020-03-09,Italy,NA,Lazio,5879082,15,2,102,5
2020-03-10,Italy,NA,Lazio,5879082,14,1,116,6
2020-03-11,Italy,NA,Lazio,5879082,34,0,150,6
2020-03-12,Italy,NA,Lazio,5879082,50,3,200,9
2020-03-13,Italy,NA,Lazio,5879082,77,2,277,11
2020-03-14,Italy,NA,Lazio,5879082,80,2,357,13
2020-03-15,Italy,NA,Lazio,5879082,79,3,436,16
2020-03-16,Italy,NA,Lazio,5879082,87,3,523,19
2020-03-17,Italy,NA,Lazio,5879082,84,4,607,23
2020-03-18,Italy,NA,Lazio,5879082,117,9,724,32
2020-03-19,Italy,NA,Lazio,5879082,99,6,823,38
2020-03-20,Italy,NA,Lazio,5879082,185,5,1008,43
2020-03-21,Italy,NA,Lazio,5879082,182,7,1190,50
2020-03-22,Italy,NA,Lazio,5879082,193,3,1383,53
2020-03-23,Italy,NA,Lazio,5879082,157,10,1540,63
2020-03-24,Italy,NA,Lazio,5879082,188,17,1728,80
2020-03-25,Italy,NA,Lazio,5879082,173,15,1901,95
2020-03-26,Italy,NA,Lazio,5879082,195,11,2096,106
2020-03-27,Italy,NA,Lazio,5879082,199,12,2295,118
2020-03-28,Italy,NA,Lazio,5879082,210,6,2505,124
2020-03-29,Italy,NA,Lazio,5879082,201,12,2706,136
2020-03-30,Italy,NA,Lazio,5879082,208,14,2914,150
2020-03-31,Italy,NA,Lazio,5879082,181,12,3095,162
2020-04-01,Italy,NA,Lazio,5879082,169,7,3264,169
2020-04-02,Italy,NA,Lazio,5879082,169,16,3433,185
2020-04-03,Italy,NA,Lazio,5879082,167,14,3600,199
2020-04-04,Italy,NA,Lazio,5879082,157,13,3757,212
2020-04-05,Italy,NA,Lazio,5879082,123,7,3880,219
2020-04-06,Italy,NA,Lazio,5879082,151,10,4031,229
2020-04-07,Italy,NA,Lazio,5879082,118,9,4149,238
2020-04-08,Italy,NA,Lazio,5879082,117,6,4266,244
2020-04-09,Italy,NA,Lazio,5879082,163,9,4429,253
2020-04-10,Italy,NA,Lazio,5879082,154,10,4583,263
2020-04-11,Italy,NA,Lazio,5879082,140,10,4723,273
2020-04-12,Italy,NA,Lazio,5879082,122,6,4845,279
2020-04-13,Italy,NA,Lazio,5879082,123,5,4968,284
2020-04-14,Italy,NA,Lazio,5879082,143,16,5111,300
2020-04-15,Italy,NA,Lazio,5879082,121,11,5232,311
2020-04-16,Italy,NA,Lazio,5879082,148,5,5380,316
2020-04-17,Italy,NA,Lazio,5879082,144,16,5524,332
2020-04-18,Italy,NA,Lazio,5879082,144,8,5668,340
2020-04-19,Italy,NA,Lazio,5879082,87,1,5755,341
2020-04-20,Italy,NA,Lazio,5879082,60,8,5815,349
2020-04-21,Italy,NA,Lazio,5879082,80,14,5895,363
2020-04-22,Italy,NA,Lazio,5879082,80,7,5975,370
2020-04-23,Italy,NA,Lazio,5879082,79,5,6054,375
2020-04-24,Italy,NA,Lazio,5879082,78,9,6132,384
2020-04-25,Italy,NA,Lazio,5879082,92,3,6224,387
2020-04-26,Italy,NA,Lazio,5879082,85,2,6309,389
2020-04-27,Italy,NA,Lazio,5879082,83,8,6392,397
2020-04-28,Italy,NA,Lazio,5879082,75,17,6467,414
2020-04-29,Italy,NA,Lazio,5879082,78,17,6545,431
2020-04-30,Italy,NA,Lazio,5879082,71,10,6616,441
2020-05-01,Italy,NA,Lazio,5879082,56,41,6672,482
2020-05-02,Italy,NA,Lazio,5879082,84,15,6756,497
2020-05-03,Italy,NA,Lazio,5879082,53,11,6809,508
2020-05-04,Italy,NA,Lazio,5879082,38,16,6847,524
2020-05-05,Italy,NA,Lazio,5879082,67,10,6914,534
2020-05-06,Italy,NA,Lazio,5879082,81,4,6995,538
2020-05-07,Italy,NA,Lazio,5879082,39,5,7034,543
2020-05-08,Italy,NA,Lazio,5879082,52,6,7086,549
2020-05-09,Italy,NA,Lazio,5879082,47,4,7133,553
2020-05-10,Italy,NA,Lazio,5879082,32,4,7165,557
2020-05-11,Italy,NA,Lazio,5879082,25,5,7190,562
2020-05-12,Italy,NA,Lazio,5879082,22,4,7212,566
2020-05-13,Italy,NA,Lazio,5879082,38,11,7250,577
2020-05-14,Italy,NA,Lazio,5879082,41,18,7291,595
2020-05-15,Italy,NA,Lazio,5879082,73,9,7364,604
2020-05-16,Italy,NA,Lazio,5879082,32,12,7396,616
2020-05-17,Italy,NA,Lazio,5879082,50,6,7446,622
2020-05-18,Italy,NA,Lazio,5879082,39,6,7485,628
2020-05-19,Italy,NA,Lazio,5879082,20,12,7505,640
2020-05-20,Italy,NA,Lazio,5879082,28,7,7533,647
2020-05-21,Italy,NA,Lazio,5879082,25,15,7558,662
2020-05-22,Italy,NA,Lazio,5879082,31,7,7589,669
2020-05-23,Italy,NA,Lazio,5879082,18,7,7607,676
2020-05-24,Italy,NA,Lazio,5879082,20,8,7627,684
2020-05-25,Italy,NA,Lazio,5879082,16,4,7643,688
2020-05-26,Italy,NA,Lazio,5879082,18,5,7661,693
2020-05-27,Italy,NA,Lazio,5879082,11,8,7672,701
2020-05-28,Italy,NA,Lazio,5879082,21,7,7693,708
2020-05-29,Italy,NA,Lazio,5879082,16,13,7709,721
2020-05-30,Italy,NA,Lazio,5879082,6,7,7715,728
2020-05-31,Italy,NA,Lazio,5879082,13,7,7728,735
2020-06-01,Italy,NA,Lazio,5879082,10,4,7738,739
2020-06-02,Italy,NA,Lazio,5879082,5,2,7743,741
2020-06-03,Italy,NA,Lazio,5879082,10,6,7753,747
2020-06-04,Italy,NA,Lazio,5879082,11,3,7764,750
2020-06-05,Italy,NA,Lazio,5879082,9,4,7773,754
2020-06-06,Italy,NA,Lazio,5879082,28,4,7801,758
2020-06-07,Italy,NA,Lazio,5879082,11,2,7812,760
2020-06-08,Italy,NA,Lazio,5879082,16,3,7828,763
2020-06-09,Italy,NA,Lazio,5879082,23,3,7851,766
2020-06-10,Italy,NA,Lazio,5879082,18,4,7869,770
2020-06-11,Italy,NA,Lazio,5879082,20,6,7889,776
2020-06-12,Italy,NA,Lazio,5879082,27,5,7916,781
2020-06-13,Italy,NA,Lazio,5879082,25,25,7941,806
2020-06-14,Italy,NA,Lazio,5879082,14,2,7955,808
2020-06-15,Italy,NA,Lazio,5879082,3,3,7958,811
2020-06-16,Italy,NA,Lazio,5879082,9,3,7967,814
2020-06-17,Italy,NA,Lazio,5879082,10,4,7977,818
2020-06-18,Italy,NA,Lazio,5879082,9,4,7986,822
2020-06-19,Italy,NA,Lazio,5879082,9,4,7995,826
2020-06-20,Italy,NA,Lazio,5879082,14,1,8009,827
2020-06-21,Italy,NA,Lazio,5879082,8,0,8017,827
2020-06-22,Italy,NA,Lazio,5879082,8,3,8025,830
2020-06-23,Italy,NA,Lazio,5879082,8,2,8033,832
2020-06-24,Italy,NA,Lazio,5879082,6,1,8039,833
2020-06-25,Italy,NA,Lazio,5879082,12,2,8051,835
2020-06-26,Italy,NA,Lazio,5879082,13,1,8064,836
2020-06-27,Italy,NA,Lazio,5879082,18,1,8082,837
2020-06-28,Italy,NA,Lazio,5879082,14,0,8096,837
2020-06-29,Italy,NA,Lazio,5879082,9,0,8105,837
2020-06-30,Italy,NA,Lazio,5879082,5,0,8110,837
2020-07-01,Italy,NA,Lazio,5879082,9,2,8119,839
2020-07-02,Italy,NA,Lazio,5879082,11,0,8130,839
2020-07-03,Italy,NA,Lazio,5879082,11,1,8141,840
2020-07-04,Italy,NA,Lazio,5879082,31,1,8172,841
2020-07-05,Italy,NA,Lazio,5879082,14,0,8186,841
2020-07-06,Italy,NA,Lazio,5879082,19,1,8205,842
2020-07-07,Italy,NA,Lazio,5879082,5,0,8210,842
2020-07-08,Italy,NA,Lazio,5879082,14,0,8224,842
2020-07-09,Italy,NA,Lazio,5879082,28,1,8252,843
2020-07-10,Italy,NA,Lazio,5879082,23,1,8275,844
2020-07-11,Italy,NA,Lazio,5879082,19,0,8294,844
2020-07-12,Italy,NA,Lazio,5879082,20,0,8314,844
2020-07-13,Italy,NA,Lazio,5879082,24,1,8338,845
2020-07-14,Italy,NA,Lazio,5879082,18,1,8356,846
2020-07-15,Italy,NA,Lazio,5879082,20,1,8376,847
2020-07-16,Italy,NA,Lazio,5879082,9,1,8385,848
2020-07-17,Italy,NA,Lazio,5879082,14,1,8399,849
2020-07-18,Italy,NA,Lazio,5879082,20,1,8419,850
2020-07-19,Italy,NA,Lazio,5879082,17,1,8436,851
2020-07-20,Italy,NA,Lazio,5879082,14,0,8450,851
2020-07-21,Italy,NA,Lazio,5879082,6,2,8456,853
2020-07-22,Italy,NA,Lazio,5879082,16,2,8472,855
2020-07-23,Italy,NA,Lazio,5879082,26,1,8498,856
2020-07-24,Italy,NA,Lazio,5879082,18,1,8516,857
2020-07-25,Italy,NA,Lazio,5879082,19,1,8535,858
2020-07-26,Italy,NA,Lazio,5879082,19,2,8554,860
2020-07-27,Italy,NA,Lazio,5879082,13,1,8567,861
2020-07-28,Italy,NA,Lazio,5879082,10,1,8577,862
2020-07-29,Italy,NA,Lazio,5879082,34,0,8611,862
2020-07-30,Italy,NA,Lazio,5879082,18,1,8629,863
2020-07-31,Italy,NA,Lazio,5879082,18,0,8647,863
2020-08-01,Italy,NA,Lazio,5879082,18,0,8665,863
2020-08-02,Italy,NA,Lazio,5879082,17,0,8682,863
2020-08-03,Italy,NA,Lazio,5879082,15,1,8697,864
2020-08-04,Italy,NA,Lazio,5879082,17,0,8714,864
2020-08-05,Italy,NA,Lazio,5879082,12,1,8726,865
2020-08-06,Italy,NA,Lazio,5879082,18,0,8744,865
2020-08-07,Italy,NA,Lazio,5879082,20,0,8764,865
2020-08-08,Italy,NA,Lazio,5879082,20,1,8784,866
2020-08-09,Italy,NA,Lazio,5879082,38,0,8822,866
2020-08-10,Italy,NA,Lazio,5879082,38,1,8860,867
2020-08-11,Italy,NA,Lazio,5879082,23,0,8883,867
2020-08-12,Italy,NA,Lazio,5879082,37,1,8920,868
2020-08-13,Italy,NA,Lazio,5879082,36,1,8956,869
2020-08-14,Italy,NA,Lazio,5879082,45,1,9001,870
2020-08-15,Italy,NA,Lazio,5879082,58,0,9059,870
2020-08-16,Italy,NA,Lazio,5879082,68,0,9127,870
2020-08-17,Italy,NA,Lazio,5879082,51,0,9178,870
2020-08-18,Italy,NA,Lazio,5879082,43,1,9221,871
2020-08-19,Italy,NA,Lazio,5879082,75,0,9296,871
2020-08-20,Italy,NA,Lazio,5879082,115,1,9411,872
2020-08-21,Italy,NA,Lazio,5879082,137,1,9548,873
2020-08-22,Italy,NA,Lazio,5879082,215,0,9763,873
2020-08-23,Italy,NA,Lazio,5879082,184,1,9947,874
2020-08-24,Italy,NA,Lazio,5879082,146,1,10093,875
2020-08-25,Italy,NA,Lazio,5879082,143,0,10236,875
2020-08-26,Italy,NA,Lazio,5879082,162,1,10398,876
2020-08-27,Italy,NA,Lazio,5879082,152,1,10550,877
2020-08-28,Italy,NA,Lazio,5879082,166,1,10716,878
2020-08-29,Italy,NA,Lazio,5879082,171,0,10887,878
2020-08-30,Italy,NA,Lazio,5879082,156,0,11043,878
2020-08-31,Italy,NA,Lazio,5879082,148,0,11191,878
2020-09-01,Italy,NA,Lazio,5879082,125,0,11316,878
2020-09-02,Italy,NA,Lazio,5879082,130,0,11446,878
2020-09-03,Italy,NA,Lazio,5879082,154,1,11600,879
2020-09-04,Italy,NA,Lazio,5879082,171,0,11771,879
2020-09-05,Italy,NA,Lazio,5879082,158,1,11929,880
2020-09-06,Italy,NA,Lazio,5879082,122,1,12051,881
2020-09-07,Italy,NA,Lazio,5879082,159,0,12210,881
2020-09-08,Italy,NA,Lazio,5879082,129,0,12339,881
2020-09-09,Italy,NA,Lazio,5879082,175,0,12514,881
2020-09-10,Italy,NA,Lazio,5879082,163,1,12677,882
2020-09-11,Italy,NA,Lazio,5879082,148,1,12825,883
2020-09-12,Italy,NA,Lazio,5879082,155,1,12980,884
2020-09-13,Italy,NA,Lazio,5879082,143,1,13123,885
2020-09-14,Italy,NA,Lazio,5879082,181,0,13304,885
2020-09-15,Italy,NA,Lazio,5879082,139,2,13443,887
2020-09-16,Italy,NA,Lazio,5879082,165,0,13608,887
2020-09-17,Italy,NA,Lazio,5879082,181,2,13789,889
2020-09-18,Italy,NA,Lazio,5879082,193,0,13982,889
2020-09-19,Italy,NA,Lazio,5879082,197,1,14179,890
2020-09-20,Italy,NA,Lazio,5879082,165,0,14344,890
2020-09-21,Italy,NA,Lazio,5879082,198,5,14542,895
2020-09-22,Italy,NA,Lazio,5879082,238,4,14780,899
2020-09-23,Italy,NA,Lazio,5879082,195,3,14975,902
2020-02-26,Italy,NA,Liguria,1550640,10,0,11,0
2020-02-27,Italy,NA,Liguria,1550640,8,0,19,0
2020-02-28,Italy,NA,Liguria,1550640,0,0,19,0
2020-02-29,Italy,NA,Liguria,1550640,23,0,42,0
2020-03-01,Italy,NA,Liguria,1550640,0,0,42,0
2020-03-02,Italy,NA,Liguria,1550640,0,0,42,0
2020-03-03,Italy,NA,Liguria,1550640,2,1,42,1
2020-03-04,Italy,NA,Liguria,1550640,2,0,42,1
2020-03-05,Italy,NA,Liguria,1550640,2,2,42,3
2020-03-06,Italy,NA,Liguria,1550640,4,0,42,3
2020-03-07,Italy,NA,Liguria,1550640,19,1,51,4
2020-03-08,Italy,NA,Liguria,1550640,27,2,78,6
2020-03-09,Italy,NA,Liguria,1550640,31,1,109,7
2020-03-10,Italy,NA,Liguria,1550640,32,1,141,8
2020-03-11,Italy,NA,Liguria,1550640,53,0,194,8
2020-03-12,Italy,NA,Liguria,1550640,80,3,274,11
2020-03-13,Italy,NA,Liguria,1550640,71,6,345,17
2020-03-14,Italy,NA,Liguria,1550640,118,10,463,27
2020-03-15,Italy,NA,Liguria,1550640,96,6,559,33
2020-03-16,Italy,NA,Liguria,1550640,108,17,667,50
2020-03-17,Italy,NA,Liguria,1550640,111,10,778,60
2020-03-18,Italy,NA,Liguria,1550640,109,13,887,73
2020-03-19,Italy,NA,Liguria,1550640,172,18,1059,91
2020-03-20,Italy,NA,Liguria,1550640,162,28,1221,119
2020-03-21,Italy,NA,Liguria,1550640,215,33,1436,152
2020-03-22,Italy,NA,Liguria,1550640,229,19,1665,171
2020-03-23,Italy,NA,Liguria,1550640,259,41,1924,212
2020-03-24,Italy,NA,Liguria,1550640,192,19,2116,231
2020-03-25,Italy,NA,Liguria,1550640,189,23,2305,254
2020-03-26,Italy,NA,Liguria,1550640,262,26,2567,280
2020-03-27,Italy,NA,Liguria,1550640,129,51,2696,331
2020-03-28,Italy,NA,Liguria,1550640,126,27,2822,358
2020-03-29,Italy,NA,Liguria,1550640,254,19,3076,377
2020-03-30,Italy,NA,Liguria,1550640,141,20,3217,397
2020-03-31,Italy,NA,Liguria,1550640,199,31,3416,428
2020-04-01,Italy,NA,Liguria,1550640,244,32,3660,460
2020-04-02,Italy,NA,Liguria,1550640,122,28,3782,488
2020-04-03,Italy,NA,Liguria,1550640,183,31,3965,519
2020-04-04,Italy,NA,Liguria,1550640,238,23,4203,542
2020-04-05,Italy,NA,Liguria,1550640,246,14,4449,556
2020-04-06,Italy,NA,Liguria,1550640,100,39,4549,595
2020-04-07,Italy,NA,Liguria,1550640,208,25,4757,620
2020-04-08,Italy,NA,Liguria,1550640,149,34,4906,654
2020-04-09,Italy,NA,Liguria,1550640,114,28,5020,682
2020-04-10,Italy,NA,Liguria,1550640,171,27,5191,709
2020-04-11,Italy,NA,Liguria,1550640,185,25,5376,734
2020-04-12,Italy,NA,Liguria,1550640,118,15,5494,749
2020-04-13,Italy,NA,Liguria,1550640,102,11,5596,760
2020-04-14,Italy,NA,Liguria,1550640,212,33,5808,793
2020-04-15,Italy,NA,Liguria,1550640,128,14,5936,807
2020-04-16,Italy,NA,Liguria,1550640,103,21,6039,828
2020-04-17,Italy,NA,Liguria,1550640,149,38,6188,866
2020-04-18,Italy,NA,Liguria,1550640,113,31,6301,897
2020-04-19,Italy,NA,Liguria,1550640,227,31,6528,928
2020-04-20,Italy,NA,Liguria,1550640,141,29,6669,957
2020-04-21,Italy,NA,Liguria,1550640,95,33,6764,990
2020-04-22,Italy,NA,Liguria,1550640,154,32,6918,1022
2020-04-23,Italy,NA,Liguria,1550640,131,25,7049,1047
2020-04-24,Italy,NA,Liguria,1550640,124,29,7173,1076
2020-04-25,Italy,NA,Liguria,1550640,128,17,7301,1093
2020-04-26,Italy,NA,Liguria,1550640,187,21,7488,1114
2020-04-27,Italy,NA,Liguria,1550640,154,14,7642,1128
2020-04-28,Italy,NA,Liguria,1550640,130,13,7772,1141
2020-04-29,Italy,NA,Liguria,1550640,117,11,7889,1152
2020-04-30,Italy,NA,Liguria,1550640,104,15,7993,1167
2020-05-01,Italy,NA,Liguria,1550640,133,17,8126,1184
2020-05-02,Italy,NA,Liguria,1550640,186,11,8312,1195
2020-05-03,Italy,NA,Liguria,1550640,47,14,8359,1209
2020-05-04,Italy,NA,Liguria,1550640,53,12,8412,1221
2020-05-05,Italy,NA,Liguria,1550640,63,11,8475,1232
2020-05-06,Italy,NA,Liguria,1550640,76,11,8551,1243
2020-05-07,Italy,NA,Liguria,1550640,94,11,8645,1254
2020-05-08,Italy,NA,Liguria,1550640,78,11,8723,1265
2020-05-09,Italy,NA,Liguria,1550640,15,11,8738,1276
2020-05-10,Italy,NA,Liguria,1550640,50,5,8788,1281
2020-05-11,Italy,NA,Liguria,1550640,44,12,8832,1293
2020-05-12,Italy,NA,Liguria,1550640,31,8,8863,1301
2020-05-13,Italy,NA,Liguria,1550640,67,13,8930,1314
2020-05-14,Italy,NA,Liguria,1550640,65,15,8995,1329
2020-05-15,Italy,NA,Liguria,1550640,65,7,9060,1336
2020-05-16,Italy,NA,Liguria,1550640,51,10,9111,1346
2020-05-17,Italy,NA,Liguria,1550640,48,9,9159,1355
2020-05-18,Italy,NA,Liguria,1550640,32,12,9191,1367
2020-05-19,Italy,NA,Liguria,1550640,66,9,9257,1376
2020-05-20,Italy,NA,Liguria,1550640,32,10,9289,1386
2020-05-21,Italy,NA,Liguria,1550640,55,11,9344,1397
2020-05-22,Italy,NA,Liguria,1550640,45,10,9389,1407
2020-05-23,Italy,NA,Liguria,1550640,38,7,9427,1414
2020-05-24,Italy,NA,Liguria,1550640,53,5,9480,1419
2020-05-25,Italy,NA,Liguria,1550640,17,6,9497,1425
2020-05-26,Italy,NA,Liguria,1550640,53,6,9550,1431
2020-05-27,Italy,NA,Liguria,1550640,39,7,9589,1438
2020-05-28,Italy,NA,Liguria,1550640,16,7,9605,1445
2020-05-29,Italy,NA,Liguria,1550640,14,7,9619,1452
2020-05-30,Italy,NA,Liguria,1550640,32,7,9651,1459
2020-05-31,Italy,NA,Liguria,1550640,12,6,9663,1465
2020-06-01,Italy,NA,Liguria,1550640,56,2,9719,1467
2020-06-02,Italy,NA,Liguria,1550640,15,1,9734,1468
2020-06-03,Italy,NA,Liguria,1550640,17,5,9751,1473
2020-06-04,Italy,NA,Liguria,1550640,21,6,9772,1479
2020-06-05,Italy,NA,Liguria,1550640,14,7,9786,1486
2020-06-06,Italy,NA,Liguria,1550640,13,6,9799,1492
2020-06-07,Italy,NA,Liguria,1550640,13,7,9812,1499
2020-06-08,Italy,NA,Liguria,1550640,14,6,9826,1505
2020-06-09,Italy,NA,Liguria,1550640,8,4,9834,1509
2020-06-10,Italy,NA,Liguria,1550640,20,4,9854,1513
2020-06-11,Italy,NA,Liguria,1550640,10,1,9864,1514
2020-06-12,Italy,NA,Liguria,1550640,7,2,9871,1516
2020-06-13,Italy,NA,Liguria,1550640,4,2,9875,1518
2020-06-14,Italy,NA,Liguria,1550640,4,3,9879,1521
2020-06-15,Italy,NA,Liguria,1550640,8,4,9887,1525
2020-06-16,Italy,NA,Liguria,1550640,4,4,9891,1529
2020-06-17,Italy,NA,Liguria,1550640,5,3,9896,1532
2020-06-18,Italy,NA,Liguria,1550640,7,4,9903,1536
2020-06-19,Italy,NA,Liguria,1550640,7,4,9910,1540
2020-06-20,Italy,NA,Liguria,1550640,10,5,9920,1545
2020-06-21,Italy,NA,Liguria,1550640,7,4,9927,1549
2020-06-22,Italy,NA,Liguria,1550640,8,3,9935,1552
2020-06-23,Italy,NA,Liguria,1550640,4,1,9939,1553
2020-06-24,Italy,NA,Liguria,1550640,1,2,9940,1555
2020-06-25,Italy,NA,Liguria,1550640,14,1,9954,1556
2020-06-26,Italy,NA,Liguria,1550640,4,0,9958,1556
2020-06-27,Italy,NA,Liguria,1550640,5,1,9963,1557
2020-06-28,Italy,NA,Liguria,1550640,4,1,9967,1558
2020-06-29,Italy,NA,Liguria,1550640,7,0,9974,1558
2020-06-30,Italy,NA,Liguria,1550640,3,0,9977,1558
2020-07-01,Italy,NA,Liguria,1550640,5,0,9982,1558
2020-07-02,Italy,NA,Liguria,1550640,2,0,9984,1558
2020-07-03,Italy,NA,Liguria,1550640,3,0,9987,1558
2020-07-04,Italy,NA,Liguria,1550640,4,0,9991,1558
2020-07-05,Italy,NA,Liguria,1550640,8,0,9999,1558
2020-07-06,Italy,NA,Liguria,1550640,2,0,10001,1558
2020-07-07,Italy,NA,Liguria,1550640,2,0,10003,1558
2020-07-08,Italy,NA,Liguria,1550640,3,0,10006,1558
2020-07-09,Italy,NA,Liguria,1550640,4,0,10010,1558
2020-07-10,Italy,NA,Liguria,1550640,15,0,10025,1558
2020-07-11,Italy,NA,Liguria,1550640,6,1,10031,1559
2020-07-12,Italy,NA,Liguria,1550640,0,0,10031,1559
2020-07-13,Italy,NA,Liguria,1550640,1,0,10032,1559
2020-07-14,Italy,NA,Liguria,1550640,6,2,10038,1561
2020-07-15,Italy,NA,Liguria,1550640,4,0,10042,1561
2020-07-16,Italy,NA,Liguria,1550640,8,3,10050,1564
2020-07-17,Italy,NA,Liguria,1550640,2,1,10052,1565
2020-07-18,Italy,NA,Liguria,1550640,18,0,10070,1565
2020-07-19,Italy,NA,Liguria,1550640,23,0,10093,1565
2020-07-20,Italy,NA,Liguria,1550640,12,0,10105,1565
2020-07-21,Italy,NA,Liguria,1550640,12,0,10117,1565
2020-07-22,Italy,NA,Liguria,1550640,7,0,10124,1565
2020-07-23,Italy,NA,Liguria,1550640,15,1,10139,1566
2020-07-24,Italy,NA,Liguria,1550640,5,0,10144,1566
2020-07-25,Italy,NA,Liguria,1550640,3,0,10147,1566
2020-07-26,Italy,NA,Liguria,1550640,3,0,10150,1566
2020-07-27,Italy,NA,Liguria,1550640,24,0,10174,1566
2020-07-28,Italy,NA,Liguria,1550640,3,0,10177,1566
2020-07-29,Italy,NA,Liguria,1550640,20,0,10197,1566
2020-07-30,Italy,NA,Liguria,1550640,13,0,10210,1566
2020-07-31,Italy,NA,Liguria,1550640,4,1,10214,1567
2020-08-01,Italy,NA,Liguria,1550640,16,0,10230,1567
2020-08-02,Italy,NA,Liguria,1550640,6,0,10236,1567
2020-08-03,Italy,NA,Liguria,1550640,2,1,10238,1568
2020-08-04,Italy,NA,Liguria,1550640,5,0,10243,1568
2020-08-05,Italy,NA,Liguria,1550640,7,0,10250,1568
2020-08-06,Italy,NA,Liguria,1550640,13,0,10263,1568
2020-08-07,Italy,NA,Liguria,1550640,9,0,10272,1568
2020-08-08,Italy,NA,Liguria,1550640,4,1,10276,1569
2020-08-09,Italy,NA,Liguria,1550640,7,0,10283,1569
2020-08-10,Italy,NA,Liguria,1550640,10,0,10293,1569
2020-08-11,Italy,NA,Liguria,1550640,11,0,10304,1569
2020-08-12,Italy,NA,Liguria,1550640,26,0,10330,1569
2020-08-13,Italy,NA,Liguria,1550640,63,0,10393,1569
2020-08-14,Italy,NA,Liguria,1550640,20,0,10413,1569
2020-08-15,Italy,NA,Liguria,1550640,33,0,10446,1569
2020-08-16,Italy,NA,Liguria,1550640,12,0,10458,1569
2020-08-17,Italy,NA,Liguria,1550640,16,0,10474,1569
2020-08-18,Italy,NA,Liguria,1550640,27,0,10501,1569
2020-08-19,Italy,NA,Liguria,1550640,30,0,10531,1569
2020-08-20,Italy,NA,Liguria,1550640,31,2,10562,1571
2020-08-21,Italy,NA,Liguria,1550640,21,0,10583,1571
2020-08-22,Italy,NA,Liguria,1550640,34,0,10617,1571
2020-08-23,Italy,NA,Liguria,1550640,28,0,10645,1571
2020-08-24,Italy,NA,Liguria,1550640,26,0,10671,1571
2020-08-25,Italy,NA,Liguria,1550640,12,0,10683,1571
2020-08-26,Italy,NA,Liguria,1550640,41,0,10724,1571
2020-08-27,Italy,NA,Liguria,1550640,37,0,10761,1571
2020-08-28,Italy,NA,Liguria,1550640,46,0,10807,1571
2020-08-29,Italy,NA,Liguria,1550640,47,0,10854,1571
2020-08-30,Italy,NA,Liguria,1550640,53,0,10907,1571
2020-08-31,Italy,NA,Liguria,1550640,44,0,10951,1571
2020-09-01,Italy,NA,Liguria,1550640,19,0,10970,1571
2020-09-02,Italy,NA,Liguria,1550640,47,0,11017,1571
2020-09-03,Italy,NA,Liguria,1550640,22,1,11039,1572
2020-09-04,Italy,NA,Liguria,1550640,47,0,11086,1572
2020-09-05,Italy,NA,Liguria,1550640,95,1,11181,1573
2020-09-06,Italy,NA,Liguria,1550640,111,2,11292,1575
2020-09-07,Italy,NA,Liguria,1550640,59,2,11351,1577
2020-09-08,Italy,NA,Liguria,1550640,64,1,11415,1578
2020-09-09,Italy,NA,Liguria,1550640,51,1,11466,1579
2020-09-10,Italy,NA,Liguria,1550640,114,0,11580,1579
2020-09-11,Italy,NA,Liguria,1550640,82,0,11662,1579
2020-09-12,Italy,NA,Liguria,1550640,112,0,11774,1579
2020-09-13,Italy,NA,Liguria,1550640,78,0,11852,1579
2020-09-14,Italy,NA,Liguria,1550640,65,3,11917,1582
2020-09-15,Italy,NA,Liguria,1550640,141,0,12058,1582
2020-09-16,Italy,NA,Liguria,1550640,73,1,12131,1583
2020-09-17,Italy,NA,Liguria,1550640,40,3,12171,1586
2020-09-18,Italy,NA,Liguria,1550640,158,0,12329,1586
2020-09-19,Italy,NA,Liguria,1550640,78,2,12407,1588
2020-09-20,Italy,NA,Liguria,1550640,85,3,12492,1591
2020-09-21,Italy,NA,Liguria,1550640,64,0,12556,1591
2020-09-22,Italy,NA,Liguria,1550640,105,1,12661,1592
2020-09-23,Italy,NA,Liguria,1550640,108,2,12769,1594
2020-02-24,Italy,NA,Lombardy,10060574,166,0,172,6
2020-02-25,Italy,NA,Lombardy,10060574,68,3,240,9
2020-02-26,Italy,NA,Lombardy,10060574,18,0,258,9
2020-02-27,Italy,NA,Lombardy,10060574,145,5,403,14
2020-02-28,Italy,NA,Lombardy,10060574,128,3,531,17
2020-02-29,Italy,NA,Lombardy,10060574,84,6,615,23
2020-03-01,Italy,NA,Lombardy,10060574,369,1,984,24
2020-03-02,Italy,NA,Lombardy,10060574,270,14,1254,38
2020-03-03,Italy,NA,Lombardy,10060574,266,17,1520,55
2020-03-04,Italy,NA,Lombardy,10060574,300,18,1820,73
2020-03-05,Italy,NA,Lombardy,10060574,431,25,2251,98
2020-03-06,Italy,NA,Lombardy,10060574,361,37,2612,135
2020-03-07,Italy,NA,Lombardy,10060574,808,19,3420,154
2020-03-08,Italy,NA,Lombardy,10060574,769,113,4189,267
2020-03-09,Italy,NA,Lombardy,10060574,1280,66,5469,333
2020-03-10,Italy,NA,Lombardy,10060574,322,135,5791,468
2020-03-11,Italy,NA,Lombardy,10060574,1489,149,7280,617
2020-03-12,Italy,NA,Lombardy,10060574,1445,127,8725,744
2020-03-13,Italy,NA,Lombardy,10060574,1095,146,9820,890
2020-03-14,Italy,NA,Lombardy,10060574,1865,76,11685,966
2020-03-15,Italy,NA,Lombardy,10060574,1587,252,13272,1218
2020-03-16,Italy,NA,Lombardy,10060574,1377,202,14649,1420
2020-03-17,Italy,NA,Lombardy,10060574,1571,220,16220,1640
2020-03-18,Italy,NA,Lombardy,10060574,1493,319,17713,1959
2020-03-19,Italy,NA,Lombardy,10060574,2171,209,19884,2168
2020-03-20,Italy,NA,Lombardy,10060574,2380,381,22264,2549
2020-03-21,Italy,NA,Lombardy,10060574,3251,546,25515,3095
2020-03-22,Italy,NA,Lombardy,10060574,1691,361,27206,3456
2020-03-23,Italy,NA,Lombardy,10060574,1555,320,28761,3776
2020-03-24,Italy,NA,Lombardy,10060574,1942,402,30703,4178
2020-03-25,Italy,NA,Lombardy,10060574,1643,296,32346,4474
2020-03-26,Italy,NA,Lombardy,10060574,2543,387,34889,4861
2020-03-27,Italy,NA,Lombardy,10060574,2409,541,37298,5402
2020-03-28,Italy,NA,Lombardy,10060574,2117,542,39415,5944
2020-03-29,Italy,NA,Lombardy,10060574,1592,416,41007,6360
2020-03-30,Italy,NA,Lombardy,10060574,1154,458,42161,6818
2020-03-31,Italy,NA,Lombardy,10060574,1047,381,43208,7199
2020-04-01,Italy,NA,Lombardy,10060574,1565,394,44773,7593
2020-04-02,Italy,NA,Lombardy,10060574,1292,367,46065,7960
2020-04-03,Italy,NA,Lombardy,10060574,1455,351,47520,8311
2020-04-04,Italy,NA,Lombardy,10060574,1598,345,49118,8656
2020-04-05,Italy,NA,Lombardy,10060574,1337,249,50455,8905
2020-04-06,Italy,NA,Lombardy,10060574,1079,297,51534,9202
2020-04-07,Italy,NA,Lombardy,10060574,791,282,52325,9484
2020-04-08,Italy,NA,Lombardy,10060574,1089,238,53414,9722
2020-04-09,Italy,NA,Lombardy,10060574,1388,300,54802,10022
2020-04-10,Italy,NA,Lombardy,10060574,1246,216,56048,10238
2020-04-11,Italy,NA,Lombardy,10060574,1544,273,57592,10511
2020-04-12,Italy,NA,Lombardy,10060574,1460,110,59052,10621
2020-04-13,Italy,NA,Lombardy,10060574,1262,280,60314,10901
2020-04-14,Italy,NA,Lombardy,10060574,1012,241,61326,11142
2020-04-15,Italy,NA,Lombardy,10060574,827,235,62153,11377
2020-04-16,Italy,NA,Lombardy,10060574,941,231,63094,11608
2020-04-17,Italy,NA,Lombardy,10060574,1041,243,64135,11851
2020-04-18,Italy,NA,Lombardy,10060574,1246,199,65381,12050
2020-04-19,Italy,NA,Lombardy,10060574,855,163,66236,12213
2020-04-20,Italy,NA,Lombardy,10060574,735,163,66971,12376
2020-04-21,Italy,NA,Lombardy,10060574,960,203,67931,12579
2020-04-22,Italy,NA,Lombardy,10060574,1161,161,69092,12740
2020-04-23,Italy,NA,Lombardy,10060574,1073,200,70165,12940
2020-04-24,Italy,NA,Lombardy,10060574,1091,166,71256,13106
2020-04-25,Italy,NA,Lombardy,10060574,713,163,71969,13269
2020-04-26,Italy,NA,Lombardy,10060574,920,56,72889,13325
2020-04-27,Italy,NA,Lombardy,10060574,590,124,73479,13449
2020-04-28,Italy,NA,Lombardy,10060574,869,126,74348,13575
2020-04-29,Italy,NA,Lombardy,10060574,786,104,75134,13679
2020-04-30,Italy,NA,Lombardy,10060574,598,93,75732,13772
2020-05-01,Italy,NA,Lombardy,10060574,737,88,76469,13860
2020-05-02,Italy,NA,Lombardy,10060574,533,329,77002,14189
2020-05-03,Italy,NA,Lombardy,10060574,526,42,77528,14231
2020-05-04,Italy,NA,Lombardy,10060574,577,63,78105,14294
2020-05-05,Italy,NA,Lombardy,10060574,500,95,78605,14389
2020-05-06,Italy,NA,Lombardy,10060574,764,222,79369,14611
2020-05-07,Italy,NA,Lombardy,10060574,720,134,80089,14745
2020-05-08,Italy,NA,Lombardy,10060574,634,94,80723,14839
2020-05-09,Italy,NA,Lombardy,10060574,502,85,81225,14924
2020-05-10,Italy,NA,Lombardy,10060574,282,62,81507,14986
2020-05-11,Italy,NA,Lombardy,10060574,364,68,81871,15054
2020-05-12,Italy,NA,Lombardy,10060574,1033,62,82904,15116
2020-05-13,Italy,NA,Lombardy,10060574,394,69,83298,15185
2020-05-14,Italy,NA,Lombardy,10060574,522,111,83820,15296
2020-05-15,Italy,NA,Lombardy,10060574,299,115,84119,15411
2020-05-16,Italy,NA,Lombardy,10060574,399,39,84518,15450
2020-05-17,Italy,NA,Lombardy,10060574,326,69,84844,15519
2020-05-18,Italy,NA,Lombardy,10060574,175,24,85019,15543
2020-05-19,Italy,NA,Lombardy,10060574,462,54,85481,15597
2020-05-20,Italy,NA,Lombardy,10060574,294,65,85775,15662
2020-05-21,Italy,NA,Lombardy,10060574,316,65,86091,15727
2020-05-22,Italy,NA,Lombardy,10060574,293,57,86384,15784
2020-05-23,Italy,NA,Lombardy,10060574,441,56,86825,15840
2020-05-24,Italy,NA,Lombardy,10060574,285,0,87110,15840
2020-05-25,Italy,NA,Lombardy,10060574,148,34,87258,15874
2020-05-26,Italy,NA,Lombardy,10060574,159,22,87417,15896
2020-05-27,Italy,NA,Lombardy,10060574,384,58,87801,15954
2020-05-28,Italy,NA,Lombardy,10060574,382,20,88183,15974
2020-05-29,Italy,NA,Lombardy,10060574,354,38,88537,16012
2020-05-30,Italy,NA,Lombardy,10060574,221,67,88758,16079
2020-05-31,Italy,NA,Lombardy,10060574,210,33,88968,16112
2020-06-01,Italy,NA,Lombardy,10060574,50,19,89018,16131
2020-06-02,Italy,NA,Lombardy,10060574,187,12,89205,16143
2020-06-03,Italy,NA,Lombardy,10060574,237,29,89442,16172
2020-06-04,Italy,NA,Lombardy,10060574,84,29,89526,16201
2020-06-05,Italy,NA,Lombardy,10060574,402,21,89928,16222
2020-06-06,Italy,NA,Lombardy,10060574,142,27,90070,16249
2020-06-07,Italy,NA,Lombardy,10060574,125,21,90195,16270
2020-06-08,Italy,NA,Lombardy,10060574,194,32,90389,16302
2020-06-09,Italy,NA,Lombardy,10060574,192,15,90581,16317
2020-06-10,Italy,NA,Lombardy,10060574,99,32,90680,16349
2020-06-11,Italy,NA,Lombardy,10060574,252,25,90932,16374
2020-06-12,Italy,NA,Lombardy,10060574,272,31,91204,16405
2020-06-13,Italy,NA,Lombardy,10060574,210,23,91414,16428
2020-06-14,Italy,NA,Lombardy,10060574,244,21,91658,16449
2020-06-15,Italy,NA,Lombardy,10060574,259,8,91917,16457
2020-06-16,Italy,NA,Lombardy,10060574,143,9,92060,16466
2020-06-17,Italy,NA,Lombardy,10060574,242,14,92302,16480
2020-06-18,Italy,NA,Lombardy,10060574,216,36,92518,16516
2020-06-19,Italy,NA,Lombardy,10060574,157,18,92675,16534
2020-06-20,Italy,NA,Lombardy,10060574,165,23,92840,16557
2020-06-21,Italy,NA,Lombardy,10060574,128,13,92968,16570
2020-06-22,Italy,NA,Lombardy,10060574,143,3,93111,16573
2020-06-23,Italy,NA,Lombardy,10060574,62,6,93173,16579
2020-06-24,Italy,NA,Lombardy,10060574,88,7,93261,16586
2020-06-25,Italy,NA,Lombardy,10060574,170,22,93431,16608
2020-06-26,Italy,NA,Lombardy,10060574,156,16,93587,16624
2020-06-27,Italy,NA,Lombardy,10060574,77,2,93664,16626
2020-06-28,Italy,NA,Lombardy,10060574,97,13,93761,16639
2020-06-29,Italy,NA,Lombardy,10060574,78,1,93839,16640
2020-06-30,Italy,NA,Lombardy,10060574,62,4,93901,16644
2020-07-01,Italy,NA,Lombardy,10060574,109,6,94010,16650
2020-07-02,Italy,NA,Lombardy,10060574,98,21,94108,16671
2020-07-03,Italy,NA,Lombardy,10060574,115,4,94223,16675
2020-07-04,Italy,NA,Lombardy,10060574,95,16,94318,16691
2020-07-05,Italy,NA,Lombardy,10060574,98,6,94416,16697
2020-07-06,Italy,NA,Lombardy,10060574,111,3,94527,16700
2020-07-07,Italy,NA,Lombardy,10060574,53,13,94580,16713
2020-07-08,Italy,NA,Lombardy,10060574,71,12,94651,16725
2020-07-09,Italy,NA,Lombardy,10060574,119,5,94770,16730
2020-07-10,Italy,NA,Lombardy,10060574,135,6,94905,16736
2020-07-11,Italy,NA,Lombardy,10060574,67,4,94972,16740
2020-07-12,Italy,NA,Lombardy,10060574,77,8,95049,16748
2020-07-13,Italy,NA,Lombardy,10060574,94,9,95143,16757
2020-07-14,Italy,NA,Lombardy,10060574,30,3,95173,16760
2020-07-15,Italy,NA,Lombardy,10060574,63,5,95236,16765
2020-07-16,Italy,NA,Lombardy,10060574,80,10,95316,16775
2020-07-17,Italy,NA,Lombardy,10060574,55,3,95371,16778
2020-07-18,Italy,NA,Lombardy,10060574,88,10,95459,16788
2020-07-19,Italy,NA,Lombardy,10060574,33,0,95492,16788
2020-07-20,Italy,NA,Lombardy,10060574,56,8,95548,16796
2020-07-21,Italy,NA,Lombardy,10060574,34,1,95582,16797
2020-07-22,Italy,NA,Lombardy,10060574,51,1,95633,16798
2020-07-23,Italy,NA,Lombardy,10060574,82,3,95715,16801
2020-07-24,Italy,NA,Lombardy,10060574,53,0,95768,16801
2020-07-25,Italy,NA,Lombardy,10060574,79,0,95847,16801
2020-07-26,Italy,NA,Lombardy,10060574,74,0,95921,16801
2020-07-27,Italy,NA,Lombardy,10060574,34,0,95955,16801
2020-07-28,Italy,NA,Lombardy,10060574,53,1,96008,16802
2020-07-29,Italy,NA,Lombardy,10060574,46,0,96054,16802
2020-07-30,Italy,NA,Lombardy,10060574,88,0,96142,16802
2020-07-31,Italy,NA,Lombardy,10060574,77,4,96219,16806
2020-08-01,Italy,NA,Lombardy,10060574,55,1,96274,16807
2020-08-02,Italy,NA,Lombardy,10060574,38,8,96312,16815
2020-08-03,Italy,NA,Lombardy,10060574,25,3,96337,16818
2020-08-04,Italy,NA,Lombardy,10060574,44,1,96381,16819
2020-08-05,Italy,NA,Lombardy,10060574,138,5,96519,16824
2020-08-06,Italy,NA,Lombardy,10060574,118,5,96637,16829
2020-08-07,Italy,NA,Lombardy,10060574,69,0,96706,16829
2020-08-08,Italy,NA,Lombardy,10060574,76,3,96782,16832
2020-08-09,Italy,NA,Lombardy,10060574,71,1,96853,16833
2020-08-10,Italy,NA,Lombardy,10060574,31,0,96884,16833
2020-08-11,Italy,NA,Lombardy,10060574,68,0,96952,16833
2020-08-12,Italy,NA,Lombardy,10060574,102,0,97054,16833
2020-08-13,Italy,NA,Lombardy,10060574,74,2,97128,16835
2020-08-14,Italy,NA,Lombardy,10060574,97,1,97225,16836
2020-08-15,Italy,NA,Lombardy,10060574,94,1,97319,16837
2020-08-16,Italy,NA,Lombardy,10060574,61,3,97380,16840
2020-08-17,Italy,NA,Lombardy,10060574,43,0,97423,16840
2020-08-18,Italy,NA,Lombardy,10060574,50,0,97473,16840
2020-08-19,Italy,NA,Lombardy,10060574,91,4,97564,16844
2020-08-20,Italy,NA,Lombardy,10060574,154,2,97718,16846
2020-08-21,Italy,NA,Lombardy,10060574,174,6,97892,16852
2020-08-22,Italy,NA,Lombardy,10060574,185,0,98077,16852
2020-08-23,Italy,NA,Lombardy,10060574,239,4,98316,16856
2020-08-24,Italy,NA,Lombardy,10060574,110,1,98426,16857
2020-08-25,Italy,NA,Lombardy,10060574,119,0,98545,16857
2020-08-26,Italy,NA,Lombardy,10060574,269,0,98814,16857
2020-08-27,Italy,NA,Lombardy,10060574,286,0,99100,16857
2020-08-28,Italy,NA,Lombardy,10060574,316,3,99416,16860
2020-08-29,Italy,NA,Lombardy,10060574,289,0,99705,16860
2020-08-30,Italy,NA,Lombardy,10060574,235,3,99940,16863
2020-08-31,Italy,NA,Lombardy,10060574,135,2,100075,16865
2020-09-01,Italy,NA,Lombardy,10060574,242,2,100317,16867
2020-09-02,Italy,NA,Lombardy,10060574,237,2,100554,16869
2020-09-03,Italy,NA,Lombardy,10060574,228,1,100782,16870
2020-09-04,Italy,NA,Lombardy,10060574,337,6,101119,16876
2020-09-05,Italy,NA,Lombardy,10060574,388,1,101507,16877
2020-09-06,Italy,NA,Lombardy,10060574,198,3,101705,16880
2020-09-07,Italy,NA,Lombardy,10060574,109,6,101814,16886
2020-09-08,Italy,NA,Lombardy,10060574,271,2,102085,16888
2020-09-09,Italy,NA,Lombardy,10060574,218,3,102303,16891
2020-09-10,Italy,NA,Lombardy,10060574,245,1,102548,16892
2020-09-11,Italy,NA,Lombardy,10060574,257,4,102805,16896
2020-09-12,Italy,NA,Lombardy,10060574,269,0,103074,16896
2020-09-13,Italy,NA,Lombardy,10060574,265,3,103339,16899
2020-09-14,Italy,NA,Lombardy,10060574,125,2,103464,16901
2020-09-15,Italy,NA,Lombardy,10060574,176,2,103640,16903
2020-09-16,Italy,NA,Lombardy,10060574,159,2,103799,16905
2020-09-17,Italy,NA,Lombardy,10060574,281,1,104080,16906
2020-09-18,Italy,NA,Lombardy,10060574,224,2,104304,16908
2020-09-19,Italy,NA,Lombardy,10060574,243,9,104547,16917
2020-09-20,Italy,NA,Lombardy,10060574,211,5,104758,16922
2020-09-21,Italy,NA,Lombardy,10060574,90,1,104848,16923
2020-09-22,Italy,NA,Lombardy,10060574,182,2,105030,16925
2020-09-23,Italy,NA,Lombardy,10060574,196,0,105226,16925
2020-02-29,Italy,NA,Marche,1525271,5,0,11,0
2020-03-01,Italy,NA,Marche,1525271,14,0,25,0
2020-03-02,Italy,NA,Marche,1525271,10,1,35,1
2020-03-03,Italy,NA,Marche,1525271,26,1,61,2
2020-03-04,Italy,NA,Marche,1525271,23,2,84,4
2020-03-05,Italy,NA,Marche,1525271,40,0,124,4
2020-03-06,Italy,NA,Marche,1525271,35,0,159,4
2020-03-07,Italy,NA,Marche,1525271,48,2,207,6
2020-03-08,Italy,NA,Marche,1525271,65,1,272,7
2020-03-09,Italy,NA,Marche,1525271,51,3,323,10
2020-03-10,Italy,NA,Marche,1525271,71,3,394,13
2020-03-11,Italy,NA,Marche,1525271,85,5,479,18
2020-03-12,Italy,NA,Marche,1525271,113,4,592,22
2020-03-13,Italy,NA,Marche,1525271,133,5,725,27
2020-03-14,Italy,NA,Marche,1525271,174,9,899,36
2020-03-15,Italy,NA,Marche,1525271,234,10,1133,46
2020-03-16,Italy,NA,Marche,1525271,109,11,1242,57
2020-03-17,Italy,NA,Marche,1525271,129,12,1371,69
2020-03-18,Italy,NA,Marche,1525271,197,23,1568,92
2020-03-19,Italy,NA,Marche,1525271,169,23,1737,115
2020-03-20,Italy,NA,Marche,1525271,244,22,1981,137
2020-03-21,Italy,NA,Marche,1525271,172,17,2153,154
2020-03-22,Italy,NA,Marche,1525271,268,30,2421,184
2020-03-23,Italy,NA,Marche,1525271,148,19,2569,203
2020-03-24,Italy,NA,Marche,1525271,167,28,2736,231
2020-03-25,Italy,NA,Marche,1525271,198,56,2934,287
2020-03-26,Italy,NA,Marche,1525271,180,23,3114,310
2020-03-27,Italy,NA,Marche,1525271,82,26,3196,336
2020-03-28,Italy,NA,Marche,1525271,177,28,3373,364
2020-03-29,Italy,NA,Marche,1525271,185,22,3558,386
2020-03-30,Italy,NA,Marche,1525271,126,31,3684,417
2020-03-31,Italy,NA,Marche,1525271,141,35,3825,452
2020-04-01,Italy,NA,Marche,1525271,137,25,3962,477
2020-04-02,Italy,NA,Marche,1525271,136,26,4098,503
2020-04-03,Italy,NA,Marche,1525271,132,54,4230,557
2020-04-04,Italy,NA,Marche,1525271,111,17,4341,574
2020-04-05,Italy,NA,Marche,1525271,123,25,4464,599
2020-04-06,Italy,NA,Marche,1525271,150,13,4614,612
2020-04-07,Italy,NA,Marche,1525271,96,18,4710,630
2020-04-08,Italy,NA,Marche,1525271,149,22,4859,652
2020-04-09,Italy,NA,Marche,1525271,96,17,4955,669
2020-04-10,Italy,NA,Marche,1525271,129,13,5084,682
2020-04-11,Italy,NA,Marche,1525271,127,7,5211,689
2020-04-12,Italy,NA,Marche,1525271,92,11,5303,700
2020-04-13,Italy,NA,Marche,1525271,78,13,5381,713
2020-04-14,Italy,NA,Marche,1525271,45,15,5426,728
2020-04-15,Italy,NA,Marche,1525271,77,18,5503,746
2020-04-16,Italy,NA,Marche,1525271,79,18,5582,764
2020-04-17,Italy,NA,Marche,1525271,86,21,5668,785
2020-04-18,Italy,NA,Marche,1525271,53,10,5721,795
2020-04-19,Italy,NA,Marche,1525271,48,12,5769,807
2020-04-20,Italy,NA,Marche,1525271,57,15,5826,822
2020-04-21,Italy,NA,Marche,1525271,51,12,5877,834
2020-04-22,Italy,NA,Marche,1525271,47,11,5924,845
2020-04-23,Italy,NA,Marche,1525271,28,12,5952,857
2020-04-24,Italy,NA,Marche,1525271,76,8,6028,865
2020-04-25,Italy,NA,Marche,1525271,30,9,6058,874
2020-04-26,Italy,NA,Marche,1525271,53,5,6111,879
2020-04-27,Italy,NA,Marche,1525271,16,5,6127,884
2020-04-28,Italy,NA,Marche,1525271,48,9,6175,893
2020-04-29,Italy,NA,Marche,1525271,35,6,6210,899
2020-04-30,Italy,NA,Marche,1525271,37,7,6247,906
2020-05-01,Italy,NA,Marche,1525271,28,5,6275,911
2020-05-02,Italy,NA,Marche,1525271,23,5,6298,916
2020-05-03,Italy,NA,Marche,1525271,21,11,6319,927
2020-05-04,Italy,NA,Marche,1525271,44,5,6363,932
2020-05-05,Italy,NA,Marche,1525271,29,4,6392,936
2020-05-06,Italy,NA,Marche,1525271,29,7,6421,943
2020-05-07,Italy,NA,Marche,1525271,31,5,6452,948
2020-05-08,Italy,NA,Marche,1525271,18,6,6470,954
2020-05-09,Italy,NA,Marche,1525271,23,4,6493,958
2020-05-10,Italy,NA,Marche,1525271,40,2,6533,960
2020-05-11,Italy,NA,Marche,1525271,10,4,6543,964
2020-05-12,Italy,NA,Marche,1525271,25,5,6568,969
2020-05-13,Italy,NA,Marche,1525271,20,2,6588,971
2020-05-14,Italy,NA,Marche,1525271,15,3,6603,974
2020-05-15,Italy,NA,Marche,1525271,16,3,6619,977
2020-05-16,Italy,NA,Marche,1525271,23,5,6642,982
2020-05-17,Italy,NA,Marche,1525271,25,2,6667,984
2020-05-18,Italy,NA,Marche,1525271,11,0,6678,984
2020-05-19,Italy,NA,Marche,1525271,0,2,6678,986
2020-05-20,Italy,NA,Marche,1525271,2,1,6678,987
2020-05-21,Italy,NA,Marche,1525271,12,3,6689,990
2020-05-22,Italy,NA,Marche,1525271,8,0,6697,990
2020-05-23,Italy,NA,Marche,1525271,4,3,6701,993
2020-05-24,Italy,NA,Marche,1525271,13,1,6714,994
2020-05-25,Italy,NA,Marche,1525271,2,1,6716,995
2020-05-26,Italy,NA,Marche,1525271,2,1,6718,996
2020-05-27,Italy,NA,Marche,1525271,0,0,6718,996
2020-05-28,Italy,NA,Marche,1525271,1,1,6719,997
2020-05-29,Italy,NA,Marche,1525271,4,0,6723,997
2020-05-30,Italy,NA,Marche,1525271,4,1,6727,997
2020-05-31,Italy,NA,Marche,1525271,3,0,6730,997
2020-06-01,Italy,NA,Marche,1525271,0,0,6730,997
2020-06-02,Italy,NA,Marche,1525271,4,0,6734,997
2020-06-03,Italy,NA,Marche,1525271,1,0,6735,997
2020-06-04,Italy,NA,Marche,1525271,3,1,6738,997
2020-06-05,Italy,NA,Marche,1525271,2,1,6740,997
2020-06-06,Italy,NA,Marche,1525271,2,2,6742,997
2020-06-07,Italy,NA,Marche,1525271,3,0,6745,997
2020-06-08,Italy,NA,Marche,1525271,2,0,6747,997
2020-06-09,Italy,NA,Marche,1525271,0,1,6747,997
2020-06-10,Italy,NA,Marche,1525271,3,0,6750,997
2020-06-11,Italy,NA,Marche,1525271,1,0,6751,997
2020-06-12,Italy,NA,Marche,1525271,1,1,6752,997
2020-06-13,Italy,NA,Marche,1525271,2,0,6754,997
2020-06-14,Italy,NA,Marche,1525271,4,0,6758,997
2020-06-15,Italy,NA,Marche,1525271,4,0,6762,997
2020-06-16,Italy,NA,Marche,1525271,1,1,6763,997
2020-06-17,Italy,NA,Marche,1525271,1,0,6764,997
2020-06-18,Italy,NA,Marche,1525271,4,0,6768,997
2020-06-19,Italy,NA,Marche,1525271,0,0,6768,997
2020-06-20,Italy,NA,Marche,1525271,0,0,6768,997
2020-06-21,Italy,NA,Marche,1525271,0,0,6768,997
2020-06-22,Italy,NA,Marche,1525271,3,0,6774,997
2020-06-23,Italy,NA,Marche,1525271,1,0,6775,997
2020-06-24,Italy,NA,Marche,1525271,4,0,6779,997
2020-06-25,Italy,NA,Marche,1525271,2,0,6781,997
2020-06-26,Italy,NA,Marche,1525271,2,0,6783,997
2020-06-27,Italy,NA,Marche,1525271,2,0,6785,997
2020-06-28,Italy,NA,Marche,1525271,0,0,6785,997
2020-06-29,Italy,NA,Marche,1525271,0,0,6785,997
2020-06-30,Italy,NA,Marche,1525271,0,0,6785,997
2020-07-01,Italy,NA,Marche,1525271,5,0,6786,997
2020-07-02,Italy,NA,Marche,1525271,3,0,6789,997
2020-07-03,Italy,NA,Marche,1525271,0,0,6789,997
2020-07-04,Italy,NA,Marche,1525271,0,0,6789,997
2020-07-05,Italy,NA,Marche,1525271,1,0,6790,997
2020-07-06,Italy,NA,Marche,1525271,0,0,6790,997
2020-07-07,Italy,NA,Marche,1525271,1,0,6791,997
2020-07-08,Italy,NA,Marche,1525271,3,0,6794,997
2020-07-09,Italy,NA,Marche,1525271,4,0,6798,997
2020-07-10,Italy,NA,Marche,1525271,1,0,6799,997
2020-07-11,Italy,NA,Marche,1525271,4,0,6803,997
2020-07-12,Italy,NA,Marche,1525271,1,0,6804,997
2020-07-13,Italy,NA,Marche,1525271,0,0,6804,997
2020-07-14,Italy,NA,Marche,1525271,1,0,6805,997
2020-07-15,Italy,NA,Marche,1525271,0,0,6805,997
2020-07-16,Italy,NA,Marche,1525271,1,0,6806,997
2020-07-17,Italy,NA,Marche,1525271,3,0,6809,997
2020-07-18,Italy,NA,Marche,1525271,3,0,6812,997
2020-07-19,Italy,NA,Marche,1525271,0,0,6812,997
2020-07-20,Italy,NA,Marche,1525271,0,0,6812,997
2020-07-21,Italy,NA,Marche,1525271,2,0,6813,997
2020-07-22,Italy,NA,Marche,1525271,1,0,6814,997
2020-07-23,Italy,NA,Marche,1525271,1,0,6815,997
2020-07-24,Italy,NA,Marche,1525271,1,0,6816,997
2020-07-25,Italy,NA,Marche,1525271,2,0,6818,997
2020-07-26,Italy,NA,Marche,1525271,7,0,6825,997
2020-07-27,Italy,NA,Marche,1525271,2,0,6827,997
2020-07-28,Italy,NA,Marche,1525271,11,0,6838,997
2020-07-29,Italy,NA,Marche,1525271,17,0,6855,997
2020-07-30,Italy,NA,Marche,1525271,8,0,6863,997
2020-07-31,Italy,NA,Marche,1525271,21,0,6884,997
2020-08-01,Italy,NA,Marche,1525271,5,0,6889,997
2020-08-02,Italy,NA,Marche,1525271,8,0,6897,997
2020-08-03,Italy,NA,Marche,1525271,0,0,6897,997
2020-08-04,Italy,NA,Marche,1525271,2,0,6899,997
2020-08-05,Italy,NA,Marche,1525271,6,0,6905,997
2020-08-06,Italy,NA,Marche,1525271,9,0,6914,997
2020-08-07,Italy,NA,Marche,1525271,21,0,6935,997
2020-08-08,Italy,NA,Marche,1525271,3,0,6938,997
2020-08-09,Italy,NA,Marche,1525271,16,0,6954,997
2020-08-10,Italy,NA,Marche,1525271,2,0,6956,997
2020-08-11,Italy,NA,Marche,1525271,4,0,6960,997
2020-08-12,Italy,NA,Marche,1525271,16,0,6976,997
2020-08-13,Italy,NA,Marche,1525271,11,0,6987,997
2020-08-14,Italy,NA,Marche,1525271,32,0,7019,997
2020-08-15,Italy,NA,Marche,1525271,11,0,7030,997
2020-08-16,Italy,NA,Marche,1525271,5,0,7035,997
2020-08-17,Italy,NA,Marche,1525271,8,0,7043,997
2020-08-18,Italy,NA,Marche,1525271,15,0,7058,997
2020-08-19,Italy,NA,Marche,1525271,7,0,7065,997
2020-08-20,Italy,NA,Marche,1525271,13,0,7078,997
2020-08-21,Italy,NA,Marche,1525271,17,0,7095,997
2020-08-22,Italy,NA,Marche,1525271,10,0,7105,997
2020-08-23,Italy,NA,Marche,1525271,5,0,7110,997
2020-08-24,Italy,NA,Marche,1525271,3,0,7113,997
2020-08-25,Italy,NA,Marche,1525271,11,0,7124,997
2020-08-26,Italy,NA,Marche,1525271,9,0,7133,997
2020-08-27,Italy,NA,Marche,1525271,61,0,7194,997
2020-08-28,Italy,NA,Marche,1525271,17,0,7211,997
2020-08-29,Italy,NA,Marche,1525271,12,0,7223,997
2020-08-30,Italy,NA,Marche,1525271,15,0,7238,997
2020-08-31,Italy,NA,Marche,1525271,2,0,7240,997
2020-09-01,Italy,NA,Marche,1525271,16,0,7256,997
2020-09-02,Italy,NA,Marche,1525271,17,0,7273,997
2020-09-03,Italy,NA,Marche,1525271,21,1,7294,997
2020-09-04,Italy,NA,Marche,1525271,17,0,7311,997
2020-09-05,Italy,NA,Marche,1525271,32,0,7343,997
2020-09-06,Italy,NA,Marche,1525271,20,0,7363,997
2020-09-07,Italy,NA,Marche,1525271,6,0,7369,997
2020-09-08,Italy,NA,Marche,1525271,15,0,7384,997
2020-09-09,Italy,NA,Marche,1525271,19,0,7403,997
2020-09-10,Italy,NA,Marche,1525271,40,1,7443,997
2020-09-11,Italy,NA,Marche,1525271,41,0,7484,997
2020-09-12,Italy,NA,Marche,1525271,27,0,7511,997
2020-09-13,Italy,NA,Marche,1525271,39,0,7550,997
2020-09-14,Italy,NA,Marche,1525271,11,0,7561,997
2020-09-15,Italy,NA,Marche,1525271,14,0,7575,997
2020-09-16,Italy,NA,Marche,1525271,38,0,7613,997
2020-09-17,Italy,NA,Marche,1525271,37,0,7650,997
2020-09-18,Italy,NA,Marche,1525271,29,0,7679,997
2020-09-19,Italy,NA,Marche,1525271,24,0,7703,997
2020-09-20,Italy,NA,Marche,1525271,31,0,7734,997
2020-09-21,Italy,NA,Marche,1525271,17,0,7751,997
2020-09-22,Italy,NA,Marche,1525271,18,0,7769,997
2020-09-23,Italy,NA,Marche,1525271,32,0,7801,997
2020-03-06,Italy,NA,Molise,305617,5,0,12,0
2020-03-07,Italy,NA,Molise,305617,2,0,14,0
2020-03-08,Italy,NA,Molise,305617,0,0,14,0
2020-03-09,Italy,NA,Molise,305617,0,0,14,0
2020-03-10,Italy,NA,Molise,305617,1,0,15,0
2020-03-11,Italy,NA,Molise,305617,1,0,16,0
2020-03-12,Italy,NA,Molise,305617,0,0,16,0
2020-03-13,Italy,NA,Molise,305617,1,0,17,0
2020-03-14,Italy,NA,Molise,305617,0,0,17,0
2020-03-15,Italy,NA,Molise,305617,0,0,17,0
2020-03-16,Italy,NA,Molise,305617,4,1,21,1
2020-03-17,Italy,NA,Molise,305617,4,0,25,1
2020-03-18,Italy,NA,Molise,305617,3,0,28,1
2020-03-19,Italy,NA,Molise,305617,18,1,46,2
2020-03-20,Italy,NA,Molise,305617,4,3,50,5
2020-03-21,Italy,NA,Molise,305617,11,2,61,7
2020-03-22,Italy,NA,Molise,305617,5,0,66,7
2020-03-23,Italy,NA,Molise,305617,1,0,67,7
2020-03-24,Italy,NA,Molise,305617,6,1,73,8
2020-03-25,Italy,NA,Molise,305617,0,0,73,8
2020-03-26,Italy,NA,Molise,305617,30,0,103,8
2020-03-27,Italy,NA,Molise,305617,6,1,109,9
2020-03-28,Italy,NA,Molise,305617,14,0,123,9
2020-03-29,Italy,NA,Molise,305617,4,0,127,9
2020-03-30,Italy,NA,Molise,305617,7,0,134,9
2020-03-31,Italy,NA,Molise,305617,10,0,144,9
2020-04-01,Italy,NA,Molise,305617,16,1,160,10
2020-04-02,Italy,NA,Molise,305617,5,1,165,11
2020-04-03,Italy,NA,Molise,305617,11,0,176,11
2020-04-04,Italy,NA,Molise,305617,30,0,206,11
2020-04-05,Italy,NA,Molise,305617,18,2,224,13
2020-04-06,Italy,NA,Molise,305617,0,0,224,13
2020-04-07,Italy,NA,Molise,305617,0,0,224,13
2020-04-08,Italy,NA,Molise,305617,2,0,226,13
2020-04-09,Italy,NA,Molise,305617,8,0,234,13
2020-04-10,Italy,NA,Molise,305617,9,0,243,13
2020-04-11,Italy,NA,Molise,305617,3,1,246,14
2020-04-12,Italy,NA,Molise,305617,11,1,257,15
2020-04-13,Italy,NA,Molise,305617,0,0,257,15
2020-04-14,Italy,NA,Molise,305617,0,0,257,15
2020-04-15,Italy,NA,Molise,305617,6,0,263,15
2020-04-16,Italy,NA,Molise,305617,0,1,263,16
2020-04-17,Italy,NA,Molise,305617,6,0,269,16
2020-04-18,Italy,NA,Molise,305617,0,0,269,16
2020-04-19,Italy,NA,Molise,305617,10,1,279,17
2020-04-20,Italy,NA,Molise,305617,2,1,281,18
2020-04-21,Italy,NA,Molise,305617,1,0,282,18
2020-04-22,Italy,NA,Molise,305617,2,1,284,19
2020-04-23,Italy,NA,Molise,305617,0,1,284,20
2020-04-24,Italy,NA,Molise,305617,3,0,287,20
2020-04-25,Italy,NA,Molise,305617,5,1,292,21
2020-04-26,Italy,NA,Molise,305617,4,0,296,21
2020-04-27,Italy,NA,Molise,305617,0,0,296,21
2020-04-28,Italy,NA,Molise,305617,1,0,297,21
2020-04-29,Italy,NA,Molise,305617,0,0,297,21
2020-04-30,Italy,NA,Molise,305617,1,0,298,21
2020-05-01,Italy,NA,Molise,305617,2,0,300,21
2020-05-02,Italy,NA,Molise,305617,1,0,301,21
2020-05-03,Italy,NA,Molise,305617,0,1,301,22
2020-05-04,Italy,NA,Molise,305617,0,0,301,22
2020-05-05,Italy,NA,Molise,305617,0,0,301,22
2020-05-06,Italy,NA,Molise,305617,3,0,304,22
2020-05-07,Italy,NA,Molise,305617,1,0,305,22
2020-05-08,Italy,NA,Molise,305617,22,0,327,22
2020-05-09,Italy,NA,Molise,305617,20,0,347,22
2020-05-10,Italy,NA,Molise,305617,23,0,370,22
2020-05-11,Italy,NA,Molise,305617,13,0,383,22
2020-05-12,Italy,NA,Molise,305617,3,0,386,22
2020-05-13,Italy,NA,Molise,305617,15,0,401,22
2020-05-14,Italy,NA,Molise,305617,2,0,403,22
2020-05-15,Italy,NA,Molise,305617,4,0,407,22
2020-05-16,Italy,NA,Molise,305617,3,0,410,22
2020-05-17,Italy,NA,Molise,305617,1,0,411,22
2020-05-18,Italy,NA,Molise,305617,11,0,422,22
2020-05-19,Italy,NA,Molise,305617,0,0,422,22
2020-05-20,Italy,NA,Molise,305617,0,0,422,22
2020-05-21,Italy,NA,Molise,305617,1,0,423,22
2020-05-22,Italy,NA,Molise,305617,3,0,426,22
2020-05-23,Italy,NA,Molise,305617,5,0,431,22
2020-05-24,Italy,NA,Molise,305617,1,0,432,22
2020-05-25,Italy,NA,Molise,305617,0,0,432,22
2020-05-26,Italy,NA,Molise,305617,0,0,432,22
2020-05-27,Italy,NA,Molise,305617,2,0,434,22
2020-05-28,Italy,NA,Molise,305617,1,0,435,22
2020-05-29,Italy,NA,Molise,305617,1,0,436,22
2020-05-30,Italy,NA,Molise,305617,0,0,436,22
2020-05-31,Italy,NA,Molise,305617,0,0,436,22
2020-06-01,Italy,NA,Molise,305617,0,0,436,22
2020-06-02,Italy,NA,Molise,305617,0,0,436,22
2020-06-03,Italy,NA,Molise,305617,0,0,436,22
2020-06-04,Italy,NA,Molise,305617,0,1,436,23
2020-06-05,Italy,NA,Molise,305617,0,0,436,23
2020-06-06,Italy,NA,Molise,305617,0,0,436,23
2020-06-07,Italy,NA,Molise,305617,0,0,436,23
2020-06-08,Italy,NA,Molise,305617,0,0,436,23
2020-06-09,Italy,NA,Molise,305617,2,0,438,23
2020-06-10,Italy,NA,Molise,305617,1,0,439,23
2020-06-11,Italy,NA,Molise,305617,0,0,439,23
2020-06-12,Italy,NA,Molise,305617,0,0,439,23
2020-06-13,Italy,NA,Molise,305617,0,0,439,23
2020-06-14,Italy,NA,Molise,305617,0,0,439,23
2020-06-15,Italy,NA,Molise,305617,0,0,439,23
2020-06-16,Italy,NA,Molise,305617,0,0,439,23
2020-06-17,Italy,NA,Molise,305617,1,0,440,23
2020-06-18,Italy,NA,Molise,305617,0,0,440,23
2020-06-19,Italy,NA,Molise,305617,1,0,441,23
2020-06-20,Italy,NA,Molise,305617,0,0,441,23
2020-06-21,Italy,NA,Molise,305617,0,0,441,23
2020-06-22,Italy,NA,Molise,305617,3,0,444,23
2020-06-23,Italy,NA,Molise,305617,0,0,444,23
2020-06-24,Italy,NA,Molise,305617,0,0,444,23
2020-06-25,Italy,NA,Molise,305617,0,0,444,23
2020-06-26,Italy,NA,Molise,305617,1,0,445,23
2020-06-27,Italy,NA,Molise,305617,0,0,445,23
2020-06-28,Italy,NA,Molise,305617,0,0,445,23
2020-06-29,Italy,NA,Molise,305617,0,0,445,23
2020-06-30,Italy,NA,Molise,305617,0,0,445,23
2020-07-01,Italy,NA,Molise,305617,0,0,445,23
2020-07-02,Italy,NA,Molise,305617,0,0,445,23
2020-07-03,Italy,NA,Molise,305617,0,0,445,23
2020-07-04,Italy,NA,Molise,305617,0,0,445,23
2020-07-05,Italy,NA,Molise,305617,0,0,445,23
2020-07-06,Italy,NA,Molise,305617,0,0,445,23
2020-07-07,Italy,NA,Molise,305617,0,0,445,23
2020-07-08,Italy,NA,Molise,305617,0,0,445,23
2020-07-09,Italy,NA,Molise,305617,0,0,445,23
2020-07-10,Italy,NA,Molise,305617,0,0,445,23
2020-07-11,Italy,NA,Molise,305617,0,0,445,23
2020-07-12,Italy,NA,Molise,305617,1,0,446,23
2020-07-13,Italy,NA,Molise,305617,0,0,446,23
2020-07-14,Italy,NA,Molise,305617,0,0,446,23
2020-07-15,Italy,NA,Molise,305617,0,0,446,23
2020-07-16,Italy,NA,Molise,305617,0,0,446,23
2020-07-17,Italy,NA,Molise,305617,0,0,446,23
2020-07-18,Italy,NA,Molise,305617,0,0,446,23
2020-07-19,Italy,NA,Molise,305617,0,0,446,23
2020-07-20,Italy,NA,Molise,305617,0,0,446,23
2020-07-21,Italy,NA,Molise,305617,0,0,446,23
2020-07-22,Italy,NA,Molise,305617,4,0,450,23
2020-07-23,Italy,NA,Molise,305617,9,0,459,23
2020-07-24,Italy,NA,Molise,305617,1,0,460,23
2020-07-25,Italy,NA,Molise,305617,3,0,463,23
2020-07-26,Italy,NA,Molise,305617,3,0,466,23
2020-07-27,Italy,NA,Molise,305617,3,0,469,23
2020-07-28,Italy,NA,Molise,305617,0,0,469,23
2020-07-29,Italy,NA,Molise,305617,1,0,470,23
2020-07-30,Italy,NA,Molise,305617,0,0,470,23
2020-07-31,Italy,NA,Molise,305617,1,0,471,23
2020-08-01,Italy,NA,Molise,305617,2,0,473,23
2020-08-02,Italy,NA,Molise,305617,2,0,475,23
2020-08-03,Italy,NA,Molise,305617,2,0,477,23
2020-08-04,Italy,NA,Molise,305617,0,0,477,23
2020-08-05,Italy,NA,Molise,305617,1,0,478,23
2020-08-06,Italy,NA,Molise,305617,0,0,478,23
2020-08-07,Italy,NA,Molise,305617,1,0,479,23
2020-08-08,Italy,NA,Molise,305617,0,0,479,23
2020-08-09,Italy,NA,Molise,305617,0,0,479,23
2020-08-10,Italy,NA,Molise,305617,0,0,479,23
2020-08-11,Italy,NA,Molise,305617,0,0,479,23
2020-08-12,Italy,NA,Molise,305617,0,0,479,23
2020-08-13,Italy,NA,Molise,305617,6,0,485,23
2020-08-14,Italy,NA,Molise,305617,0,0,485,23
2020-08-15,Italy,NA,Molise,305617,2,0,487,23
2020-08-16,Italy,NA,Molise,305617,0,0,487,23
2020-08-17,Italy,NA,Molise,305617,0,0,487,23
2020-08-18,Italy,NA,Molise,305617,9,0,496,23
2020-08-19,Italy,NA,Molise,305617,7,0,503,23
2020-08-20,Italy,NA,Molise,305617,4,0,507,23
2020-08-21,Italy,NA,Molise,305617,2,0,509,23
2020-08-22,Italy,NA,Molise,305617,1,0,510,23
2020-08-23,Italy,NA,Molise,305617,1,0,511,23
2020-08-24,Italy,NA,Molise,305617,0,0,511,23
2020-08-25,Italy,NA,Molise,305617,0,0,511,23
2020-08-26,Italy,NA,Molise,305617,9,0,520,23
2020-08-27,Italy,NA,Molise,305617,1,0,521,23
2020-08-28,Italy,NA,Molise,305617,1,0,522,23
2020-08-29,Italy,NA,Molise,305617,2,0,524,23
2020-08-30,Italy,NA,Molise,305617,1,0,525,23
2020-08-31,Italy,NA,Molise,305617,0,0,525,23
2020-09-01,Italy,NA,Molise,305617,3,0,528,23
2020-09-02,Italy,NA,Molise,305617,0,0,528,23
2020-09-03,Italy,NA,Molise,305617,2,0,530,23
2020-09-04,Italy,NA,Molise,305617,4,0,534,23
2020-09-05,Italy,NA,Molise,305617,0,0,534,23
2020-09-06,Italy,NA,Molise,305617,2,0,536,23
2020-09-07,Italy,NA,Molise,305617,9,0,545,23
2020-09-08,Italy,NA,Molise,305617,3,0,548,23
2020-09-09,Italy,NA,Molise,305617,4,0,552,23
2020-09-10,Italy,NA,Molise,305617,3,0,555,23
2020-09-11,Italy,NA,Molise,305617,4,0,559,23
2020-09-12,Italy,NA,Molise,305617,3,0,562,23
2020-09-13,Italy,NA,Molise,305617,3,0,565,23
2020-09-14,Italy,NA,Molise,305617,4,0,569,23
2020-09-15,Italy,NA,Molise,305617,1,0,570,23
2020-09-16,Italy,NA,Molise,305617,6,0,576,23
2020-09-17,Italy,NA,Molise,305617,2,0,578,23
2020-09-18,Italy,NA,Molise,305617,3,0,581,23
2020-09-19,Italy,NA,Molise,305617,5,0,586,23
2020-09-20,Italy,NA,Molise,305617,1,0,587,23
2020-09-21,Italy,NA,Molise,305617,31,0,618,23
2020-09-22,Italy,NA,Molise,305617,2,0,620,23
2020-09-23,Italy,NA,Molise,305617,3,0,623,23
2020-02-28,Italy,NA,Piedmont,4356406,9,0,11,0
2020-02-29,Italy,NA,Piedmont,4356406,0,0,11,0
2020-03-01,Italy,NA,Piedmont,4356406,38,0,49,0
2020-03-02,Italy,NA,Piedmont,4356406,2,0,51,0
2020-03-03,Italy,NA,Piedmont,4356406,5,0,56,0
2020-03-04,Italy,NA,Piedmont,4356406,26,0,82,0
2020-03-05,Italy,NA,Piedmont,4356406,26,2,108,2
2020-03-06,Italy,NA,Piedmont,4356406,35,2,143,4
2020-03-07,Italy,NA,Piedmont,4356406,64,1,207,5
2020-03-08,Italy,NA,Piedmont,4356406,153,0,360,5
2020-03-09,Italy,NA,Piedmont,4356406,0,8,360,13
2020-03-10,Italy,NA,Piedmont,4356406,103,4,453,17
2020-03-11,Italy,NA,Piedmont,4356406,48,4,501,21
2020-03-12,Italy,NA,Piedmont,4356406,79,5,580,26
2020-03-13,Italy,NA,Piedmont,4356406,260,20,840,46
2020-03-14,Italy,NA,Piedmont,4356406,33,13,873,59
2020-03-15,Italy,NA,Piedmont,4356406,238,22,1111,81
2020-03-16,Italy,NA,Piedmont,4356406,405,30,1516,111
2020-03-17,Italy,NA,Piedmont,4356406,381,22,1897,133
2020-03-18,Italy,NA,Piedmont,4356406,444,21,2341,154
2020-03-19,Italy,NA,Piedmont,4356406,591,21,2932,175
2020-03-20,Italy,NA,Piedmont,4356406,529,34,3461,209
2020-03-21,Italy,NA,Piedmont,4356406,291,29,3752,238
2020-03-22,Italy,NA,Piedmont,4356406,668,45,4420,283
2020-03-23,Italy,NA,Piedmont,4356406,441,32,4861,315
2020-03-24,Italy,NA,Piedmont,4356406,654,59,5515,374
2020-03-25,Italy,NA,Piedmont,4356406,509,75,6024,449
2020-03-26,Italy,NA,Piedmont,4356406,510,0,6534,449
2020-03-27,Italy,NA,Piedmont,4356406,558,120,7092,569
2020-03-28,Italy,NA,Piedmont,4356406,579,48,7671,617
2020-03-29,Italy,NA,Piedmont,4356406,535,67,8206,684
2020-03-30,Italy,NA,Piedmont,4356406,506,65,8712,749
2020-03-31,Italy,NA,Piedmont,4356406,589,105,9301,854
2020-04-01,Italy,NA,Piedmont,4356406,494,32,9795,886
2020-04-02,Italy,NA,Piedmont,4356406,558,97,10353,983
2020-04-03,Italy,NA,Piedmont,4356406,543,60,10896,1043
2020-04-04,Italy,NA,Piedmont,4356406,813,85,11709,1128
2020-04-05,Italy,NA,Piedmont,4356406,653,40,12362,1168
2020-04-06,Italy,NA,Piedmont,4356406,562,83,12924,1251
2020-04-07,Italy,NA,Piedmont,4356406,419,68,13343,1319
2020-04-08,Italy,NA,Piedmont,4356406,540,59,13883,1378
2020-04-09,Italy,NA,Piedmont,4356406,639,76,14522,1454
2020-04-10,Italy,NA,Piedmont,4356406,490,78,15012,1532
2020-04-11,Italy,NA,Piedmont,4356406,996,101,16008,1633
2020-04-12,Italy,NA,Piedmont,4356406,652,96,16660,1729
2020-04-13,Italy,NA,Piedmont,4356406,474,97,17134,1826
2020-04-14,Italy,NA,Piedmont,4356406,556,101,17690,1927
2020-04-15,Italy,NA,Piedmont,4356406,539,88,18229,2015
2020-04-16,Italy,NA,Piedmont,4356406,879,79,19108,2094
2020-04-17,Italy,NA,Piedmont,4356406,695,77,19803,2171
2020-04-18,Italy,NA,Piedmont,4356406,661,81,20464,2252
2020-04-19,Italy,NA,Piedmont,4356406,593,79,21057,2331
2020-04-20,Italy,NA,Piedmont,4356406,292,78,21349,2409
2020-04-21,Italy,NA,Piedmont,4356406,606,76,21955,2485
2020-04-22,Italy,NA,Piedmont,4356406,784,74,22739,2559
2020-04-23,Italy,NA,Piedmont,4356406,401,71,23140,2630
2020-04-24,Italy,NA,Piedmont,4356406,682,69,23822,2699
2020-04-25,Italy,NA,Piedmont,4356406,604,68,24426,2767
2020-04-26,Italy,NA,Piedmont,4356406,394,56,24820,2823
2020-04-27,Italy,NA,Piedmont,4356406,278,55,25098,2878
2020-04-28,Italy,NA,Piedmont,4356406,352,58,25450,2936
2020-04-29,Italy,NA,Piedmont,4356406,411,67,25861,3003
2020-04-30,Italy,NA,Piedmont,4356406,428,63,26289,3066
2020-05-01,Italy,NA,Piedmont,4356406,395,31,26684,3097
2020-05-02,Italy,NA,Piedmont,4356406,495,29,27179,3126
2020-05-03,Italy,NA,Piedmont,4356406,251,26,27430,3152
2020-05-04,Italy,NA,Piedmont,4356406,192,34,27622,3186
2020-05-05,Italy,NA,Piedmont,4356406,152,30,27774,3216
2020-05-06,Italy,NA,Piedmont,4356406,165,31,27939,3247
2020-05-07,Italy,NA,Piedmont,4356406,196,35,28135,3282
2020-05-08,Italy,NA,Piedmont,4356406,233,23,28368,3305
2020-05-09,Italy,NA,Piedmont,4356406,181,26,28549,3331
2020-05-10,Italy,NA,Piedmont,4356406,116,36,28665,3367
2020-05-11,Italy,NA,Piedmont,4356406,111,33,28776,3400
2020-05-12,Italy,NA,Piedmont,4356406,113,28,28889,3428
2020-05-13,Italy,NA,Piedmont,4356406,169,32,29058,3460
2020-05-14,Italy,NA,Piedmont,4356406,151,33,29209,3493
2020-05-15,Italy,NA,Piedmont,4356406,137,64,29346,3557
2020-05-16,Italy,NA,Piedmont,4356406,137,37,29483,3594
2020-05-17,Italy,NA,Piedmont,4356406,64,18,29547,3612
2020-05-18,Italy,NA,Piedmont,4356406,72,20,29619,3632
2020-05-19,Italy,NA,Piedmont,4356406,108,47,29727,3679
2020-05-20,Italy,NA,Piedmont,4356406,158,39,29885,3718
2020-05-21,Italy,NA,Piedmont,4356406,105,24,29990,3742
2020-05-22,Italy,NA,Piedmont,4356406,87,15,30077,3757
2020-05-23,Italy,NA,Piedmont,4356406,60,14,30137,3771
2020-05-24,Italy,NA,Piedmont,4356406,43,12,30180,3783
2020-05-25,Italy,NA,Piedmont,4356406,48,15,30228,3798
2020-05-26,Italy,NA,Piedmont,4356406,86,14,30314,3812
2020-05-27,Italy,NA,Piedmont,4356406,73,16,30387,3828
2020-05-28,Italy,NA,Piedmont,4356406,58,10,30445,3838
2020-05-29,Italy,NA,Piedmont,4356406,56,13,30501,3851
2020-05-30,Italy,NA,Piedmont,4356406,82,7,30583,3858
2020-05-31,Italy,NA,Piedmont,4356406,54,9,30637,3867
2020-06-01,Italy,NA,Piedmont,4356406,21,9,30658,3876
2020-06-02,Italy,NA,Piedmont,4356406,57,8,30715,3884
2020-06-03,Italy,NA,Piedmont,4356406,19,14,30734,3898
2020-06-04,Italy,NA,Piedmont,4356406,24,12,30758,3910
2020-06-05,Italy,NA,Piedmont,4356406,49,17,30807,3927
2020-06-06,Italy,NA,Piedmont,4356406,38,7,30845,3934
2020-06-07,Italy,NA,Piedmont,4356406,10,7,30855,3941
2020-06-08,Italy,NA,Piedmont,4356406,14,13,30869,3954
2020-06-09,Italy,NA,Piedmont,4356406,21,7,30890,3961
2020-06-10,Italy,NA,Piedmont,4356406,26,15,30916,3976
2020-06-11,Italy,NA,Piedmont,4356406,42,12,30958,3988
2020-06-12,Italy,NA,Piedmont,4356406,31,8,30989,3996
2020-06-13,Italy,NA,Piedmont,4356406,40,10,31029,4006
2020-06-14,Italy,NA,Piedmont,4356406,30,6,31059,4012
2020-06-15,Italy,NA,Piedmont,4356406,2,0,31061,4012
2020-06-16,Italy,NA,Piedmont,4356406,29,6,31090,4018
2020-06-17,Italy,NA,Piedmont,4356406,41,8,31131,4026
2020-06-18,Italy,NA,Piedmont,4356406,31,6,31162,4032
2020-06-19,Italy,NA,Piedmont,4356406,26,7,31188,4039
2020-06-20,Italy,NA,Piedmont,4356406,27,6,31215,4045
2020-06-21,Italy,NA,Piedmont,4356406,26,6,31241,4051
2020-06-22,Italy,NA,Piedmont,4356406,7,4,31248,4055
2020-06-23,Italy,NA,Piedmont,4356406,6,4,31254,4059
2020-06-24,Italy,NA,Piedmont,4356406,22,7,31276,4066
2020-06-25,Italy,NA,Piedmont,4356406,20,5,31296,4071
2020-06-26,Italy,NA,Piedmont,4356406,15,6,31311,4077
2020-06-27,Italy,NA,Piedmont,4356406,11,3,31322,4080
2020-06-28,Italy,NA,Piedmont,4356406,14,5,31336,4085
2020-06-29,Italy,NA,Piedmont,4356406,2,2,31338,4087
2020-06-30,Italy,NA,Piedmont,4356406,11,3,31349,4090
2020-07-01,Italy,NA,Piedmont,4356406,16,1,31365,4091
2020-07-02,Italy,NA,Piedmont,4356406,13,5,31378,4096
2020-07-03,Italy,NA,Piedmont,4356406,16,4,31394,4100
2020-07-04,Italy,NA,Piedmont,4356406,11,2,31405,4102
2020-07-05,Italy,NA,Piedmont,4356406,18,0,31423,4102
2020-07-06,Italy,NA,Piedmont,4356406,6,2,31429,4104
2020-07-07,Italy,NA,Piedmont,4356406,5,3,31434,4107
2020-07-08,Italy,NA,Piedmont,4356406,25,0,31459,4107
2020-07-09,Italy,NA,Piedmont,4356406,16,1,31475,4108
2020-07-10,Italy,NA,Piedmont,4356406,10,2,31485,4110
2020-07-11,Italy,NA,Piedmont,4356406,9,1,31494,4111
2020-07-12,Italy,NA,Piedmont,4356406,4,0,31498,4111
2020-07-13,Italy,NA,Piedmont,4356406,6,1,31504,4112
2020-07-14,Italy,NA,Piedmont,4356406,3,3,31507,4115
2020-07-15,Italy,NA,Piedmont,4356406,8,3,31515,4118
2020-07-16,Italy,NA,Piedmont,4356406,7,0,31522,4118
2020-07-17,Italy,NA,Piedmont,4356406,8,1,31530,4119
2020-07-18,Italy,NA,Piedmont,4356406,3,0,31533,4119
2020-07-19,Italy,NA,Piedmont,4356406,3,0,31536,4119
2020-07-20,Italy,NA,Piedmont,4356406,1,1,31537,4120
2020-07-21,Italy,NA,Piedmont,4356406,8,3,31545,4123
2020-07-22,Italy,NA,Piedmont,4356406,13,0,31558,4123
2020-07-23,Italy,NA,Piedmont,4356406,9,0,31567,4123
2020-07-24,Italy,NA,Piedmont,4356406,11,0,31578,4123
2020-07-25,Italy,NA,Piedmont,4356406,16,2,31594,4125
2020-07-26,Italy,NA,Piedmont,4356406,12,1,31606,4126
2020-07-27,Italy,NA,Piedmont,4356406,4,1,31610,4127
2020-07-28,Italy,NA,Piedmont,4356406,12,0,31622,4127
2020-07-29,Italy,NA,Piedmont,4356406,14,1,31636,4128
2020-07-30,Italy,NA,Piedmont,4356406,10,0,31646,4128
2020-07-31,Italy,NA,Piedmont,4356406,21,1,31667,4129
2020-08-01,Italy,NA,Piedmont,4356406,16,0,31683,4129
2020-08-02,Italy,NA,Piedmont,4356406,15,0,31698,4129
2020-08-03,Italy,NA,Piedmont,4356406,13,2,31711,4131
2020-08-04,Italy,NA,Piedmont,4356406,8,1,31719,4132
2020-08-05,Italy,NA,Piedmont,4356406,21,2,31740,4134
2020-08-06,Italy,NA,Piedmont,4356406,22,1,31762,4135
2020-08-07,Italy,NA,Piedmont,4356406,37,1,31799,4136
2020-08-08,Italy,NA,Piedmont,4356406,31,0,31830,4136
2020-08-09,Italy,NA,Piedmont,4356406,38,0,31868,4136
2020-08-10,Italy,NA,Piedmont,4356406,20,0,31888,4136
2020-08-11,Italy,NA,Piedmont,4356406,26,0,31914,4136
2020-08-12,Italy,NA,Piedmont,4356406,42,2,31956,4138
2020-08-13,Italy,NA,Piedmont,4356406,26,1,31982,4139
2020-08-14,Italy,NA,Piedmont,4356406,15,0,31997,4139
2020-08-15,Italy,NA,Piedmont,4356406,47,0,32044,4139
2020-08-16,Italy,NA,Piedmont,4356406,40,0,32084,4139
2020-08-17,Italy,NA,Piedmont,4356406,16,1,32100,4140
2020-08-18,Italy,NA,Piedmont,4356406,27,1,32127,4141
2020-08-19,Italy,NA,Piedmont,4356406,42,1,32169,4142
2020-08-20,Italy,NA,Piedmont,4356406,52,0,32221,4142
2020-08-21,Italy,NA,Piedmont,4356406,39,0,32260,4142
2020-08-22,Italy,NA,Piedmont,4356406,41,1,32301,4143
2020-08-23,Italy,NA,Piedmont,4356406,42,0,32343,4143
2020-08-24,Italy,NA,Piedmont,4356406,40,0,32383,4143
2020-08-25,Italy,NA,Piedmont,4356406,57,0,32440,4143
2020-08-26,Italy,NA,Piedmont,4356406,75,1,32515,4144
2020-08-27,Italy,NA,Piedmont,4356406,88,0,32603,4144
2020-08-28,Italy,NA,Piedmont,4356406,91,1,32694,4145
2020-08-29,Italy,NA,Piedmont,4356406,90,0,32784,4145
2020-08-30,Italy,NA,Piedmont,4356406,60,1,32844,4146
2020-08-31,Italy,NA,Piedmont,4356406,37,0,32881,4146
2020-09-01,Italy,NA,Piedmont,4356406,42,0,32923,4146
2020-09-02,Italy,NA,Piedmont,4356406,66,1,32989,4147
2020-09-03,Italy,NA,Piedmont,4356406,75,1,33064,4148
2020-09-04,Italy,NA,Piedmont,4356406,82,1,33146,4149
2020-09-05,Italy,NA,Piedmont,4356406,54,1,33200,4150
2020-09-06,Italy,NA,Piedmont,4356406,56,0,33256,4150
2020-09-07,Italy,NA,Piedmont,4356406,37,1,33293,4151
2020-09-08,Italy,NA,Piedmont,4356406,42,1,33335,4152
2020-09-09,Italy,NA,Piedmont,4356406,112,0,33447,4152
2020-09-10,Italy,NA,Piedmont,4356406,74,1,33521,4153
2020-09-11,Italy,NA,Piedmont,4356406,57,0,33578,4153
2020-09-12,Italy,NA,Piedmont,4356406,93,0,33671,4153
2020-09-13,Italy,NA,Piedmont,4356406,82,0,33753,4153
2020-09-14,Italy,NA,Piedmont,4356406,61,0,33814,4153
2020-09-15,Italy,NA,Piedmont,4356406,39,0,33853,4153
2020-09-16,Italy,NA,Piedmont,4356406,117,0,33970,4153
2020-09-17,Italy,NA,Piedmont,4356406,70,0,34040,4153
2020-09-18,Italy,NA,Piedmont,4356406,127,0,34167,4153
2020-09-19,Italy,NA,Piedmont,4356406,74,1,34241,4154
2020-09-20,Italy,NA,Piedmont,4356406,98,0,34339,4154
2020-09-21,Italy,NA,Piedmont,4356406,57,1,34396,4155
2020-09-22,Italy,NA,Piedmont,4356406,84,1,34480,4156
2020-09-23,Italy,NA,Piedmont,4356406,95,1,34575,4157
2020-03-08,Italy,NA,Sardinia,1639591,6,0,11,0
2020-03-09,Italy,NA,Sardinia,1639591,8,0,19,0
2020-03-10,Italy,NA,Sardinia,1639591,1,0,20,0
2020-03-11,Italy,NA,Sardinia,1639591,17,0,37,0
2020-03-12,Italy,NA,Sardinia,1639591,2,0,39,0
2020-03-13,Italy,NA,Sardinia,1639591,4,0,43,0
2020-03-14,Italy,NA,Sardinia,1639591,4,0,47,0
2020-03-15,Italy,NA,Sardinia,1639591,30,2,77,2
2020-03-16,Italy,NA,Sardinia,1639591,30,0,107,2
2020-03-17,Italy,NA,Sardinia,1639591,10,0,117,2
2020-03-18,Italy,NA,Sardinia,1639591,17,0,134,2
2020-03-19,Italy,NA,Sardinia,1639591,72,0,206,2
2020-03-20,Italy,NA,Sardinia,1639591,87,0,293,2
2020-03-21,Italy,NA,Sardinia,1639591,37,2,330,4
2020-03-22,Italy,NA,Sardinia,1639591,9,3,339,7
2020-03-23,Italy,NA,Sardinia,1639591,20,4,359,11
2020-03-24,Italy,NA,Sardinia,1639591,62,4,421,15
2020-03-25,Italy,NA,Sardinia,1639591,21,3,442,18
2020-03-26,Italy,NA,Sardinia,1639591,52,1,494,19
2020-03-27,Italy,NA,Sardinia,1639591,36,2,530,21
2020-03-28,Italy,NA,Sardinia,1639591,94,5,624,26
2020-03-29,Italy,NA,Sardinia,1639591,14,1,638,27
2020-03-30,Italy,NA,Sardinia,1639591,44,1,682,28
2020-03-31,Italy,NA,Sardinia,1639591,40,3,722,31
2020-04-01,Italy,NA,Sardinia,1639591,23,3,745,34
2020-04-02,Italy,NA,Sardinia,1639591,49,6,794,40
2020-04-03,Italy,NA,Sardinia,1639591,31,1,825,41
2020-04-04,Italy,NA,Sardinia,1639591,49,0,874,41
2020-04-05,Italy,NA,Sardinia,1639591,33,2,907,43
2020-04-06,Italy,NA,Sardinia,1639591,15,4,922,47
2020-04-07,Italy,NA,Sardinia,1639591,13,5,935,52
2020-04-08,Italy,NA,Sardinia,1639591,40,7,975,59
2020-04-09,Italy,NA,Sardinia,1639591,51,5,1026,64
2020-04-10,Italy,NA,Sardinia,1639591,37,5,1063,69
2020-04-11,Italy,NA,Sardinia,1639591,28,4,1091,73
2020-04-12,Italy,NA,Sardinia,1639591,22,0,1113,73
2020-04-13,Italy,NA,Sardinia,1639591,15,2,1128,75
2020-04-14,Italy,NA,Sardinia,1639591,10,5,1138,80
2020-04-15,Italy,NA,Sardinia,1639591,23,3,1161,83
2020-04-16,Italy,NA,Sardinia,1639591,3,2,1164,85
2020-04-17,Italy,NA,Sardinia,1639591,14,1,1178,86
2020-04-18,Italy,NA,Sardinia,1639591,20,0,1198,86
2020-04-19,Italy,NA,Sardinia,1639591,17,0,1215,86
2020-04-20,Italy,NA,Sardinia,1639591,13,0,1228,86
2020-04-21,Italy,NA,Sardinia,1639591,8,7,1236,93
2020-04-22,Italy,NA,Sardinia,1639591,11,3,1247,96
2020-04-23,Italy,NA,Sardinia,1639591,7,2,1254,98
2020-04-24,Italy,NA,Sardinia,1639591,3,4,1257,102
2020-04-25,Italy,NA,Sardinia,1639591,14,1,1271,103
2020-04-26,Italy,NA,Sardinia,1639591,9,6,1280,109
2020-04-27,Italy,NA,Sardinia,1639591,3,0,1283,109
2020-04-28,Italy,NA,Sardinia,1639591,2,0,1285,109
2020-04-29,Italy,NA,Sardinia,1639591,5,7,1290,116
2020-04-30,Italy,NA,Sardinia,1639591,5,0,1295,116
2020-05-01,Italy,NA,Sardinia,1639591,18,1,1313,117
2020-05-02,Italy,NA,Sardinia,1639591,2,2,1315,119
2020-05-03,Italy,NA,Sardinia,1639591,4,0,1319,119
2020-05-04,Italy,NA,Sardinia,1639591,0,0,1319,119
2020-05-05,Italy,NA,Sardinia,1639591,1,0,1319,119
2020-05-06,Italy,NA,Sardinia,1639591,1,0,1319,119
2020-05-07,Italy,NA,Sardinia,1639591,5,0,1324,119
2020-05-08,Italy,NA,Sardinia,1639591,6,0,1330,119
2020-05-09,Italy,NA,Sardinia,1639591,4,0,1334,119
2020-05-10,Italy,NA,Sardinia,1639591,6,1,1340,120
2020-05-11,Italy,NA,Sardinia,1639591,3,0,1343,120
2020-05-12,Italy,NA,Sardinia,1639591,1,0,1344,120
2020-05-13,Italy,NA,Sardinia,1639591,1,0,1345,120
2020-05-14,Italy,NA,Sardinia,1639591,0,5,1345,125
2020-05-15,Italy,NA,Sardinia,1639591,3,0,1348,125
2020-05-16,Italy,NA,Sardinia,1639591,4,0,1352,125
2020-05-17,Italy,NA,Sardinia,1639591,1,0,1353,125
2020-05-18,Italy,NA,Sardinia,1639591,0,1,1353,126
2020-05-19,Italy,NA,Sardinia,1639591,1,0,1354,126
2020-05-20,Italy,NA,Sardinia,1639591,1,0,1355,126
2020-05-21,Italy,NA,Sardinia,1639591,1,1,1356,127
2020-05-22,Italy,NA,Sardinia,1639591,0,1,1356,128
2020-05-23,Italy,NA,Sardinia,1639591,0,1,1356,129
2020-05-24,Italy,NA,Sardinia,1639591,0,0,1356,129
2020-05-25,Italy,NA,Sardinia,1639591,0,0,1356,129
2020-05-26,Italy,NA,Sardinia,1639591,0,1,1356,130
2020-05-27,Italy,NA,Sardinia,1639591,1,0,1356,130
2020-05-28,Italy,NA,Sardinia,1639591,0,0,1356,130
2020-05-29,Italy,NA,Sardinia,1639591,1,0,1356,130
2020-05-30,Italy,NA,Sardinia,1639591,0,0,1356,130
2020-05-31,Italy,NA,Sardinia,1639591,0,0,1356,130
2020-06-01,Italy,NA,Sardinia,1639591,1,1,1357,131
2020-06-02,Italy,NA,Sardinia,1639591,0,0,1357,131
2020-06-03,Italy,NA,Sardinia,1639591,0,0,1357,131
2020-06-04,Italy,NA,Sardinia,1639591,0,0,1357,131
2020-06-05,Italy,NA,Sardinia,1639591,2,0,1359,131
2020-06-06,Italy,NA,Sardinia,1639591,3,0,1362,131
2020-06-07,Italy,NA,Sardinia,1639591,0,0,1362,131
2020-06-08,Italy,NA,Sardinia,1639591,0,0,1362,131
2020-06-09,Italy,NA,Sardinia,1639591,0,0,1362,131
2020-06-10,Italy,NA,Sardinia,1639591,0,0,1362,131
2020-06-11,Italy,NA,Sardinia,1639591,1,0,1362,131
2020-06-12,Italy,NA,Sardinia,1639591,1,0,1363,131
2020-06-13,Italy,NA,Sardinia,1639591,0,1,1363,132
2020-06-14,Italy,NA,Sardinia,1639591,0,0,1363,132
2020-06-15,Italy,NA,Sardinia,1639591,0,0,1363,132
2020-06-16,Italy,NA,Sardinia,1639591,2,0,1365,132
2020-06-17,Italy,NA,Sardinia,1639591,1,0,1366,132
2020-06-18,Italy,NA,Sardinia,1639591,1,0,1367,132
2020-06-19,Italy,NA,Sardinia,1639591,1,0,1368,132
2020-06-20,Italy,NA,Sardinia,1639591,1,0,1369,132
2020-06-21,Italy,NA,Sardinia,1639591,0,0,1369,132
2020-06-22,Italy,NA,Sardinia,1639591,0,0,1369,132
2020-06-23,Italy,NA,Sardinia,1639591,0,0,1369,132
2020-06-24,Italy,NA,Sardinia,1639591,1,0,1369,132
2020-06-25,Italy,NA,Sardinia,1639591,1,0,1369,132
2020-06-26,Italy,NA,Sardinia,1639591,0,0,1369,132
2020-06-27,Italy,NA,Sardinia,1639591,1,0,1369,132
2020-06-28,Italy,NA,Sardinia,1639591,1,0,1369,132
2020-06-29,Italy,NA,Sardinia,1639591,0,0,1369,132
2020-06-30,Italy,NA,Sardinia,1639591,2,1,1369,133
2020-07-01,Italy,NA,Sardinia,1639591,0,0,1369,133
2020-07-02,Italy,NA,Sardinia,1639591,2,0,1369,133
2020-07-03,Italy,NA,Sardinia,1639591,1,0,1369,133
2020-07-04,Italy,NA,Sardinia,1639591,0,0,1369,133
2020-07-05,Italy,NA,Sardinia,1639591,1,0,1370,133
2020-07-06,Italy,NA,Sardinia,1639591,1,1,1371,134
2020-07-07,Italy,NA,Sardinia,1639591,0,0,1371,134
2020-07-08,Italy,NA,Sardinia,1639591,0,0,1371,134
2020-07-09,Italy,NA,Sardinia,1639591,0,0,1371,134
2020-07-10,Italy,NA,Sardinia,1639591,1,0,1372,134
2020-07-11,Italy,NA,Sardinia,1639591,0,0,1372,134
2020-07-12,Italy,NA,Sardinia,1639591,0,0,1372,134
2020-07-13,Italy,NA,Sardinia,1639591,1,0,1373,134
2020-07-14,Italy,NA,Sardinia,1639591,1,0,1374,134
2020-07-15,Italy,NA,Sardinia,1639591,2,0,1376,134
2020-07-16,Italy,NA,Sardinia,1639591,1,0,1377,134
2020-07-17,Italy,NA,Sardinia,1639591,0,0,1377,134
2020-07-18,Italy,NA,Sardinia,1639591,1,0,1378,134
2020-07-19,Italy,NA,Sardinia,1639591,1,0,1379,134
2020-07-20,Italy,NA,Sardinia,1639591,0,0,1379,134
2020-07-21,Italy,NA,Sardinia,1639591,0,0,1379,134
2020-07-22,Italy,NA,Sardinia,1639591,1,0,1380,134
2020-07-23,Italy,NA,Sardinia,1639591,2,0,1382,134
2020-07-24,Italy,NA,Sardinia,1639591,3,0,1385,134
2020-07-25,Italy,NA,Sardinia,1639591,3,0,1388,134
2020-07-26,Italy,NA,Sardinia,1639591,0,0,1388,134
2020-07-27,Italy,NA,Sardinia,1639591,0,1,1388,135
2020-07-28,Italy,NA,Sardinia,1639591,6,0,1392,135
2020-07-29,Italy,NA,Sardinia,1639591,2,0,1394,135
2020-07-30,Italy,NA,Sardinia,1639591,0,0,1394,135
2020-07-31,Italy,NA,Sardinia,1639591,10,0,1404,135
2020-08-01,Italy,NA,Sardinia,1639591,6,0,1410,135
2020-08-02,Italy,NA,Sardinia,1639591,4,0,1414,135
2020-08-03,Italy,NA,Sardinia,1639591,2,0,1416,135
2020-08-04,Italy,NA,Sardinia,1639591,2,0,1418,135
2020-08-05,Italy,NA,Sardinia,1639591,9,0,1427,135
2020-08-06,Italy,NA,Sardinia,1639591,3,0,1430,135
2020-08-07,Italy,NA,Sardinia,1639591,3,0,1433,135
2020-08-08,Italy,NA,Sardinia,1639591,0,0,1433,135
2020-08-09,Italy,NA,Sardinia,1639591,6,0,1439,135
2020-08-10,Italy,NA,Sardinia,1639591,2,0,1441,135
2020-08-11,Italy,NA,Sardinia,1639591,20,0,1461,135
2020-08-12,Italy,NA,Sardinia,1639591,1,0,1462,135
2020-08-13,Italy,NA,Sardinia,1639591,17,0,1479,135
2020-08-14,Italy,NA,Sardinia,1639591,5,0,1484,135
2020-08-15,Italy,NA,Sardinia,1639591,5,0,1489,135
2020-08-16,Italy,NA,Sardinia,1639591,5,0,1493,135
2020-08-17,Italy,NA,Sardinia,1639591,7,0,1500,135
2020-08-18,Italy,NA,Sardinia,1639591,12,0,1512,135
2020-08-19,Italy,NA,Sardinia,1639591,37,0,1549,135
2020-08-20,Italy,NA,Sardinia,1639591,23,0,1567,135
2020-08-21,Italy,NA,Sardinia,1639591,42,0,1609,135
2020-08-22,Italy,NA,Sardinia,1639591,44,0,1653,135
2020-08-23,Italy,NA,Sardinia,1639591,81,0,1734,135
2020-08-24,Italy,NA,Sardinia,1639591,91,0,1825,135
2020-08-25,Italy,NA,Sardinia,1639591,34,0,1859,135
2020-08-26,Italy,NA,Sardinia,1639591,53,0,1912,135
2020-08-27,Italy,NA,Sardinia,1639591,57,0,1967,135
2020-08-28,Italy,NA,Sardinia,1639591,55,0,2022,135
2020-08-29,Italy,NA,Sardinia,1639591,70,0,2092,135
2020-08-30,Italy,NA,Sardinia,1639591,22,0,2114,135
2020-08-31,Italy,NA,Sardinia,1639591,79,0,2193,135
2020-09-01,Italy,NA,Sardinia,1639591,50,0,2243,135
2020-09-02,Italy,NA,Sardinia,1639591,73,1,2316,135
2020-09-03,Italy,NA,Sardinia,1639591,39,0,2355,135
2020-09-04,Italy,NA,Sardinia,1639591,66,0,2421,135
2020-09-05,Italy,NA,Sardinia,1639591,65,1,2486,136
2020-09-06,Italy,NA,Sardinia,1639591,19,0,2505,136
2020-09-07,Italy,NA,Sardinia,1639591,59,0,2564,136
2020-09-08,Italy,NA,Sardinia,1639591,51,0,2615,136
2020-09-09,Italy,NA,Sardinia,1639591,47,2,2662,138
2020-09-10,Italy,NA,Sardinia,1639591,63,1,2725,139
2020-09-11,Italy,NA,Sardinia,1639591,65,0,2790,139
2020-09-12,Italy,NA,Sardinia,1639591,51,1,2841,140
2020-09-13,Italy,NA,Sardinia,1639591,33,0,2874,140
2020-09-14,Italy,NA,Sardinia,1639591,54,0,2928,140
2020-09-15,Italy,NA,Sardinia,1639591,36,0,2964,140
2020-09-16,Italy,NA,Sardinia,1639591,27,0,2991,140
2020-09-17,Italy,NA,Sardinia,1639591,51,0,3042,140
2020-09-18,Italy,NA,Sardinia,1639591,66,1,3108,141
2020-09-19,Italy,NA,Sardinia,1639591,59,0,3167,141
2020-09-20,Italy,NA,Sardinia,1639591,72,0,3239,141
2020-09-21,Italy,NA,Sardinia,1639591,64,2,3303,143
2020-09-22,Italy,NA,Sardinia,1639591,53,0,3356,143
2020-09-23,Italy,NA,Sardinia,1639591,49,2,3405,145
2020-03-04,Italy,NA,Sicily,4999891,11,0,18,0
2020-03-05,Italy,NA,Sicily,4999891,0,0,18,0
2020-03-06,Italy,NA,Sicily,4999891,6,0,24,0
2020-03-07,Italy,NA,Sicily,4999891,11,0,35,0
2020-03-08,Italy,NA,Sicily,4999891,18,0,53,0
2020-03-09,Italy,NA,Sicily,4999891,1,0,54,0
2020-03-10,Italy,NA,Sicily,4999891,8,0,62,0
2020-03-11,Italy,NA,Sicily,4999891,21,0,83,0
2020-03-12,Italy,NA,Sicily,4999891,32,2,115,2
2020-03-13,Italy,NA,Sicily,4999891,15,0,130,2
2020-03-14,Italy,NA,Sicily,4999891,26,0,156,2
2020-03-15,Italy,NA,Sicily,4999891,32,0,188,2
2020-03-16,Italy,NA,Sicily,4999891,25,0,213,2
2020-03-17,Italy,NA,Sicily,4999891,24,1,237,3
2020-03-18,Italy,NA,Sicily,4999891,45,0,282,3
2020-03-19,Italy,NA,Sicily,4999891,58,1,340,4
2020-03-20,Italy,NA,Sicily,4999891,68,0,408,4
2020-03-21,Italy,NA,Sicily,4999891,82,2,490,6
2020-03-22,Italy,NA,Sicily,4999891,140,2,630,8
2020-03-23,Italy,NA,Sicily,4999891,91,5,721,13
2020-03-24,Italy,NA,Sicily,4999891,125,7,846,20
2020-03-25,Italy,NA,Sicily,4999891,148,5,994,25
2020-03-26,Italy,NA,Sicily,4999891,170,8,1164,33
2020-03-27,Italy,NA,Sicily,4999891,86,6,1250,39
2020-03-28,Italy,NA,Sicily,4999891,109,18,1359,57
2020-03-29,Italy,NA,Sicily,4999891,101,8,1460,65
2020-03-30,Italy,NA,Sicily,4999891,95,11,1555,76
2020-03-31,Italy,NA,Sicily,4999891,92,5,1647,81
2020-04-01,Italy,NA,Sicily,4999891,71,7,1718,88
2020-04-02,Italy,NA,Sicily,4999891,73,5,1791,93
2020-04-03,Italy,NA,Sicily,4999891,68,8,1859,101
2020-04-04,Italy,NA,Sicily,4999891,73,10,1932,111
2020-04-05,Italy,NA,Sicily,4999891,62,5,1994,116
2020-04-06,Italy,NA,Sicily,4999891,52,7,2046,123
2020-04-07,Italy,NA,Sicily,4999891,51,2,2097,125
2020-04-08,Italy,NA,Sicily,4999891,62,8,2159,133
2020-04-09,Italy,NA,Sicily,4999891,73,5,2232,138
2020-04-10,Italy,NA,Sicily,4999891,70,10,2302,148
2020-04-11,Italy,NA,Sicily,4999891,62,6,2364,154
2020-04-12,Italy,NA,Sicily,4999891,52,9,2416,163
2020-04-13,Italy,NA,Sicily,4999891,42,8,2458,171
2020-04-14,Italy,NA,Sicily,4999891,43,4,2501,175
2020-04-15,Italy,NA,Sicily,4999891,34,6,2535,181
2020-04-16,Italy,NA,Sicily,4999891,44,6,2579,187
2020-04-17,Italy,NA,Sicily,4999891,46,3,2625,190
2020-04-18,Italy,NA,Sicily,4999891,47,6,2672,196
2020-04-19,Italy,NA,Sicily,4999891,45,4,2717,200
2020-04-20,Italy,NA,Sicily,4999891,42,3,2759,203
2020-04-21,Italy,NA,Sicily,4999891,76,3,2835,206
2020-04-22,Italy,NA,Sicily,4999891,48,2,2883,208
2020-04-23,Italy,NA,Sicily,4999891,43,5,2926,213
2020-04-24,Italy,NA,Sicily,4999891,55,5,2981,218
2020-04-25,Italy,NA,Sicily,4999891,39,6,3020,224
2020-04-26,Italy,NA,Sicily,4999891,35,4,3055,228
2020-04-27,Italy,NA,Sicily,4999891,30,3,3085,231
2020-04-28,Italy,NA,Sicily,4999891,35,1,3120,232
2020-04-29,Italy,NA,Sicily,4999891,20,0,3140,232
2020-04-30,Italy,NA,Sicily,4999891,26,3,3166,235
2020-05-01,Italy,NA,Sicily,4999891,28,2,3194,237
2020-05-02,Italy,NA,Sicily,4999891,19,3,3213,240
2020-05-03,Italy,NA,Sicily,4999891,27,2,3240,242
2020-05-04,Italy,NA,Sicily,4999891,15,2,3255,244
2020-05-05,Italy,NA,Sicily,4999891,12,3,3267,247
2020-05-06,Italy,NA,Sicily,4999891,14,3,3281,250
2020-05-07,Italy,NA,Sicily,4999891,7,1,3288,251
2020-05-08,Italy,NA,Sicily,4999891,13,2,3301,253
2020-05-09,Italy,NA,Sicily,4999891,12,3,3313,256
2020-05-10,Italy,NA,Sicily,4999891,14,0,3327,256
2020-05-11,Italy,NA,Sicily,4999891,12,1,3339,257
2020-05-12,Italy,NA,Sicily,4999891,4,4,3343,261
2020-05-13,Italy,NA,Sicily,4999891,11,1,3354,262
2020-05-14,Italy,NA,Sicily,4999891,12,1,3366,263
2020-05-15,Italy,NA,Sicily,4999891,8,0,3374,263
2020-05-16,Italy,NA,Sicily,4999891,8,2,3382,265
2020-05-17,Italy,NA,Sicily,4999891,6,2,3388,267
2020-05-18,Italy,NA,Sicily,4999891,7,0,3395,267
2020-05-19,Italy,NA,Sicily,4999891,8,1,3403,268
2020-05-20,Italy,NA,Sicily,4999891,8,0,3411,268
2020-05-21,Italy,NA,Sicily,4999891,6,0,3417,268
2020-05-22,Italy,NA,Sicily,4999891,4,0,3421,268
2020-05-23,Italy,NA,Sicily,4999891,0,1,3421,269
2020-05-24,Italy,NA,Sicily,4999891,2,0,3423,269
2020-05-25,Italy,NA,Sicily,4999891,4,1,3427,270
2020-05-26,Italy,NA,Sicily,4999891,3,1,3430,271
2020-05-27,Italy,NA,Sicily,4999891,5,1,3435,272
2020-05-28,Italy,NA,Sicily,4999891,3,0,3438,272
2020-05-29,Italy,NA,Sicily,4999891,2,0,3440,272
2020-05-30,Italy,NA,Sicily,4999891,2,1,3442,273
2020-05-31,Italy,NA,Sicily,4999891,1,1,3443,274
2020-06-01,Italy,NA,Sicily,4999891,0,0,3443,274
2020-06-02,Italy,NA,Sicily,4999891,4,1,3447,275
2020-06-03,Italy,NA,Sicily,4999891,0,0,3447,275
2020-06-04,Italy,NA,Sicily,4999891,0,1,3447,276
2020-06-05,Italy,NA,Sicily,4999891,1,0,3448,276
2020-06-06,Italy,NA,Sicily,4999891,2,0,3450,276
2020-06-07,Italy,NA,Sicily,4999891,1,1,3451,277
2020-06-08,Italy,NA,Sicily,4999891,1,1,3452,278
2020-06-09,Italy,NA,Sicily,4999891,2,0,3454,278
2020-06-10,Italy,NA,Sicily,4999891,1,0,3455,278
2020-06-11,Italy,NA,Sicily,4999891,0,1,3455,279
2020-06-12,Italy,NA,Sicily,4999891,0,0,3455,279
2020-06-13,Italy,NA,Sicily,4999891,1,0,3456,279
2020-06-14,Italy,NA,Sicily,4999891,1,0,3457,279
2020-06-15,Italy,NA,Sicily,4999891,1,1,3458,280
2020-06-16,Italy,NA,Sicily,4999891,2,0,3460,280
2020-06-17,Italy,NA,Sicily,4999891,2,0,3462,280
2020-06-18,Italy,NA,Sicily,4999891,2,0,3464,280
2020-06-19,Italy,NA,Sicily,4999891,3,0,3464,280
2020-06-20,Italy,NA,Sicily,4999891,0,0,3464,280
2020-06-21,Italy,NA,Sicily,4999891,2,0,3464,280
2020-06-22,Italy,NA,Sicily,4999891,0,0,3464,280
2020-06-23,Italy,NA,Sicily,4999891,1,0,3464,280
2020-06-24,Italy,NA,Sicily,4999891,1,0,3464,280
2020-06-25,Italy,NA,Sicily,4999891,2,0,3464,280
2020-06-26,Italy,NA,Sicily,4999891,0,1,3464,281
2020-06-27,Italy,NA,Sicily,4999891,1,0,3464,281
2020-06-28,Italy,NA,Sicily,4999891,0,0,3464,281
2020-06-29,Italy,NA,Sicily,4999891,1,0,3464,281
2020-06-30,Italy,NA,Sicily,4999891,2,1,3464,282
2020-07-01,Italy,NA,Sicily,4999891,1,0,3464,282
2020-07-02,Italy,NA,Sicily,4999891,9,0,3464,282
2020-07-03,Italy,NA,Sicily,4999891,1,0,3464,282
2020-07-04,Italy,NA,Sicily,4999891,3,0,3464,282
2020-07-05,Italy,NA,Sicily,4999891,0,0,3464,282
2020-07-06,Italy,NA,Sicily,4999891,1,0,3464,282
2020-07-07,Italy,NA,Sicily,4999891,1,0,3464,282
2020-07-08,Italy,NA,Sicily,4999891,1,1,3464,283
2020-07-09,Italy,NA,Sicily,4999891,1,0,3464,283
2020-07-10,Italy,NA,Sicily,4999891,0,0,3464,283
2020-07-11,Italy,NA,Sicily,4999891,1,0,3464,283
2020-07-12,Italy,NA,Sicily,4999891,0,0,3464,283
2020-07-13,Italy,NA,Sicily,4999891,1,0,3464,283
2020-07-14,Italy,NA,Sicily,4999891,15,0,3464,283
2020-07-15,Italy,NA,Sicily,4999891,0,0,3464,283
2020-07-16,Italy,NA,Sicily,4999891,17,0,3464,283
2020-07-17,Italy,NA,Sicily,4999891,4,0,3464,283
2020-07-18,Italy,NA,Sicily,4999891,4,0,3464,283
2020-07-19,Italy,NA,Sicily,4999891,2,0,3464,283
2020-07-20,Italy,NA,Sicily,4999891,2,0,3464,283
2020-07-21,Italy,NA,Sicily,4999891,2,0,3464,283
2020-07-22,Italy,NA,Sicily,4999891,7,0,3464,283
2020-07-23,Italy,NA,Sicily,4999891,5,0,3464,283
2020-07-24,Italy,NA,Sicily,4999891,8,0,3464,283
2020-07-25,Italy,NA,Sicily,4999891,13,0,3464,283
2020-07-26,Italy,NA,Sicily,4999891,14,0,3464,283
2020-07-27,Italy,NA,Sicily,4999891,3,0,3464,283
2020-07-28,Italy,NA,Sicily,4999891,19,0,3464,283
2020-07-29,Italy,NA,Sicily,4999891,18,0,3464,283
2020-07-30,Italy,NA,Sicily,4999891,39,0,3464,283
2020-07-31,Italy,NA,Sicily,4999891,16,0,3464,283
2020-08-01,Italy,NA,Sicily,4999891,10,0,3464,283
2020-08-02,Italy,NA,Sicily,4999891,7,0,3464,283
2020-08-03,Italy,NA,Sicily,4999891,3,0,3464,283
2020-08-04,Italy,NA,Sicily,4999891,10,1,3464,284
2020-08-05,Italy,NA,Sicily,4999891,21,0,3464,284
2020-08-06,Italy,NA,Sicily,4999891,30,0,3464,284
2020-08-07,Italy,NA,Sicily,4999891,27,0,3464,284
2020-08-08,Italy,NA,Sicily,4999891,28,0,3464,284
2020-08-09,Italy,NA,Sicily,4999891,29,0,3464,284
2020-08-10,Italy,NA,Sicily,4999891,32,0,3485,284
2020-08-11,Italy,NA,Sicily,4999891,89,0,3574,284
2020-08-12,Italy,NA,Sicily,4999891,29,0,3603,284
2020-08-13,Italy,NA,Sicily,4999891,42,0,3645,284
2020-08-14,Italy,NA,Sicily,4999891,36,0,3681,284
2020-08-15,Italy,NA,Sicily,4999891,46,0,3727,284
2020-08-16,Italy,NA,Sicily,4999891,39,1,3766,285
2020-08-17,Italy,NA,Sicily,4999891,14,1,3780,286
2020-08-18,Italy,NA,Sicily,4999891,13,0,3793,286
2020-08-19,Italy,NA,Sicily,4999891,45,0,3838,286
2020-08-20,Italy,NA,Sicily,4999891,37,0,3875,286
2020-08-21,Italy,NA,Sicily,4999891,44,0,3919,286
2020-08-22,Italy,NA,Sicily,4999891,48,0,3967,286
2020-08-23,Italy,NA,Sicily,4999891,35,0,4002,286
2020-08-24,Italy,NA,Sicily,4999891,65,0,4067,286
2020-08-25,Italy,NA,Sicily,4999891,24,0,4091,286
2020-08-26,Italy,NA,Sicily,4999891,33,0,4124,286
2020-08-27,Italy,NA,Sicily,4999891,50,0,4174,286
2020-08-28,Italy,NA,Sicily,4999891,54,0,4228,286
2020-08-29,Italy,NA,Sicily,4999891,29,0,4257,286
2020-08-30,Italy,NA,Sicily,4999891,34,0,4291,286
2020-08-31,Italy,NA,Sicily,4999891,26,0,4317,286
2020-09-01,Italy,NA,Sicily,4999891,33,1,4350,287
2020-09-02,Italy,NA,Sicily,4999891,83,0,4433,287
2020-09-03,Italy,NA,Sicily,4999891,54,1,4487,288
2020-09-04,Italy,NA,Sicily,4999891,78,0,4565,288
2020-09-05,Italy,NA,Sicily,4999891,114,1,4679,289
2020-09-06,Italy,NA,Sicily,4999891,37,0,4716,289
2020-09-07,Italy,NA,Sicily,4999891,49,0,4765,289
2020-09-08,Italy,NA,Sicily,4999891,84,0,4849,289
2020-09-09,Italy,NA,Sicily,4999891,77,0,4926,289
2020-09-10,Italy,NA,Sicily,4999891,106,0,5032,289
2020-09-11,Italy,NA,Sicily,4999891,104,0,5136,289
2020-09-12,Italy,NA,Sicily,4999891,44,0,5180,289
2020-09-13,Italy,NA,Sicily,4999891,61,1,5241,290
2020-09-14,Italy,NA,Sicily,4999891,65,2,5306,292
2020-09-15,Italy,NA,Sicily,4999891,77,0,5383,292
2020-09-16,Italy,NA,Sicily,4999891,90,3,5473,295
2020-09-17,Italy,NA,Sicily,4999891,96,0,5569,295
2020-09-18,Italy,NA,Sicily,4999891,179,1,5748,296
2020-09-19,Italy,NA,Sicily,4999891,98,0,5846,296
2020-09-20,Italy,NA,Sicily,4999891,116,0,5962,296
2020-09-21,Italy,NA,Sicily,4999891,75,3,6037,299
2020-09-22,Italy,NA,Sicily,4999891,108,1,6145,300
2020-09-23,Italy,NA,Sicily,4999891,89,3,6234,303
2020-03-10,Italy,NA,South Tyrol,531178,29,0,38,0
2020-03-11,Italy,NA,South Tyrol,531178,37,0,75,0
2020-03-12,Italy,NA,South Tyrol,531178,29,1,104,1
2020-03-13,Italy,NA,South Tyrol,531178,21,1,125,2
2020-03-14,Italy,NA,South Tyrol,531178,48,1,173,3
2020-03-15,Italy,NA,South Tyrol,531178,31,2,204,5
2020-03-16,Italy,NA,South Tyrol,531178,37,1,241,6
2020-03-17,Italy,NA,South Tyrol,531178,50,2,291,8
2020-03-18,Italy,NA,South Tyrol,531178,85,1,376,9
2020-03-19,Italy,NA,South Tyrol,531178,60,5,436,14
2020-03-20,Italy,NA,South Tyrol,531178,112,3,548,17
2020-03-21,Italy,NA,South Tyrol,531178,73,3,621,20
2020-03-22,Italy,NA,South Tyrol,531178,57,3,678,23
2020-03-23,Italy,NA,South Tyrol,531178,46,6,724,29
2020-03-24,Italy,NA,South Tyrol,531178,57,9,781,38
2020-03-25,Italy,NA,South Tyrol,531178,77,5,858,43
2020-03-26,Italy,NA,South Tyrol,531178,48,5,906,48
2020-03-27,Italy,NA,South Tyrol,531178,97,12,1003,60
2020-03-28,Italy,NA,South Tyrol,531178,106,4,1109,64
2020-03-29,Italy,NA,South Tyrol,531178,105,0,1214,64
2020-03-30,Italy,NA,South Tyrol,531178,111,10,1325,74
2020-03-31,Italy,NA,South Tyrol,531178,46,2,1371,76
2020-04-01,Italy,NA,South Tyrol,531178,47,40,1418,116
2020-04-02,Italy,NA,South Tyrol,531178,61,13,1479,129
2020-04-03,Italy,NA,South Tyrol,531178,80,10,1559,139
2020-04-04,Italy,NA,South Tyrol,531178,33,7,1592,146
2020-04-05,Italy,NA,South Tyrol,531178,52,12,1644,158
2020-04-06,Italy,NA,South Tyrol,531178,78,6,1722,164
2020-04-07,Italy,NA,South Tyrol,531178,89,10,1811,174
2020-04-08,Italy,NA,South Tyrol,531178,24,9,1835,183
2020-04-09,Italy,NA,South Tyrol,531178,68,4,1903,187
2020-04-10,Italy,NA,South Tyrol,531178,52,4,1955,191
2020-04-11,Italy,NA,South Tyrol,531178,2,9,1957,200
2020-04-12,Italy,NA,South Tyrol,531178,141,5,2098,205
2020-04-13,Italy,NA,South Tyrol,531178,51,7,2149,212
2020-04-14,Italy,NA,South Tyrol,531178,35,2,2184,214
2020-04-15,Italy,NA,South Tyrol,531178,40,9,2224,223
2020-04-16,Italy,NA,South Tyrol,531178,43,2,2267,225
2020-04-17,Italy,NA,South Tyrol,531178,29,9,2296,234
2020-04-18,Italy,NA,South Tyrol,531178,29,5,2325,239
2020-04-19,Italy,NA,South Tyrol,531178,55,6,2380,245
2020-04-20,Italy,NA,South Tyrol,531178,14,4,2394,249
2020-04-21,Italy,NA,South Tyrol,531178,16,2,2410,251
2020-04-22,Italy,NA,South Tyrol,531178,6,5,2416,256
2020-04-23,Italy,NA,South Tyrol,531178,19,5,2435,261
2020-04-24,Italy,NA,South Tyrol,531178,21,2,2456,263
2020-04-25,Italy,NA,South Tyrol,531178,20,2,2476,265
2020-04-26,Italy,NA,South Tyrol,531178,5,4,2481,269
2020-04-27,Italy,NA,South Tyrol,531178,15,1,2496,270
2020-04-28,Italy,NA,South Tyrol,531178,2,2,2498,272
2020-04-29,Italy,NA,South Tyrol,531178,9,2,2507,274
2020-04-30,Italy,NA,South Tyrol,531178,11,1,2518,275
2020-05-01,Italy,NA,South Tyrol,531178,10,3,2528,278
2020-05-02,Italy,NA,South Tyrol,531178,7,1,2535,279
2020-05-03,Italy,NA,South Tyrol,531178,1,2,2536,281
2020-05-04,Italy,NA,South Tyrol,531178,5,3,2541,284
2020-05-05,Italy,NA,South Tyrol,531178,1,2,2542,286
2020-05-06,Italy,NA,South Tyrol,531178,1,0,2543,286
2020-05-07,Italy,NA,South Tyrol,531178,9,0,2552,286
2020-05-08,Italy,NA,South Tyrol,531178,6,3,2558,289
2020-05-09,Italy,NA,South Tyrol,531178,9,1,2567,290
2020-05-10,Italy,NA,South Tyrol,531178,2,0,2569,290
2020-05-11,Italy,NA,South Tyrol,531178,3,0,2572,290
2020-05-12,Italy,NA,South Tyrol,531178,0,0,2572,290
2020-05-13,Italy,NA,South Tyrol,531178,3,0,2575,290
2020-05-14,Italy,NA,South Tyrol,531178,3,0,2578,290
2020-05-15,Italy,NA,South Tyrol,531178,0,0,2578,290
2020-05-16,Italy,NA,South Tyrol,531178,0,0,2578,290
2020-05-17,Italy,NA,South Tyrol,531178,3,0,2581,290
2020-05-18,Italy,NA,South Tyrol,531178,1,1,2582,291
2020-05-19,Italy,NA,South Tyrol,531178,5,0,2587,291
2020-05-20,Italy,NA,South Tyrol,531178,0,0,2587,291
2020-05-21,Italy,NA,South Tyrol,531178,0,0,2587,291
2020-05-22,Italy,NA,South Tyrol,531178,3,0,2590,291
2020-05-23,Italy,NA,South Tyrol,531178,0,0,2590,291
2020-05-24,Italy,NA,South Tyrol,531178,3,0,2593,291
2020-05-25,Italy,NA,South Tyrol,531178,0,0,2593,291
2020-05-26,Italy,NA,South Tyrol,531178,0,0,2593,291
2020-05-27,Italy,NA,South Tyrol,531178,0,0,2593,291
2020-05-28,Italy,NA,South Tyrol,531178,2,0,2595,291
2020-05-29,Italy,NA,South Tyrol,531178,0,0,2595,291
2020-05-30,Italy,NA,South Tyrol,531178,1,0,2596,291
2020-05-31,Italy,NA,South Tyrol,531178,1,0,2597,291
2020-06-01,Italy,NA,South Tyrol,531178,1,0,2598,291
2020-06-02,Italy,NA,South Tyrol,531178,0,0,2598,291
2020-06-03,Italy,NA,South Tyrol,531178,0,0,2598,291
2020-06-04,Italy,NA,South Tyrol,531178,0,1,2598,292
2020-06-05,Italy,NA,South Tyrol,531178,1,0,2599,292
2020-06-06,Italy,NA,South Tyrol,531178,1,0,2600,292
2020-06-07,Italy,NA,South Tyrol,531178,3,0,2603,292
2020-06-08,Italy,NA,South Tyrol,531178,1,0,2604,292
2020-06-09,Italy,NA,South Tyrol,531178,0,0,2604,292
2020-06-10,Italy,NA,South Tyrol,531178,0,0,2604,292
2020-06-11,Italy,NA,South Tyrol,531178,2,0,2606,292
2020-06-12,Italy,NA,South Tyrol,531178,2,0,2608,292
2020-06-13,Italy,NA,South Tyrol,531178,2,0,2610,292
2020-06-14,Italy,NA,South Tyrol,531178,3,0,2613,292
2020-06-15,Italy,NA,South Tyrol,531178,0,1,2613,292
2020-06-16,Italy,NA,South Tyrol,531178,0,0,2613,292
2020-06-17,Italy,NA,South Tyrol,531178,0,0,2613,292
2020-06-18,Italy,NA,South Tyrol,531178,2,0,2613,292
2020-06-19,Italy,NA,South Tyrol,531178,2,0,2615,292
2020-06-20,Italy,NA,South Tyrol,531178,0,0,2618,292
2020-06-21,Italy,NA,South Tyrol,531178,4,0,2622,292
2020-06-22,Italy,NA,South Tyrol,531178,11,0,2633,292
2020-06-23,Italy,NA,South Tyrol,531178,0,0,2633,292
2020-06-24,Italy,NA,South Tyrol,531178,1,0,2634,292
2020-06-25,Italy,NA,South Tyrol,531178,0,0,2634,292
2020-06-26,Italy,NA,South Tyrol,531178,0,0,2634,292
2020-06-27,Italy,NA,South Tyrol,531178,2,0,2636,292
2020-06-28,Italy,NA,South Tyrol,531178,1,0,2637,292
2020-06-29,Italy,NA,South Tyrol,531178,2,0,2639,292
2020-06-30,Italy,NA,South Tyrol,531178,0,0,2639,292
2020-07-01,Italy,NA,South Tyrol,531178,3,0,2642,292
2020-07-02,Italy,NA,South Tyrol,531178,0,0,2642,292
2020-07-03,Italy,NA,South Tyrol,531178,0,0,2642,292
2020-07-04,Italy,NA,South Tyrol,531178,3,0,2645,292
2020-07-05,Italy,NA,South Tyrol,531178,2,0,2647,292
2020-07-06,Italy,NA,South Tyrol,531178,0,0,2647,292
2020-07-07,Italy,NA,South Tyrol,531178,1,0,2648,292
2020-07-08,Italy,NA,South Tyrol,531178,2,0,2650,292
2020-07-09,Italy,NA,South Tyrol,531178,3,0,2653,292
2020-07-10,Italy,NA,South Tyrol,531178,5,0,2658,292
2020-07-11,Italy,NA,South Tyrol,531178,3,0,2661,292
2020-07-12,Italy,NA,South Tyrol,531178,5,0,2666,292
2020-07-13,Italy,NA,South Tyrol,531178,7,0,2673,292
2020-07-14,Italy,NA,South Tyrol,531178,1,0,2674,292
2020-07-15,Italy,NA,South Tyrol,531178,3,0,2677,292
2020-07-16,Italy,NA,South Tyrol,531178,1,0,2678,292
2020-07-17,Italy,NA,South Tyrol,531178,4,0,2682,292
2020-07-18,Italy,NA,South Tyrol,531178,1,0,2683,292
2020-07-19,Italy,NA,South Tyrol,531178,1,0,2684,292
2020-07-20,Italy,NA,South Tyrol,531178,0,0,2684,292
2020-07-21,Italy,NA,South Tyrol,531178,1,0,2685,292
2020-07-22,Italy,NA,South Tyrol,531178,0,0,2685,292
2020-07-23,Italy,NA,South Tyrol,531178,1,0,2686,292
2020-07-24,Italy,NA,South Tyrol,531178,1,0,2687,292
2020-07-25,Italy,NA,South Tyrol,531178,6,0,2693,292
2020-07-26,Italy,NA,South Tyrol,531178,5,0,2698,292
2020-07-27,Italy,NA,South Tyrol,531178,2,0,2700,292
2020-07-28,Italy,NA,South Tyrol,531178,2,0,2700,292
2020-07-29,Italy,NA,South Tyrol,531178,5,0,2700,292
2020-07-30,Italy,NA,South Tyrol,531178,6,0,2702,292
2020-07-31,Italy,NA,South Tyrol,531178,15,0,2717,292
2020-08-01,Italy,NA,South Tyrol,531178,8,0,2725,292
2020-08-02,Italy,NA,South Tyrol,531178,3,0,2728,292
2020-08-03,Italy,NA,South Tyrol,531178,6,0,2734,292
2020-08-04,Italy,NA,South Tyrol,531178,6,0,2740,292
2020-08-05,Italy,NA,South Tyrol,531178,5,0,2745,292
2020-08-06,Italy,NA,South Tyrol,531178,12,0,2757,292
2020-08-07,Italy,NA,South Tyrol,531178,4,0,2761,292
2020-08-08,Italy,NA,South Tyrol,531178,5,0,2766,292
2020-08-09,Italy,NA,South Tyrol,531178,7,0,2773,292
2020-08-10,Italy,NA,South Tyrol,531178,1,0,2774,292
2020-08-11,Italy,NA,South Tyrol,531178,1,0,2775,292
2020-08-12,Italy,NA,South Tyrol,531178,4,0,2779,292
2020-08-13,Italy,NA,South Tyrol,531178,3,0,2781,292
2020-08-14,Italy,NA,South Tyrol,531178,3,0,2784,292
2020-08-15,Italy,NA,South Tyrol,531178,9,0,2793,292
2020-08-16,Italy,NA,South Tyrol,531178,9,0,2802,292
2020-08-17,Italy,NA,South Tyrol,531178,2,0,2804,292
2020-08-18,Italy,NA,South Tyrol,531178,0,0,2804,292
2020-08-19,Italy,NA,South Tyrol,531178,7,0,2811,292
2020-08-20,Italy,NA,South Tyrol,531178,21,0,2832,292
2020-08-21,Italy,NA,South Tyrol,531178,5,0,2837,292
2020-08-22,Italy,NA,South Tyrol,531178,19,0,2856,292
2020-08-23,Italy,NA,South Tyrol,531178,13,0,2869,292
2020-08-24,Italy,NA,South Tyrol,531178,15,0,2884,292
2020-08-25,Italy,NA,South Tyrol,531178,9,0,2893,292
2020-08-26,Italy,NA,South Tyrol,531178,5,0,2898,292
2020-08-27,Italy,NA,South Tyrol,531178,9,0,2907,292
2020-08-28,Italy,NA,South Tyrol,531178,8,0,2915,292
2020-08-29,Italy,NA,South Tyrol,531178,9,0,2924,292
2020-08-30,Italy,NA,South Tyrol,531178,8,0,2932,292
2020-08-31,Italy,NA,South Tyrol,531178,3,0,2935,292
2020-09-01,Italy,NA,South Tyrol,531178,13,0,2948,292
2020-09-02,Italy,NA,South Tyrol,531178,10,0,2958,292
2020-09-03,Italy,NA,South Tyrol,531178,4,0,2962,292
2020-09-04,Italy,NA,South Tyrol,531178,11,0,2973,292
2020-09-05,Italy,NA,South Tyrol,531178,23,0,2996,292
2020-09-06,Italy,NA,South Tyrol,531178,7,0,3003,292
2020-09-07,Italy,NA,South Tyrol,531178,0,0,3003,292
2020-09-08,Italy,NA,South Tyrol,531178,4,0,3007,292
2020-09-09,Italy,NA,South Tyrol,531178,10,0,3017,292
2020-09-10,Italy,NA,South Tyrol,531178,20,0,3037,292
2020-09-11,Italy,NA,South Tyrol,531178,26,0,3063,292
2020-09-12,Italy,NA,South Tyrol,531178,25,0,3088,292
2020-09-13,Italy,NA,South Tyrol,531178,40,0,3128,292
2020-09-14,Italy,NA,South Tyrol,531178,7,0,3135,292
2020-09-15,Italy,NA,South Tyrol,531178,21,0,3156,292
2020-09-16,Italy,NA,South Tyrol,531178,12,0,3168,292
2020-09-17,Italy,NA,South Tyrol,531178,15,0,3183,292
2020-09-18,Italy,NA,South Tyrol,531178,72,0,3255,292
2020-09-19,Italy,NA,South Tyrol,531178,26,0,3281,292
2020-09-20,Italy,NA,South Tyrol,531178,20,0,3301,292
2020-09-21,Italy,NA,South Tyrol,531178,20,0,3321,292
2020-09-22,Italy,NA,South Tyrol,531178,8,0,3329,292
2020-09-23,Italy,NA,South Tyrol,531178,37,0,3366,292
2020-03-07,Italy,NA,Trentino-Alto Adige,541098,4,0,14,0
2020-03-08,Italy,NA,Trentino-Alto Adige,541098,9,0,23,0
2020-03-09,Italy,NA,Trentino-Alto Adige,541098,10,0,33,0
2020-03-10,Italy,NA,Trentino-Alto Adige,541098,19,0,52,0
2020-03-11,Italy,NA,Trentino-Alto Adige,541098,25,0,77,0
2020-03-12,Italy,NA,Trentino-Alto Adige,541098,30,1,107,1
2020-03-13,Italy,NA,Trentino-Alto Adige,541098,56,1,163,2
2020-03-14,Italy,NA,Trentino-Alto Adige,541098,43,0,206,2
2020-03-15,Italy,NA,Trentino-Alto Adige,541098,172,4,378,6
2020-03-16,Italy,NA,Trentino-Alto Adige,541098,0,0,378,6
2020-03-17,Italy,NA,Trentino-Alto Adige,541098,7,1,385,7
2020-03-18,Italy,NA,Trentino-Alto Adige,541098,70,0,455,7
2020-03-19,Italy,NA,Trentino-Alto Adige,541098,68,5,523,12
2020-03-20,Italy,NA,Trentino-Alto Adige,541098,119,1,642,13
2020-03-21,Italy,NA,Trentino-Alto Adige,541098,140,15,782,28
2020-03-22,Italy,NA,Trentino-Alto Adige,541098,172,7,954,35
2020-03-23,Italy,NA,Trentino-Alto Adige,541098,69,6,1023,41
2020-03-24,Italy,NA,Trentino-Alto Adige,541098,87,15,1110,56
2020-03-25,Italy,NA,Trentino-Alto Adige,541098,112,18,1222,74
2020-03-26,Italy,NA,Trentino-Alto Adige,541098,75,12,1297,86
2020-03-27,Italy,NA,Trentino-Alto Adige,541098,94,16,1391,102
2020-03-28,Italy,NA,Trentino-Alto Adige,541098,114,18,1505,120
2020-03-29,Italy,NA,Trentino-Alto Adige,541098,89,9,1594,129
2020-03-30,Italy,NA,Trentino-Alto Adige,541098,88,18,1682,147
2020-03-31,Italy,NA,Trentino-Alto Adige,541098,64,17,1746,164
2020-04-01,Italy,NA,Trentino-Alto Adige,541098,124,9,1870,173
2020-04-02,Italy,NA,Trentino-Alto Adige,541098,133,14,2003,187
2020-04-03,Italy,NA,Trentino-Alto Adige,541098,106,17,2109,204
2020-04-04,Italy,NA,Trentino-Alto Adige,541098,111,6,2220,210
2020-04-05,Italy,NA,Trentino-Alto Adige,541098,65,7,2285,217
2020-04-06,Italy,NA,Trentino-Alto Adige,541098,63,13,2348,230
2020-04-07,Italy,NA,Trentino-Alto Adige,541098,128,14,2476,244
2020-04-08,Italy,NA,Trentino-Alto Adige,541098,126,11,2602,255
2020-04-09,Italy,NA,Trentino-Alto Adige,541098,106,13,2708,268
2020-04-10,Italy,NA,Trentino-Alto Adige,541098,108,7,2816,275
2020-04-11,Italy,NA,Trentino-Alto Adige,541098,154,9,2970,284
2020-04-12,Italy,NA,Trentino-Alto Adige,541098,83,9,3053,293
2020-04-13,Italy,NA,Trentino-Alto Adige,541098,73,7,3126,300
2020-04-14,Italy,NA,Trentino-Alto Adige,541098,15,10,3141,310
2020-04-15,Italy,NA,Trentino-Alto Adige,541098,79,8,3220,318
2020-04-16,Italy,NA,Trentino-Alto Adige,541098,74,4,3294,322
2020-04-17,Italy,NA,Trentino-Alto Adige,541098,82,20,3376,342
2020-04-18,Italy,NA,Trentino-Alto Adige,541098,55,6,3431,348
2020-04-19,Italy,NA,Trentino-Alto Adige,541098,101,12,3532,360
2020-04-20,Italy,NA,Trentino-Alto Adige,541098,58,6,3590,366
2020-04-21,Italy,NA,Trentino-Alto Adige,541098,24,10,3614,376
2020-04-22,Italy,NA,Trentino-Alto Adige,541098,32,5,3646,381
2020-04-23,Italy,NA,Trentino-Alto Adige,541098,81,1,3727,382
2020-04-24,Italy,NA,Trentino-Alto Adige,541098,49,7,3776,389
2020-04-25,Italy,NA,Trentino-Alto Adige,541098,62,11,3838,400
2020-04-26,Italy,NA,Trentino-Alto Adige,541098,56,5,3894,405
2020-04-27,Italy,NA,Trentino-Alto Adige,541098,101,2,3995,407
2020-04-28,Italy,NA,Trentino-Alto Adige,541098,30,5,4025,412
2020-04-29,Italy,NA,Trentino-Alto Adige,541098,44,4,4069,416
2020-04-30,Italy,NA,Trentino-Alto Adige,541098,47,2,4116,418
2020-05-01,Italy,NA,Trentino-Alto Adige,541098,16,5,4132,423
2020-05-02,Italy,NA,Trentino-Alto Adige,541098,49,2,4181,425
2020-05-03,Italy,NA,Trentino-Alto Adige,541098,66,4,4247,429
2020-05-04,Italy,NA,Trentino-Alto Adige,541098,11,1,4258,430
2020-05-05,Italy,NA,Trentino-Alto Adige,541098,3,3,4261,433
2020-05-06,Italy,NA,Trentino-Alto Adige,541098,19,4,4280,437
2020-05-07,Italy,NA,Trentino-Alto Adige,541098,3,1,4283,438
2020-05-08,Italy,NA,Trentino-Alto Adige,541098,2,0,4285,438
2020-05-09,Italy,NA,Trentino-Alto Adige,541098,7,0,4292,438
2020-05-10,Italy,NA,Trentino-Alto Adige,541098,3,3,4295,441
2020-05-11,Italy,NA,Trentino-Alto Adige,541098,2,2,4297,443
2020-05-12,Italy,NA,Trentino-Alto Adige,541098,6,2,4303,445
2020-05-13,Italy,NA,Trentino-Alto Adige,541098,9,1,4312,446
2020-05-14,Italy,NA,Trentino-Alto Adige,541098,3,2,4315,448
2020-05-15,Italy,NA,Trentino-Alto Adige,541098,3,3,4318,451
2020-05-16,Italy,NA,Trentino-Alto Adige,541098,8,2,4326,453
2020-05-17,Italy,NA,Trentino-Alto Adige,541098,12,0,4338,453
2020-05-18,Italy,NA,Trentino-Alto Adige,541098,13,0,4351,453
2020-05-19,Italy,NA,Trentino-Alto Adige,541098,7,2,4358,455
2020-05-20,Italy,NA,Trentino-Alto Adige,541098,10,0,4368,455
2020-05-21,Italy,NA,Trentino-Alto Adige,541098,10,0,4378,455
2020-05-22,Italy,NA,Trentino-Alto Adige,541098,10,0,4388,455
2020-05-23,Italy,NA,Trentino-Alto Adige,541098,7,1,4395,456
2020-05-24,Italy,NA,Trentino-Alto Adige,541098,9,1,4404,457
2020-05-25,Italy,NA,Trentino-Alto Adige,541098,1,1,4405,458
2020-05-26,Italy,NA,Trentino-Alto Adige,541098,10,3,4415,461
2020-05-27,Italy,NA,Trentino-Alto Adige,541098,7,1,4422,462
2020-05-28,Italy,NA,Trentino-Alto Adige,541098,3,0,4425,462
2020-05-29,Italy,NA,Trentino-Alto Adige,541098,3,0,4428,462
2020-05-30,Italy,NA,Trentino-Alto Adige,541098,1,0,4429,462
2020-05-31,Italy,NA,Trentino-Alto Adige,541098,1,0,4430,462
2020-06-01,Italy,NA,Trentino-Alto Adige,541098,2,0,4432,462
2020-06-02,Italy,NA,Trentino-Alto Adige,541098,0,1,4432,463
2020-06-03,Italy,NA,Trentino-Alto Adige,541098,1,0,4433,463
2020-06-04,Italy,NA,Trentino-Alto Adige,541098,0,1,4433,464
2020-06-05,Italy,NA,Trentino-Alto Adige,541098,0,0,4433,464
2020-06-06,Italy,NA,Trentino-Alto Adige,541098,1,0,4434,464
2020-06-07,Italy,NA,Trentino-Alto Adige,541098,1,0,4435,464
2020-06-08,Italy,NA,Trentino-Alto Adige,541098,1,0,4436,464
2020-06-09,Italy,NA,Trentino-Alto Adige,541098,3,0,4439,464
2020-06-10,Italy,NA,Trentino-Alto Adige,541098,0,0,4439,464
2020-06-11,Italy,NA,Trentino-Alto Adige,541098,2,0,4441,464
2020-06-12,Italy,NA,Trentino-Alto Adige,541098,2,0,4443,464
2020-06-13,Italy,NA,Trentino-Alto Adige,541098,3,0,4446,464
2020-06-14,Italy,NA,Trentino-Alto Adige,541098,1,0,4447,464
2020-06-15,Italy,NA,Trentino-Alto Adige,541098,1,1,4448,465
2020-06-16,Italy,NA,Trentino-Alto Adige,541098,0,0,4448,465
2020-06-17,Italy,NA,Trentino-Alto Adige,541098,1,0,4449,465
2020-06-18,Italy,NA,Trentino-Alto Adige,541098,8,0,4457,465
2020-06-19,Italy,NA,Trentino-Alto Adige,541098,1,1,4458,466
2020-06-20,Italy,NA,Trentino-Alto Adige,541098,0,0,4458,466
2020-06-21,Italy,NA,Trentino-Alto Adige,541098,5,0,4463,466
2020-06-22,Italy,NA,Trentino-Alto Adige,541098,1,0,4464,466
2020-06-23,Italy,NA,Trentino-Alto Adige,541098,1,0,4465,466
2020-06-24,Italy,NA,Trentino-Alto Adige,541098,0,0,4852,466
2020-06-25,Italy,NA,Trentino-Alto Adige,541098,3,0,4855,466
2020-06-26,Italy,NA,Trentino-Alto Adige,541098,4,0,4859,466
2020-06-27,Italy,NA,Trentino-Alto Adige,541098,1,0,4860,466
2020-06-28,Italy,NA,Trentino-Alto Adige,541098,3,0,4863,466
2020-06-29,Italy,NA,Trentino-Alto Adige,541098,0,0,4863,466
2020-06-30,Italy,NA,Trentino-Alto Adige,541098,0,0,4863,466
2020-07-01,Italy,NA,Trentino-Alto Adige,541098,1,0,4864,466
2020-07-02,Italy,NA,Trentino-Alto Adige,541098,1,0,4865,466
2020-07-03,Italy,NA,Trentino-Alto Adige,541098,6,0,4871,466
2020-07-04,Italy,NA,Trentino-Alto Adige,541098,2,0,4873,466
2020-07-05,Italy,NA,Trentino-Alto Adige,541098,0,0,4873,466
2020-07-06,Italy,NA,Trentino-Alto Adige,541098,0,0,4873,466
2020-07-07,Italy,NA,Trentino-Alto Adige,541098,3,0,4876,466
2020-07-08,Italy,NA,Trentino-Alto Adige,541098,0,0,4876,466
2020-07-09,Italy,NA,Trentino-Alto Adige,541098,0,0,4876,466
2020-07-10,Italy,NA,Trentino-Alto Adige,541098,3,0,4879,466
2020-07-11,Italy,NA,Trentino-Alto Adige,541098,2,0,4881,466
2020-07-12,Italy,NA,Trentino-Alto Adige,541098,0,0,4881,466
2020-07-13,Italy,NA,Trentino-Alto Adige,541098,0,0,4881,466
2020-07-14,Italy,NA,Trentino-Alto Adige,541098,0,0,4881,466
2020-07-15,Italy,NA,Trentino-Alto Adige,541098,0,0,4881,466
2020-07-16,Italy,NA,Trentino-Alto Adige,541098,0,0,4881,466
2020-07-17,Italy,NA,Trentino-Alto Adige,541098,0,0,4881,466
2020-07-18,Italy,NA,Trentino-Alto Adige,541098,3,0,4884,466
2020-07-19,Italy,NA,Trentino-Alto Adige,541098,1,0,4885,466
2020-07-20,Italy,NA,Trentino-Alto Adige,541098,4,0,4889,466
2020-07-21,Italy,NA,Trentino-Alto Adige,541098,2,0,4891,466
2020-07-22,Italy,NA,Trentino-Alto Adige,541098,20,0,4911,466
2020-07-23,Italy,NA,Trentino-Alto Adige,541098,30,0,4941,466
2020-07-24,Italy,NA,Trentino-Alto Adige,541098,16,0,4957,466
2020-07-25,Italy,NA,Trentino-Alto Adige,541098,2,0,4959,466
2020-07-26,Italy,NA,Trentino-Alto Adige,541098,6,0,4965,466
2020-07-27,Italy,NA,Trentino-Alto Adige,541098,1,0,4966,466
2020-07-28,Italy,NA,Trentino-Alto Adige,541098,0,0,4966,466
2020-07-29,Italy,NA,Trentino-Alto Adige,541098,4,0,4970,466
2020-07-30,Italy,NA,Trentino-Alto Adige,541098,3,0,4973,466
2020-07-31,Italy,NA,Trentino-Alto Adige,541098,2,0,4975,466
2020-08-01,Italy,NA,Trentino-Alto Adige,541098,0,0,4975,466
2020-08-02,Italy,NA,Trentino-Alto Adige,541098,4,0,4979,466
2020-08-03,Italy,NA,Trentino-Alto Adige,541098,2,0,4981,466
2020-08-04,Italy,NA,Trentino-Alto Adige,541098,2,0,4983,466
2020-08-05,Italy,NA,Trentino-Alto Adige,541098,1,0,4984,466
2020-08-06,Italy,NA,Trentino-Alto Adige,541098,4,0,4988,466
2020-08-07,Italy,NA,Trentino-Alto Adige,541098,4,0,4992,466
2020-08-08,Italy,NA,Trentino-Alto Adige,541098,1,0,4993,466
2020-08-09,Italy,NA,Trentino-Alto Adige,541098,2,0,4995,466
2020-08-10,Italy,NA,Trentino-Alto Adige,541098,1,0,4996,466
2020-08-11,Italy,NA,Trentino-Alto Adige,541098,2,0,4998,466
2020-08-12,Italy,NA,Trentino-Alto Adige,541098,0,0,4998,466
2020-08-13,Italy,NA,Trentino-Alto Adige,541098,2,0,5000,466
2020-08-14,Italy,NA,Trentino-Alto Adige,541098,3,0,5003,466
2020-08-15,Italy,NA,Trentino-Alto Adige,541098,0,0,5003,466
2020-08-16,Italy,NA,Trentino-Alto Adige,541098,0,0,5003,466
2020-08-17,Italy,NA,Trentino-Alto Adige,541098,1,0,5004,466
2020-08-18,Italy,NA,Trentino-Alto Adige,541098,2,0,5006,466
2020-08-19,Italy,NA,Trentino-Alto Adige,541098,2,0,5008,466
2020-08-20,Italy,NA,Trentino-Alto Adige,541098,4,0,5012,466
2020-08-21,Italy,NA,Trentino-Alto Adige,541098,4,0,5016,466
2020-08-22,Italy,NA,Trentino-Alto Adige,541098,9,0,5025,466
2020-08-23,Italy,NA,Trentino-Alto Adige,541098,3,0,5028,466
2020-08-24,Italy,NA,Trentino-Alto Adige,541098,1,0,5029,466
2020-08-25,Italy,NA,Trentino-Alto Adige,541098,3,0,5032,466
2020-08-26,Italy,NA,Trentino-Alto Adige,541098,7,0,5039,466
2020-08-27,Italy,NA,Trentino-Alto Adige,541098,15,0,5054,466
2020-08-28,Italy,NA,Trentino-Alto Adige,541098,16,0,5070,466
2020-08-29,Italy,NA,Trentino-Alto Adige,541098,14,0,5084,466
2020-08-30,Italy,NA,Trentino-Alto Adige,541098,8,0,5092,466
2020-08-31,Italy,NA,Trentino-Alto Adige,541098,4,0,5096,466
2020-09-01,Italy,NA,Trentino-Alto Adige,541098,3,0,5099,466
2020-09-02,Italy,NA,Trentino-Alto Adige,541098,33,0,5132,466
2020-09-03,Italy,NA,Trentino-Alto Adige,541098,91,0,5223,466
2020-09-04,Italy,NA,Trentino-Alto Adige,541098,23,0,5246,466
2020-09-05,Italy,NA,Trentino-Alto Adige,541098,53,0,5299,466
2020-09-06,Italy,NA,Trentino-Alto Adige,541098,33,0,5332,466
2020-09-07,Italy,NA,Trentino-Alto Adige,541098,17,0,5349,466
2020-09-08,Italy,NA,Trentino-Alto Adige,541098,3,0,5352,466
2020-09-09,Italy,NA,Trentino-Alto Adige,541098,7,0,5359,466
2020-09-10,Italy,NA,Trentino-Alto Adige,541098,82,0,5441,466
2020-09-11,Italy,NA,Trentino-Alto Adige,541098,29,0,5470,466
2020-09-12,Italy,NA,Trentino-Alto Adige,541098,22,0,5492,466
2020-09-13,Italy,NA,Trentino-Alto Adige,541098,9,0,5501,466
2020-09-14,Italy,NA,Trentino-Alto Adige,541098,20,0,5521,466
2020-09-15,Italy,NA,Trentino-Alto Adige,541098,20,0,5541,466
2020-09-16,Italy,NA,Trentino-Alto Adige,541098,32,0,5573,466
2020-09-17,Italy,NA,Trentino-Alto Adige,541098,76,0,5649,466
2020-09-18,Italy,NA,Trentino-Alto Adige,541098,18,0,5667,466
2020-09-19,Italy,NA,Trentino-Alto Adige,541098,22,0,5689,466
2020-09-20,Italy,NA,Trentino-Alto Adige,541098,45,0,5734,466
2020-09-21,Italy,NA,Trentino-Alto Adige,541098,2,0,5736,466
2020-09-22,Italy,NA,Trentino-Alto Adige,541098,25,0,5761,466
2020-09-23,Italy,NA,Trentino-Alto Adige,541098,22,0,5783,466
2020-02-29,Italy,NA,Tuscany,3729641,3,0,11,0
2020-03-01,Italy,NA,Tuscany,3729641,2,0,13,0
2020-03-02,Italy,NA,Tuscany,3729641,0,0,13,0
2020-03-03,Italy,NA,Tuscany,3729641,6,0,19,0
2020-03-04,Italy,NA,Tuscany,3729641,19,0,38,0
2020-03-05,Italy,NA,Tuscany,3729641,23,0,61,0
2020-03-06,Italy,NA,Tuscany,3729641,18,0,79,0
2020-03-07,Italy,NA,Tuscany,3729641,34,0,113,0
2020-03-08,Italy,NA,Tuscany,3729641,53,0,166,0
2020-03-09,Italy,NA,Tuscany,3729641,42,1,208,1
2020-03-10,Italy,NA,Tuscany,3729641,56,0,264,1
2020-03-11,Italy,NA,Tuscany,3729641,56,0,320,1
2020-03-12,Italy,NA,Tuscany,3729641,44,4,364,5
2020-03-13,Italy,NA,Tuscany,3729641,106,0,470,5
2020-03-14,Italy,NA,Tuscany,3729641,160,1,630,6
2020-03-15,Italy,NA,Tuscany,3729641,151,2,781,8
2020-03-16,Italy,NA,Tuscany,3729641,85,6,866,14
2020-03-17,Italy,NA,Tuscany,3729641,187,3,1053,17
2020-03-18,Italy,NA,Tuscany,3729641,277,5,1330,22
2020-03-19,Italy,NA,Tuscany,3729641,152,16,1482,38
2020-03-20,Italy,NA,Tuscany,3729641,311,9,1793,47
2020-03-21,Italy,NA,Tuscany,3729641,219,25,2012,72
2020-03-22,Italy,NA,Tuscany,3729641,265,19,2277,91
2020-03-23,Italy,NA,Tuscany,3729641,184,18,2461,109
2020-03-24,Italy,NA,Tuscany,3729641,238,20,2699,129
2020-03-25,Italy,NA,Tuscany,3729641,273,13,2972,142
2020-03-26,Italy,NA,Tuscany,3729641,254,16,3226,158
2020-03-27,Italy,NA,Tuscany,3729641,224,19,3450,177
2020-03-28,Italy,NA,Tuscany,3729641,367,21,3817,198
2020-03-29,Italy,NA,Tuscany,3729641,305,17,4122,215
2020-03-30,Italy,NA,Tuscany,3729641,290,16,4412,231
2020-03-31,Italy,NA,Tuscany,3729641,196,13,4608,244
2020-04-01,Italy,NA,Tuscany,3729641,259,9,4867,253
2020-04-02,Italy,NA,Tuscany,3729641,406,15,5273,268
2020-04-03,Italy,NA,Tuscany,3729641,226,22,5499,290
2020-04-04,Italy,NA,Tuscany,3729641,172,17,5671,307
2020-04-05,Italy,NA,Tuscany,3729641,176,18,5847,325
2020-04-06,Italy,NA,Tuscany,3729641,154,25,6001,350
2020-04-07,Italy,NA,Tuscany,3729641,172,19,6173,369
2020-04-08,Italy,NA,Tuscany,3729641,206,23,6379,392
2020-04-09,Italy,NA,Tuscany,3729641,173,16,6552,408
2020-04-10,Italy,NA,Tuscany,3729641,175,46,6727,454
2020-04-11,Italy,NA,Tuscany,3729641,231,13,6958,467
2020-04-12,Italy,NA,Tuscany,3729641,277,28,7235,495
2020-04-13,Italy,NA,Tuscany,3729641,155,23,7390,518
2020-04-14,Italy,NA,Tuscany,3729641,137,20,7527,538
2020-04-15,Italy,NA,Tuscany,3729641,139,18,7666,556
2020-04-16,Italy,NA,Tuscany,3729641,277,29,7943,585
2020-04-17,Italy,NA,Tuscany,3729641,167,17,8110,602
2020-04-18,Italy,NA,Tuscany,3729641,127,16,8237,618
2020-04-19,Italy,NA,Tuscany,3729641,135,19,8372,637
2020-04-20,Italy,NA,Tuscany,3729641,135,30,8507,667
2020-04-21,Italy,NA,Tuscany,3729641,96,19,8603,686
2020-04-22,Italy,NA,Tuscany,3729641,97,19,8700,705
2020-04-23,Italy,NA,Tuscany,3729641,80,18,8780,723
2020-04-24,Italy,NA,Tuscany,3729641,97,19,8877,742
2020-04-25,Italy,NA,Tuscany,3729641,138,18,9015,760
2020-04-26,Italy,NA,Tuscany,3729641,132,18,9147,778
2020-04-27,Italy,NA,Tuscany,3729641,32,17,9179,795
2020-04-28,Italy,NA,Tuscany,3729641,52,16,9231,811
2020-04-29,Italy,NA,Tuscany,3729641,61,16,9292,827
2020-04-30,Italy,NA,Tuscany,3729641,60,15,9352,842
2020-05-01,Italy,NA,Tuscany,3729641,93,12,9445,854
2020-05-02,Italy,NA,Tuscany,3729641,80,9,9525,863
2020-05-03,Italy,NA,Tuscany,3729641,38,9,9563,872
2020-05-04,Italy,NA,Tuscany,3729641,38,9,9601,881
2020-05-05,Italy,NA,Tuscany,3729641,30,8,9631,889
2020-05-06,Italy,NA,Tuscany,3729641,26,10,9657,899
2020-05-07,Italy,NA,Tuscany,3729641,26,16,9683,915
2020-05-08,Italy,NA,Tuscany,3729641,38,15,9721,930
2020-05-09,Italy,NA,Tuscany,3729641,24,7,9745,937
2020-05-10,Italy,NA,Tuscany,3729641,29,5,9774,942
2020-05-11,Italy,NA,Tuscany,3729641,13,8,9787,950
2020-05-12,Italy,NA,Tuscany,3729641,15,9,9802,959
2020-05-13,Italy,NA,Tuscany,3729641,27,5,9829,964
2020-05-14,Italy,NA,Tuscany,3729641,30,9,9859,973
2020-05-15,Italy,NA,Tuscany,3729641,24,3,9883,976
2020-05-16,Italy,NA,Tuscany,3729641,30,3,9913,979
2020-05-17,Italy,NA,Tuscany,3729641,35,5,9948,984
2020-05-18,Italy,NA,Tuscany,3729641,13,5,9961,989
2020-05-19,Italy,NA,Tuscany,3729641,7,3,9968,992
2020-05-20,Italy,NA,Tuscany,3729641,14,6,9982,998
2020-05-21,Italy,NA,Tuscany,3729641,18,6,10000,1004
2020-05-22,Italy,NA,Tuscany,3729641,35,5,10035,1009
2020-05-23,Italy,NA,Tuscany,3729641,12,2,10047,1011
2020-05-24,Italy,NA,Tuscany,3729641,15,2,10062,1013
2020-05-25,Italy,NA,Tuscany,3729641,5,2,10067,1015
2020-05-26,Italy,NA,Tuscany,3729641,3,6,10070,1021
2020-05-27,Italy,NA,Tuscany,3729641,12,6,10082,1027
2020-05-28,Italy,NA,Tuscany,3729641,4,2,10086,1029
2020-05-29,Italy,NA,Tuscany,3729641,2,2,10088,1031
2020-05-30,Italy,NA,Tuscany,3729641,12,6,10100,1037
2020-05-31,Italy,NA,Tuscany,3729641,4,4,10104,1041
2020-06-01,Italy,NA,Tuscany,3729641,3,7,10107,1048
2020-06-02,Italy,NA,Tuscany,3729641,10,5,10117,1053
2020-06-03,Italy,NA,Tuscany,3729641,4,2,10121,1055
2020-06-04,Italy,NA,Tuscany,3729641,1,4,10122,1059
2020-06-05,Italy,NA,Tuscany,3729641,7,4,10129,1063
2020-06-06,Italy,NA,Tuscany,3729641,5,5,10134,1068
2020-06-07,Italy,NA,Tuscany,3729641,1,2,10135,1070
2020-06-08,Italy,NA,Tuscany,3729641,9,4,10144,1074
2020-06-09,Italy,NA,Tuscany,3729641,1,3,10145,1077
2020-06-10,Italy,NA,Tuscany,3729641,3,1,10148,1078
2020-06-11,Italy,NA,Tuscany,3729641,10,1,10158,1079
2020-06-12,Italy,NA,Tuscany,3729641,7,1,10165,1080
2020-06-13,Italy,NA,Tuscany,3729641,7,2,10172,1082
2020-06-14,Italy,NA,Tuscany,3729641,8,3,10180,1085
2020-06-15,Italy,NA,Tuscany,3729641,8,3,10188,1088
2020-06-16,Italy,NA,Tuscany,3729641,3,3,10191,1091
2020-06-17,Italy,NA,Tuscany,3729641,2,1,10193,1092
2020-06-18,Italy,NA,Tuscany,3729641,2,1,10195,1093
2020-06-19,Italy,NA,Tuscany,3729641,10,2,10205,1095
2020-06-20,Italy,NA,Tuscany,3729641,2,0,10207,1095
2020-06-21,Italy,NA,Tuscany,3729641,3,0,10210,1095
2020-06-22,Italy,NA,Tuscany,3729641,1,4,10211,1099
2020-06-23,Italy,NA,Tuscany,3729641,6,1,10217,1100
2020-06-24,Italy,NA,Tuscany,3729641,5,1,10222,1101
2020-06-25,Italy,NA,Tuscany,3729641,2,0,10224,1101
2020-06-26,Italy,NA,Tuscany,3729641,2,2,10226,1103
2020-06-27,Italy,NA,Tuscany,3729641,12,0,10238,1103
2020-06-28,Italy,NA,Tuscany,3729641,5,0,10243,1103
2020-06-29,Italy,NA,Tuscany,3729641,5,1,10248,1104
2020-06-30,Italy,NA,Tuscany,3729641,2,0,10250,1104
2020-07-01,Italy,NA,Tuscany,3729641,4,2,10254,1106
2020-07-02,Italy,NA,Tuscany,3729641,4,3,10258,1109
2020-07-03,Italy,NA,Tuscany,3729641,9,3,10267,1112
2020-07-04,Italy,NA,Tuscany,3729641,9,2,10276,1114
2020-07-05,Italy,NA,Tuscany,3729641,9,0,10285,1114
2020-07-06,Italy,NA,Tuscany,3729641,2,0,10287,1114
2020-07-07,Italy,NA,Tuscany,3729641,19,2,10306,1116
2020-07-08,Italy,NA,Tuscany,3729641,7,2,10313,1118
2020-07-09,Italy,NA,Tuscany,3729641,1,2,10314,1120
2020-07-10,Italy,NA,Tuscany,3729641,2,1,10316,1121
2020-07-11,Italy,NA,Tuscany,3729641,5,1,10321,1122
2020-07-12,Italy,NA,Tuscany,3729641,1,0,10322,1122
2020-07-13,Italy,NA,Tuscany,3729641,4,0,10326,1122
2020-07-14,Italy,NA,Tuscany,3729641,4,3,10330,1125
2020-07-15,Italy,NA,Tuscany,3729641,8,2,10338,1127
2020-07-16,Italy,NA,Tuscany,3729641,12,0,10350,1127
2020-07-17,Italy,NA,Tuscany,3729641,6,2,10356,1129
2020-07-18,Italy,NA,Tuscany,3729641,2,0,10358,1129
2020-07-19,Italy,NA,Tuscany,3729641,16,0,10374,1129
2020-07-20,Italy,NA,Tuscany,3729641,1,1,10375,1130
2020-07-21,Italy,NA,Tuscany,3729641,9,1,10384,1131
2020-07-22,Italy,NA,Tuscany,3729641,6,0,10390,1131
2020-07-23,Italy,NA,Tuscany,3729641,4,0,10394,1131
2020-07-24,Italy,NA,Tuscany,3729641,11,0,10405,1131
2020-07-25,Italy,NA,Tuscany,3729641,10,0,10415,1131
2020-07-26,Italy,NA,Tuscany,3729641,15,0,10430,1131
2020-07-27,Italy,NA,Tuscany,3729641,8,0,10438,1131
2020-07-28,Italy,NA,Tuscany,3729641,3,3,10441,1134
2020-07-29,Italy,NA,Tuscany,3729641,17,0,10458,1134
2020-07-30,Italy,NA,Tuscany,3729641,11,0,10469,1134
2020-07-31,Italy,NA,Tuscany,3729641,14,0,10483,1134
2020-08-01,Italy,NA,Tuscany,3729641,6,1,10489,1135
2020-08-02,Italy,NA,Tuscany,3729641,9,0,10498,1135
2020-08-03,Italy,NA,Tuscany,3729641,10,1,10508,1136
2020-08-04,Italy,NA,Tuscany,3729641,11,1,10519,1137
2020-08-05,Italy,NA,Tuscany,3729641,11,0,10530,1137
2020-08-06,Italy,NA,Tuscany,3729641,17,0,10547,1137
2020-08-07,Italy,NA,Tuscany,3729641,13,0,10560,1137
2020-08-08,Italy,NA,Tuscany,3729641,23,0,10583,1137
2020-08-09,Italy,NA,Tuscany,3729641,61,0,10644,1137
2020-08-10,Italy,NA,Tuscany,3729641,8,0,10652,1137
2020-08-11,Italy,NA,Tuscany,3729641,22,0,10674,1137
2020-08-12,Italy,NA,Tuscany,3729641,33,0,10707,1137
2020-08-13,Italy,NA,Tuscany,3729641,28,0,10735,1137
2020-08-14,Italy,NA,Tuscany,3729641,26,0,10761,1137
2020-08-15,Italy,NA,Tuscany,3729641,38,1,10799,1138
2020-08-16,Italy,NA,Tuscany,3729641,34,0,10833,1138
2020-08-17,Italy,NA,Tuscany,3729641,21,1,10854,1139
2020-08-18,Italy,NA,Tuscany,3729641,31,0,10885,1139
2020-08-19,Italy,NA,Tuscany,3729641,40,0,10925,1139
2020-08-20,Italy,NA,Tuscany,3729641,59,0,10984,1139
2020-08-21,Italy,NA,Tuscany,3729641,79,0,11063,1139
2020-08-22,Italy,NA,Tuscany,3729641,53,0,11116,1139
2020-08-23,Italy,NA,Tuscany,3729641,59,0,11175,1139
2020-08-24,Italy,NA,Tuscany,3729641,44,0,11219,1139
2020-08-25,Italy,NA,Tuscany,3729641,34,0,11253,1139
2020-08-26,Italy,NA,Tuscany,3729641,161,1,11414,1140
2020-08-27,Italy,NA,Tuscany,3729641,99,0,11513,1140
2020-08-28,Italy,NA,Tuscany,3729641,82,1,11595,1141
2020-08-29,Italy,NA,Tuscany,3729641,92,0,11687,1141
2020-08-30,Italy,NA,Tuscany,3729641,98,0,11785,1141
2020-08-31,Italy,NA,Tuscany,3729641,73,0,11858,1141
2020-09-01,Italy,NA,Tuscany,3729641,40,1,11898,1142
2020-09-02,Italy,NA,Tuscany,3729641,69,0,11967,1142
2020-09-03,Italy,NA,Tuscany,3729641,113,1,12080,1143
2020-09-04,Italy,NA,Tuscany,3729641,99,0,12179,1143
2020-09-05,Italy,NA,Tuscany,3729641,113,0,12292,1143
2020-09-06,Italy,NA,Tuscany,3729641,122,0,12414,1143
2020-09-07,Italy,NA,Tuscany,3729641,85,1,12499,1144
2020-09-08,Italy,NA,Tuscany,3729641,59,1,12558,1145
2020-09-09,Italy,NA,Tuscany,3729641,88,2,12646,1147
2020-09-10,Italy,NA,Tuscany,3729641,92,0,12738,1147
2020-09-11,Italy,NA,Tuscany,3729641,147,1,12885,1148
2020-09-12,Italy,NA,Tuscany,3729641,138,0,13023,1148
2020-09-13,Italy,NA,Tuscany,3729641,91,1,13114,1149
2020-09-14,Italy,NA,Tuscany,3729641,59,1,13173,1150
2020-09-15,Italy,NA,Tuscany,3729641,41,1,13214,1151
2020-09-16,Italy,NA,Tuscany,3729641,90,0,13304,1151
2020-09-17,Italy,NA,Tuscany,3729641,119,1,13423,1152
2020-09-18,Italy,NA,Tuscany,3729641,99,0,13522,1152
2020-09-19,Italy,NA,Tuscany,3729641,143,0,13665,1152
2020-09-20,Italy,NA,Tuscany,3729641,147,0,13812,1152
2020-09-21,Italy,NA,Tuscany,3729641,84,0,13896,1152
2020-09-22,Italy,NA,Tuscany,3729641,74,0,13970,1152
2020-09-23,Italy,NA,Tuscany,3729641,90,1,14060,1153
2020-03-06,Italy,NA,Umbria,882015,7,0,16,0
2020-03-07,Italy,NA,Umbria,882015,8,0,24,0
2020-03-08,Italy,NA,Umbria,882015,2,0,26,0
2020-03-09,Italy,NA,Umbria,882015,2,0,28,0
2020-03-10,Italy,NA,Umbria,882015,9,0,37,0
2020-03-11,Italy,NA,Umbria,882015,9,0,46,0
2020-03-12,Italy,NA,Umbria,882015,18,0,64,0
2020-03-13,Italy,NA,Umbria,882015,12,1,76,1
2020-03-14,Italy,NA,Umbria,882015,31,0,107,1
2020-03-15,Italy,NA,Umbria,882015,36,0,143,1
2020-03-16,Italy,NA,Umbria,882015,21,0,164,1
2020-03-17,Italy,NA,Umbria,882015,33,0,197,1
2020-03-18,Italy,NA,Umbria,882015,50,1,247,2
2020-03-19,Italy,NA,Umbria,882015,87,0,334,2
2020-03-20,Italy,NA,Umbria,882015,61,5,395,7
2020-03-21,Italy,NA,Umbria,882015,67,3,462,10
2020-03-22,Italy,NA,Umbria,882015,59,6,521,16
2020-03-23,Italy,NA,Umbria,882015,56,0,577,16
2020-03-24,Italy,NA,Umbria,882015,71,3,648,19
2020-03-25,Italy,NA,Umbria,882015,62,0,710,19
2020-03-26,Italy,NA,Umbria,882015,92,1,802,20
2020-03-27,Italy,NA,Umbria,882015,82,1,884,21
2020-03-28,Italy,NA,Umbria,882015,85,7,969,28
2020-03-29,Italy,NA,Umbria,882015,54,3,1023,31
2020-03-30,Italy,NA,Umbria,882015,28,2,1051,33
2020-03-31,Italy,NA,Umbria,882015,27,4,1078,37
2020-04-01,Italy,NA,Umbria,882015,17,0,1095,37
2020-04-02,Italy,NA,Umbria,882015,33,1,1128,38
2020-04-03,Italy,NA,Umbria,882015,51,1,1179,39
2020-04-04,Italy,NA,Umbria,882015,31,2,1210,41
2020-04-05,Italy,NA,Umbria,882015,29,2,1239,43
2020-04-06,Italy,NA,Umbria,882015,14,1,1253,44
2020-04-07,Italy,NA,Umbria,882015,10,5,1263,49
2020-04-08,Italy,NA,Umbria,882015,26,1,1289,50
2020-04-09,Italy,NA,Umbria,882015,9,1,1298,51
2020-04-10,Italy,NA,Umbria,882015,4,1,1302,52
2020-04-11,Italy,NA,Umbria,882015,7,0,1309,52
2020-04-12,Italy,NA,Umbria,882015,10,0,1319,52
2020-04-13,Italy,NA,Umbria,882015,1,0,1320,52
2020-04-14,Italy,NA,Umbria,882015,1,1,1321,53
2020-04-15,Italy,NA,Umbria,882015,1,1,1322,54
2020-04-16,Italy,NA,Umbria,882015,7,1,1329,55
2020-04-17,Italy,NA,Umbria,882015,8,2,1337,57
2020-04-18,Italy,NA,Umbria,882015,7,0,1344,57
2020-04-19,Italy,NA,Umbria,882015,4,1,1348,58
2020-04-20,Italy,NA,Umbria,882015,1,0,1349,58
2020-04-21,Italy,NA,Umbria,882015,4,2,1353,60
2020-04-22,Italy,NA,Umbria,882015,4,1,1357,61
2020-04-23,Italy,NA,Umbria,882015,5,0,1362,61
2020-04-24,Italy,NA,Umbria,882015,1,1,1363,62
2020-04-25,Italy,NA,Umbria,882015,3,1,1366,63
2020-04-26,Italy,NA,Umbria,882015,2,1,1368,64
2020-04-27,Italy,NA,Umbria,882015,2,1,1370,65
2020-04-28,Italy,NA,Umbria,882015,9,0,1379,65
2020-04-29,Italy,NA,Umbria,882015,12,1,1391,66
2020-04-30,Italy,NA,Umbria,882015,1,1,1392,67
2020-05-01,Italy,NA,Umbria,882015,1,1,1393,68
2020-05-02,Italy,NA,Umbria,882015,1,0,1394,68
2020-05-03,Italy,NA,Umbria,882015,0,0,1394,68
2020-05-04,Italy,NA,Umbria,882015,0,2,1394,70
2020-05-05,Italy,NA,Umbria,882015,6,0,1400,70
2020-05-06,Italy,NA,Umbria,882015,4,0,1404,70
2020-05-07,Italy,NA,Umbria,882015,1,0,1405,70
2020-05-08,Italy,NA,Umbria,882015,1,1,1406,71
2020-05-09,Italy,NA,Umbria,882015,1,0,1407,71
2020-05-10,Italy,NA,Umbria,882015,4,0,1411,71
2020-05-11,Italy,NA,Umbria,882015,1,0,1412,71
2020-05-12,Italy,NA,Umbria,882015,7,0,1419,71
2020-05-13,Italy,NA,Umbria,882015,0,1,1419,72
2020-05-14,Italy,NA,Umbria,882015,1,1,1420,73
2020-05-15,Italy,NA,Umbria,882015,2,0,1422,73
2020-05-16,Italy,NA,Umbria,882015,0,0,1422,73
2020-05-17,Italy,NA,Umbria,882015,2,0,1424,73
2020-05-18,Italy,NA,Umbria,882015,0,0,1424,73
2020-05-19,Italy,NA,Umbria,882015,3,1,1427,74
2020-05-20,Italy,NA,Umbria,882015,0,0,1427,74
2020-05-21,Italy,NA,Umbria,882015,2,0,1429,74
2020-05-22,Italy,NA,Umbria,882015,0,0,1429,74
2020-05-23,Italy,NA,Umbria,882015,1,0,1430,74
2020-05-24,Italy,NA,Umbria,882015,0,1,1430,75
2020-05-25,Italy,NA,Umbria,882015,0,0,1430,75
2020-05-26,Italy,NA,Umbria,882015,1,0,1431,75
2020-05-27,Italy,NA,Umbria,882015,0,0,1431,75
2020-05-28,Italy,NA,Umbria,882015,0,0,1431,75
2020-05-29,Italy,NA,Umbria,882015,0,1,1431,76
2020-05-30,Italy,NA,Umbria,882015,0,0,1431,76
2020-05-31,Italy,NA,Umbria,882015,0,0,1431,76
2020-06-01,Italy,NA,Umbria,882015,0,0,1431,76
2020-06-02,Italy,NA,Umbria,882015,0,0,1431,76
2020-06-03,Italy,NA,Umbria,882015,0,0,1431,76
2020-06-04,Italy,NA,Umbria,882015,0,0,1431,76
2020-06-05,Italy,NA,Umbria,882015,0,0,1431,76
2020-06-06,Italy,NA,Umbria,882015,0,0,1431,76
2020-06-07,Italy,NA,Umbria,882015,1,0,1432,76
2020-06-08,Italy,NA,Umbria,882015,0,0,1432,76
2020-06-09,Italy,NA,Umbria,882015,3,0,1435,76
2020-06-10,Italy,NA,Umbria,882015,1,0,1436,76
2020-06-11,Italy,NA,Umbria,882015,0,0,1436,76
2020-06-12,Italy,NA,Umbria,882015,0,0,1436,76
2020-06-13,Italy,NA,Umbria,882015,0,0,1436,76
2020-06-14,Italy,NA,Umbria,882015,0,1,1436,77
2020-06-15,Italy,NA,Umbria,882015,0,0,1436,77
2020-06-16,Italy,NA,Umbria,882015,1,0,1437,77
2020-06-17,Italy,NA,Umbria,882015,0,0,1437,77
2020-06-18,Italy,NA,Umbria,882015,0,0,1437,77
2020-06-19,Italy,NA,Umbria,882015,1,0,1438,77
2020-06-20,Italy,NA,Umbria,882015,0,1,1438,78
2020-06-21,Italy,NA,Umbria,882015,0,0,1438,78
2020-06-22,Italy,NA,Umbria,882015,0,0,1438,78
2020-06-23,Italy,NA,Umbria,882015,0,0,1438,78
2020-06-24,Italy,NA,Umbria,882015,1,1,1439,79
2020-06-25,Italy,NA,Umbria,882015,0,0,1439,79
2020-06-26,Italy,NA,Umbria,882015,1,0,1440,79
2020-06-27,Italy,NA,Umbria,882015,0,1,1440,80
2020-06-28,Italy,NA,Umbria,882015,0,0,1440,80
2020-06-29,Italy,NA,Umbria,882015,0,0,1440,80
2020-06-30,Italy,NA,Umbria,882015,1,0,1441,80
2020-07-01,Italy,NA,Umbria,882015,0,0,1441,80
2020-07-02,Italy,NA,Umbria,882015,3,0,1444,80
2020-07-03,Italy,NA,Umbria,882015,2,0,1446,80
2020-07-04,Italy,NA,Umbria,882015,1,0,1447,80
2020-07-05,Italy,NA,Umbria,882015,0,0,1447,80
2020-07-06,Italy,NA,Umbria,882015,0,0,1447,80
2020-07-07,Italy,NA,Umbria,882015,0,0,1447,80
2020-07-08,Italy,NA,Umbria,882015,0,0,1447,80
2020-07-09,Italy,NA,Umbria,882015,0,0,1447,80
2020-07-10,Italy,NA,Umbria,882015,1,0,1448,80
2020-07-11,Italy,NA,Umbria,882015,0,0,1448,80
2020-07-12,Italy,NA,Umbria,882015,2,0,1450,80
2020-07-13,Italy,NA,Umbria,882015,0,0,1450,80
2020-07-14,Italy,NA,Umbria,882015,0,0,1450,80
2020-07-15,Italy,NA,Umbria,882015,2,0,1452,80
2020-07-16,Italy,NA,Umbria,882015,0,0,1452,80
2020-07-17,Italy,NA,Umbria,882015,2,0,1454,80
2020-07-18,Italy,NA,Umbria,882015,2,0,1456,80
2020-07-19,Italy,NA,Umbria,882015,0,0,1456,80
2020-07-20,Italy,NA,Umbria,882015,0,0,1456,80
2020-07-21,Italy,NA,Umbria,882015,3,0,1459,80
2020-07-22,Italy,NA,Umbria,882015,2,0,1461,80
2020-07-23,Italy,NA,Umbria,882015,2,0,1463,80
2020-07-24,Italy,NA,Umbria,882015,2,0,1465,80
2020-07-25,Italy,NA,Umbria,882015,0,0,1465,80
2020-07-26,Italy,NA,Umbria,882015,0,0,1465,80
2020-07-27,Italy,NA,Umbria,882015,0,0,1465,80
2020-07-28,Italy,NA,Umbria,882015,0,0,1465,80
2020-07-29,Italy,NA,Umbria,882015,0,0,1465,80
2020-07-30,Italy,NA,Umbria,882015,0,0,1465,80
2020-07-31,Italy,NA,Umbria,882015,1,0,1466,80
2020-08-01,Italy,NA,Umbria,882015,6,0,1472,80
2020-08-02,Italy,NA,Umbria,882015,2,0,1474,80
2020-08-03,Italy,NA,Umbria,882015,1,0,1475,80
2020-08-04,Italy,NA,Umbria,882015,2,0,1477,80
2020-08-05,Italy,NA,Umbria,882015,2,0,1479,80
2020-08-06,Italy,NA,Umbria,882015,3,0,1482,80
2020-08-07,Italy,NA,Umbria,882015,6,0,1488,80
2020-08-08,Italy,NA,Umbria,882015,10,0,1498,80
2020-08-09,Italy,NA,Umbria,882015,7,0,1505,80
2020-08-10,Italy,NA,Umbria,882015,5,0,1510,80
2020-08-11,Italy,NA,Umbria,882015,1,0,1511,80
2020-08-12,Italy,NA,Umbria,882015,6,0,1517,80
2020-08-13,Italy,NA,Umbria,882015,7,0,1524,80
2020-08-14,Italy,NA,Umbria,882015,8,0,1532,80
2020-08-15,Italy,NA,Umbria,882015,13,0,1545,80
2020-08-16,Italy,NA,Umbria,882015,3,0,1548,80
2020-08-17,Italy,NA,Umbria,882015,1,0,1549,80
2020-08-18,Italy,NA,Umbria,882015,10,0,1559,80
2020-08-19,Italy,NA,Umbria,882015,4,0,1563,80
2020-08-20,Italy,NA,Umbria,882015,17,0,1580,80
2020-08-21,Italy,NA,Umbria,882015,22,0,1602,80
2020-08-22,Italy,NA,Umbria,882015,18,0,1620,80
2020-08-23,Italy,NA,Umbria,882015,19,0,1639,80
2020-08-24,Italy,NA,Umbria,882015,11,0,1650,80
2020-08-25,Italy,NA,Umbria,882015,29,0,1679,80
2020-08-26,Italy,NA,Umbria,882015,20,0,1699,80
2020-08-27,Italy,NA,Umbria,882015,20,0,1719,80
2020-08-28,Italy,NA,Umbria,882015,22,0,1741,80
2020-08-29,Italy,NA,Umbria,882015,12,0,1753,80
2020-08-30,Italy,NA,Umbria,882015,31,0,1784,80
2020-08-31,Italy,NA,Umbria,882015,9,0,1793,80
2020-09-01,Italy,NA,Umbria,882015,10,0,1803,80
2020-09-02,Italy,NA,Umbria,882015,27,0,1830,80
2020-09-03,Italy,NA,Umbria,882015,9,0,1839,80
2020-09-04,Italy,NA,Umbria,882015,35,0,1874,80
2020-09-05,Italy,NA,Umbria,882015,16,1,1890,81
2020-09-06,Italy,NA,Umbria,882015,25,0,1915,81
2020-09-07,Italy,NA,Umbria,882015,13,0,1928,81
2020-09-08,Italy,NA,Umbria,882015,7,0,1935,81
2020-09-09,Italy,NA,Umbria,882015,33,0,1968,81
2020-09-10,Italy,NA,Umbria,882015,24,0,1992,81
2020-09-11,Italy,NA,Umbria,882015,17,0,2009,81
2020-09-12,Italy,NA,Umbria,882015,33,0,2042,81
2020-09-13,Italy,NA,Umbria,882015,24,0,2066,81
2020-09-14,Italy,NA,Umbria,882015,12,0,2078,81
2020-09-15,Italy,NA,Umbria,882015,22,0,2100,81
2020-09-16,Italy,NA,Umbria,882015,17,0,2117,81
2020-09-17,Italy,NA,Umbria,882015,22,1,2139,82
2020-09-18,Italy,NA,Umbria,882015,21,0,2160,82
2020-09-19,Italy,NA,Umbria,882015,32,1,2192,83
2020-09-20,Italy,NA,Umbria,882015,24,0,2216,83
2020-09-21,Italy,NA,Umbria,882015,5,1,2221,84
2020-09-22,Italy,NA,Umbria,882015,26,0,2247,84
2020-09-23,Italy,NA,Umbria,882015,19,1,2266,85
2020-02-24,Italy,NA,Veneto,4905854,32,0,33,1
2020-02-25,Italy,NA,Veneto,4905854,10,0,43,1
2020-02-26,Italy,NA,Veneto,4905854,28,1,71,2
2020-02-27,Italy,NA,Veneto,4905854,40,0,111,2
2020-02-28,Italy,NA,Veneto,4905854,40,0,151,2
2020-02-29,Italy,NA,Veneto,4905854,40,0,191,2
2020-03-01,Italy,NA,Veneto,4905854,72,0,263,2
2020-03-02,Italy,NA,Veneto,4905854,10,0,273,2
2020-03-03,Italy,NA,Veneto,4905854,34,1,307,3
2020-03-04,Italy,NA,Veneto,4905854,53,3,360,6
2020-03-05,Italy,NA,Veneto,4905854,47,4,407,10
2020-03-06,Italy,NA,Veneto,4905854,81,2,488,12
2020-03-07,Italy,NA,Veneto,4905854,55,1,543,13
2020-03-08,Italy,NA,Veneto,4905854,127,5,670,18
2020-03-09,Italy,NA,Veneto,4905854,74,2,744,20
2020-03-10,Italy,NA,Veneto,4905854,112,6,856,26
2020-03-11,Italy,NA,Veneto,4905854,167,3,1023,29
2020-03-12,Italy,NA,Veneto,4905854,361,3,1384,32
2020-03-13,Italy,NA,Veneto,4905854,211,10,1595,42
2020-03-14,Italy,NA,Veneto,4905854,342,13,1937,55
2020-03-15,Italy,NA,Veneto,4905854,235,8,2172,63
2020-03-16,Italy,NA,Veneto,4905854,301,6,2473,69
2020-03-17,Italy,NA,Veneto,4905854,231,11,2704,80
2020-03-18,Italy,NA,Veneto,4905854,510,14,3214,94
2020-03-19,Italy,NA,Veneto,4905854,270,21,3484,115
2020-03-20,Italy,NA,Veneto,4905854,547,16,4031,131
2020-03-21,Italy,NA,Veneto,4905854,586,15,4617,146
2020-03-22,Italy,NA,Veneto,4905854,505,23,5122,169
2020-03-23,Italy,NA,Veneto,4905854,383,23,5505,192
2020-03-24,Italy,NA,Veneto,4905854,443,24,5948,216
2020-03-25,Italy,NA,Veneto,4905854,494,42,6442,258
2020-03-26,Italy,NA,Veneto,4905854,493,29,6935,287
2020-03-27,Italy,NA,Veneto,4905854,562,26,7497,313
2020-03-28,Italy,NA,Veneto,4905854,433,49,7930,362
2020-03-29,Italy,NA,Veneto,4905854,428,30,8358,392
2020-03-30,Italy,NA,Veneto,4905854,366,21,8724,413
2020-03-31,Italy,NA,Veneto,4905854,431,64,9155,477
2020-04-01,Italy,NA,Veneto,4905854,470,22,9625,499
2020-04-02,Italy,NA,Veneto,4905854,486,33,10111,532
2020-04-03,Italy,NA,Veneto,4905854,353,40,10464,572
2020-04-04,Italy,NA,Veneto,4905854,360,35,10824,607
2020-04-05,Italy,NA,Veneto,4905854,402,24,11226,631
2020-04-06,Italy,NA,Veneto,4905854,362,31,11588,662
2020-04-07,Italy,NA,Veneto,4905854,337,33,11925,695
2020-04-08,Italy,NA,Veneto,4905854,485,41,12410,736
2020-04-09,Italy,NA,Veneto,4905854,523,20,12933,756
2020-04-10,Italy,NA,Veneto,4905854,488,37,13421,793
2020-04-11,Italy,NA,Veneto,4905854,347,38,13768,831
2020-04-12,Italy,NA,Veneto,4905854,309,25,14077,856
2020-04-13,Italy,NA,Veneto,4905854,174,26,14251,882
2020-04-14,Italy,NA,Veneto,4905854,181,24,14432,906
2020-04-15,Italy,NA,Veneto,4905854,192,34,14624,940
2020-04-16,Italy,NA,Veneto,4905854,366,41,14990,981
2020-04-17,Italy,NA,Veneto,4905854,384,45,15374,1026
2020-04-18,Italy,NA,Veneto,4905854,318,33,15692,1059
2020-04-19,Italy,NA,Veneto,4905854,243,28,15935,1087
2020-04-20,Italy,NA,Veneto,4905854,192,25,16127,1112
2020-04-21,Italy,NA,Veneto,4905854,277,42,16404,1154
2020-04-22,Italy,NA,Veneto,4905854,334,27,16738,1181
2020-04-23,Italy,NA,Veneto,4905854,143,25,16881,1206
2020-04-24,Italy,NA,Veneto,4905854,348,38,17229,1244
2020-04-25,Italy,NA,Veneto,4905854,162,44,17391,1288
2020-04-26,Italy,NA,Veneto,4905854,80,27,17471,1315
2020-04-27,Italy,NA,Veneto,4905854,108,29,17579,1344
2020-04-28,Italy,NA,Veneto,4905854,129,64,17708,1408
2020-04-29,Italy,NA,Veneto,4905854,117,29,17825,1437
2020-04-30,Italy,NA,Veneto,4905854,135,22,17960,1459
2020-05-01,Italy,NA,Veneto,4905854,138,20,18098,1479
2020-05-02,Italy,NA,Veneto,4905854,126,23,18224,1502
2020-05-03,Italy,NA,Veneto,4905854,94,14,18318,1516
2020-05-04,Italy,NA,Veneto,4905854,55,12,18373,1528
2020-05-05,Italy,NA,Veneto,4905854,29,17,18402,1545
2020-05-06,Italy,NA,Veneto,4905854,77,23,18479,1568
2020-05-07,Italy,NA,Veneto,4905854,74,21,18553,1589
2020-05-08,Italy,NA,Veneto,4905854,65,38,18618,1627
2020-05-09,Italy,NA,Veneto,4905854,53,16,18671,1643
2020-05-10,Italy,NA,Veneto,4905854,51,14,18722,1657
2020-05-11,Italy,NA,Veneto,4905854,19,9,18741,1666
2020-05-12,Italy,NA,Veneto,4905854,41,20,18782,1686
2020-05-13,Italy,NA,Veneto,4905854,31,26,18813,1712
2020-05-14,Italy,NA,Veneto,4905854,32,31,18845,1743
2020-05-15,Italy,NA,Veneto,4905854,44,19,18889,1762
2020-05-16,Italy,NA,Veneto,4905854,39,21,18928,1783
2020-05-17,Italy,NA,Veneto,4905854,13,11,18941,1794
2020-05-18,Italy,NA,Veneto,4905854,9,9,18950,1803
2020-05-19,Italy,NA,Veneto,4905854,47,17,18997,1820
2020-05-20,Italy,NA,Veneto,4905854,33,12,19030,1832
2020-05-21,Italy,NA,Veneto,4905854,8,9,19038,1841
2020-05-22,Italy,NA,Veneto,4905854,21,13,19059,1854
2020-05-23,Italy,NA,Veneto,4905854,10,11,19069,1865
2020-05-24,Italy,NA,Veneto,4905854,17,4,19086,1869
2020-05-25,Italy,NA,Veneto,4905854,11,9,19097,1878
2020-05-26,Italy,NA,Veneto,4905854,8,8,19105,1886
2020-05-27,Italy,NA,Veneto,4905854,8,9,19113,1895
2020-05-28,Italy,NA,Veneto,4905854,12,3,19125,1898
2020-05-29,Italy,NA,Veneto,4905854,9,8,19134,1906
2020-05-30,Italy,NA,Veneto,4905854,12,10,19146,1916
2020-05-31,Italy,NA,Veneto,4905854,6,2,19152,1918
2020-06-01,Italy,NA,Veneto,4905854,2,0,19154,1918
2020-06-02,Italy,NA,Veneto,4905854,8,3,19162,1921
2020-06-03,Italy,NA,Veneto,4905854,2,0,19164,1921
2020-06-04,Italy,NA,Veneto,4905854,4,13,19168,1934
2020-06-05,Italy,NA,Veneto,4905854,6,4,19174,1938
2020-06-06,Italy,NA,Veneto,4905854,8,11,19182,1949
2020-06-07,Italy,NA,Veneto,4905854,1,5,19183,1954
2020-06-08,Italy,NA,Veneto,4905854,4,1,19187,1955
2020-06-09,Italy,NA,Veneto,4905854,4,6,19191,1961
2020-06-10,Italy,NA,Veneto,4905854,3,0,19194,1961
2020-06-11,Italy,NA,Veneto,4905854,5,3,19199,1964
2020-06-12,Italy,NA,Veneto,4905854,0,3,19199,1967
2020-06-13,Italy,NA,Veneto,4905854,13,10,19212,1977
2020-06-14,Italy,NA,Veneto,4905854,7,1,19219,1978
2020-06-15,Italy,NA,Veneto,4905854,1,0,19220,1978
2020-06-16,Italy,NA,Veneto,4905854,1,4,19221,1982
2020-06-17,Italy,NA,Veneto,4905854,4,5,19225,1987
2020-06-18,Italy,NA,Veneto,4905854,8,7,19233,1994
2020-06-19,Italy,NA,Veneto,4905854,2,4,19235,1998
2020-06-20,Italy,NA,Veneto,4905854,3,4,19238,2002
2020-06-21,Italy,NA,Veneto,4905854,7,0,19245,2002
2020-06-22,Italy,NA,Veneto,4905854,2,1,19247,2003
2020-06-23,Italy,NA,Veneto,4905854,3,1,19250,2004
2020-06-24,Italy,NA,Veneto,4905854,3,0,19253,2004
2020-06-25,Italy,NA,Veneto,4905854,4,2,19257,2006
2020-06-26,Italy,NA,Veneto,4905854,5,1,19262,2007
2020-06-27,Italy,NA,Veneto,4905854,2,0,19264,2007
2020-06-28,Italy,NA,Veneto,4905854,11,1,19275,2008
2020-06-29,Italy,NA,Veneto,4905854,3,0,19278,2008
2020-06-30,Italy,NA,Veneto,4905854,8,4,19286,2012
2020-07-01,Italy,NA,Veneto,4905854,3,10,19289,2022
2020-07-02,Italy,NA,Veneto,4905854,20,0,19309,2022
2020-07-03,Italy,NA,Veneto,4905854,5,1,19314,2023
2020-07-04,Italy,NA,Veneto,4905854,4,0,19318,2023
2020-07-05,Italy,NA,Veneto,4905854,8,0,19326,2023
2020-07-06,Italy,NA,Veneto,4905854,1,1,19327,2024
2020-07-07,Italy,NA,Veneto,4905854,14,10,19341,2034
2020-07-08,Italy,NA,Veneto,4905854,7,0,19348,2034
2020-07-09,Italy,NA,Veneto,4905854,10,3,19358,2037
2020-07-10,Italy,NA,Veneto,4905854,11,2,19369,2039
2020-07-11,Italy,NA,Veneto,4905854,10,0,19379,2039
2020-07-12,Italy,NA,Veneto,4905854,16,0,19395,2039
2020-07-13,Italy,NA,Veneto,4905854,6,0,19401,2039
2020-07-14,Italy,NA,Veneto,4905854,19,2,19420,2041
2020-07-15,Italy,NA,Veneto,4905854,21,2,19441,2043
2020-07-16,Italy,NA,Veneto,4905854,29,4,19470,2047
2020-07-17,Italy,NA,Veneto,4905854,55,0,19525,2047
2020-07-18,Italy,NA,Veneto,4905854,34,2,19559,2049
2020-07-19,Italy,NA,Veneto,4905854,48,1,19607,2050
2020-07-20,Italy,NA,Veneto,4905854,42,0,19649,2050
2020-07-21,Italy,NA,Veneto,4905854,22,3,19671,2053
2020-07-22,Italy,NA,Veneto,4905854,36,4,19707,2057
2020-07-23,Italy,NA,Veneto,4905854,22,5,19729,2062
2020-07-24,Italy,NA,Veneto,4905854,30,1,19759,2063
2020-07-25,Italy,NA,Veneto,4905854,31,1,19790,2064
2020-07-26,Italy,NA,Veneto,4905854,19,0,19809,2064
2020-07-27,Italy,NA,Veneto,4905854,16,0,19825,2064
2020-07-28,Italy,NA,Veneto,4905854,24,5,19849,2069
2020-07-29,Italy,NA,Veneto,4905854,42,4,19891,2073
2020-07-30,Italy,NA,Veneto,4905854,112,0,20003,2073
2020-07-31,Italy,NA,Veneto,4905854,117,1,20120,2074
2020-08-01,Italy,NA,Veneto,4905854,46,1,20166,2075
2020-08-02,Italy,NA,Veneto,4905854,45,0,20211,2075
2020-08-03,Italy,NA,Veneto,4905854,22,1,20233,2076
2020-08-04,Italy,NA,Veneto,4905854,20,1,20253,2077
2020-08-05,Italy,NA,Veneto,4905854,41,0,20294,2077
2020-08-06,Italy,NA,Veneto,4905854,58,0,20352,2077
2020-08-07,Italy,NA,Veneto,4905854,183,1,20535,2078
2020-08-08,Italy,NA,Veneto,4905854,63,5,20598,2083
2020-08-09,Italy,NA,Veneto,4905854,58,0,20656,2083
2020-08-10,Italy,NA,Veneto,4905854,20,0,20676,2083
2020-08-11,Italy,NA,Veneto,4905854,65,2,20741,2085
2020-08-12,Italy,NA,Veneto,4905854,60,7,20801,2092
2020-08-13,Italy,NA,Veneto,4905854,84,2,20885,2094
2020-08-14,Italy,NA,Veneto,4905854,127,1,21012,2095
2020-08-15,Italy,NA,Veneto,4905854,120,1,21132,2096
2020-08-16,Italy,NA,Veneto,4905854,78,0,21210,2096
2020-08-17,Italy,NA,Veneto,4905854,46,0,21256,2096
2020-08-18,Italy,NA,Veneto,4905854,60,2,21316,2098
2020-08-19,Italy,NA,Veneto,4905854,59,1,21375,2099
2020-08-20,Italy,NA,Veneto,4905854,159,1,21534,2100
2020-08-21,Italy,NA,Veneto,4905854,116,2,21650,2102
2020-08-22,Italy,NA,Veneto,4905854,160,2,21810,2104
2020-08-23,Italy,NA,Veneto,4905854,145,0,21955,2104
2020-08-24,Italy,NA,Veneto,4905854,116,0,22071,2104
2020-08-25,Italy,NA,Veneto,4905854,119,3,22190,2107
2020-08-26,Italy,NA,Veneto,4905854,147,9,22337,2116
2020-08-27,Italy,NA,Veneto,4905854,132,1,22469,2117
2020-08-28,Italy,NA,Veneto,4905854,135,2,22604,2119
2020-08-29,Italy,NA,Veneto,4905854,151,1,22755,2120
2020-08-30,Italy,NA,Veneto,4905854,109,0,22864,2120
2020-08-31,Italy,NA,Veneto,4905854,65,0,22929,2120
2020-09-01,Italy,NA,Veneto,4905854,97,2,23026,2122
2020-09-02,Italy,NA,Veneto,4905854,163,1,23189,2123
2020-09-03,Italy,NA,Veneto,4905854,115,0,23304,2123
2020-09-04,Italy,NA,Veneto,4905854,273,3,23577,2126
2020-09-05,Italy,NA,Veneto,4905854,188,4,23765,2130
2020-09-06,Italy,NA,Veneto,4905854,179,0,23944,2130
2020-09-07,Italy,NA,Veneto,4905854,69,0,24013,2130
2020-09-08,Italy,NA,Veneto,4905854,105,2,24118,2132
2020-09-09,Italy,NA,Veneto,4905854,91,3,24209,2135
2020-09-10,Italy,NA,Veneto,4905854,147,0,24356,2135
2020-09-11,Italy,NA,Veneto,4905854,173,3,24529,2138
2020-09-12,Italy,NA,Veneto,4905854,138,3,24667,2141
2020-09-13,Italy,NA,Veneto,4905854,142,1,24809,2142
2020-09-14,Italy,NA,Veneto,4905854,55,2,24864,2144
2020-09-15,Italy,NA,Veneto,4905854,115,2,24979,2146
2020-09-16,Italy,NA,Veneto,4905854,159,5,25138,2151
2020-09-17,Italy,NA,Veneto,4905854,109,0,25247,2151
2020-09-18,Italy,NA,Veneto,4905854,176,2,25423,2153
2020-09-19,Italy,NA,Veneto,4905854,186,5,25609,2158
2020-09-20,Italy,NA,Veneto,4905854,173,4,25782,2162
2020-09-21,Italy,NA,Veneto,4905854,103,0,25885,2162
2020-09-22,Italy,NA,Veneto,4905854,119,3,26004,2165
2020-09-23,Italy,NA,Veneto,4905854,150,2,26154,2167
2020-02-21,Japan,NA,Aichi,7549594,2,0,11,0
2020-02-22,Japan,NA,Aichi,7549594,4,0,15,0
2020-02-23,Japan,NA,Aichi,7549594,2,0,17,0
2020-02-24,Japan,NA,Aichi,7549594,0,0,17,0
2020-02-25,Japan,NA,Aichi,7549594,3,0,20,0
2020-02-26,Japan,NA,Aichi,7549594,5,0,25,0
2020-02-27,Japan,NA,Aichi,7549594,2,0,27,0
2020-02-28,Japan,NA,Aichi,7549594,1,0,28,0
2020-02-29,Japan,NA,Aichi,7549594,1,0,29,0
2020-03-01,Japan,NA,Aichi,7549594,3,0,32,0
2020-03-02,Japan,NA,Aichi,7549594,0,0,32,0
2020-03-03,Japan,NA,Aichi,7549594,9,0,41,0
2020-03-04,Japan,NA,Aichi,7549594,8,0,49,0
2020-03-05,Japan,NA,Aichi,7549594,8,0,57,0
2020-03-06,Japan,NA,Aichi,7549594,5,0,62,0
2020-03-07,Japan,NA,Aichi,7549594,7,0,69,0
2020-03-08,Japan,NA,Aichi,7549594,11,1,80,1
2020-03-09,Japan,NA,Aichi,7549594,6,0,86,1
2020-03-10,Japan,NA,Aichi,7549594,13,2,99,3
2020-03-11,Japan,NA,Aichi,7549594,5,2,104,5
2020-03-12,Japan,NA,Aichi,7549594,7,3,111,8
2020-03-13,Japan,NA,Aichi,7549594,3,2,114,10
2020-03-14,Japan,NA,Aichi,7549594,7,1,121,11
2020-03-15,Japan,NA,Aichi,7549594,0,1,121,12
2020-03-16,Japan,NA,Aichi,7549594,2,2,123,14
2020-03-17,Japan,NA,Aichi,7549594,2,0,125,14
2020-03-18,Japan,NA,Aichi,7549594,5,1,130,15
2020-03-19,Japan,NA,Aichi,7549594,4,0,134,15
2020-03-20,Japan,NA,Aichi,7549594,5,1,139,16
2020-03-21,Japan,NA,Aichi,7549594,2,0,141,16
2020-03-22,Japan,NA,Aichi,7549594,2,0,143,16
2020-03-23,Japan,NA,Aichi,7549594,2,1,145,17
2020-03-24,Japan,NA,Aichi,7549594,3,0,148,17
2020-03-25,Japan,NA,Aichi,7549594,6,1,154,18
2020-03-26,Japan,NA,Aichi,7549594,3,1,157,19
2020-03-27,Japan,NA,Aichi,7549594,3,0,160,19
2020-03-28,Japan,NA,Aichi,7549594,4,0,164,19
2020-03-29,Japan,NA,Aichi,7549594,3,0,167,19
2020-03-30,Japan,NA,Aichi,7549594,3,0,170,19
2020-03-31,Japan,NA,Aichi,7549594,8,0,178,19
2020-04-01,Japan,NA,Aichi,7549594,5,0,183,19
2020-04-02,Japan,NA,Aichi,7549594,6,0,189,19
2020-04-03,Japan,NA,Aichi,7549594,12,0,201,19
2020-04-04,Japan,NA,Aichi,7549594,19,0,220,19
2020-04-05,Japan,NA,Aichi,7549594,7,1,227,20
2020-04-06,Japan,NA,Aichi,7549594,11,1,238,21
2020-04-07,Japan,NA,Aichi,7549594,21,0,259,21
2020-04-08,Japan,NA,Aichi,7549594,20,0,279,21
2020-04-09,Japan,NA,Aichi,7549594,21,0,300,21
2020-04-10,Japan,NA,Aichi,7549594,14,1,314,22
2020-04-11,Japan,NA,Aichi,7549594,10,1,324,23
2020-04-12,Japan,NA,Aichi,7549594,2,1,326,24
2020-04-13,Japan,NA,Aichi,7549594,9,0,335,24
2020-04-14,Japan,NA,Aichi,7549594,10,0,345,24
2020-04-15,Japan,NA,Aichi,7549594,11,0,356,24
2020-04-16,Japan,NA,Aichi,7549594,14,0,370,24
2020-04-17,Japan,NA,Aichi,7549594,10,0,380,24
2020-04-18,Japan,NA,Aichi,7549594,15,1,395,25
2020-04-19,Japan,NA,Aichi,7549594,10,0,405,25
2020-04-20,Japan,NA,Aichi,7549594,5,2,410,27
2020-04-21,Japan,NA,Aichi,7549594,16,2,426,29
2020-04-22,Japan,NA,Aichi,7549594,19,0,445,29
2020-04-23,Japan,NA,Aichi,7549594,12,0,457,29
2020-04-24,Japan,NA,Aichi,7549594,14,1,471,30
2020-04-25,Japan,NA,Aichi,7549594,1,1,472,31
2020-04-26,Japan,NA,Aichi,7549594,1,0,473,31
2020-04-27,Japan,NA,Aichi,7549594,0,0,473,31
2020-04-28,Japan,NA,Aichi,7549594,5,0,478,31
2020-04-29,Japan,NA,Aichi,7549594,4,1,482,32
2020-04-30,Japan,NA,Aichi,7549594,1,1,483,33
2020-05-01,Japan,NA,Aichi,7549594,3,0,486,33
2020-05-02,Japan,NA,Aichi,7549594,0,1,486,34
2020-05-03,Japan,NA,Aichi,7549594,1,0,487,34
2020-05-04,Japan,NA,Aichi,7549594,3,0,490,34
2020-05-05,Japan,NA,Aichi,7549594,3,0,493,34
2020-05-06,Japan,NA,Aichi,7549594,0,0,493,34
2020-05-07,Japan,NA,Aichi,7549594,0,0,493,34
2020-05-08,Japan,NA,Aichi,7549594,0,0,493,34
2020-05-09,Japan,NA,Aichi,7549594,3,0,496,34
2020-05-10,Japan,NA,Aichi,7549594,0,0,496,34
2020-05-11,Japan,NA,Aichi,7549594,1,0,497,34
2020-05-12,Japan,NA,Aichi,7549594,1,0,498,34
2020-05-13,Japan,NA,Aichi,7549594,1,0,499,34
2020-05-14,Japan,NA,Aichi,7549594,1,0,500,34
2020-05-15,Japan,NA,Aichi,7549594,1,0,501,34
2020-05-16,Japan,NA,Aichi,7549594,2,0,503,34
2020-05-17,Japan,NA,Aichi,7549594,0,0,503,34
2020-05-18,Japan,NA,Aichi,7549594,0,0,503,34
2020-05-19,Japan,NA,Aichi,7549594,0,0,503,34
2020-05-20,Japan,NA,Aichi,7549594,0,0,503,34
2020-05-21,Japan,NA,Aichi,7549594,0,0,503,34
2020-05-22,Japan,NA,Aichi,7549594,0,0,503,34
2020-05-23,Japan,NA,Aichi,7549594,1,0,504,34
2020-05-24,Japan,NA,Aichi,7549594,0,0,504,34
2020-05-25,Japan,NA,Aichi,7549594,0,0,504,34
2020-05-26,Japan,NA,Aichi,7549594,0,0,504,34
2020-05-27,Japan,NA,Aichi,7549594,0,0,504,34
2020-05-28,Japan,NA,Aichi,7549594,0,0,504,34
2020-05-29,Japan,NA,Aichi,7549594,0,0,504,34
2020-05-30,Japan,NA,Aichi,7549594,1,0,505,34
2020-05-31,Japan,NA,Aichi,7549594,0,0,505,34
2020-06-01,Japan,NA,Aichi,7549594,0,0,505,34
2020-06-02,Japan,NA,Aichi,7549594,1,0,506,34
2020-06-03,Japan,NA,Aichi,7549594,0,0,506,34
2020-06-04,Japan,NA,Aichi,7549594,0,0,506,34
2020-06-05,Japan,NA,Aichi,7549594,1,0,507,34
2020-06-06,Japan,NA,Aichi,7549594,0,0,507,34
2020-06-07,Japan,NA,Aichi,7549594,1,0,508,34
2020-06-08,Japan,NA,Aichi,7549594,0,0,508,34
2020-06-09,Japan,NA,Aichi,7549594,0,0,508,34
2020-06-10,Japan,NA,Aichi,7549594,2,0,510,34
2020-06-11,Japan,NA,Aichi,7549594,0,0,510,34
2020-06-12,Japan,NA,Aichi,7549594,2,0,512,34
2020-06-13,Japan,NA,Aichi,7549594,1,0,513,34
2020-06-14,Japan,NA,Aichi,7549594,0,0,513,34
2020-06-15,Japan,NA,Aichi,7549594,0,0,513,34
2020-06-16,Japan,NA,Aichi,7549594,1,0,514,34
2020-06-17,Japan,NA,Aichi,7549594,3,0,517,34
2020-06-18,Japan,NA,Aichi,7549594,0,0,517,34
2020-06-19,Japan,NA,Aichi,7549594,1,0,518,34
2020-06-20,Japan,NA,Aichi,7549594,1,0,519,34
2020-06-21,Japan,NA,Aichi,7549594,0,0,519,34
2020-06-22,Japan,NA,Aichi,7549594,0,0,519,34
2020-06-23,Japan,NA,Aichi,7549594,0,0,519,34
2020-06-24,Japan,NA,Aichi,7549594,0,0,519,34
2020-06-25,Japan,NA,Aichi,7549594,0,0,519,34
2020-06-26,Japan,NA,Aichi,7549594,0,0,519,34
2020-06-27,Japan,NA,Aichi,7549594,0,0,519,34
2020-06-28,Japan,NA,Aichi,7549594,0,0,519,34
2020-06-29,Japan,NA,Aichi,7549594,1,0,520,34
2020-06-30,Japan,NA,Aichi,7549594,1,0,521,34
2020-07-01,Japan,NA,Aichi,7549594,0,0,521,34
2020-07-02,Japan,NA,Aichi,7549594,0,0,521,34
2020-07-03,Japan,NA,Aichi,7549594,0,0,521,34
2020-07-04,Japan,NA,Aichi,7549594,0,0,521,34
2020-07-05,Japan,NA,Aichi,7549594,0,0,521,34
2020-07-06,Japan,NA,Aichi,7549594,2,0,523,34
2020-07-07,Japan,NA,Aichi,7549594,0,0,523,34
2020-07-08,Japan,NA,Aichi,7549594,2,0,525,34
2020-07-09,Japan,NA,Aichi,7549594,0,0,525,34
2020-07-10,Japan,NA,Aichi,7549594,0,0,525,34
2020-07-11,Japan,NA,Aichi,7549594,2,0,527,34
2020-07-12,Japan,NA,Aichi,7549594,0,0,527,34
2020-07-13,Japan,NA,Aichi,7549594,2,0,529,34
2020-07-14,Japan,NA,Aichi,7549594,5,0,534,34
2020-07-15,Japan,NA,Aichi,7549594,16,0,550,34
2020-07-16,Japan,NA,Aichi,7549594,21,0,571,34
2020-07-17,Japan,NA,Aichi,7549594,19,0,590,34
2020-07-18,Japan,NA,Aichi,7549594,25,0,615,34
2020-07-19,Japan,NA,Aichi,7549594,21,0,636,34
2020-07-20,Japan,NA,Aichi,7549594,21,0,657,34
2020-07-21,Japan,NA,Aichi,7549594,53,0,710,34
2020-07-22,Japan,NA,Aichi,7549594,64,1,774,35
2020-07-23,Japan,NA,Aichi,7549594,97,0,871,35
2020-07-24,Japan,NA,Aichi,7549594,63,0,934,35
2020-07-25,Japan,NA,Aichi,7549594,78,0,1012,35
2020-07-26,Japan,NA,Aichi,7549594,80,0,1092,35
2020-07-27,Japan,NA,Aichi,7549594,76,0,1168,35
2020-07-28,Japan,NA,Aichi,7549594,110,0,1278,35
2020-07-29,Japan,NA,Aichi,7549594,167,0,1445,35
2020-07-30,Japan,NA,Aichi,7549594,160,0,1605,35
2020-07-31,Japan,NA,Aichi,7549594,193,0,1798,35
2020-08-01,Japan,NA,Aichi,7549594,181,0,1979,35
2020-08-02,Japan,NA,Aichi,7549594,160,0,2139,35
2020-08-03,Japan,NA,Aichi,7549594,125,0,2264,35
2020-08-04,Japan,NA,Aichi,7549594,120,0,2384,35
2020-08-05,Japan,NA,Aichi,7549594,147,2,2531,37
2020-08-06,Japan,NA,Aichi,7549594,140,0,2671,37
2020-08-07,Japan,NA,Aichi,7549594,158,0,2829,37
2020-08-08,Japan,NA,Aichi,7549594,177,0,3006,37
2020-08-09,Japan,NA,Aichi,7549594,129,0,3135,37
2020-08-10,Japan,NA,Aichi,7549594,101,0,3236,37
2020-08-11,Japan,NA,Aichi,7549594,67,0,3303,37
2020-08-12,Japan,NA,Aichi,7549594,86,1,3389,38
2020-08-13,Japan,NA,Aichi,7549594,109,1,3498,39
2020-08-14,Japan,NA,Aichi,7549594,88,0,3586,39
2020-08-15,Japan,NA,Aichi,7549594,72,4,3658,43
2020-08-16,Japan,NA,Aichi,7549594,83,1,3741,44
2020-08-17,Japan,NA,Aichi,7549594,43,1,3784,45
2020-08-18,Japan,NA,Aichi,7549594,57,1,3841,46
2020-08-19,Japan,NA,Aichi,7549594,57,2,3898,48
2020-08-20,Japan,NA,Aichi,7549594,82,1,3980,49
2020-08-21,Japan,NA,Aichi,7549594,90,3,4070,52
2020-08-22,Japan,NA,Aichi,7549594,69,2,4139,54
2020-08-23,Japan,NA,Aichi,7549594,50,3,4189,57
2020-08-24,Japan,NA,Aichi,7549594,43,0,4232,57
2020-08-25,Japan,NA,Aichi,7549594,43,1,4275,58
2020-08-26,Japan,NA,Aichi,7549594,50,0,4325,58
2020-08-27,Japan,NA,Aichi,7549594,39,2,4364,60
2020-08-28,Japan,NA,Aichi,7549594,50,1,4414,61
2020-08-29,Japan,NA,Aichi,7549594,45,3,4459,64
2020-08-30,Japan,NA,Aichi,7549594,36,1,4495,65
2020-08-31,Japan,NA,Aichi,7549594,42,0,4537,65
2020-09-01,Japan,NA,Aichi,7549594,24,3,4561,68
2020-09-02,Japan,NA,Aichi,7549594,27,3,4588,71
2020-09-03,Japan,NA,Aichi,7549594,18,1,4606,72
2020-09-04,Japan,NA,Aichi,7549594,33,1,4639,73
2020-09-05,Japan,NA,Aichi,7549594,34,0,4673,73
2020-09-06,Japan,NA,Aichi,7549594,27,1,4700,74
2020-09-07,Japan,NA,Aichi,7549594,21,0,4721,74
2020-09-08,Japan,NA,Aichi,7549594,11,0,4732,74
2020-09-09,Japan,NA,Aichi,7549594,21,0,4753,74
2020-09-10,Japan,NA,Aichi,7549594,36,0,4789,74
2020-09-11,Japan,NA,Aichi,7549594,48,1,4837,75
2020-09-12,Japan,NA,Aichi,7549594,29,0,4866,75
2020-09-13,Japan,NA,Aichi,7549594,33,1,4899,76
2020-09-14,Japan,NA,Aichi,7549594,23,0,4922,76
2020-09-15,Japan,NA,Aichi,7549594,21,1,4943,77
2020-09-16,Japan,NA,Aichi,7549594,22,0,4965,77
2020-09-17,Japan,NA,Aichi,7549594,36,0,5001,77
2020-09-18,Japan,NA,Aichi,7549594,40,1,5041,78
2020-09-19,Japan,NA,Aichi,7549594,31,1,5072,79
2020-09-20,Japan,NA,Aichi,7549594,33,2,5105,81
2020-09-21,Japan,NA,Aichi,7549594,19,0,5124,81
2020-09-22,Japan,NA,Aichi,7549594,9,0,5133,81
2020-09-23,Japan,NA,Aichi,7549594,14,2,5147,83
2020-02-26,Japan,NA,Chiba,6279026,3,0,13,0
2020-02-27,Japan,NA,Chiba,6279026,0,0,13,0
2020-02-28,Japan,NA,Chiba,6279026,0,0,13,0
2020-02-29,Japan,NA,Chiba,6279026,0,0,13,0
2020-03-01,Japan,NA,Chiba,6279026,1,0,14,0
2020-03-02,Japan,NA,Chiba,6279026,0,0,14,0
2020-03-03,Japan,NA,Chiba,6279026,0,0,14,0
2020-03-04,Japan,NA,Chiba,6279026,1,0,15,0
2020-03-05,Japan,NA,Chiba,6279026,0,0,15,0
2020-03-06,Japan,NA,Chiba,6279026,2,0,17,0
2020-03-07,Japan,NA,Chiba,6279026,4,0,21,0
2020-03-08,Japan,NA,Chiba,6279026,0,0,21,0
2020-03-09,Japan,NA,Chiba,6279026,1,0,22,0
2020-03-10,Japan,NA,Chiba,6279026,1,0,23,0
2020-03-11,Japan,NA,Chiba,6279026,2,0,25,0
2020-03-12,Japan,NA,Chiba,6279026,2,0,27,0
2020-03-13,Japan,NA,Chiba,6279026,2,0,29,0
2020-03-14,Japan,NA,Chiba,6279026,2,0,31,0
2020-03-15,Japan,NA,Chiba,6279026,0,0,31,0
2020-03-16,Japan,NA,Chiba,6279026,0,0,31,0
2020-03-17,Japan,NA,Chiba,6279026,0,0,31,0
2020-03-18,Japan,NA,Chiba,6279026,2,0,33,0
2020-03-19,Japan,NA,Chiba,6279026,3,0,36,0
2020-03-20,Japan,NA,Chiba,6279026,5,0,41,0
2020-03-21,Japan,NA,Chiba,6279026,1,0,42,0
2020-03-22,Japan,NA,Chiba,6279026,2,0,44,0
2020-03-23,Japan,NA,Chiba,6279026,3,0,47,0
2020-03-24,Japan,NA,Chiba,6279026,1,0,48,0
2020-03-25,Japan,NA,Chiba,6279026,5,0,53,0
2020-03-26,Japan,NA,Chiba,6279026,3,0,56,0
2020-03-27,Japan,NA,Chiba,6279026,7,0,63,0
2020-03-28,Japan,NA,Chiba,6279026,62,1,125,1
2020-03-29,Japan,NA,Chiba,6279026,33,0,158,1
2020-03-30,Japan,NA,Chiba,6279026,0,0,158,1
2020-03-31,Japan,NA,Chiba,6279026,13,0,171,1
2020-04-01,Japan,NA,Chiba,6279026,14,0,185,1
2020-04-02,Japan,NA,Chiba,6279026,5,0,190,1
2020-04-03,Japan,NA,Chiba,6279026,20,0,210,1
2020-04-04,Japan,NA,Chiba,6279026,26,0,236,1
2020-04-05,Japan,NA,Chiba,6279026,26,0,262,1
2020-04-06,Japan,NA,Chiba,6279026,18,0,280,1
2020-04-07,Japan,NA,Chiba,6279026,13,0,293,1
2020-04-08,Japan,NA,Chiba,6279026,34,0,327,1
2020-04-09,Japan,NA,Chiba,6279026,30,0,357,1
2020-04-10,Japan,NA,Chiba,6279026,33,1,390,2
2020-04-11,Japan,NA,Chiba,6279026,36,2,426,4
2020-04-12,Japan,NA,Chiba,6279026,44,1,470,5
2020-04-13,Japan,NA,Chiba,6279026,19,0,489,5
2020-04-14,Japan,NA,Chiba,6279026,16,1,505,6
2020-04-15,Japan,NA,Chiba,6279026,35,1,540,7
2020-04-16,Japan,NA,Chiba,6279026,58,0,598,7
2020-04-17,Japan,NA,Chiba,6279026,35,1,633,8
2020-04-18,Japan,NA,Chiba,6279026,34,2,667,10
2020-04-19,Japan,NA,Chiba,6279026,18,1,685,11
2020-04-20,Japan,NA,Chiba,6279026,22,0,707,11
2020-04-21,Japan,NA,Chiba,6279026,21,2,728,13
2020-04-22,Japan,NA,Chiba,6279026,20,3,748,16
2020-04-23,Japan,NA,Chiba,6279026,24,2,772,18
2020-04-24,Japan,NA,Chiba,6279026,18,3,790,21
2020-04-25,Japan,NA,Chiba,6279026,8,1,798,22
2020-04-26,Japan,NA,Chiba,6279026,8,4,806,26
2020-04-27,Japan,NA,Chiba,6279026,7,3,813,29
2020-04-28,Japan,NA,Chiba,6279026,8,2,821,31
2020-04-29,Japan,NA,Chiba,6279026,4,0,825,31
2020-04-30,Japan,NA,Chiba,6279026,9,1,834,32
2020-05-01,Japan,NA,Chiba,6279026,6,2,840,34
2020-05-02,Japan,NA,Chiba,6279026,6,0,846,34
2020-05-03,Japan,NA,Chiba,6279026,5,0,851,34
2020-05-04,Japan,NA,Chiba,6279026,5,0,856,34
2020-05-05,Japan,NA,Chiba,6279026,1,2,857,36
2020-05-06,Japan,NA,Chiba,6279026,2,1,859,37
2020-05-07,Japan,NA,Chiba,6279026,5,1,864,38
2020-05-08,Japan,NA,Chiba,6279026,3,0,867,38
2020-05-09,Japan,NA,Chiba,6279026,3,1,870,39
2020-05-10,Japan,NA,Chiba,6279026,0,1,870,40
2020-05-11,Japan,NA,Chiba,6279026,3,0,873,40
2020-05-12,Japan,NA,Chiba,6279026,3,0,876,40
2020-05-13,Japan,NA,Chiba,6279026,2,0,878,40
2020-05-14,Japan,NA,Chiba,6279026,0,0,878,40
2020-05-15,Japan,NA,Chiba,6279026,2,2,880,42
2020-05-16,Japan,NA,Chiba,6279026,8,0,888,42
2020-05-17,Japan,NA,Chiba,6279026,0,0,888,42
2020-05-18,Japan,NA,Chiba,6279026,2,0,890,42
2020-05-19,Japan,NA,Chiba,6279026,0,0,890,42
2020-05-20,Japan,NA,Chiba,6279026,1,0,891,42
2020-05-21,Japan,NA,Chiba,6279026,3,2,894,44
2020-05-22,Japan,NA,Chiba,6279026,0,0,894,44
2020-05-23,Japan,NA,Chiba,6279026,0,0,894,44
2020-05-24,Japan,NA,Chiba,6279026,0,0,894,44
2020-05-25,Japan,NA,Chiba,6279026,0,0,894,44
2020-05-26,Japan,NA,Chiba,6279026,0,0,894,44
2020-05-27,Japan,NA,Chiba,6279026,1,0,895,44
2020-05-28,Japan,NA,Chiba,6279026,1,1,896,45
2020-05-29,Japan,NA,Chiba,6279026,0,0,896,45
2020-05-30,Japan,NA,Chiba,6279026,1,0,897,45
2020-05-31,Japan,NA,Chiba,6279026,1,0,898,45
2020-06-01,Japan,NA,Chiba,6279026,0,0,898,45
2020-06-02,Japan,NA,Chiba,6279026,1,0,899,45
2020-06-03,Japan,NA,Chiba,6279026,1,0,900,45
2020-06-04,Japan,NA,Chiba,6279026,0,0,900,45
2020-06-05,Japan,NA,Chiba,6279026,1,0,901,45
2020-06-06,Japan,NA,Chiba,6279026,0,0,901,45
2020-06-07,Japan,NA,Chiba,6279026,3,0,904,45
2020-06-08,Japan,NA,Chiba,6279026,0,0,904,45
2020-06-09,Japan,NA,Chiba,6279026,3,0,907,45
2020-06-10,Japan,NA,Chiba,6279026,2,0,909,45
2020-06-11,Japan,NA,Chiba,6279026,3,0,912,45
2020-06-12,Japan,NA,Chiba,6279026,3,0,915,45
2020-06-13,Japan,NA,Chiba,6279026,1,0,916,45
2020-06-14,Japan,NA,Chiba,6279026,0,0,916,45
2020-06-15,Japan,NA,Chiba,6279026,0,0,916,45
2020-06-16,Japan,NA,Chiba,6279026,0,0,916,45
2020-06-17,Japan,NA,Chiba,6279026,1,0,917,45
2020-06-18,Japan,NA,Chiba,6279026,2,0,919,45
2020-06-19,Japan,NA,Chiba,6279026,0,0,919,45
2020-06-20,Japan,NA,Chiba,6279026,2,0,921,45
2020-06-21,Japan,NA,Chiba,6279026,0,0,921,45
2020-06-22,Japan,NA,Chiba,6279026,2,0,923,45
2020-06-23,Japan,NA,Chiba,6279026,3,0,926,45
2020-06-24,Japan,NA,Chiba,6279026,4,0,930,45
2020-06-25,Japan,NA,Chiba,6279026,4,0,934,45
2020-06-26,Japan,NA,Chiba,6279026,4,0,938,45
2020-06-27,Japan,NA,Chiba,6279026,5,0,943,45
2020-06-28,Japan,NA,Chiba,6279026,3,0,946,45
2020-06-29,Japan,NA,Chiba,6279026,4,0,950,45
2020-06-30,Japan,NA,Chiba,6279026,7,0,957,45
2020-07-01,Japan,NA,Chiba,6279026,6,0,963,45
2020-07-02,Japan,NA,Chiba,6279026,11,0,974,45
2020-07-03,Japan,NA,Chiba,6279026,9,0,983,45
2020-07-04,Japan,NA,Chiba,6279026,15,0,998,45
2020-07-05,Japan,NA,Chiba,6279026,7,0,1005,45
2020-07-06,Japan,NA,Chiba,6279026,9,0,1014,45
2020-07-07,Japan,NA,Chiba,6279026,11,1,1025,46
2020-07-08,Japan,NA,Chiba,6279026,9,0,1034,46
2020-07-09,Japan,NA,Chiba,6279026,22,0,1056,46
2020-07-10,Japan,NA,Chiba,6279026,12,0,1068,46
2020-07-11,Japan,NA,Chiba,6279026,13,0,1081,46
2020-07-12,Japan,NA,Chiba,6279026,31,0,1112,46
2020-07-13,Japan,NA,Chiba,6279026,17,0,1129,46
2020-07-14,Japan,NA,Chiba,6279026,25,0,1154,46
2020-07-15,Japan,NA,Chiba,6279026,29,0,1183,46
2020-07-16,Japan,NA,Chiba,6279026,32,0,1215,46
2020-07-17,Japan,NA,Chiba,6279026,20,0,1235,46
2020-07-18,Japan,NA,Chiba,6279026,32,0,1267,46
2020-07-19,Japan,NA,Chiba,6279026,24,0,1291,46
2020-07-20,Japan,NA,Chiba,6279026,18,0,1309,46
2020-07-21,Japan,NA,Chiba,6279026,15,0,1324,46
2020-07-22,Japan,NA,Chiba,6279026,40,0,1364,46
2020-07-23,Japan,NA,Chiba,6279026,33,0,1397,46
2020-07-24,Japan,NA,Chiba,6279026,26,0,1423,46
2020-07-25,Japan,NA,Chiba,6279026,21,0,1444,46
2020-07-26,Japan,NA,Chiba,6279026,22,0,1466,46
2020-07-27,Japan,NA,Chiba,6279026,24,0,1490,46
2020-07-28,Japan,NA,Chiba,6279026,23,2,1513,48
2020-07-29,Japan,NA,Chiba,6279026,49,0,1562,48
2020-07-30,Japan,NA,Chiba,6279026,49,0,1611,48
2020-07-31,Japan,NA,Chiba,6279026,35,1,1646,49
2020-08-01,Japan,NA,Chiba,6279026,73,0,1719,49
2020-08-02,Japan,NA,Chiba,6279026,51,0,1770,49
2020-08-03,Japan,NA,Chiba,6279026,43,1,1813,50
2020-08-04,Japan,NA,Chiba,6279026,47,0,1860,50
2020-08-05,Japan,NA,Chiba,6279026,50,1,1910,51
2020-08-06,Japan,NA,Chiba,6279026,76,0,1986,51
2020-08-07,Japan,NA,Chiba,6279026,65,1,2051,52
2020-08-08,Japan,NA,Chiba,6279026,53,0,2104,52
2020-08-09,Japan,NA,Chiba,6279026,46,2,2150,54
2020-08-10,Japan,NA,Chiba,6279026,41,0,2191,54
2020-08-11,Japan,NA,Chiba,6279026,18,1,2209,55
2020-08-12,Japan,NA,Chiba,6279026,34,0,2243,55
2020-08-13,Japan,NA,Chiba,6279026,46,0,2289,55
2020-08-14,Japan,NA,Chiba,6279026,51,1,2340,56
2020-08-15,Japan,NA,Chiba,6279026,60,0,2400,56
2020-08-16,Japan,NA,Chiba,6279026,48,0,2448,56
2020-08-17,Japan,NA,Chiba,6279026,32,2,2480,58
2020-08-18,Japan,NA,Chiba,6279026,37,0,2517,58
2020-08-19,Japan,NA,Chiba,6279026,46,0,2563,58
2020-08-20,Japan,NA,Chiba,6279026,64,0,2627,58
2020-08-21,Japan,NA,Chiba,6279026,54,1,2681,59
2020-08-22,Japan,NA,Chiba,6279026,43,0,2724,59
2020-08-23,Japan,NA,Chiba,6279026,36,0,2760,59
2020-08-24,Japan,NA,Chiba,6279026,27,0,2787,59
2020-08-25,Japan,NA,Chiba,6279026,33,1,2820,60
2020-08-26,Japan,NA,Chiba,6279026,43,1,2863,61
2020-08-27,Japan,NA,Chiba,6279026,45,0,2908,61
2020-08-28,Japan,NA,Chiba,6279026,39,0,2947,61
2020-08-29,Japan,NA,Chiba,6279026,33,0,2980,61
2020-08-30,Japan,NA,Chiba,6279026,39,1,3019,62
2020-08-31,Japan,NA,Chiba,6279026,17,0,3036,62
2020-09-01,Japan,NA,Chiba,6279026,17,1,3053,63
2020-09-02,Japan,NA,Chiba,6279026,24,0,3077,63
2020-09-03,Japan,NA,Chiba,6279026,33,0,3110,63
2020-09-04,Japan,NA,Chiba,6279026,35,0,3145,63
2020-09-05,Japan,NA,Chiba,6279026,28,0,3173,63
2020-09-06,Japan,NA,Chiba,6279026,23,1,3196,64
2020-09-07,Japan,NA,Chiba,6279026,14,0,3210,64
2020-09-08,Japan,NA,Chiba,6279026,32,0,3242,64
2020-09-09,Japan,NA,Chiba,6279026,23,1,3265,65
2020-09-10,Japan,NA,Chiba,6279026,28,1,3293,66
2020-09-11,Japan,NA,Chiba,6279026,31,0,3324,66
2020-09-12,Japan,NA,Chiba,6279026,45,1,3369,67
2020-09-13,Japan,NA,Chiba,6279026,20,0,3389,67
2020-09-14,Japan,NA,Chiba,6279026,11,0,3400,67
2020-09-15,Japan,NA,Chiba,6279026,30,0,3430,67
2020-09-16,Japan,NA,Chiba,6279026,37,0,3467,67
2020-09-17,Japan,NA,Chiba,6279026,34,0,3501,67
2020-09-18,Japan,NA,Chiba,6279026,40,1,3541,68
2020-09-19,Japan,NA,Chiba,6279026,46,0,3587,68
2020-09-20,Japan,NA,Chiba,6279026,35,0,3622,68
2020-09-21,Japan,NA,Chiba,6279026,14,0,3636,68
2020-09-22,Japan,NA,Chiba,6279026,18,0,3654,68
2020-09-23,Japan,NA,Chiba,6279026,20,0,3674,68
2020-03-26,Japan,NA,Fukuoka,5110113,3,0,12,0
2020-03-27,Japan,NA,Fukuoka,5110113,4,0,16,0
2020-03-28,Japan,NA,Fukuoka,5110113,6,0,22,0
2020-03-29,Japan,NA,Fukuoka,5110113,4,0,26,0
2020-03-30,Japan,NA,Fukuoka,5110113,3,0,29,0
2020-03-31,Japan,NA,Fukuoka,5110113,17,0,46,0
2020-04-01,Japan,NA,Fukuoka,5110113,32,0,78,0
2020-04-02,Japan,NA,Fukuoka,5110113,22,0,100,0
2020-04-03,Japan,NA,Fukuoka,5110113,19,1,119,1
2020-04-04,Japan,NA,Fukuoka,5110113,27,0,146,1
2020-04-05,Japan,NA,Fukuoka,5110113,16,0,162,1
2020-04-06,Japan,NA,Fukuoka,5110113,14,0,176,1
2020-04-07,Japan,NA,Fukuoka,5110113,23,0,199,1
2020-04-08,Japan,NA,Fukuoka,5110113,25,0,224,1
2020-04-09,Japan,NA,Fukuoka,5110113,26,0,250,1
2020-04-10,Japan,NA,Fukuoka,5110113,39,0,289,1
2020-04-11,Japan,NA,Fukuoka,5110113,43,0,332,1
2020-04-12,Japan,NA,Fukuoka,5110113,30,0,362,1
2020-04-13,Japan,NA,Fukuoka,5110113,11,1,373,2
2020-04-14,Japan,NA,Fukuoka,5110113,32,2,405,4
2020-04-15,Japan,NA,Fukuoka,5110113,30,2,435,6
2020-04-16,Japan,NA,Fukuoka,5110113,26,2,461,8
2020-04-17,Japan,NA,Fukuoka,5110113,17,1,478,9
2020-04-18,Japan,NA,Fukuoka,5110113,24,1,502,10
2020-04-19,Japan,NA,Fukuoka,5110113,16,1,518,11
2020-04-20,Japan,NA,Fukuoka,5110113,2,1,520,12
2020-04-21,Japan,NA,Fukuoka,5110113,21,0,541,12
2020-04-22,Japan,NA,Fukuoka,5110113,21,1,562,13
2020-04-23,Japan,NA,Fukuoka,5110113,12,2,574,15
2020-04-24,Japan,NA,Fukuoka,5110113,12,0,586,15
2020-04-25,Japan,NA,Fukuoka,5110113,14,0,600,15
2020-04-26,Japan,NA,Fukuoka,5110113,11,1,611,16
2020-04-27,Japan,NA,Fukuoka,5110113,9,1,620,17
2020-04-28,Japan,NA,Fukuoka,5110113,4,0,624,17
2020-04-29,Japan,NA,Fukuoka,5110113,13,2,637,19
2020-04-30,Japan,NA,Fukuoka,5110113,3,1,640,20
2020-05-01,Japan,NA,Fukuoka,5110113,3,1,643,21
2020-05-02,Japan,NA,Fukuoka,5110113,3,1,646,22
2020-05-03,Japan,NA,Fukuoka,5110113,0,2,646,24
2020-05-04,Japan,NA,Fukuoka,5110113,1,0,647,24
2020-05-05,Japan,NA,Fukuoka,5110113,1,0,648,24
2020-05-06,Japan,NA,Fukuoka,5110113,1,0,649,24
2020-05-07,Japan,NA,Fukuoka,5110113,1,0,650,24
2020-05-08,Japan,NA,Fukuoka,5110113,0,0,650,24
2020-05-09,Japan,NA,Fukuoka,5110113,2,0,652,24
2020-05-10,Japan,NA,Fukuoka,5110113,1,0,653,24
2020-05-11,Japan,NA,Fukuoka,5110113,0,0,653,24
2020-05-12,Japan,NA,Fukuoka,5110113,1,0,654,24
2020-05-13,Japan,NA,Fukuoka,5110113,0,1,654,25
2020-05-14,Japan,NA,Fukuoka,5110113,1,0,655,25
2020-05-15,Japan,NA,Fukuoka,5110113,0,0,655,25
2020-05-16,Japan,NA,Fukuoka,5110113,0,0,655,25
2020-05-17,Japan,NA,Fukuoka,5110113,0,0,655,25
2020-05-18,Japan,NA,Fukuoka,5110113,0,0,655,25
2020-05-19,Japan,NA,Fukuoka,5110113,0,0,655,25
2020-05-20,Japan,NA,Fukuoka,5110113,0,0,655,25
2020-05-21,Japan,NA,Fukuoka,5110113,0,0,655,25
2020-05-22,Japan,NA,Fukuoka,5110113,0,0,655,25
2020-05-23,Japan,NA,Fukuoka,5110113,4,0,659,25
2020-05-24,Japan,NA,Fukuoka,5110113,3,1,662,26
2020-05-25,Japan,NA,Fukuoka,5110113,6,0,668,26
2020-05-26,Japan,NA,Fukuoka,5110113,2,0,670,26
2020-05-27,Japan,NA,Fukuoka,5110113,8,0,678,26
2020-05-28,Japan,NA,Fukuoka,5110113,21,1,699,27
2020-05-29,Japan,NA,Fukuoka,5110113,26,0,725,27
2020-05-30,Japan,NA,Fukuoka,5110113,16,0,741,27
2020-05-31,Japan,NA,Fukuoka,5110113,12,1,753,28
2020-06-01,Japan,NA,Fukuoka,5110113,16,1,769,29
2020-06-02,Japan,NA,Fukuoka,5110113,6,0,775,29
2020-06-03,Japan,NA,Fukuoka,5110113,6,0,781,29
2020-06-04,Japan,NA,Fukuoka,5110113,6,1,787,30
2020-06-05,Japan,NA,Fukuoka,5110113,5,0,792,30
2020-06-06,Japan,NA,Fukuoka,5110113,2,0,794,30
2020-06-07,Japan,NA,Fukuoka,5110113,3,0,797,30
2020-06-08,Japan,NA,Fukuoka,5110113,3,0,800,30
2020-06-09,Japan,NA,Fukuoka,5110113,3,0,803,30
2020-06-10,Japan,NA,Fukuoka,5110113,2,1,805,31
2020-06-11,Japan,NA,Fukuoka,5110113,2,0,807,31
2020-06-12,Japan,NA,Fukuoka,5110113,9,1,816,32
2020-06-13,Japan,NA,Fukuoka,5110113,1,0,817,32
2020-06-14,Japan,NA,Fukuoka,5110113,3,0,820,32
2020-06-15,Japan,NA,Fukuoka,5110113,1,0,821,32
2020-06-16,Japan,NA,Fukuoka,5110113,1,0,822,32
2020-06-17,Japan,NA,Fukuoka,5110113,3,0,825,32
2020-06-18,Japan,NA,Fukuoka,5110113,3,1,828,33
2020-06-19,Japan,NA,Fukuoka,5110113,4,0,832,33
2020-06-20,Japan,NA,Fukuoka,5110113,0,0,832,33
2020-06-21,Japan,NA,Fukuoka,5110113,0,0,832,33
2020-06-22,Japan,NA,Fukuoka,5110113,0,0,832,33
2020-06-23,Japan,NA,Fukuoka,5110113,3,0,835,33
2020-06-24,Japan,NA,Fukuoka,5110113,1,0,836,33
2020-06-25,Japan,NA,Fukuoka,5110113,1,0,837,33
2020-06-26,Japan,NA,Fukuoka,5110113,0,0,837,33
2020-06-27,Japan,NA,Fukuoka,5110113,1,0,838,33
2020-06-28,Japan,NA,Fukuoka,5110113,0,0,838,33
2020-06-29,Japan,NA,Fukuoka,5110113,1,0,839,33
2020-06-30,Japan,NA,Fukuoka,5110113,4,0,843,33
2020-07-01,Japan,NA,Fukuoka,5110113,4,0,847,33
2020-07-02,Japan,NA,Fukuoka,5110113,4,0,851,33
2020-07-03,Japan,NA,Fukuoka,5110113,4,0,855,33
2020-07-04,Japan,NA,Fukuoka,5110113,6,0,861,33
2020-07-05,Japan,NA,Fukuoka,5110113,9,0,870,33
2020-07-06,Japan,NA,Fukuoka,5110113,1,0,871,33
2020-07-07,Japan,NA,Fukuoka,5110113,7,0,878,33
2020-07-08,Japan,NA,Fukuoka,5110113,13,0,891,33
2020-07-09,Japan,NA,Fukuoka,5110113,4,0,895,33
2020-07-10,Japan,NA,Fukuoka,5110113,6,0,901,33
2020-07-11,Japan,NA,Fukuoka,5110113,9,0,910,33
2020-07-12,Japan,NA,Fukuoka,5110113,5,0,915,33
2020-07-13,Japan,NA,Fukuoka,5110113,2,0,917,33
2020-07-14,Japan,NA,Fukuoka,5110113,4,0,921,33
2020-07-15,Japan,NA,Fukuoka,5110113,9,0,930,33
2020-07-16,Japan,NA,Fukuoka,5110113,16,0,946,33
2020-07-17,Japan,NA,Fukuoka,5110113,19,0,965,33
2020-07-18,Japan,NA,Fukuoka,5110113,24,0,989,33
2020-07-19,Japan,NA,Fukuoka,5110113,32,0,1021,33
2020-07-20,Japan,NA,Fukuoka,5110113,32,0,1053,33
2020-07-21,Japan,NA,Fukuoka,5110113,53,0,1106,33
2020-07-22,Japan,NA,Fukuoka,5110113,61,0,1167,33
2020-07-23,Japan,NA,Fukuoka,5110113,66,0,1233,33
2020-07-24,Japan,NA,Fukuoka,5110113,52,0,1285,33
2020-07-25,Japan,NA,Fukuoka,5110113,49,0,1334,33
2020-07-26,Japan,NA,Fukuoka,5110113,90,0,1424,33
2020-07-27,Japan,NA,Fukuoka,5110113,49,0,1473,33
2020-07-28,Japan,NA,Fukuoka,5110113,54,0,1527,33
2020-07-29,Japan,NA,Fukuoka,5110113,101,0,1628,33
2020-07-30,Japan,NA,Fukuoka,5110113,121,0,1749,33
2020-07-31,Japan,NA,Fukuoka,5110113,169,1,1918,34
2020-08-01,Japan,NA,Fukuoka,5110113,121,0,2039,34
2020-08-02,Japan,NA,Fukuoka,5110113,145,0,2184,34
2020-08-03,Japan,NA,Fukuoka,5110113,75,1,2259,35
2020-08-04,Japan,NA,Fukuoka,5110113,87,0,2346,35
2020-08-05,Japan,NA,Fukuoka,5110113,122,0,2468,35
2020-08-06,Japan,NA,Fukuoka,5110113,136,1,2604,36
2020-08-07,Japan,NA,Fukuoka,5110113,139,0,2743,36
2020-08-08,Japan,NA,Fukuoka,5110113,150,1,2893,37
2020-08-09,Japan,NA,Fukuoka,5110113,108,0,3001,37
2020-08-10,Japan,NA,Fukuoka,5110113,72,0,3073,37
2020-08-11,Japan,NA,Fukuoka,5110113,54,1,3127,38
2020-08-12,Japan,NA,Fukuoka,5110113,76,0,3203,38
2020-08-13,Japan,NA,Fukuoka,5110113,143,1,3346,39
2020-08-14,Japan,NA,Fukuoka,5110113,125,0,3471,39
2020-08-15,Japan,NA,Fukuoka,5110113,75,0,3546,39
2020-08-16,Japan,NA,Fukuoka,5110113,73,2,3619,41
2020-08-17,Japan,NA,Fukuoka,5110113,50,1,3669,42
2020-08-18,Japan,NA,Fukuoka,5110113,45,3,3714,45
2020-08-19,Japan,NA,Fukuoka,5110113,102,1,3816,46
2020-08-20,Japan,NA,Fukuoka,5110113,70,1,3886,47
2020-08-21,Japan,NA,Fukuoka,5110113,87,0,3973,47
2020-08-22,Japan,NA,Fukuoka,5110113,68,1,4041,48
2020-08-23,Japan,NA,Fukuoka,5110113,62,2,4103,50
2020-08-24,Japan,NA,Fukuoka,5110113,51,1,4154,51
2020-08-25,Japan,NA,Fukuoka,5110113,53,1,4207,52
2020-08-26,Japan,NA,Fukuoka,5110113,59,1,4266,53
2020-08-27,Japan,NA,Fukuoka,5110113,64,0,4330,53
2020-08-28,Japan,NA,Fukuoka,5110113,66,3,4396,56
2020-08-29,Japan,NA,Fukuoka,5110113,76,3,4472,59
2020-08-30,Japan,NA,Fukuoka,5110113,80,1,4552,60
2020-08-31,Japan,NA,Fukuoka,5110113,30,2,4582,62
2020-09-01,Japan,NA,Fukuoka,5110113,38,1,4620,63
2020-09-02,Japan,NA,Fukuoka,5110113,49,1,4669,64
2020-09-03,Japan,NA,Fukuoka,5110113,36,1,4705,65
2020-09-04,Japan,NA,Fukuoka,5110113,33,2,4738,67
2020-09-05,Japan,NA,Fukuoka,5110113,27,1,4765,68
2020-09-06,Japan,NA,Fukuoka,5110113,35,1,4800,69
2020-09-07,Japan,NA,Fukuoka,5110113,17,0,4817,69
2020-09-08,Japan,NA,Fukuoka,5110113,11,5,4828,74
2020-09-09,Japan,NA,Fukuoka,5110113,26,0,4854,74
2020-09-10,Japan,NA,Fukuoka,5110113,24,3,4878,77
2020-09-11,Japan,NA,Fukuoka,5110113,25,1,4903,78
2020-09-12,Japan,NA,Fukuoka,5110113,14,1,4917,79
2020-09-13,Japan,NA,Fukuoka,5110113,9,1,4926,80
2020-09-14,Japan,NA,Fukuoka,5110113,7,0,4933,80
2020-09-15,Japan,NA,Fukuoka,5110113,11,4,4944,84
2020-09-16,Japan,NA,Fukuoka,5110113,11,4,4955,88
2020-09-17,Japan,NA,Fukuoka,5110113,9,0,4964,88
2020-09-18,Japan,NA,Fukuoka,5110113,8,2,4972,90
2020-09-19,Japan,NA,Fukuoka,5110113,9,0,4981,90
2020-09-20,Japan,NA,Fukuoka,5110113,7,0,4988,90
2020-09-21,Japan,NA,Fukuoka,5110113,1,1,4989,91
2020-09-22,Japan,NA,Fukuoka,5110113,2,0,4991,91
2020-09-23,Japan,NA,Fukuoka,5110113,1,1,4992,92
2020-03-24,Japan,NA,Gifu,1991390,3,0,11,0
2020-03-25,Japan,NA,Gifu,1991390,1,0,12,0
2020-03-26,Japan,NA,Gifu,1991390,3,0,15,0
2020-03-27,Japan,NA,Gifu,1991390,2,0,17,0
2020-03-28,Japan,NA,Gifu,1991390,2,0,19,0
2020-03-29,Japan,NA,Gifu,1991390,1,0,20,0
2020-03-30,Japan,NA,Gifu,1991390,2,0,22,0
2020-03-31,Japan,NA,Gifu,1991390,4,0,26,0
2020-04-01,Japan,NA,Gifu,1991390,5,0,31,0
2020-04-02,Japan,NA,Gifu,1991390,5,0,36,0
2020-04-03,Japan,NA,Gifu,1991390,4,0,40,0
2020-04-04,Japan,NA,Gifu,1991390,7,1,47,1
2020-04-05,Japan,NA,Gifu,1991390,11,0,58,1
2020-04-06,Japan,NA,Gifu,1991390,1,0,59,1
2020-04-07,Japan,NA,Gifu,1991390,10,0,69,1
2020-04-08,Japan,NA,Gifu,1991390,8,0,77,1
2020-04-09,Japan,NA,Gifu,1991390,9,0,86,1
2020-04-10,Japan,NA,Gifu,1991390,11,0,97,1
2020-04-11,Japan,NA,Gifu,1991390,9,0,106,1
2020-04-12,Japan,NA,Gifu,1991390,6,0,112,1
2020-04-13,Japan,NA,Gifu,1991390,7,0,119,1
2020-04-14,Japan,NA,Gifu,1991390,8,0,127,1
2020-04-15,Japan,NA,Gifu,1991390,3,0,130,1
2020-04-16,Japan,NA,Gifu,1991390,5,0,135,1
2020-04-17,Japan,NA,Gifu,1991390,1,1,136,2
2020-04-18,Japan,NA,Gifu,1991390,1,0,137,2
2020-04-19,Japan,NA,Gifu,1991390,2,1,139,3
2020-04-20,Japan,NA,Gifu,1991390,0,1,139,4
2020-04-21,Japan,NA,Gifu,1991390,5,1,144,5
2020-04-22,Japan,NA,Gifu,1991390,3,1,147,6
2020-04-23,Japan,NA,Gifu,1991390,2,0,149,6
2020-04-24,Japan,NA,Gifu,1991390,0,0,149,6
2020-04-25,Japan,NA,Gifu,1991390,0,0,149,6
2020-04-26,Japan,NA,Gifu,1991390,0,0,149,6
2020-04-27,Japan,NA,Gifu,1991390,0,0,149,6
2020-04-28,Japan,NA,Gifu,1991390,0,0,149,6
2020-04-29,Japan,NA,Gifu,1991390,0,0,149,6
2020-04-30,Japan,NA,Gifu,1991390,0,0,149,6
2020-05-01,Japan,NA,Gifu,1991390,0,0,149,6
2020-05-02,Japan,NA,Gifu,1991390,1,0,150,6
2020-05-03,Japan,NA,Gifu,1991390,0,0,150,6
2020-05-04,Japan,NA,Gifu,1991390,0,0,150,6
2020-05-05,Japan,NA,Gifu,1991390,0,0,150,6
2020-05-06,Japan,NA,Gifu,1991390,0,0,150,6
2020-05-07,Japan,NA,Gifu,1991390,0,0,150,6
2020-05-08,Japan,NA,Gifu,1991390,0,0,150,6
2020-05-09,Japan,NA,Gifu,1991390,0,0,150,6
2020-05-10,Japan,NA,Gifu,1991390,0,0,150,6
2020-05-11,Japan,NA,Gifu,1991390,0,0,150,6
2020-05-12,Japan,NA,Gifu,1991390,0,0,150,6
2020-05-13,Japan,NA,Gifu,1991390,0,0,150,6
2020-05-14,Japan,NA,Gifu,1991390,0,1,150,7
2020-05-15,Japan,NA,Gifu,1991390,0,0,150,7
2020-05-16,Japan,NA,Gifu,1991390,0,0,150,7
2020-05-17,Japan,NA,Gifu,1991390,0,0,150,7
2020-05-18,Japan,NA,Gifu,1991390,0,0,150,7
2020-05-19,Japan,NA,Gifu,1991390,0,0,150,7
2020-05-20,Japan,NA,Gifu,1991390,0,0,150,7
2020-05-21,Japan,NA,Gifu,1991390,0,0,150,7
2020-05-22,Japan,NA,Gifu,1991390,0,0,150,7
2020-05-23,Japan,NA,Gifu,1991390,0,0,150,7
2020-05-24,Japan,NA,Gifu,1991390,0,0,150,7
2020-05-25,Japan,NA,Gifu,1991390,0,0,150,7
2020-05-26,Japan,NA,Gifu,1991390,0,0,150,7
2020-05-27,Japan,NA,Gifu,1991390,0,0,150,7
2020-05-28,Japan,NA,Gifu,1991390,0,0,150,7
2020-05-29,Japan,NA,Gifu,1991390,0,0,150,7
2020-05-30,Japan,NA,Gifu,1991390,0,0,150,7
2020-05-31,Japan,NA,Gifu,1991390,0,0,150,7
2020-06-01,Japan,NA,Gifu,1991390,1,0,151,7
2020-06-02,Japan,NA,Gifu,1991390,0,0,151,7
2020-06-03,Japan,NA,Gifu,1991390,0,0,151,7
2020-06-04,Japan,NA,Gifu,1991390,0,0,151,7
2020-06-05,Japan,NA,Gifu,1991390,0,0,151,7
2020-06-06,Japan,NA,Gifu,1991390,0,0,151,7
2020-06-07,Japan,NA,Gifu,1991390,0,0,151,7
2020-06-08,Japan,NA,Gifu,1991390,1,0,152,7
2020-06-09,Japan,NA,Gifu,1991390,1,0,153,7
2020-06-10,Japan,NA,Gifu,1991390,0,0,153,7
2020-06-11,Japan,NA,Gifu,1991390,0,0,153,7
2020-06-12,Japan,NA,Gifu,1991390,0,0,153,7
2020-06-13,Japan,NA,Gifu,1991390,0,0,153,7
2020-06-14,Japan,NA,Gifu,1991390,0,0,153,7
2020-06-15,Japan,NA,Gifu,1991390,1,0,154,7
2020-06-16,Japan,NA,Gifu,1991390,0,0,154,7
2020-06-17,Japan,NA,Gifu,1991390,1,0,155,7
2020-06-18,Japan,NA,Gifu,1991390,0,0,155,7
2020-06-19,Japan,NA,Gifu,1991390,0,0,155,7
2020-06-20,Japan,NA,Gifu,1991390,1,0,156,7
2020-06-21,Japan,NA,Gifu,1991390,0,0,156,7
2020-06-22,Japan,NA,Gifu,1991390,0,0,156,7
2020-06-23,Japan,NA,Gifu,1991390,0,0,156,7
2020-06-24,Japan,NA,Gifu,1991390,0,0,156,7
2020-06-25,Japan,NA,Gifu,1991390,0,0,156,7
2020-06-26,Japan,NA,Gifu,1991390,0,0,156,7
2020-06-27,Japan,NA,Gifu,1991390,0,0,156,7
2020-06-28,Japan,NA,Gifu,1991390,0,0,156,7
2020-06-29,Japan,NA,Gifu,1991390,0,0,156,7
2020-06-30,Japan,NA,Gifu,1991390,0,0,156,7
2020-07-01,Japan,NA,Gifu,1991390,1,0,157,7
2020-07-02,Japan,NA,Gifu,1991390,3,0,160,7
2020-07-03,Japan,NA,Gifu,1991390,0,0,160,7
2020-07-04,Japan,NA,Gifu,1991390,0,0,160,7
2020-07-05,Japan,NA,Gifu,1991390,0,0,160,7
2020-07-06,Japan,NA,Gifu,1991390,0,0,160,7
2020-07-07,Japan,NA,Gifu,1991390,0,0,160,7
2020-07-08,Japan,NA,Gifu,1991390,0,0,160,7
2020-07-09,Japan,NA,Gifu,1991390,2,0,162,7
2020-07-10,Japan,NA,Gifu,1991390,0,0,162,7
2020-07-11,Japan,NA,Gifu,1991390,0,0,162,7
2020-07-12,Japan,NA,Gifu,1991390,0,0,162,7
2020-07-13,Japan,NA,Gifu,1991390,0,0,162,7
2020-07-14,Japan,NA,Gifu,1991390,3,0,165,7
2020-07-15,Japan,NA,Gifu,1991390,1,0,166,7
2020-07-16,Japan,NA,Gifu,1991390,2,0,168,7
2020-07-17,Japan,NA,Gifu,1991390,4,0,172,7
2020-07-18,Japan,NA,Gifu,1991390,1,0,173,7
2020-07-19,Japan,NA,Gifu,1991390,4,0,177,7
2020-07-20,Japan,NA,Gifu,1991390,3,0,180,7
2020-07-21,Japan,NA,Gifu,1991390,14,0,194,7
2020-07-22,Japan,NA,Gifu,1991390,6,0,200,7
2020-07-23,Japan,NA,Gifu,1991390,8,0,208,7
2020-07-24,Japan,NA,Gifu,1991390,8,0,216,7
2020-07-25,Japan,NA,Gifu,1991390,4,0,220,7
2020-07-26,Japan,NA,Gifu,1991390,11,0,231,7
2020-07-27,Japan,NA,Gifu,1991390,9,0,240,7
2020-07-28,Japan,NA,Gifu,1991390,25,0,265,7
2020-07-29,Japan,NA,Gifu,1991390,30,0,295,7
2020-07-30,Japan,NA,Gifu,1991390,17,0,312,7
2020-07-31,Japan,NA,Gifu,1991390,19,0,331,7
2020-08-01,Japan,NA,Gifu,1991390,13,0,344,7
2020-08-02,Japan,NA,Gifu,1991390,7,0,351,7
2020-08-03,Japan,NA,Gifu,1991390,11,0,362,7
2020-08-04,Japan,NA,Gifu,1991390,17,0,379,7
2020-08-05,Japan,NA,Gifu,1991390,21,0,400,7
2020-08-06,Japan,NA,Gifu,1991390,20,0,420,7
2020-08-07,Japan,NA,Gifu,1991390,15,0,435,7
2020-08-08,Japan,NA,Gifu,1991390,15,0,450,7
2020-08-09,Japan,NA,Gifu,1991390,15,0,465,7
2020-08-10,Japan,NA,Gifu,1991390,7,0,472,7
2020-08-11,Japan,NA,Gifu,1991390,3,0,475,7
2020-08-12,Japan,NA,Gifu,1991390,9,0,484,7
2020-08-13,Japan,NA,Gifu,1991390,8,0,492,7
2020-08-14,Japan,NA,Gifu,1991390,8,0,500,7
2020-08-15,Japan,NA,Gifu,1991390,11,0,511,7
2020-08-16,Japan,NA,Gifu,1991390,1,0,512,7
2020-08-17,Japan,NA,Gifu,1991390,4,1,516,8
2020-08-18,Japan,NA,Gifu,1991390,4,0,520,8
2020-08-19,Japan,NA,Gifu,1991390,3,0,523,8
2020-08-20,Japan,NA,Gifu,1991390,9,0,532,8
2020-08-21,Japan,NA,Gifu,1991390,1,1,533,9
2020-08-22,Japan,NA,Gifu,1991390,5,0,538,9
2020-08-23,Japan,NA,Gifu,1991390,1,0,539,9
2020-08-24,Japan,NA,Gifu,1991390,4,0,543,9
2020-08-25,Japan,NA,Gifu,1991390,5,0,548,9
2020-08-26,Japan,NA,Gifu,1991390,1,0,549,9
2020-08-27,Japan,NA,Gifu,1991390,2,0,551,9
2020-08-28,Japan,NA,Gifu,1991390,0,0,551,9
2020-08-29,Japan,NA,Gifu,1991390,4,1,555,10
2020-08-30,Japan,NA,Gifu,1991390,0,0,555,10
2020-08-31,Japan,NA,Gifu,1991390,0,0,555,10
2020-09-01,Japan,NA,Gifu,1991390,3,0,558,10
2020-09-02,Japan,NA,Gifu,1991390,4,0,562,10
2020-09-03,Japan,NA,Gifu,1991390,1,0,563,10
2020-09-04,Japan,NA,Gifu,1991390,1,0,564,10
2020-09-05,Japan,NA,Gifu,1991390,0,0,564,10
2020-09-06,Japan,NA,Gifu,1991390,0,0,564,10
2020-09-07,Japan,NA,Gifu,1991390,0,0,564,10
2020-09-08,Japan,NA,Gifu,1991390,2,0,566,10
2020-09-09,Japan,NA,Gifu,1991390,2,0,568,10
2020-09-10,Japan,NA,Gifu,1991390,1,0,569,10
2020-09-11,Japan,NA,Gifu,1991390,5,0,574,10
2020-09-12,Japan,NA,Gifu,1991390,6,0,580,10
2020-09-13,Japan,NA,Gifu,1991390,12,0,592,10
2020-09-14,Japan,NA,Gifu,1991390,2,0,594,10
2020-09-15,Japan,NA,Gifu,1991390,2,0,596,10
2020-09-16,Japan,NA,Gifu,1991390,0,0,596,10
2020-09-17,Japan,NA,Gifu,1991390,0,0,596,10
2020-09-18,Japan,NA,Gifu,1991390,0,0,596,10
2020-09-19,Japan,NA,Gifu,1991390,1,0,597,10
2020-09-20,Japan,NA,Gifu,1991390,0,0,597,10
2020-09-21,Japan,NA,Gifu,1991390,2,0,599,10
2020-09-22,Japan,NA,Gifu,1991390,1,0,600,10
2020-09-23,Japan,NA,Gifu,1991390,3,0,603,10
2020-03-20,Japan,NA,Gunma,1937626,1,0,11,0
2020-03-21,Japan,NA,Gunma,1937626,0,0,11,0
2020-03-22,Japan,NA,Gunma,1937626,0,1,11,1
2020-03-23,Japan,NA,Gunma,1937626,0,0,11,1
2020-03-24,Japan,NA,Gunma,1937626,2,0,13,1
2020-03-25,Japan,NA,Gunma,1937626,1,0,14,1
2020-03-26,Japan,NA,Gunma,1937626,0,0,14,1
2020-03-27,Japan,NA,Gunma,1937626,0,0,14,1
2020-03-28,Japan,NA,Gunma,1937626,4,0,18,1
2020-03-29,Japan,NA,Gunma,1937626,0,0,18,1
2020-03-30,Japan,NA,Gunma,1937626,0,0,18,1
2020-03-31,Japan,NA,Gunma,1937626,1,0,19,1
2020-04-01,Japan,NA,Gunma,1937626,1,0,20,1
2020-04-02,Japan,NA,Gunma,1937626,1,0,21,1
2020-04-03,Japan,NA,Gunma,1937626,4,0,25,1
2020-04-04,Japan,NA,Gunma,1937626,1,0,26,1
2020-04-05,Japan,NA,Gunma,1937626,0,0,26,1
2020-04-06,Japan,NA,Gunma,1937626,0,0,26,1
2020-04-07,Japan,NA,Gunma,1937626,3,0,29,1
2020-04-08,Japan,NA,Gunma,1937626,0,0,29,1
2020-04-09,Japan,NA,Gunma,1937626,4,0,33,1
2020-04-10,Japan,NA,Gunma,1937626,11,0,44,1
2020-04-11,Japan,NA,Gunma,1937626,35,1,79,2
2020-04-12,Japan,NA,Gunma,1937626,11,0,90,2
2020-04-13,Japan,NA,Gunma,1937626,0,0,90,2
2020-04-14,Japan,NA,Gunma,1937626,6,2,96,4
2020-04-15,Japan,NA,Gunma,1937626,10,0,106,4
2020-04-16,Japan,NA,Gunma,1937626,6,0,112,4
2020-04-17,Japan,NA,Gunma,1937626,2,0,114,4
2020-04-18,Japan,NA,Gunma,1937626,6,1,120,5
2020-04-19,Japan,NA,Gunma,1937626,2,1,122,6
2020-04-20,Japan,NA,Gunma,1937626,2,2,124,8
2020-04-21,Japan,NA,Gunma,1937626,7,1,131,9
2020-04-22,Japan,NA,Gunma,1937626,3,0,134,9
2020-04-23,Japan,NA,Gunma,1937626,4,2,138,11
2020-04-24,Japan,NA,Gunma,1937626,2,1,140,12
2020-04-25,Japan,NA,Gunma,1937626,0,0,140,12
2020-04-26,Japan,NA,Gunma,1937626,1,2,141,14
2020-04-27,Japan,NA,Gunma,1937626,5,1,146,15
2020-04-28,Japan,NA,Gunma,1937626,0,0,146,15
2020-04-29,Japan,NA,Gunma,1937626,0,0,146,15
2020-04-30,Japan,NA,Gunma,1937626,0,1,146,16
2020-05-01,Japan,NA,Gunma,1937626,0,0,146,16
2020-05-02,Japan,NA,Gunma,1937626,0,0,146,16
2020-05-03,Japan,NA,Gunma,1937626,0,0,146,16
2020-05-04,Japan,NA,Gunma,1937626,0,0,146,16
2020-05-05,Japan,NA,Gunma,1937626,0,0,146,16
2020-05-06,Japan,NA,Gunma,1937626,1,2,147,18
2020-05-07,Japan,NA,Gunma,1937626,0,0,147,18
2020-05-08,Japan,NA,Gunma,1937626,0,0,147,18
2020-05-09,Japan,NA,Gunma,1937626,0,0,147,18
2020-05-10,Japan,NA,Gunma,1937626,0,0,147,18
2020-05-11,Japan,NA,Gunma,1937626,0,0,147,18
2020-05-12,Japan,NA,Gunma,1937626,0,0,147,18
2020-05-13,Japan,NA,Gunma,1937626,0,0,147,18
2020-05-14,Japan,NA,Gunma,1937626,0,0,147,18
2020-05-15,Japan,NA,Gunma,1937626,0,0,147,18
2020-05-16,Japan,NA,Gunma,1937626,0,0,147,18
2020-05-17,Japan,NA,Gunma,1937626,0,0,147,18
2020-05-18,Japan,NA,Gunma,1937626,0,0,147,18
2020-05-19,Japan,NA,Gunma,1937626,1,0,148,18
2020-05-20,Japan,NA,Gunma,1937626,0,1,148,19
2020-05-21,Japan,NA,Gunma,1937626,0,0,148,19
2020-05-22,Japan,NA,Gunma,1937626,1,0,149,19
2020-05-23,Japan,NA,Gunma,1937626,0,0,149,19
2020-05-24,Japan,NA,Gunma,1937626,0,0,149,19
2020-05-25,Japan,NA,Gunma,1937626,0,0,149,19
2020-05-26,Japan,NA,Gunma,1937626,0,0,149,19
2020-05-27,Japan,NA,Gunma,1937626,0,0,149,19
2020-05-28,Japan,NA,Gunma,1937626,0,0,149,19
2020-05-29,Japan,NA,Gunma,1937626,0,0,149,19
2020-05-30,Japan,NA,Gunma,1937626,0,0,149,19
2020-05-31,Japan,NA,Gunma,1937626,0,0,149,19
2020-06-01,Japan,NA,Gunma,1937626,0,0,149,19
2020-06-02,Japan,NA,Gunma,1937626,0,0,149,19
2020-06-03,Japan,NA,Gunma,1937626,0,0,149,19
2020-06-04,Japan,NA,Gunma,1937626,0,0,149,19
2020-06-05,Japan,NA,Gunma,1937626,2,0,151,19
2020-06-06,Japan,NA,Gunma,1937626,0,0,151,19
2020-06-07,Japan,NA,Gunma,1937626,0,0,151,19
2020-06-08,Japan,NA,Gunma,1937626,0,0,151,19
2020-06-09,Japan,NA,Gunma,1937626,0,0,151,19
2020-06-10,Japan,NA,Gunma,1937626,0,0,151,19
2020-06-11,Japan,NA,Gunma,1937626,0,0,151,19
2020-06-12,Japan,NA,Gunma,1937626,0,0,151,19
2020-06-13,Japan,NA,Gunma,1937626,0,0,151,19
2020-06-14,Japan,NA,Gunma,1937626,0,0,151,19
2020-06-15,Japan,NA,Gunma,1937626,0,0,151,19
2020-06-16,Japan,NA,Gunma,1937626,0,0,151,19
2020-06-17,Japan,NA,Gunma,1937626,0,0,151,19
2020-06-18,Japan,NA,Gunma,1937626,0,0,151,19
2020-06-19,Japan,NA,Gunma,1937626,0,0,151,19
2020-06-20,Japan,NA,Gunma,1937626,0,0,151,19
2020-06-21,Japan,NA,Gunma,1937626,0,0,151,19
2020-06-22,Japan,NA,Gunma,1937626,0,0,151,19
2020-06-23,Japan,NA,Gunma,1937626,0,0,151,19
2020-06-24,Japan,NA,Gunma,1937626,1,0,152,19
2020-06-25,Japan,NA,Gunma,1937626,0,0,152,19
2020-06-26,Japan,NA,Gunma,1937626,0,0,152,19
2020-06-27,Japan,NA,Gunma,1937626,0,0,152,19
2020-06-28,Japan,NA,Gunma,1937626,0,0,152,19
2020-06-29,Japan,NA,Gunma,1937626,0,0,152,19
2020-06-30,Japan,NA,Gunma,1937626,1,0,153,19
2020-07-01,Japan,NA,Gunma,1937626,0,0,153,19
2020-07-02,Japan,NA,Gunma,1937626,0,0,153,19
2020-07-03,Japan,NA,Gunma,1937626,1,0,154,19
2020-07-04,Japan,NA,Gunma,1937626,1,0,155,19
2020-07-05,Japan,NA,Gunma,1937626,0,0,155,19
2020-07-06,Japan,NA,Gunma,1937626,0,0,155,19
2020-07-07,Japan,NA,Gunma,1937626,0,0,155,19
2020-07-08,Japan,NA,Gunma,1937626,0,0,155,19
2020-07-09,Japan,NA,Gunma,1937626,0,0,155,19
2020-07-10,Japan,NA,Gunma,1937626,0,0,155,19
2020-07-11,Japan,NA,Gunma,1937626,0,0,155,19
2020-07-12,Japan,NA,Gunma,1937626,0,0,155,19
2020-07-13,Japan,NA,Gunma,1937626,2,0,157,19
2020-07-14,Japan,NA,Gunma,1937626,0,0,157,19
2020-07-15,Japan,NA,Gunma,1937626,4,0,161,19
2020-07-16,Japan,NA,Gunma,1937626,3,0,164,19
2020-07-17,Japan,NA,Gunma,1937626,2,0,166,19
2020-07-18,Japan,NA,Gunma,1937626,1,0,167,19
2020-07-19,Japan,NA,Gunma,1937626,0,0,167,19
2020-07-20,Japan,NA,Gunma,1937626,0,0,167,19
2020-07-21,Japan,NA,Gunma,1937626,2,0,169,19
2020-07-22,Japan,NA,Gunma,1937626,5,0,174,19
2020-07-23,Japan,NA,Gunma,1937626,3,0,177,19
2020-07-24,Japan,NA,Gunma,1937626,0,0,177,19
2020-07-25,Japan,NA,Gunma,1937626,2,0,179,19
2020-07-26,Japan,NA,Gunma,1937626,0,0,179,19
2020-07-27,Japan,NA,Gunma,1937626,0,0,179,19
2020-07-28,Japan,NA,Gunma,1937626,3,0,182,19
2020-07-29,Japan,NA,Gunma,1937626,1,0,183,19
2020-07-30,Japan,NA,Gunma,1937626,4,0,187,19
2020-07-31,Japan,NA,Gunma,1937626,3,0,190,19
2020-08-01,Japan,NA,Gunma,1937626,1,0,191,19
2020-08-02,Japan,NA,Gunma,1937626,1,0,192,19
2020-08-03,Japan,NA,Gunma,1937626,2,0,194,19
2020-08-04,Japan,NA,Gunma,1937626,3,0,197,19
2020-08-05,Japan,NA,Gunma,1937626,5,0,202,19
2020-08-06,Japan,NA,Gunma,1937626,6,0,208,19
2020-08-07,Japan,NA,Gunma,1937626,6,0,214,19
2020-08-08,Japan,NA,Gunma,1937626,7,0,221,19
2020-08-09,Japan,NA,Gunma,1937626,5,0,226,19
2020-08-10,Japan,NA,Gunma,1937626,8,0,234,19
2020-08-11,Japan,NA,Gunma,1937626,4,0,238,19
2020-08-12,Japan,NA,Gunma,1937626,7,0,245,19
2020-08-13,Japan,NA,Gunma,1937626,9,0,254,19
2020-08-14,Japan,NA,Gunma,1937626,16,0,270,19
2020-08-15,Japan,NA,Gunma,1937626,9,0,279,19
2020-08-16,Japan,NA,Gunma,1937626,19,0,298,19
2020-08-17,Japan,NA,Gunma,1937626,9,0,307,19
2020-08-18,Japan,NA,Gunma,1937626,15,0,322,19
2020-08-19,Japan,NA,Gunma,1937626,15,0,337,19
2020-08-20,Japan,NA,Gunma,1937626,14,0,351,19
2020-08-21,Japan,NA,Gunma,1937626,10,0,361,19
2020-08-22,Japan,NA,Gunma,1937626,13,0,374,19
2020-08-23,Japan,NA,Gunma,1937626,6,0,380,19
2020-08-24,Japan,NA,Gunma,1937626,4,0,384,19
2020-08-25,Japan,NA,Gunma,1937626,8,0,392,19
2020-08-26,Japan,NA,Gunma,1937626,16,0,408,19
2020-08-27,Japan,NA,Gunma,1937626,18,0,426,19
2020-08-28,Japan,NA,Gunma,1937626,6,0,432,19
2020-08-29,Japan,NA,Gunma,1937626,2,0,434,19
2020-08-30,Japan,NA,Gunma,1937626,3,0,437,19
2020-08-31,Japan,NA,Gunma,1937626,3,0,440,19
2020-09-01,Japan,NA,Gunma,1937626,5,0,445,19
2020-09-02,Japan,NA,Gunma,1937626,6,0,451,19
2020-09-03,Japan,NA,Gunma,1937626,12,0,463,19
2020-09-04,Japan,NA,Gunma,1937626,8,0,471,19
2020-09-05,Japan,NA,Gunma,1937626,3,0,474,19
2020-09-06,Japan,NA,Gunma,1937626,8,0,482,19
2020-09-07,Japan,NA,Gunma,1937626,9,0,491,19
2020-09-08,Japan,NA,Gunma,1937626,5,0,496,19
2020-09-09,Japan,NA,Gunma,1937626,5,0,501,19
2020-09-10,Japan,NA,Gunma,1937626,4,0,505,19
2020-09-11,Japan,NA,Gunma,1937626,12,0,517,19
2020-09-12,Japan,NA,Gunma,1937626,24,0,541,19
2020-09-13,Japan,NA,Gunma,1937626,6,0,547,19
2020-09-14,Japan,NA,Gunma,1937626,6,0,553,19
2020-09-15,Japan,NA,Gunma,1937626,14,0,567,19
2020-09-16,Japan,NA,Gunma,1937626,24,0,591,19
2020-09-17,Japan,NA,Gunma,1937626,11,0,602,19
2020-09-18,Japan,NA,Gunma,1937626,27,0,629,19
2020-09-19,Japan,NA,Gunma,1937626,15,0,644,19
2020-09-20,Japan,NA,Gunma,1937626,19,0,663,19
2020-09-21,Japan,NA,Gunma,1937626,7,0,670,19
2020-09-22,Japan,NA,Gunma,1937626,13,0,683,19
2020-09-23,Japan,NA,Gunma,1937626,1,0,684,19
2020-02-22,Japan,NA,Hokkaido,5273681,9,0,17,0
2020-02-23,Japan,NA,Hokkaido,5273681,9,0,26,0
2020-02-24,Japan,NA,Hokkaido,5273681,4,0,30,0
2020-02-25,Japan,NA,Hokkaido,5273681,5,0,35,0
2020-02-26,Japan,NA,Hokkaido,5273681,4,1,39,1
2020-02-27,Japan,NA,Hokkaido,5273681,15,1,54,2
2020-02-28,Japan,NA,Hokkaido,5273681,12,0,66,2
2020-02-29,Japan,NA,Hokkaido,5273681,4,0,70,2
2020-03-01,Japan,NA,Hokkaido,5273681,2,1,72,3
2020-03-02,Japan,NA,Hokkaido,5273681,5,0,77,3
2020-03-03,Japan,NA,Hokkaido,5273681,2,0,79,3
2020-03-04,Japan,NA,Hokkaido,5273681,3,0,82,3
2020-03-05,Japan,NA,Hokkaido,5273681,1,0,83,3
2020-03-06,Japan,NA,Hokkaido,5273681,7,0,90,3
2020-03-07,Japan,NA,Hokkaido,5273681,8,0,98,3
2020-03-08,Japan,NA,Hokkaido,5273681,3,0,101,3
2020-03-09,Japan,NA,Hokkaido,5273681,7,0,108,3
2020-03-10,Japan,NA,Hokkaido,5273681,3,0,111,3
2020-03-11,Japan,NA,Hokkaido,5273681,7,0,118,3
2020-03-12,Japan,NA,Hokkaido,5273681,10,1,128,4
2020-03-13,Japan,NA,Hokkaido,5273681,9,0,137,4
2020-03-14,Japan,NA,Hokkaido,5273681,7,0,144,4
2020-03-15,Japan,NA,Hokkaido,5273681,4,1,148,5
2020-03-16,Japan,NA,Hokkaido,5273681,4,1,152,6
2020-03-17,Japan,NA,Hokkaido,5273681,0,0,152,6
2020-03-18,Japan,NA,Hokkaido,5273681,2,0,154,6
2020-03-19,Japan,NA,Hokkaido,5273681,3,0,157,6
2020-03-20,Japan,NA,Hokkaido,5273681,1,0,158,6
2020-03-21,Japan,NA,Hokkaido,5273681,1,0,159,6
2020-03-22,Japan,NA,Hokkaido,5273681,3,0,162,6
2020-03-23,Japan,NA,Hokkaido,5273681,0,0,162,6
2020-03-24,Japan,NA,Hokkaido,5273681,1,0,163,6
2020-03-25,Japan,NA,Hokkaido,5273681,4,1,167,7
2020-03-26,Japan,NA,Hokkaido,5273681,1,0,168,7
2020-03-27,Japan,NA,Hokkaido,5273681,1,0,169,7
2020-03-28,Japan,NA,Hokkaido,5273681,2,0,171,7
2020-03-29,Japan,NA,Hokkaido,5273681,4,0,175,7
2020-03-30,Japan,NA,Hokkaido,5273681,1,0,176,7
2020-03-31,Japan,NA,Hokkaido,5273681,0,0,176,7
2020-04-01,Japan,NA,Hokkaido,5273681,4,0,180,7
2020-04-02,Japan,NA,Hokkaido,5273681,3,1,183,8
2020-04-03,Japan,NA,Hokkaido,5273681,5,0,188,8
2020-04-04,Japan,NA,Hokkaido,5273681,3,0,191,8
2020-04-05,Japan,NA,Hokkaido,5273681,0,0,191,8
2020-04-06,Japan,NA,Hokkaido,5273681,0,1,191,9
2020-04-07,Japan,NA,Hokkaido,5273681,4,0,195,9
2020-04-08,Japan,NA,Hokkaido,5273681,10,0,205,9
2020-04-09,Japan,NA,Hokkaido,5273681,18,1,223,10
2020-04-10,Japan,NA,Hokkaido,5273681,13,0,236,10
2020-04-11,Japan,NA,Hokkaido,5273681,16,0,252,10
2020-04-12,Japan,NA,Hokkaido,5273681,12,1,264,11
2020-04-13,Japan,NA,Hokkaido,5273681,5,0,269,11
2020-04-14,Japan,NA,Hokkaido,5273681,18,2,287,13
2020-04-15,Japan,NA,Hokkaido,5273681,23,1,310,14
2020-04-16,Japan,NA,Hokkaido,5273681,22,0,332,14
2020-04-17,Japan,NA,Hokkaido,5273681,32,2,364,16
2020-04-18,Japan,NA,Hokkaido,5273681,38,2,402,18
2020-04-19,Japan,NA,Hokkaido,5273681,27,0,429,18
2020-04-20,Japan,NA,Hokkaido,5273681,17,3,446,21
2020-04-21,Japan,NA,Hokkaido,5273681,22,2,468,23
2020-04-22,Japan,NA,Hokkaido,5273681,22,2,490,25
2020-04-23,Japan,NA,Hokkaido,5273681,45,0,535,25
2020-04-24,Japan,NA,Hokkaido,5273681,22,0,557,25
2020-04-25,Japan,NA,Hokkaido,5273681,39,0,596,25
2020-04-26,Japan,NA,Hokkaido,5273681,14,0,610,25
2020-04-27,Japan,NA,Hokkaido,5273681,35,1,645,26
2020-04-28,Japan,NA,Hokkaido,5273681,38,1,683,27
2020-04-29,Japan,NA,Hokkaido,5273681,38,0,721,27
2020-04-30,Japan,NA,Hokkaido,5273681,41,2,762,29
2020-05-01,Japan,NA,Hokkaido,5273681,23,8,785,37
2020-05-02,Japan,NA,Hokkaido,5273681,33,3,818,40
2020-05-03,Japan,NA,Hokkaido,5273681,25,1,843,41
2020-05-04,Japan,NA,Hokkaido,5273681,31,2,874,43
2020-05-05,Japan,NA,Hokkaido,5273681,11,2,885,45
2020-05-06,Japan,NA,Hokkaido,5273681,22,1,907,46
2020-05-07,Japan,NA,Hokkaido,5273681,14,1,921,47
2020-05-08,Japan,NA,Hokkaido,5273681,6,1,927,48
2020-05-09,Japan,NA,Hokkaido,5273681,11,3,938,51
2020-05-10,Japan,NA,Hokkaido,5273681,9,5,947,56
2020-05-11,Japan,NA,Hokkaido,5273681,10,6,957,62
2020-05-12,Japan,NA,Hokkaido,5273681,13,6,970,68
2020-05-13,Japan,NA,Hokkaido,5273681,4,2,974,70
2020-05-14,Japan,NA,Hokkaido,5273681,6,2,980,72
2020-05-15,Japan,NA,Hokkaido,5273681,8,1,988,73
2020-05-16,Japan,NA,Hokkaido,5273681,7,1,995,74
2020-05-17,Japan,NA,Hokkaido,5273681,7,1,1002,75
2020-05-18,Japan,NA,Hokkaido,5273681,1,1,1003,76
2020-05-19,Japan,NA,Hokkaido,5273681,3,1,1006,77
2020-05-20,Japan,NA,Hokkaido,5273681,1,0,1007,77
2020-05-21,Japan,NA,Hokkaido,5273681,5,1,1012,78
2020-05-22,Japan,NA,Hokkaido,5273681,5,0,1017,78
2020-05-23,Japan,NA,Hokkaido,5273681,8,1,1025,79
2020-05-24,Japan,NA,Hokkaido,5273681,15,2,1040,81
2020-05-25,Japan,NA,Hokkaido,5273681,3,2,1043,83
2020-05-26,Japan,NA,Hokkaido,5273681,9,1,1052,84
2020-05-27,Japan,NA,Hokkaido,5273681,5,1,1057,85
2020-05-28,Japan,NA,Hokkaido,5273681,6,1,1063,86
2020-05-29,Japan,NA,Hokkaido,5273681,3,0,1066,86
2020-05-30,Japan,NA,Hokkaido,5273681,4,0,1070,86
2020-05-31,Japan,NA,Hokkaido,5273681,4,0,1074,86
2020-06-01,Japan,NA,Hokkaido,5273681,5,1,1079,87
2020-06-02,Japan,NA,Hokkaido,5273681,3,0,1082,87
2020-06-03,Japan,NA,Hokkaido,5273681,3,1,1085,88
2020-06-04,Japan,NA,Hokkaido,5273681,3,2,1088,90
2020-06-05,Japan,NA,Hokkaido,5273681,4,0,1092,90
2020-06-06,Japan,NA,Hokkaido,5273681,8,0,1100,90
2020-06-07,Japan,NA,Hokkaido,5273681,4,0,1104,90
2020-06-08,Japan,NA,Hokkaido,5273681,4,1,1108,91
2020-06-09,Japan,NA,Hokkaido,5273681,7,0,1115,91
2020-06-10,Japan,NA,Hokkaido,5273681,5,0,1120,91
2020-06-11,Japan,NA,Hokkaido,5273681,7,0,1127,91
2020-06-12,Japan,NA,Hokkaido,5273681,10,0,1137,91
2020-06-13,Japan,NA,Hokkaido,5273681,9,0,1146,91
2020-06-14,Japan,NA,Hokkaido,5273681,7,0,1153,91
2020-06-15,Japan,NA,Hokkaido,5273681,6,0,1159,91
2020-06-16,Japan,NA,Hokkaido,5273681,2,1,1161,92
2020-06-17,Japan,NA,Hokkaido,5273681,6,0,1167,92
2020-06-18,Japan,NA,Hokkaido,5273681,5,1,1172,93
2020-06-19,Japan,NA,Hokkaido,5273681,3,1,1175,94
2020-06-20,Japan,NA,Hokkaido,5273681,3,0,1178,94
2020-06-21,Japan,NA,Hokkaido,5273681,2,1,1180,95
2020-06-22,Japan,NA,Hokkaido,5273681,2,0,1182,95
2020-06-23,Japan,NA,Hokkaido,5273681,1,2,1183,97
2020-06-24,Japan,NA,Hokkaido,5273681,10,1,1193,98
2020-06-25,Japan,NA,Hokkaido,5273681,6,0,1199,98
2020-06-26,Japan,NA,Hokkaido,5273681,5,0,1204,98
2020-06-27,Japan,NA,Hokkaido,5273681,1,1,1205,99
2020-06-28,Japan,NA,Hokkaido,5273681,17,0,1222,99
2020-06-29,Japan,NA,Hokkaido,5273681,11,0,1233,99
2020-06-30,Japan,NA,Hokkaido,5273681,13,0,1246,99
2020-07-01,Japan,NA,Hokkaido,5273681,4,1,1250,100
2020-07-02,Japan,NA,Hokkaido,5273681,8,1,1258,101
2020-07-03,Japan,NA,Hokkaido,5273681,0,0,1258,101
2020-07-04,Japan,NA,Hokkaido,5273681,1,0,1259,101
2020-07-05,Japan,NA,Hokkaido,5273681,1,0,1260,101
2020-07-06,Japan,NA,Hokkaido,5273681,0,0,1260,101
2020-07-07,Japan,NA,Hokkaido,5273681,1,0,1261,101
2020-07-08,Japan,NA,Hokkaido,5273681,4,0,1265,101
2020-07-09,Japan,NA,Hokkaido,5273681,1,0,1266,101
2020-07-10,Japan,NA,Hokkaido,5273681,6,0,1272,101
2020-07-11,Japan,NA,Hokkaido,5273681,1,0,1273,101
2020-07-12,Japan,NA,Hokkaido,5273681,4,0,1277,101
2020-07-13,Japan,NA,Hokkaido,5273681,2,1,1279,102
2020-07-14,Japan,NA,Hokkaido,5273681,8,0,1287,102
2020-07-15,Japan,NA,Hokkaido,5273681,13,0,1300,102
2020-07-16,Japan,NA,Hokkaido,5273681,6,0,1306,102
2020-07-17,Japan,NA,Hokkaido,5273681,3,0,1309,102
2020-07-18,Japan,NA,Hokkaido,5273681,13,0,1322,102
2020-07-19,Japan,NA,Hokkaido,5273681,9,0,1331,102
2020-07-20,Japan,NA,Hokkaido,5273681,3,0,1334,102
2020-07-21,Japan,NA,Hokkaido,5273681,10,0,1344,102
2020-07-22,Japan,NA,Hokkaido,5273681,6,0,1350,102
2020-07-23,Japan,NA,Hokkaido,5273681,4,1,1354,103
2020-07-24,Japan,NA,Hokkaido,5273681,6,0,1360,103
2020-07-25,Japan,NA,Hokkaido,5273681,8,0,1368,103
2020-07-26,Japan,NA,Hokkaido,5273681,5,0,1373,103
2020-07-27,Japan,NA,Hokkaido,5273681,4,0,1377,103
2020-07-28,Japan,NA,Hokkaido,5273681,3,0,1380,103
2020-07-29,Japan,NA,Hokkaido,5273681,5,0,1385,103
2020-07-30,Japan,NA,Hokkaido,5273681,9,0,1394,103
2020-07-31,Japan,NA,Hokkaido,5273681,15,0,1409,103
2020-08-01,Japan,NA,Hokkaido,5273681,18,0,1427,103
2020-08-02,Japan,NA,Hokkaido,5273681,9,0,1436,103
2020-08-03,Japan,NA,Hokkaido,5273681,23,0,1459,103
2020-08-04,Japan,NA,Hokkaido,5273681,11,0,1470,103
2020-08-05,Japan,NA,Hokkaido,5273681,14,0,1484,103
2020-08-06,Japan,NA,Hokkaido,5273681,11,0,1495,103
2020-08-07,Japan,NA,Hokkaido,5273681,14,0,1509,103
2020-08-08,Japan,NA,Hokkaido,5273681,13,0,1522,103
2020-08-09,Japan,NA,Hokkaido,5273681,10,0,1532,103
2020-08-10,Japan,NA,Hokkaido,5273681,13,0,1545,103
2020-08-11,Japan,NA,Hokkaido,5273681,14,0,1559,103
2020-08-12,Japan,NA,Hokkaido,5273681,4,0,1563,103
2020-08-13,Japan,NA,Hokkaido,5273681,10,0,1573,103
2020-08-14,Japan,NA,Hokkaido,5273681,12,0,1585,103
2020-08-15,Japan,NA,Hokkaido,5273681,14,0,1599,103
2020-08-16,Japan,NA,Hokkaido,5273681,8,0,1607,103
2020-08-17,Japan,NA,Hokkaido,5273681,5,0,1612,103
2020-08-18,Japan,NA,Hokkaido,5273681,6,0,1618,103
2020-08-19,Japan,NA,Hokkaido,5273681,8,0,1626,103
2020-08-20,Japan,NA,Hokkaido,5273681,25,0,1651,103
2020-08-21,Japan,NA,Hokkaido,5273681,10,0,1661,103
2020-08-22,Japan,NA,Hokkaido,5273681,16,0,1677,103
2020-08-23,Japan,NA,Hokkaido,5273681,14,0,1691,103
2020-08-24,Japan,NA,Hokkaido,5273681,8,0,1699,103
2020-08-25,Japan,NA,Hokkaido,5273681,7,0,1706,103
2020-08-26,Japan,NA,Hokkaido,5273681,7,0,1713,103
2020-08-27,Japan,NA,Hokkaido,5273681,10,0,1723,103
2020-08-28,Japan,NA,Hokkaido,5273681,16,0,1739,103
2020-08-29,Japan,NA,Hokkaido,5273681,8,0,1747,103
2020-08-30,Japan,NA,Hokkaido,5273681,4,0,1751,103
2020-08-31,Japan,NA,Hokkaido,5273681,8,0,1759,103
2020-09-01,Japan,NA,Hokkaido,5273681,16,0,1775,103
2020-09-02,Japan,NA,Hokkaido,5273681,6,1,1781,104
2020-09-03,Japan,NA,Hokkaido,5273681,6,0,1787,104
2020-09-04,Japan,NA,Hokkaido,5273681,5,0,1792,104
2020-09-05,Japan,NA,Hokkaido,5273681,10,1,1802,105
2020-09-06,Japan,NA,Hokkaido,5273681,4,0,1806,105
2020-09-07,Japan,NA,Hokkaido,5273681,6,0,1812,105
2020-09-08,Japan,NA,Hokkaido,5273681,11,0,1823,105
2020-09-09,Japan,NA,Hokkaido,5273681,4,0,1827,105
2020-09-10,Japan,NA,Hokkaido,5273681,11,1,1838,106
2020-09-11,Japan,NA,Hokkaido,5273681,6,0,1844,106
2020-09-12,Japan,NA,Hokkaido,5273681,7,0,1851,106
2020-09-13,Japan,NA,Hokkaido,5273681,3,0,1854,106
2020-09-14,Japan,NA,Hokkaido,5273681,8,0,1862,106
2020-09-15,Japan,NA,Hokkaido,5273681,8,0,1870,106
2020-09-16,Japan,NA,Hokkaido,5273681,11,0,1881,106
2020-09-17,Japan,NA,Hokkaido,5273681,7,0,1888,106
2020-09-18,Japan,NA,Hokkaido,5273681,17,0,1905,106
2020-09-19,Japan,NA,Hokkaido,5273681,17,0,1922,106
2020-09-20,Japan,NA,Hokkaido,5273681,16,0,1938,106
2020-09-21,Japan,NA,Hokkaido,5273681,15,1,1953,107
2020-09-22,Japan,NA,Hokkaido,5273681,9,0,1962,107
2020-09-23,Japan,NA,Hokkaido,5273681,12,0,1974,107
2020-03-08,Japan,NA,Hyogo,5463609,2,0,12,0
2020-03-09,Japan,NA,Hyogo,5463609,4,0,16,0
2020-03-10,Japan,NA,Hyogo,5463609,8,0,24,0
2020-03-11,Japan,NA,Hyogo,5463609,13,1,37,1
2020-03-12,Japan,NA,Hyogo,5463609,9,0,46,1
2020-03-13,Japan,NA,Hyogo,5463609,10,0,56,1
2020-03-14,Japan,NA,Hyogo,5463609,11,0,67,1
2020-03-15,Japan,NA,Hyogo,5463609,11,0,78,1
2020-03-16,Japan,NA,Hyogo,5463609,4,1,82,2
2020-03-17,Japan,NA,Hyogo,5463609,4,0,86,2
2020-03-18,Japan,NA,Hyogo,5463609,5,1,91,3
2020-03-19,Japan,NA,Hyogo,5463609,2,1,93,4
2020-03-20,Japan,NA,Hyogo,5463609,8,0,101,4
2020-03-21,Japan,NA,Hyogo,5463609,6,0,107,4
2020-03-22,Japan,NA,Hyogo,5463609,4,2,111,6
2020-03-23,Japan,NA,Hyogo,5463609,2,0,113,6
2020-03-24,Japan,NA,Hyogo,5463609,5,0,118,6
2020-03-25,Japan,NA,Hyogo,5463609,1,0,119,6
2020-03-26,Japan,NA,Hyogo,5463609,1,1,120,7
2020-03-27,Japan,NA,Hyogo,5463609,3,2,123,9
2020-03-28,Japan,NA,Hyogo,5463609,3,1,126,10
2020-03-29,Japan,NA,Hyogo,5463609,7,0,133,10
2020-03-30,Japan,NA,Hyogo,5463609,4,1,137,11
2020-03-31,Japan,NA,Hyogo,5463609,11,0,148,11
2020-04-01,Japan,NA,Hyogo,5463609,14,0,162,11
2020-04-02,Japan,NA,Hyogo,5463609,7,0,169,11
2020-04-03,Japan,NA,Hyogo,5463609,6,0,175,11
2020-04-04,Japan,NA,Hyogo,5463609,15,0,190,11
2020-04-05,Japan,NA,Hyogo,5463609,13,0,203,11
2020-04-06,Japan,NA,Hyogo,5463609,6,1,209,12
2020-04-07,Japan,NA,Hyogo,5463609,20,0,229,12
2020-04-08,Japan,NA,Hyogo,5463609,19,0,248,12
2020-04-09,Japan,NA,Hyogo,5463609,39,1,287,13
2020-04-10,Japan,NA,Hyogo,5463609,29,0,316,13
2020-04-11,Japan,NA,Hyogo,5463609,42,1,358,14
2020-04-12,Japan,NA,Hyogo,5463609,17,0,375,14
2020-04-13,Japan,NA,Hyogo,5463609,9,1,384,15
2020-04-14,Japan,NA,Hyogo,5463609,19,0,403,15
2020-04-15,Japan,NA,Hyogo,5463609,20,0,423,15
2020-04-16,Japan,NA,Hyogo,5463609,31,1,454,16
2020-04-17,Japan,NA,Hyogo,5463609,27,1,481,17
2020-04-18,Japan,NA,Hyogo,5463609,21,0,502,17
2020-04-19,Japan,NA,Hyogo,5463609,11,2,513,19
2020-04-20,Japan,NA,Hyogo,5463609,11,3,524,22
2020-04-21,Japan,NA,Hyogo,5463609,19,0,543,22
2020-04-22,Japan,NA,Hyogo,5463609,17,0,560,22
2020-04-23,Japan,NA,Hyogo,5463609,20,0,580,22
2020-04-24,Japan,NA,Hyogo,5463609,25,1,605,23
2020-04-25,Japan,NA,Hyogo,5463609,15,1,620,24
2020-04-26,Japan,NA,Hyogo,5463609,9,0,629,24
2020-04-27,Japan,NA,Hyogo,5463609,1,0,630,24
2020-04-28,Japan,NA,Hyogo,5463609,7,3,637,27
2020-04-29,Japan,NA,Hyogo,5463609,6,0,643,27
2020-04-30,Japan,NA,Hyogo,5463609,3,0,646,27
2020-05-01,Japan,NA,Hyogo,5463609,5,0,651,27
2020-05-02,Japan,NA,Hyogo,5463609,4,1,655,28
2020-05-03,Japan,NA,Hyogo,5463609,12,0,667,28
2020-05-04,Japan,NA,Hyogo,5463609,0,1,667,29
2020-05-05,Japan,NA,Hyogo,5463609,6,1,673,30
2020-05-06,Japan,NA,Hyogo,5463609,3,0,676,30
2020-05-07,Japan,NA,Hyogo,5463609,3,2,679,32
2020-05-08,Japan,NA,Hyogo,5463609,1,0,680,32
2020-05-09,Japan,NA,Hyogo,5463609,8,2,688,34
2020-05-10,Japan,NA,Hyogo,5463609,5,0,693,34
2020-05-11,Japan,NA,Hyogo,5463609,1,0,694,34
2020-05-12,Japan,NA,Hyogo,5463609,0,1,694,35
2020-05-13,Japan,NA,Hyogo,5463609,3,2,697,37
2020-05-14,Japan,NA,Hyogo,5463609,1,0,698,37
2020-05-15,Japan,NA,Hyogo,5463609,0,1,698,38
2020-05-16,Japan,NA,Hyogo,5463609,1,0,699,38
2020-05-17,Japan,NA,Hyogo,5463609,0,0,699,38
2020-05-18,Japan,NA,Hyogo,5463609,0,0,699,38
2020-05-19,Japan,NA,Hyogo,5463609,0,0,699,38
2020-05-20,Japan,NA,Hyogo,5463609,0,0,699,38
2020-05-21,Japan,NA,Hyogo,5463609,0,0,699,38
2020-05-22,Japan,NA,Hyogo,5463609,0,2,699,40
2020-05-23,Japan,NA,Hyogo,5463609,0,0,699,40
2020-05-24,Japan,NA,Hyogo,5463609,0,0,699,40
2020-05-25,Japan,NA,Hyogo,5463609,0,0,699,40
2020-05-26,Japan,NA,Hyogo,5463609,0,0,699,40
2020-05-27,Japan,NA,Hyogo,5463609,0,0,699,40
2020-05-28,Japan,NA,Hyogo,5463609,0,1,699,41
2020-05-29,Japan,NA,Hyogo,5463609,0,1,699,42
2020-05-30,Japan,NA,Hyogo,5463609,0,0,699,42
2020-05-31,Japan,NA,Hyogo,5463609,0,0,699,42
2020-06-01,Japan,NA,Hyogo,5463609,0,0,699,42
2020-06-02,Japan,NA,Hyogo,5463609,0,0,699,42
2020-06-03,Japan,NA,Hyogo,5463609,0,0,699,42
2020-06-04,Japan,NA,Hyogo,5463609,0,0,699,42
2020-06-05,Japan,NA,Hyogo,5463609,0,0,699,42
2020-06-06,Japan,NA,Hyogo,5463609,0,0,699,42
2020-06-07,Japan,NA,Hyogo,5463609,0,0,699,42
2020-06-08,Japan,NA,Hyogo,5463609,0,1,699,43
2020-06-09,Japan,NA,Hyogo,5463609,0,0,699,43
2020-06-10,Japan,NA,Hyogo,5463609,0,0,699,43
2020-06-11,Japan,NA,Hyogo,5463609,0,0,699,43
2020-06-12,Japan,NA,Hyogo,5463609,0,0,699,43
2020-06-13,Japan,NA,Hyogo,5463609,0,0,699,43
2020-06-14,Japan,NA,Hyogo,5463609,0,0,699,43
2020-06-15,Japan,NA,Hyogo,5463609,0,0,699,43
2020-06-16,Japan,NA,Hyogo,5463609,0,0,699,43
2020-06-17,Japan,NA,Hyogo,5463609,0,0,699,43
2020-06-18,Japan,NA,Hyogo,5463609,0,0,699,43
2020-06-19,Japan,NA,Hyogo,5463609,1,0,700,43
2020-06-20,Japan,NA,Hyogo,5463609,0,0,700,43
2020-06-21,Japan,NA,Hyogo,5463609,2,0,702,43
2020-06-22,Japan,NA,Hyogo,5463609,0,0,702,43
2020-06-23,Japan,NA,Hyogo,5463609,1,0,703,43
2020-06-24,Japan,NA,Hyogo,5463609,1,0,704,43
2020-06-25,Japan,NA,Hyogo,5463609,0,0,704,43
2020-06-26,Japan,NA,Hyogo,5463609,1,0,705,43
2020-06-27,Japan,NA,Hyogo,5463609,0,0,705,43
2020-06-28,Japan,NA,Hyogo,5463609,0,0,705,43
2020-06-29,Japan,NA,Hyogo,5463609,0,0,705,43
2020-06-30,Japan,NA,Hyogo,5463609,1,2,706,45
2020-07-01,Japan,NA,Hyogo,5463609,2,0,708,45
2020-07-02,Japan,NA,Hyogo,5463609,1,0,709,45
2020-07-03,Japan,NA,Hyogo,5463609,0,0,709,45
2020-07-04,Japan,NA,Hyogo,5463609,1,0,710,45
2020-07-05,Japan,NA,Hyogo,5463609,2,0,712,45
2020-07-06,Japan,NA,Hyogo,5463609,4,0,716,45
2020-07-07,Japan,NA,Hyogo,5463609,1,0,717,45
2020-07-08,Japan,NA,Hyogo,5463609,3,0,720,45
2020-07-09,Japan,NA,Hyogo,5463609,2,0,722,45
2020-07-10,Japan,NA,Hyogo,5463609,4,0,726,45
2020-07-11,Japan,NA,Hyogo,5463609,5,0,731,45
2020-07-12,Japan,NA,Hyogo,5463609,6,0,737,45
2020-07-13,Japan,NA,Hyogo,5463609,1,0,738,45
2020-07-14,Japan,NA,Hyogo,5463609,9,0,747,45
2020-07-15,Japan,NA,Hyogo,5463609,12,0,759,45
2020-07-16,Japan,NA,Hyogo,5463609,17,0,776,45
2020-07-17,Japan,NA,Hyogo,5463609,25,0,801,45
2020-07-18,Japan,NA,Hyogo,5463609,12,0,813,45
2020-07-19,Japan,NA,Hyogo,5463609,21,0,834,45
2020-07-20,Japan,NA,Hyogo,5463609,7,0,841,45
2020-07-21,Japan,NA,Hyogo,5463609,12,0,853,45
2020-07-22,Japan,NA,Hyogo,5463609,30,0,883,45
2020-07-23,Japan,NA,Hyogo,5463609,35,0,918,45
2020-07-24,Japan,NA,Hyogo,5463609,23,0,941,45
2020-07-25,Japan,NA,Hyogo,5463609,24,0,965,45
2020-07-26,Japan,NA,Hyogo,5463609,49,0,1014,45
2020-07-27,Japan,NA,Hyogo,5463609,12,0,1026,45
2020-07-28,Japan,NA,Hyogo,5463609,33,0,1059,45
2020-07-29,Japan,NA,Hyogo,5463609,46,0,1105,45
2020-07-30,Japan,NA,Hyogo,5463609,53,0,1158,45
2020-07-31,Japan,NA,Hyogo,5463609,62,0,1220,45
2020-08-01,Japan,NA,Hyogo,5463609,32,0,1252,45
2020-08-02,Japan,NA,Hyogo,5463609,60,0,1312,45
2020-08-03,Japan,NA,Hyogo,5463609,27,0,1339,45
2020-08-04,Japan,NA,Hyogo,5463609,32,0,1371,45
2020-08-05,Japan,NA,Hyogo,5463609,52,1,1423,46
2020-08-06,Japan,NA,Hyogo,5463609,61,1,1484,47
2020-08-07,Japan,NA,Hyogo,5463609,49,0,1533,47
2020-08-08,Japan,NA,Hyogo,5463609,55,0,1588,47
2020-08-09,Japan,NA,Hyogo,5463609,48,0,1636,47
2020-08-10,Japan,NA,Hyogo,5463609,26,0,1662,47
2020-08-11,Japan,NA,Hyogo,5463609,30,0,1692,47
2020-08-12,Japan,NA,Hyogo,5463609,36,0,1728,47
2020-08-13,Japan,NA,Hyogo,5463609,48,0,1776,47
2020-08-14,Japan,NA,Hyogo,5463609,33,1,1809,48
2020-08-15,Japan,NA,Hyogo,5463609,53,0,1862,48
2020-08-16,Japan,NA,Hyogo,5463609,37,0,1899,48
2020-08-17,Japan,NA,Hyogo,5463609,24,0,1923,48
2020-08-18,Japan,NA,Hyogo,5463609,25,0,1948,48
2020-08-19,Japan,NA,Hyogo,5463609,49,0,1997,48
2020-08-20,Japan,NA,Hyogo,5463609,34,0,2031,48
2020-08-21,Japan,NA,Hyogo,5463609,39,1,2070,49
2020-08-22,Japan,NA,Hyogo,5463609,33,0,2103,49
2020-08-23,Japan,NA,Hyogo,5463609,24,0,2127,49
2020-08-24,Japan,NA,Hyogo,5463609,8,0,2135,49
2020-08-25,Japan,NA,Hyogo,5463609,23,0,2158,49
2020-08-26,Japan,NA,Hyogo,5463609,28,1,2186,50
2020-08-27,Japan,NA,Hyogo,5463609,22,1,2208,51
2020-08-28,Japan,NA,Hyogo,5463609,26,2,2234,53
2020-08-29,Japan,NA,Hyogo,5463609,20,0,2254,53
2020-08-30,Japan,NA,Hyogo,5463609,13,0,2267,53
2020-08-31,Japan,NA,Hyogo,5463609,8,0,2275,53
2020-09-01,Japan,NA,Hyogo,5463609,21,0,2296,53
2020-09-02,Japan,NA,Hyogo,5463609,7,0,2303,53
2020-09-03,Japan,NA,Hyogo,5463609,13,0,2316,53
2020-09-04,Japan,NA,Hyogo,5463609,13,1,2329,54
2020-09-05,Japan,NA,Hyogo,5463609,9,0,2338,54
2020-09-06,Japan,NA,Hyogo,5463609,16,0,2354,54
2020-09-07,Japan,NA,Hyogo,5463609,6,0,2360,54
2020-09-08,Japan,NA,Hyogo,5463609,18,0,2378,54
2020-09-09,Japan,NA,Hyogo,5463609,22,0,2400,54
2020-09-10,Japan,NA,Hyogo,5463609,21,0,2421,54
2020-09-11,Japan,NA,Hyogo,5463609,14,1,2435,55
2020-09-12,Japan,NA,Hyogo,5463609,20,0,2455,55
2020-09-13,Japan,NA,Hyogo,5463609,15,0,2470,55
2020-09-14,Japan,NA,Hyogo,5463609,8,0,2478,55
2020-09-15,Japan,NA,Hyogo,5463609,23,0,2501,55
2020-09-16,Japan,NA,Hyogo,5463609,20,0,2521,55
2020-09-17,Japan,NA,Hyogo,5463609,16,1,2537,56
2020-09-18,Japan,NA,Hyogo,5463609,12,0,2549,56
2020-09-19,Japan,NA,Hyogo,5463609,21,0,2570,56
2020-09-20,Japan,NA,Hyogo,5463609,5,1,2575,57
2020-09-21,Japan,NA,Hyogo,5463609,27,0,2602,57
2020-09-22,Japan,NA,Hyogo,5463609,13,0,2615,57
2020-09-23,Japan,NA,Hyogo,5463609,1,0,2616,57
2020-03-27,Japan,NA,Ibaraki,2868041,3,0,13,0
2020-03-28,Japan,NA,Ibaraki,2868041,3,0,16,0
2020-03-29,Japan,NA,Ibaraki,2868041,0,0,16,0
2020-03-30,Japan,NA,Ibaraki,2868041,4,0,20,0
2020-03-31,Japan,NA,Ibaraki,2868041,4,0,24,0
2020-04-01,Japan,NA,Ibaraki,2868041,18,2,42,2
2020-04-02,Japan,NA,Ibaraki,2868041,2,0,44,2
2020-04-03,Japan,NA,Ibaraki,2868041,10,0,54,2
2020-04-04,Japan,NA,Ibaraki,2868041,5,0,59,2
2020-04-05,Japan,NA,Ibaraki,2868041,5,0,64,2
2020-04-06,Japan,NA,Ibaraki,2868041,7,0,71,2
2020-04-07,Japan,NA,Ibaraki,2868041,6,0,77,2
2020-04-08,Japan,NA,Ibaraki,2868041,0,0,77,2
2020-04-09,Japan,NA,Ibaraki,2868041,5,0,82,2
2020-04-10,Japan,NA,Ibaraki,2868041,9,1,91,3
2020-04-11,Japan,NA,Ibaraki,2868041,12,2,103,5
2020-04-12,Japan,NA,Ibaraki,2868041,6,0,109,5
2020-04-13,Japan,NA,Ibaraki,2868041,1,0,110,5
2020-04-14,Japan,NA,Ibaraki,2868041,6,0,116,5
2020-04-15,Japan,NA,Ibaraki,2868041,3,0,119,5
2020-04-16,Japan,NA,Ibaraki,2868041,4,0,123,5
2020-04-17,Japan,NA,Ibaraki,2868041,8,0,131,5
2020-04-18,Japan,NA,Ibaraki,2868041,4,0,135,5
2020-04-19,Japan,NA,Ibaraki,2868041,4,0,139,5
2020-04-20,Japan,NA,Ibaraki,2868041,4,0,143,5
2020-04-21,Japan,NA,Ibaraki,2868041,3,1,146,6
2020-04-22,Japan,NA,Ibaraki,2868041,5,0,151,6
2020-04-23,Japan,NA,Ibaraki,2868041,2,0,153,6
2020-04-24,Japan,NA,Ibaraki,2868041,4,0,157,6
2020-04-25,Japan,NA,Ibaraki,2868041,3,0,160,6
2020-04-26,Japan,NA,Ibaraki,2868041,1,0,161,6
2020-04-27,Japan,NA,Ibaraki,2868041,0,0,161,6
2020-04-28,Japan,NA,Ibaraki,2868041,1,0,162,6
2020-04-29,Japan,NA,Ibaraki,2868041,1,0,163,6
2020-04-30,Japan,NA,Ibaraki,2868041,0,1,163,7
2020-05-01,Japan,NA,Ibaraki,2868041,2,1,165,8
2020-05-02,Japan,NA,Ibaraki,2868041,0,0,165,8
2020-05-03,Japan,NA,Ibaraki,2868041,0,0,165,8
2020-05-04,Japan,NA,Ibaraki,2868041,2,1,167,9
2020-05-05,Japan,NA,Ibaraki,2868041,1,0,168,9
2020-05-06,Japan,NA,Ibaraki,2868041,0,0,168,9
2020-05-07,Japan,NA,Ibaraki,2868041,0,0,168,9
2020-05-08,Japan,NA,Ibaraki,2868041,0,0,168,9
2020-05-09,Japan,NA,Ibaraki,2868041,0,0,168,9
2020-05-10,Japan,NA,Ibaraki,2868041,0,0,168,9
2020-05-11,Japan,NA,Ibaraki,2868041,0,0,168,9
2020-05-12,Japan,NA,Ibaraki,2868041,0,0,168,9
2020-05-13,Japan,NA,Ibaraki,2868041,0,0,168,9
2020-05-14,Japan,NA,Ibaraki,2868041,0,0,168,9
2020-05-15,Japan,NA,Ibaraki,2868041,0,0,168,9
2020-05-16,Japan,NA,Ibaraki,2868041,0,0,168,9
2020-05-17,Japan,NA,Ibaraki,2868041,0,0,168,9
2020-05-18,Japan,NA,Ibaraki,2868041,0,0,168,9
2020-05-19,Japan,NA,Ibaraki,2868041,0,0,168,9
2020-05-20,Japan,NA,Ibaraki,2868041,0,0,168,9
2020-05-21,Japan,NA,Ibaraki,2868041,0,0,168,9
2020-05-22,Japan,NA,Ibaraki,2868041,0,0,168,9
2020-05-23,Japan,NA,Ibaraki,2868041,0,0,168,9
2020-05-24,Japan,NA,Ibaraki,2868041,0,0,168,9
2020-05-25,Japan,NA,Ibaraki,2868041,0,0,168,9
2020-05-26,Japan,NA,Ibaraki,2868041,0,1,168,10
2020-05-27,Japan,NA,Ibaraki,2868041,0,0,168,10
2020-05-28,Japan,NA,Ibaraki,2868041,0,0,168,10
2020-05-29,Japan,NA,Ibaraki,2868041,0,0,168,10
2020-05-30,Japan,NA,Ibaraki,2868041,0,0,168,10
2020-05-31,Japan,NA,Ibaraki,2868041,0,0,168,10
2020-06-01,Japan,NA,Ibaraki,2868041,0,0,168,10
2020-06-02,Japan,NA,Ibaraki,2868041,0,0,168,10
2020-06-03,Japan,NA,Ibaraki,2868041,0,0,168,10
2020-06-04,Japan,NA,Ibaraki,2868041,0,0,168,10
2020-06-05,Japan,NA,Ibaraki,2868041,0,0,168,10
2020-06-06,Japan,NA,Ibaraki,2868041,0,0,168,10
2020-06-07,Japan,NA,Ibaraki,2868041,0,0,168,10
2020-06-08,Japan,NA,Ibaraki,2868041,0,0,168,10
2020-06-09,Japan,NA,Ibaraki,2868041,0,0,168,10
2020-06-10,Japan,NA,Ibaraki,2868041,0,0,168,10
2020-06-11,Japan,NA,Ibaraki,2868041,0,0,168,10
2020-06-12,Japan,NA,Ibaraki,2868041,0,0,168,10
2020-06-13,Japan,NA,Ibaraki,2868041,0,0,168,10
2020-06-14,Japan,NA,Ibaraki,2868041,0,0,168,10
2020-06-15,Japan,NA,Ibaraki,2868041,0,0,168,10
2020-06-16,Japan,NA,Ibaraki,2868041,0,0,168,10
2020-06-17,Japan,NA,Ibaraki,2868041,0,0,168,10
2020-06-18,Japan,NA,Ibaraki,2868041,0,0,168,10
2020-06-19,Japan,NA,Ibaraki,2868041,0,0,168,10
2020-06-20,Japan,NA,Ibaraki,2868041,2,0,170,10
2020-06-21,Japan,NA,Ibaraki,2868041,0,0,170,10
2020-06-22,Japan,NA,Ibaraki,2868041,0,0,170,10
2020-06-23,Japan,NA,Ibaraki,2868041,0,0,170,10
2020-06-24,Japan,NA,Ibaraki,2868041,0,0,170,10
2020-06-25,Japan,NA,Ibaraki,2868041,0,0,170,10
2020-06-26,Japan,NA,Ibaraki,2868041,2,0,172,10
2020-06-27,Japan,NA,Ibaraki,2868041,0,0,172,10
2020-06-28,Japan,NA,Ibaraki,2868041,1,0,173,10
2020-06-29,Japan,NA,Ibaraki,2868041,1,0,174,10
2020-06-30,Japan,NA,Ibaraki,2868041,0,0,174,10
2020-07-01,Japan,NA,Ibaraki,2868041,0,0,174,10
2020-07-02,Japan,NA,Ibaraki,2868041,2,0,176,10
2020-07-03,Japan,NA,Ibaraki,2868041,6,0,182,10
2020-07-04,Japan,NA,Ibaraki,2868041,1,0,183,10
2020-07-05,Japan,NA,Ibaraki,2868041,0,0,183,10
2020-07-06,Japan,NA,Ibaraki,2868041,3,0,186,10
2020-07-07,Japan,NA,Ibaraki,2868041,1,0,187,10
2020-07-08,Japan,NA,Ibaraki,2868041,1,0,188,10
2020-07-09,Japan,NA,Ibaraki,2868041,1,0,189,10
2020-07-10,Japan,NA,Ibaraki,2868041,7,0,196,10
2020-07-11,Japan,NA,Ibaraki,2868041,0,0,196,10
2020-07-12,Japan,NA,Ibaraki,2868041,3,0,199,10
2020-07-13,Japan,NA,Ibaraki,2868041,3,0,202,10
2020-07-14,Japan,NA,Ibaraki,2868041,2,0,204,10
2020-07-15,Japan,NA,Ibaraki,2868041,5,0,209,10
2020-07-16,Japan,NA,Ibaraki,2868041,2,0,211,10
2020-07-17,Japan,NA,Ibaraki,2868041,4,0,215,10
2020-07-18,Japan,NA,Ibaraki,2868041,5,0,220,10
2020-07-19,Japan,NA,Ibaraki,2868041,5,0,225,10
2020-07-20,Japan,NA,Ibaraki,2868041,1,0,226,10
2020-07-21,Japan,NA,Ibaraki,2868041,4,0,230,10
2020-07-22,Japan,NA,Ibaraki,2868041,5,0,235,10
2020-07-23,Japan,NA,Ibaraki,2868041,2,0,237,10
2020-07-24,Japan,NA,Ibaraki,2868041,2,0,239,10
2020-07-25,Japan,NA,Ibaraki,2868041,0,0,239,10
2020-07-26,Japan,NA,Ibaraki,2868041,3,0,242,10
2020-07-27,Japan,NA,Ibaraki,2868041,2,0,244,10
2020-07-28,Japan,NA,Ibaraki,2868041,15,0,259,10
2020-07-29,Japan,NA,Ibaraki,2868041,9,0,268,10
2020-07-30,Japan,NA,Ibaraki,2868041,12,0,280,10
2020-07-31,Japan,NA,Ibaraki,2868041,14,0,294,10
2020-08-01,Japan,NA,Ibaraki,2868041,14,0,308,10
2020-08-02,Japan,NA,Ibaraki,2868041,14,0,322,10
2020-08-03,Japan,NA,Ibaraki,2868041,5,0,327,10
2020-08-04,Japan,NA,Ibaraki,2868041,7,0,334,10
2020-08-05,Japan,NA,Ibaraki,2868041,10,0,344,10
2020-08-06,Japan,NA,Ibaraki,2868041,12,0,356,10
2020-08-07,Japan,NA,Ibaraki,2868041,12,0,368,10
2020-08-08,Japan,NA,Ibaraki,2868041,12,0,380,10
2020-08-09,Japan,NA,Ibaraki,2868041,17,0,397,10
2020-08-10,Japan,NA,Ibaraki,2868041,6,0,403,10
2020-08-11,Japan,NA,Ibaraki,2868041,3,0,406,10
2020-08-12,Japan,NA,Ibaraki,2868041,10,0,416,10
2020-08-13,Japan,NA,Ibaraki,2868041,15,0,431,10
2020-08-14,Japan,NA,Ibaraki,2868041,12,0,443,10
2020-08-15,Japan,NA,Ibaraki,2868041,7,0,450,10
2020-08-16,Japan,NA,Ibaraki,2868041,2,0,452,10
2020-08-17,Japan,NA,Ibaraki,2868041,4,0,456,10
2020-08-18,Japan,NA,Ibaraki,2868041,7,0,463,10
2020-08-19,Japan,NA,Ibaraki,2868041,13,1,476,11
2020-08-20,Japan,NA,Ibaraki,2868041,3,0,479,11
2020-08-21,Japan,NA,Ibaraki,2868041,11,0,490,11
2020-08-22,Japan,NA,Ibaraki,2868041,8,0,498,11
2020-08-23,Japan,NA,Ibaraki,2868041,5,0,503,11
2020-08-24,Japan,NA,Ibaraki,2868041,4,0,507,11
2020-08-25,Japan,NA,Ibaraki,2868041,5,1,512,12
2020-08-26,Japan,NA,Ibaraki,2868041,12,0,524,12
2020-08-27,Japan,NA,Ibaraki,2868041,8,0,532,12
2020-08-28,Japan,NA,Ibaraki,2868041,6,1,538,13
2020-08-29,Japan,NA,Ibaraki,2868041,4,0,542,13
2020-08-30,Japan,NA,Ibaraki,2868041,2,0,544,13
2020-08-31,Japan,NA,Ibaraki,2868041,1,0,545,13
2020-09-01,Japan,NA,Ibaraki,2868041,4,0,549,13
2020-09-02,Japan,NA,Ibaraki,2868041,6,1,555,14
2020-09-03,Japan,NA,Ibaraki,2868041,4,0,559,14
2020-09-04,Japan,NA,Ibaraki,2868041,8,0,567,14
2020-09-05,Japan,NA,Ibaraki,2868041,6,0,573,14
2020-09-06,Japan,NA,Ibaraki,2868041,10,0,583,14
2020-09-07,Japan,NA,Ibaraki,2868041,0,0,583,14
2020-09-08,Japan,NA,Ibaraki,2868041,5,0,588,14
2020-09-09,Japan,NA,Ibaraki,2868041,1,0,589,14
2020-09-10,Japan,NA,Ibaraki,2868041,4,0,593,14
2020-09-11,Japan,NA,Ibaraki,2868041,13,0,606,14
2020-09-12,Japan,NA,Ibaraki,2868041,3,1,609,15
2020-09-13,Japan,NA,Ibaraki,2868041,3,0,612,15
2020-09-14,Japan,NA,Ibaraki,2868041,2,1,614,16
2020-09-15,Japan,NA,Ibaraki,2868041,2,0,616,16
2020-09-16,Japan,NA,Ibaraki,2868041,2,0,618,16
2020-09-17,Japan,NA,Ibaraki,2868041,3,0,621,16
2020-09-18,Japan,NA,Ibaraki,2868041,1,0,622,16
2020-09-19,Japan,NA,Ibaraki,2868041,1,0,623,16
2020-09-20,Japan,NA,Ibaraki,2868041,1,0,624,16
2020-09-21,Japan,NA,Ibaraki,2868041,3,0,627,16
2020-09-22,Japan,NA,Ibaraki,2868041,2,1,629,17
2020-09-23,Japan,NA,Ibaraki,2868041,1,0,630,17
2020-03-30,Japan,NA,Ishikawa,1137181,2,0,11,0
2020-03-31,Japan,NA,Ishikawa,1137181,2,0,13,0
2020-04-01,Japan,NA,Ishikawa,1137181,2,0,15,0
2020-04-02,Japan,NA,Ishikawa,1137181,1,0,16,0
2020-04-03,Japan,NA,Ishikawa,1137181,8,0,24,0
2020-04-04,Japan,NA,Ishikawa,1137181,8,0,32,0
2020-04-05,Japan,NA,Ishikawa,1137181,11,0,43,0
2020-04-06,Japan,NA,Ishikawa,1137181,2,0,45,0
2020-04-07,Japan,NA,Ishikawa,1137181,10,0,55,0
2020-04-08,Japan,NA,Ishikawa,1137181,11,0,66,0
2020-04-09,Japan,NA,Ishikawa,1137181,7,0,73,0
2020-04-10,Japan,NA,Ishikawa,1137181,19,0,92,0
2020-04-11,Japan,NA,Ishikawa,1137181,12,0,104,0
2020-04-12,Japan,NA,Ishikawa,1137181,9,0,113,0
2020-04-13,Japan,NA,Ishikawa,1137181,8,0,121,0
2020-04-14,Japan,NA,Ishikawa,1137181,10,3,131,3
2020-04-15,Japan,NA,Ishikawa,1137181,9,1,140,4
2020-04-16,Japan,NA,Ishikawa,1137181,6,0,146,4
2020-04-17,Japan,NA,Ishikawa,1137181,14,0,160,4
2020-04-18,Japan,NA,Ishikawa,1137181,13,0,173,4
2020-04-19,Japan,NA,Ishikawa,1137181,5,0,178,4
2020-04-20,Japan,NA,Ishikawa,1137181,3,0,181,4
2020-04-21,Japan,NA,Ishikawa,1137181,12,1,193,5
2020-04-22,Japan,NA,Ishikawa,1137181,6,0,199,5
2020-04-23,Japan,NA,Ishikawa,1137181,17,0,216,5
2020-04-24,Japan,NA,Ishikawa,1137181,6,0,222,5
2020-04-25,Japan,NA,Ishikawa,1137181,4,0,226,5
2020-04-26,Japan,NA,Ishikawa,1137181,9,0,235,5
2020-04-27,Japan,NA,Ishikawa,1137181,6,1,241,6
2020-04-28,Japan,NA,Ishikawa,1137181,8,0,249,6
2020-04-29,Japan,NA,Ishikawa,1137181,1,2,250,8
2020-04-30,Japan,NA,Ishikawa,1137181,1,0,251,8
2020-05-01,Japan,NA,Ishikawa,1137181,3,3,254,11
2020-05-02,Japan,NA,Ishikawa,1137181,6,2,260,13
2020-05-03,Japan,NA,Ishikawa,1137181,4,2,264,15
2020-05-04,Japan,NA,Ishikawa,1137181,3,1,267,16
2020-05-05,Japan,NA,Ishikawa,1137181,1,0,268,16
2020-05-06,Japan,NA,Ishikawa,1137181,3,0,271,16
2020-05-07,Japan,NA,Ishikawa,1137181,4,0,275,16
2020-05-08,Japan,NA,Ishikawa,1137181,0,0,275,16
2020-05-09,Japan,NA,Ishikawa,1137181,2,0,277,16
2020-05-10,Japan,NA,Ishikawa,1137181,1,0,278,16
2020-05-11,Japan,NA,Ishikawa,1137181,2,1,280,17
2020-05-12,Japan,NA,Ishikawa,1137181,3,2,283,19
2020-05-13,Japan,NA,Ishikawa,1137181,1,0,284,19
2020-05-14,Japan,NA,Ishikawa,1137181,0,1,284,20
2020-05-15,Japan,NA,Ishikawa,1137181,1,0,285,20
2020-05-16,Japan,NA,Ishikawa,1137181,1,1,286,21
2020-05-17,Japan,NA,Ishikawa,1137181,1,0,287,21
2020-05-18,Japan,NA,Ishikawa,1137181,0,1,287,22
2020-05-19,Japan,NA,Ishikawa,1137181,3,0,290,22
2020-05-20,Japan,NA,Ishikawa,1137181,0,0,290,22
2020-05-21,Japan,NA,Ishikawa,1137181,2,0,292,22
2020-05-22,Japan,NA,Ishikawa,1137181,2,2,294,24
2020-05-23,Japan,NA,Ishikawa,1137181,1,0,295,24
2020-05-24,Japan,NA,Ishikawa,1137181,0,0,295,24
2020-05-25,Japan,NA,Ishikawa,1137181,0,0,295,24
2020-05-26,Japan,NA,Ishikawa,1137181,1,0,296,24
2020-05-27,Japan,NA,Ishikawa,1137181,0,0,296,24
2020-05-28,Japan,NA,Ishikawa,1137181,1,0,297,24
2020-05-29,Japan,NA,Ishikawa,1137181,1,0,298,24
2020-05-30,Japan,NA,Ishikawa,1137181,0,1,298,25
2020-05-31,Japan,NA,Ishikawa,1137181,0,0,298,25
2020-06-01,Japan,NA,Ishikawa,1137181,0,0,298,25
2020-06-02,Japan,NA,Ishikawa,1137181,0,0,298,25
2020-06-03,Japan,NA,Ishikawa,1137181,0,1,298,26
2020-06-04,Japan,NA,Ishikawa,1137181,0,0,298,26
2020-06-05,Japan,NA,Ishikawa,1137181,1,1,299,27
2020-06-06,Japan,NA,Ishikawa,1137181,0,0,299,27
2020-06-07,Japan,NA,Ishikawa,1137181,0,0,299,27
2020-06-08,Japan,NA,Ishikawa,1137181,0,0,299,27
2020-06-09,Japan,NA,Ishikawa,1137181,0,0,299,27
2020-06-10,Japan,NA,Ishikawa,1137181,0,0,299,27
2020-06-11,Japan,NA,Ishikawa,1137181,0,0,299,27
2020-06-12,Japan,NA,Ishikawa,1137181,0,0,299,27
2020-06-13,Japan,NA,Ishikawa,1137181,0,0,299,27
2020-06-14,Japan,NA,Ishikawa,1137181,0,0,299,27
2020-06-15,Japan,NA,Ishikawa,1137181,0,0,299,27
2020-06-16,Japan,NA,Ishikawa,1137181,0,0,299,27
2020-06-17,Japan,NA,Ishikawa,1137181,0,0,299,27
2020-06-18,Japan,NA,Ishikawa,1137181,0,0,299,27
2020-06-19,Japan,NA,Ishikawa,1137181,0,0,299,27
2020-06-20,Japan,NA,Ishikawa,1137181,0,0,299,27
2020-06-21,Japan,NA,Ishikawa,1137181,0,0,299,27
2020-06-22,Japan,NA,Ishikawa,1137181,1,0,300,27
2020-06-23,Japan,NA,Ishikawa,1137181,0,0,300,27
2020-06-24,Japan,NA,Ishikawa,1137181,0,0,300,27
2020-06-25,Japan,NA,Ishikawa,1137181,0,0,300,27
2020-06-26,Japan,NA,Ishikawa,1137181,0,0,300,27
2020-06-27,Japan,NA,Ishikawa,1137181,0,0,300,27
2020-06-28,Japan,NA,Ishikawa,1137181,0,0,300,27
2020-06-29,Japan,NA,Ishikawa,1137181,0,0,300,27
2020-06-30,Japan,NA,Ishikawa,1137181,0,0,300,27
2020-07-01,Japan,NA,Ishikawa,1137181,0,0,300,27
2020-07-02,Japan,NA,Ishikawa,1137181,0,0,300,27
2020-07-03,Japan,NA,Ishikawa,1137181,0,0,300,27
2020-07-04,Japan,NA,Ishikawa,1137181,0,0,300,27
2020-07-05,Japan,NA,Ishikawa,1137181,0,0,300,27
2020-07-06,Japan,NA,Ishikawa,1137181,0,0,300,27
2020-07-07,Japan,NA,Ishikawa,1137181,0,0,300,27
2020-07-08,Japan,NA,Ishikawa,1137181,0,0,300,27
2020-07-09,Japan,NA,Ishikawa,1137181,0,0,300,27
2020-07-10,Japan,NA,Ishikawa,1137181,0,0,300,27
2020-07-11,Japan,NA,Ishikawa,1137181,0,0,300,27
2020-07-12,Japan,NA,Ishikawa,1137181,0,0,300,27
2020-07-13,Japan,NA,Ishikawa,1137181,0,0,300,27
2020-07-14,Japan,NA,Ishikawa,1137181,0,0,300,27
2020-07-15,Japan,NA,Ishikawa,1137181,0,0,300,27
2020-07-16,Japan,NA,Ishikawa,1137181,0,0,300,27
2020-07-17,Japan,NA,Ishikawa,1137181,1,0,301,27
2020-07-18,Japan,NA,Ishikawa,1137181,2,0,303,27
2020-07-19,Japan,NA,Ishikawa,1137181,0,0,303,27
2020-07-20,Japan,NA,Ishikawa,1137181,0,0,303,27
2020-07-21,Japan,NA,Ishikawa,1137181,3,0,306,27
2020-07-22,Japan,NA,Ishikawa,1137181,0,0,306,27
2020-07-23,Japan,NA,Ishikawa,1137181,1,0,307,27
2020-07-24,Japan,NA,Ishikawa,1137181,3,0,310,27
2020-07-25,Japan,NA,Ishikawa,1137181,0,0,310,27
2020-07-26,Japan,NA,Ishikawa,1137181,3,0,313,27
2020-07-27,Japan,NA,Ishikawa,1137181,0,0,313,27
2020-07-28,Japan,NA,Ishikawa,1137181,1,0,314,27
2020-07-29,Japan,NA,Ishikawa,1137181,2,0,316,27
2020-07-30,Japan,NA,Ishikawa,1137181,4,0,320,27
2020-07-31,Japan,NA,Ishikawa,1137181,1,0,321,27
2020-08-01,Japan,NA,Ishikawa,1137181,1,0,322,27
2020-08-02,Japan,NA,Ishikawa,1137181,1,0,323,27
2020-08-03,Japan,NA,Ishikawa,1137181,0,0,323,27
2020-08-04,Japan,NA,Ishikawa,1137181,1,0,324,27
2020-08-05,Japan,NA,Ishikawa,1137181,0,0,324,27
2020-08-06,Japan,NA,Ishikawa,1137181,6,0,330,27
2020-08-07,Japan,NA,Ishikawa,1137181,1,0,331,27
2020-08-08,Japan,NA,Ishikawa,1137181,11,0,342,27
2020-08-09,Japan,NA,Ishikawa,1137181,22,1,364,28
2020-08-10,Japan,NA,Ishikawa,1137181,12,0,376,28
2020-08-11,Japan,NA,Ishikawa,1137181,14,0,390,28
2020-08-12,Japan,NA,Ishikawa,1137181,9,0,399,28
2020-08-13,Japan,NA,Ishikawa,1137181,13,0,412,28
2020-08-14,Japan,NA,Ishikawa,1137181,13,0,425,28
2020-08-15,Japan,NA,Ishikawa,1137181,13,0,438,28
2020-08-16,Japan,NA,Ishikawa,1137181,18,1,456,29
2020-08-17,Japan,NA,Ishikawa,1137181,19,0,475,29
2020-08-18,Japan,NA,Ishikawa,1137181,11,0,486,29
2020-08-19,Japan,NA,Ishikawa,1137181,19,0,505,29
2020-08-20,Japan,NA,Ishikawa,1137181,19,1,524,30
2020-08-21,Japan,NA,Ishikawa,1137181,8,0,532,30
2020-08-22,Japan,NA,Ishikawa,1137181,18,0,550,30
2020-08-23,Japan,NA,Ishikawa,1137181,16,1,566,31
2020-08-24,Japan,NA,Ishikawa,1137181,7,0,573,31
2020-08-25,Japan,NA,Ishikawa,1137181,12,0,585,31
2020-08-26,Japan,NA,Ishikawa,1137181,7,0,592,31
2020-08-27,Japan,NA,Ishikawa,1137181,13,2,605,33
2020-08-28,Japan,NA,Ishikawa,1137181,8,0,613,33
2020-08-29,Japan,NA,Ishikawa,1137181,7,0,620,33
2020-08-30,Japan,NA,Ishikawa,1137181,4,0,624,33
2020-08-31,Japan,NA,Ishikawa,1137181,2,0,626,33
2020-09-01,Japan,NA,Ishikawa,1137181,27,0,653,33
2020-09-02,Japan,NA,Ishikawa,1137181,13,1,666,34
2020-09-03,Japan,NA,Ishikawa,1137181,11,0,677,34
2020-09-04,Japan,NA,Ishikawa,1137181,4,3,681,37
2020-09-05,Japan,NA,Ishikawa,1137181,16,1,697,38
2020-09-06,Japan,NA,Ishikawa,1137181,7,0,704,38
2020-09-07,Japan,NA,Ishikawa,1137181,4,1,708,39
2020-09-08,Japan,NA,Ishikawa,1137181,4,0,712,39
2020-09-09,Japan,NA,Ishikawa,1137181,6,1,718,40
2020-09-10,Japan,NA,Ishikawa,1137181,4,1,722,41
2020-09-11,Japan,NA,Ishikawa,1137181,2,1,724,42
2020-09-12,Japan,NA,Ishikawa,1137181,6,0,730,42
2020-09-13,Japan,NA,Ishikawa,1137181,0,0,730,42
2020-09-14,Japan,NA,Ishikawa,1137181,1,1,731,43
2020-09-15,Japan,NA,Ishikawa,1137181,5,0,736,43
2020-09-16,Japan,NA,Ishikawa,1137181,0,1,736,44
2020-09-17,Japan,NA,Ishikawa,1137181,6,0,742,44
2020-09-18,Japan,NA,Ishikawa,1137181,2,0,744,44
2020-09-19,Japan,NA,Ishikawa,1137181,6,0,750,44
2020-09-20,Japan,NA,Ishikawa,1137181,4,0,754,44
2020-09-21,Japan,NA,Ishikawa,1137181,2,1,756,45
2020-09-22,Japan,NA,Ishikawa,1137181,4,0,760,45
2020-09-23,Japan,NA,Ishikawa,1137181,1,1,761,46
2020-02-21,Japan,NA,Kanagawa,9200166,3,0,12,1
2020-02-22,Japan,NA,Kanagawa,9200166,4,0,16,1
2020-02-23,Japan,NA,Kanagawa,9200166,0,0,16,1
2020-02-24,Japan,NA,Kanagawa,9200166,1,0,17,1
2020-02-25,Japan,NA,Kanagawa,9200166,0,0,17,1
2020-02-26,Japan,NA,Kanagawa,9200166,1,0,18,1
2020-02-27,Japan,NA,Kanagawa,9200166,3,0,21,1
2020-02-28,Japan,NA,Kanagawa,9200166,1,0,22,1
2020-02-29,Japan,NA,Kanagawa,9200166,0,0,22,1
2020-03-01,Japan,NA,Kanagawa,9200166,3,0,25,1
2020-03-02,Japan,NA,Kanagawa,9200166,5,0,30,1
2020-03-03,Japan,NA,Kanagawa,9200166,1,0,31,1
2020-03-04,Japan,NA,Kanagawa,9200166,0,0,31,1
2020-03-05,Japan,NA,Kanagawa,9200166,3,0,34,1
2020-03-06,Japan,NA,Kanagawa,9200166,6,0,40,1
2020-03-07,Japan,NA,Kanagawa,9200166,1,0,41,1
2020-03-08,Japan,NA,Kanagawa,9200166,0,0,41,1
2020-03-09,Japan,NA,Kanagawa,9200166,0,1,41,2
2020-03-10,Japan,NA,Kanagawa,9200166,2,1,43,3
2020-03-11,Japan,NA,Kanagawa,9200166,3,0,46,3
2020-03-12,Japan,NA,Kanagawa,9200166,3,0,49,3
2020-03-13,Japan,NA,Kanagawa,9200166,1,0,50,3
2020-03-14,Japan,NA,Kanagawa,9200166,0,0,50,3
2020-03-15,Japan,NA,Kanagawa,9200166,5,0,55,3
2020-03-16,Japan,NA,Kanagawa,9200166,0,0,55,3
2020-03-17,Japan,NA,Kanagawa,9200166,4,1,59,4
2020-03-18,Japan,NA,Kanagawa,9200166,1,0,60,4
2020-03-19,Japan,NA,Kanagawa,9200166,6,0,66,4
2020-03-20,Japan,NA,Kanagawa,9200166,2,0,68,4
2020-03-21,Japan,NA,Kanagawa,9200166,4,0,72,4
2020-03-22,Japan,NA,Kanagawa,9200166,5,0,77,4
2020-03-23,Japan,NA,Kanagawa,9200166,0,0,77,4
2020-03-24,Japan,NA,Kanagawa,9200166,6,0,83,4
2020-03-25,Japan,NA,Kanagawa,9200166,4,0,87,4
2020-03-26,Japan,NA,Kanagawa,9200166,6,0,93,4
2020-03-27,Japan,NA,Kanagawa,9200166,11,1,104,5
2020-03-28,Japan,NA,Kanagawa,9200166,12,0,116,5
2020-03-29,Japan,NA,Kanagawa,9200166,9,0,125,5
2020-03-30,Japan,NA,Kanagawa,9200166,3,1,128,6
2020-03-31,Japan,NA,Kanagawa,9200166,14,0,142,6
2020-04-01,Japan,NA,Kanagawa,9200166,19,0,161,6
2020-04-02,Japan,NA,Kanagawa,9200166,25,1,186,7
2020-04-03,Japan,NA,Kanagawa,9200166,31,0,217,7
2020-04-04,Japan,NA,Kanagawa,9200166,21,0,238,7
2020-04-05,Japan,NA,Kanagawa,9200166,27,0,265,7
2020-04-06,Japan,NA,Kanagawa,9200166,6,0,271,7
2020-04-07,Japan,NA,Kanagawa,9200166,18,0,289,7
2020-04-08,Japan,NA,Kanagawa,9200166,64,0,353,7
2020-04-09,Japan,NA,Kanagawa,9200166,28,0,381,7
2020-04-10,Japan,NA,Kanagawa,9200166,55,3,436,10
2020-04-11,Japan,NA,Kanagawa,9200166,76,1,512,11
2020-04-12,Japan,NA,Kanagawa,9200166,31,1,543,12
2020-04-13,Japan,NA,Kanagawa,9200166,15,2,558,14
2020-04-14,Japan,NA,Kanagawa,9200166,20,0,578,14
2020-04-15,Japan,NA,Kanagawa,9200166,40,0,618,14
2020-04-16,Japan,NA,Kanagawa,9200166,56,1,674,15
2020-04-17,Japan,NA,Kanagawa,9200166,33,1,707,16
2020-04-18,Japan,NA,Kanagawa,9200166,44,1,751,17
2020-04-19,Japan,NA,Kanagawa,9200166,30,0,781,17
2020-04-20,Japan,NA,Kanagawa,9200166,17,2,798,19
2020-04-21,Japan,NA,Kanagawa,9200166,13,1,811,20
2020-04-22,Japan,NA,Kanagawa,9200166,25,3,836,23
2020-04-23,Japan,NA,Kanagawa,9200166,39,1,875,24
2020-04-24,Japan,NA,Kanagawa,9200166,32,0,907,24
2020-04-25,Japan,NA,Kanagawa,9200166,31,1,938,25
2020-04-26,Japan,NA,Kanagawa,9200166,16,1,954,26
2020-04-27,Japan,NA,Kanagawa,9200166,7,1,961,27
2020-04-28,Japan,NA,Kanagawa,9200166,11,2,972,29
2020-04-29,Japan,NA,Kanagawa,9200166,25,3,997,32
2020-04-30,Japan,NA,Kanagawa,9200166,26,2,1023,34
2020-05-01,Japan,NA,Kanagawa,9200166,15,3,1038,37
2020-05-02,Japan,NA,Kanagawa,9200166,36,2,1074,39
2020-05-03,Japan,NA,Kanagawa,9200166,23,3,1097,42
2020-05-04,Japan,NA,Kanagawa,9200166,10,3,1107,45
2020-05-05,Japan,NA,Kanagawa,9200166,14,1,1121,46
2020-05-06,Japan,NA,Kanagawa,9200166,7,1,1128,47
2020-05-07,Japan,NA,Kanagawa,9200166,13,0,1141,47
2020-05-08,Japan,NA,Kanagawa,9200166,7,3,1148,50
2020-05-09,Japan,NA,Kanagawa,9200166,7,1,1155,51
2020-05-10,Japan,NA,Kanagawa,9200166,13,2,1168,53
2020-05-11,Japan,NA,Kanagawa,9200166,7,4,1175,57
2020-05-12,Japan,NA,Kanagawa,9200166,15,2,1190,59
2020-05-13,Japan,NA,Kanagawa,9200166,10,3,1200,62
2020-05-14,Japan,NA,Kanagawa,9200166,32,1,1232,63
2020-05-15,Japan,NA,Kanagawa,9200166,16,1,1248,64
2020-05-16,Japan,NA,Kanagawa,9200166,12,0,1260,64
2020-05-17,Japan,NA,Kanagawa,9200166,5,0,1265,64
2020-05-18,Japan,NA,Kanagawa,9200166,8,4,1273,68
2020-05-19,Japan,NA,Kanagawa,9200166,8,0,1281,68
2020-05-20,Japan,NA,Kanagawa,9200166,21,1,1302,69
2020-05-21,Japan,NA,Kanagawa,9200166,10,2,1312,71
2020-05-22,Japan,NA,Kanagawa,9200166,7,2,1319,73
2020-05-23,Japan,NA,Kanagawa,9200166,5,2,1324,75
2020-05-24,Japan,NA,Kanagawa,9200166,5,1,1329,76
2020-05-25,Japan,NA,Kanagawa,9200166,1,0,1330,76
2020-05-26,Japan,NA,Kanagawa,9200166,3,2,1333,78
2020-05-27,Japan,NA,Kanagawa,9200166,5,1,1338,79
2020-05-28,Japan,NA,Kanagawa,9200166,7,3,1345,82
2020-05-29,Japan,NA,Kanagawa,9200166,11,2,1356,84
2020-05-30,Japan,NA,Kanagawa,9200166,3,1,1359,85
2020-05-31,Japan,NA,Kanagawa,9200166,6,1,1365,86
2020-06-01,Japan,NA,Kanagawa,9200166,1,0,1366,86
2020-06-02,Japan,NA,Kanagawa,9200166,3,0,1369,86
2020-06-03,Japan,NA,Kanagawa,9200166,2,1,1371,87
2020-06-04,Japan,NA,Kanagawa,9200166,6,0,1377,87
2020-06-05,Japan,NA,Kanagawa,9200166,6,0,1383,87
2020-06-06,Japan,NA,Kanagawa,9200166,5,0,1388,87
2020-06-07,Japan,NA,Kanagawa,9200166,5,0,1393,87
2020-06-08,Japan,NA,Kanagawa,9200166,0,1,1393,88
2020-06-09,Japan,NA,Kanagawa,9200166,1,1,1394,89
2020-06-10,Japan,NA,Kanagawa,9200166,0,0,1394,89
2020-06-11,Japan,NA,Kanagawa,9200166,1,0,1395,89
2020-06-12,Japan,NA,Kanagawa,9200166,3,1,1398,90
2020-06-13,Japan,NA,Kanagawa,9200166,6,0,1404,90
2020-06-14,Japan,NA,Kanagawa,9200166,0,0,1404,90
2020-06-15,Japan,NA,Kanagawa,9200166,3,1,1407,91
2020-06-16,Japan,NA,Kanagawa,9200166,2,2,1409,93
2020-06-17,Japan,NA,Kanagawa,9200166,7,0,1416,93
2020-06-18,Japan,NA,Kanagawa,9200166,6,0,1422,93
2020-06-19,Japan,NA,Kanagawa,9200166,2,1,1424,94
2020-06-20,Japan,NA,Kanagawa,9200166,5,0,1429,94
2020-06-21,Japan,NA,Kanagawa,9200166,0,0,1429,94
2020-06-22,Japan,NA,Kanagawa,9200166,0,0,1429,94
2020-06-23,Japan,NA,Kanagawa,9200166,1,0,1430,94
2020-06-24,Japan,NA,Kanagawa,9200166,4,0,1434,94
2020-06-25,Japan,NA,Kanagawa,9200166,6,2,1440,96
2020-06-26,Japan,NA,Kanagawa,9200166,7,0,1447,96
2020-06-27,Japan,NA,Kanagawa,9200166,4,0,1451,96
2020-06-28,Japan,NA,Kanagawa,9200166,10,0,1461,96
2020-06-29,Japan,NA,Kanagawa,9200166,6,0,1467,96
2020-06-30,Japan,NA,Kanagawa,9200166,31,0,1498,96
2020-07-01,Japan,NA,Kanagawa,9200166,8,0,1506,96
2020-07-02,Japan,NA,Kanagawa,9200166,11,0,1517,96
2020-07-03,Japan,NA,Kanagawa,9200166,24,0,1541,96
2020-07-04,Japan,NA,Kanagawa,9200166,20,0,1561,96
2020-07-05,Japan,NA,Kanagawa,9200166,21,0,1582,96
2020-07-06,Japan,NA,Kanagawa,9200166,11,0,1593,96
2020-07-07,Japan,NA,Kanagawa,9200166,8,0,1601,96
2020-07-08,Japan,NA,Kanagawa,9200166,23,1,1624,97
2020-07-09,Japan,NA,Kanagawa,9200166,25,0,1649,97
2020-07-10,Japan,NA,Kanagawa,9200166,32,0,1681,97
2020-07-11,Japan,NA,Kanagawa,9200166,35,1,1716,98
2020-07-12,Japan,NA,Kanagawa,9200166,23,0,1739,98
2020-07-13,Japan,NA,Kanagawa,9200166,16,0,1755,98
2020-07-14,Japan,NA,Kanagawa,9200166,28,0,1783,98
2020-07-15,Japan,NA,Kanagawa,9200166,41,0,1824,98
2020-07-16,Japan,NA,Kanagawa,9200166,48,0,1872,98
2020-07-17,Japan,NA,Kanagawa,9200166,43,0,1915,98
2020-07-18,Japan,NA,Kanagawa,9200166,49,0,1964,98
2020-07-19,Japan,NA,Kanagawa,9200166,30,0,1994,98
2020-07-20,Japan,NA,Kanagawa,9200166,11,0,2005,98
2020-07-21,Japan,NA,Kanagawa,9200166,30,0,2035,98
2020-07-22,Japan,NA,Kanagawa,9200166,68,0,2103,98
2020-07-23,Japan,NA,Kanagawa,9200166,53,0,2156,98
2020-07-24,Japan,NA,Kanagawa,9200166,25,0,2181,98
2020-07-25,Japan,NA,Kanagawa,9200166,18,0,2199,98
2020-07-26,Japan,NA,Kanagawa,9200166,33,0,2232,98
2020-07-27,Japan,NA,Kanagawa,9200166,14,0,2246,98
2020-07-28,Japan,NA,Kanagawa,9200166,33,0,2279,98
2020-07-29,Japan,NA,Kanagawa,9200166,70,1,2349,99
2020-07-30,Japan,NA,Kanagawa,9200166,76,0,2425,99
2020-07-31,Japan,NA,Kanagawa,9200166,53,0,2478,99
2020-08-01,Japan,NA,Kanagawa,9200166,58,0,2536,99
2020-08-02,Japan,NA,Kanagawa,9200166,72,0,2608,99
2020-08-03,Japan,NA,Kanagawa,9200166,48,0,2656,99
2020-08-04,Japan,NA,Kanagawa,9200166,89,0,2745,99
2020-08-05,Japan,NA,Kanagawa,9200166,81,1,2826,100
2020-08-06,Japan,NA,Kanagawa,9200166,119,1,2945,101
2020-08-07,Japan,NA,Kanagawa,9200166,107,2,3052,103
2020-08-08,Japan,NA,Kanagawa,9200166,128,0,3180,103
2020-08-09,Japan,NA,Kanagawa,9200166,81,0,3261,103
2020-08-10,Japan,NA,Kanagawa,9200166,38,0,3299,103
2020-08-11,Japan,NA,Kanagawa,9200166,27,1,3326,104
2020-08-12,Japan,NA,Kanagawa,9200166,66,0,3392,104
2020-08-13,Japan,NA,Kanagawa,9200166,123,1,3515,105
2020-08-14,Japan,NA,Kanagawa,9200166,117,0,3632,105
2020-08-15,Japan,NA,Kanagawa,9200166,136,0,3768,105
2020-08-16,Japan,NA,Kanagawa,9200166,80,0,3848,105
2020-08-17,Japan,NA,Kanagawa,9200166,50,1,3898,106
2020-08-18,Japan,NA,Kanagawa,9200166,84,0,3982,106
2020-08-19,Japan,NA,Kanagawa,9200166,95,0,4077,106
2020-08-20,Japan,NA,Kanagawa,9200166,104,1,4181,107
2020-08-21,Japan,NA,Kanagawa,9200166,82,1,4263,108
2020-08-22,Japan,NA,Kanagawa,9200166,101,0,4364,108
2020-08-23,Japan,NA,Kanagawa,9200166,49,0,4413,108
2020-08-24,Japan,NA,Kanagawa,9200166,39,4,4452,112
2020-08-25,Japan,NA,Kanagawa,9200166,56,3,4508,115
2020-08-26,Japan,NA,Kanagawa,9200166,85,1,4593,116
2020-08-27,Japan,NA,Kanagawa,9200166,66,0,4659,116
2020-08-28,Japan,NA,Kanagawa,9200166,75,0,4734,116
2020-08-29,Japan,NA,Kanagawa,9200166,106,2,4840,118
2020-08-30,Japan,NA,Kanagawa,9200166,64,4,4904,122
2020-08-31,Japan,NA,Kanagawa,9200166,50,1,4954,123
2020-09-01,Japan,NA,Kanagawa,9200166,59,1,5013,124
2020-09-02,Japan,NA,Kanagawa,9200166,76,0,5089,124
2020-09-03,Japan,NA,Kanagawa,9200166,81,2,5170,126
2020-09-04,Japan,NA,Kanagawa,9200166,108,0,5278,126
2020-09-05,Japan,NA,Kanagawa,9200166,67,0,5345,126
2020-09-06,Japan,NA,Kanagawa,9200166,79,0,5424,126
2020-09-07,Japan,NA,Kanagawa,9200166,29,0,5453,126
2020-09-08,Japan,NA,Kanagawa,9200166,63,0,5516,126
2020-09-09,Japan,NA,Kanagawa,9200166,106,0,5622,126
2020-09-10,Japan,NA,Kanagawa,9200166,112,0,5734,126
2020-09-11,Japan,NA,Kanagawa,9200166,82,0,5816,126
2020-09-12,Japan,NA,Kanagawa,9200166,68,1,5884,127
2020-09-13,Japan,NA,Kanagawa,9200166,53,1,5937,128
2020-09-14,Japan,NA,Kanagawa,9200166,15,1,5952,129
2020-09-15,Japan,NA,Kanagawa,9200166,52,0,6004,129
2020-09-16,Japan,NA,Kanagawa,9200166,101,1,6105,130
2020-09-17,Japan,NA,Kanagawa,9200166,65,5,6170,135
2020-09-18,Japan,NA,Kanagawa,9200166,78,0,6248,135
2020-09-19,Japan,NA,Kanagawa,9200166,68,0,6316,135
2020-09-20,Japan,NA,Kanagawa,9200166,60,0,6376,135
2020-09-21,Japan,NA,Kanagawa,9200166,20,0,6396,135
2020-09-22,Japan,NA,Kanagawa,9200166,38,1,6434,136
2020-09-23,Japan,NA,Kanagawa,9200166,11,0,6445,136
2020-03-28,Japan,NA,Kumamoto,1746740,1,0,11,0
2020-03-29,Japan,NA,Kumamoto,1746740,1,0,12,0
2020-03-30,Japan,NA,Kumamoto,1746740,2,0,14,0
2020-03-31,Japan,NA,Kumamoto,1746740,0,0,14,0
2020-04-01,Japan,NA,Kumamoto,1746740,1,0,15,0
2020-04-02,Japan,NA,Kumamoto,1746740,0,0,15,0
2020-04-03,Japan,NA,Kumamoto,1746740,3,0,18,0
2020-04-04,Japan,NA,Kumamoto,1746740,0,0,18,0
2020-04-05,Japan,NA,Kumamoto,1746740,1,0,19,0
2020-04-06,Japan,NA,Kumamoto,1746740,0,0,19,0
2020-04-07,Japan,NA,Kumamoto,1746740,2,0,21,0
2020-04-08,Japan,NA,Kumamoto,1746740,1,0,22,0
2020-04-09,Japan,NA,Kumamoto,1746740,1,0,23,0
2020-04-10,Japan,NA,Kumamoto,1746740,1,1,24,1
2020-04-11,Japan,NA,Kumamoto,1746740,1,0,25,1
2020-04-12,Japan,NA,Kumamoto,1746740,2,0,27,1
2020-04-13,Japan,NA,Kumamoto,1746740,1,0,28,1
2020-04-14,Japan,NA,Kumamoto,1746740,3,0,31,1
2020-04-15,Japan,NA,Kumamoto,1746740,2,0,33,1
2020-04-16,Japan,NA,Kumamoto,1746740,0,0,33,1
2020-04-17,Japan,NA,Kumamoto,1746740,2,0,35,1
2020-04-18,Japan,NA,Kumamoto,1746740,2,0,37,1
2020-04-19,Japan,NA,Kumamoto,1746740,3,0,40,1
2020-04-20,Japan,NA,Kumamoto,1746740,1,0,41,1
2020-04-21,Japan,NA,Kumamoto,1746740,1,0,42,1
2020-04-22,Japan,NA,Kumamoto,1746740,1,0,43,1
2020-04-23,Japan,NA,Kumamoto,1746740,1,0,44,1
2020-04-24,Japan,NA,Kumamoto,1746740,1,0,45,1
2020-04-25,Japan,NA,Kumamoto,1746740,0,0,45,1
2020-04-26,Japan,NA,Kumamoto,1746740,1,0,46,1
2020-04-27,Japan,NA,Kumamoto,1746740,0,0,46,1
2020-04-28,Japan,NA,Kumamoto,1746740,0,0,46,1
2020-04-29,Japan,NA,Kumamoto,1746740,0,0,46,1
2020-04-30,Japan,NA,Kumamoto,1746740,0,0,46,1
2020-05-01,Japan,NA,Kumamoto,1746740,0,0,46,1
2020-05-02,Japan,NA,Kumamoto,1746740,0,0,46,1
2020-05-03,Japan,NA,Kumamoto,1746740,0,1,46,2
2020-05-04,Japan,NA,Kumamoto,1746740,0,0,46,2
2020-05-05,Japan,NA,Kumamoto,1746740,0,0,46,2
2020-05-06,Japan,NA,Kumamoto,1746740,0,0,46,2
2020-05-07,Japan,NA,Kumamoto,1746740,0,0,46,2
2020-05-08,Japan,NA,Kumamoto,1746740,1,0,47,2
2020-05-09,Japan,NA,Kumamoto,1746740,0,1,47,3
2020-05-10,Japan,NA,Kumamoto,1746740,0,0,47,3
2020-05-11,Japan,NA,Kumamoto,1746740,0,0,47,3
2020-05-12,Japan,NA,Kumamoto,1746740,0,0,47,3
2020-05-13,Japan,NA,Kumamoto,1746740,0,0,47,3
2020-05-14,Japan,NA,Kumamoto,1746740,0,0,47,3
2020-05-15,Japan,NA,Kumamoto,1746740,0,0,47,3
2020-05-16,Japan,NA,Kumamoto,1746740,0,0,47,3
2020-05-17,Japan,NA,Kumamoto,1746740,0,0,47,3
2020-05-18,Japan,NA,Kumamoto,1746740,0,0,47,3
2020-05-19,Japan,NA,Kumamoto,1746740,0,0,47,3
2020-05-20,Japan,NA,Kumamoto,1746740,0,0,47,3
2020-05-21,Japan,NA,Kumamoto,1746740,0,0,47,3
2020-05-22,Japan,NA,Kumamoto,1746740,0,0,47,3
2020-05-23,Japan,NA,Kumamoto,1746740,0,0,47,3
2020-05-24,Japan,NA,Kumamoto,1746740,0,0,47,3
2020-05-25,Japan,NA,Kumamoto,1746740,0,0,47,3
2020-05-26,Japan,NA,Kumamoto,1746740,0,0,47,3
2020-05-27,Japan,NA,Kumamoto,1746740,0,0,47,3
2020-05-28,Japan,NA,Kumamoto,1746740,0,0,47,3
2020-05-29,Japan,NA,Kumamoto,1746740,0,0,47,3
2020-05-30,Japan,NA,Kumamoto,1746740,0,0,47,3
2020-05-31,Japan,NA,Kumamoto,1746740,0,0,47,3
2020-06-01,Japan,NA,Kumamoto,1746740,0,0,47,3
2020-06-02,Japan,NA,Kumamoto,1746740,0,0,47,3
2020-06-03,Japan,NA,Kumamoto,1746740,0,0,47,3
2020-06-04,Japan,NA,Kumamoto,1746740,0,0,47,3
2020-06-05,Japan,NA,Kumamoto,1746740,0,0,47,3
2020-06-06,Japan,NA,Kumamoto,1746740,0,0,47,3
2020-06-07,Japan,NA,Kumamoto,1746740,0,0,47,3
2020-06-08,Japan,NA,Kumamoto,1746740,0,0,47,3
2020-06-09,Japan,NA,Kumamoto,1746740,0,0,47,3
2020-06-10,Japan,NA,Kumamoto,1746740,0,0,47,3
2020-06-11,Japan,NA,Kumamoto,1746740,0,0,47,3
2020-06-12,Japan,NA,Kumamoto,1746740,0,0,47,3
2020-06-13,Japan,NA,Kumamoto,1746740,0,0,47,3
2020-06-14,Japan,NA,Kumamoto,1746740,0,0,47,3
2020-06-15,Japan,NA,Kumamoto,1746740,0,0,47,3
2020-06-16,Japan,NA,Kumamoto,1746740,0,0,47,3
2020-06-17,Japan,NA,Kumamoto,1746740,0,0,47,3
2020-06-18,Japan,NA,Kumamoto,1746740,0,0,47,3
2020-06-19,Japan,NA,Kumamoto,1746740,0,0,47,3
2020-06-20,Japan,NA,Kumamoto,1746740,0,0,47,3
2020-06-21,Japan,NA,Kumamoto,1746740,0,0,47,3
2020-06-22,Japan,NA,Kumamoto,1746740,1,0,48,3
2020-06-23,Japan,NA,Kumamoto,1746740,0,0,48,3
2020-06-24,Japan,NA,Kumamoto,1746740,0,0,48,3
2020-06-25,Japan,NA,Kumamoto,1746740,0,0,48,3
2020-06-26,Japan,NA,Kumamoto,1746740,0,0,48,3
2020-06-27,Japan,NA,Kumamoto,1746740,0,0,48,3
2020-06-28,Japan,NA,Kumamoto,1746740,0,0,48,3
2020-06-29,Japan,NA,Kumamoto,1746740,0,0,48,3
2020-06-30,Japan,NA,Kumamoto,1746740,0,0,48,3
2020-07-01,Japan,NA,Kumamoto,1746740,0,0,48,3
2020-07-02,Japan,NA,Kumamoto,1746740,0,0,48,3
2020-07-03,Japan,NA,Kumamoto,1746740,0,0,48,3
2020-07-04,Japan,NA,Kumamoto,1746740,0,0,48,3
2020-07-05,Japan,NA,Kumamoto,1746740,0,0,48,3
2020-07-06,Japan,NA,Kumamoto,1746740,0,0,48,3
2020-07-07,Japan,NA,Kumamoto,1746740,0,0,48,3
2020-07-08,Japan,NA,Kumamoto,1746740,0,0,48,3
2020-07-09,Japan,NA,Kumamoto,1746740,0,0,48,3
2020-07-10,Japan,NA,Kumamoto,1746740,0,0,48,3
2020-07-11,Japan,NA,Kumamoto,1746740,0,0,48,3
2020-07-12,Japan,NA,Kumamoto,1746740,0,0,48,3
2020-07-13,Japan,NA,Kumamoto,1746740,0,0,48,3
2020-07-14,Japan,NA,Kumamoto,1746740,0,0,48,3
2020-07-15,Japan,NA,Kumamoto,1746740,0,0,48,3
2020-07-16,Japan,NA,Kumamoto,1746740,1,0,49,3
2020-07-17,Japan,NA,Kumamoto,1746740,0,0,49,3
2020-07-18,Japan,NA,Kumamoto,1746740,0,0,49,3
2020-07-19,Japan,NA,Kumamoto,1746740,0,0,49,3
2020-07-20,Japan,NA,Kumamoto,1746740,1,0,50,3
2020-07-21,Japan,NA,Kumamoto,1746740,1,0,51,3
2020-07-22,Japan,NA,Kumamoto,1746740,2,0,53,3
2020-07-23,Japan,NA,Kumamoto,1746740,3,0,56,3
2020-07-24,Japan,NA,Kumamoto,1746740,1,0,57,3
2020-07-25,Japan,NA,Kumamoto,1746740,2,0,59,3
2020-07-26,Japan,NA,Kumamoto,1746740,21,0,80,3
2020-07-27,Japan,NA,Kumamoto,1746740,33,0,113,3
2020-07-28,Japan,NA,Kumamoto,1746740,22,0,135,3
2020-07-29,Japan,NA,Kumamoto,1746740,21,0,156,3
2020-07-30,Japan,NA,Kumamoto,1746740,16,0,172,3
2020-07-31,Japan,NA,Kumamoto,1746740,18,0,190,3
2020-08-01,Japan,NA,Kumamoto,1746740,26,0,216,3
2020-08-02,Japan,NA,Kumamoto,1746740,20,0,236,3
2020-08-03,Japan,NA,Kumamoto,1746740,6,1,242,4
2020-08-04,Japan,NA,Kumamoto,1746740,37,0,279,4
2020-08-05,Japan,NA,Kumamoto,1746740,42,1,321,5
2020-08-06,Japan,NA,Kumamoto,1746740,10,0,331,5
2020-08-07,Japan,NA,Kumamoto,1746740,9,0,340,5
2020-08-08,Japan,NA,Kumamoto,1746740,10,0,350,5
2020-08-09,Japan,NA,Kumamoto,1746740,3,0,353,5
2020-08-10,Japan,NA,Kumamoto,1746740,3,0,356,5
2020-08-11,Japan,NA,Kumamoto,1746740,4,0,360,5
2020-08-12,Japan,NA,Kumamoto,1746740,10,0,370,5
2020-08-13,Japan,NA,Kumamoto,1746740,9,0,379,5
2020-08-14,Japan,NA,Kumamoto,1746740,12,0,391,5
2020-08-15,Japan,NA,Kumamoto,1746740,11,1,402,6
2020-08-16,Japan,NA,Kumamoto,1746740,4,0,406,6
2020-08-17,Japan,NA,Kumamoto,1746740,5,0,411,6
2020-08-18,Japan,NA,Kumamoto,1746740,5,1,416,7
2020-08-19,Japan,NA,Kumamoto,1746740,10,0,426,7
2020-08-20,Japan,NA,Kumamoto,1746740,15,0,441,7
2020-08-21,Japan,NA,Kumamoto,1746740,13,0,454,7
2020-08-22,Japan,NA,Kumamoto,1746740,11,0,465,7
2020-08-23,Japan,NA,Kumamoto,1746740,5,0,470,7
2020-08-24,Japan,NA,Kumamoto,1746740,4,0,474,7
2020-08-25,Japan,NA,Kumamoto,1746740,5,0,479,7
2020-08-26,Japan,NA,Kumamoto,1746740,5,0,484,7
2020-08-27,Japan,NA,Kumamoto,1746740,6,0,490,7
2020-08-28,Japan,NA,Kumamoto,1746740,7,0,497,7
2020-08-29,Japan,NA,Kumamoto,1746740,11,0,508,7
2020-08-30,Japan,NA,Kumamoto,1746740,2,0,510,7
2020-08-31,Japan,NA,Kumamoto,1746740,9,0,519,7
2020-09-01,Japan,NA,Kumamoto,1746740,4,0,523,7
2020-09-02,Japan,NA,Kumamoto,1746740,4,0,527,7
2020-09-03,Japan,NA,Kumamoto,1746740,6,0,533,7
2020-09-04,Japan,NA,Kumamoto,1746740,3,0,536,7
2020-09-05,Japan,NA,Kumamoto,1746740,6,0,542,7
2020-09-06,Japan,NA,Kumamoto,1746740,2,1,544,8
2020-09-07,Japan,NA,Kumamoto,1746740,2,0,546,8
2020-09-08,Japan,NA,Kumamoto,1746740,3,0,549,8
2020-09-09,Japan,NA,Kumamoto,1746740,3,0,552,8
2020-09-10,Japan,NA,Kumamoto,1746740,4,0,556,8
2020-09-11,Japan,NA,Kumamoto,1746740,7,0,563,8
2020-09-12,Japan,NA,Kumamoto,1746740,4,0,567,8
2020-09-13,Japan,NA,Kumamoto,1746740,1,0,568,8
2020-09-14,Japan,NA,Kumamoto,1746740,0,0,568,8
2020-09-15,Japan,NA,Kumamoto,1746740,1,0,569,8
2020-09-16,Japan,NA,Kumamoto,1746740,0,0,569,8
2020-09-17,Japan,NA,Kumamoto,1746740,0,0,569,8
2020-09-18,Japan,NA,Kumamoto,1746740,1,0,570,8
2020-03-09,Japan,NA,Kyoto,2583140,4,0,12,0
2020-03-10,Japan,NA,Kyoto,2583140,1,0,13,0
2020-03-11,Japan,NA,Kyoto,2583140,2,0,15,0
2020-03-12,Japan,NA,Kyoto,2583140,2,0,17,0
2020-03-13,Japan,NA,Kyoto,2583140,0,0,17,0
2020-03-14,Japan,NA,Kyoto,2583140,0,0,17,0
2020-03-15,Japan,NA,Kyoto,2583140,0,0,17,0
2020-03-16,Japan,NA,Kyoto,2583140,0,0,17,0
2020-03-17,Japan,NA,Kyoto,2583140,2,0,19,0
2020-03-18,Japan,NA,Kyoto,2583140,2,0,21,0
2020-03-19,Japan,NA,Kyoto,2583140,0,0,21,0
2020-03-20,Japan,NA,Kyoto,2583140,1,0,22,0
2020-03-21,Japan,NA,Kyoto,2583140,1,0,23,0
2020-03-22,Japan,NA,Kyoto,2583140,1,0,24,0
2020-03-23,Japan,NA,Kyoto,2583140,1,0,25,0
2020-03-24,Japan,NA,Kyoto,2583140,2,0,27,0
2020-03-25,Japan,NA,Kyoto,2583140,4,0,31,0
2020-03-26,Japan,NA,Kyoto,2583140,3,0,34,0
2020-03-27,Japan,NA,Kyoto,2583140,1,0,35,0
2020-03-28,Japan,NA,Kyoto,2583140,5,0,40,0
2020-03-29,Japan,NA,Kyoto,2583140,7,0,47,0
2020-03-30,Japan,NA,Kyoto,2583140,9,0,56,0
2020-03-31,Japan,NA,Kyoto,2583140,13,0,69,0
2020-04-01,Japan,NA,Kyoto,2583140,7,0,76,0
2020-04-02,Japan,NA,Kyoto,2583140,12,0,88,0
2020-04-03,Japan,NA,Kyoto,2583140,18,0,106,0
2020-04-04,Japan,NA,Kyoto,2583140,10,0,116,0
2020-04-05,Japan,NA,Kyoto,2583140,9,0,125,0
2020-04-06,Japan,NA,Kyoto,2583140,8,0,133,0
2020-04-07,Japan,NA,Kyoto,2583140,12,0,145,0
2020-04-08,Japan,NA,Kyoto,2583140,10,0,155,0
2020-04-09,Japan,NA,Kyoto,2583140,10,1,165,1
2020-04-10,Japan,NA,Kyoto,2583140,9,0,174,1
2020-04-11,Japan,NA,Kyoto,2583140,7,2,181,3
2020-04-12,Japan,NA,Kyoto,2583140,12,0,193,3
2020-04-13,Japan,NA,Kyoto,2583140,12,0,205,3
2020-04-14,Japan,NA,Kyoto,2583140,5,0,210,3
2020-04-15,Japan,NA,Kyoto,2583140,5,0,215,3
2020-04-16,Japan,NA,Kyoto,2583140,10,0,225,3
2020-04-17,Japan,NA,Kyoto,2583140,10,0,235,3
2020-04-18,Japan,NA,Kyoto,2583140,7,0,242,3
2020-04-19,Japan,NA,Kyoto,2583140,9,0,251,3
2020-04-20,Japan,NA,Kyoto,2583140,8,2,259,5
2020-04-21,Japan,NA,Kyoto,2583140,5,1,264,6
2020-04-22,Japan,NA,Kyoto,2583140,11,2,275,8
2020-04-23,Japan,NA,Kyoto,2583140,7,0,282,8
2020-04-24,Japan,NA,Kyoto,2583140,4,0,286,8
2020-04-25,Japan,NA,Kyoto,2583140,4,0,290,8
2020-04-26,Japan,NA,Kyoto,2583140,4,0,294,8
2020-04-27,Japan,NA,Kyoto,2583140,15,1,309,9
2020-04-28,Japan,NA,Kyoto,2583140,4,0,313,9
2020-04-29,Japan,NA,Kyoto,2583140,4,1,317,10
2020-04-30,Japan,NA,Kyoto,2583140,3,0,320,10
2020-05-01,Japan,NA,Kyoto,2583140,4,1,324,11
2020-05-02,Japan,NA,Kyoto,2583140,5,1,329,12
2020-05-03,Japan,NA,Kyoto,2583140,2,0,331,12
2020-05-04,Japan,NA,Kyoto,2583140,3,0,334,12
2020-05-05,Japan,NA,Kyoto,2583140,4,1,338,13
2020-05-06,Japan,NA,Kyoto,2583140,3,0,341,13
2020-05-07,Japan,NA,Kyoto,2583140,6,0,347,13
2020-05-08,Japan,NA,Kyoto,2583140,1,0,348,13
2020-05-09,Japan,NA,Kyoto,2583140,4,0,352,13
2020-05-10,Japan,NA,Kyoto,2583140,0,0,352,13
2020-05-11,Japan,NA,Kyoto,2583140,0,0,352,13
2020-05-12,Japan,NA,Kyoto,2583140,4,0,356,13
2020-05-13,Japan,NA,Kyoto,2583140,1,0,357,13
2020-05-14,Japan,NA,Kyoto,2583140,1,0,358,13
2020-05-15,Japan,NA,Kyoto,2583140,0,0,358,13
2020-05-16,Japan,NA,Kyoto,2583140,0,1,358,14
2020-05-17,Japan,NA,Kyoto,2583140,0,0,358,14
2020-05-18,Japan,NA,Kyoto,2583140,0,0,358,14
2020-05-19,Japan,NA,Kyoto,2583140,0,0,358,14
2020-05-20,Japan,NA,Kyoto,2583140,0,0,358,14
2020-05-21,Japan,NA,Kyoto,2583140,0,0,358,14
2020-05-22,Japan,NA,Kyoto,2583140,0,0,358,14
2020-05-23,Japan,NA,Kyoto,2583140,0,0,358,14
2020-05-24,Japan,NA,Kyoto,2583140,0,1,358,15
2020-05-25,Japan,NA,Kyoto,2583140,0,0,358,15
2020-05-26,Japan,NA,Kyoto,2583140,0,1,358,16
2020-05-27,Japan,NA,Kyoto,2583140,0,0,358,16
2020-05-28,Japan,NA,Kyoto,2583140,0,1,358,17
2020-05-29,Japan,NA,Kyoto,2583140,0,0,358,17
2020-05-30,Japan,NA,Kyoto,2583140,0,0,358,17
2020-05-31,Japan,NA,Kyoto,2583140,0,0,358,17
2020-06-01,Japan,NA,Kyoto,2583140,0,0,358,17
2020-06-02,Japan,NA,Kyoto,2583140,0,0,358,17
2020-06-03,Japan,NA,Kyoto,2583140,0,0,358,17
2020-06-04,Japan,NA,Kyoto,2583140,0,1,358,18
2020-06-05,Japan,NA,Kyoto,2583140,0,0,358,18
2020-06-06,Japan,NA,Kyoto,2583140,1,0,359,18
2020-06-07,Japan,NA,Kyoto,2583140,0,0,359,18
2020-06-08,Japan,NA,Kyoto,2583140,0,0,359,18
2020-06-09,Japan,NA,Kyoto,2583140,1,0,360,18
2020-06-10,Japan,NA,Kyoto,2583140,0,0,360,18
2020-06-11,Japan,NA,Kyoto,2583140,0,0,360,18
2020-06-12,Japan,NA,Kyoto,2583140,0,0,360,18
2020-06-13,Japan,NA,Kyoto,2583140,0,0,360,18
2020-06-14,Japan,NA,Kyoto,2583140,0,0,360,18
2020-06-15,Japan,NA,Kyoto,2583140,0,0,360,18
2020-06-16,Japan,NA,Kyoto,2583140,3,0,363,18
2020-06-17,Japan,NA,Kyoto,2583140,0,0,363,18
2020-06-18,Japan,NA,Kyoto,2583140,0,0,363,18
2020-06-19,Japan,NA,Kyoto,2583140,1,0,364,18
2020-06-20,Japan,NA,Kyoto,2583140,1,0,365,18
2020-06-21,Japan,NA,Kyoto,2583140,0,0,365,18
2020-06-22,Japan,NA,Kyoto,2583140,0,0,365,18
2020-06-23,Japan,NA,Kyoto,2583140,0,0,365,18
2020-06-24,Japan,NA,Kyoto,2583140,0,0,365,18
2020-06-25,Japan,NA,Kyoto,2583140,1,0,366,18
2020-06-26,Japan,NA,Kyoto,2583140,4,0,370,18
2020-06-27,Japan,NA,Kyoto,2583140,4,0,374,18
2020-06-28,Japan,NA,Kyoto,2583140,1,0,375,18
2020-06-29,Japan,NA,Kyoto,2583140,4,0,379,18
2020-06-30,Japan,NA,Kyoto,2583140,2,0,381,18
2020-07-01,Japan,NA,Kyoto,2583140,2,0,383,18
2020-07-02,Japan,NA,Kyoto,2583140,3,0,386,18
2020-07-03,Japan,NA,Kyoto,2583140,5,0,391,18
2020-07-04,Japan,NA,Kyoto,2583140,9,0,400,18
2020-07-05,Japan,NA,Kyoto,2583140,1,0,401,18
2020-07-06,Japan,NA,Kyoto,2583140,3,0,404,18
2020-07-07,Japan,NA,Kyoto,2583140,9,0,413,18
2020-07-08,Japan,NA,Kyoto,2583140,2,0,415,18
2020-07-09,Japan,NA,Kyoto,2583140,5,0,420,18
2020-07-10,Japan,NA,Kyoto,2583140,10,0,430,18
2020-07-11,Japan,NA,Kyoto,2583140,9,0,439,18
2020-07-12,Japan,NA,Kyoto,2583140,8,0,447,18
2020-07-13,Japan,NA,Kyoto,2583140,9,0,456,18
2020-07-14,Japan,NA,Kyoto,2583140,12,0,468,18
2020-07-15,Japan,NA,Kyoto,2583140,9,0,477,18
2020-07-16,Japan,NA,Kyoto,2583140,13,0,490,18
2020-07-17,Japan,NA,Kyoto,2583140,12,0,502,18
2020-07-18,Japan,NA,Kyoto,2583140,25,0,527,18
2020-07-19,Japan,NA,Kyoto,2583140,12,0,539,18
2020-07-20,Japan,NA,Kyoto,2583140,27,0,566,18
2020-07-21,Japan,NA,Kyoto,2583140,20,0,586,18
2020-07-22,Japan,NA,Kyoto,2583140,19,0,605,18
2020-07-23,Japan,NA,Kyoto,2583140,19,0,624,18
2020-07-24,Japan,NA,Kyoto,2583140,16,1,640,19
2020-07-25,Japan,NA,Kyoto,2583140,4,0,644,19
2020-07-26,Japan,NA,Kyoto,2583140,13,0,657,19
2020-07-27,Japan,NA,Kyoto,2583140,20,1,677,20
2020-07-28,Japan,NA,Kyoto,2583140,31,0,708,20
2020-07-29,Japan,NA,Kyoto,2583140,41,0,749,20
2020-07-30,Japan,NA,Kyoto,2583140,9,0,758,20
2020-07-31,Japan,NA,Kyoto,2583140,29,0,787,20
2020-08-01,Japan,NA,Kyoto,2583140,22,0,809,20
2020-08-02,Japan,NA,Kyoto,2583140,17,0,826,20
2020-08-03,Japan,NA,Kyoto,2583140,29,0,855,20
2020-08-04,Japan,NA,Kyoto,2583140,21,1,876,21
2020-08-05,Japan,NA,Kyoto,2583140,27,0,903,21
2020-08-06,Japan,NA,Kyoto,2583140,20,0,923,21
2020-08-07,Japan,NA,Kyoto,2583140,19,0,942,21
2020-08-08,Japan,NA,Kyoto,2583140,21,0,963,21
2020-08-09,Japan,NA,Kyoto,2583140,20,0,983,21
2020-08-10,Japan,NA,Kyoto,2583140,8,0,991,21
2020-08-11,Japan,NA,Kyoto,2583140,10,0,1001,21
2020-08-12,Japan,NA,Kyoto,2583140,25,0,1026,21
2020-08-13,Japan,NA,Kyoto,2583140,35,0,1061,21
2020-08-14,Japan,NA,Kyoto,2583140,30,0,1091,21
2020-08-15,Japan,NA,Kyoto,2583140,22,0,1113,21
2020-08-16,Japan,NA,Kyoto,2583140,6,0,1119,21
2020-08-17,Japan,NA,Kyoto,2583140,19,0,1138,21
2020-08-18,Japan,NA,Kyoto,2583140,26,0,1164,21
2020-08-19,Japan,NA,Kyoto,2583140,38,0,1202,21
2020-08-20,Japan,NA,Kyoto,2583140,41,0,1243,21
2020-08-21,Japan,NA,Kyoto,2583140,38,0,1281,21
2020-08-22,Japan,NA,Kyoto,2583140,25,0,1306,21
2020-08-23,Japan,NA,Kyoto,2583140,13,0,1319,21
2020-08-24,Japan,NA,Kyoto,2583140,7,0,1326,21
2020-08-25,Japan,NA,Kyoto,2583140,17,1,1343,22
2020-08-26,Japan,NA,Kyoto,2583140,31,0,1374,22
2020-08-27,Japan,NA,Kyoto,2583140,27,0,1401,22
2020-08-28,Japan,NA,Kyoto,2583140,21,0,1422,22
2020-08-29,Japan,NA,Kyoto,2583140,17,0,1439,22
2020-08-30,Japan,NA,Kyoto,2583140,9,1,1448,23
2020-08-31,Japan,NA,Kyoto,2583140,4,0,1452,23
2020-09-01,Japan,NA,Kyoto,2583140,22,0,1474,23
2020-09-02,Japan,NA,Kyoto,2583140,19,2,1493,25
2020-09-03,Japan,NA,Kyoto,2583140,19,0,1512,25
2020-09-04,Japan,NA,Kyoto,2583140,24,0,1536,25
2020-09-05,Japan,NA,Kyoto,2583140,25,0,1561,25
2020-09-06,Japan,NA,Kyoto,2583140,14,0,1575,25
2020-09-07,Japan,NA,Kyoto,2583140,8,0,1583,25
2020-09-08,Japan,NA,Kyoto,2583140,11,0,1594,25
2020-09-09,Japan,NA,Kyoto,2583140,6,0,1600,25
2020-09-10,Japan,NA,Kyoto,2583140,7,0,1607,25
2020-09-11,Japan,NA,Kyoto,2583140,2,0,1609,25
2020-09-12,Japan,NA,Kyoto,2583140,7,0,1616,25
2020-09-13,Japan,NA,Kyoto,2583140,8,0,1624,25
2020-09-14,Japan,NA,Kyoto,2583140,4,0,1628,25
2020-09-15,Japan,NA,Kyoto,2583140,13,0,1641,25
2020-09-16,Japan,NA,Kyoto,2583140,9,0,1650,25
2020-09-17,Japan,NA,Kyoto,2583140,9,0,1659,25
2020-09-18,Japan,NA,Kyoto,2583140,5,0,1664,25
2020-09-19,Japan,NA,Kyoto,2583140,8,0,1672,25
2020-09-20,Japan,NA,Kyoto,2583140,18,0,1690,25
2020-09-21,Japan,NA,Kyoto,2583140,5,0,1695,25
2020-09-22,Japan,NA,Kyoto,2583140,7,0,1702,25
2020-09-23,Japan,NA,Kyoto,2583140,3,0,1705,25
2020-03-28,Japan,NA,Nara,1331330,2,0,11,0
2020-03-29,Japan,NA,Nara,1331330,0,0,11,0
2020-03-30,Japan,NA,Nara,1331330,0,0,11,0
2020-03-31,Japan,NA,Nara,1331330,0,0,11,0
2020-04-01,Japan,NA,Nara,1331330,4,0,15,0
2020-04-02,Japan,NA,Nara,1331330,4,0,19,0
2020-04-03,Japan,NA,Nara,1331330,2,0,21,0
2020-04-04,Japan,NA,Nara,1331330,3,0,24,0
2020-04-05,Japan,NA,Nara,1331330,1,0,25,0
2020-04-06,Japan,NA,Nara,1331330,1,0,26,0
2020-04-07,Japan,NA,Nara,1331330,2,0,28,0
2020-04-08,Japan,NA,Nara,1331330,2,0,30,0
2020-04-09,Japan,NA,Nara,1331330,4,0,34,0
2020-04-10,Japan,NA,Nara,1331330,3,0,37,0
2020-04-11,Japan,NA,Nara,1331330,2,0,39,0
2020-04-12,Japan,NA,Nara,1331330,2,0,41,0
2020-04-13,Japan,NA,Nara,1331330,3,0,44,0
2020-04-14,Japan,NA,Nara,1331330,3,0,47,0
2020-04-15,Japan,NA,Nara,1331330,6,1,53,1
2020-04-16,Japan,NA,Nara,1331330,1,0,54,1
2020-04-17,Japan,NA,Nara,1331330,2,0,56,1
2020-04-18,Japan,NA,Nara,1331330,3,0,59,1
2020-04-19,Japan,NA,Nara,1331330,2,0,61,1
2020-04-20,Japan,NA,Nara,1331330,2,0,63,1
2020-04-21,Japan,NA,Nara,1331330,8,0,71,1
2020-04-22,Japan,NA,Nara,1331330,1,0,72,1
2020-04-23,Japan,NA,Nara,1331330,1,0,73,1
2020-04-24,Japan,NA,Nara,1331330,0,0,73,1
2020-04-25,Japan,NA,Nara,1331330,0,0,73,1
2020-04-26,Japan,NA,Nara,1331330,0,0,73,1
2020-04-27,Japan,NA,Nara,1331330,2,0,75,1
2020-04-28,Japan,NA,Nara,1331330,2,0,77,1
2020-04-29,Japan,NA,Nara,1331330,2,0,79,1
2020-04-30,Japan,NA,Nara,1331330,0,0,79,1
2020-05-01,Japan,NA,Nara,1331330,3,0,82,1
2020-05-02,Japan,NA,Nara,1331330,0,0,82,1
2020-05-03,Japan,NA,Nara,1331330,1,0,83,1
2020-05-04,Japan,NA,Nara,1331330,0,1,83,2
2020-05-05,Japan,NA,Nara,1331330,1,0,84,2
2020-05-06,Japan,NA,Nara,1331330,0,0,84,2
2020-05-07,Japan,NA,Nara,1331330,0,0,84,2
2020-05-08,Japan,NA,Nara,1331330,1,0,85,2
2020-05-09,Japan,NA,Nara,1331330,1,0,86,2
2020-05-10,Japan,NA,Nara,1331330,0,0,86,2
2020-05-11,Japan,NA,Nara,1331330,0,0,86,2
2020-05-12,Japan,NA,Nara,1331330,0,0,86,2
2020-05-13,Japan,NA,Nara,1331330,0,0,86,2
2020-05-14,Japan,NA,Nara,1331330,0,0,86,2
2020-05-15,Japan,NA,Nara,1331330,0,0,86,2
2020-05-16,Japan,NA,Nara,1331330,0,0,86,2
2020-05-17,Japan,NA,Nara,1331330,0,0,86,2
2020-05-18,Japan,NA,Nara,1331330,0,0,86,2
2020-05-19,Japan,NA,Nara,1331330,0,0,86,2
2020-05-20,Japan,NA,Nara,1331330,0,0,86,2
2020-05-21,Japan,NA,Nara,1331330,0,0,86,2
2020-05-22,Japan,NA,Nara,1331330,0,0,86,2
2020-05-23,Japan,NA,Nara,1331330,0,0,86,2
2020-05-24,Japan,NA,Nara,1331330,0,0,86,2
2020-05-25,Japan,NA,Nara,1331330,0,0,86,2
2020-05-26,Japan,NA,Nara,1331330,0,0,86,2
2020-05-27,Japan,NA,Nara,1331330,1,0,87,2
2020-05-28,Japan,NA,Nara,1331330,0,0,87,2
2020-05-29,Japan,NA,Nara,1331330,0,0,87,2
2020-05-30,Japan,NA,Nara,1331330,0,0,87,2
2020-05-31,Japan,NA,Nara,1331330,0,0,87,2
2020-06-01,Japan,NA,Nara,1331330,0,0,87,2
2020-06-02,Japan,NA,Nara,1331330,0,0,87,2
2020-06-03,Japan,NA,Nara,1331330,0,0,87,2
2020-06-04,Japan,NA,Nara,1331330,0,0,87,2
2020-06-05,Japan,NA,Nara,1331330,0,0,87,2
2020-06-06,Japan,NA,Nara,1331330,0,0,87,2
2020-06-07,Japan,NA,Nara,1331330,0,0,87,2
2020-06-08,Japan,NA,Nara,1331330,0,0,87,2
2020-06-09,Japan,NA,Nara,1331330,0,0,87,2
2020-06-10,Japan,NA,Nara,1331330,0,0,87,2
2020-06-11,Japan,NA,Nara,1331330,0,0,87,2
2020-06-12,Japan,NA,Nara,1331330,0,0,87,2
2020-06-13,Japan,NA,Nara,1331330,0,0,87,2
2020-06-14,Japan,NA,Nara,1331330,0,0,87,2
2020-06-15,Japan,NA,Nara,1331330,0,0,87,2
2020-06-16,Japan,NA,Nara,1331330,0,0,87,2
2020-06-17,Japan,NA,Nara,1331330,0,0,87,2
2020-06-18,Japan,NA,Nara,1331330,0,0,87,2
2020-06-19,Japan,NA,Nara,1331330,0,0,87,2
2020-06-20,Japan,NA,Nara,1331330,0,0,87,2
2020-06-21,Japan,NA,Nara,1331330,0,0,87,2
2020-06-22,Japan,NA,Nara,1331330,0,0,87,2
2020-06-23,Japan,NA,Nara,1331330,0,0,87,2
2020-06-24,Japan,NA,Nara,1331330,0,0,87,2
2020-06-25,Japan,NA,Nara,1331330,0,0,87,2
2020-06-26,Japan,NA,Nara,1331330,0,0,87,2
2020-06-27,Japan,NA,Nara,1331330,0,0,87,2
2020-06-28,Japan,NA,Nara,1331330,0,0,87,2
2020-06-29,Japan,NA,Nara,1331330,0,0,87,2
2020-06-30,Japan,NA,Nara,1331330,0,0,87,2
2020-07-01,Japan,NA,Nara,1331330,0,0,87,2
2020-07-02,Japan,NA,Nara,1331330,0,0,87,2
2020-07-03,Japan,NA,Nara,1331330,0,0,87,2
2020-07-04,Japan,NA,Nara,1331330,1,0,88,2
2020-07-05,Japan,NA,Nara,1331330,2,0,90,2
2020-07-06,Japan,NA,Nara,1331330,1,0,91,2
2020-07-07,Japan,NA,Nara,1331330,2,0,93,2
2020-07-08,Japan,NA,Nara,1331330,2,0,95,2
2020-07-09,Japan,NA,Nara,1331330,2,0,97,2
2020-07-10,Japan,NA,Nara,1331330,5,0,102,2
2020-07-11,Japan,NA,Nara,1331330,7,0,109,2
2020-07-12,Japan,NA,Nara,1331330,5,0,114,2
2020-07-13,Japan,NA,Nara,1331330,4,0,118,2
2020-07-14,Japan,NA,Nara,1331330,3,0,121,2
2020-07-15,Japan,NA,Nara,1331330,5,0,126,2
2020-07-16,Japan,NA,Nara,1331330,7,0,133,2
2020-07-17,Japan,NA,Nara,1331330,5,0,138,2
2020-07-18,Japan,NA,Nara,1331330,8,0,146,2
2020-07-19,Japan,NA,Nara,1331330,3,0,149,2
2020-07-20,Japan,NA,Nara,1331330,2,0,151,2
2020-07-21,Japan,NA,Nara,1331330,7,0,158,2
2020-07-22,Japan,NA,Nara,1331330,8,0,166,2
2020-07-23,Japan,NA,Nara,1331330,13,0,179,2
2020-07-24,Japan,NA,Nara,1331330,11,0,190,2
2020-07-25,Japan,NA,Nara,1331330,4,0,194,2
2020-07-26,Japan,NA,Nara,1331330,5,0,199,2
2020-07-27,Japan,NA,Nara,1331330,4,0,203,2
2020-07-28,Japan,NA,Nara,1331330,6,0,209,2
2020-07-29,Japan,NA,Nara,1331330,6,0,215,2
2020-07-30,Japan,NA,Nara,1331330,7,0,222,2
2020-07-31,Japan,NA,Nara,1331330,7,0,229,2
2020-08-01,Japan,NA,Nara,1331330,21,0,250,2
2020-08-02,Japan,NA,Nara,1331330,6,0,256,2
2020-08-03,Japan,NA,Nara,1331330,8,0,264,2
2020-08-04,Japan,NA,Nara,1331330,5,0,269,2
2020-08-05,Japan,NA,Nara,1331330,9,0,278,2
2020-08-06,Japan,NA,Nara,1331330,7,0,285,2
2020-08-07,Japan,NA,Nara,1331330,9,0,294,2
2020-08-08,Japan,NA,Nara,1331330,16,0,310,2
2020-08-09,Japan,NA,Nara,1331330,12,0,322,2
2020-08-10,Japan,NA,Nara,1331330,6,0,328,2
2020-08-11,Japan,NA,Nara,1331330,2,0,330,2
2020-08-12,Japan,NA,Nara,1331330,2,0,332,2
2020-08-13,Japan,NA,Nara,1331330,9,1,341,3
2020-08-14,Japan,NA,Nara,1331330,13,0,354,3
2020-08-15,Japan,NA,Nara,1331330,5,0,359,3
2020-08-16,Japan,NA,Nara,1331330,24,0,383,3
2020-08-17,Japan,NA,Nara,1331330,9,0,392,3
2020-08-18,Japan,NA,Nara,1331330,37,0,429,3
2020-08-19,Japan,NA,Nara,1331330,10,0,439,3
2020-08-20,Japan,NA,Nara,1331330,11,0,450,3
2020-08-21,Japan,NA,Nara,1331330,10,0,460,3
2020-08-22,Japan,NA,Nara,1331330,9,0,469,3
2020-08-23,Japan,NA,Nara,1331330,8,0,477,3
2020-08-24,Japan,NA,Nara,1331330,2,0,479,3
2020-08-25,Japan,NA,Nara,1331330,5,0,484,3
2020-08-26,Japan,NA,Nara,1331330,4,2,488,5
2020-08-27,Japan,NA,Nara,1331330,4,0,492,5
2020-08-28,Japan,NA,Nara,1331330,2,0,494,5
2020-08-29,Japan,NA,Nara,1331330,2,0,496,5
2020-08-30,Japan,NA,Nara,1331330,5,0,501,5
2020-08-31,Japan,NA,Nara,1331330,3,1,504,6
2020-09-01,Japan,NA,Nara,1331330,5,0,509,6
2020-09-02,Japan,NA,Nara,1331330,1,1,510,7
2020-09-03,Japan,NA,Nara,1331330,2,0,512,7
2020-09-04,Japan,NA,Nara,1331330,5,1,517,8
2020-09-05,Japan,NA,Nara,1331330,3,0,520,8
2020-09-06,Japan,NA,Nara,1331330,4,0,524,8
2020-09-07,Japan,NA,Nara,1331330,0,0,524,8
2020-09-08,Japan,NA,Nara,1331330,1,0,525,8
2020-09-09,Japan,NA,Nara,1331330,1,0,526,8
2020-09-10,Japan,NA,Nara,1331330,2,0,528,8
2020-09-11,Japan,NA,Nara,1331330,1,0,529,8
2020-09-12,Japan,NA,Nara,1331330,1,0,530,8
2020-09-13,Japan,NA,Nara,1331330,0,0,530,8
2020-09-14,Japan,NA,Nara,1331330,1,1,531,9
2020-09-15,Japan,NA,Nara,1331330,4,0,535,9
2020-09-16,Japan,NA,Nara,1331330,0,0,535,9
2020-09-17,Japan,NA,Nara,1331330,1,0,536,9
2020-09-18,Japan,NA,Nara,1331330,0,0,536,9
2020-09-19,Japan,NA,Nara,1331330,1,0,537,9
2020-09-20,Japan,NA,Nara,1331330,2,0,539,9
2020-09-21,Japan,NA,Nara,1331330,1,0,540,9
2020-09-22,Japan,NA,Nara,1331330,1,0,541,9
2020-09-23,Japan,NA,Nara,1331330,2,0,543,9
2020-04-03,Japan,NA,Okinawa,1457162,2,0,11,0
2020-04-04,Japan,NA,Okinawa,1457162,5,0,16,0
2020-04-05,Japan,NA,Okinawa,1457162,0,0,16,0
2020-04-06,Japan,NA,Okinawa,1457162,6,0,22,0
2020-04-07,Japan,NA,Okinawa,1457162,11,0,33,0
2020-04-08,Japan,NA,Okinawa,1457162,5,0,38,0
2020-04-09,Japan,NA,Okinawa,1457162,3,0,41,0
2020-04-10,Japan,NA,Okinawa,1457162,7,0,48,0
2020-04-11,Japan,NA,Okinawa,1457162,8,0,56,0
2020-04-12,Japan,NA,Okinawa,1457162,9,0,65,0
2020-04-13,Japan,NA,Okinawa,1457162,7,0,72,0
2020-04-14,Japan,NA,Okinawa,1457162,4,0,76,0
2020-04-15,Japan,NA,Okinawa,1457162,10,0,86,0
2020-04-16,Japan,NA,Okinawa,1457162,8,1,94,1
2020-04-17,Japan,NA,Okinawa,1457162,7,0,101,1
2020-04-18,Japan,NA,Okinawa,1457162,9,0,110,1
2020-04-19,Japan,NA,Okinawa,1457162,5,2,115,3
2020-04-20,Japan,NA,Okinawa,1457162,6,0,121,3
2020-04-21,Japan,NA,Okinawa,1457162,4,0,125,3
2020-04-22,Japan,NA,Okinawa,1457162,5,0,130,3
2020-04-23,Japan,NA,Okinawa,1457162,2,1,132,4
2020-04-24,Japan,NA,Okinawa,1457162,1,0,133,4
2020-04-25,Japan,NA,Okinawa,1457162,1,0,134,4
2020-04-26,Japan,NA,Okinawa,1457162,3,0,137,4
2020-04-27,Japan,NA,Okinawa,1457162,0,0,137,4
2020-04-28,Japan,NA,Okinawa,1457162,4,0,141,4
2020-04-29,Japan,NA,Okinawa,1457162,0,0,141,4
2020-04-30,Japan,NA,Okinawa,1457162,1,1,142,5
2020-05-01,Japan,NA,Okinawa,1457162,0,0,142,5
2020-05-02,Japan,NA,Okinawa,1457162,0,0,142,5
2020-05-03,Japan,NA,Okinawa,1457162,0,0,142,5
2020-05-04,Japan,NA,Okinawa,1457162,0,0,142,5
2020-05-05,Japan,NA,Okinawa,1457162,0,0,142,5
2020-05-06,Japan,NA,Okinawa,1457162,0,0,142,5
2020-05-07,Japan,NA,Okinawa,1457162,0,0,142,5
2020-05-08,Japan,NA,Okinawa,1457162,0,0,142,5
2020-05-09,Japan,NA,Okinawa,1457162,0,0,142,5
2020-05-10,Japan,NA,Okinawa,1457162,0,0,142,5
2020-05-11,Japan,NA,Okinawa,1457162,0,0,142,5
2020-05-12,Japan,NA,Okinawa,1457162,0,1,142,6
2020-05-13,Japan,NA,Okinawa,1457162,0,0,142,6
2020-05-14,Japan,NA,Okinawa,1457162,0,0,142,6
2020-05-15,Japan,NA,Okinawa,1457162,0,0,142,6
2020-05-16,Japan,NA,Okinawa,1457162,0,0,142,6
2020-05-17,Japan,NA,Okinawa,1457162,0,0,142,6
2020-05-18,Japan,NA,Okinawa,1457162,0,0,142,6
2020-05-19,Japan,NA,Okinawa,1457162,0,0,142,6
2020-05-20,Japan,NA,Okinawa,1457162,0,0,142,6
2020-05-21,Japan,NA,Okinawa,1457162,0,0,142,6
2020-05-22,Japan,NA,Okinawa,1457162,0,0,142,6
2020-05-23,Japan,NA,Okinawa,1457162,0,0,142,6
2020-05-24,Japan,NA,Okinawa,1457162,0,0,142,6
2020-05-25,Japan,NA,Okinawa,1457162,0,0,142,6
2020-05-26,Japan,NA,Okinawa,1457162,0,0,142,6
2020-05-27,Japan,NA,Okinawa,1457162,0,0,142,6
2020-05-28,Japan,NA,Okinawa,1457162,0,0,142,6
2020-05-29,Japan,NA,Okinawa,1457162,0,0,142,6
2020-05-30,Japan,NA,Okinawa,1457162,0,0,142,6
2020-05-31,Japan,NA,Okinawa,1457162,0,0,142,6
2020-06-01,Japan,NA,Okinawa,1457162,0,0,142,6
2020-06-02,Japan,NA,Okinawa,1457162,0,0,142,6
2020-06-03,Japan,NA,Okinawa,1457162,0,1,142,7
2020-06-04,Japan,NA,Okinawa,1457162,0,0,142,7
2020-06-05,Japan,NA,Okinawa,1457162,0,0,142,7
2020-06-06,Japan,NA,Okinawa,1457162,0,0,142,7
2020-06-07,Japan,NA,Okinawa,1457162,0,0,142,7
2020-06-08,Japan,NA,Okinawa,1457162,0,0,142,7
2020-06-09,Japan,NA,Okinawa,1457162,0,0,142,7
2020-06-10,Japan,NA,Okinawa,1457162,0,0,142,7
2020-06-11,Japan,NA,Okinawa,1457162,0,0,142,7
2020-06-12,Japan,NA,Okinawa,1457162,0,0,142,7
2020-06-13,Japan,NA,Okinawa,1457162,0,0,142,7
2020-06-14,Japan,NA,Okinawa,1457162,0,0,142,7
2020-06-15,Japan,NA,Okinawa,1457162,0,0,142,7
2020-06-16,Japan,NA,Okinawa,1457162,0,0,142,7
2020-06-17,Japan,NA,Okinawa,1457162,0,0,142,7
2020-06-18,Japan,NA,Okinawa,1457162,0,0,142,7
2020-06-19,Japan,NA,Okinawa,1457162,0,0,142,7
2020-06-20,Japan,NA,Okinawa,1457162,0,0,142,7
2020-06-21,Japan,NA,Okinawa,1457162,0,0,142,7
2020-06-22,Japan,NA,Okinawa,1457162,0,0,142,7
2020-06-23,Japan,NA,Okinawa,1457162,0,0,142,7
2020-06-24,Japan,NA,Okinawa,1457162,0,0,142,7
2020-06-25,Japan,NA,Okinawa,1457162,0,0,142,7
2020-06-26,Japan,NA,Okinawa,1457162,0,0,142,7
2020-06-27,Japan,NA,Okinawa,1457162,0,0,142,7
2020-06-28,Japan,NA,Okinawa,1457162,0,0,142,7
2020-06-29,Japan,NA,Okinawa,1457162,0,0,142,7
2020-06-30,Japan,NA,Okinawa,1457162,0,0,142,7
2020-07-01,Japan,NA,Okinawa,1457162,0,0,142,7
2020-07-02,Japan,NA,Okinawa,1457162,0,0,142,7
2020-07-03,Japan,NA,Okinawa,1457162,0,0,142,7
2020-07-04,Japan,NA,Okinawa,1457162,0,0,142,7
2020-07-05,Japan,NA,Okinawa,1457162,0,0,142,7
2020-07-06,Japan,NA,Okinawa,1457162,0,0,142,7
2020-07-07,Japan,NA,Okinawa,1457162,0,0,142,7
2020-07-08,Japan,NA,Okinawa,1457162,2,0,144,7
2020-07-09,Japan,NA,Okinawa,1457162,1,0,145,7
2020-07-10,Japan,NA,Okinawa,1457162,1,0,146,7
2020-07-11,Japan,NA,Okinawa,1457162,2,0,148,7
2020-07-12,Japan,NA,Okinawa,1457162,0,0,148,7
2020-07-13,Japan,NA,Okinawa,1457162,0,0,148,7
2020-07-14,Japan,NA,Okinawa,1457162,0,0,148,7
2020-07-15,Japan,NA,Okinawa,1457162,0,0,148,7
2020-07-16,Japan,NA,Okinawa,1457162,1,0,149,7
2020-07-17,Japan,NA,Okinawa,1457162,0,0,149,7
2020-07-18,Japan,NA,Okinawa,1457162,0,0,149,7
2020-07-19,Japan,NA,Okinawa,1457162,2,0,151,7
2020-07-20,Japan,NA,Okinawa,1457162,2,0,153,7
2020-07-21,Japan,NA,Okinawa,1457162,2,0,155,7
2020-07-22,Japan,NA,Okinawa,1457162,2,0,157,7
2020-07-23,Japan,NA,Okinawa,1457162,5,0,162,7
2020-07-24,Japan,NA,Okinawa,1457162,10,0,172,7
2020-07-25,Japan,NA,Okinawa,1457162,14,0,186,7
2020-07-26,Japan,NA,Okinawa,1457162,6,0,192,7
2020-07-27,Japan,NA,Okinawa,1457162,18,0,210,7
2020-07-28,Japan,NA,Okinawa,1457162,21,0,231,7
2020-07-29,Japan,NA,Okinawa,1457162,44,0,275,7
2020-07-30,Japan,NA,Okinawa,1457162,49,0,324,7
2020-07-31,Japan,NA,Okinawa,1457162,71,0,395,7
2020-08-01,Japan,NA,Okinawa,1457162,58,0,453,7
2020-08-02,Japan,NA,Okinawa,1457162,63,0,516,7
2020-08-03,Japan,NA,Okinawa,1457162,37,0,553,7
2020-08-04,Japan,NA,Okinawa,1457162,83,0,636,7
2020-08-05,Japan,NA,Okinawa,1457162,74,0,710,7
2020-08-06,Japan,NA,Okinawa,1457162,72,0,782,7
2020-08-07,Japan,NA,Okinawa,1457162,100,0,882,7
2020-08-08,Japan,NA,Okinawa,1457162,84,0,966,7
2020-08-09,Japan,NA,Okinawa,1457162,156,0,1122,7
2020-08-10,Japan,NA,Okinawa,1457162,51,3,1173,10
2020-08-11,Japan,NA,Okinawa,1457162,64,0,1237,10
2020-08-12,Japan,NA,Okinawa,1457162,65,0,1302,10
2020-08-13,Japan,NA,Okinawa,1457162,95,0,1397,10
2020-08-14,Japan,NA,Okinawa,1457162,105,1,1502,11
2020-08-15,Japan,NA,Okinawa,1457162,47,0,1549,11
2020-08-16,Japan,NA,Okinawa,1457162,59,2,1608,13
2020-08-17,Japan,NA,Okinawa,1457162,38,1,1646,14
2020-08-18,Japan,NA,Okinawa,1457162,33,0,1679,14
2020-08-19,Japan,NA,Okinawa,1457162,69,1,1748,15
2020-08-20,Japan,NA,Okinawa,1457162,43,2,1791,17
2020-08-21,Japan,NA,Okinawa,1457162,30,1,1821,18
2020-08-22,Japan,NA,Okinawa,1457162,31,0,1852,18
2020-08-23,Japan,NA,Okinawa,1457162,25,1,1877,19
2020-08-24,Japan,NA,Okinawa,1457162,22,4,1899,23
2020-08-25,Japan,NA,Okinawa,1457162,31,1,1930,24
2020-08-26,Japan,NA,Okinawa,1457162,34,1,1964,25
2020-08-27,Japan,NA,Okinawa,1457162,34,1,1998,26
2020-08-28,Japan,NA,Okinawa,1457162,42,0,2040,26
2020-08-29,Japan,NA,Okinawa,1457162,31,0,2071,26
2020-08-30,Japan,NA,Okinawa,1457162,33,1,2104,27
2020-08-31,Japan,NA,Okinawa,1457162,23,1,2127,28
2020-09-01,Japan,NA,Okinawa,1457162,0,0,2127,28
2020-09-02,Japan,NA,Okinawa,1457162,14,1,2141,29
2020-09-03,Japan,NA,Okinawa,1457162,19,2,2160,31
2020-09-04,Japan,NA,Okinawa,1457162,27,0,2187,31
2020-09-05,Japan,NA,Okinawa,1457162,20,1,2207,32
2020-09-06,Japan,NA,Okinawa,1457162,0,0,2207,32
2020-09-07,Japan,NA,Okinawa,1457162,18,4,2225,36
2020-09-08,Japan,NA,Okinawa,1457162,9,2,2234,38
2020-09-09,Japan,NA,Okinawa,1457162,8,3,2242,41
2020-09-10,Japan,NA,Okinawa,1457162,16,0,2258,41
2020-09-11,Japan,NA,Okinawa,1457162,10,0,2268,41
2020-09-12,Japan,NA,Okinawa,1457162,11,4,2279,45
2020-09-13,Japan,NA,Okinawa,1457162,10,0,2289,45
2020-09-14,Japan,NA,Okinawa,1457162,3,0,2292,45
2020-09-15,Japan,NA,Okinawa,1457162,4,0,2296,45
2020-09-16,Japan,NA,Okinawa,1457162,8,0,2304,45
2020-09-17,Japan,NA,Okinawa,1457162,5,0,2309,45
2020-09-18,Japan,NA,Okinawa,1457162,12,0,2321,45
2020-09-19,Japan,NA,Okinawa,1457162,14,0,2335,45
2020-09-20,Japan,NA,Okinawa,1457162,15,0,2350,45
2020-09-21,Japan,NA,Okinawa,1457162,7,0,2357,45
2020-09-22,Japan,NA,Okinawa,1457162,6,0,2363,45
2020-09-23,Japan,NA,Okinawa,1457162,13,0,2376,45
2020-03-04,Japan,NA,Osaka,8823453,9,0,17,0
2020-03-05,Japan,NA,Osaka,8823453,1,0,18,0
2020-03-06,Japan,NA,Osaka,8823453,13,0,31,0
2020-03-07,Japan,NA,Osaka,8823453,10,0,41,0
2020-03-08,Japan,NA,Osaka,8823453,14,0,55,0
2020-03-09,Japan,NA,Osaka,8823453,0,0,55,0
2020-03-10,Japan,NA,Osaka,8823453,18,0,73,0
2020-03-11,Japan,NA,Osaka,8823453,7,0,80,0
2020-03-12,Japan,NA,Osaka,8823453,9,0,89,0
2020-03-13,Japan,NA,Osaka,8823453,3,0,92,0
2020-03-14,Japan,NA,Osaka,8823453,10,0,102,0
2020-03-15,Japan,NA,Osaka,8823453,4,0,106,0
2020-03-16,Japan,NA,Osaka,8823453,2,0,108,0
2020-03-17,Japan,NA,Osaka,8823453,4,0,112,0
2020-03-18,Japan,NA,Osaka,8823453,5,0,117,0
2020-03-19,Japan,NA,Osaka,8823453,2,1,119,1
2020-03-20,Japan,NA,Osaka,8823453,4,0,123,1
2020-03-21,Japan,NA,Osaka,8823453,2,0,125,1
2020-03-22,Japan,NA,Osaka,8823453,6,1,131,2
2020-03-23,Japan,NA,Osaka,8823453,3,0,134,2
2020-03-24,Japan,NA,Osaka,8823453,8,0,142,2
2020-03-25,Japan,NA,Osaka,8823453,7,0,149,2
2020-03-26,Japan,NA,Osaka,8823453,7,0,156,2
2020-03-27,Japan,NA,Osaka,8823453,20,0,176,2
2020-03-28,Japan,NA,Osaka,8823453,15,0,191,2
2020-03-29,Japan,NA,Osaka,8823453,17,0,208,2
2020-03-30,Japan,NA,Osaka,8823453,8,0,216,2
2020-03-31,Japan,NA,Osaka,8823453,28,0,244,2
2020-04-01,Japan,NA,Osaka,8823453,34,0,278,2
2020-04-02,Japan,NA,Osaka,8823453,33,1,311,3
2020-04-03,Japan,NA,Osaka,8823453,35,0,346,3
2020-04-04,Japan,NA,Osaka,8823453,41,1,387,4
2020-04-05,Japan,NA,Osaka,8823453,21,0,408,4
2020-04-06,Japan,NA,Osaka,8823453,20,0,428,4
2020-04-07,Japan,NA,Osaka,8823453,53,0,481,4
2020-04-08,Japan,NA,Osaka,8823453,43,2,524,6
2020-04-09,Japan,NA,Osaka,8823453,92,0,616,6
2020-04-10,Japan,NA,Osaka,8823453,80,0,696,6
2020-04-11,Japan,NA,Osaka,8823453,70,0,766,6
2020-04-12,Japan,NA,Osaka,8823453,45,0,811,6
2020-04-13,Japan,NA,Osaka,8823453,24,0,835,6
2020-04-14,Japan,NA,Osaka,8823453,59,1,894,7
2020-04-15,Japan,NA,Osaka,8823453,74,1,968,8
2020-04-16,Japan,NA,Osaka,8823453,52,0,1020,8
2020-04-17,Japan,NA,Osaka,8823453,55,1,1075,9
2020-04-18,Japan,NA,Osaka,8823453,88,1,1163,10
2020-04-19,Japan,NA,Osaka,8823453,48,2,1211,12
2020-04-20,Japan,NA,Osaka,8823453,84,1,1295,13
2020-04-21,Japan,NA,Osaka,8823453,54,2,1349,15
2020-04-22,Japan,NA,Osaka,8823453,31,3,1380,18
2020-04-23,Japan,NA,Osaka,8823453,35,4,1415,22
2020-04-24,Japan,NA,Osaka,8823453,31,4,1446,26
2020-04-25,Japan,NA,Osaka,8823453,29,2,1475,28
2020-04-26,Japan,NA,Osaka,8823453,16,2,1491,30
2020-04-27,Japan,NA,Osaka,8823453,30,2,1521,32
2020-04-28,Japan,NA,Osaka,8823453,32,4,1553,36
2020-04-29,Japan,NA,Osaka,8823453,44,3,1597,39
2020-04-30,Japan,NA,Osaka,8823453,28,2,1625,41
2020-05-01,Japan,NA,Osaka,8823453,14,2,1639,43
2020-05-02,Japan,NA,Osaka,8823453,17,3,1656,46
2020-05-03,Japan,NA,Osaka,8823453,10,4,1666,50
2020-05-04,Japan,NA,Osaka,8823453,13,3,1679,53
2020-05-05,Japan,NA,Osaka,8823453,7,3,1686,56
2020-05-06,Japan,NA,Osaka,8823453,12,0,1698,56
2020-05-07,Japan,NA,Osaka,8823453,8,3,1706,59
2020-05-08,Japan,NA,Osaka,8823453,10,0,1716,59
2020-05-09,Japan,NA,Osaka,8823453,16,0,1732,59
2020-05-10,Japan,NA,Osaka,8823453,11,0,1743,59
2020-05-11,Japan,NA,Osaka,8823453,1,2,1744,61
2020-05-12,Japan,NA,Osaka,8823453,6,0,1750,61
2020-05-13,Japan,NA,Osaka,8823453,12,1,1762,62
2020-05-14,Japan,NA,Osaka,8823453,3,1,1765,63
2020-05-15,Japan,NA,Osaka,8823453,3,3,1768,66
2020-05-16,Japan,NA,Osaka,8823453,2,4,1770,70
2020-05-17,Japan,NA,Osaka,8823453,0,0,1770,70
2020-05-18,Japan,NA,Osaka,8823453,1,0,1771,70
2020-05-19,Japan,NA,Osaka,8823453,3,1,1774,71
2020-05-20,Japan,NA,Osaka,8823453,3,5,1777,76
2020-05-21,Japan,NA,Osaka,8823453,3,0,1780,76
2020-05-22,Japan,NA,Osaka,8823453,1,2,1781,78
2020-05-23,Japan,NA,Osaka,8823453,0,0,1781,78
2020-05-24,Japan,NA,Osaka,8823453,0,0,1781,78
2020-05-25,Japan,NA,Osaka,8823453,0,0,1781,78
2020-05-26,Japan,NA,Osaka,8823453,0,2,1781,80
2020-05-27,Japan,NA,Osaka,8823453,1,0,1782,80
2020-05-28,Japan,NA,Osaka,8823453,0,2,1782,82
2020-05-29,Japan,NA,Osaka,8823453,0,0,1782,82
2020-05-30,Japan,NA,Osaka,8823453,0,1,1782,83
2020-05-31,Japan,NA,Osaka,8823453,1,0,1783,83
2020-06-01,Japan,NA,Osaka,8823453,0,0,1783,83
2020-06-02,Japan,NA,Osaka,8823453,0,1,1783,84
2020-06-03,Japan,NA,Osaka,8823453,0,0,1783,84
2020-06-04,Japan,NA,Osaka,8823453,0,0,1783,84
2020-06-05,Japan,NA,Osaka,8823453,0,0,1783,84
2020-06-06,Japan,NA,Osaka,8823453,1,0,1784,84
2020-06-07,Japan,NA,Osaka,8823453,1,0,1785,84
2020-06-08,Japan,NA,Osaka,8823453,0,0,1785,84
2020-06-09,Japan,NA,Osaka,8823453,0,0,1785,84
2020-06-10,Japan,NA,Osaka,8823453,0,1,1785,85
2020-06-11,Japan,NA,Osaka,8823453,1,0,1786,85
2020-06-12,Japan,NA,Osaka,8823453,0,0,1786,85
2020-06-13,Japan,NA,Osaka,8823453,0,1,1786,86
2020-06-14,Japan,NA,Osaka,8823453,1,0,1787,86
2020-06-15,Japan,NA,Osaka,8823453,0,0,1787,86
2020-06-16,Japan,NA,Osaka,8823453,3,0,1790,86
2020-06-17,Japan,NA,Osaka,8823453,4,0,1794,86
2020-06-18,Japan,NA,Osaka,8823453,4,0,1798,86
2020-06-19,Japan,NA,Osaka,8823453,2,0,1800,86
2020-06-20,Japan,NA,Osaka,8823453,6,0,1806,86
2020-06-21,Japan,NA,Osaka,8823453,3,0,1809,86
2020-06-22,Japan,NA,Osaka,8823453,0,0,1809,86
2020-06-23,Japan,NA,Osaka,8823453,0,0,1809,86
2020-06-24,Japan,NA,Osaka,8823453,2,0,1811,86
2020-06-25,Japan,NA,Osaka,8823453,1,0,1812,86
2020-06-26,Japan,NA,Osaka,8823453,2,0,1814,86
2020-06-27,Japan,NA,Osaka,8823453,2,0,1816,86
2020-06-28,Japan,NA,Osaka,8823453,5,0,1821,86
2020-06-29,Japan,NA,Osaka,8823453,7,0,1828,86
2020-06-30,Japan,NA,Osaka,8823453,5,0,1833,86
2020-07-01,Japan,NA,Osaka,8823453,10,0,1843,86
2020-07-02,Japan,NA,Osaka,8823453,8,0,1851,86
2020-07-03,Japan,NA,Osaka,8823453,11,0,1862,86
2020-07-04,Japan,NA,Osaka,8823453,17,0,1879,86
2020-07-05,Japan,NA,Osaka,8823453,6,0,1885,86
2020-07-06,Japan,NA,Osaka,8823453,8,0,1893,86
2020-07-07,Japan,NA,Osaka,8823453,12,0,1905,86
2020-07-08,Japan,NA,Osaka,8823453,10,0,1915,86
2020-07-09,Japan,NA,Osaka,8823453,30,0,1945,86
2020-07-10,Japan,NA,Osaka,8823453,22,0,1967,86
2020-07-11,Japan,NA,Osaka,8823453,28,0,1995,86
2020-07-12,Japan,NA,Osaka,8823453,32,0,2027,86
2020-07-13,Japan,NA,Osaka,8823453,18,0,2045,86
2020-07-14,Japan,NA,Osaka,8823453,20,0,2065,86
2020-07-15,Japan,NA,Osaka,8823453,61,0,2126,86
2020-07-16,Japan,NA,Osaka,8823453,66,0,2192,86
2020-07-17,Japan,NA,Osaka,8823453,53,0,2245,86
2020-07-18,Japan,NA,Osaka,8823453,86,0,2331,86
2020-07-19,Japan,NA,Osaka,8823453,89,0,2420,86
2020-07-20,Japan,NA,Osaka,8823453,49,0,2469,86
2020-07-21,Japan,NA,Osaka,8823453,72,0,2541,86
2020-07-22,Japan,NA,Osaka,8823453,121,0,2662,86
2020-07-23,Japan,NA,Osaka,8823453,104,0,2766,86
2020-07-24,Japan,NA,Osaka,8823453,149,1,2915,87
2020-07-25,Japan,NA,Osaka,8823453,132,1,3047,88
2020-07-26,Japan,NA,Osaka,8823453,141,0,3188,88
2020-07-27,Japan,NA,Osaka,8823453,86,0,3274,88
2020-07-28,Japan,NA,Osaka,8823453,155,0,3429,88
2020-07-29,Japan,NA,Osaka,8823453,221,1,3650,89
2020-07-30,Japan,NA,Osaka,8823453,190,0,3840,89
2020-07-31,Japan,NA,Osaka,8823453,216,1,4056,90
2020-08-01,Japan,NA,Osaka,8823453,195,0,4251,90
2020-08-02,Japan,NA,Osaka,8823453,194,0,4445,90
2020-08-03,Japan,NA,Osaka,8823453,81,1,4526,91
2020-08-04,Japan,NA,Osaka,8823453,193,1,4719,92
2020-08-05,Japan,NA,Osaka,8823453,196,0,4915,92
2020-08-06,Japan,NA,Osaka,8823453,225,1,5140,93
2020-08-07,Japan,NA,Osaka,8823453,255,2,5395,95
2020-08-08,Japan,NA,Osaka,8823453,178,0,5573,95
2020-08-09,Japan,NA,Osaka,8823453,195,1,5768,96
2020-08-10,Japan,NA,Osaka,8823453,123,0,5891,96
2020-08-11,Japan,NA,Osaka,8823453,101,1,5992,97
2020-08-12,Japan,NA,Osaka,8823453,184,1,6176,98
2020-08-13,Japan,NA,Osaka,8823453,177,3,6353,101
2020-08-14,Japan,NA,Osaka,8823453,192,5,6545,106
2020-08-15,Japan,NA,Osaka,8823453,151,0,6696,106
2020-08-16,Japan,NA,Osaka,8823453,147,0,6843,106
2020-08-17,Japan,NA,Osaka,8823453,71,5,6914,111
2020-08-18,Japan,NA,Osaka,8823453,185,6,7099,117
2020-08-19,Japan,NA,Osaka,8823453,187,5,7286,122
2020-08-20,Japan,NA,Osaka,8823453,132,1,7418,123
2020-08-21,Japan,NA,Osaka,8823453,166,5,7584,128
2020-08-22,Japan,NA,Osaka,8823453,134,1,7718,129
2020-08-23,Japan,NA,Osaka,8823453,121,0,7839,129
2020-08-24,Japan,NA,Osaka,8823453,60,2,7899,131
2020-08-25,Japan,NA,Osaka,8823453,119,3,8018,134
2020-08-26,Japan,NA,Osaka,8823453,119,2,8137,136
2020-08-27,Japan,NA,Osaka,8823453,94,2,8231,138
2020-08-28,Japan,NA,Osaka,8823453,106,9,8337,147
2020-08-29,Japan,NA,Osaka,8823453,90,0,8427,147
2020-08-30,Japan,NA,Osaka,8823453,62,1,8489,148
2020-08-31,Japan,NA,Osaka,8823453,53,4,8542,152
2020-09-01,Japan,NA,Osaka,8823453,114,3,8656,155
2020-09-02,Japan,NA,Osaka,8823453,96,2,8752,157
2020-09-03,Japan,NA,Osaka,8823453,74,0,8826,157
2020-09-04,Japan,NA,Osaka,8823453,74,4,8900,161
2020-09-05,Japan,NA,Osaka,8823453,76,2,8976,163
2020-09-06,Japan,NA,Osaka,8823453,67,2,9043,165
2020-09-07,Japan,NA,Osaka,8823453,45,1,9088,166
2020-09-08,Japan,NA,Osaka,8823453,81,2,9169,168
2020-09-09,Japan,NA,Osaka,8823453,63,3,9232,171
2020-09-10,Japan,NA,Osaka,8823453,92,1,9324,172
2020-09-11,Japan,NA,Osaka,8823453,120,3,9444,175
2020-09-12,Japan,NA,Osaka,8823453,83,2,9527,177
2020-09-13,Japan,NA,Osaka,8823453,77,2,9604,179
2020-09-14,Japan,NA,Osaka,8823453,32,1,9636,180
2020-09-15,Japan,NA,Osaka,8823453,89,6,9725,186
2020-09-16,Japan,NA,Osaka,8823453,78,2,9803,188
2020-09-17,Japan,NA,Osaka,8823453,57,0,9860,188
2020-09-18,Japan,NA,Osaka,8823453,60,2,9920,190
2020-09-19,Japan,NA,Osaka,8823453,81,2,10001,192
2020-09-20,Japan,NA,Osaka,8823453,59,0,10060,192
2020-09-21,Japan,NA,Osaka,8823453,39,1,10099,193
2020-09-22,Japan,NA,Osaka,8823453,67,1,10166,194
2020-09-23,Japan,NA,Osaka,8823453,39,1,10205,195
2020-03-10,Japan,NA,Saitama,7337330,5,0,12,0
2020-03-11,Japan,NA,Saitama,7337330,2,0,14,0
2020-03-12,Japan,NA,Saitama,7337330,6,0,20,0
2020-03-13,Japan,NA,Saitama,7337330,2,0,22,0
2020-03-14,Japan,NA,Saitama,7337330,7,0,29,0
2020-03-15,Japan,NA,Saitama,7337330,0,0,29,0
2020-03-16,Japan,NA,Saitama,7337330,0,0,29,0
2020-03-17,Japan,NA,Saitama,7337330,4,0,33,0
2020-03-18,Japan,NA,Saitama,7337330,1,0,34,0
2020-03-19,Japan,NA,Saitama,7337330,4,0,38,0
2020-03-20,Japan,NA,Saitama,7337330,3,0,41,0
2020-03-21,Japan,NA,Saitama,7337330,3,0,44,0
2020-03-22,Japan,NA,Saitama,7337330,6,1,50,1
2020-03-23,Japan,NA,Saitama,7337330,1,0,51,1
2020-03-24,Japan,NA,Saitama,7337330,7,0,58,1
2020-03-25,Japan,NA,Saitama,7337330,1,0,59,1
2020-03-26,Japan,NA,Saitama,7337330,7,0,66,1
2020-03-27,Japan,NA,Saitama,7337330,6,1,72,2
2020-03-28,Japan,NA,Saitama,7337330,6,0,78,2
2020-03-29,Japan,NA,Saitama,7337330,5,0,83,2
2020-03-30,Japan,NA,Saitama,7337330,1,0,84,2
2020-03-31,Japan,NA,Saitama,7337330,15,0,99,2
2020-04-01,Japan,NA,Saitama,7337330,4,1,103,3
2020-04-02,Japan,NA,Saitama,7337330,14,0,117,3
2020-04-03,Japan,NA,Saitama,7337330,17,0,134,3
2020-04-04,Japan,NA,Saitama,7337330,25,0,159,3
2020-04-05,Japan,NA,Saitama,7337330,25,0,184,3
2020-04-06,Japan,NA,Saitama,7337330,14,1,198,4
2020-04-07,Japan,NA,Saitama,7337330,17,0,215,4
2020-04-08,Japan,NA,Saitama,7337330,34,1,249,5
2020-04-09,Japan,NA,Saitama,7337330,35,0,284,5
2020-04-10,Japan,NA,Saitama,7337330,53,1,337,6
2020-04-11,Japan,NA,Saitama,7337330,37,0,374,6
2020-04-12,Japan,NA,Saitama,7337330,40,0,414,6
2020-04-13,Japan,NA,Saitama,7337330,15,1,429,7
2020-04-14,Japan,NA,Saitama,7337330,22,2,451,9
2020-04-15,Japan,NA,Saitama,7337330,61,1,512,10
2020-04-16,Japan,NA,Saitama,7337330,51,2,563,12
2020-04-17,Japan,NA,Saitama,7337330,26,1,589,13
2020-04-18,Japan,NA,Saitama,7337330,37,0,626,13
2020-04-19,Japan,NA,Saitama,7337330,37,0,663,13
2020-04-20,Japan,NA,Saitama,7337330,12,0,675,13
2020-04-21,Japan,NA,Saitama,7337330,10,2,685,15
2020-04-22,Japan,NA,Saitama,7337330,39,1,724,16
2020-04-23,Japan,NA,Saitama,7337330,33,7,757,23
2020-04-24,Japan,NA,Saitama,7337330,18,0,775,23
2020-04-25,Japan,NA,Saitama,7337330,22,1,797,24
2020-04-26,Japan,NA,Saitama,7337330,19,1,816,25
2020-04-27,Japan,NA,Saitama,7337330,8,2,824,27
2020-04-28,Japan,NA,Saitama,7337330,7,3,831,30
2020-04-29,Japan,NA,Saitama,7337330,15,0,846,30
2020-04-30,Japan,NA,Saitama,7337330,12,4,858,34
2020-05-01,Japan,NA,Saitama,7337330,5,2,863,36
2020-05-02,Japan,NA,Saitama,7337330,21,1,884,37
2020-05-03,Japan,NA,Saitama,7337330,12,1,896,38
2020-05-04,Japan,NA,Saitama,7337330,5,1,901,39
2020-05-05,Japan,NA,Saitama,7337330,6,0,907,39
2020-05-06,Japan,NA,Saitama,7337330,9,1,916,40
2020-05-07,Japan,NA,Saitama,7337330,14,1,930,41
2020-05-08,Japan,NA,Saitama,7337330,11,0,941,41
2020-05-09,Japan,NA,Saitama,7337330,16,0,957,41
2020-05-10,Japan,NA,Saitama,7337330,5,1,962,42
2020-05-11,Japan,NA,Saitama,7337330,2,0,964,42
2020-05-12,Japan,NA,Saitama,7337330,1,1,965,43
2020-05-13,Japan,NA,Saitama,7337330,4,1,969,44
2020-05-14,Japan,NA,Saitama,7337330,4,1,973,45
2020-05-15,Japan,NA,Saitama,7337330,2,0,975,45
2020-05-16,Japan,NA,Saitama,7337330,5,1,980,46
2020-05-17,Japan,NA,Saitama,7337330,4,0,984,46
2020-05-18,Japan,NA,Saitama,7337330,3,0,987,46
2020-05-19,Japan,NA,Saitama,7337330,0,0,987,46
2020-05-20,Japan,NA,Saitama,7337330,5,0,992,46
2020-05-21,Japan,NA,Saitama,7337330,1,0,993,46
2020-05-22,Japan,NA,Saitama,7337330,1,0,994,46
2020-05-23,Japan,NA,Saitama,7337330,1,0,995,46
2020-05-24,Japan,NA,Saitama,7337330,0,0,995,46
2020-05-25,Japan,NA,Saitama,7337330,0,1,995,47
2020-05-26,Japan,NA,Saitama,7337330,0,0,995,47
2020-05-27,Japan,NA,Saitama,7337330,0,0,995,47
2020-05-28,Japan,NA,Saitama,7337330,2,1,997,48
2020-05-29,Japan,NA,Saitama,7337330,2,0,999,48
2020-05-30,Japan,NA,Saitama,7337330,0,0,999,48
2020-05-31,Japan,NA,Saitama,7337330,0,0,999,48
2020-06-01,Japan,NA,Saitama,7337330,0,0,999,48
2020-06-02,Japan,NA,Saitama,7337330,0,1,999,49
2020-06-03,Japan,NA,Saitama,7337330,2,0,1001,49
2020-06-04,Japan,NA,Saitama,7337330,0,1,1001,50
2020-06-05,Japan,NA,Saitama,7337330,1,1,1002,51
2020-06-06,Japan,NA,Saitama,7337330,1,0,1003,51
2020-06-07,Japan,NA,Saitama,7337330,0,0,1003,51
2020-06-08,Japan,NA,Saitama,7337330,0,0,1003,51
2020-06-09,Japan,NA,Saitama,7337330,1,0,1004,51
2020-06-10,Japan,NA,Saitama,7337330,6,0,1010,51
2020-06-11,Japan,NA,Saitama,7337330,3,0,1013,51
2020-06-12,Japan,NA,Saitama,7337330,2,0,1015,51
2020-06-13,Japan,NA,Saitama,7337330,0,0,1015,51
2020-06-14,Japan,NA,Saitama,7337330,2,0,1017,51
2020-06-15,Japan,NA,Saitama,7337330,0,1,1017,52
2020-06-16,Japan,NA,Saitama,7337330,1,0,1018,52
2020-06-17,Japan,NA,Saitama,7337330,1,0,1019,52
2020-06-18,Japan,NA,Saitama,7337330,2,0,1021,52
2020-06-19,Japan,NA,Saitama,7337330,2,12,1023,64
2020-06-20,Japan,NA,Saitama,7337330,4,0,1027,64
2020-06-21,Japan,NA,Saitama,7337330,7,0,1034,64
2020-06-22,Japan,NA,Saitama,7337330,4,0,1038,64
2020-06-23,Japan,NA,Saitama,7337330,12,0,1050,64
2020-06-24,Japan,NA,Saitama,7337330,9,0,1059,64
2020-06-25,Japan,NA,Saitama,7337330,11,0,1070,64
2020-06-26,Japan,NA,Saitama,7337330,16,0,1086,64
2020-06-27,Japan,NA,Saitama,7337330,11,0,1097,64
2020-06-28,Japan,NA,Saitama,7337330,8,0,1105,64
2020-06-29,Japan,NA,Saitama,7337330,13,0,1118,64
2020-06-30,Japan,NA,Saitama,7337330,10,0,1128,64
2020-07-01,Japan,NA,Saitama,7337330,14,0,1142,64
2020-07-02,Japan,NA,Saitama,7337330,19,0,1161,64
2020-07-03,Japan,NA,Saitama,7337330,26,0,1187,64
2020-07-04,Japan,NA,Saitama,7337330,27,0,1214,64
2020-07-05,Japan,NA,Saitama,7337330,21,0,1235,64
2020-07-06,Japan,NA,Saitama,7337330,16,1,1251,65
2020-07-07,Japan,NA,Saitama,7337330,27,1,1278,66
2020-07-08,Japan,NA,Saitama,7337330,48,0,1326,66
2020-07-09,Japan,NA,Saitama,7337330,22,0,1348,66
2020-07-10,Japan,NA,Saitama,7337330,44,0,1392,66
2020-07-11,Japan,NA,Saitama,7337330,35,0,1427,66
2020-07-12,Japan,NA,Saitama,7337330,31,0,1458,66
2020-07-13,Japan,NA,Saitama,7337330,26,0,1484,66
2020-07-14,Japan,NA,Saitama,7337330,42,0,1526,66
2020-07-15,Japan,NA,Saitama,7337330,38,0,1564,66
2020-07-16,Japan,NA,Saitama,7337330,49,0,1613,66
2020-07-17,Japan,NA,Saitama,7337330,51,0,1664,66
2020-07-18,Japan,NA,Saitama,7337330,49,1,1713,67
2020-07-19,Japan,NA,Saitama,7337330,37,0,1750,67
2020-07-20,Japan,NA,Saitama,7337330,28,1,1778,68
2020-07-21,Japan,NA,Saitama,7337330,47,1,1825,69
2020-07-22,Japan,NA,Saitama,7337330,62,0,1887,69
2020-07-23,Japan,NA,Saitama,7337330,64,1,1951,70
2020-07-24,Japan,NA,Saitama,7337330,45,1,1996,71
2020-07-25,Japan,NA,Saitama,7337330,35,0,2031,71
2020-07-26,Japan,NA,Saitama,7337330,33,0,2064,71
2020-07-27,Japan,NA,Saitama,7337330,23,0,2087,71
2020-07-28,Japan,NA,Saitama,7337330,55,0,2142,71
2020-07-29,Japan,NA,Saitama,7337330,53,1,2195,72
2020-07-30,Japan,NA,Saitama,7337330,57,0,2252,72
2020-07-31,Japan,NA,Saitama,7337330,57,1,2309,73
2020-08-01,Japan,NA,Saitama,7337330,74,0,2383,73
2020-08-02,Japan,NA,Saitama,7337330,74,0,2457,73
2020-08-03,Japan,NA,Saitama,7337330,49,0,2506,73
2020-08-04,Japan,NA,Saitama,7337330,49,2,2555,75
2020-08-05,Japan,NA,Saitama,7337330,64,1,2619,76
2020-08-06,Japan,NA,Saitama,7337330,65,2,2684,78
2020-08-07,Japan,NA,Saitama,7337330,50,0,2734,78
2020-08-08,Japan,NA,Saitama,7337330,84,0,2818,78
2020-08-09,Japan,NA,Saitama,7337330,56,0,2874,78
2020-08-10,Japan,NA,Saitama,7337330,42,0,2916,78
2020-08-11,Japan,NA,Saitama,7337330,36,0,2952,78
2020-08-12,Japan,NA,Saitama,7337330,45,1,2997,79
2020-08-13,Japan,NA,Saitama,7337330,56,0,3053,79
2020-08-14,Japan,NA,Saitama,7337330,56,0,3109,79
2020-08-15,Japan,NA,Saitama,7337330,52,2,3161,81
2020-08-16,Japan,NA,Saitama,7337330,56,0,3217,81
2020-08-17,Japan,NA,Saitama,7337330,35,0,3252,81
2020-08-18,Japan,NA,Saitama,7337330,24,1,3276,82
2020-08-19,Japan,NA,Saitama,7337330,62,1,3338,83
2020-08-20,Japan,NA,Saitama,7337330,71,1,3409,84
2020-08-21,Japan,NA,Saitama,7337330,50,0,3459,84
2020-08-22,Japan,NA,Saitama,7337330,66,1,3525,85
2020-08-23,Japan,NA,Saitama,7337330,31,0,3556,85
2020-08-24,Japan,NA,Saitama,7337330,30,0,3586,85
2020-08-25,Japan,NA,Saitama,7337330,35,0,3621,85
2020-08-26,Japan,NA,Saitama,7337330,54,0,3675,85
2020-08-27,Japan,NA,Saitama,7337330,69,1,3744,86
2020-08-28,Japan,NA,Saitama,7337330,56,1,3800,87
2020-08-29,Japan,NA,Saitama,7337330,55,1,3855,88
2020-08-30,Japan,NA,Saitama,7337330,42,0,3897,88
2020-08-31,Japan,NA,Saitama,7337330,25,0,3922,88
2020-09-01,Japan,NA,Saitama,7337330,46,1,3968,89
2020-09-02,Japan,NA,Saitama,7337330,40,0,4008,89
2020-09-03,Japan,NA,Saitama,7337330,42,0,4050,89
2020-09-04,Japan,NA,Saitama,7337330,24,0,4074,89
2020-09-05,Japan,NA,Saitama,7337330,22,3,4096,92
2020-09-06,Japan,NA,Saitama,7337330,21,0,4117,92
2020-09-07,Japan,NA,Saitama,7337330,14,1,4131,93
2020-09-08,Japan,NA,Saitama,7337330,12,1,4143,94
2020-09-09,Japan,NA,Saitama,7337330,25,2,4168,96
2020-09-10,Japan,NA,Saitama,7337330,30,0,4198,96
2020-09-11,Japan,NA,Saitama,7337330,25,0,4223,96
2020-09-12,Japan,NA,Saitama,7337330,36,0,4259,96
2020-09-13,Japan,NA,Saitama,7337330,22,0,4281,96
2020-09-14,Japan,NA,Saitama,7337330,16,0,4297,96
2020-09-15,Japan,NA,Saitama,7337330,19,0,4316,96
2020-09-16,Japan,NA,Saitama,7337330,29,0,4345,96
2020-09-17,Japan,NA,Saitama,7337330,20,0,4365,96
2020-09-18,Japan,NA,Saitama,7337330,24,2,4389,98
2020-09-19,Japan,NA,Saitama,7337330,23,1,4412,99
2020-09-20,Japan,NA,Saitama,7337330,16,0,4428,99
2020-09-21,Japan,NA,Saitama,7337330,15,0,4443,99
2020-09-22,Japan,NA,Saitama,7337330,14,0,4457,99
2020-09-23,Japan,NA,Saitama,7337330,12,0,4469,99
2020-04-01,Japan,NA,Shizuoka,3639226,2,0,12,0
2020-04-02,Japan,NA,Shizuoka,3639226,1,0,13,0
2020-04-03,Japan,NA,Shizuoka,3639226,2,0,15,0
2020-04-04,Japan,NA,Shizuoka,3639226,1,0,16,0
2020-04-05,Japan,NA,Shizuoka,3639226,0,0,16,0
2020-04-06,Japan,NA,Shizuoka,3639226,2,0,18,0
2020-04-07,Japan,NA,Shizuoka,3639226,3,0,21,0
2020-04-08,Japan,NA,Shizuoka,3639226,9,0,30,0
2020-04-09,Japan,NA,Shizuoka,3639226,2,0,32,0
2020-04-10,Japan,NA,Shizuoka,3639226,4,0,36,0
2020-04-11,Japan,NA,Shizuoka,3639226,2,0,38,0
2020-04-12,Japan,NA,Shizuoka,3639226,2,0,40,0
2020-04-13,Japan,NA,Shizuoka,3639226,5,0,45,0
2020-04-14,Japan,NA,Shizuoka,3639226,1,0,46,0
2020-04-15,Japan,NA,Shizuoka,3639226,1,0,47,0
2020-04-16,Japan,NA,Shizuoka,3639226,1,0,48,0
2020-04-17,Japan,NA,Shizuoka,3639226,1,0,49,0
2020-04-18,Japan,NA,Shizuoka,3639226,0,0,49,0
2020-04-19,Japan,NA,Shizuoka,3639226,2,0,51,0
2020-04-20,Japan,NA,Shizuoka,3639226,0,0,51,0
2020-04-21,Japan,NA,Shizuoka,3639226,1,0,52,0
2020-04-22,Japan,NA,Shizuoka,3639226,4,0,56,0
2020-04-23,Japan,NA,Shizuoka,3639226,1,0,57,0
2020-04-24,Japan,NA,Shizuoka,3639226,1,0,58,0
2020-04-25,Japan,NA,Shizuoka,3639226,3,0,61,0
2020-04-26,Japan,NA,Shizuoka,3639226,1,0,62,0
2020-04-27,Japan,NA,Shizuoka,3639226,1,0,63,0
2020-04-28,Japan,NA,Shizuoka,3639226,3,0,66,0
2020-04-29,Japan,NA,Shizuoka,3639226,1,0,67,0
2020-04-30,Japan,NA,Shizuoka,3639226,4,1,71,1
2020-05-01,Japan,NA,Shizuoka,3639226,1,0,72,1
2020-05-02,Japan,NA,Shizuoka,3639226,0,0,72,1
2020-05-03,Japan,NA,Shizuoka,3639226,0,0,72,1
2020-05-04,Japan,NA,Shizuoka,3639226,0,0,72,1
2020-05-05,Japan,NA,Shizuoka,3639226,0,0,72,1
2020-05-06,Japan,NA,Shizuoka,3639226,0,0,72,1
2020-05-07,Japan,NA,Shizuoka,3639226,0,0,72,1
2020-05-08,Japan,NA,Shizuoka,3639226,0,0,72,1
2020-05-09,Japan,NA,Shizuoka,3639226,0,0,72,1
2020-05-10,Japan,NA,Shizuoka,3639226,0,0,72,1
2020-05-11,Japan,NA,Shizuoka,3639226,0,0,72,1
2020-05-12,Japan,NA,Shizuoka,3639226,0,0,72,1
2020-05-13,Japan,NA,Shizuoka,3639226,0,0,72,1
2020-05-14,Japan,NA,Shizuoka,3639226,0,0,72,1
2020-05-15,Japan,NA,Shizuoka,3639226,0,0,72,1
2020-05-16,Japan,NA,Shizuoka,3639226,0,0,72,1
2020-05-17,Japan,NA,Shizuoka,3639226,0,0,72,1
2020-05-18,Japan,NA,Shizuoka,3639226,0,0,72,1
2020-05-19,Japan,NA,Shizuoka,3639226,0,0,72,1
2020-05-20,Japan,NA,Shizuoka,3639226,0,0,72,1
2020-05-21,Japan,NA,Shizuoka,3639226,1,0,73,1
2020-05-22,Japan,NA,Shizuoka,3639226,0,0,73,1
2020-05-23,Japan,NA,Shizuoka,3639226,0,0,73,1
2020-05-24,Japan,NA,Shizuoka,3639226,1,0,74,1
2020-05-25,Japan,NA,Shizuoka,3639226,0,0,74,1
2020-05-26,Japan,NA,Shizuoka,3639226,0,0,74,1
2020-05-27,Japan,NA,Shizuoka,3639226,0,0,74,1
2020-05-28,Japan,NA,Shizuoka,3639226,0,0,74,1
2020-05-29,Japan,NA,Shizuoka,3639226,0,0,74,1
2020-05-30,Japan,NA,Shizuoka,3639226,0,0,74,1
2020-05-31,Japan,NA,Shizuoka,3639226,0,0,74,1
2020-06-01,Japan,NA,Shizuoka,3639226,0,0,74,1
2020-06-02,Japan,NA,Shizuoka,3639226,0,0,74,1
2020-06-03,Japan,NA,Shizuoka,3639226,0,0,74,1
2020-06-04,Japan,NA,Shizuoka,3639226,0,0,74,1
2020-06-05,Japan,NA,Shizuoka,3639226,0,0,74,1
2020-06-06,Japan,NA,Shizuoka,3639226,0,0,74,1
2020-06-07,Japan,NA,Shizuoka,3639226,0,0,74,1
2020-06-08,Japan,NA,Shizuoka,3639226,0,0,74,1
2020-06-09,Japan,NA,Shizuoka,3639226,0,0,74,1
2020-06-10,Japan,NA,Shizuoka,3639226,1,0,75,1
2020-06-11,Japan,NA,Shizuoka,3639226,1,0,76,1
2020-06-12,Japan,NA,Shizuoka,3639226,0,0,76,1
2020-06-13,Japan,NA,Shizuoka,3639226,0,0,76,1
2020-06-14,Japan,NA,Shizuoka,3639226,0,0,76,1
2020-06-15,Japan,NA,Shizuoka,3639226,0,0,76,1
2020-06-16,Japan,NA,Shizuoka,3639226,1,0,77,1
2020-06-17,Japan,NA,Shizuoka,3639226,1,0,78,1
2020-06-18,Japan,NA,Shizuoka,3639226,0,0,78,1
2020-06-19,Japan,NA,Shizuoka,3639226,1,0,79,1
2020-06-20,Japan,NA,Shizuoka,3639226,0,0,79,1
2020-06-21,Japan,NA,Shizuoka,3639226,0,0,79,1
2020-06-22,Japan,NA,Shizuoka,3639226,0,0,79,1
2020-06-23,Japan,NA,Shizuoka,3639226,0,0,79,1
2020-06-24,Japan,NA,Shizuoka,3639226,0,0,79,1
2020-06-25,Japan,NA,Shizuoka,3639226,0,0,79,1
2020-06-26,Japan,NA,Shizuoka,3639226,0,0,79,1
2020-06-27,Japan,NA,Shizuoka,3639226,0,0,79,1
2020-06-28,Japan,NA,Shizuoka,3639226,0,0,79,1
2020-06-29,Japan,NA,Shizuoka,3639226,1,0,80,1
2020-06-30,Japan,NA,Shizuoka,3639226,0,0,80,1
2020-07-01,Japan,NA,Shizuoka,3639226,0,0,80,1
2020-07-02,Japan,NA,Shizuoka,3639226,0,0,80,1
2020-07-03,Japan,NA,Shizuoka,3639226,5,0,85,1
2020-07-04,Japan,NA,Shizuoka,3639226,0,0,85,1
2020-07-05,Japan,NA,Shizuoka,3639226,0,0,85,1
2020-07-06,Japan,NA,Shizuoka,3639226,0,0,85,1
2020-07-07,Japan,NA,Shizuoka,3639226,2,0,87,1
2020-07-08,Japan,NA,Shizuoka,3639226,1,0,88,1
2020-07-09,Japan,NA,Shizuoka,3639226,2,0,90,1
2020-07-10,Japan,NA,Shizuoka,3639226,1,0,91,1
2020-07-11,Japan,NA,Shizuoka,3639226,0,0,91,1
2020-07-12,Japan,NA,Shizuoka,3639226,2,0,93,1
2020-07-13,Japan,NA,Shizuoka,3639226,0,0,93,1
2020-07-14,Japan,NA,Shizuoka,3639226,2,0,95,1
2020-07-15,Japan,NA,Shizuoka,3639226,1,0,96,1
2020-07-16,Japan,NA,Shizuoka,3639226,2,0,98,1
2020-07-17,Japan,NA,Shizuoka,3639226,3,0,101,1
2020-07-18,Japan,NA,Shizuoka,3639226,2,0,103,1
2020-07-19,Japan,NA,Shizuoka,3639226,4,0,107,1
2020-07-20,Japan,NA,Shizuoka,3639226,1,0,108,1
2020-07-21,Japan,NA,Shizuoka,3639226,5,0,113,1
2020-07-22,Japan,NA,Shizuoka,3639226,5,0,118,1
2020-07-23,Japan,NA,Shizuoka,3639226,5,0,123,1
2020-07-24,Japan,NA,Shizuoka,3639226,7,0,130,1
2020-07-25,Japan,NA,Shizuoka,3639226,30,0,160,1
2020-07-26,Japan,NA,Shizuoka,3639226,25,0,185,1
2020-07-27,Japan,NA,Shizuoka,3639226,14,0,199,1
2020-07-28,Japan,NA,Shizuoka,3639226,18,0,217,1
2020-07-29,Japan,NA,Shizuoka,3639226,16,0,233,1
2020-07-30,Japan,NA,Shizuoka,3639226,16,0,249,1
2020-07-31,Japan,NA,Shizuoka,3639226,23,0,272,1
2020-08-01,Japan,NA,Shizuoka,3639226,16,0,288,1
2020-08-02,Japan,NA,Shizuoka,3639226,18,0,306,1
2020-08-03,Japan,NA,Shizuoka,3639226,2,0,308,1
2020-08-04,Japan,NA,Shizuoka,3639226,16,0,324,1
2020-08-05,Japan,NA,Shizuoka,3639226,9,0,333,1
2020-08-06,Japan,NA,Shizuoka,3639226,9,0,342,1
2020-08-07,Japan,NA,Shizuoka,3639226,2,0,344,1
2020-08-08,Japan,NA,Shizuoka,3639226,11,0,355,1
2020-08-09,Japan,NA,Shizuoka,3639226,8,0,363,1
2020-08-10,Japan,NA,Shizuoka,3639226,6,0,369,1
2020-08-11,Japan,NA,Shizuoka,3639226,7,0,376,1
2020-08-12,Japan,NA,Shizuoka,3639226,10,0,386,1
2020-08-13,Japan,NA,Shizuoka,3639226,3,0,389,1
2020-08-14,Japan,NA,Shizuoka,3639226,13,0,402,1
2020-08-15,Japan,NA,Shizuoka,3639226,7,0,409,1
2020-08-16,Japan,NA,Shizuoka,3639226,7,0,416,1
2020-08-17,Japan,NA,Shizuoka,3639226,1,0,417,1
2020-08-18,Japan,NA,Shizuoka,3639226,5,0,422,1
2020-08-19,Japan,NA,Shizuoka,3639226,5,0,427,1
2020-08-20,Japan,NA,Shizuoka,3639226,2,0,429,1
2020-08-21,Japan,NA,Shizuoka,3639226,0,0,429,1
2020-08-22,Japan,NA,Shizuoka,3639226,6,0,435,1
2020-08-23,Japan,NA,Shizuoka,3639226,5,0,440,1
2020-08-24,Japan,NA,Shizuoka,3639226,5,0,445,1
2020-08-25,Japan,NA,Shizuoka,3639226,8,0,453,1
2020-08-26,Japan,NA,Shizuoka,3639226,6,0,459,1
2020-08-27,Japan,NA,Shizuoka,3639226,12,0,471,1
2020-08-28,Japan,NA,Shizuoka,3639226,6,0,477,1
2020-08-29,Japan,NA,Shizuoka,3639226,2,0,479,1
2020-08-30,Japan,NA,Shizuoka,3639226,0,0,479,1
2020-08-31,Japan,NA,Shizuoka,3639226,0,0,479,1
2020-09-01,Japan,NA,Shizuoka,3639226,2,0,481,1
2020-09-02,Japan,NA,Shizuoka,3639226,2,0,483,1
2020-09-03,Japan,NA,Shizuoka,3639226,1,0,484,1
2020-09-04,Japan,NA,Shizuoka,3639226,2,0,486,1
2020-09-05,Japan,NA,Shizuoka,3639226,7,0,493,1
2020-09-06,Japan,NA,Shizuoka,3639226,0,0,493,1
2020-09-07,Japan,NA,Shizuoka,3639226,0,0,493,1
2020-09-08,Japan,NA,Shizuoka,3639226,0,0,493,1
2020-09-09,Japan,NA,Shizuoka,3639226,5,0,498,1
2020-09-10,Japan,NA,Shizuoka,3639226,4,0,502,1
2020-09-11,Japan,NA,Shizuoka,3639226,1,0,503,1
2020-09-12,Japan,NA,Shizuoka,3639226,0,0,503,1
2020-09-13,Japan,NA,Shizuoka,3639226,0,1,503,2
2020-09-14,Japan,NA,Shizuoka,3639226,0,0,503,2
2020-09-15,Japan,NA,Shizuoka,3639226,2,0,505,2
2020-09-16,Japan,NA,Shizuoka,3639226,5,0,510,2
2020-09-17,Japan,NA,Shizuoka,3639226,3,0,513,2
2020-09-18,Japan,NA,Shizuoka,3639226,3,0,516,2
2020-09-19,Japan,NA,Shizuoka,3639226,2,0,518,2
2020-09-20,Japan,NA,Shizuoka,3639226,3,0,521,2
2020-02-15,Japan,NA,Tokyo,13942856,8,0,14,0
2020-02-16,Japan,NA,Tokyo,13942856,5,0,19,0
2020-02-17,Japan,NA,Tokyo,13942856,0,0,19,0
2020-02-18,Japan,NA,Tokyo,13942856,3,0,22,0
2020-02-19,Japan,NA,Tokyo,13942856,3,0,25,0
2020-02-20,Japan,NA,Tokyo,13942856,0,0,25,0
2020-02-21,Japan,NA,Tokyo,13942856,3,0,28,0
2020-02-22,Japan,NA,Tokyo,13942856,1,0,29,0
2020-02-23,Japan,NA,Tokyo,13942856,0,0,29,0
2020-02-24,Japan,NA,Tokyo,13942856,3,0,32,0
2020-02-25,Japan,NA,Tokyo,13942856,0,0,32,0
2020-02-26,Japan,NA,Tokyo,13942856,3,1,35,1
2020-02-27,Japan,NA,Tokyo,13942856,1,0,36,1
2020-02-28,Japan,NA,Tokyo,13942856,0,0,36,1
2020-02-29,Japan,NA,Tokyo,13942856,1,0,37,1
2020-03-01,Japan,NA,Tokyo,13942856,2,0,39,1
2020-03-02,Japan,NA,Tokyo,13942856,0,0,39,1
2020-03-03,Japan,NA,Tokyo,13942856,1,0,40,1
2020-03-04,Japan,NA,Tokyo,13942856,4,0,44,1
2020-03-05,Japan,NA,Tokyo,13942856,8,0,52,1
2020-03-06,Japan,NA,Tokyo,13942856,6,0,58,1
2020-03-07,Japan,NA,Tokyo,13942856,6,0,64,1
2020-03-08,Japan,NA,Tokyo,13942856,0,0,64,1
2020-03-09,Japan,NA,Tokyo,13942856,0,1,64,2
2020-03-10,Japan,NA,Tokyo,13942856,3,0,67,2
2020-03-11,Japan,NA,Tokyo,13942856,6,0,73,2
2020-03-12,Japan,NA,Tokyo,13942856,2,0,75,2
2020-03-13,Japan,NA,Tokyo,13942856,2,0,77,2
2020-03-14,Japan,NA,Tokyo,13942856,10,0,87,2
2020-03-15,Japan,NA,Tokyo,13942856,3,0,90,2
2020-03-16,Japan,NA,Tokyo,13942856,0,0,90,2
2020-03-17,Japan,NA,Tokyo,13942856,12,0,102,2
2020-03-18,Japan,NA,Tokyo,13942856,9,0,111,2
2020-03-19,Japan,NA,Tokyo,13942856,7,0,118,2
2020-03-20,Japan,NA,Tokyo,13942856,11,1,129,3
2020-03-21,Japan,NA,Tokyo,13942856,7,1,136,4
2020-03-22,Japan,NA,Tokyo,13942856,3,0,139,4
2020-03-23,Japan,NA,Tokyo,13942856,16,0,155,4
2020-03-24,Japan,NA,Tokyo,13942856,18,1,173,5
2020-03-25,Japan,NA,Tokyo,13942856,41,0,214,5
2020-03-26,Japan,NA,Tokyo,13942856,46,0,260,5
2020-03-27,Japan,NA,Tokyo,13942856,40,1,300,6
2020-03-28,Japan,NA,Tokyo,13942856,64,1,364,7
2020-03-29,Japan,NA,Tokyo,13942856,72,1,436,8
2020-03-30,Japan,NA,Tokyo,13942856,12,1,448,9
2020-03-31,Japan,NA,Tokyo,13942856,78,7,526,16
2020-04-01,Japan,NA,Tokyo,13942856,67,0,593,16
2020-04-02,Japan,NA,Tokyo,13942856,98,0,691,16
2020-04-03,Japan,NA,Tokyo,13942856,92,2,783,18
2020-04-04,Japan,NA,Tokyo,13942856,118,5,901,23
2020-04-05,Japan,NA,Tokyo,13942856,141,7,1042,30
2020-04-06,Japan,NA,Tokyo,13942856,85,0,1127,30
2020-04-07,Japan,NA,Tokyo,13942856,87,1,1214,31
2020-04-08,Japan,NA,Tokyo,13942856,156,4,1370,35
2020-04-09,Japan,NA,Tokyo,13942856,183,1,1553,36
2020-04-10,Japan,NA,Tokyo,13942856,199,4,1752,40
2020-04-11,Japan,NA,Tokyo,13942856,198,0,1950,40
2020-04-12,Japan,NA,Tokyo,13942856,174,2,2124,42
2020-04-13,Japan,NA,Tokyo,13942856,100,0,2224,42
2020-04-14,Japan,NA,Tokyo,13942856,159,5,2383,47
2020-04-15,Japan,NA,Tokyo,13942856,127,6,2510,53
2020-04-16,Japan,NA,Tokyo,13942856,151,3,2661,56
2020-04-17,Japan,NA,Tokyo,13942856,206,7,2867,63
2020-04-18,Japan,NA,Tokyo,13942856,186,5,3053,68
2020-04-19,Japan,NA,Tokyo,13942856,109,3,3162,71
2020-04-20,Japan,NA,Tokyo,13942856,101,6,3263,77
2020-04-21,Japan,NA,Tokyo,13942856,123,4,3386,81
2020-04-22,Japan,NA,Tokyo,13942856,123,0,3509,81
2020-04-23,Japan,NA,Tokyo,13942856,134,6,3643,87
2020-04-24,Japan,NA,Tokyo,13942856,170,6,3813,93
2020-04-25,Japan,NA,Tokyo,13942856,119,7,3932,100
2020-04-26,Japan,NA,Tokyo,13942856,82,0,4014,100
2020-04-27,Japan,NA,Tokyo,13942856,41,6,4055,106
2020-04-28,Japan,NA,Tokyo,13942856,113,2,4168,108
2020-04-29,Japan,NA,Tokyo,13942856,47,9,4215,117
2020-04-30,Japan,NA,Tokyo,13942856,59,3,4274,120
2020-05-01,Japan,NA,Tokyo,13942856,165,6,4439,126
2020-05-02,Japan,NA,Tokyo,13942856,154,15,4593,141
2020-05-03,Japan,NA,Tokyo,13942856,93,4,4686,145
2020-05-04,Japan,NA,Tokyo,13942856,87,5,4773,150
2020-05-05,Japan,NA,Tokyo,13942856,57,0,4830,150
2020-05-06,Japan,NA,Tokyo,13942856,37,5,4867,155
2020-05-07,Japan,NA,Tokyo,13942856,23,5,4890,160
2020-05-08,Japan,NA,Tokyo,13942856,39,11,4929,171
2020-05-09,Japan,NA,Tokyo,13942856,36,9,4965,180
2020-05-10,Japan,NA,Tokyo,13942856,22,0,4987,180
2020-05-11,Japan,NA,Tokyo,13942856,15,9,5002,189
2020-05-12,Japan,NA,Tokyo,13942856,27,7,5029,196
2020-05-13,Japan,NA,Tokyo,13942856,10,7,5039,203
2020-05-14,Japan,NA,Tokyo,13942856,30,9,5069,212
2020-05-15,Japan,NA,Tokyo,13942856,9,7,5078,219
2020-05-16,Japan,NA,Tokyo,13942856,14,11,5092,230
2020-05-17,Japan,NA,Tokyo,13942856,5,7,5097,237
2020-05-18,Japan,NA,Tokyo,13942856,10,4,5107,241
2020-05-19,Japan,NA,Tokyo,13942856,5,3,5112,244
2020-05-20,Japan,NA,Tokyo,13942856,5,3,5117,247
2020-05-21,Japan,NA,Tokyo,13942856,11,9,5128,256
2020-05-22,Japan,NA,Tokyo,13942856,3,7,5131,263
2020-05-23,Japan,NA,Tokyo,13942856,2,8,5133,271
2020-05-24,Japan,NA,Tokyo,13942856,14,9,5147,280
2020-05-25,Japan,NA,Tokyo,13942856,8,8,5155,288
2020-05-26,Japan,NA,Tokyo,13942856,10,4,5165,292
2020-05-27,Japan,NA,Tokyo,13942856,11,4,5176,296
2020-05-28,Japan,NA,Tokyo,13942856,15,3,5191,299
2020-05-29,Japan,NA,Tokyo,13942856,21,3,5212,302
2020-05-30,Japan,NA,Tokyo,13942856,14,2,5226,304
2020-05-31,Japan,NA,Tokyo,13942856,5,1,5231,305
2020-06-01,Japan,NA,Tokyo,13942856,13,0,5244,305
2020-06-02,Japan,NA,Tokyo,13942856,34,1,5278,306
2020-06-03,Japan,NA,Tokyo,13942856,12,0,5290,306
2020-06-04,Japan,NA,Tokyo,13942856,28,1,5318,307
2020-06-05,Japan,NA,Tokyo,13942856,20,2,5338,309
2020-06-06,Japan,NA,Tokyo,13942856,26,2,5364,311
2020-06-07,Japan,NA,Tokyo,13942856,14,0,5378,311
2020-06-08,Japan,NA,Tokyo,13942856,13,0,5391,311
2020-06-09,Japan,NA,Tokyo,13942856,12,0,5403,311
2020-06-10,Japan,NA,Tokyo,13942856,18,0,5421,311
2020-06-11,Japan,NA,Tokyo,13942856,22,0,5443,311
2020-06-12,Japan,NA,Tokyo,13942856,25,2,5468,313
2020-06-13,Japan,NA,Tokyo,13942856,24,1,5492,314
2020-06-14,Japan,NA,Tokyo,13942856,47,0,5539,314
2020-06-15,Japan,NA,Tokyo,13942856,48,0,5587,314
2020-06-16,Japan,NA,Tokyo,13942856,27,2,5614,316
2020-06-17,Japan,NA,Tokyo,13942856,16,1,5630,317
2020-06-18,Japan,NA,Tokyo,13942856,41,0,5671,317
2020-06-19,Japan,NA,Tokyo,13942856,35,3,5706,320
2020-06-20,Japan,NA,Tokyo,13942856,39,0,5745,320
2020-06-21,Japan,NA,Tokyo,13942856,34,0,5779,320
2020-06-22,Japan,NA,Tokyo,13942856,29,1,5808,321
2020-06-23,Japan,NA,Tokyo,13942856,31,2,5839,323
2020-06-24,Japan,NA,Tokyo,13942856,55,2,5894,325
2020-06-25,Japan,NA,Tokyo,13942856,48,0,5942,325
2020-06-26,Japan,NA,Tokyo,13942856,54,0,5996,325
2020-06-27,Japan,NA,Tokyo,13942856,57,0,6053,325
2020-06-28,Japan,NA,Tokyo,13942856,60,0,6113,325
2020-06-29,Japan,NA,Tokyo,13942856,58,0,6171,325
2020-06-30,Japan,NA,Tokyo,13942856,54,0,6225,325
2020-07-01,Japan,NA,Tokyo,13942856,67,0,6292,325
2020-07-02,Japan,NA,Tokyo,13942856,107,0,6399,325
2020-07-03,Japan,NA,Tokyo,13942856,124,0,6523,325
2020-07-04,Japan,NA,Tokyo,13942856,131,0,6654,325
2020-07-05,Japan,NA,Tokyo,13942856,111,0,6765,325
2020-07-06,Japan,NA,Tokyo,13942856,102,0,6867,325
2020-07-07,Japan,NA,Tokyo,13942856,106,0,6973,325
2020-07-08,Japan,NA,Tokyo,13942856,75,0,7048,325
2020-07-09,Japan,NA,Tokyo,13942856,224,0,7272,325
2020-07-10,Japan,NA,Tokyo,13942856,243,0,7515,325
2020-07-11,Japan,NA,Tokyo,13942856,206,0,7721,325
2020-07-12,Japan,NA,Tokyo,13942856,206,0,7927,325
2020-07-13,Japan,NA,Tokyo,13942856,119,0,8046,325
2020-07-14,Japan,NA,Tokyo,13942856,143,0,8189,325
2020-07-15,Japan,NA,Tokyo,13942856,165,1,8354,326
2020-07-16,Japan,NA,Tokyo,13942856,286,0,8640,326
2020-07-17,Japan,NA,Tokyo,13942856,293,0,8933,326
2020-07-18,Japan,NA,Tokyo,13942856,290,0,9223,326
2020-07-19,Japan,NA,Tokyo,13942856,188,0,9411,326
2020-07-20,Japan,NA,Tokyo,13942856,168,1,9579,327
2020-07-21,Japan,NA,Tokyo,13942856,237,0,9816,327
2020-07-22,Japan,NA,Tokyo,13942856,238,0,10054,327
2020-07-23,Japan,NA,Tokyo,13942856,366,0,10420,327
2020-07-24,Japan,NA,Tokyo,13942856,260,0,10680,327
2020-07-25,Japan,NA,Tokyo,13942856,295,1,10975,328
2020-07-26,Japan,NA,Tokyo,13942856,239,0,11214,328
2020-07-27,Japan,NA,Tokyo,13942856,131,0,11345,328
2020-07-28,Japan,NA,Tokyo,13942856,266,0,11611,328
2020-07-29,Japan,NA,Tokyo,13942856,250,1,11861,329
2020-07-30,Japan,NA,Tokyo,13942856,367,1,12228,330
2020-07-31,Japan,NA,Tokyo,13942856,463,2,12691,332
2020-08-01,Japan,NA,Tokyo,13942856,472,0,13163,332
2020-08-02,Japan,NA,Tokyo,13942856,292,0,13455,332
2020-08-03,Japan,NA,Tokyo,13942856,258,1,13713,333
2020-08-04,Japan,NA,Tokyo,13942856,309,0,14022,333
2020-08-05,Japan,NA,Tokyo,13942856,263,0,14285,333
2020-08-06,Japan,NA,Tokyo,13942856,360,0,14645,333
2020-08-07,Japan,NA,Tokyo,13942856,462,0,15107,333
2020-08-08,Japan,NA,Tokyo,13942856,429,0,15536,333
2020-08-09,Japan,NA,Tokyo,13942856,331,0,15867,333
2020-08-10,Japan,NA,Tokyo,13942856,197,1,16064,334
2020-08-11,Japan,NA,Tokyo,13942856,188,2,16252,336
2020-08-12,Japan,NA,Tokyo,13942856,222,0,16474,336
2020-08-13,Japan,NA,Tokyo,13942856,206,2,16680,338
2020-08-14,Japan,NA,Tokyo,13942856,389,0,17069,338
2020-08-15,Japan,NA,Tokyo,13942856,385,0,17454,338
2020-08-16,Japan,NA,Tokyo,13942856,260,2,17714,340
2020-08-17,Japan,NA,Tokyo,13942856,161,1,17875,341
2020-08-18,Japan,NA,Tokyo,13942856,207,3,18082,344
2020-08-19,Japan,NA,Tokyo,13942856,186,3,18268,347
2020-08-20,Japan,NA,Tokyo,13942856,339,1,18607,348
2020-08-21,Japan,NA,Tokyo,13942856,258,2,18865,350
2020-08-22,Japan,NA,Tokyo,13942856,256,0,19121,350
2020-08-23,Japan,NA,Tokyo,13942856,212,0,19333,350
2020-08-24,Japan,NA,Tokyo,13942856,95,2,19428,352
2020-08-25,Japan,NA,Tokyo,13942856,182,2,19610,354
2020-08-26,Japan,NA,Tokyo,13942856,236,2,19846,356
2020-08-27,Japan,NA,Tokyo,13942856,250,0,20096,356
2020-08-28,Japan,NA,Tokyo,13942856,226,2,20322,358
2020-08-29,Japan,NA,Tokyo,13942856,247,0,20569,358
2020-08-30,Japan,NA,Tokyo,13942856,148,2,20717,360
2020-08-31,Japan,NA,Tokyo,13942856,100,3,20817,363
2020-09-01,Japan,NA,Tokyo,13942856,170,1,20987,364
2020-09-02,Japan,NA,Tokyo,13942856,141,0,21128,364
2020-09-03,Japan,NA,Tokyo,13942856,211,1,21339,365
2020-09-04,Japan,NA,Tokyo,13942856,136,4,21475,369
2020-09-05,Japan,NA,Tokyo,13942856,181,0,21656,369
2020-09-06,Japan,NA,Tokyo,13942856,116,0,21772,369
2020-09-07,Japan,NA,Tokyo,13942856,77,3,21849,372
2020-09-08,Japan,NA,Tokyo,13942856,170,6,22019,378
2020-09-09,Japan,NA,Tokyo,13942856,149,1,22168,379
2020-09-10,Japan,NA,Tokyo,13942856,276,0,22444,379
2020-09-11,Japan,NA,Tokyo,13942856,187,1,22631,380
2020-09-12,Japan,NA,Tokyo,13942856,226,2,22857,382
2020-09-13,Japan,NA,Tokyo,13942856,146,0,23003,382
2020-09-14,Japan,NA,Tokyo,13942856,80,2,23083,384
2020-09-15,Japan,NA,Tokyo,13942856,191,2,23274,386
2020-09-16,Japan,NA,Tokyo,13942856,163,3,23437,389
2020-09-17,Japan,NA,Tokyo,13942856,171,0,23608,389
2020-09-18,Japan,NA,Tokyo,13942856,220,1,23828,390
2020-09-19,Japan,NA,Tokyo,13942856,218,0,24046,390
2020-09-20,Japan,NA,Tokyo,13942856,162,0,24208,390
2020-09-21,Japan,NA,Tokyo,13942856,98,1,24306,391
2020-09-22,Japan,NA,Tokyo,13942856,88,0,24394,391
2020-09-23,Japan,NA,Tokyo,13942856,59,1,24453,392
2020-03-23,Mexico,NA,Aguascalientes,1184996,4,0,14,0
2020-03-25,Mexico,NA,Aguascalientes,1184996,17,0,31,0
2020-03-26,Mexico,NA,Aguascalientes,1184996,4,0,35,0
2020-03-27,Mexico,NA,Aguascalientes,1184996,6,0,41,0
2020-03-28,Mexico,NA,Aguascalientes,1184996,5,0,46,0
2020-03-29,Mexico,NA,Aguascalientes,1184996,3,0,49,0
2020-03-30,Mexico,NA,Aguascalientes,1184996,4,0,53,0
2020-03-31,Mexico,NA,Aguascalientes,1184996,1,0,54,0
2020-04-03,Mexico,NA,Aguascalientes,1184996,2,0,56,0
2020-04-05,Mexico,NA,Aguascalientes,1184996,2,0,58,0
2020-04-06,Mexico,NA,Aguascalientes,1184996,4,0,62,0
2020-04-07,Mexico,NA,Aguascalientes,1184996,1,0,63,0
2020-04-08,Mexico,NA,Aguascalientes,1184996,1,0,64,0
2020-04-10,Mexico,NA,Aguascalientes,1184996,3,1,67,1
2020-04-11,Mexico,NA,Aguascalientes,1184996,1,0,68,1
2020-04-12,Mexico,NA,Aguascalientes,1184996,2,0,70,1
2020-04-13,Mexico,NA,Aguascalientes,1184996,8,1,78,2
2020-04-14,Mexico,NA,Aguascalientes,1184996,2,0,80,2
2020-04-15,Mexico,NA,Aguascalientes,1184996,12,0,92,2
2020-04-16,Mexico,NA,Aguascalientes,1184996,7,0,99,2
2020-04-17,Mexico,NA,Aguascalientes,1184996,18,1,117,3
2020-04-18,Mexico,NA,Aguascalientes,1184996,13,0,130,3
2020-04-19,Mexico,NA,Aguascalientes,1184996,3,1,133,4
2020-04-20,Mexico,NA,Aguascalientes,1184996,17,0,150,4
2020-04-21,Mexico,NA,Aguascalientes,1184996,13,0,163,4
2020-04-22,Mexico,NA,Aguascalientes,1184996,11,1,174,5
2020-04-23,Mexico,NA,Aguascalientes,1184996,21,0,195,5
2020-04-24,Mexico,NA,Aguascalientes,1184996,11,0,206,5
2020-04-25,Mexico,NA,Aguascalientes,1184996,1,0,207,5
2020-04-26,Mexico,NA,Aguascalientes,1184996,7,0,214,5
2020-04-27,Mexico,NA,Aguascalientes,1184996,17,1,231,6
2020-04-28,Mexico,NA,Aguascalientes,1184996,32,1,263,7
2020-04-29,Mexico,NA,Aguascalientes,1184996,18,0,281,7
2020-04-30,Mexico,NA,Aguascalientes,1184996,27,1,308,8
2020-05-01,Mexico,NA,Aguascalientes,1184996,4,0,312,8
2020-05-02,Mexico,NA,Aguascalientes,1184996,4,0,316,8
2020-05-03,Mexico,NA,Aguascalientes,1184996,4,0,320,8
2020-05-04,Mexico,NA,Aguascalientes,1184996,50,1,370,9
2020-05-05,Mexico,NA,Aguascalientes,1184996,12,0,382,9
2020-05-06,Mexico,NA,Aguascalientes,1184996,16,3,398,12
2020-05-07,Mexico,NA,Aguascalientes,1184996,24,3,422,15
2020-05-08,Mexico,NA,Aguascalientes,1184996,14,1,436,16
2020-05-10,Mexico,NA,Aguascalientes,1184996,4,1,440,17
2020-05-11,Mexico,NA,Aguascalientes,1184996,11,0,451,17
2020-05-12,Mexico,NA,Aguascalientes,1184996,43,0,494,17
2020-05-13,Mexico,NA,Aguascalientes,1184996,14,2,508,19
2020-05-14,Mexico,NA,Aguascalientes,1184996,23,1,531,20
2020-05-15,Mexico,NA,Aguascalientes,1184996,28,1,559,21
2020-05-16,Mexico,NA,Aguascalientes,1184996,3,1,562,22
2020-05-17,Mexico,NA,Aguascalientes,1184996,7,4,569,26
2020-05-18,Mexico,NA,Aguascalientes,1184996,37,0,606,26
2020-05-19,Mexico,NA,Aguascalientes,1184996,20,0,626,26
2020-05-20,Mexico,NA,Aguascalientes,1184996,27,0,653,26
2020-05-21,Mexico,NA,Aguascalientes,1184996,30,2,683,28
2020-05-22,Mexico,NA,Aguascalientes,1184996,24,1,707,29
2020-05-23,Mexico,NA,Aguascalientes,1184996,17,0,724,29
2020-05-24,Mexico,NA,Aguascalientes,1184996,8,4,732,33
2020-05-25,Mexico,NA,Aguascalientes,1184996,39,1,771,34
2020-05-26,Mexico,NA,Aguascalientes,1184996,39,1,810,35
2020-05-27,Mexico,NA,Aguascalientes,1184996,36,4,846,39
2020-05-28,Mexico,NA,Aguascalientes,1184996,45,3,891,42
2020-05-29,Mexico,NA,Aguascalientes,1184996,42,3,933,45
2020-05-30,Mexico,NA,Aguascalientes,1184996,15,2,948,47
2020-05-31,Mexico,NA,Aguascalientes,1184996,20,2,968,49
2020-06-01,Mexico,NA,Aguascalientes,1184996,63,2,1031,51
2020-06-02,Mexico,NA,Aguascalientes,1184996,60,3,1091,54
2020-06-03,Mexico,NA,Aguascalientes,1184996,60,4,1151,58
2020-06-04,Mexico,NA,Aguascalientes,1184996,44,4,1195,62
2020-06-05,Mexico,NA,Aguascalientes,1184996,60,1,1255,63
2020-06-06,Mexico,NA,Aguascalientes,1184996,24,5,1279,68
2020-06-07,Mexico,NA,Aguascalientes,1184996,26,4,1305,72
2020-06-08,Mexico,NA,Aguascalientes,1184996,73,2,1378,74
2020-06-09,Mexico,NA,Aguascalientes,1184996,66,4,1444,78
2020-06-10,Mexico,NA,Aguascalientes,1184996,63,6,1507,84
2020-06-11,Mexico,NA,Aguascalientes,1184996,63,3,1570,87
2020-06-12,Mexico,NA,Aguascalientes,1184996,60,7,1630,94
2020-06-13,Mexico,NA,Aguascalientes,1184996,33,2,1663,96
2020-06-14,Mexico,NA,Aguascalientes,1184996,23,3,1686,99
2020-06-15,Mexico,NA,Aguascalientes,1184996,80,3,1766,102
2020-06-16,Mexico,NA,Aguascalientes,1184996,58,5,1824,107
2020-06-17,Mexico,NA,Aguascalientes,1184996,73,4,1897,111
2020-06-18,Mexico,NA,Aguascalientes,1184996,63,6,1960,117
2020-06-19,Mexico,NA,Aguascalientes,1184996,69,5,2029,122
2020-06-20,Mexico,NA,Aguascalientes,1184996,15,4,2044,126
2020-06-21,Mexico,NA,Aguascalientes,1184996,26,5,2070,131
2020-06-22,Mexico,NA,Aguascalientes,1184996,68,1,2138,132
2020-06-23,Mexico,NA,Aguascalientes,1184996,54,2,2192,134
2020-06-24,Mexico,NA,Aguascalientes,1184996,50,6,2242,140
2020-06-25,Mexico,NA,Aguascalientes,1184996,69,3,2311,143
2020-06-26,Mexico,NA,Aguascalientes,1184996,56,10,2367,153
2020-06-27,Mexico,NA,Aguascalientes,1184996,17,4,2384,157
2020-06-28,Mexico,NA,Aguascalientes,1184996,11,1,2395,158
2020-06-29,Mexico,NA,Aguascalientes,1184996,38,4,2433,162
2020-06-30,Mexico,NA,Aguascalientes,1184996,39,2,2472,164
2020-07-01,Mexico,NA,Aguascalientes,1184996,79,2,2551,166
2020-07-02,Mexico,NA,Aguascalientes,1184996,69,3,2620,169
2020-07-03,Mexico,NA,Aguascalientes,1184996,67,4,2687,173
2020-07-04,Mexico,NA,Aguascalientes,1184996,11,8,2698,181
2020-07-05,Mexico,NA,Aguascalientes,1184996,8,4,2706,185
2020-07-06,Mexico,NA,Aguascalientes,1184996,91,2,2797,187
2020-07-07,Mexico,NA,Aguascalientes,1184996,119,6,2916,193
2020-07-08,Mexico,NA,Aguascalientes,1184996,53,6,2969,199
2020-07-09,Mexico,NA,Aguascalientes,1184996,43,3,3012,202
2020-07-10,Mexico,NA,Aguascalientes,1184996,77,1,3089,203
2020-07-11,Mexico,NA,Aguascalientes,1184996,21,4,3110,207
2020-07-12,Mexico,NA,Aguascalientes,1184996,32,4,3142,211
2020-07-13,Mexico,NA,Aguascalientes,1184996,82,3,3224,214
2020-07-14,Mexico,NA,Aguascalientes,1184996,82,5,3306,219
2020-07-15,Mexico,NA,Aguascalientes,1184996,81,3,3387,222
2020-07-16,Mexico,NA,Aguascalientes,1184996,85,4,3472,226
2020-07-17,Mexico,NA,Aguascalientes,1184996,73,2,3545,228
2020-07-18,Mexico,NA,Aguascalientes,1184996,22,3,3567,231
2020-07-19,Mexico,NA,Aguascalientes,1184996,15,2,3582,233
2020-07-20,Mexico,NA,Aguascalientes,1184996,51,4,3633,237
2020-07-21,Mexico,NA,Aguascalientes,1184996,97,2,3730,239
2020-07-22,Mexico,NA,Aguascalientes,1184996,52,2,3782,241
2020-07-23,Mexico,NA,Aguascalientes,1184996,72,8,3854,249
2020-07-24,Mexico,NA,Aguascalientes,1184996,73,8,3927,257
2020-07-25,Mexico,NA,Aguascalientes,1184996,18,5,3945,262
2020-07-26,Mexico,NA,Aguascalientes,1184996,21,4,3966,266
2020-07-27,Mexico,NA,Aguascalientes,1184996,69,3,4035,269
2020-07-28,Mexico,NA,Aguascalientes,1184996,63,3,4098,272
2020-07-29,Mexico,NA,Aguascalientes,1184996,59,2,4157,274
2020-07-30,Mexico,NA,Aguascalientes,1184996,58,3,4215,277
2020-07-31,Mexico,NA,Aguascalientes,1184996,61,4,4276,281
2020-08-01,Mexico,NA,Aguascalientes,1184996,35,3,4311,284
2020-08-02,Mexico,NA,Aguascalientes,1184996,17,2,4328,286
2020-08-03,Mexico,NA,Aguascalientes,1184996,61,2,4389,288
2020-08-04,Mexico,NA,Aguascalientes,1184996,71,6,4460,294
2020-08-05,Mexico,NA,Aguascalientes,1184996,49,2,4509,296
2020-08-06,Mexico,NA,Aguascalientes,1184996,41,6,4550,302
2020-08-07,Mexico,NA,Aguascalientes,1184996,42,7,4592,309
2020-08-08,Mexico,NA,Aguascalientes,1184996,22,5,4614,314
2020-08-09,Mexico,NA,Aguascalientes,1184996,19,5,4633,319
2020-08-10,Mexico,NA,Aguascalientes,1184996,77,3,4710,322
2020-08-11,Mexico,NA,Aguascalientes,1184996,51,3,4761,325
2020-08-12,Mexico,NA,Aguascalientes,1184996,58,5,4819,330
2020-08-13,Mexico,NA,Aguascalientes,1184996,62,5,4881,335
2020-08-14,Mexico,NA,Aguascalientes,1184996,53,5,4934,340
2020-08-15,Mexico,NA,Aguascalientes,1184996,14,8,4948,348
2020-08-16,Mexico,NA,Aguascalientes,1184996,33,4,4981,352
2020-08-17,Mexico,NA,Aguascalientes,1184996,90,4,5071,356
2020-08-18,Mexico,NA,Aguascalientes,1184996,79,5,5150,361
2020-08-19,Mexico,NA,Aguascalientes,1184996,65,4,5215,365
2020-08-20,Mexico,NA,Aguascalientes,1184996,55,5,5270,370
2020-08-21,Mexico,NA,Aguascalientes,1184996,65,5,5335,375
2020-08-22,Mexico,NA,Aguascalientes,1184996,40,2,5375,377
2020-08-23,Mexico,NA,Aguascalientes,1184996,35,2,5410,379
2020-08-24,Mexico,NA,Aguascalientes,1184996,66,13,5476,392
2020-08-25,Mexico,NA,Aguascalientes,1184996,66,6,5542,398
2020-08-26,Mexico,NA,Aguascalientes,1184996,100,5,5642,403
2020-08-27,Mexico,NA,Aguascalientes,1184996,57,10,5699,413
2020-08-28,Mexico,NA,Aguascalientes,1184996,71,6,5770,419
2020-08-29,Mexico,NA,Aguascalientes,1184996,42,4,5812,423
2020-08-30,Mexico,NA,Aguascalientes,1184996,22,1,5834,424
2020-08-31,Mexico,NA,Aguascalientes,1184996,91,9,5925,433
2020-09-01,Mexico,NA,Aguascalientes,1184996,58,4,5983,437
2020-09-02,Mexico,NA,Aguascalientes,1184996,80,14,6063,451
2020-09-03,Mexico,NA,Aguascalientes,1184996,76,6,6139,457
2020-09-04,Mexico,NA,Aguascalientes,1184996,47,9,6186,466
2020-09-05,Mexico,NA,Aguascalientes,1184996,19,8,6205,474
2020-09-06,Mexico,NA,Aguascalientes,1184996,22,5,6227,479
2020-09-07,Mexico,NA,Aguascalientes,1184996,72,8,6299,487
2020-09-08,Mexico,NA,Aguascalientes,1184996,54,9,6353,496
2020-09-09,Mexico,NA,Aguascalientes,1184996,59,7,6412,503
2020-09-10,Mexico,NA,Aguascalientes,1184996,55,2,6467,505
2020-09-11,Mexico,NA,Aguascalientes,1184996,51,5,6518,510
2020-09-12,Mexico,NA,Aguascalientes,1184996,13,6,6531,516
2020-09-13,Mexico,NA,Aguascalientes,1184996,10,4,6541,520
2020-09-14,Mexico,NA,Aguascalientes,1184996,65,8,6606,528
2020-09-15,Mexico,NA,Aguascalientes,1184996,14,5,6620,533
2020-09-16,Mexico,NA,Aguascalientes,1184996,23,7,6643,540
2020-09-17,Mexico,NA,Aguascalientes,1184996,98,6,6741,546
2020-09-18,Mexico,NA,Aguascalientes,1184996,52,7,6793,553
2020-09-19,Mexico,NA,Aguascalientes,1184996,21,4,6814,557
2020-09-20,Mexico,NA,Aguascalientes,1184996,13,7,6827,564
2020-09-21,Mexico,NA,Aguascalientes,1184996,40,9,6867,573
2020-09-22,Mexico,NA,Aguascalientes,1184996,4,4,6871,577
2020-09-23,Mexico,NA,Aguascalientes,1184996,3,2,6874,579
2020-03-19,Mexico,NA,Baja California,3155070,5,0,14,0
2020-03-20,Mexico,NA,Baja California,3155070,6,0,20,0
2020-03-21,Mexico,NA,Baja California,3155070,3,0,23,0
2020-03-22,Mexico,NA,Baja California,3155070,2,0,25,0
2020-03-23,Mexico,NA,Baja California,3155070,10,0,35,0
2020-03-24,Mexico,NA,Baja California,3155070,9,0,44,0
2020-03-25,Mexico,NA,Baja California,3155070,7,0,51,0
2020-03-26,Mexico,NA,Baja California,3155070,11,0,62,0
2020-03-27,Mexico,NA,Baja California,3155070,16,0,78,0
2020-03-28,Mexico,NA,Baja California,3155070,7,0,85,0
2020-03-29,Mexico,NA,Baja California,3155070,21,1,106,1
2020-03-30,Mexico,NA,Baja California,3155070,29,2,135,3
2020-03-31,Mexico,NA,Baja California,3155070,44,2,179,5
2020-04-01,Mexico,NA,Baja California,3155070,66,2,245,7
2020-04-02,Mexico,NA,Baja California,3155070,30,5,275,12
2020-04-03,Mexico,NA,Baja California,3155070,38,2,313,14
2020-04-04,Mexico,NA,Baja California,3155070,25,5,338,19
2020-04-05,Mexico,NA,Baja California,3155070,20,1,358,20
2020-04-06,Mexico,NA,Baja California,3155070,70,10,428,30
2020-04-07,Mexico,NA,Baja California,3155070,41,5,469,35
2020-04-08,Mexico,NA,Baja California,3155070,58,6,527,41
2020-04-09,Mexico,NA,Baja California,3155070,58,5,585,46
2020-04-10,Mexico,NA,Baja California,3155070,49,7,634,53
2020-04-11,Mexico,NA,Baja California,3155070,32,10,666,63
2020-04-12,Mexico,NA,Baja California,3155070,44,12,710,75
2020-04-13,Mexico,NA,Baja California,3155070,81,8,791,83
2020-04-14,Mexico,NA,Baja California,3155070,104,12,895,95
2020-04-15,Mexico,NA,Baja California,3155070,102,17,997,112
2020-04-16,Mexico,NA,Baja California,3155070,84,11,1081,123
2020-04-17,Mexico,NA,Baja California,3155070,99,20,1180,143
2020-04-18,Mexico,NA,Baja California,3155070,46,16,1226,159
2020-04-19,Mexico,NA,Baja California,3155070,44,16,1270,175
2020-04-20,Mexico,NA,Baja California,3155070,110,14,1380,189
2020-04-21,Mexico,NA,Baja California,3155070,108,15,1488,204
2020-04-22,Mexico,NA,Baja California,3155070,91,18,1579,222
2020-04-23,Mexico,NA,Baja California,3155070,111,19,1690,241
2020-04-24,Mexico,NA,Baja California,3155070,87,24,1777,265
2020-04-25,Mexico,NA,Baja California,3155070,44,18,1821,283
2020-04-26,Mexico,NA,Baja California,3155070,68,18,1889,301
2020-04-27,Mexico,NA,Baja California,3155070,112,28,2001,329
2020-04-28,Mexico,NA,Baja California,3155070,98,21,2099,350
2020-04-29,Mexico,NA,Baja California,3155070,109,29,2208,379
2020-04-30,Mexico,NA,Baja California,3155070,89,22,2297,401
2020-05-01,Mexico,NA,Baja California,3155070,92,23,2389,424
2020-05-02,Mexico,NA,Baja California,3155070,78,26,2467,450
2020-05-03,Mexico,NA,Baja California,3155070,91,14,2558,464
2020-05-04,Mexico,NA,Baja California,3155070,145,30,2703,494
2020-05-05,Mexico,NA,Baja California,3155070,141,31,2844,525
2020-05-06,Mexico,NA,Baja California,3155070,118,28,2962,553
2020-05-07,Mexico,NA,Baja California,3155070,123,26,3085,579
2020-05-08,Mexico,NA,Baja California,3155070,142,34,3227,613
2020-05-09,Mexico,NA,Baja California,3155070,75,36,3302,649
2020-05-10,Mexico,NA,Baja California,3155070,69,28,3371,674
2020-05-11,Mexico,NA,Baja California,3155070,130,31,3501,700
2020-05-12,Mexico,NA,Baja California,3155070,125,29,3626,725
2020-05-13,Mexico,NA,Baja California,3155070,129,38,3755,751
2020-05-14,Mexico,NA,Baja California,3155070,113,36,3868,773
2020-05-15,Mexico,NA,Baja California,3155070,147,27,4015,803
2020-05-16,Mexico,NA,Baja California,3155070,70,30,4085,817
2020-05-17,Mexico,NA,Baja California,3155070,72,40,4157,831
2020-05-18,Mexico,NA,Baja California,3155070,215,52,4372,874
2020-05-19,Mexico,NA,Baja California,3155070,156,33,4528,905
2020-05-20,Mexico,NA,Baja California,3155070,170,41,4698,939
2020-05-21,Mexico,NA,Baja California,3155070,230,21,4928,985
2020-05-22,Mexico,NA,Baja California,3155070,208,26,5136,1027
2020-05-23,Mexico,NA,Baja California,3155070,66,27,5202,1040
2020-05-24,Mexico,NA,Baja California,3155070,80,32,5282,1056
2020-05-25,Mexico,NA,Baja California,3155070,136,32,5418,1083
2020-05-26,Mexico,NA,Baja California,3155070,134,30,5552,1110
2020-05-27,Mexico,NA,Baja California,3155070,130,29,5682,1136
2020-05-28,Mexico,NA,Baja California,3155070,118,37,5800,1160
2020-05-29,Mexico,NA,Baja California,3155070,115,18,5915,1183
2020-05-30,Mexico,NA,Baja California,3155070,84,33,5999,1199
2020-05-31,Mexico,NA,Baja California,3155070,71,29,6070,1214
2020-06-01,Mexico,NA,Baja California,3155070,152,32,6222,1244
2020-06-02,Mexico,NA,Baja California,3155070,170,29,6392,1278
2020-06-03,Mexico,NA,Baja California,3155070,162,25,6554,1310
2020-06-04,Mexico,NA,Baja California,3155070,147,28,6701,1340
2020-06-05,Mexico,NA,Baja California,3155070,152,26,6853,1370
2020-06-06,Mexico,NA,Baja California,3155070,103,39,6956,1391
2020-06-07,Mexico,NA,Baja California,3155070,69,28,7025,1405
2020-06-08,Mexico,NA,Baja California,3155070,170,30,7195,1439
2020-06-09,Mexico,NA,Baja California,3155070,172,18,7367,1473
2020-06-10,Mexico,NA,Baja California,3155070,145,29,7512,1502
2020-06-11,Mexico,NA,Baja California,3155070,149,22,7661,1532
2020-06-12,Mexico,NA,Baja California,3155070,110,32,7771,1554
2020-06-13,Mexico,NA,Baja California,3155070,86,27,7857,1571
2020-06-14,Mexico,NA,Baja California,3155070,93,31,7950,1590
2020-06-15,Mexico,NA,Baja California,3155070,177,22,8127,1625
2020-06-16,Mexico,NA,Baja California,3155070,186,18,8313,1662
2020-06-17,Mexico,NA,Baja California,3155070,150,30,8463,1692
2020-06-18,Mexico,NA,Baja California,3155070,143,24,8606,1721
2020-06-19,Mexico,NA,Baja California,3155070,175,22,8781,1756
2020-06-20,Mexico,NA,Baja California,3155070,84,13,8865,1773
2020-06-21,Mexico,NA,Baja California,3155070,62,19,8927,1785
2020-06-22,Mexico,NA,Baja California,3155070,208,23,9135,1827
2020-06-23,Mexico,NA,Baja California,3155070,195,24,9330,1866
2020-06-24,Mexico,NA,Baja California,3155070,178,24,9508,1901
2020-06-25,Mexico,NA,Baja California,3155070,173,25,9681,1936
2020-06-26,Mexico,NA,Baja California,3155070,172,25,9853,1970
2020-06-27,Mexico,NA,Baja California,3155070,110,20,9963,1992
2020-06-28,Mexico,NA,Baja California,3155070,62,16,10025,2005
2020-06-29,Mexico,NA,Baja California,3155070,206,28,10231,2046
2020-06-30,Mexico,NA,Baja California,3155070,194,31,10425,2085
2020-07-01,Mexico,NA,Baja California,3155070,176,22,10601,2120
2020-07-02,Mexico,NA,Baja California,3155070,191,25,10792,2155
2020-07-03,Mexico,NA,Baja California,3155070,162,27,10954,2182
2020-07-04,Mexico,NA,Baja California,3155070,71,27,11025,2205
2020-07-05,Mexico,NA,Baja California,3155070,91,33,11116,2223
2020-07-06,Mexico,NA,Baja California,3155070,208,43,11324,2264
2020-07-07,Mexico,NA,Baja California,3155070,208,28,11532,2306
2020-07-08,Mexico,NA,Baja California,3155070,210,23,11742,2336
2020-07-09,Mexico,NA,Baja California,3155070,158,22,11900,2358
2020-07-10,Mexico,NA,Baja California,3155070,126,28,12026,2386
2020-07-11,Mexico,NA,Baja California,3155070,56,25,12082,2411
2020-07-12,Mexico,NA,Baja California,3155070,72,23,12154,2430
2020-07-13,Mexico,NA,Baja California,3155070,145,18,12299,2452
2020-07-14,Mexico,NA,Baja California,3155070,157,19,12456,2471
2020-07-15,Mexico,NA,Baja California,3155070,166,9,12622,2480
2020-07-16,Mexico,NA,Baja California,3155070,149,23,12771,2503
2020-07-17,Mexico,NA,Baja California,3155070,127,26,12898,2529
2020-07-18,Mexico,NA,Baja California,3155070,77,18,12975,2547
2020-07-19,Mexico,NA,Baja California,3155070,89,24,13064,2571
2020-07-20,Mexico,NA,Baja California,3155070,149,25,13213,2596
2020-07-21,Mexico,NA,Baja California,3155070,132,17,13345,2613
2020-07-22,Mexico,NA,Baja California,3155070,130,21,13475,2634
2020-07-23,Mexico,NA,Baja California,3155070,113,22,13588,2656
2020-07-24,Mexico,NA,Baja California,3155070,125,16,13713,2672
2020-07-25,Mexico,NA,Baja California,3155070,77,27,13790,2699
2020-07-26,Mexico,NA,Baja California,3155070,57,16,13847,2715
2020-07-27,Mexico,NA,Baja California,3155070,134,24,13981,2739
2020-07-28,Mexico,NA,Baja California,3155070,119,20,14100,2759
2020-07-29,Mexico,NA,Baja California,3155070,115,17,14215,2776
2020-07-30,Mexico,NA,Baja California,3155070,131,22,14346,2798
2020-07-31,Mexico,NA,Baja California,3155070,152,16,14498,2814
2020-08-01,Mexico,NA,Baja California,3155070,59,15,14557,2829
2020-08-02,Mexico,NA,Baja California,3155070,62,15,14619,2844
2020-08-03,Mexico,NA,Baja California,3155070,144,23,14763,2867
2020-08-04,Mexico,NA,Baja California,3155070,139,29,14902,2896
2020-08-05,Mexico,NA,Baja California,3155070,109,13,15011,2909
2020-08-06,Mexico,NA,Baja California,3155070,111,10,15122,2919
2020-08-07,Mexico,NA,Baja California,3155070,93,13,15215,2932
2020-08-08,Mexico,NA,Baja California,3155070,60,19,15275,2951
2020-08-09,Mexico,NA,Baja California,3155070,46,7,15321,2958
2020-08-10,Mexico,NA,Baja California,3155070,155,16,15476,2974
2020-08-11,Mexico,NA,Baja California,3155070,108,21,15584,2995
2020-08-12,Mexico,NA,Baja California,3155070,106,6,15690,3001
2020-08-13,Mexico,NA,Baja California,3155070,104,12,15794,3013
2020-08-14,Mexico,NA,Baja California,3155070,94,18,15888,3031
2020-08-15,Mexico,NA,Baja California,3155070,39,13,15927,3044
2020-08-16,Mexico,NA,Baja California,3155070,44,16,15971,3060
2020-08-17,Mexico,NA,Baja California,3155070,163,27,16134,3087
2020-08-18,Mexico,NA,Baja California,3155070,122,18,16256,3105
2020-08-19,Mexico,NA,Baja California,3155070,119,12,16375,3117
2020-08-20,Mexico,NA,Baja California,3155070,132,11,16507,3128
2020-08-21,Mexico,NA,Baja California,3155070,96,13,16603,3141
2020-08-22,Mexico,NA,Baja California,3155070,42,14,16645,3155
2020-08-23,Mexico,NA,Baja California,3155070,39,13,16684,3168
2020-08-24,Mexico,NA,Baja California,3155070,147,16,16831,3184
2020-08-25,Mexico,NA,Baja California,3155070,104,11,16935,3195
2020-08-26,Mexico,NA,Baja California,3155070,87,9,17022,3204
2020-08-27,Mexico,NA,Baja California,3155070,110,7,17132,3211
2020-08-28,Mexico,NA,Baja California,3155070,101,15,17233,3226
2020-08-29,Mexico,NA,Baja California,3155070,38,9,17271,3235
2020-08-30,Mexico,NA,Baja California,3155070,35,21,17306,3256
2020-08-31,Mexico,NA,Baja California,3155070,183,14,17489,3270
2020-09-01,Mexico,NA,Baja California,3155070,181,16,17670,3286
2020-09-02,Mexico,NA,Baja California,3155070,150,15,17820,3301
2020-09-03,Mexico,NA,Baja California,3155070,150,8,17970,3309
2020-09-04,Mexico,NA,Baja California,3155070,117,14,18087,3323
2020-09-05,Mexico,NA,Baja California,3155070,56,12,18143,3335
2020-09-06,Mexico,NA,Baja California,3155070,33,7,18176,3342
2020-09-07,Mexico,NA,Baja California,3155070,122,19,18298,3361
2020-09-08,Mexico,NA,Baja California,3155070,85,8,18383,3369
2020-09-09,Mexico,NA,Baja California,3155070,61,15,18444,3384
2020-09-10,Mexico,NA,Baja California,3155070,39,9,18483,3393
2020-09-11,Mexico,NA,Baja California,3155070,43,7,18526,3400
2020-09-12,Mexico,NA,Baja California,3155070,19,12,18545,3412
2020-09-13,Mexico,NA,Baja California,3155070,16,6,18561,3418
2020-09-14,Mexico,NA,Baja California,3155070,54,14,18615,3432
2020-09-15,Mexico,NA,Baja California,3155070,29,8,18644,3440
2020-09-16,Mexico,NA,Baja California,3155070,18,12,18662,3452
2020-09-17,Mexico,NA,Baja California,3155070,46,9,18708,3461
2020-09-18,Mexico,NA,Baja California,3155070,55,12,18763,3473
2020-09-19,Mexico,NA,Baja California,3155070,11,6,18774,3479
2020-09-20,Mexico,NA,Baja California,3155070,15,7,18789,3486
2020-09-21,Mexico,NA,Baja California,3155070,23,4,18812,3490
2020-09-22,Mexico,NA,Baja California,3155070,10,3,18822,3493
2020-03-26,Mexico,NA,Baja California Sur,637026,2,0,12,0
2020-03-27,Mexico,NA,Baja California Sur,637026,4,0,16,0
2020-03-28,Mexico,NA,Baja California Sur,637026,4,0,20,0
2020-03-29,Mexico,NA,Baja California Sur,637026,1,1,21,1
2020-03-30,Mexico,NA,Baja California Sur,637026,14,0,35,1
2020-03-31,Mexico,NA,Baja California Sur,637026,7,1,42,2
2020-04-01,Mexico,NA,Baja California Sur,637026,5,0,47,2
2020-04-02,Mexico,NA,Baja California Sur,637026,11,0,58,2
2020-04-03,Mexico,NA,Baja California Sur,637026,16,0,74,2
2020-04-04,Mexico,NA,Baja California Sur,637026,5,1,79,3
2020-04-05,Mexico,NA,Baja California Sur,637026,5,1,84,4
2020-04-06,Mexico,NA,Baja California Sur,637026,23,0,107,4
2020-04-07,Mexico,NA,Baja California Sur,637026,24,0,131,4
2020-04-08,Mexico,NA,Baja California Sur,637026,24,1,155,5
2020-04-09,Mexico,NA,Baja California Sur,637026,22,0,177,5
2020-04-10,Mexico,NA,Baja California Sur,637026,9,0,186,5
2020-04-11,Mexico,NA,Baja California Sur,637026,7,1,193,6
2020-04-12,Mexico,NA,Baja California Sur,637026,5,1,198,7
2020-04-13,Mexico,NA,Baja California Sur,637026,14,1,212,8
2020-04-14,Mexico,NA,Baja California Sur,637026,17,0,229,8
2020-04-15,Mexico,NA,Baja California Sur,637026,5,0,234,8
2020-04-16,Mexico,NA,Baja California Sur,637026,9,1,243,9
2020-04-17,Mexico,NA,Baja California Sur,637026,6,1,249,10
2020-04-18,Mexico,NA,Baja California Sur,637026,3,0,252,10
2020-04-19,Mexico,NA,Baja California Sur,637026,8,0,260,10
2020-04-20,Mexico,NA,Baja California Sur,637026,7,1,267,11
2020-04-21,Mexico,NA,Baja California Sur,637026,12,1,279,12
2020-04-22,Mexico,NA,Baja California Sur,637026,5,2,284,14
2020-04-23,Mexico,NA,Baja California Sur,637026,9,0,293,14
2020-04-24,Mexico,NA,Baja California Sur,637026,13,1,306,15
2020-04-25,Mexico,NA,Baja California Sur,637026,5,0,311,15
2020-04-26,Mexico,NA,Baja California Sur,637026,7,2,318,17
2020-04-27,Mexico,NA,Baja California Sur,637026,10,0,328,17
2020-04-28,Mexico,NA,Baja California Sur,637026,4,1,332,18
2020-04-29,Mexico,NA,Baja California Sur,637026,4,1,336,19
2020-04-30,Mexico,NA,Baja California Sur,637026,14,0,350,19
2020-05-01,Mexico,NA,Baja California Sur,637026,2,0,352,19
2020-05-02,Mexico,NA,Baja California Sur,637026,9,0,361,19
2020-05-03,Mexico,NA,Baja California Sur,637026,6,1,367,20
2020-05-04,Mexico,NA,Baja California Sur,637026,7,1,374,21
2020-05-05,Mexico,NA,Baja California Sur,637026,12,0,386,21
2020-05-06,Mexico,NA,Baja California Sur,637026,10,2,396,23
2020-05-07,Mexico,NA,Baja California Sur,637026,11,0,407,23
2020-05-08,Mexico,NA,Baja California Sur,637026,9,2,416,25
2020-05-09,Mexico,NA,Baja California Sur,637026,6,0,422,25
2020-05-10,Mexico,NA,Baja California Sur,637026,10,2,432,27
2020-05-11,Mexico,NA,Baja California Sur,637026,7,1,439,28
2020-05-12,Mexico,NA,Baja California Sur,637026,16,0,455,28
2020-05-13,Mexico,NA,Baja California Sur,637026,13,1,468,29
2020-05-14,Mexico,NA,Baja California Sur,637026,8,1,476,30
2020-05-15,Mexico,NA,Baja California Sur,637026,5,0,481,30
2020-05-16,Mexico,NA,Baja California Sur,637026,11,1,492,31
2020-05-17,Mexico,NA,Baja California Sur,637026,3,1,495,32
2020-05-18,Mexico,NA,Baja California Sur,637026,11,1,506,33
2020-05-19,Mexico,NA,Baja California Sur,637026,15,0,521,33
2020-05-20,Mexico,NA,Baja California Sur,637026,17,1,538,34
2020-05-21,Mexico,NA,Baja California Sur,637026,8,0,546,34
2020-05-22,Mexico,NA,Baja California Sur,637026,15,1,561,35
2020-05-23,Mexico,NA,Baja California Sur,637026,7,0,568,35
2020-05-24,Mexico,NA,Baja California Sur,637026,9,1,577,36
2020-05-25,Mexico,NA,Baja California Sur,637026,16,0,593,36
2020-05-26,Mexico,NA,Baja California Sur,637026,14,1,607,37
2020-05-27,Mexico,NA,Baja California Sur,637026,22,2,629,39
2020-05-28,Mexico,NA,Baja California Sur,637026,18,0,647,39
2020-05-29,Mexico,NA,Baja California Sur,637026,22,1,669,40
2020-05-30,Mexico,NA,Baja California Sur,637026,13,0,682,40
2020-05-31,Mexico,NA,Baja California Sur,637026,8,0,690,40
2020-06-01,Mexico,NA,Baja California Sur,637026,36,1,726,41
2020-06-02,Mexico,NA,Baja California Sur,637026,18,1,744,42
2020-06-03,Mexico,NA,Baja California Sur,637026,16,2,760,44
2020-06-04,Mexico,NA,Baja California Sur,637026,22,3,782,47
2020-06-05,Mexico,NA,Baja California Sur,637026,22,3,804,50
2020-06-06,Mexico,NA,Baja California Sur,637026,14,0,818,50
2020-06-07,Mexico,NA,Baja California Sur,637026,20,0,838,50
2020-06-08,Mexico,NA,Baja California Sur,637026,53,0,891,50
2020-06-09,Mexico,NA,Baja California Sur,637026,38,1,929,51
2020-06-10,Mexico,NA,Baja California Sur,637026,47,0,976,51
2020-06-11,Mexico,NA,Baja California Sur,637026,29,2,1005,53
2020-06-12,Mexico,NA,Baja California Sur,637026,25,2,1030,55
2020-06-13,Mexico,NA,Baja California Sur,637026,22,2,1052,57
2020-06-14,Mexico,NA,Baja California Sur,637026,21,4,1073,61
2020-06-15,Mexico,NA,Baja California Sur,637026,52,4,1125,65
2020-06-16,Mexico,NA,Baja California Sur,637026,30,1,1155,66
2020-06-17,Mexico,NA,Baja California Sur,637026,47,1,1202,67
2020-06-18,Mexico,NA,Baja California Sur,637026,48,1,1250,68
2020-06-19,Mexico,NA,Baja California Sur,637026,19,1,1269,69
2020-06-20,Mexico,NA,Baja California Sur,637026,35,2,1304,71
2020-06-21,Mexico,NA,Baja California Sur,637026,17,0,1321,71
2020-06-22,Mexico,NA,Baja California Sur,637026,33,1,1354,72
2020-06-23,Mexico,NA,Baja California Sur,637026,47,1,1401,73
2020-06-24,Mexico,NA,Baja California Sur,637026,53,1,1454,74
2020-06-25,Mexico,NA,Baja California Sur,637026,54,1,1508,75
2020-06-26,Mexico,NA,Baja California Sur,637026,41,1,1549,76
2020-06-27,Mexico,NA,Baja California Sur,637026,45,3,1594,79
2020-06-28,Mexico,NA,Baja California Sur,637026,35,0,1629,79
2020-06-29,Mexico,NA,Baja California Sur,637026,66,1,1695,80
2020-06-30,Mexico,NA,Baja California Sur,637026,59,4,1754,84
2020-07-01,Mexico,NA,Baja California Sur,637026,73,1,1827,85
2020-07-02,Mexico,NA,Baja California Sur,637026,70,5,1897,90
2020-07-03,Mexico,NA,Baja California Sur,637026,64,4,1961,94
2020-07-04,Mexico,NA,Baja California Sur,637026,57,1,2018,95
2020-07-05,Mexico,NA,Baja California Sur,637026,49,2,2067,97
2020-07-06,Mexico,NA,Baja California Sur,637026,89,2,2156,99
2020-07-07,Mexico,NA,Baja California Sur,637026,113,0,2269,99
2020-07-08,Mexico,NA,Baja California Sur,637026,93,1,2362,100
2020-07-09,Mexico,NA,Baja California Sur,637026,126,3,2488,103
2020-07-10,Mexico,NA,Baja California Sur,637026,118,3,2606,106
2020-07-11,Mexico,NA,Baja California Sur,637026,38,4,2644,110
2020-07-12,Mexico,NA,Baja California Sur,637026,49,5,2693,115
2020-07-13,Mexico,NA,Baja California Sur,637026,130,4,2823,119
2020-07-14,Mexico,NA,Baja California Sur,637026,121,4,2944,123
2020-07-15,Mexico,NA,Baja California Sur,637026,132,3,3076,126
2020-07-16,Mexico,NA,Baja California Sur,637026,117,2,3193,128
2020-07-17,Mexico,NA,Baja California Sur,637026,90,7,3283,135
2020-07-18,Mexico,NA,Baja California Sur,637026,62,2,3345,137
2020-07-19,Mexico,NA,Baja California Sur,637026,40,3,3385,140
2020-07-20,Mexico,NA,Baja California Sur,637026,155,4,3540,144
2020-07-21,Mexico,NA,Baja California Sur,637026,111,4,3651,148
2020-07-22,Mexico,NA,Baja California Sur,637026,115,5,3766,153
2020-07-23,Mexico,NA,Baja California Sur,637026,143,4,3909,157
2020-07-24,Mexico,NA,Baja California Sur,637026,106,7,4015,164
2020-07-25,Mexico,NA,Baja California Sur,637026,67,4,4082,168
2020-07-26,Mexico,NA,Baja California Sur,637026,39,7,4121,175
2020-07-27,Mexico,NA,Baja California Sur,637026,173,5,4294,180
2020-07-28,Mexico,NA,Baja California Sur,637026,152,6,4446,186
2020-07-29,Mexico,NA,Baja California Sur,637026,120,8,4566,194
2020-07-30,Mexico,NA,Baja California Sur,637026,153,9,4719,203
2020-07-31,Mexico,NA,Baja California Sur,637026,101,3,4820,206
2020-08-01,Mexico,NA,Baja California Sur,637026,65,6,4885,212
2020-08-02,Mexico,NA,Baja California Sur,637026,40,4,4925,216
2020-08-03,Mexico,NA,Baja California Sur,637026,163,3,5088,219
2020-08-04,Mexico,NA,Baja California Sur,637026,146,4,5234,223
2020-08-05,Mexico,NA,Baja California Sur,637026,152,4,5386,227
2020-08-06,Mexico,NA,Baja California Sur,637026,123,1,5509,228
2020-08-07,Mexico,NA,Baja California Sur,637026,112,6,5621,234
2020-08-08,Mexico,NA,Baja California Sur,637026,82,8,5703,242
2020-08-09,Mexico,NA,Baja California Sur,637026,45,8,5748,250
2020-08-10,Mexico,NA,Baja California Sur,637026,140,5,5888,255
2020-08-11,Mexico,NA,Baja California Sur,637026,122,13,6010,268
2020-08-12,Mexico,NA,Baja California Sur,637026,129,6,6139,274
2020-08-13,Mexico,NA,Baja California Sur,637026,141,3,6280,277
2020-08-14,Mexico,NA,Baja California Sur,637026,132,9,6412,286
2020-08-15,Mexico,NA,Baja California Sur,637026,57,5,6469,291
2020-08-16,Mexico,NA,Baja California Sur,637026,47,7,6516,298
2020-08-17,Mexico,NA,Baja California Sur,637026,144,7,6660,305
2020-08-18,Mexico,NA,Baja California Sur,637026,141,12,6801,317
2020-08-19,Mexico,NA,Baja California Sur,637026,96,8,6897,325
2020-08-20,Mexico,NA,Baja California Sur,637026,35,6,6932,331
2020-08-21,Mexico,NA,Baja California Sur,637026,80,6,7012,337
2020-08-22,Mexico,NA,Baja California Sur,637026,73,4,7085,341
2020-08-23,Mexico,NA,Baja California Sur,637026,49,6,7134,347
2020-08-24,Mexico,NA,Baja California Sur,637026,144,6,7278,353
2020-08-25,Mexico,NA,Baja California Sur,637026,100,8,7378,361
2020-08-26,Mexico,NA,Baja California Sur,637026,108,3,7486,364
2020-08-27,Mexico,NA,Baja California Sur,637026,122,3,7608,367
2020-08-28,Mexico,NA,Baja California Sur,637026,68,3,7676,370
2020-08-29,Mexico,NA,Baja California Sur,637026,52,5,7728,375
2020-08-30,Mexico,NA,Baja California Sur,637026,63,3,7791,378
2020-08-31,Mexico,NA,Baja California Sur,637026,131,8,7922,386
2020-09-01,Mexico,NA,Baja California Sur,637026,120,5,8042,391
2020-09-02,Mexico,NA,Baja California Sur,637026,134,4,8176,395
2020-09-03,Mexico,NA,Baja California Sur,637026,114,6,8290,401
2020-09-04,Mexico,NA,Baja California Sur,637026,107,3,8397,404
2020-09-05,Mexico,NA,Baja California Sur,637026,57,1,8454,405
2020-09-06,Mexico,NA,Baja California Sur,637026,39,3,8493,408
2020-09-07,Mexico,NA,Baja California Sur,637026,137,1,8630,409
2020-09-08,Mexico,NA,Baja California Sur,637026,129,5,8759,414
2020-09-09,Mexico,NA,Baja California Sur,637026,106,8,8865,422
2020-09-10,Mexico,NA,Baja California Sur,637026,83,2,8948,424
2020-09-11,Mexico,NA,Baja California Sur,637026,94,2,9042,426
2020-09-12,Mexico,NA,Baja California Sur,637026,66,3,9108,429
2020-09-13,Mexico,NA,Baja California Sur,637026,30,4,9138,433
2020-09-14,Mexico,NA,Baja California Sur,637026,98,3,9236,436
2020-09-15,Mexico,NA,Baja California Sur,637026,89,1,9325,437
2020-09-16,Mexico,NA,Baja California Sur,637026,56,1,9381,438
2020-09-17,Mexico,NA,Baja California Sur,637026,89,1,9470,439
2020-09-18,Mexico,NA,Baja California Sur,637026,113,0,9583,439
2020-09-19,Mexico,NA,Baja California Sur,637026,59,4,9642,443
2020-09-20,Mexico,NA,Baja California Sur,637026,19,1,9661,444
2020-09-21,Mexico,NA,Baja California Sur,637026,90,2,9751,446
2020-09-22,Mexico,NA,Baja California Sur,637026,56,1,9807,447
2020-09-23,Mexico,NA,Baja California Sur,637026,2,0,9809,447
2020-04-03,Mexico,NA,Campeche,822441,1,0,11,0
2020-04-05,Mexico,NA,Campeche,822441,3,0,14,0
2020-04-06,Mexico,NA,Campeche,822441,3,1,17,1
2020-04-09,Mexico,NA,Campeche,822441,2,0,19,1
2020-04-10,Mexico,NA,Campeche,822441,1,1,20,2
2020-04-11,Mexico,NA,Campeche,822441,5,0,25,2
2020-04-12,Mexico,NA,Campeche,822441,2,0,27,2
2020-04-13,Mexico,NA,Campeche,822441,2,0,29,2
2020-04-14,Mexico,NA,Campeche,822441,4,1,33,3
2020-04-15,Mexico,NA,Campeche,822441,3,0,36,3
2020-04-16,Mexico,NA,Campeche,822441,4,0,40,3
2020-04-17,Mexico,NA,Campeche,822441,3,1,43,4
2020-04-18,Mexico,NA,Campeche,822441,6,0,49,4
2020-04-19,Mexico,NA,Campeche,822441,2,2,51,6
2020-04-20,Mexico,NA,Campeche,822441,5,0,56,6
2020-04-21,Mexico,NA,Campeche,822441,7,1,63,7
2020-04-22,Mexico,NA,Campeche,822441,6,2,69,9
2020-04-23,Mexico,NA,Campeche,822441,7,2,76,11
2020-04-24,Mexico,NA,Campeche,822441,4,2,80,13
2020-04-25,Mexico,NA,Campeche,822441,6,2,86,15
2020-04-26,Mexico,NA,Campeche,822441,8,1,94,16
2020-04-27,Mexico,NA,Campeche,822441,4,1,98,17
2020-04-28,Mexico,NA,Campeche,822441,6,0,104,17
2020-04-29,Mexico,NA,Campeche,822441,8,3,112,20
2020-04-30,Mexico,NA,Campeche,822441,8,0,120,20
2020-05-01,Mexico,NA,Campeche,822441,6,2,126,22
2020-05-02,Mexico,NA,Campeche,822441,11,2,137,24
2020-05-03,Mexico,NA,Campeche,822441,11,1,148,25
2020-05-04,Mexico,NA,Campeche,822441,18,0,166,25
2020-05-05,Mexico,NA,Campeche,822441,9,1,175,26
2020-05-06,Mexico,NA,Campeche,822441,16,1,191,27
2020-05-07,Mexico,NA,Campeche,822441,11,1,202,28
2020-05-08,Mexico,NA,Campeche,822441,14,1,216,29
2020-05-09,Mexico,NA,Campeche,822441,14,3,230,32
2020-05-10,Mexico,NA,Campeche,822441,7,1,237,33
2020-05-11,Mexico,NA,Campeche,822441,24,2,261,35
2020-05-12,Mexico,NA,Campeche,822441,20,2,281,37
2020-05-13,Mexico,NA,Campeche,822441,16,1,297,38
2020-05-14,Mexico,NA,Campeche,822441,12,4,309,42
2020-05-15,Mexico,NA,Campeche,822441,15,5,324,47
2020-05-16,Mexico,NA,Campeche,822441,15,3,339,50
2020-05-17,Mexico,NA,Campeche,822441,15,2,354,52
2020-05-18,Mexico,NA,Campeche,822441,17,2,371,54
2020-05-19,Mexico,NA,Campeche,822441,21,2,392,56
2020-05-20,Mexico,NA,Campeche,822441,24,4,416,60
2020-05-21,Mexico,NA,Campeche,822441,16,1,432,61
2020-05-22,Mexico,NA,Campeche,822441,25,1,457,62
2020-05-23,Mexico,NA,Campeche,822441,17,1,474,63
2020-05-24,Mexico,NA,Campeche,822441,14,5,488,68
2020-05-25,Mexico,NA,Campeche,822441,33,3,521,71
2020-05-26,Mexico,NA,Campeche,822441,35,3,556,74
2020-05-27,Mexico,NA,Campeche,822441,31,1,587,75
2020-05-28,Mexico,NA,Campeche,822441,29,4,616,79
2020-05-29,Mexico,NA,Campeche,822441,20,3,636,82
2020-05-30,Mexico,NA,Campeche,822441,19,2,655,84
2020-05-31,Mexico,NA,Campeche,822441,7,0,662,84
2020-06-01,Mexico,NA,Campeche,822441,38,2,700,86
2020-06-02,Mexico,NA,Campeche,822441,23,4,723,90
2020-06-03,Mexico,NA,Campeche,822441,19,3,742,93
2020-06-04,Mexico,NA,Campeche,822441,39,2,781,95
2020-06-05,Mexico,NA,Campeche,822441,41,2,822,97
2020-06-06,Mexico,NA,Campeche,822441,24,2,846,99
2020-06-07,Mexico,NA,Campeche,822441,23,6,869,105
2020-06-08,Mexico,NA,Campeche,822441,42,9,911,114
2020-06-09,Mexico,NA,Campeche,822441,59,3,970,117
2020-06-10,Mexico,NA,Campeche,822441,69,2,1039,119
2020-06-11,Mexico,NA,Campeche,822441,74,2,1113,121
2020-06-12,Mexico,NA,Campeche,822441,34,3,1147,124
2020-06-13,Mexico,NA,Campeche,822441,27,7,1174,131
2020-06-14,Mexico,NA,Campeche,822441,21,5,1195,136
2020-06-15,Mexico,NA,Campeche,822441,98,6,1293,142
2020-06-16,Mexico,NA,Campeche,822441,81,3,1374,145
2020-06-17,Mexico,NA,Campeche,822441,104,8,1478,153
2020-06-18,Mexico,NA,Campeche,822441,87,2,1565,155
2020-06-19,Mexico,NA,Campeche,822441,99,4,1664,159
2020-06-20,Mexico,NA,Campeche,822441,54,9,1718,168
2020-06-21,Mexico,NA,Campeche,822441,38,4,1756,172
2020-06-22,Mexico,NA,Campeche,822441,104,5,1860,177
2020-06-23,Mexico,NA,Campeche,822441,92,10,1952,187
2020-06-24,Mexico,NA,Campeche,822441,86,8,2038,195
2020-06-25,Mexico,NA,Campeche,822441,90,5,2128,200
2020-06-26,Mexico,NA,Campeche,822441,94,9,2222,209
2020-06-27,Mexico,NA,Campeche,822441,52,15,2274,224
2020-06-28,Mexico,NA,Campeche,822441,47,13,2321,237
2020-06-29,Mexico,NA,Campeche,822441,69,10,2390,247
2020-06-30,Mexico,NA,Campeche,822441,89,6,2479,253
2020-07-01,Mexico,NA,Campeche,822441,70,12,2549,265
2020-07-02,Mexico,NA,Campeche,822441,92,8,2641,273
2020-07-03,Mexico,NA,Campeche,822441,59,13,2700,286
2020-07-04,Mexico,NA,Campeche,822441,32,9,2732,295
2020-07-05,Mexico,NA,Campeche,822441,36,7,2768,302
2020-07-06,Mexico,NA,Campeche,822441,80,12,2848,314
2020-07-07,Mexico,NA,Campeche,822441,90,16,2938,330
2020-07-08,Mexico,NA,Campeche,822441,90,11,3028,341
2020-07-09,Mexico,NA,Campeche,822441,97,13,3125,354
2020-07-10,Mexico,NA,Campeche,822441,107,17,3232,371
2020-07-11,Mexico,NA,Campeche,822441,51,13,3283,384
2020-07-12,Mexico,NA,Campeche,822441,55,10,3338,394
2020-07-13,Mexico,NA,Campeche,822441,104,11,3442,405
2020-07-14,Mexico,NA,Campeche,822441,63,10,3505,415
2020-07-15,Mexico,NA,Campeche,822441,114,7,3619,422
2020-07-16,Mexico,NA,Campeche,822441,105,16,3724,438
2020-07-17,Mexico,NA,Campeche,822441,89,10,3813,448
2020-07-18,Mexico,NA,Campeche,822441,45,10,3858,458
2020-07-19,Mexico,NA,Campeche,822441,45,14,3903,472
2020-07-20,Mexico,NA,Campeche,822441,104,9,4007,481
2020-07-21,Mexico,NA,Campeche,822441,98,15,4105,496
2020-07-22,Mexico,NA,Campeche,822441,84,8,4189,504
2020-07-23,Mexico,NA,Campeche,822441,79,7,4268,511
2020-07-24,Mexico,NA,Campeche,822441,79,10,4347,521
2020-07-25,Mexico,NA,Campeche,822441,34,10,4381,531
2020-07-26,Mexico,NA,Campeche,822441,24,16,4405,547
2020-07-27,Mexico,NA,Campeche,822441,66,9,4471,556
2020-07-28,Mexico,NA,Campeche,822441,85,8,4556,564
2020-07-29,Mexico,NA,Campeche,822441,67,13,4623,577
2020-07-30,Mexico,NA,Campeche,822441,61,4,4684,581
2020-07-31,Mexico,NA,Campeche,822441,53,10,4737,591
2020-08-01,Mexico,NA,Campeche,822441,31,13,4768,604
2020-08-02,Mexico,NA,Campeche,822441,30,13,4798,617
2020-08-03,Mexico,NA,Campeche,822441,49,17,4847,634
2020-08-04,Mexico,NA,Campeche,822441,65,7,4912,641
2020-08-05,Mexico,NA,Campeche,822441,49,8,4961,649
2020-08-06,Mexico,NA,Campeche,822441,46,12,5007,661
2020-08-07,Mexico,NA,Campeche,822441,23,4,5030,665
2020-08-08,Mexico,NA,Campeche,822441,17,6,5047,671
2020-08-09,Mexico,NA,Campeche,822441,15,9,5062,680
2020-08-10,Mexico,NA,Campeche,822441,40,5,5102,685
2020-08-11,Mexico,NA,Campeche,822441,24,7,5126,692
2020-08-12,Mexico,NA,Campeche,822441,35,5,5161,697
2020-08-13,Mexico,NA,Campeche,822441,35,7,5196,704
2020-08-14,Mexico,NA,Campeche,822441,13,7,5209,711
2020-08-15,Mexico,NA,Campeche,822441,13,9,5222,720
2020-08-16,Mexico,NA,Campeche,822441,10,3,5232,723
2020-08-17,Mexico,NA,Campeche,822441,30,6,5262,729
2020-08-18,Mexico,NA,Campeche,822441,43,4,5305,733
2020-08-19,Mexico,NA,Campeche,822441,31,4,5336,737
2020-08-20,Mexico,NA,Campeche,822441,24,1,5360,738
2020-08-21,Mexico,NA,Campeche,822441,62,3,5422,741
2020-08-22,Mexico,NA,Campeche,822441,13,4,5435,745
2020-08-23,Mexico,NA,Campeche,822441,10,4,5445,749
2020-08-24,Mexico,NA,Campeche,822441,32,2,5477,751
2020-08-25,Mexico,NA,Campeche,822441,30,1,5507,752
2020-08-26,Mexico,NA,Campeche,822441,20,4,5527,756
2020-08-27,Mexico,NA,Campeche,822441,24,1,5551,757
2020-08-28,Mexico,NA,Campeche,822441,45,0,5596,757
2020-08-29,Mexico,NA,Campeche,822441,8,2,5604,759
2020-08-30,Mexico,NA,Campeche,822441,5,11,5609,770
2020-08-31,Mexico,NA,Campeche,822441,32,3,5641,773
2020-09-01,Mexico,NA,Campeche,822441,17,3,5658,776
2020-09-02,Mexico,NA,Campeche,822441,28,2,5686,778
2020-09-03,Mexico,NA,Campeche,822441,23,1,5709,779
2020-09-04,Mexico,NA,Campeche,822441,15,2,5724,781
2020-09-05,Mexico,NA,Campeche,822441,2,2,5726,783
2020-09-06,Mexico,NA,Campeche,822441,6,1,5732,784
2020-09-07,Mexico,NA,Campeche,822441,18,0,5750,784
2020-09-08,Mexico,NA,Campeche,822441,12,2,5762,786
2020-09-09,Mexico,NA,Campeche,822441,11,0,5773,786
2020-09-10,Mexico,NA,Campeche,822441,9,1,5782,787
2020-09-11,Mexico,NA,Campeche,822441,32,2,5814,789
2020-09-12,Mexico,NA,Campeche,822441,10,1,5824,790
2020-09-13,Mexico,NA,Campeche,822441,5,1,5829,791
2020-09-14,Mexico,NA,Campeche,822441,13,1,5842,792
2020-09-15,Mexico,NA,Campeche,822441,3,3,5845,795
2020-09-16,Mexico,NA,Campeche,822441,2,1,5847,796
2020-09-17,Mexico,NA,Campeche,822441,9,2,5856,798
2020-09-18,Mexico,NA,Campeche,822441,36,2,5892,800
2020-09-19,Mexico,NA,Campeche,822441,2,0,5894,800
2020-09-20,Mexico,NA,Campeche,822441,2,1,5896,801
2020-09-21,Mexico,NA,Campeche,822441,7,3,5903,804
2020-09-22,Mexico,NA,Campeche,822441,2,1,5905,805
2020-03-27,Mexico,NA,Chiapas,4796580,5,0,12,0
2020-03-28,Mexico,NA,Chiapas,4796580,1,0,13,0
2020-03-30,Mexico,NA,Chiapas,4796580,2,0,15,0
2020-03-31,Mexico,NA,Chiapas,4796580,2,0,17,0
2020-04-01,Mexico,NA,Chiapas,4796580,4,0,21,0
2020-04-02,Mexico,NA,Chiapas,4796580,2,0,23,0
2020-04-03,Mexico,NA,Chiapas,4796580,5,0,28,0
2020-04-04,Mexico,NA,Chiapas,4796580,1,0,29,0
2020-04-05,Mexico,NA,Chiapas,4796580,1,0,30,0
2020-04-06,Mexico,NA,Chiapas,4796580,5,1,35,1
2020-04-07,Mexico,NA,Chiapas,4796580,2,0,37,1
2020-04-08,Mexico,NA,Chiapas,4796580,6,0,43,1
2020-04-09,Mexico,NA,Chiapas,4796580,3,1,46,2
2020-04-10,Mexico,NA,Chiapas,4796580,3,0,49,2
2020-04-11,Mexico,NA,Chiapas,4796580,1,1,50,3
2020-04-13,Mexico,NA,Chiapas,4796580,5,1,55,4
2020-04-14,Mexico,NA,Chiapas,4796580,5,0,60,4
2020-04-15,Mexico,NA,Chiapas,4796580,6,0,66,4
2020-04-16,Mexico,NA,Chiapas,4796580,3,0,69,4
2020-04-17,Mexico,NA,Chiapas,4796580,10,0,79,4
2020-04-18,Mexico,NA,Chiapas,4796580,4,0,83,4
2020-04-19,Mexico,NA,Chiapas,4796580,7,1,90,5
2020-04-20,Mexico,NA,Chiapas,4796580,10,0,100,5
2020-04-21,Mexico,NA,Chiapas,4796580,9,0,109,5
2020-04-22,Mexico,NA,Chiapas,4796580,11,1,120,6
2020-04-23,Mexico,NA,Chiapas,4796580,15,1,135,7
2020-04-24,Mexico,NA,Chiapas,4796580,13,0,148,7
2020-04-25,Mexico,NA,Chiapas,4796580,9,0,157,7
2020-04-26,Mexico,NA,Chiapas,4796580,12,0,169,7
2020-04-27,Mexico,NA,Chiapas,4796580,21,1,190,8
2020-04-28,Mexico,NA,Chiapas,4796580,9,1,199,9
2020-04-29,Mexico,NA,Chiapas,4796580,19,1,218,10
2020-04-30,Mexico,NA,Chiapas,4796580,13,1,231,11
2020-05-01,Mexico,NA,Chiapas,4796580,18,1,249,12
2020-05-02,Mexico,NA,Chiapas,4796580,9,4,258,16
2020-05-03,Mexico,NA,Chiapas,4796580,14,0,272,16
2020-05-04,Mexico,NA,Chiapas,4796580,31,0,303,16
2020-05-05,Mexico,NA,Chiapas,4796580,27,3,330,19
2020-05-06,Mexico,NA,Chiapas,4796580,35,1,365,20
2020-05-07,Mexico,NA,Chiapas,4796580,34,1,399,21
2020-05-08,Mexico,NA,Chiapas,4796580,34,2,433,23
2020-05-09,Mexico,NA,Chiapas,4796580,23,4,456,27
2020-05-10,Mexico,NA,Chiapas,4796580,21,7,477,34
2020-05-11,Mexico,NA,Chiapas,4796580,32,5,509,39
2020-05-12,Mexico,NA,Chiapas,4796580,46,5,555,44
2020-05-13,Mexico,NA,Chiapas,4796580,67,5,622,49
2020-05-14,Mexico,NA,Chiapas,4796580,66,3,688,52
2020-05-15,Mexico,NA,Chiapas,4796580,82,2,770,54
2020-05-16,Mexico,NA,Chiapas,4796580,40,3,810,57
2020-05-17,Mexico,NA,Chiapas,4796580,34,6,844,63
2020-05-18,Mexico,NA,Chiapas,4796580,93,5,937,68
2020-05-19,Mexico,NA,Chiapas,4796580,64,11,1001,79
2020-05-20,Mexico,NA,Chiapas,4796580,74,6,1075,85
2020-05-21,Mexico,NA,Chiapas,4796580,104,2,1179,87
2020-05-22,Mexico,NA,Chiapas,4796580,99,10,1278,97
2020-05-23,Mexico,NA,Chiapas,4796580,55,8,1333,105
2020-05-24,Mexico,NA,Chiapas,4796580,50,11,1383,116
2020-05-25,Mexico,NA,Chiapas,4796580,146,13,1529,129
2020-05-26,Mexico,NA,Chiapas,4796580,132,4,1661,133
2020-05-27,Mexico,NA,Chiapas,4796580,125,11,1786,144
2020-05-28,Mexico,NA,Chiapas,4796580,142,13,1928,157
2020-05-29,Mexico,NA,Chiapas,4796580,126,12,2054,169
2020-05-30,Mexico,NA,Chiapas,4796580,70,14,2124,183
2020-05-31,Mexico,NA,Chiapas,4796580,70,11,2194,194
2020-06-01,Mexico,NA,Chiapas,4796580,146,15,2340,209
2020-06-02,Mexico,NA,Chiapas,4796580,144,25,2484,234
2020-06-03,Mexico,NA,Chiapas,4796580,114,22,2598,256
2020-06-04,Mexico,NA,Chiapas,4796580,109,16,2707,272
2020-06-05,Mexico,NA,Chiapas,4796580,128,19,2835,291
2020-06-06,Mexico,NA,Chiapas,4796580,70,10,2905,301
2020-06-07,Mexico,NA,Chiapas,4796580,73,24,2978,325
2020-06-08,Mexico,NA,Chiapas,4796580,140,26,3118,351
2020-06-09,Mexico,NA,Chiapas,4796580,129,26,3247,377
2020-06-10,Mexico,NA,Chiapas,4796580,110,15,3357,392
2020-06-11,Mexico,NA,Chiapas,4796580,95,11,3452,403
2020-06-12,Mexico,NA,Chiapas,4796580,105,23,3557,426
2020-06-13,Mexico,NA,Chiapas,4796580,68,13,3625,439
2020-06-14,Mexico,NA,Chiapas,4796580,60,12,3685,451
2020-06-15,Mexico,NA,Chiapas,4796580,95,15,3780,466
2020-06-16,Mexico,NA,Chiapas,4796580,91,21,3871,487
2020-06-17,Mexico,NA,Chiapas,4796580,113,14,3984,501
2020-06-18,Mexico,NA,Chiapas,4796580,94,15,4078,516
2020-06-19,Mexico,NA,Chiapas,4796580,82,11,4160,527
2020-06-20,Mexico,NA,Chiapas,4796580,53,12,4213,539
2020-06-21,Mexico,NA,Chiapas,4796580,39,10,4252,549
2020-06-22,Mexico,NA,Chiapas,4796580,95,17,4347,566
2020-06-23,Mexico,NA,Chiapas,4796580,86,17,4433,583
2020-06-24,Mexico,NA,Chiapas,4796580,97,22,4530,605
2020-06-25,Mexico,NA,Chiapas,4796580,89,12,4619,617
2020-06-26,Mexico,NA,Chiapas,4796580,84,16,4703,633
2020-06-27,Mexico,NA,Chiapas,4796580,42,13,4745,646
2020-06-28,Mexico,NA,Chiapas,4796580,45,26,4790,672
2020-06-29,Mexico,NA,Chiapas,4796580,68,11,4858,683
2020-06-30,Mexico,NA,Chiapas,4796580,54,18,4912,701
2020-07-01,Mexico,NA,Chiapas,4796580,63,11,4975,712
2020-07-02,Mexico,NA,Chiapas,4796580,53,8,5028,720
2020-07-03,Mexico,NA,Chiapas,4796580,62,12,5090,732
2020-07-04,Mexico,NA,Chiapas,4796580,42,15,5132,747
2020-07-05,Mexico,NA,Chiapas,4796580,23,18,5155,765
2020-07-06,Mexico,NA,Chiapas,4796580,43,9,5198,774
2020-07-07,Mexico,NA,Chiapas,4796580,44,18,5242,792
2020-07-08,Mexico,NA,Chiapas,4796580,33,11,5275,803
2020-07-09,Mexico,NA,Chiapas,4796580,30,12,5305,815
2020-07-10,Mexico,NA,Chiapas,4796580,41,14,5346,829
2020-07-11,Mexico,NA,Chiapas,4796580,21,13,5367,842
2020-07-12,Mexico,NA,Chiapas,4796580,25,16,5392,858
2020-07-13,Mexico,NA,Chiapas,4796580,37,10,5429,868
2020-07-14,Mexico,NA,Chiapas,4796580,27,14,5456,882
2020-07-15,Mexico,NA,Chiapas,4796580,29,11,5485,893
2020-07-16,Mexico,NA,Chiapas,4796580,23,11,5508,904
2020-07-17,Mexico,NA,Chiapas,4796580,30,10,5538,914
2020-07-18,Mexico,NA,Chiapas,4796580,10,8,5548,922
2020-07-19,Mexico,NA,Chiapas,4796580,29,2,5577,924
2020-07-20,Mexico,NA,Chiapas,4796580,32,10,5609,934
2020-07-21,Mexico,NA,Chiapas,4796580,21,7,5630,941
2020-07-22,Mexico,NA,Chiapas,4796580,22,6,5652,947
2020-07-23,Mexico,NA,Chiapas,4796580,18,3,5670,950
2020-07-24,Mexico,NA,Chiapas,4796580,33,6,5703,956
2020-07-25,Mexico,NA,Chiapas,4796580,13,3,5716,959
2020-07-26,Mexico,NA,Chiapas,4796580,14,3,5730,962
2020-07-27,Mexico,NA,Chiapas,4796580,22,7,5752,969
2020-07-28,Mexico,NA,Chiapas,4796580,26,3,5778,972
2020-07-29,Mexico,NA,Chiapas,4796580,20,8,5798,980
2020-07-30,Mexico,NA,Chiapas,4796580,18,4,5816,984
2020-07-31,Mexico,NA,Chiapas,4796580,27,6,5843,990
2020-08-01,Mexico,NA,Chiapas,4796580,15,8,5858,998
2020-08-02,Mexico,NA,Chiapas,4796580,11,4,5869,1002
2020-08-03,Mexico,NA,Chiapas,4796580,17,8,5886,1010
2020-08-04,Mexico,NA,Chiapas,4796580,30,5,5916,1015
2020-08-05,Mexico,NA,Chiapas,4796580,33,6,5949,1021
2020-08-06,Mexico,NA,Chiapas,4796580,29,2,5978,1023
2020-08-07,Mexico,NA,Chiapas,4796580,9,0,5987,1023
2020-08-08,Mexico,NA,Chiapas,4796580,7,2,5994,1025
2020-08-09,Mexico,NA,Chiapas,4796580,9,5,6003,1030
2020-08-10,Mexico,NA,Chiapas,4796580,16,4,6019,1034
2020-08-11,Mexico,NA,Chiapas,4796580,16,3,6035,1037
2020-08-12,Mexico,NA,Chiapas,4796580,12,6,6047,1043
2020-08-13,Mexico,NA,Chiapas,4796580,30,5,6077,1048
2020-08-14,Mexico,NA,Chiapas,4796580,15,1,6092,1049
2020-08-15,Mexico,NA,Chiapas,4796580,9,1,6101,1050
2020-08-16,Mexico,NA,Chiapas,4796580,7,2,6108,1052
2020-08-17,Mexico,NA,Chiapas,4796580,18,2,6126,1054
2020-08-18,Mexico,NA,Chiapas,4796580,13,2,6139,1056
2020-08-19,Mexico,NA,Chiapas,4796580,16,4,6155,1060
2020-08-20,Mexico,NA,Chiapas,4796580,22,2,6177,1062
2020-08-21,Mexico,NA,Chiapas,4796580,30,1,6207,1063
2020-08-22,Mexico,NA,Chiapas,4796580,11,1,6218,1064
2020-08-23,Mexico,NA,Chiapas,4796580,9,1,6227,1065
2020-08-24,Mexico,NA,Chiapas,4796580,9,0,6236,1065
2020-08-25,Mexico,NA,Chiapas,4796580,14,3,6250,1068
2020-08-26,Mexico,NA,Chiapas,4796580,11,2,6261,1070
2020-08-27,Mexico,NA,Chiapas,4796580,8,2,6269,1072
2020-08-28,Mexico,NA,Chiapas,4796580,7,0,6276,1072
2020-08-29,Mexico,NA,Chiapas,4796580,3,1,6279,1073
2020-08-30,Mexico,NA,Chiapas,4796580,5,1,6284,1074
2020-08-31,Mexico,NA,Chiapas,4796580,5,0,6289,1074
2020-09-01,Mexico,NA,Chiapas,4796580,15,2,6304,1076
2020-09-02,Mexico,NA,Chiapas,4796580,6,0,6310,1076
2020-09-03,Mexico,NA,Chiapas,4796580,13,1,6323,1077
2020-09-04,Mexico,NA,Chiapas,4796580,9,2,6332,1079
2020-09-05,Mexico,NA,Chiapas,4796580,8,1,6340,1080
2020-09-06,Mexico,NA,Chiapas,4796580,3,0,6343,1080
2020-09-07,Mexico,NA,Chiapas,4796580,13,0,6356,1080
2020-09-08,Mexico,NA,Chiapas,4796580,9,0,6365,1080
2020-09-09,Mexico,NA,Chiapas,4796580,10,1,6375,1081
2020-09-10,Mexico,NA,Chiapas,4796580,19,0,6394,1081
2020-09-11,Mexico,NA,Chiapas,4796580,7,0,6401,1081
2020-09-12,Mexico,NA,Chiapas,4796580,9,0,6410,1081
2020-09-13,Mexico,NA,Chiapas,4796580,3,0,6413,1081
2020-09-14,Mexico,NA,Chiapas,4796580,18,1,6431,1082
2020-09-15,Mexico,NA,Chiapas,4796580,8,1,6439,1083
2020-09-16,Mexico,NA,Chiapas,4796580,2,0,6441,1083
2020-09-17,Mexico,NA,Chiapas,4796580,11,1,6452,1084
2020-09-18,Mexico,NA,Chiapas,4796580,8,0,6460,1084
2020-09-19,Mexico,NA,Chiapas,4796580,8,0,6468,1084
2020-09-20,Mexico,NA,Chiapas,4796580,2,1,6470,1085
2020-09-21,Mexico,NA,Chiapas,4796580,14,0,6484,1085
2020-09-22,Mexico,NA,Chiapas,4796580,6,0,6490,1085
2020-09-23,Mexico,NA,Chiapas,4796580,4,0,6494,1085
2020-03-25,Mexico,NA,Chihuahua,3406465,2,0,12,0
2020-03-26,Mexico,NA,Chihuahua,3406465,3,0,15,0
2020-03-27,Mexico,NA,Chihuahua,3406465,2,0,17,0
2020-03-28,Mexico,NA,Chihuahua,3406465,2,0,19,0
2020-03-29,Mexico,NA,Chihuahua,3406465,5,0,24,0
2020-03-30,Mexico,NA,Chihuahua,3406465,5,0,29,0
2020-03-31,Mexico,NA,Chihuahua,3406465,5,0,34,0
2020-04-01,Mexico,NA,Chihuahua,3406465,8,0,42,0
2020-04-02,Mexico,NA,Chihuahua,3406465,8,0,50,0
2020-04-03,Mexico,NA,Chihuahua,3406465,5,2,55,2
2020-04-04,Mexico,NA,Chihuahua,3406465,9,1,64,3
2020-04-05,Mexico,NA,Chihuahua,3406465,13,1,77,4
2020-04-06,Mexico,NA,Chihuahua,3406465,14,2,91,6
2020-04-07,Mexico,NA,Chihuahua,3406465,8,6,99,12
2020-04-08,Mexico,NA,Chihuahua,3406465,11,6,110,18
2020-04-09,Mexico,NA,Chihuahua,3406465,11,4,121,22
2020-04-10,Mexico,NA,Chihuahua,3406465,12,1,133,23
2020-04-11,Mexico,NA,Chihuahua,3406465,18,1,151,24
2020-04-12,Mexico,NA,Chihuahua,3406465,11,4,162,28
2020-04-13,Mexico,NA,Chihuahua,3406465,20,3,182,31
2020-04-14,Mexico,NA,Chihuahua,3406465,18,2,200,33
2020-04-15,Mexico,NA,Chihuahua,3406465,26,7,226,40
2020-04-16,Mexico,NA,Chihuahua,3406465,30,2,256,42
2020-04-17,Mexico,NA,Chihuahua,3406465,21,7,277,49
2020-04-18,Mexico,NA,Chihuahua,3406465,23,5,300,54
2020-04-19,Mexico,NA,Chihuahua,3406465,23,4,323,58
2020-04-20,Mexico,NA,Chihuahua,3406465,46,9,369,67
2020-04-21,Mexico,NA,Chihuahua,3406465,41,10,410,77
2020-04-22,Mexico,NA,Chihuahua,3406465,38,7,448,84
2020-04-23,Mexico,NA,Chihuahua,3406465,58,2,506,86
2020-04-24,Mexico,NA,Chihuahua,3406465,49,14,555,100
2020-04-25,Mexico,NA,Chihuahua,3406465,39,8,594,108
2020-04-26,Mexico,NA,Chihuahua,3406465,29,5,623,113
2020-04-27,Mexico,NA,Chihuahua,3406465,58,6,681,119
2020-04-28,Mexico,NA,Chihuahua,3406465,59,7,740,126
2020-04-29,Mexico,NA,Chihuahua,3406465,68,7,808,133
2020-04-30,Mexico,NA,Chihuahua,3406465,75,10,883,143
2020-05-01,Mexico,NA,Chihuahua,3406465,50,15,933,158
2020-05-02,Mexico,NA,Chihuahua,3406465,50,6,983,164
2020-05-03,Mexico,NA,Chihuahua,3406465,31,9,1014,173
2020-05-04,Mexico,NA,Chihuahua,3406465,63,11,1077,184
2020-05-05,Mexico,NA,Chihuahua,3406465,80,5,1157,189
2020-05-06,Mexico,NA,Chihuahua,3406465,76,12,1233,201
2020-05-07,Mexico,NA,Chihuahua,3406465,66,17,1299,218
2020-05-08,Mexico,NA,Chihuahua,3406465,59,11,1358,229
2020-05-09,Mexico,NA,Chihuahua,3406465,46,11,1404,240
2020-05-10,Mexico,NA,Chihuahua,3406465,51,13,1455,253
2020-05-11,Mexico,NA,Chihuahua,3406465,75,8,1530,261
2020-05-12,Mexico,NA,Chihuahua,3406465,53,10,1583,271
2020-05-13,Mexico,NA,Chihuahua,3406465,83,14,1666,285
2020-05-14,Mexico,NA,Chihuahua,3406465,75,14,1741,299
2020-05-15,Mexico,NA,Chihuahua,3406465,66,9,1807,308
2020-05-16,Mexico,NA,Chihuahua,3406465,54,5,1861,313
2020-05-17,Mexico,NA,Chihuahua,3406465,54,8,1915,321
2020-05-18,Mexico,NA,Chihuahua,3406465,85,13,2000,334
2020-05-19,Mexico,NA,Chihuahua,3406465,69,16,2069,350
2020-05-20,Mexico,NA,Chihuahua,3406465,75,8,2144,358
2020-05-21,Mexico,NA,Chihuahua,3406465,100,4,2244,362
2020-05-22,Mexico,NA,Chihuahua,3406465,80,10,2324,372
2020-05-23,Mexico,NA,Chihuahua,3406465,64,13,2388,385
2020-05-24,Mexico,NA,Chihuahua,3406465,29,4,2417,389
2020-05-25,Mexico,NA,Chihuahua,3406465,92,10,2509,399
2020-05-26,Mexico,NA,Chihuahua,3406465,70,14,2579,413
2020-05-27,Mexico,NA,Chihuahua,3406465,65,8,2644,421
2020-05-28,Mexico,NA,Chihuahua,3406465,52,12,2696,433
2020-05-29,Mexico,NA,Chihuahua,3406465,84,11,2780,444
2020-05-30,Mexico,NA,Chihuahua,3406465,24,8,2804,452
2020-05-31,Mexico,NA,Chihuahua,3406465,35,6,2839,458
2020-06-01,Mexico,NA,Chihuahua,3406465,69,11,2908,469
2020-06-02,Mexico,NA,Chihuahua,3406465,79,11,2987,480
2020-06-03,Mexico,NA,Chihuahua,3406465,50,9,3037,489
2020-06-04,Mexico,NA,Chihuahua,3406465,46,6,3083,495
2020-06-05,Mexico,NA,Chihuahua,3406465,68,12,3151,507
2020-06-06,Mexico,NA,Chihuahua,3406465,30,16,3181,523
2020-06-07,Mexico,NA,Chihuahua,3406465,28,14,3209,537
2020-06-08,Mexico,NA,Chihuahua,3406465,71,16,3280,553
2020-06-09,Mexico,NA,Chihuahua,3406465,54,9,3334,562
2020-06-10,Mexico,NA,Chihuahua,3406465,63,9,3397,571
2020-06-11,Mexico,NA,Chihuahua,3406465,61,12,3458,583
2020-06-12,Mexico,NA,Chihuahua,3406465,45,8,3503,591
2020-06-13,Mexico,NA,Chihuahua,3406465,22,7,3525,598
2020-06-14,Mexico,NA,Chihuahua,3406465,24,13,3549,611
2020-06-15,Mexico,NA,Chihuahua,3406465,47,10,3596,621
2020-06-16,Mexico,NA,Chihuahua,3406465,72,11,3668,632
2020-06-17,Mexico,NA,Chihuahua,3406465,52,11,3720,643
2020-06-18,Mexico,NA,Chihuahua,3406465,57,8,3777,651
2020-06-19,Mexico,NA,Chihuahua,3406465,56,6,3833,657
2020-06-20,Mexico,NA,Chihuahua,3406465,32,6,3865,663
2020-06-21,Mexico,NA,Chihuahua,3406465,24,5,3889,668
2020-06-22,Mexico,NA,Chihuahua,3406465,54,10,3943,678
2020-06-23,Mexico,NA,Chihuahua,3406465,52,6,3995,684
2020-06-24,Mexico,NA,Chihuahua,3406465,52,6,4047,690
2020-06-25,Mexico,NA,Chihuahua,3406465,42,7,4089,697
2020-06-26,Mexico,NA,Chihuahua,3406465,73,9,4162,706
2020-06-27,Mexico,NA,Chihuahua,3406465,32,3,4194,709
2020-06-28,Mexico,NA,Chihuahua,3406465,18,7,4212,716
2020-06-29,Mexico,NA,Chihuahua,3406465,74,8,4286,724
2020-06-30,Mexico,NA,Chihuahua,3406465,77,8,4363,732
2020-07-01,Mexico,NA,Chihuahua,3406465,94,5,4457,737
2020-07-02,Mexico,NA,Chihuahua,3406465,86,5,4543,742
2020-07-03,Mexico,NA,Chihuahua,3406465,63,10,4606,752
2020-07-04,Mexico,NA,Chihuahua,3406465,30,4,4636,756
2020-07-05,Mexico,NA,Chihuahua,3406465,29,5,4665,761
2020-07-06,Mexico,NA,Chihuahua,3406465,79,12,4744,773
2020-07-07,Mexico,NA,Chihuahua,3406465,83,11,4827,784
2020-07-08,Mexico,NA,Chihuahua,3406465,93,8,4920,792
2020-07-09,Mexico,NA,Chihuahua,3406465,70,11,4990,803
2020-07-10,Mexico,NA,Chihuahua,3406465,120,11,5110,814
2020-07-11,Mexico,NA,Chihuahua,3406465,54,11,5164,825
2020-07-12,Mexico,NA,Chihuahua,3406465,28,9,5192,834
2020-07-13,Mexico,NA,Chihuahua,3406465,114,11,5306,845
2020-07-14,Mexico,NA,Chihuahua,3406465,91,6,5397,851
2020-07-15,Mexico,NA,Chihuahua,3406465,102,4,5499,855
2020-07-16,Mexico,NA,Chihuahua,3406465,92,6,5591,861
2020-07-17,Mexico,NA,Chihuahua,3406465,77,5,5668,866
2020-07-18,Mexico,NA,Chihuahua,3406465,43,5,5711,871
2020-07-19,Mexico,NA,Chihuahua,3406465,32,9,5743,880
2020-07-20,Mexico,NA,Chihuahua,3406465,97,9,5840,889
2020-07-21,Mexico,NA,Chihuahua,3406465,94,6,5934,895
2020-07-22,Mexico,NA,Chihuahua,3406465,116,11,6050,906
2020-07-23,Mexico,NA,Chihuahua,3406465,114,7,6164,913
2020-07-24,Mexico,NA,Chihuahua,3406465,93,6,6257,919
2020-07-25,Mexico,NA,Chihuahua,3406465,46,7,6303,926
2020-07-26,Mexico,NA,Chihuahua,3406465,35,9,6338,935
2020-07-27,Mexico,NA,Chihuahua,3406465,86,7,6424,942
2020-07-28,Mexico,NA,Chihuahua,3406465,100,16,6524,958
2020-07-29,Mexico,NA,Chihuahua,3406465,97,12,6621,970
2020-07-30,Mexico,NA,Chihuahua,3406465,108,12,6729,982
2020-07-31,Mexico,NA,Chihuahua,3406465,80,5,6809,987
2020-08-01,Mexico,NA,Chihuahua,3406465,57,6,6866,993
2020-08-02,Mexico,NA,Chihuahua,3406465,34,6,6900,999
2020-08-03,Mexico,NA,Chihuahua,3406465,94,10,6994,1009
2020-08-04,Mexico,NA,Chihuahua,3406465,100,14,7094,1023
2020-08-05,Mexico,NA,Chihuahua,3406465,106,11,7200,1034
2020-08-06,Mexico,NA,Chihuahua,3406465,90,10,7290,1044
2020-08-07,Mexico,NA,Chihuahua,3406465,102,11,7392,1055
2020-08-08,Mexico,NA,Chihuahua,3406465,54,8,7446,1063
2020-08-09,Mexico,NA,Chihuahua,3406465,44,11,7490,1074
2020-08-10,Mexico,NA,Chihuahua,3406465,79,7,7569,1081
2020-08-11,Mexico,NA,Chihuahua,3406465,108,8,7677,1089
2020-08-12,Mexico,NA,Chihuahua,3406465,79,10,7756,1099
2020-08-13,Mexico,NA,Chihuahua,3406465,102,3,7858,1102
2020-08-14,Mexico,NA,Chihuahua,3406465,69,4,7927,1106
2020-08-15,Mexico,NA,Chihuahua,3406465,39,6,7966,1112
2020-08-16,Mexico,NA,Chihuahua,3406465,30,4,7996,1116
2020-08-17,Mexico,NA,Chihuahua,3406465,85,6,8081,1122
2020-08-18,Mexico,NA,Chihuahua,3406465,85,4,8166,1126
2020-08-19,Mexico,NA,Chihuahua,3406465,91,7,8257,1133
2020-08-20,Mexico,NA,Chihuahua,3406465,87,6,8344,1139
2020-08-21,Mexico,NA,Chihuahua,3406465,76,10,8420,1149
2020-08-22,Mexico,NA,Chihuahua,3406465,44,5,8464,1154
2020-08-23,Mexico,NA,Chihuahua,3406465,22,4,8486,1158
2020-08-24,Mexico,NA,Chihuahua,3406465,85,8,8571,1166
2020-08-25,Mexico,NA,Chihuahua,3406465,98,7,8669,1173
2020-08-26,Mexico,NA,Chihuahua,3406465,126,7,8795,1180
2020-08-27,Mexico,NA,Chihuahua,3406465,97,9,8892,1189
2020-08-28,Mexico,NA,Chihuahua,3406465,77,8,8969,1197
2020-08-29,Mexico,NA,Chihuahua,3406465,35,4,9004,1201
2020-08-30,Mexico,NA,Chihuahua,3406465,27,2,9031,1203
2020-08-31,Mexico,NA,Chihuahua,3406465,105,12,9136,1215
2020-09-01,Mexico,NA,Chihuahua,3406465,110,5,9246,1220
2020-09-02,Mexico,NA,Chihuahua,3406465,112,3,9358,1223
2020-09-03,Mexico,NA,Chihuahua,3406465,75,7,9433,1230
2020-09-04,Mexico,NA,Chihuahua,3406465,58,9,9491,1239
2020-09-05,Mexico,NA,Chihuahua,3406465,26,4,9517,1243
2020-09-06,Mexico,NA,Chihuahua,3406465,22,6,9539,1249
2020-09-07,Mexico,NA,Chihuahua,3406465,85,3,9624,1252
2020-09-08,Mexico,NA,Chihuahua,3406465,76,3,9700,1255
2020-09-09,Mexico,NA,Chihuahua,3406465,87,5,9787,1260
2020-09-10,Mexico,NA,Chihuahua,3406465,46,8,9833,1268
2020-09-11,Mexico,NA,Chihuahua,3406465,63,6,9896,1274
2020-09-12,Mexico,NA,Chihuahua,3406465,30,3,9926,1277
2020-09-13,Mexico,NA,Chihuahua,3406465,7,5,9933,1282
2020-09-14,Mexico,NA,Chihuahua,3406465,66,4,9999,1286
2020-09-15,Mexico,NA,Chihuahua,3406465,49,5,10048,1291
2020-09-16,Mexico,NA,Chihuahua,3406465,25,4,10073,1295
2020-09-17,Mexico,NA,Chihuahua,3406465,37,8,10110,1303
2020-09-18,Mexico,NA,Chihuahua,3406465,60,3,10170,1306
2020-09-19,Mexico,NA,Chihuahua,3406465,17,2,10187,1308
2020-09-20,Mexico,NA,Chihuahua,3406465,9,6,10196,1314
2020-09-21,Mexico,NA,Chihuahua,3406465,11,5,10207,1319
2020-09-22,Mexico,NA,Chihuahua,3406465,3,4,10210,1323
2020-09-23,Mexico,NA,Chihuahua,3406465,2,0,10212,1323
2020-03-19,Mexico,NA,Coahuila,2748391,3,0,11,0
2020-03-20,Mexico,NA,Coahuila,2748391,4,0,15,0
2020-03-23,Mexico,NA,Coahuila,2748391,1,0,16,0
2020-03-24,Mexico,NA,Coahuila,2748391,6,0,22,0
2020-03-26,Mexico,NA,Coahuila,2748391,3,0,25,0
2020-03-27,Mexico,NA,Coahuila,2748391,4,0,29,0
2020-03-28,Mexico,NA,Coahuila,2748391,4,1,33,1
2020-03-29,Mexico,NA,Coahuila,2748391,8,0,41,1
2020-03-30,Mexico,NA,Coahuila,2748391,18,1,59,2
2020-03-31,Mexico,NA,Coahuila,2748391,14,1,73,3
2020-04-01,Mexico,NA,Coahuila,2748391,21,0,94,3
2020-04-02,Mexico,NA,Coahuila,2748391,22,2,116,5
2020-04-03,Mexico,NA,Coahuila,2748391,25,2,141,7
2020-04-04,Mexico,NA,Coahuila,2748391,11,1,152,8
2020-04-05,Mexico,NA,Coahuila,2748391,4,2,156,10
2020-04-06,Mexico,NA,Coahuila,2748391,26,1,182,11
2020-04-07,Mexico,NA,Coahuila,2748391,8,3,190,14
2020-04-08,Mexico,NA,Coahuila,2748391,18,0,208,14
2020-04-09,Mexico,NA,Coahuila,2748391,6,1,214,15
2020-04-10,Mexico,NA,Coahuila,2748391,14,1,228,16
2020-04-11,Mexico,NA,Coahuila,2748391,9,0,237,16
2020-04-12,Mexico,NA,Coahuila,2748391,7,0,244,16
2020-04-13,Mexico,NA,Coahuila,2748391,15,1,259,17
2020-04-14,Mexico,NA,Coahuila,2748391,17,5,276,22
2020-04-15,Mexico,NA,Coahuila,2748391,16,1,292,23
2020-04-16,Mexico,NA,Coahuila,2748391,5,3,297,26
2020-04-17,Mexico,NA,Coahuila,2748391,10,0,307,26
2020-04-18,Mexico,NA,Coahuila,2748391,9,0,316,26
2020-04-19,Mexico,NA,Coahuila,2748391,9,2,325,28
2020-04-20,Mexico,NA,Coahuila,2748391,9,4,334,32
2020-04-21,Mexico,NA,Coahuila,2748391,22,2,356,34
2020-04-22,Mexico,NA,Coahuila,2748391,14,2,370,36
2020-04-23,Mexico,NA,Coahuila,2748391,10,2,380,38
2020-04-24,Mexico,NA,Coahuila,2748391,13,2,393,40
2020-04-25,Mexico,NA,Coahuila,2748391,3,2,396,42
2020-04-26,Mexico,NA,Coahuila,2748391,4,2,400,44
2020-04-27,Mexico,NA,Coahuila,2748391,24,0,424,44
2020-04-28,Mexico,NA,Coahuila,2748391,18,2,442,46
2020-04-29,Mexico,NA,Coahuila,2748391,13,0,455,46
2020-04-30,Mexico,NA,Coahuila,2748391,20,0,475,46
2020-05-01,Mexico,NA,Coahuila,2748391,15,0,490,46
2020-05-02,Mexico,NA,Coahuila,2748391,5,1,495,47
2020-05-03,Mexico,NA,Coahuila,2748391,5,2,500,49
2020-05-04,Mexico,NA,Coahuila,2748391,26,4,526,53
2020-05-05,Mexico,NA,Coahuila,2748391,31,1,557,54
2020-05-06,Mexico,NA,Coahuila,2748391,34,3,591,57
2020-05-07,Mexico,NA,Coahuila,2748391,23,1,614,58
2020-05-08,Mexico,NA,Coahuila,2748391,19,1,633,59
2020-05-09,Mexico,NA,Coahuila,2748391,9,1,642,60
2020-05-10,Mexico,NA,Coahuila,2748391,15,2,657,62
2020-05-11,Mexico,NA,Coahuila,2748391,29,2,686,64
2020-05-12,Mexico,NA,Coahuila,2748391,31,0,717,64
2020-05-13,Mexico,NA,Coahuila,2748391,17,0,734,64
2020-05-14,Mexico,NA,Coahuila,2748391,32,1,766,65
2020-05-15,Mexico,NA,Coahuila,2748391,37,3,803,68
2020-05-16,Mexico,NA,Coahuila,2748391,17,4,820,72
2020-05-17,Mexico,NA,Coahuila,2748391,12,2,832,74
2020-05-18,Mexico,NA,Coahuila,2748391,61,0,893,74
2020-05-19,Mexico,NA,Coahuila,2748391,48,0,941,74
2020-05-20,Mexico,NA,Coahuila,2748391,42,1,983,75
2020-05-21,Mexico,NA,Coahuila,2748391,64,1,1047,76
2020-05-22,Mexico,NA,Coahuila,2748391,45,1,1092,77
2020-05-23,Mexico,NA,Coahuila,2748391,35,2,1127,79
2020-05-24,Mexico,NA,Coahuila,2748391,17,6,1144,85
2020-05-25,Mexico,NA,Coahuila,2748391,54,2,1198,87
2020-05-26,Mexico,NA,Coahuila,2748391,55,3,1253,90
2020-05-27,Mexico,NA,Coahuila,2748391,70,0,1323,90
2020-05-28,Mexico,NA,Coahuila,2748391,55,3,1378,93
2020-05-29,Mexico,NA,Coahuila,2748391,93,5,1471,98
2020-05-30,Mexico,NA,Coahuila,2748391,36,1,1507,99
2020-05-31,Mexico,NA,Coahuila,2748391,35,1,1542,100
2020-06-01,Mexico,NA,Coahuila,2748391,102,1,1644,101
2020-06-02,Mexico,NA,Coahuila,2748391,77,2,1721,103
2020-06-03,Mexico,NA,Coahuila,2748391,73,4,1794,107
2020-06-04,Mexico,NA,Coahuila,2748391,77,3,1871,110
2020-06-05,Mexico,NA,Coahuila,2748391,89,6,1960,116
2020-06-06,Mexico,NA,Coahuila,2748391,38,4,1998,120
2020-06-07,Mexico,NA,Coahuila,2748391,41,8,2039,128
2020-06-08,Mexico,NA,Coahuila,2748391,139,7,2178,135
2020-06-09,Mexico,NA,Coahuila,2748391,129,4,2307,139
2020-06-10,Mexico,NA,Coahuila,2748391,125,5,2432,144
2020-06-11,Mexico,NA,Coahuila,2748391,127,8,2559,152
2020-06-12,Mexico,NA,Coahuila,2748391,136,4,2695,156
2020-06-13,Mexico,NA,Coahuila,2748391,57,4,2752,160
2020-06-14,Mexico,NA,Coahuila,2748391,45,8,2797,168
2020-06-15,Mexico,NA,Coahuila,2748391,168,5,2965,173
2020-06-16,Mexico,NA,Coahuila,2748391,187,7,3152,180
2020-06-17,Mexico,NA,Coahuila,2748391,180,11,3332,191
2020-06-18,Mexico,NA,Coahuila,2748391,204,3,3536,194
2020-06-19,Mexico,NA,Coahuila,2748391,207,6,3743,200
2020-06-20,Mexico,NA,Coahuila,2748391,119,3,3862,203
2020-06-21,Mexico,NA,Coahuila,2748391,65,13,3927,216
2020-06-22,Mexico,NA,Coahuila,2748391,273,7,4200,223
2020-06-23,Mexico,NA,Coahuila,2748391,330,6,4530,229
2020-06-24,Mexico,NA,Coahuila,2748391,248,12,4778,241
2020-06-25,Mexico,NA,Coahuila,2748391,202,7,4980,248
2020-06-26,Mexico,NA,Coahuila,2748391,244,11,5224,259
2020-06-27,Mexico,NA,Coahuila,2748391,176,9,5400,268
2020-06-28,Mexico,NA,Coahuila,2748391,108,8,5508,276
2020-06-29,Mexico,NA,Coahuila,2748391,333,19,5841,295
2020-06-30,Mexico,NA,Coahuila,2748391,302,17,6143,312
2020-07-01,Mexico,NA,Coahuila,2748391,319,14,6462,326
2020-07-02,Mexico,NA,Coahuila,2748391,243,13,6705,339
2020-07-03,Mexico,NA,Coahuila,2748391,323,18,7028,357
2020-07-04,Mexico,NA,Coahuila,2748391,194,19,7222,376
2020-07-05,Mexico,NA,Coahuila,2748391,140,11,7362,387
2020-07-06,Mexico,NA,Coahuila,2748391,307,15,7669,402
2020-07-07,Mexico,NA,Coahuila,2748391,361,16,8030,418
2020-07-08,Mexico,NA,Coahuila,2748391,310,13,8340,431
2020-07-09,Mexico,NA,Coahuila,2748391,308,17,8648,448
2020-07-10,Mexico,NA,Coahuila,2748391,276,11,8924,459
2020-07-11,Mexico,NA,Coahuila,2748391,118,16,9042,475
2020-07-12,Mexico,NA,Coahuila,2748391,84,14,9126,489
2020-07-13,Mexico,NA,Coahuila,2748391,387,20,9513,509
2020-07-14,Mexico,NA,Coahuila,2748391,367,22,9880,531
2020-07-15,Mexico,NA,Coahuila,2748391,298,29,10178,560
2020-07-16,Mexico,NA,Coahuila,2748391,293,23,10471,583
2020-07-17,Mexico,NA,Coahuila,2748391,300,17,10771,600
2020-07-18,Mexico,NA,Coahuila,2748391,162,18,10933,618
2020-07-19,Mexico,NA,Coahuila,2748391,100,18,11033,636
2020-07-20,Mexico,NA,Coahuila,2748391,308,23,11341,659
2020-07-21,Mexico,NA,Coahuila,2748391,325,29,11666,688
2020-07-22,Mexico,NA,Coahuila,2748391,305,19,11971,707
2020-07-23,Mexico,NA,Coahuila,2748391,324,21,12295,728
2020-07-24,Mexico,NA,Coahuila,2748391,344,14,12639,742
2020-07-25,Mexico,NA,Coahuila,2748391,176,20,12815,762
2020-07-26,Mexico,NA,Coahuila,2748391,105,12,12920,774
2020-07-27,Mexico,NA,Coahuila,2748391,424,14,13344,788
2020-07-28,Mexico,NA,Coahuila,2748391,391,27,13735,815
2020-07-29,Mexico,NA,Coahuila,2748391,323,18,14058,833
2020-07-30,Mexico,NA,Coahuila,2748391,340,33,14398,866
2020-07-31,Mexico,NA,Coahuila,2748391,255,18,14653,884
2020-08-01,Mexico,NA,Coahuila,2748391,225,33,14878,917
2020-08-02,Mexico,NA,Coahuila,2748391,64,21,14942,938
2020-08-03,Mexico,NA,Coahuila,2748391,324,25,15266,963
2020-08-04,Mexico,NA,Coahuila,2748391,402,25,15668,988
2020-08-05,Mexico,NA,Coahuila,2748391,360,23,16028,1011
2020-08-06,Mexico,NA,Coahuila,2748391,352,20,16380,1031
2020-08-07,Mexico,NA,Coahuila,2748391,331,29,16711,1060
2020-08-08,Mexico,NA,Coahuila,2748391,197,20,16908,1080
2020-08-09,Mexico,NA,Coahuila,2748391,85,17,16993,1097
2020-08-10,Mexico,NA,Coahuila,2748391,381,29,17374,1126
2020-08-11,Mexico,NA,Coahuila,2748391,377,19,17751,1145
2020-08-12,Mexico,NA,Coahuila,2748391,285,33,18036,1178
2020-08-13,Mexico,NA,Coahuila,2748391,297,15,18333,1193
2020-08-14,Mexico,NA,Coahuila,2748391,302,17,18635,1210
2020-08-15,Mexico,NA,Coahuila,2748391,212,19,18847,1229
2020-08-16,Mexico,NA,Coahuila,2748391,128,23,18975,1252
2020-08-17,Mexico,NA,Coahuila,2748391,276,22,19251,1274
2020-08-18,Mexico,NA,Coahuila,2748391,282,24,19533,1298
2020-08-19,Mexico,NA,Coahuila,2748391,305,14,19838,1312
2020-08-20,Mexico,NA,Coahuila,2748391,289,13,20127,1325
2020-08-21,Mexico,NA,Coahuila,2748391,371,17,20498,1342
2020-08-22,Mexico,NA,Coahuila,2748391,153,15,20651,1357
2020-08-23,Mexico,NA,Coahuila,2748391,100,13,20751,1370
2020-08-24,Mexico,NA,Coahuila,2748391,303,17,21054,1387
2020-08-25,Mexico,NA,Coahuila,2748391,272,13,21326,1400
2020-08-26,Mexico,NA,Coahuila,2748391,296,16,21622,1416
2020-08-27,Mexico,NA,Coahuila,2748391,255,12,21877,1428
2020-08-28,Mexico,NA,Coahuila,2748391,244,28,22121,1456
2020-08-29,Mexico,NA,Coahuila,2748391,119,13,22240,1469
2020-08-30,Mexico,NA,Coahuila,2748391,51,17,22291,1486
2020-08-31,Mexico,NA,Coahuila,2748391,231,22,22522,1508
2020-09-01,Mexico,NA,Coahuila,2748391,227,17,22749,1525
2020-09-02,Mexico,NA,Coahuila,2748391,194,18,22943,1543
2020-09-03,Mexico,NA,Coahuila,2748391,179,14,23122,1557
2020-09-04,Mexico,NA,Coahuila,2748391,180,14,23302,1571
2020-09-05,Mexico,NA,Coahuila,2748391,91,13,23393,1584
2020-09-06,Mexico,NA,Coahuila,2748391,88,11,23481,1595
2020-09-07,Mexico,NA,Coahuila,2748391,197,20,23678,1615
2020-09-08,Mexico,NA,Coahuila,2748391,209,14,23887,1629
2020-09-09,Mexico,NA,Coahuila,2748391,151,16,24038,1645
2020-09-10,Mexico,NA,Coahuila,2748391,138,8,24176,1653
2020-09-11,Mexico,NA,Coahuila,2748391,134,19,24310,1672
2020-09-12,Mexico,NA,Coahuila,2748391,66,19,24376,1691
2020-09-13,Mexico,NA,Coahuila,2748391,67,11,24443,1702
2020-09-14,Mexico,NA,Coahuila,2748391,172,16,24615,1718
2020-09-15,Mexico,NA,Coahuila,2748391,111,7,24726,1725
2020-09-16,Mexico,NA,Coahuila,2748391,90,10,24816,1735
2020-09-17,Mexico,NA,Coahuila,2748391,185,13,25001,1748
2020-09-18,Mexico,NA,Coahuila,2748391,135,7,25136,1755
2020-09-19,Mexico,NA,Coahuila,2748391,49,14,25185,1769
2020-09-20,Mexico,NA,Coahuila,2748391,22,12,25207,1781
2020-09-21,Mexico,NA,Coahuila,2748391,89,8,25296,1789
2020-09-22,Mexico,NA,Coahuila,2748391,91,9,25387,1798
2020-09-23,Mexico,NA,Coahuila,2748391,21,1,25408,1799
2020-04-15,Mexico,NA,Colima,650555,1,0,11,1
2020-04-16,Mexico,NA,Colima,650555,2,1,13,2
2020-04-17,Mexico,NA,Colima,650555,2,0,15,2
2020-04-18,Mexico,NA,Colima,650555,1,0,16,2
2020-04-19,Mexico,NA,Colima,650555,1,0,17,2
2020-04-20,Mexico,NA,Colima,650555,1,0,18,2
2020-04-21,Mexico,NA,Colima,650555,1,0,19,2
2020-04-22,Mexico,NA,Colima,650555,1,0,20,2
2020-04-23,Mexico,NA,Colima,650555,3,0,23,2
2020-04-24,Mexico,NA,Colima,650555,2,0,25,2
2020-04-25,Mexico,NA,Colima,650555,1,0,26,2
2020-04-26,Mexico,NA,Colima,650555,0,1,26,3
2020-04-27,Mexico,NA,Colima,650555,2,0,28,3
2020-04-30,Mexico,NA,Colima,650555,3,0,31,3
2020-05-01,Mexico,NA,Colima,650555,1,0,32,3
2020-05-02,Mexico,NA,Colima,650555,0,1,32,4
2020-05-03,Mexico,NA,Colima,650555,2,0,34,4
2020-05-04,Mexico,NA,Colima,650555,3,2,37,6
2020-05-05,Mexico,NA,Colima,650555,5,1,42,7
2020-05-06,Mexico,NA,Colima,650555,1,0,43,7
2020-05-07,Mexico,NA,Colima,650555,1,0,44,7
2020-05-08,Mexico,NA,Colima,650555,2,0,46,7
2020-05-09,Mexico,NA,Colima,650555,3,0,49,7
2020-05-10,Mexico,NA,Colima,650555,1,0,50,7
2020-05-11,Mexico,NA,Colima,650555,2,1,52,8
2020-05-12,Mexico,NA,Colima,650555,6,0,58,8
2020-05-13,Mexico,NA,Colima,650555,4,0,62,8
2020-05-14,Mexico,NA,Colima,650555,12,0,74,8
2020-05-15,Mexico,NA,Colima,650555,4,1,78,9
2020-05-16,Mexico,NA,Colima,650555,3,1,81,10
2020-05-17,Mexico,NA,Colima,650555,5,0,86,10
2020-05-18,Mexico,NA,Colima,650555,7,1,93,11
2020-05-19,Mexico,NA,Colima,650555,7,0,100,11
2020-05-20,Mexico,NA,Colima,650555,8,2,108,13
2020-05-21,Mexico,NA,Colima,650555,4,1,112,14
2020-05-22,Mexico,NA,Colima,650555,7,1,119,15
2020-05-23,Mexico,NA,Colima,650555,4,0,123,15
2020-05-24,Mexico,NA,Colima,650555,7,4,130,19
2020-05-25,Mexico,NA,Colima,650555,7,0,137,19
2020-05-26,Mexico,NA,Colima,650555,7,2,144,21
2020-05-27,Mexico,NA,Colima,650555,4,1,148,22
2020-05-28,Mexico,NA,Colima,650555,7,0,155,22
2020-05-29,Mexico,NA,Colima,650555,8,1,163,23
2020-05-30,Mexico,NA,Colima,650555,6,0,169,23
2020-05-31,Mexico,NA,Colima,650555,4,2,173,25
2020-06-01,Mexico,NA,Colima,650555,11,1,184,26
2020-06-02,Mexico,NA,Colima,650555,11,0,195,26
2020-06-03,Mexico,NA,Colima,650555,11,1,206,27
2020-06-04,Mexico,NA,Colima,650555,9,0,215,27
2020-06-05,Mexico,NA,Colima,650555,11,1,226,28
2020-06-06,Mexico,NA,Colima,650555,11,2,237,30
2020-06-07,Mexico,NA,Colima,650555,4,2,241,32
2020-06-08,Mexico,NA,Colima,650555,12,0,253,32
2020-06-09,Mexico,NA,Colima,650555,14,0,267,32
2020-06-10,Mexico,NA,Colima,650555,12,2,279,34
2020-06-11,Mexico,NA,Colima,650555,16,1,295,35
2020-06-12,Mexico,NA,Colima,650555,13,1,308,36
2020-06-13,Mexico,NA,Colima,650555,11,1,319,37
2020-06-14,Mexico,NA,Colima,650555,8,1,327,38
2020-06-15,Mexico,NA,Colima,650555,15,1,342,39
2020-06-16,Mexico,NA,Colima,650555,24,2,366,41
2020-06-17,Mexico,NA,Colima,650555,18,2,384,43
2020-06-18,Mexico,NA,Colima,650555,18,2,402,45
2020-06-19,Mexico,NA,Colima,650555,27,2,429,47
2020-06-20,Mexico,NA,Colima,650555,11,4,440,51
2020-06-21,Mexico,NA,Colima,650555,15,3,455,54
2020-06-22,Mexico,NA,Colima,650555,21,2,476,56
2020-06-23,Mexico,NA,Colima,650555,23,4,499,60
2020-06-24,Mexico,NA,Colima,650555,20,1,519,61
2020-06-25,Mexico,NA,Colima,650555,24,5,543,66
2020-06-26,Mexico,NA,Colima,650555,27,1,570,67
2020-06-27,Mexico,NA,Colima,650555,17,3,587,70
2020-06-28,Mexico,NA,Colima,650555,13,2,600,72
2020-06-29,Mexico,NA,Colima,650555,21,0,621,72
2020-06-30,Mexico,NA,Colima,650555,22,2,643,74
2020-07-01,Mexico,NA,Colima,650555,36,3,679,77
2020-07-02,Mexico,NA,Colima,650555,18,1,697,78
2020-07-03,Mexico,NA,Colima,650555,34,0,731,78
2020-07-04,Mexico,NA,Colima,650555,13,2,744,80
2020-07-05,Mexico,NA,Colima,650555,14,2,758,82
2020-07-06,Mexico,NA,Colima,650555,33,3,791,85
2020-07-07,Mexico,NA,Colima,650555,36,0,827,85
2020-07-08,Mexico,NA,Colima,650555,34,3,861,88
2020-07-09,Mexico,NA,Colima,650555,37,4,898,92
2020-07-10,Mexico,NA,Colima,650555,58,4,956,96
2020-07-11,Mexico,NA,Colima,650555,28,10,984,106
2020-07-12,Mexico,NA,Colima,650555,22,6,1006,112
2020-07-13,Mexico,NA,Colima,650555,54,7,1060,119
2020-07-14,Mexico,NA,Colima,650555,56,4,1116,123
2020-07-15,Mexico,NA,Colima,650555,47,6,1163,129
2020-07-16,Mexico,NA,Colima,650555,68,5,1231,134
2020-07-17,Mexico,NA,Colima,650555,48,7,1279,141
2020-07-18,Mexico,NA,Colima,650555,43,2,1322,143
2020-07-19,Mexico,NA,Colima,650555,34,3,1356,146
2020-07-20,Mexico,NA,Colima,650555,59,5,1415,151
2020-07-21,Mexico,NA,Colima,650555,64,7,1479,158
2020-07-22,Mexico,NA,Colima,650555,77,8,1556,166
2020-07-23,Mexico,NA,Colima,650555,71,1,1627,167
2020-07-24,Mexico,NA,Colima,650555,61,10,1688,177
2020-07-25,Mexico,NA,Colima,650555,40,3,1728,180
2020-07-26,Mexico,NA,Colima,650555,38,4,1766,184
2020-07-27,Mexico,NA,Colima,650555,49,7,1815,191
2020-07-28,Mexico,NA,Colima,650555,68,4,1883,195
2020-07-29,Mexico,NA,Colima,650555,52,3,1935,198
2020-07-30,Mexico,NA,Colima,650555,62,6,1997,204
2020-07-31,Mexico,NA,Colima,650555,43,7,2040,211
2020-08-01,Mexico,NA,Colima,650555,24,9,2064,220
2020-08-02,Mexico,NA,Colima,650555,34,3,2098,223
2020-08-03,Mexico,NA,Colima,650555,76,10,2174,233
2020-08-04,Mexico,NA,Colima,650555,74,5,2248,238
2020-08-05,Mexico,NA,Colima,650555,62,8,2310,246
2020-08-06,Mexico,NA,Colima,650555,63,8,2373,254
2020-08-07,Mexico,NA,Colima,650555,59,4,2432,258
2020-08-08,Mexico,NA,Colima,650555,32,8,2464,266
2020-08-09,Mexico,NA,Colima,650555,35,11,2499,277
2020-08-10,Mexico,NA,Colima,650555,70,9,2569,286
2020-08-11,Mexico,NA,Colima,650555,73,9,2642,295
2020-08-12,Mexico,NA,Colima,650555,79,3,2721,298
2020-08-13,Mexico,NA,Colima,650555,71,6,2792,304
2020-08-14,Mexico,NA,Colima,650555,80,8,2872,312
2020-08-15,Mexico,NA,Colima,650555,42,5,2914,317
2020-08-16,Mexico,NA,Colima,650555,43,3,2957,320
2020-08-17,Mexico,NA,Colima,650555,75,10,3032,330
2020-08-18,Mexico,NA,Colima,650555,61,3,3093,333
2020-08-19,Mexico,NA,Colima,650555,73,4,3166,337
2020-08-20,Mexico,NA,Colima,650555,76,7,3242,344
2020-08-21,Mexico,NA,Colima,650555,65,9,3307,353
2020-08-22,Mexico,NA,Colima,650555,41,8,3348,361
2020-08-23,Mexico,NA,Colima,650555,38,7,3386,368
2020-08-24,Mexico,NA,Colima,650555,77,5,3463,373
2020-08-25,Mexico,NA,Colima,650555,80,8,3543,381
2020-08-26,Mexico,NA,Colima,650555,69,5,3612,386
2020-08-27,Mexico,NA,Colima,650555,59,7,3671,393
2020-08-28,Mexico,NA,Colima,650555,52,5,3723,398
2020-08-29,Mexico,NA,Colima,650555,35,7,3758,405
2020-08-30,Mexico,NA,Colima,650555,28,2,3786,407
2020-08-31,Mexico,NA,Colima,650555,75,5,3861,412
2020-09-01,Mexico,NA,Colima,650555,39,11,3900,423
2020-09-02,Mexico,NA,Colima,650555,32,3,3932,426
2020-09-03,Mexico,NA,Colima,650555,30,0,3962,426
2020-09-04,Mexico,NA,Colima,650555,37,5,3999,431
2020-09-05,Mexico,NA,Colima,650555,21,4,4020,435
2020-09-06,Mexico,NA,Colima,650555,20,2,4040,437
2020-09-07,Mexico,NA,Colima,650555,44,3,4084,440
2020-09-08,Mexico,NA,Colima,650555,37,7,4121,447
2020-09-09,Mexico,NA,Colima,650555,32,2,4153,449
2020-09-10,Mexico,NA,Colima,650555,39,5,4192,454
2020-09-11,Mexico,NA,Colima,650555,46,3,4238,457
2020-09-12,Mexico,NA,Colima,650555,15,6,4253,463
2020-09-13,Mexico,NA,Colima,650555,23,4,4276,467
2020-09-14,Mexico,NA,Colima,650555,45,6,4321,473
2020-09-15,Mexico,NA,Colima,650555,41,4,4362,477
2020-09-16,Mexico,NA,Colima,650555,20,4,4382,481
2020-09-17,Mexico,NA,Colima,650555,40,4,4422,485
2020-09-18,Mexico,NA,Colima,650555,57,2,4479,487
2020-09-19,Mexico,NA,Colima,650555,35,6,4514,493
2020-09-20,Mexico,NA,Colima,650555,34,3,4548,496
2020-09-21,Mexico,NA,Colima,650555,31,6,4579,502
2020-09-22,Mexico,NA,Colima,650555,16,4,4595,506
2020-09-23,Mexico,NA,Colima,650555,4,2,4599,508
2020-03-30,Mexico,NA,Durango,1632934,2,0,11,2
2020-03-31,Mexico,NA,Durango,1632934,2,1,13,2
2020-04-01,Mexico,NA,Durango,1632934,1,1,14,2
2020-04-06,Mexico,NA,Durango,1632934,1,0,15,3
2020-04-08,Mexico,NA,Durango,1632934,1,0,16,3
2020-04-09,Mexico,NA,Durango,1632934,1,0,17,3
2020-04-11,Mexico,NA,Durango,1632934,1,0,18,3
2020-04-15,Mexico,NA,Durango,1632934,2,0,20,4
2020-04-16,Mexico,NA,Durango,1632934,2,0,22,4
2020-04-18,Mexico,NA,Durango,1632934,2,0,24,4
2020-04-19,Mexico,NA,Durango,1632934,10,0,34,4
2020-04-20,Mexico,NA,Durango,1632934,4,0,38,4
2020-04-21,Mexico,NA,Durango,1632934,4,1,42,5
2020-04-22,Mexico,NA,Durango,1632934,2,0,44,5
2020-04-23,Mexico,NA,Durango,1632934,2,0,46,5
2020-04-24,Mexico,NA,Durango,1632934,2,1,48,6
2020-04-25,Mexico,NA,Durango,1632934,5,1,53,7
2020-04-26,Mexico,NA,Durango,1632934,8,1,61,8
2020-04-27,Mexico,NA,Durango,1632934,5,0,66,8
2020-04-28,Mexico,NA,Durango,1632934,3,1,69,9
2020-04-29,Mexico,NA,Durango,1632934,8,0,77,9
2020-04-30,Mexico,NA,Durango,1632934,2,0,79,9
2020-05-01,Mexico,NA,Durango,1632934,6,1,85,10
2020-05-02,Mexico,NA,Durango,1632934,6,2,91,12
2020-05-03,Mexico,NA,Durango,1632934,7,1,98,13
2020-05-04,Mexico,NA,Durango,1632934,3,0,101,13
2020-05-05,Mexico,NA,Durango,1632934,3,0,104,13
2020-05-06,Mexico,NA,Durango,1632934,5,0,109,13
2020-05-07,Mexico,NA,Durango,1632934,11,0,120,13
2020-05-08,Mexico,NA,Durango,1632934,10,2,130,15
2020-05-09,Mexico,NA,Durango,1632934,2,1,132,16
2020-05-10,Mexico,NA,Durango,1632934,1,0,133,16
2020-05-11,Mexico,NA,Durango,1632934,6,0,139,16
2020-05-12,Mexico,NA,Durango,1632934,11,0,150,16
2020-05-13,Mexico,NA,Durango,1632934,10,1,160,17
2020-05-14,Mexico,NA,Durango,1632934,12,3,172,20
2020-05-15,Mexico,NA,Durango,1632934,16,3,188,23
2020-05-16,Mexico,NA,Durango,1632934,3,2,191,25
2020-05-17,Mexico,NA,Durango,1632934,8,1,199,26
2020-05-18,Mexico,NA,Durango,1632934,15,0,214,26
2020-05-19,Mexico,NA,Durango,1632934,7,0,221,26
2020-05-20,Mexico,NA,Durango,1632934,23,5,244,31
2020-05-21,Mexico,NA,Durango,1632934,20,1,264,32
2020-05-22,Mexico,NA,Durango,1632934,23,0,287,32
2020-05-23,Mexico,NA,Durango,1632934,5,0,292,32
2020-05-24,Mexico,NA,Durango,1632934,15,3,307,35
2020-05-25,Mexico,NA,Durango,1632934,27,3,334,38
2020-05-26,Mexico,NA,Durango,1632934,21,2,355,40
2020-05-27,Mexico,NA,Durango,1632934,27,2,382,42
2020-05-28,Mexico,NA,Durango,1632934,23,4,405,46
2020-05-29,Mexico,NA,Durango,1632934,33,3,438,49
2020-05-30,Mexico,NA,Durango,1632934,38,0,476,49
2020-05-31,Mexico,NA,Durango,1632934,12,3,488,52
2020-06-01,Mexico,NA,Durango,1632934,39,1,527,53
2020-06-02,Mexico,NA,Durango,1632934,38,4,565,57
2020-06-03,Mexico,NA,Durango,1632934,28,1,593,58
2020-06-04,Mexico,NA,Durango,1632934,44,2,637,60
2020-06-05,Mexico,NA,Durango,1632934,79,4,716,64
2020-06-06,Mexico,NA,Durango,1632934,22,4,738,68
2020-06-07,Mexico,NA,Durango,1632934,20,2,758,70
2020-06-08,Mexico,NA,Durango,1632934,72,3,830,73
2020-06-09,Mexico,NA,Durango,1632934,69,2,899,75
2020-06-10,Mexico,NA,Durango,1632934,50,6,949,81
2020-06-11,Mexico,NA,Durango,1632934,59,4,1008,85
2020-06-12,Mexico,NA,Durango,1632934,53,7,1061,92
2020-06-13,Mexico,NA,Durango,1632934,17,4,1078,96
2020-06-14,Mexico,NA,Durango,1632934,18,6,1096,102
2020-06-15,Mexico,NA,Durango,1632934,70,6,1166,108
2020-06-16,Mexico,NA,Durango,1632934,90,6,1256,114
2020-06-17,Mexico,NA,Durango,1632934,69,9,1325,123
2020-06-18,Mexico,NA,Durango,1632934,82,2,1407,125
2020-06-19,Mexico,NA,Durango,1632934,52,4,1459,129
2020-06-20,Mexico,NA,Durango,1632934,14,1,1473,130
2020-06-21,Mexico,NA,Durango,1632934,16,3,1489,133
2020-06-22,Mexico,NA,Durango,1632934,72,3,1561,136
2020-06-23,Mexico,NA,Durango,1632934,107,4,1668,140
2020-06-24,Mexico,NA,Durango,1632934,94,5,1762,145
2020-06-25,Mexico,NA,Durango,1632934,70,5,1832,150
2020-06-26,Mexico,NA,Durango,1632934,89,6,1921,156
2020-06-27,Mexico,NA,Durango,1632934,52,2,1973,158
2020-06-28,Mexico,NA,Durango,1632934,38,5,2011,163
2020-06-29,Mexico,NA,Durango,1632934,63,2,2074,165
2020-06-30,Mexico,NA,Durango,1632934,88,2,2162,167
2020-07-01,Mexico,NA,Durango,1632934,110,7,2272,174
2020-07-02,Mexico,NA,Durango,1632934,61,5,2333,179
2020-07-03,Mexico,NA,Durango,1632934,76,2,2409,181
2020-07-04,Mexico,NA,Durango,1632934,20,3,2429,184
2020-07-05,Mexico,NA,Durango,1632934,20,4,2449,188
2020-07-06,Mexico,NA,Durango,1632934,69,4,2518,192
2020-07-07,Mexico,NA,Durango,1632934,66,8,2584,200
2020-07-08,Mexico,NA,Durango,1632934,79,7,2663,207
2020-07-09,Mexico,NA,Durango,1632934,114,7,2777,214
2020-07-10,Mexico,NA,Durango,1632934,73,2,2850,216
2020-07-11,Mexico,NA,Durango,1632934,27,10,2877,226
2020-07-12,Mexico,NA,Durango,1632934,25,7,2902,233
2020-07-13,Mexico,NA,Durango,1632934,104,4,3006,237
2020-07-14,Mexico,NA,Durango,1632934,84,7,3090,244
2020-07-15,Mexico,NA,Durango,1632934,87,4,3177,248
2020-07-16,Mexico,NA,Durango,1632934,80,7,3257,255
2020-07-17,Mexico,NA,Durango,1632934,83,6,3340,261
2020-07-18,Mexico,NA,Durango,1632934,30,6,3370,267
2020-07-19,Mexico,NA,Durango,1632934,14,3,3384,270
2020-07-20,Mexico,NA,Durango,1632934,108,10,3492,280
2020-07-21,Mexico,NA,Durango,1632934,114,2,3606,282
2020-07-22,Mexico,NA,Durango,1632934,85,4,3691,286
2020-07-23,Mexico,NA,Durango,1632934,88,6,3779,292
2020-07-24,Mexico,NA,Durango,1632934,72,1,3851,293
2020-07-25,Mexico,NA,Durango,1632934,21,9,3872,302
2020-07-26,Mexico,NA,Durango,1632934,38,5,3910,307
2020-07-27,Mexico,NA,Durango,1632934,120,4,4030,311
2020-07-28,Mexico,NA,Durango,1632934,94,1,4124,312
2020-07-29,Mexico,NA,Durango,1632934,97,4,4221,316
2020-07-30,Mexico,NA,Durango,1632934,74,7,4295,323
2020-07-31,Mexico,NA,Durango,1632934,86,10,4381,333
2020-08-01,Mexico,NA,Durango,1632934,38,4,4419,337
2020-08-02,Mexico,NA,Durango,1632934,17,4,4436,341
2020-08-03,Mexico,NA,Durango,1632934,104,5,4540,346
2020-08-04,Mexico,NA,Durango,1632934,77,7,4617,353
2020-08-05,Mexico,NA,Durango,1632934,83,9,4700,362
2020-08-06,Mexico,NA,Durango,1632934,103,3,4803,365
2020-08-07,Mexico,NA,Durango,1632934,64,7,4867,372
2020-08-08,Mexico,NA,Durango,1632934,22,5,4889,377
2020-08-09,Mexico,NA,Durango,1632934,21,7,4910,384
2020-08-10,Mexico,NA,Durango,1632934,98,3,5008,387
2020-08-11,Mexico,NA,Durango,1632934,123,5,5131,392
2020-08-12,Mexico,NA,Durango,1632934,87,1,5218,393
2020-08-13,Mexico,NA,Durango,1632934,99,5,5317,398
2020-08-14,Mexico,NA,Durango,1632934,90,6,5407,404
2020-08-15,Mexico,NA,Durango,1632934,16,4,5423,408
2020-08-16,Mexico,NA,Durango,1632934,19,3,5442,411
2020-08-17,Mexico,NA,Durango,1632934,116,2,5558,413
2020-08-18,Mexico,NA,Durango,1632934,112,4,5670,417
2020-08-19,Mexico,NA,Durango,1632934,68,10,5738,427
2020-08-20,Mexico,NA,Durango,1632934,103,2,5841,429
2020-08-21,Mexico,NA,Durango,1632934,101,3,5942,432
2020-08-22,Mexico,NA,Durango,1632934,33,6,5975,438
2020-08-23,Mexico,NA,Durango,1632934,25,5,6000,443
2020-08-24,Mexico,NA,Durango,1632934,129,4,6129,447
2020-08-25,Mexico,NA,Durango,1632934,106,8,6235,455
2020-08-26,Mexico,NA,Durango,1632934,112,3,6347,458
2020-08-27,Mexico,NA,Durango,1632934,101,8,6448,466
2020-08-28,Mexico,NA,Durango,1632934,110,10,6558,476
2020-08-29,Mexico,NA,Durango,1632934,21,8,6579,484
2020-08-30,Mexico,NA,Durango,1632934,25,5,6604,489
2020-08-31,Mexico,NA,Durango,1632934,137,6,6741,495
2020-09-01,Mexico,NA,Durango,1632934,138,6,6879,501
2020-09-02,Mexico,NA,Durango,1632934,144,5,7023,506
2020-09-03,Mexico,NA,Durango,1632934,101,9,7124,515
2020-09-04,Mexico,NA,Durango,1632934,108,4,7232,519
2020-09-05,Mexico,NA,Durango,1632934,25,6,7257,525
2020-09-06,Mexico,NA,Durango,1632934,33,4,7290,529
2020-09-07,Mexico,NA,Durango,1632934,124,3,7414,532
2020-09-08,Mexico,NA,Durango,1632934,103,7,7517,539
2020-09-09,Mexico,NA,Durango,1632934,103,7,7620,546
2020-09-10,Mexico,NA,Durango,1632934,95,4,7715,550
2020-09-11,Mexico,NA,Durango,1632934,112,3,7827,553
2020-09-12,Mexico,NA,Durango,1632934,17,5,7844,558
2020-09-13,Mexico,NA,Durango,1632934,22,4,7866,562
2020-09-14,Mexico,NA,Durango,1632934,97,6,7963,568
2020-09-15,Mexico,NA,Durango,1632934,74,3,8037,571
2020-09-16,Mexico,NA,Durango,1632934,12,8,8049,579
2020-09-17,Mexico,NA,Durango,1632934,100,2,8149,581
2020-09-18,Mexico,NA,Durango,1632934,98,3,8247,584
2020-09-19,Mexico,NA,Durango,1632934,16,4,8263,588
2020-09-20,Mexico,NA,Durango,1632934,17,0,8280,588
2020-09-21,Mexico,NA,Durango,1632934,54,0,8334,588
2020-09-22,Mexico,NA,Durango,1632934,44,2,8378,590
2020-09-23,Mexico,NA,Durango,1632934,22,0,8400,590
2020-03-20,Mexico,NA,Guanajuato,5486372,4,0,11,0
2020-03-21,Mexico,NA,Guanajuato,5486372,11,0,22,0
2020-03-22,Mexico,NA,Guanajuato,5486372,1,0,23,0
2020-03-23,Mexico,NA,Guanajuato,5486372,6,0,29,0
2020-03-24,Mexico,NA,Guanajuato,5486372,1,0,30,0
2020-03-25,Mexico,NA,Guanajuato,5486372,4,0,34,0
2020-03-26,Mexico,NA,Guanajuato,5486372,6,0,40,0
2020-03-27,Mexico,NA,Guanajuato,5486372,5,0,45,0
2020-03-28,Mexico,NA,Guanajuato,5486372,4,0,49,0
2020-03-29,Mexico,NA,Guanajuato,5486372,1,0,50,0
2020-03-30,Mexico,NA,Guanajuato,5486372,5,0,55,0
2020-03-31,Mexico,NA,Guanajuato,5486372,2,0,57,0
2020-04-01,Mexico,NA,Guanajuato,5486372,1,0,58,0
2020-04-02,Mexico,NA,Guanajuato,5486372,2,0,60,0
2020-04-03,Mexico,NA,Guanajuato,5486372,5,0,65,0
2020-04-04,Mexico,NA,Guanajuato,5486372,3,0,68,0
2020-04-05,Mexico,NA,Guanajuato,5486372,3,2,71,2
2020-04-06,Mexico,NA,Guanajuato,5486372,7,0,78,2
2020-04-07,Mexico,NA,Guanajuato,5486372,6,1,84,3
2020-04-08,Mexico,NA,Guanajuato,5486372,9,0,93,3
2020-04-09,Mexico,NA,Guanajuato,5486372,2,1,95,4
2020-04-10,Mexico,NA,Guanajuato,5486372,2,1,97,5
2020-04-11,Mexico,NA,Guanajuato,5486372,4,0,101,5
2020-04-12,Mexico,NA,Guanajuato,5486372,1,0,102,5
2020-04-13,Mexico,NA,Guanajuato,5486372,3,0,105,5
2020-04-14,Mexico,NA,Guanajuato,5486372,4,2,109,7
2020-04-15,Mexico,NA,Guanajuato,5486372,13,1,122,8
2020-04-16,Mexico,NA,Guanajuato,5486372,14,0,136,8
2020-04-17,Mexico,NA,Guanajuato,5486372,29,3,165,11
2020-04-18,Mexico,NA,Guanajuato,5486372,10,0,175,11
2020-04-19,Mexico,NA,Guanajuato,5486372,10,0,185,11
2020-04-20,Mexico,NA,Guanajuato,5486372,14,0,199,11
2020-04-21,Mexico,NA,Guanajuato,5486372,10,2,209,13
2020-04-22,Mexico,NA,Guanajuato,5486372,13,3,222,16
2020-04-23,Mexico,NA,Guanajuato,5486372,9,3,231,19
2020-04-24,Mexico,NA,Guanajuato,5486372,12,1,243,20
2020-04-25,Mexico,NA,Guanajuato,5486372,11,3,254,23
2020-04-26,Mexico,NA,Guanajuato,5486372,7,2,261,25
2020-04-27,Mexico,NA,Guanajuato,5486372,25,0,286,25
2020-04-28,Mexico,NA,Guanajuato,5486372,17,0,303,25
2020-04-29,Mexico,NA,Guanajuato,5486372,14,2,317,27
2020-04-30,Mexico,NA,Guanajuato,5486372,16,3,333,30
2020-05-01,Mexico,NA,Guanajuato,5486372,14,3,347,33
2020-05-02,Mexico,NA,Guanajuato,5486372,10,2,357,35
2020-05-03,Mexico,NA,Guanajuato,5486372,11,3,368,38
2020-05-04,Mexico,NA,Guanajuato,5486372,33,3,401,41
2020-05-05,Mexico,NA,Guanajuato,5486372,23,2,424,43
2020-05-06,Mexico,NA,Guanajuato,5486372,30,3,454,46
2020-05-07,Mexico,NA,Guanajuato,5486372,37,4,491,50
2020-05-08,Mexico,NA,Guanajuato,5486372,43,6,534,56
2020-05-09,Mexico,NA,Guanajuato,5486372,26,4,560,60
2020-05-10,Mexico,NA,Guanajuato,5486372,23,1,583,61
2020-05-11,Mexico,NA,Guanajuato,5486372,41,3,624,64
2020-05-12,Mexico,NA,Guanajuato,5486372,53,1,677,65
2020-05-13,Mexico,NA,Guanajuato,5486372,41,4,718,69
2020-05-14,Mexico,NA,Guanajuato,5486372,51,2,769,71
2020-05-15,Mexico,NA,Guanajuato,5486372,36,6,805,77
2020-05-16,Mexico,NA,Guanajuato,5486372,34,3,839,80
2020-05-17,Mexico,NA,Guanajuato,5486372,20,1,859,81
2020-05-18,Mexico,NA,Guanajuato,5486372,54,6,913,87
2020-05-19,Mexico,NA,Guanajuato,5486372,69,3,982,90
2020-05-20,Mexico,NA,Guanajuato,5486372,58,2,1040,92
2020-05-21,Mexico,NA,Guanajuato,5486372,62,4,1102,96
2020-05-22,Mexico,NA,Guanajuato,5486372,56,5,1158,101
2020-05-23,Mexico,NA,Guanajuato,5486372,52,6,1210,107
2020-05-24,Mexico,NA,Guanajuato,5486372,20,4,1230,111
2020-05-25,Mexico,NA,Guanajuato,5486372,119,6,1349,117
2020-05-26,Mexico,NA,Guanajuato,5486372,97,4,1446,121
2020-05-27,Mexico,NA,Guanajuato,5486372,107,5,1553,126
2020-05-28,Mexico,NA,Guanajuato,5486372,141,7,1694,133
2020-05-29,Mexico,NA,Guanajuato,5486372,144,2,1838,135
2020-05-30,Mexico,NA,Guanajuato,5486372,98,7,1936,142
2020-05-31,Mexico,NA,Guanajuato,5486372,70,6,2006,148
2020-06-01,Mexico,NA,Guanajuato,5486372,182,2,2188,150
2020-06-02,Mexico,NA,Guanajuato,5486372,174,5,2362,155
2020-06-03,Mexico,NA,Guanajuato,5486372,178,5,2540,160
2020-06-04,Mexico,NA,Guanajuato,5486372,219,8,2759,168
2020-06-05,Mexico,NA,Guanajuato,5486372,171,10,2930,178
2020-06-06,Mexico,NA,Guanajuato,5486372,126,16,3056,194
2020-06-07,Mexico,NA,Guanajuato,5486372,81,13,3137,207
2020-06-08,Mexico,NA,Guanajuato,5486372,198,14,3335,221
2020-06-09,Mexico,NA,Guanajuato,5486372,228,11,3563,232
2020-06-10,Mexico,NA,Guanajuato,5486372,187,19,3750,251
2020-06-11,Mexico,NA,Guanajuato,5486372,205,17,3955,268
2020-06-12,Mexico,NA,Guanajuato,5486372,214,15,4169,283
2020-06-13,Mexico,NA,Guanajuato,5486372,126,16,4295,299
2020-06-14,Mexico,NA,Guanajuato,5486372,84,14,4379,313
2020-06-15,Mexico,NA,Guanajuato,5486372,340,20,4719,333
2020-06-16,Mexico,NA,Guanajuato,5486372,319,20,5038,353
2020-06-17,Mexico,NA,Guanajuato,5486372,334,15,5372,368
2020-06-18,Mexico,NA,Guanajuato,5486372,325,25,5697,393
2020-06-19,Mexico,NA,Guanajuato,5486372,373,22,6070,415
2020-06-20,Mexico,NA,Guanajuato,5486372,188,26,6258,441
2020-06-21,Mexico,NA,Guanajuato,5486372,114,16,6372,457
2020-06-22,Mexico,NA,Guanajuato,5486372,385,25,6757,482
2020-06-23,Mexico,NA,Guanajuato,5486372,409,22,7166,504
2020-06-24,Mexico,NA,Guanajuato,5486372,394,24,7560,528
2020-06-25,Mexico,NA,Guanajuato,5486372,299,24,7859,552
2020-06-26,Mexico,NA,Guanajuato,5486372,366,20,8225,572
2020-06-27,Mexico,NA,Guanajuato,5486372,210,26,8435,598
2020-06-28,Mexico,NA,Guanajuato,5486372,121,22,8556,620
2020-06-29,Mexico,NA,Guanajuato,5486372,407,37,8963,657
2020-06-30,Mexico,NA,Guanajuato,5486372,418,27,9381,684
2020-07-01,Mexico,NA,Guanajuato,5486372,414,27,9795,711
2020-07-02,Mexico,NA,Guanajuato,5486372,423,39,10218,750
2020-07-03,Mexico,NA,Guanajuato,5486372,434,33,10652,783
2020-07-04,Mexico,NA,Guanajuato,5486372,225,34,10877,817
2020-07-05,Mexico,NA,Guanajuato,5486372,129,30,11006,847
2020-07-06,Mexico,NA,Guanajuato,5486372,483,34,11489,881
2020-07-07,Mexico,NA,Guanajuato,5486372,516,35,12005,916
2020-07-08,Mexico,NA,Guanajuato,5486372,504,38,12509,954
2020-07-09,Mexico,NA,Guanajuato,5486372,522,36,13031,990
2020-07-10,Mexico,NA,Guanajuato,5486372,450,33,13481,1023
2020-07-11,Mexico,NA,Guanajuato,5486372,187,33,13668,1056
2020-07-12,Mexico,NA,Guanajuato,5486372,166,37,13834,1093
2020-07-13,Mexico,NA,Guanajuato,5486372,545,26,14379,1119
2020-07-14,Mexico,NA,Guanajuato,5486372,559,33,14938,1152
2020-07-15,Mexico,NA,Guanajuato,5486372,626,30,15564,1182
2020-07-16,Mexico,NA,Guanajuato,5486372,531,24,16095,1206
2020-07-17,Mexico,NA,Guanajuato,5486372,438,28,16533,1234
2020-07-18,Mexico,NA,Guanajuato,5486372,231,40,16764,1274
2020-07-19,Mexico,NA,Guanajuato,5486372,140,29,16904,1303
2020-07-20,Mexico,NA,Guanajuato,5486372,500,35,17404,1338
2020-07-21,Mexico,NA,Guanajuato,5486372,654,42,18058,1380
2020-07-22,Mexico,NA,Guanajuato,5486372,543,36,18601,1416
2020-07-23,Mexico,NA,Guanajuato,5486372,536,22,19137,1438
2020-07-24,Mexico,NA,Guanajuato,5486372,506,50,19643,1488
2020-07-25,Mexico,NA,Guanajuato,5486372,211,36,19854,1524
2020-07-26,Mexico,NA,Guanajuato,5486372,181,38,20035,1562
2020-07-27,Mexico,NA,Guanajuato,5486372,606,41,20641,1603
2020-07-28,Mexico,NA,Guanajuato,5486372,615,34,21256,1637
2020-07-29,Mexico,NA,Guanajuato,5486372,486,31,21742,1668
2020-07-30,Mexico,NA,Guanajuato,5486372,547,33,22289,1701
2020-07-31,Mexico,NA,Guanajuato,5486372,423,27,22712,1728
2020-08-01,Mexico,NA,Guanajuato,5486372,170,30,22882,1758
2020-08-02,Mexico,NA,Guanajuato,5486372,149,27,23031,1785
2020-08-03,Mexico,NA,Guanajuato,5486372,511,26,23542,1811
2020-08-04,Mexico,NA,Guanajuato,5486372,451,35,23993,1846
2020-08-05,Mexico,NA,Guanajuato,5486372,380,37,24373,1883
2020-08-06,Mexico,NA,Guanajuato,5486372,358,34,24731,1917
2020-08-07,Mexico,NA,Guanajuato,5486372,431,30,25162,1947
2020-08-08,Mexico,NA,Guanajuato,5486372,184,39,25346,1986
2020-08-09,Mexico,NA,Guanajuato,5486372,113,34,25459,2020
2020-08-10,Mexico,NA,Guanajuato,5486372,430,26,25889,2046
2020-08-11,Mexico,NA,Guanajuato,5486372,439,22,26328,2068
2020-08-12,Mexico,NA,Guanajuato,5486372,426,19,26754,2087
2020-08-13,Mexico,NA,Guanajuato,5486372,444,17,27198,2104
2020-08-14,Mexico,NA,Guanajuato,5486372,392,31,27590,2135
2020-08-15,Mexico,NA,Guanajuato,5486372,161,21,27751,2156
2020-08-16,Mexico,NA,Guanajuato,5486372,106,19,27857,2175
2020-08-17,Mexico,NA,Guanajuato,5486372,361,29,28218,2204
2020-08-18,Mexico,NA,Guanajuato,5486372,362,26,28580,2230
2020-08-19,Mexico,NA,Guanajuato,5486372,442,25,29022,2255
2020-08-20,Mexico,NA,Guanajuato,5486372,422,26,29444,2281
2020-08-21,Mexico,NA,Guanajuato,5486372,474,21,29918,2302
2020-08-22,Mexico,NA,Guanajuato,5486372,160,34,30078,2336
2020-08-23,Mexico,NA,Guanajuato,5486372,152,24,30230,2360
2020-08-24,Mexico,NA,Guanajuato,5486372,515,16,30745,2376
2020-08-25,Mexico,NA,Guanajuato,5486372,420,23,31165,2399
2020-08-26,Mexico,NA,Guanajuato,5486372,467,18,31632,2417
2020-08-27,Mexico,NA,Guanajuato,5486372,436,19,32068,2436
2020-08-28,Mexico,NA,Guanajuato,5486372,431,21,32499,2457
2020-08-29,Mexico,NA,Guanajuato,5486372,202,15,32701,2472
2020-08-30,Mexico,NA,Guanajuato,5486372,157,18,32858,2490
2020-08-31,Mexico,NA,Guanajuato,5486372,564,28,33422,2518
2020-09-01,Mexico,NA,Guanajuato,5486372,468,20,33890,2538
2020-09-02,Mexico,NA,Guanajuato,5486372,384,18,34274,2556
2020-09-03,Mexico,NA,Guanajuato,5486372,397,14,34671,2570
2020-09-04,Mexico,NA,Guanajuato,5486372,417,20,35088,2590
2020-09-05,Mexico,NA,Guanajuato,5486372,123,20,35211,2610
2020-09-06,Mexico,NA,Guanajuato,5486372,141,11,35352,2621
2020-09-07,Mexico,NA,Guanajuato,5486372,419,10,35771,2631
2020-09-08,Mexico,NA,Guanajuato,5486372,451,10,36222,2641
2020-09-09,Mexico,NA,Guanajuato,5486372,385,15,36607,2656
2020-09-10,Mexico,NA,Guanajuato,5486372,416,17,37023,2673
2020-09-11,Mexico,NA,Guanajuato,5486372,389,20,37412,2693
2020-09-12,Mexico,NA,Guanajuato,5486372,131,16,37543,2709
2020-09-13,Mexico,NA,Guanajuato,5486372,119,11,37662,2720
2020-09-14,Mexico,NA,Guanajuato,5486372,493,14,38155,2734
2020-09-15,Mexico,NA,Guanajuato,5486372,258,14,38413,2748
2020-09-16,Mexico,NA,Guanajuato,5486372,153,10,38566,2758
2020-09-17,Mexico,NA,Guanajuato,5486372,286,4,38852,2762
2020-09-18,Mexico,NA,Guanajuato,5486372,290,7,39142,2769
2020-09-19,Mexico,NA,Guanajuato,5486372,101,16,39243,2785
2020-09-20,Mexico,NA,Guanajuato,5486372,74,18,39317,2803
2020-09-21,Mexico,NA,Guanajuato,5486372,176,6,39493,2809
2020-09-22,Mexico,NA,Guanajuato,5486372,30,13,39523,2822
2020-09-23,Mexico,NA,Guanajuato,5486372,1,3,39524,2825
2020-03-21,Mexico,NA,Guerrero,3388768,1,0,11,0
2020-03-23,Mexico,NA,Guerrero,3388768,1,0,12,0
2020-03-25,Mexico,NA,Guerrero,3388768,3,0,15,0
2020-03-26,Mexico,NA,Guerrero,3388768,4,0,19,0
2020-03-27,Mexico,NA,Guerrero,3388768,3,0,22,0
2020-03-28,Mexico,NA,Guerrero,3388768,3,1,25,1
2020-03-29,Mexico,NA,Guerrero,3388768,1,0,26,1
2020-03-30,Mexico,NA,Guerrero,3388768,2,0,28,1
2020-03-31,Mexico,NA,Guerrero,3388768,5,0,33,1
2020-04-01,Mexico,NA,Guerrero,3388768,3,0,36,1
2020-04-02,Mexico,NA,Guerrero,3388768,1,0,37,1
2020-04-03,Mexico,NA,Guerrero,3388768,1,0,38,1
2020-04-04,Mexico,NA,Guerrero,3388768,2,2,40,3
2020-04-05,Mexico,NA,Guerrero,3388768,3,0,43,3
2020-04-06,Mexico,NA,Guerrero,3388768,8,2,51,5
2020-04-07,Mexico,NA,Guerrero,3388768,11,0,62,5
2020-04-08,Mexico,NA,Guerrero,3388768,6,0,68,5
2020-04-09,Mexico,NA,Guerrero,3388768,7,1,75,6
2020-04-10,Mexico,NA,Guerrero,3388768,5,0,80,6
2020-04-11,Mexico,NA,Guerrero,3388768,5,0,85,6
2020-04-12,Mexico,NA,Guerrero,3388768,12,1,97,7
2020-04-13,Mexico,NA,Guerrero,3388768,17,1,114,8
2020-04-14,Mexico,NA,Guerrero,3388768,7,1,121,9
2020-04-15,Mexico,NA,Guerrero,3388768,5,3,126,12
2020-04-16,Mexico,NA,Guerrero,3388768,11,0,137,12
2020-04-17,Mexico,NA,Guerrero,3388768,13,1,150,13
2020-04-18,Mexico,NA,Guerrero,3388768,9,3,159,16
2020-04-19,Mexico,NA,Guerrero,3388768,6,4,165,20
2020-04-20,Mexico,NA,Guerrero,3388768,16,3,181,23
2020-04-21,Mexico,NA,Guerrero,3388768,7,7,188,30
2020-04-22,Mexico,NA,Guerrero,3388768,13,3,201,33
2020-04-23,Mexico,NA,Guerrero,3388768,19,3,220,36
2020-04-24,Mexico,NA,Guerrero,3388768,25,1,245,37
2020-04-25,Mexico,NA,Guerrero,3388768,13,4,258,41
2020-04-26,Mexico,NA,Guerrero,3388768,18,1,276,42
2020-04-27,Mexico,NA,Guerrero,3388768,27,8,303,50
2020-04-28,Mexico,NA,Guerrero,3388768,29,5,332,55
2020-04-29,Mexico,NA,Guerrero,3388768,31,4,363,59
2020-04-30,Mexico,NA,Guerrero,3388768,18,2,381,61
2020-05-01,Mexico,NA,Guerrero,3388768,14,2,395,63
2020-05-02,Mexico,NA,Guerrero,3388768,40,8,435,71
2020-05-03,Mexico,NA,Guerrero,3388768,29,4,464,75
2020-05-04,Mexico,NA,Guerrero,3388768,54,4,518,79
2020-05-05,Mexico,NA,Guerrero,3388768,37,5,555,84
2020-05-06,Mexico,NA,Guerrero,3388768,47,10,602,94
2020-05-07,Mexico,NA,Guerrero,3388768,41,6,643,100
2020-05-08,Mexico,NA,Guerrero,3388768,40,4,683,104
2020-05-09,Mexico,NA,Guerrero,3388768,36,11,719,115
2020-05-10,Mexico,NA,Guerrero,3388768,33,6,752,121
2020-05-11,Mexico,NA,Guerrero,3388768,48,8,800,129
2020-05-12,Mexico,NA,Guerrero,3388768,59,7,859,136
2020-05-13,Mexico,NA,Guerrero,3388768,48,8,907,144
2020-05-14,Mexico,NA,Guerrero,3388768,75,8,982,152
2020-05-15,Mexico,NA,Guerrero,3388768,61,13,1043,165
2020-05-16,Mexico,NA,Guerrero,3388768,51,14,1094,179
2020-05-17,Mexico,NA,Guerrero,3388768,42,16,1136,195
2020-05-18,Mexico,NA,Guerrero,3388768,128,17,1264,212
2020-05-19,Mexico,NA,Guerrero,3388768,110,12,1374,224
2020-05-20,Mexico,NA,Guerrero,3388768,142,23,1516,247
2020-05-21,Mexico,NA,Guerrero,3388768,141,17,1657,264
2020-05-22,Mexico,NA,Guerrero,3388768,131,18,1788,282
2020-05-23,Mexico,NA,Guerrero,3388768,66,19,1854,301
2020-05-24,Mexico,NA,Guerrero,3388768,71,21,1925,322
2020-05-25,Mexico,NA,Guerrero,3388768,136,27,2061,349
2020-05-26,Mexico,NA,Guerrero,3388768,118,23,2179,372
2020-05-27,Mexico,NA,Guerrero,3388768,121,26,2300,398
2020-05-28,Mexico,NA,Guerrero,3388768,114,17,2414,415
2020-05-29,Mexico,NA,Guerrero,3388768,98,22,2512,437
2020-05-30,Mexico,NA,Guerrero,3388768,62,17,2574,454
2020-05-31,Mexico,NA,Guerrero,3388768,79,23,2653,477
2020-06-01,Mexico,NA,Guerrero,3388768,153,21,2806,498
2020-06-02,Mexico,NA,Guerrero,3388768,110,28,2916,526
2020-06-03,Mexico,NA,Guerrero,3388768,116,18,3032,544
2020-06-04,Mexico,NA,Guerrero,3388768,132,17,3164,561
2020-06-05,Mexico,NA,Guerrero,3388768,125,23,3289,584
2020-06-06,Mexico,NA,Guerrero,3388768,93,19,3382,603
2020-06-07,Mexico,NA,Guerrero,3388768,65,24,3447,627
2020-06-08,Mexico,NA,Guerrero,3388768,153,22,3600,649
2020-06-09,Mexico,NA,Guerrero,3388768,108,20,3708,669
2020-06-10,Mexico,NA,Guerrero,3388768,154,23,3862,692
2020-06-11,Mexico,NA,Guerrero,3388768,154,18,4016,710
2020-06-12,Mexico,NA,Guerrero,3388768,152,18,4168,728
2020-06-13,Mexico,NA,Guerrero,3388768,79,27,4247,755
2020-06-14,Mexico,NA,Guerrero,3388768,97,23,4344,778
2020-06-15,Mexico,NA,Guerrero,3388768,143,15,4487,793
2020-06-16,Mexico,NA,Guerrero,3388768,153,19,4640,812
2020-06-17,Mexico,NA,Guerrero,3388768,110,25,4750,837
2020-06-18,Mexico,NA,Guerrero,3388768,106,19,4856,856
2020-06-19,Mexico,NA,Guerrero,3388768,135,30,4991,886
2020-06-20,Mexico,NA,Guerrero,3388768,54,14,5045,900
2020-06-21,Mexico,NA,Guerrero,3388768,71,16,5116,916
2020-06-22,Mexico,NA,Guerrero,3388768,180,29,5296,945
2020-06-23,Mexico,NA,Guerrero,3388768,126,16,5422,961
2020-06-24,Mexico,NA,Guerrero,3388768,97,15,5519,976
2020-06-25,Mexico,NA,Guerrero,3388768,134,16,5653,992
2020-06-26,Mexico,NA,Guerrero,3388768,127,22,5780,1014
2020-06-27,Mexico,NA,Guerrero,3388768,144,24,5924,1038
2020-06-28,Mexico,NA,Guerrero,3388768,173,20,6097,1058
2020-06-29,Mexico,NA,Guerrero,3388768,253,19,6350,1077
2020-06-30,Mexico,NA,Guerrero,3388768,252,22,6602,1099
2020-07-01,Mexico,NA,Guerrero,3388768,264,11,6866,1110
2020-07-02,Mexico,NA,Guerrero,3388768,303,11,7169,1121
2020-07-03,Mexico,NA,Guerrero,3388768,274,15,7443,1136
2020-07-04,Mexico,NA,Guerrero,3388768,191,21,7634,1157
2020-07-05,Mexico,NA,Guerrero,3388768,153,12,7787,1169
2020-07-06,Mexico,NA,Guerrero,3388768,161,14,7948,1183
2020-07-07,Mexico,NA,Guerrero,3388768,147,23,8095,1206
2020-07-08,Mexico,NA,Guerrero,3388768,119,10,8214,1216
2020-07-09,Mexico,NA,Guerrero,3388768,144,12,8358,1228
2020-07-10,Mexico,NA,Guerrero,3388768,139,16,8497,1244
2020-07-11,Mexico,NA,Guerrero,3388768,40,13,8537,1257
2020-07-12,Mexico,NA,Guerrero,3388768,129,7,8666,1264
2020-07-13,Mexico,NA,Guerrero,3388768,161,16,8827,1280
2020-07-14,Mexico,NA,Guerrero,3388768,171,24,8998,1304
2020-07-15,Mexico,NA,Guerrero,3388768,136,12,9134,1316
2020-07-16,Mexico,NA,Guerrero,3388768,169,9,9303,1325
2020-07-17,Mexico,NA,Guerrero,3388768,119,13,9422,1338
2020-07-18,Mexico,NA,Guerrero,3388768,116,14,9538,1352
2020-07-19,Mexico,NA,Guerrero,3388768,128,12,9666,1364
2020-07-20,Mexico,NA,Guerrero,3388768,246,14,9912,1378
2020-07-21,Mexico,NA,Guerrero,3388768,147,15,10059,1393
2020-07-22,Mexico,NA,Guerrero,3388768,153,11,10212,1404
2020-07-23,Mexico,NA,Guerrero,3388768,219,15,10431,1419
2020-07-24,Mexico,NA,Guerrero,3388768,197,10,10628,1429
2020-07-25,Mexico,NA,Guerrero,3388768,96,15,10724,1444
2020-07-26,Mexico,NA,Guerrero,3388768,88,17,10812,1461
2020-07-27,Mexico,NA,Guerrero,3388768,209,9,11021,1470
2020-07-28,Mexico,NA,Guerrero,3388768,182,7,11203,1477
2020-07-29,Mexico,NA,Guerrero,3388768,144,6,11347,1483
2020-07-30,Mexico,NA,Guerrero,3388768,197,12,11544,1495
2020-07-31,Mexico,NA,Guerrero,3388768,167,10,11711,1505
2020-08-01,Mexico,NA,Guerrero,3388768,127,10,11838,1515
2020-08-02,Mexico,NA,Guerrero,3388768,63,11,11901,1526
2020-08-03,Mexico,NA,Guerrero,3388768,187,10,12088,1536
2020-08-04,Mexico,NA,Guerrero,3388768,217,14,12305,1550
2020-08-05,Mexico,NA,Guerrero,3388768,220,7,12525,1557
2020-08-06,Mexico,NA,Guerrero,3388768,160,7,12685,1564
2020-08-07,Mexico,NA,Guerrero,3388768,142,15,12827,1579
2020-08-08,Mexico,NA,Guerrero,3388768,61,7,12888,1586
2020-08-09,Mexico,NA,Guerrero,3388768,42,9,12930,1595
2020-08-10,Mexico,NA,Guerrero,3388768,178,7,13108,1602
2020-08-11,Mexico,NA,Guerrero,3388768,128,9,13236,1611
2020-08-12,Mexico,NA,Guerrero,3388768,107,4,13343,1615
2020-08-13,Mexico,NA,Guerrero,3388768,151,12,13494,1627
2020-08-14,Mexico,NA,Guerrero,3388768,113,4,13607,1631
2020-08-15,Mexico,NA,Guerrero,3388768,75,13,13682,1644
2020-08-16,Mexico,NA,Guerrero,3388768,47,14,13729,1658
2020-08-17,Mexico,NA,Guerrero,3388768,142,8,13871,1666
2020-08-18,Mexico,NA,Guerrero,3388768,124,12,13995,1678
2020-08-19,Mexico,NA,Guerrero,3388768,143,16,14138,1694
2020-08-20,Mexico,NA,Guerrero,3388768,105,8,14243,1702
2020-08-21,Mexico,NA,Guerrero,3388768,94,6,14337,1708
2020-08-22,Mexico,NA,Guerrero,3388768,63,8,14400,1716
2020-08-23,Mexico,NA,Guerrero,3388768,58,5,14458,1721
2020-08-24,Mexico,NA,Guerrero,3388768,128,6,14586,1727
2020-08-25,Mexico,NA,Guerrero,3388768,143,11,14729,1738
2020-08-26,Mexico,NA,Guerrero,3388768,104,8,14833,1746
2020-08-27,Mexico,NA,Guerrero,3388768,116,7,14949,1753
2020-08-28,Mexico,NA,Guerrero,3388768,139,5,15088,1758
2020-08-29,Mexico,NA,Guerrero,3388768,37,15,15125,1773
2020-08-30,Mexico,NA,Guerrero,3388768,39,5,15164,1778
2020-08-31,Mexico,NA,Guerrero,3388768,143,4,15307,1782
2020-09-01,Mexico,NA,Guerrero,3388768,162,4,15469,1786
2020-09-02,Mexico,NA,Guerrero,3388768,172,2,15641,1788
2020-09-03,Mexico,NA,Guerrero,3388768,157,7,15798,1795
2020-09-04,Mexico,NA,Guerrero,3388768,162,3,15960,1798
2020-09-05,Mexico,NA,Guerrero,3388768,56,7,16016,1805
2020-09-06,Mexico,NA,Guerrero,3388768,74,1,16090,1806
2020-09-07,Mexico,NA,Guerrero,3388768,220,9,16310,1815
2020-09-08,Mexico,NA,Guerrero,3388768,185,2,16495,1817
2020-09-09,Mexico,NA,Guerrero,3388768,157,8,16652,1825
2020-09-10,Mexico,NA,Guerrero,3388768,161,4,16813,1829
2020-09-11,Mexico,NA,Guerrero,3388768,182,1,16995,1830
2020-09-12,Mexico,NA,Guerrero,3388768,77,11,17072,1841
2020-09-13,Mexico,NA,Guerrero,3388768,73,11,17145,1852
2020-09-14,Mexico,NA,Guerrero,3388768,210,5,17355,1857
2020-09-15,Mexico,NA,Guerrero,3388768,175,5,17530,1862
2020-09-16,Mexico,NA,Guerrero,3388768,64,5,17594,1867
2020-09-17,Mexico,NA,Guerrero,3388768,183,4,17777,1871
2020-09-18,Mexico,NA,Guerrero,3388768,136,3,17913,1874
2020-09-19,Mexico,NA,Guerrero,3388768,61,2,17974,1876
2020-09-20,Mexico,NA,Guerrero,3388768,14,7,17988,1883
2020-09-21,Mexico,NA,Guerrero,3388768,41,7,18029,1890
2020-09-22,Mexico,NA,Guerrero,3388768,2,3,18031,1893
2020-03-23,Mexico,NA,Hidalgo,2665018,1,0,11,0
2020-03-24,Mexico,NA,Hidalgo,2665018,1,0,12,0
2020-03-25,Mexico,NA,Hidalgo,2665018,5,0,17,0
2020-03-26,Mexico,NA,Hidalgo,2665018,4,0,21,0
2020-03-27,Mexico,NA,Hidalgo,2665018,4,1,25,1
2020-03-28,Mexico,NA,Hidalgo,2665018,0,1,25,2
2020-03-29,Mexico,NA,Hidalgo,2665018,2,0,27,2
2020-03-30,Mexico,NA,Hidalgo,2665018,7,1,34,3
2020-03-31,Mexico,NA,Hidalgo,2665018,7,0,41,3
2020-04-01,Mexico,NA,Hidalgo,2665018,5,1,46,4
2020-04-02,Mexico,NA,Hidalgo,2665018,1,0,47,4
2020-04-03,Mexico,NA,Hidalgo,2665018,3,1,50,5
2020-04-04,Mexico,NA,Hidalgo,2665018,2,0,52,5
2020-04-05,Mexico,NA,Hidalgo,2665018,2,0,54,5
2020-04-06,Mexico,NA,Hidalgo,2665018,3,0,57,5
2020-04-07,Mexico,NA,Hidalgo,2665018,3,0,60,5
2020-04-08,Mexico,NA,Hidalgo,2665018,1,2,61,7
2020-04-10,Mexico,NA,Hidalgo,2665018,7,0,68,7
2020-04-11,Mexico,NA,Hidalgo,2665018,3,0,71,7
2020-04-12,Mexico,NA,Hidalgo,2665018,5,0,76,7
2020-04-13,Mexico,NA,Hidalgo,2665018,8,0,84,7
2020-04-14,Mexico,NA,Hidalgo,2665018,9,2,93,9
2020-04-15,Mexico,NA,Hidalgo,2665018,5,3,98,12
2020-04-16,Mexico,NA,Hidalgo,2665018,5,0,103,12
2020-04-17,Mexico,NA,Hidalgo,2665018,9,0,112,12
2020-04-18,Mexico,NA,Hidalgo,2665018,6,2,118,14
2020-04-19,Mexico,NA,Hidalgo,2665018,14,1,132,15
2020-04-20,Mexico,NA,Hidalgo,2665018,19,1,151,16
2020-04-21,Mexico,NA,Hidalgo,2665018,12,2,163,18
2020-04-22,Mexico,NA,Hidalgo,2665018,15,2,178,20
2020-04-23,Mexico,NA,Hidalgo,2665018,19,2,197,22
2020-04-24,Mexico,NA,Hidalgo,2665018,20,1,217,23
2020-04-25,Mexico,NA,Hidalgo,2665018,23,7,240,30
2020-04-26,Mexico,NA,Hidalgo,2665018,18,8,258,38
2020-04-27,Mexico,NA,Hidalgo,2665018,26,1,284,39
2020-04-28,Mexico,NA,Hidalgo,2665018,27,5,311,44
2020-04-29,Mexico,NA,Hidalgo,2665018,28,2,339,46
2020-04-30,Mexico,NA,Hidalgo,2665018,31,5,370,51
2020-05-01,Mexico,NA,Hidalgo,2665018,26,9,396,60
2020-05-02,Mexico,NA,Hidalgo,2665018,21,2,417,62
2020-05-03,Mexico,NA,Hidalgo,2665018,27,7,444,69
2020-05-04,Mexico,NA,Hidalgo,2665018,35,10,479,79
2020-05-05,Mexico,NA,Hidalgo,2665018,30,10,509,89
2020-05-06,Mexico,NA,Hidalgo,2665018,41,7,550,96
2020-05-07,Mexico,NA,Hidalgo,2665018,37,8,587,104
2020-05-08,Mexico,NA,Hidalgo,2665018,36,9,623,113
2020-05-09,Mexico,NA,Hidalgo,2665018,25,6,648,119
2020-05-10,Mexico,NA,Hidalgo,2665018,25,10,673,129
2020-05-11,Mexico,NA,Hidalgo,2665018,51,8,724,137
2020-05-12,Mexico,NA,Hidalgo,2665018,56,12,780,149
2020-05-13,Mexico,NA,Hidalgo,2665018,45,9,825,158
2020-05-14,Mexico,NA,Hidalgo,2665018,67,14,892,172
2020-05-15,Mexico,NA,Hidalgo,2665018,80,15,972,187
2020-05-16,Mexico,NA,Hidalgo,2665018,54,9,1026,196
2020-05-17,Mexico,NA,Hidalgo,2665018,26,12,1052,208
2020-05-18,Mexico,NA,Hidalgo,2665018,80,14,1132,222
2020-05-19,Mexico,NA,Hidalgo,2665018,70,7,1202,229
2020-05-20,Mexico,NA,Hidalgo,2665018,78,16,1280,245
2020-05-21,Mexico,NA,Hidalgo,2665018,92,17,1372,262
2020-05-22,Mexico,NA,Hidalgo,2665018,80,12,1452,274
2020-05-23,Mexico,NA,Hidalgo,2665018,52,11,1504,285
2020-05-24,Mexico,NA,Hidalgo,2665018,40,11,1544,296
2020-05-25,Mexico,NA,Hidalgo,2665018,88,12,1632,308
2020-05-26,Mexico,NA,Hidalgo,2665018,71,11,1703,319
2020-05-27,Mexico,NA,Hidalgo,2665018,81,12,1784,331
2020-05-28,Mexico,NA,Hidalgo,2665018,93,12,1877,343
2020-05-29,Mexico,NA,Hidalgo,2665018,73,11,1950,354
2020-05-30,Mexico,NA,Hidalgo,2665018,47,11,1997,365
2020-05-31,Mexico,NA,Hidalgo,2665018,40,13,2037,378
2020-06-01,Mexico,NA,Hidalgo,2665018,94,9,2131,387
2020-06-02,Mexico,NA,Hidalgo,2665018,79,6,2210,393
2020-06-03,Mexico,NA,Hidalgo,2665018,67,16,2277,409
2020-06-04,Mexico,NA,Hidalgo,2665018,63,5,2340,414
2020-06-05,Mexico,NA,Hidalgo,2665018,66,3,2406,417
2020-06-06,Mexico,NA,Hidalgo,2665018,51,3,2457,420
2020-06-07,Mexico,NA,Hidalgo,2665018,29,12,2486,432
2020-06-08,Mexico,NA,Hidalgo,2665018,87,15,2573,447
2020-06-09,Mexico,NA,Hidalgo,2665018,110,8,2683,455
2020-06-10,Mexico,NA,Hidalgo,2665018,77,12,2760,467
2020-06-11,Mexico,NA,Hidalgo,2665018,73,10,2833,477
2020-06-12,Mexico,NA,Hidalgo,2665018,96,5,2929,482
2020-06-13,Mexico,NA,Hidalgo,2665018,45,8,2974,490
2020-06-14,Mexico,NA,Hidalgo,2665018,42,16,3016,506
2020-06-15,Mexico,NA,Hidalgo,2665018,81,10,3097,516
2020-06-16,Mexico,NA,Hidalgo,2665018,73,11,3170,527
2020-06-17,Mexico,NA,Hidalgo,2665018,73,12,3243,539
2020-06-18,Mexico,NA,Hidalgo,2665018,77,12,3320,551
2020-06-19,Mexico,NA,Hidalgo,2665018,86,11,3406,562
2020-06-20,Mexico,NA,Hidalgo,2665018,54,8,3460,570
2020-06-21,Mexico,NA,Hidalgo,2665018,28,10,3488,580
2020-06-22,Mexico,NA,Hidalgo,2665018,74,8,3562,588
2020-06-23,Mexico,NA,Hidalgo,2665018,80,12,3642,600
2020-06-24,Mexico,NA,Hidalgo,2665018,87,13,3729,613
2020-06-25,Mexico,NA,Hidalgo,2665018,84,8,3813,621
2020-06-26,Mexico,NA,Hidalgo,2665018,89,19,3902,640
2020-06-27,Mexico,NA,Hidalgo,2665018,43,6,3945,646
2020-06-28,Mexico,NA,Hidalgo,2665018,39,12,3984,658
2020-06-29,Mexico,NA,Hidalgo,2665018,94,11,4078,669
2020-06-30,Mexico,NA,Hidalgo,2665018,82,6,4160,675
2020-07-01,Mexico,NA,Hidalgo,2665018,108,18,4268,693
2020-07-02,Mexico,NA,Hidalgo,2665018,91,13,4359,706
2020-07-03,Mexico,NA,Hidalgo,2665018,75,11,4434,717
2020-07-04,Mexico,NA,Hidalgo,2665018,39,5,4473,722
2020-07-05,Mexico,NA,Hidalgo,2665018,32,9,4505,731
2020-07-06,Mexico,NA,Hidalgo,2665018,100,6,4605,737
2020-07-07,Mexico,NA,Hidalgo,2665018,87,10,4692,747
2020-07-08,Mexico,NA,Hidalgo,2665018,84,10,4776,757
2020-07-09,Mexico,NA,Hidalgo,2665018,76,10,4852,767
2020-07-10,Mexico,NA,Hidalgo,2665018,89,15,4941,782
2020-07-11,Mexico,NA,Hidalgo,2665018,49,12,4990,794
2020-07-12,Mexico,NA,Hidalgo,2665018,47,18,5037,812
2020-07-13,Mexico,NA,Hidalgo,2665018,120,14,5157,826
2020-07-14,Mexico,NA,Hidalgo,2665018,106,14,5263,840
2020-07-15,Mexico,NA,Hidalgo,2665018,108,14,5371,854
2020-07-16,Mexico,NA,Hidalgo,2665018,116,15,5487,869
2020-07-17,Mexico,NA,Hidalgo,2665018,107,17,5594,886
2020-07-18,Mexico,NA,Hidalgo,2665018,73,13,5667,899
2020-07-19,Mexico,NA,Hidalgo,2665018,56,8,5723,907
2020-07-20,Mexico,NA,Hidalgo,2665018,176,14,5899,921
2020-07-21,Mexico,NA,Hidalgo,2665018,145,18,6044,939
2020-07-22,Mexico,NA,Hidalgo,2665018,128,12,6172,951
2020-07-23,Mexico,NA,Hidalgo,2665018,132,9,6304,960
2020-07-24,Mexico,NA,Hidalgo,2665018,127,16,6431,976
2020-07-25,Mexico,NA,Hidalgo,2665018,72,20,6503,996
2020-07-26,Mexico,NA,Hidalgo,2665018,70,13,6573,1009
2020-07-27,Mexico,NA,Hidalgo,2665018,134,17,6707,1026
2020-07-28,Mexico,NA,Hidalgo,2665018,133,16,6840,1042
2020-07-29,Mexico,NA,Hidalgo,2665018,122,16,6962,1058
2020-07-30,Mexico,NA,Hidalgo,2665018,132,19,7094,1077
2020-07-31,Mexico,NA,Hidalgo,2665018,129,17,7223,1094
2020-08-01,Mexico,NA,Hidalgo,2665018,74,12,7297,1106
2020-08-02,Mexico,NA,Hidalgo,2665018,79,19,7376,1125
2020-08-03,Mexico,NA,Hidalgo,2665018,150,18,7526,1143
2020-08-04,Mexico,NA,Hidalgo,2665018,133,23,7659,1166
2020-08-05,Mexico,NA,Hidalgo,2665018,159,19,7818,1185
2020-08-06,Mexico,NA,Hidalgo,2665018,131,22,7949,1207
2020-08-07,Mexico,NA,Hidalgo,2665018,136,15,8085,1222
2020-08-08,Mexico,NA,Hidalgo,2665018,101,14,8186,1236
2020-08-09,Mexico,NA,Hidalgo,2665018,66,15,8252,1251
2020-08-10,Mexico,NA,Hidalgo,2665018,125,26,8377,1277
2020-08-11,Mexico,NA,Hidalgo,2665018,136,23,8513,1300
2020-08-12,Mexico,NA,Hidalgo,2665018,133,18,8646,1318
2020-08-13,Mexico,NA,Hidalgo,2665018,149,14,8795,1332
2020-08-14,Mexico,NA,Hidalgo,2665018,124,19,8919,1351
2020-08-15,Mexico,NA,Hidalgo,2665018,80,12,8999,1363
2020-08-16,Mexico,NA,Hidalgo,2665018,68,13,9067,1376
2020-08-17,Mexico,NA,Hidalgo,2665018,112,22,9179,1398
2020-08-18,Mexico,NA,Hidalgo,2665018,101,16,9280,1414
2020-08-19,Mexico,NA,Hidalgo,2665018,115,16,9395,1430
2020-08-20,Mexico,NA,Hidalgo,2665018,138,12,9533,1442
2020-08-21,Mexico,NA,Hidalgo,2665018,127,19,9660,1461
2020-08-22,Mexico,NA,Hidalgo,2665018,70,20,9730,1481
2020-08-23,Mexico,NA,Hidalgo,2665018,69,20,9799,1501
2020-08-24,Mexico,NA,Hidalgo,2665018,160,11,9959,1512
2020-08-25,Mexico,NA,Hidalgo,2665018,141,29,10100,1541
2020-08-26,Mexico,NA,Hidalgo,2665018,117,17,10217,1558
2020-08-27,Mexico,NA,Hidalgo,2665018,103,14,10320,1572
2020-08-28,Mexico,NA,Hidalgo,2665018,95,19,10415,1591
2020-08-29,Mexico,NA,Hidalgo,2665018,68,19,10483,1610
2020-08-30,Mexico,NA,Hidalgo,2665018,61,15,10544,1625
2020-08-31,Mexico,NA,Hidalgo,2665018,111,16,10655,1641
2020-09-01,Mexico,NA,Hidalgo,2665018,102,16,10757,1657
2020-09-02,Mexico,NA,Hidalgo,2665018,113,14,10870,1671
2020-09-03,Mexico,NA,Hidalgo,2665018,87,9,10957,1680
2020-09-04,Mexico,NA,Hidalgo,2665018,87,11,11044,1691
2020-09-05,Mexico,NA,Hidalgo,2665018,41,12,11085,1703
2020-09-06,Mexico,NA,Hidalgo,2665018,44,14,11129,1717
2020-09-07,Mexico,NA,Hidalgo,2665018,97,11,11226,1728
2020-09-08,Mexico,NA,Hidalgo,2665018,72,9,11298,1737
2020-09-09,Mexico,NA,Hidalgo,2665018,106,15,11404,1752
2020-09-10,Mexico,NA,Hidalgo,2665018,76,8,11480,1760
2020-09-11,Mexico,NA,Hidalgo,2665018,95,14,11575,1774
2020-09-12,Mexico,NA,Hidalgo,2665018,45,12,11620,1786
2020-09-13,Mexico,NA,Hidalgo,2665018,48,9,11668,1795
2020-09-14,Mexico,NA,Hidalgo,2665018,108,9,11776,1804
2020-09-15,Mexico,NA,Hidalgo,2665018,72,8,11848,1812
2020-09-16,Mexico,NA,Hidalgo,2665018,62,10,11910,1822
2020-09-17,Mexico,NA,Hidalgo,2665018,86,5,11996,1827
2020-09-18,Mexico,NA,Hidalgo,2665018,88,11,12084,1838
2020-09-19,Mexico,NA,Hidalgo,2665018,40,5,12124,1843
2020-09-20,Mexico,NA,Hidalgo,2665018,29,8,12153,1851
2020-09-21,Mexico,NA,Hidalgo,2665018,86,10,12239,1861
2020-09-22,Mexico,NA,Hidalgo,2665018,63,7,12302,1868
2020-09-23,Mexico,NA,Hidalgo,2665018,27,3,12329,1871
2020-03-14,Mexico,NA,Jalisco,7350682,5,0,12,0
2020-03-15,Mexico,NA,Jalisco,7350682,2,0,14,0
2020-03-16,Mexico,NA,Jalisco,7350682,12,0,26,0
2020-03-17,Mexico,NA,Jalisco,7350682,6,0,32,0
2020-03-18,Mexico,NA,Jalisco,7350682,17,0,49,0
2020-03-19,Mexico,NA,Jalisco,7350682,11,0,60,0
2020-03-20,Mexico,NA,Jalisco,7350682,5,1,65,1
2020-03-21,Mexico,NA,Jalisco,7350682,1,0,66,1
2020-03-22,Mexico,NA,Jalisco,7350682,3,0,69,1
2020-03-23,Mexico,NA,Jalisco,7350682,8,0,77,1
2020-03-24,Mexico,NA,Jalisco,7350682,7,0,84,1
2020-03-25,Mexico,NA,Jalisco,7350682,7,0,91,1
2020-03-26,Mexico,NA,Jalisco,7350682,6,2,97,3
2020-03-27,Mexico,NA,Jalisco,7350682,7,0,104,3
2020-03-28,Mexico,NA,Jalisco,7350682,2,0,106,3
2020-03-29,Mexico,NA,Jalisco,7350682,2,0,108,3
2020-03-30,Mexico,NA,Jalisco,7350682,7,0,115,3
2020-03-31,Mexico,NA,Jalisco,7350682,7,1,122,4
2020-04-01,Mexico,NA,Jalisco,7350682,3,0,125,4
2020-04-02,Mexico,NA,Jalisco,7350682,8,2,133,6
2020-04-03,Mexico,NA,Jalisco,7350682,10,0,143,6
2020-04-04,Mexico,NA,Jalisco,7350682,2,0,145,6
2020-04-05,Mexico,NA,Jalisco,7350682,2,1,147,7
2020-04-06,Mexico,NA,Jalisco,7350682,4,0,151,7
2020-04-07,Mexico,NA,Jalisco,7350682,6,1,157,8
2020-04-08,Mexico,NA,Jalisco,7350682,9,1,166,9
2020-04-09,Mexico,NA,Jalisco,7350682,5,0,171,9
2020-04-10,Mexico,NA,Jalisco,7350682,8,1,179,10
2020-04-11,Mexico,NA,Jalisco,7350682,5,1,184,11
2020-04-12,Mexico,NA,Jalisco,7350682,5,0,189,11
2020-04-13,Mexico,NA,Jalisco,7350682,10,0,199,11
2020-04-14,Mexico,NA,Jalisco,7350682,4,0,203,11
2020-04-15,Mexico,NA,Jalisco,7350682,11,0,214,11
2020-04-16,Mexico,NA,Jalisco,7350682,9,1,223,12
2020-04-17,Mexico,NA,Jalisco,7350682,14,1,237,13
2020-04-18,Mexico,NA,Jalisco,7350682,7,0,244,13
2020-04-19,Mexico,NA,Jalisco,7350682,3,2,247,15
2020-04-20,Mexico,NA,Jalisco,7350682,10,1,257,16
2020-04-21,Mexico,NA,Jalisco,7350682,16,1,273,17
2020-04-22,Mexico,NA,Jalisco,7350682,25,3,298,20
2020-04-23,Mexico,NA,Jalisco,7350682,19,1,317,21
2020-04-24,Mexico,NA,Jalisco,7350682,32,3,349,24
2020-04-25,Mexico,NA,Jalisco,7350682,9,2,358,26
2020-04-26,Mexico,NA,Jalisco,7350682,9,0,367,26
2020-04-27,Mexico,NA,Jalisco,7350682,22,1,389,27
2020-04-28,Mexico,NA,Jalisco,7350682,14,3,403,30
2020-04-29,Mexico,NA,Jalisco,7350682,22,2,425,32
2020-04-30,Mexico,NA,Jalisco,7350682,26,3,451,35
2020-05-01,Mexico,NA,Jalisco,7350682,15,0,466,35
2020-05-02,Mexico,NA,Jalisco,7350682,29,4,495,39
2020-05-03,Mexico,NA,Jalisco,7350682,16,3,511,42
2020-05-04,Mexico,NA,Jalisco,7350682,31,3,542,45
2020-05-05,Mexico,NA,Jalisco,7350682,20,3,562,48
2020-05-06,Mexico,NA,Jalisco,7350682,25,5,587,53
2020-05-07,Mexico,NA,Jalisco,7350682,51,3,638,56
2020-05-08,Mexico,NA,Jalisco,7350682,25,0,663,56
2020-05-09,Mexico,NA,Jalisco,7350682,28,3,691,59
2020-05-10,Mexico,NA,Jalisco,7350682,23,3,714,62
2020-05-11,Mexico,NA,Jalisco,7350682,50,2,764,64
2020-05-12,Mexico,NA,Jalisco,7350682,40,3,804,67
2020-05-13,Mexico,NA,Jalisco,7350682,30,3,834,70
2020-05-14,Mexico,NA,Jalisco,7350682,57,4,891,74
2020-05-15,Mexico,NA,Jalisco,7350682,65,7,956,81
2020-05-16,Mexico,NA,Jalisco,7350682,19,9,975,90
2020-05-17,Mexico,NA,Jalisco,7350682,31,5,1006,95
2020-05-18,Mexico,NA,Jalisco,7350682,58,3,1064,98
2020-05-19,Mexico,NA,Jalisco,7350682,75,1,1139,99
2020-05-20,Mexico,NA,Jalisco,7350682,64,6,1203,105
2020-05-21,Mexico,NA,Jalisco,7350682,64,9,1267,114
2020-05-22,Mexico,NA,Jalisco,7350682,75,2,1342,116
2020-05-23,Mexico,NA,Jalisco,7350682,43,4,1385,120
2020-05-24,Mexico,NA,Jalisco,7350682,38,3,1423,123
2020-05-25,Mexico,NA,Jalisco,7350682,95,8,1518,131
2020-05-26,Mexico,NA,Jalisco,7350682,130,5,1648,136
2020-05-27,Mexico,NA,Jalisco,7350682,143,4,1791,140
2020-05-28,Mexico,NA,Jalisco,7350682,124,3,1915,143
2020-05-29,Mexico,NA,Jalisco,7350682,167,5,2082,148
2020-05-30,Mexico,NA,Jalisco,7350682,127,14,2209,162
2020-05-31,Mexico,NA,Jalisco,7350682,85,10,2294,172
2020-06-01,Mexico,NA,Jalisco,7350682,229,20,2523,192
2020-06-02,Mexico,NA,Jalisco,7350682,196,11,2719,203
2020-06-03,Mexico,NA,Jalisco,7350682,211,18,2930,221
2020-06-04,Mexico,NA,Jalisco,7350682,178,23,3108,244
2020-06-05,Mexico,NA,Jalisco,7350682,224,17,3332,261
2020-06-06,Mexico,NA,Jalisco,7350682,101,17,3433,278
2020-06-07,Mexico,NA,Jalisco,7350682,72,21,3505,299
2020-06-08,Mexico,NA,Jalisco,7350682,263,14,3768,313
2020-06-09,Mexico,NA,Jalisco,7350682,251,26,4019,339
2020-06-10,Mexico,NA,Jalisco,7350682,248,14,4267,353
2020-06-11,Mexico,NA,Jalisco,7350682,231,24,4498,377
2020-06-12,Mexico,NA,Jalisco,7350682,184,28,4682,405
2020-06-13,Mexico,NA,Jalisco,7350682,119,14,4801,419
2020-06-14,Mexico,NA,Jalisco,7350682,88,27,4889,446
2020-06-15,Mexico,NA,Jalisco,7350682,229,18,5118,464
2020-06-16,Mexico,NA,Jalisco,7350682,217,24,5335,488
2020-06-17,Mexico,NA,Jalisco,7350682,215,30,5550,518
2020-06-18,Mexico,NA,Jalisco,7350682,237,17,5787,535
2020-06-19,Mexico,NA,Jalisco,7350682,198,24,5985,559
2020-06-20,Mexico,NA,Jalisco,7350682,139,26,6124,585
2020-06-21,Mexico,NA,Jalisco,7350682,96,26,6220,611
2020-06-22,Mexico,NA,Jalisco,7350682,226,21,6446,632
2020-06-23,Mexico,NA,Jalisco,7350682,236,27,6682,659
2020-06-24,Mexico,NA,Jalisco,7350682,205,27,6887,686
2020-06-25,Mexico,NA,Jalisco,7350682,178,29,7065,715
2020-06-26,Mexico,NA,Jalisco,7350682,223,19,7288,734
2020-06-27,Mexico,NA,Jalisco,7350682,140,23,7428,757
2020-06-28,Mexico,NA,Jalisco,7350682,109,27,7537,784
2020-06-29,Mexico,NA,Jalisco,7350682,192,34,7729,818
2020-06-30,Mexico,NA,Jalisco,7350682,231,20,7960,838
2020-07-01,Mexico,NA,Jalisco,7350682,203,32,8163,870
2020-07-02,Mexico,NA,Jalisco,7350682,208,21,8371,891
2020-07-03,Mexico,NA,Jalisco,7350682,215,33,8586,924
2020-07-04,Mexico,NA,Jalisco,7350682,140,38,8726,962
2020-07-05,Mexico,NA,Jalisco,7350682,96,32,8822,994
2020-07-06,Mexico,NA,Jalisco,7350682,244,27,9066,1021
2020-07-07,Mexico,NA,Jalisco,7350682,248,27,9314,1048
2020-07-08,Mexico,NA,Jalisco,7350682,218,30,9532,1078
2020-07-09,Mexico,NA,Jalisco,7350682,216,28,9748,1106
2020-07-10,Mexico,NA,Jalisco,7350682,244,24,9992,1130
2020-07-11,Mexico,NA,Jalisco,7350682,139,35,10131,1165
2020-07-12,Mexico,NA,Jalisco,7350682,123,30,10254,1195
2020-07-13,Mexico,NA,Jalisco,7350682,298,33,10552,1228
2020-07-14,Mexico,NA,Jalisco,7350682,304,24,10856,1252
2020-07-15,Mexico,NA,Jalisco,7350682,270,39,11126,1291
2020-07-16,Mexico,NA,Jalisco,7350682,258,30,11384,1321
2020-07-17,Mexico,NA,Jalisco,7350682,260,18,11644,1339
2020-07-18,Mexico,NA,Jalisco,7350682,165,24,11809,1363
2020-07-19,Mexico,NA,Jalisco,7350682,101,29,11910,1392
2020-07-20,Mexico,NA,Jalisco,7350682,333,31,12243,1423
2020-07-21,Mexico,NA,Jalisco,7350682,300,34,12543,1457
2020-07-22,Mexico,NA,Jalisco,7350682,273,22,12816,1479
2020-07-23,Mexico,NA,Jalisco,7350682,222,32,13038,1511
2020-07-24,Mexico,NA,Jalisco,7350682,210,24,13248,1535
2020-07-25,Mexico,NA,Jalisco,7350682,124,29,13372,1564
2020-07-26,Mexico,NA,Jalisco,7350682,121,23,13493,1587
2020-07-27,Mexico,NA,Jalisco,7350682,310,33,13803,1620
2020-07-28,Mexico,NA,Jalisco,7350682,242,37,14045,1657
2020-07-29,Mexico,NA,Jalisco,7350682,246,18,14291,1675
2020-07-30,Mexico,NA,Jalisco,7350682,216,37,14507,1712
2020-07-31,Mexico,NA,Jalisco,7350682,188,20,14695,1732
2020-08-01,Mexico,NA,Jalisco,7350682,131,29,14826,1761
2020-08-02,Mexico,NA,Jalisco,7350682,100,23,14926,1784
2020-08-03,Mexico,NA,Jalisco,7350682,262,26,15188,1810
2020-08-04,Mexico,NA,Jalisco,7350682,240,30,15428,1840
2020-08-05,Mexico,NA,Jalisco,7350682,269,32,15697,1872
2020-08-06,Mexico,NA,Jalisco,7350682,248,34,15945,1906
2020-08-07,Mexico,NA,Jalisco,7350682,245,30,16190,1936
2020-08-08,Mexico,NA,Jalisco,7350682,126,35,16316,1971
2020-08-09,Mexico,NA,Jalisco,7350682,114,27,16430,1998
2020-08-10,Mexico,NA,Jalisco,7350682,262,18,16692,2016
2020-08-11,Mexico,NA,Jalisco,7350682,239,37,16931,2053
2020-08-12,Mexico,NA,Jalisco,7350682,239,29,17170,2082
2020-08-13,Mexico,NA,Jalisco,7350682,234,25,17404,2107
2020-08-14,Mexico,NA,Jalisco,7350682,208,26,17612,2133
2020-08-15,Mexico,NA,Jalisco,7350682,104,24,17716,2157
2020-08-16,Mexico,NA,Jalisco,7350682,112,31,17828,2188
2020-08-17,Mexico,NA,Jalisco,7350682,307,29,18135,2217
2020-08-18,Mexico,NA,Jalisco,7350682,256,19,18391,2236
2020-08-19,Mexico,NA,Jalisco,7350682,219,36,18610,2272
2020-08-20,Mexico,NA,Jalisco,7350682,229,29,18839,2301
2020-08-21,Mexico,NA,Jalisco,7350682,207,25,19046,2326
2020-08-22,Mexico,NA,Jalisco,7350682,109,31,19155,2357
2020-08-23,Mexico,NA,Jalisco,7350682,100,39,19255,2396
2020-08-24,Mexico,NA,Jalisco,7350682,269,21,19524,2417
2020-08-25,Mexico,NA,Jalisco,7350682,247,28,19771,2445
2020-08-26,Mexico,NA,Jalisco,7350682,278,31,20049,2476
2020-08-27,Mexico,NA,Jalisco,7350682,236,23,20285,2499
2020-08-28,Mexico,NA,Jalisco,7350682,242,28,20527,2527
2020-08-29,Mexico,NA,Jalisco,7350682,82,24,20609,2551
2020-08-30,Mexico,NA,Jalisco,7350682,108,23,20717,2574
2020-08-31,Mexico,NA,Jalisco,7350682,315,23,21032,2597
2020-09-01,Mexico,NA,Jalisco,7350682,246,26,21278,2623
2020-09-02,Mexico,NA,Jalisco,7350682,252,23,21530,2646
2020-09-03,Mexico,NA,Jalisco,7350682,272,24,21802,2670
2020-09-04,Mexico,NA,Jalisco,7350682,214,21,22016,2691
2020-09-05,Mexico,NA,Jalisco,7350682,95,20,22111,2711
2020-09-06,Mexico,NA,Jalisco,7350682,89,42,22200,2753
2020-09-07,Mexico,NA,Jalisco,7350682,316,22,22516,2775
2020-09-08,Mexico,NA,Jalisco,7350682,283,37,22799,2812
2020-09-09,Mexico,NA,Jalisco,7350682,265,25,23064,2837
2020-09-10,Mexico,NA,Jalisco,7350682,231,22,23295,2859
2020-09-11,Mexico,NA,Jalisco,7350682,214,24,23509,2883
2020-09-12,Mexico,NA,Jalisco,7350682,86,20,23595,2903
2020-09-13,Mexico,NA,Jalisco,7350682,101,32,23696,2935
2020-09-14,Mexico,NA,Jalisco,7350682,334,29,24030,2964
2020-09-15,Mexico,NA,Jalisco,7350682,178,18,24208,2982
2020-09-16,Mexico,NA,Jalisco,7350682,97,29,24305,3011
2020-09-17,Mexico,NA,Jalisco,7350682,301,34,24606,3045
2020-09-18,Mexico,NA,Jalisco,7350682,229,23,24835,3068
2020-09-19,Mexico,NA,Jalisco,7350682,103,31,24938,3099
2020-09-20,Mexico,NA,Jalisco,7350682,78,21,25016,3120
2020-09-21,Mexico,NA,Jalisco,7350682,289,17,25305,3137
2020-09-22,Mexico,NA,Jalisco,7350682,158,15,25463,3152
2020-09-23,Mexico,NA,Jalisco,7350682,21,6,25484,3158
2020-03-10,Mexico,NA,Mexico City,8851080,3,0,11,0
2020-03-11,Mexico,NA,Mexico City,8851080,12,0,23,0
2020-03-12,Mexico,NA,Mexico City,8851080,17,0,40,0
2020-03-13,Mexico,NA,Mexico City,8851080,24,0,64,0
2020-03-14,Mexico,NA,Mexico City,8851080,21,0,85,0
2020-03-15,Mexico,NA,Mexico City,8851080,10,0,95,0
2020-03-16,Mexico,NA,Mexico City,8851080,26,0,121,0
2020-03-17,Mexico,NA,Mexico City,8851080,34,0,155,0
2020-03-18,Mexico,NA,Mexico City,8851080,31,0,186,0
2020-03-19,Mexico,NA,Mexico City,8851080,39,0,225,0
2020-03-20,Mexico,NA,Mexico City,8851080,24,0,249,0
2020-03-21,Mexico,NA,Mexico City,8851080,12,0,261,0
2020-03-22,Mexico,NA,Mexico City,8851080,11,1,272,1
2020-03-23,Mexico,NA,Mexico City,8851080,25,1,297,2
2020-03-24,Mexico,NA,Mexico City,8851080,35,0,332,2
2020-03-25,Mexico,NA,Mexico City,8851080,25,1,357,3
2020-03-26,Mexico,NA,Mexico City,8851080,50,3,407,6
2020-03-27,Mexico,NA,Mexico City,8851080,38,4,445,10
2020-03-28,Mexico,NA,Mexico City,8851080,49,1,494,11
2020-03-29,Mexico,NA,Mexico City,8851080,35,2,529,13
2020-03-30,Mexico,NA,Mexico City,8851080,77,4,606,17
2020-03-31,Mexico,NA,Mexico City,8851080,51,7,657,24
2020-04-01,Mexico,NA,Mexico City,8851080,56,5,713,29
2020-04-02,Mexico,NA,Mexico City,8851080,72,5,785,34
2020-04-03,Mexico,NA,Mexico City,8851080,79,7,864,41
2020-04-04,Mexico,NA,Mexico City,8851080,57,6,921,47
2020-04-05,Mexico,NA,Mexico City,8851080,56,4,977,51
2020-04-06,Mexico,NA,Mexico City,8851080,118,16,1095,67
2020-04-07,Mexico,NA,Mexico City,8851080,127,11,1222,78
2020-04-08,Mexico,NA,Mexico City,8851080,125,6,1347,84
2020-04-09,Mexico,NA,Mexico City,8851080,129,17,1476,101
2020-04-10,Mexico,NA,Mexico City,8851080,147,24,1623,125
2020-04-11,Mexico,NA,Mexico City,8851080,110,22,1733,147
2020-04-12,Mexico,NA,Mexico City,8851080,114,11,1847,158
2020-04-13,Mexico,NA,Mexico City,8851080,268,14,2115,172
2020-04-14,Mexico,NA,Mexico City,8851080,248,24,2363,196
2020-04-15,Mexico,NA,Mexico City,8851080,229,22,2592,218
2020-04-16,Mexico,NA,Mexico City,8851080,251,25,2843,243
2020-04-17,Mexico,NA,Mexico City,8851080,330,18,3173,261
2020-04-18,Mexico,NA,Mexico City,8851080,197,25,3370,286
2020-04-19,Mexico,NA,Mexico City,8851080,185,30,3555,316
2020-04-20,Mexico,NA,Mexico City,8851080,446,35,4001,351
2020-04-21,Mexico,NA,Mexico City,8851080,437,40,4438,391
2020-04-22,Mexico,NA,Mexico City,8851080,401,28,4839,419
2020-04-23,Mexico,NA,Mexico City,8851080,345,37,5184,456
2020-04-24,Mexico,NA,Mexico City,8851080,513,47,5697,503
2020-04-25,Mexico,NA,Mexico City,8851080,249,62,5946,565
2020-04-26,Mexico,NA,Mexico City,8851080,221,57,6167,622
2020-04-27,Mexico,NA,Mexico City,8851080,499,49,6666,671
2020-04-28,Mexico,NA,Mexico City,8851080,538,41,7204,712
2020-04-29,Mexico,NA,Mexico City,8851080,564,64,7768,776
2020-04-30,Mexico,NA,Mexico City,8851080,536,80,8304,856
2020-05-01,Mexico,NA,Mexico City,8851080,328,71,8632,927
2020-05-02,Mexico,NA,Mexico City,8851080,321,56,8953,983
2020-05-03,Mexico,NA,Mexico City,8851080,294,69,9247,1052
2020-05-04,Mexico,NA,Mexico City,8851080,723,66,9970,1118
2020-05-05,Mexico,NA,Mexico City,8851080,591,81,10561,1199
2020-05-06,Mexico,NA,Mexico City,8851080,681,83,11242,1282
2020-05-07,Mexico,NA,Mexico City,8851080,706,70,11948,1352
2020-05-08,Mexico,NA,Mexico City,8851080,791,83,12739,1435
2020-05-09,Mexico,NA,Mexico City,8851080,393,73,13132,1508
2020-05-10,Mexico,NA,Mexico City,8851080,355,82,13487,1590
2020-05-11,Mexico,NA,Mexico City,8851080,804,75,14291,1665
2020-05-12,Mexico,NA,Mexico City,8851080,808,89,15099,1754
2020-05-13,Mexico,NA,Mexico City,8851080,878,94,15977,1848
2020-05-14,Mexico,NA,Mexico City,8851080,795,99,16772,1947
2020-05-15,Mexico,NA,Mexico City,8851080,931,101,17703,2048
2020-05-16,Mexico,NA,Mexico City,8851080,590,98,18293,2146
2020-05-17,Mexico,NA,Mexico City,8851080,360,112,18653,2258
2020-05-18,Mexico,NA,Mexico City,8851080,1065,111,19718,2369
2020-05-19,Mexico,NA,Mexico City,8851080,1010,104,20728,2473
2020-05-20,Mexico,NA,Mexico City,8851080,1034,88,21762,2561
2020-05-21,Mexico,NA,Mexico City,8851080,950,117,22712,2678
2020-05-22,Mexico,NA,Mexico City,8851080,896,96,23608,2774
2020-05-23,Mexico,NA,Mexico City,8851080,464,100,24072,2874
2020-05-24,Mexico,NA,Mexico City,8851080,334,101,24406,2975
2020-05-25,Mexico,NA,Mexico City,8851080,1018,98,25424,3073
2020-05-26,Mexico,NA,Mexico City,8851080,897,97,26321,3170
2020-05-27,Mexico,NA,Mexico City,8851080,975,88,27296,3258
2020-05-28,Mexico,NA,Mexico City,8851080,827,98,28123,3356
2020-05-29,Mexico,NA,Mexico City,8851080,911,84,29034,3440
2020-05-30,Mexico,NA,Mexico City,8851080,530,80,29564,3520
2020-05-31,Mexico,NA,Mexico City,8851080,394,110,29958,3630
2020-06-01,Mexico,NA,Mexico City,8851080,1044,100,31002,3730
2020-06-02,Mexico,NA,Mexico City,8851080,905,75,31907,3805
2020-06-03,Mexico,NA,Mexico City,8851080,966,100,32873,3905
2020-06-04,Mexico,NA,Mexico City,8851080,913,96,33786,4001
2020-06-05,Mexico,NA,Mexico City,8851080,938,93,34724,4094
2020-06-06,Mexico,NA,Mexico City,8851080,503,95,35227,4189
2020-06-07,Mexico,NA,Mexico City,8851080,376,90,35603,4279
2020-06-08,Mexico,NA,Mexico City,8851080,1000,97,36603,4376
2020-06-09,Mexico,NA,Mexico City,8851080,985,91,37588,4467
2020-06-10,Mexico,NA,Mexico City,8851080,938,94,38526,4561
2020-06-11,Mexico,NA,Mexico City,8851080,862,100,39388,4661
2020-06-12,Mexico,NA,Mexico City,8851080,911,104,40299,4765
2020-06-13,Mexico,NA,Mexico City,8851080,383,106,40682,4871
2020-06-14,Mexico,NA,Mexico City,8851080,326,88,41008,4959
2020-06-15,Mexico,NA,Mexico City,8851080,916,64,41924,5023
2020-06-16,Mexico,NA,Mexico City,8851080,971,100,42895,5123
2020-06-17,Mexico,NA,Mexico City,8851080,923,95,43818,5218
2020-06-18,Mexico,NA,Mexico City,8851080,910,85,44728,5303
2020-06-19,Mexico,NA,Mexico City,8851080,871,80,45599,5383
2020-06-20,Mexico,NA,Mexico City,8851080,426,59,46025,5442
2020-06-21,Mexico,NA,Mexico City,8851080,260,79,46285,5521
2020-06-22,Mexico,NA,Mexico City,8851080,833,60,47118,5581
2020-06-23,Mexico,NA,Mexico City,8851080,867,61,47985,5642
2020-06-24,Mexico,NA,Mexico City,8851080,793,53,48778,5695
2020-06-25,Mexico,NA,Mexico City,8851080,810,48,49588,5743
2020-06-26,Mexico,NA,Mexico City,8851080,875,64,50463,5807
2020-06-27,Mexico,NA,Mexico City,8851080,356,72,50819,5879
2020-06-28,Mexico,NA,Mexico City,8851080,290,55,51109,5934
2020-06-29,Mexico,NA,Mexico City,8851080,944,46,52053,5980
2020-06-30,Mexico,NA,Mexico City,8851080,904,63,52957,6043
2020-07-01,Mexico,NA,Mexico City,8851080,972,71,53929,6114
2020-07-02,Mexico,NA,Mexico City,8851080,854,56,54783,6170
2020-07-03,Mexico,NA,Mexico City,8851080,922,57,55705,6227
2020-07-04,Mexico,NA,Mexico City,8851080,357,65,56062,6292
2020-07-05,Mexico,NA,Mexico City,8851080,225,55,56287,6347
2020-07-06,Mexico,NA,Mexico City,8851080,967,62,57254,6409
2020-07-07,Mexico,NA,Mexico City,8851080,926,68,58180,6477
2020-07-08,Mexico,NA,Mexico City,8851080,933,44,59113,6521
2020-07-09,Mexico,NA,Mexico City,8851080,731,48,59844,6569
2020-07-10,Mexico,NA,Mexico City,8851080,839,36,60683,6605
2020-07-11,Mexico,NA,Mexico City,8851080,376,49,61059,6654
2020-07-12,Mexico,NA,Mexico City,8851080,237,58,61296,6712
2020-07-13,Mexico,NA,Mexico City,8851080,1040,43,62336,6755
2020-07-14,Mexico,NA,Mexico City,8851080,898,56,63234,6811
2020-07-15,Mexico,NA,Mexico City,8851080,1175,55,64409,6866
2020-07-16,Mexico,NA,Mexico City,8851080,1086,45,65495,6911
2020-07-17,Mexico,NA,Mexico City,8851080,1137,44,66632,6955
2020-07-18,Mexico,NA,Mexico City,8851080,633,52,67265,7007
2020-07-19,Mexico,NA,Mexico City,8851080,239,47,67504,7054
2020-07-20,Mexico,NA,Mexico City,8851080,1104,42,68608,7096
2020-07-21,Mexico,NA,Mexico City,8851080,1093,41,69701,7137
2020-07-22,Mexico,NA,Mexico City,8851080,1159,27,70860,7164
2020-07-23,Mexico,NA,Mexico City,8851080,1080,38,71940,7202
2020-07-24,Mexico,NA,Mexico City,8851080,1022,32,72962,7234
2020-07-25,Mexico,NA,Mexico City,8851080,515,45,73477,7279
2020-07-26,Mexico,NA,Mexico City,8851080,256,41,73733,7320
2020-07-27,Mexico,NA,Mexico City,8851080,1007,38,74740,7358
2020-07-28,Mexico,NA,Mexico City,8851080,1008,40,75748,7398
2020-07-29,Mexico,NA,Mexico City,8851080,1024,29,76772,7427
2020-07-30,Mexico,NA,Mexico City,8851080,999,48,77771,7475
2020-07-31,Mexico,NA,Mexico City,8851080,916,36,78687,7511
2020-08-01,Mexico,NA,Mexico City,8851080,504,32,79191,7543
2020-08-02,Mexico,NA,Mexico City,8851080,223,41,79414,7584
2020-08-03,Mexico,NA,Mexico City,8851080,836,37,80250,7621
2020-08-04,Mexico,NA,Mexico City,8851080,971,46,81221,7667
2020-08-05,Mexico,NA,Mexico City,8851080,984,47,82205,7714
2020-08-06,Mexico,NA,Mexico City,8851080,882,35,83087,7749
2020-08-07,Mexico,NA,Mexico City,8851080,944,42,84031,7791
2020-08-08,Mexico,NA,Mexico City,8851080,468,53,84499,7844
2020-08-09,Mexico,NA,Mexico City,8851080,166,23,84665,7867
2020-08-10,Mexico,NA,Mexico City,8851080,840,35,85505,7902
2020-08-11,Mexico,NA,Mexico City,8851080,975,33,86480,7935
2020-08-12,Mexico,NA,Mexico City,8851080,965,38,87445,7973
2020-08-13,Mexico,NA,Mexico City,8851080,954,36,88399,8009
2020-08-14,Mexico,NA,Mexico City,8851080,983,37,89382,8046
2020-08-15,Mexico,NA,Mexico City,8851080,465,36,89847,8082
2020-08-16,Mexico,NA,Mexico City,8851080,164,30,90011,8112
2020-08-17,Mexico,NA,Mexico City,8851080,950,33,90961,8145
2020-08-18,Mexico,NA,Mexico City,8851080,1136,40,92097,8185
2020-08-19,Mexico,NA,Mexico City,8851080,1097,39,93194,8224
2020-08-20,Mexico,NA,Mexico City,8851080,902,45,94096,8269
2020-08-21,Mexico,NA,Mexico City,8851080,1042,30,95138,8299
2020-08-22,Mexico,NA,Mexico City,8851080,458,37,95596,8336
2020-08-23,Mexico,NA,Mexico City,8851080,263,38,95859,8374
2020-08-24,Mexico,NA,Mexico City,8851080,1022,36,96881,8410
2020-08-25,Mexico,NA,Mexico City,8851080,1014,40,97895,8450
2020-08-26,Mexico,NA,Mexico City,8851080,1364,39,99259,8489
2020-08-27,Mexico,NA,Mexico City,8851080,1198,30,100457,8519
2020-08-28,Mexico,NA,Mexico City,8851080,1193,41,101650,8560
2020-08-29,Mexico,NA,Mexico City,8851080,686,36,102336,8596
2020-08-30,Mexico,NA,Mexico City,8851080,229,37,102565,8633
2020-08-31,Mexico,NA,Mexico City,8851080,967,39,103532,8672
2020-09-01,Mexico,NA,Mexico City,8851080,1365,44,104897,8716
2020-09-02,Mexico,NA,Mexico City,8851080,1379,36,106276,8752
2020-09-03,Mexico,NA,Mexico City,8851080,1270,36,107546,8788
2020-09-04,Mexico,NA,Mexico City,8851080,1183,35,108729,8823
2020-09-05,Mexico,NA,Mexico City,8851080,612,41,109341,8864
2020-09-06,Mexico,NA,Mexico City,8851080,231,41,109572,8905
2020-09-07,Mexico,NA,Mexico City,8851080,917,34,110489,8939
2020-09-08,Mexico,NA,Mexico City,8851080,1299,33,111788,8972
2020-09-09,Mexico,NA,Mexico City,8851080,1233,37,113021,9009
2020-09-10,Mexico,NA,Mexico City,8851080,1127,33,114148,9042
2020-09-11,Mexico,NA,Mexico City,8851080,1127,41,115275,9083
2020-09-12,Mexico,NA,Mexico City,8851080,677,38,115952,9121
2020-09-13,Mexico,NA,Mexico City,8851080,187,32,116139,9153
2020-09-14,Mexico,NA,Mexico City,8851080,883,27,117022,9180
2020-09-15,Mexico,NA,Mexico City,8851080,676,35,117698,9215
2020-09-16,Mexico,NA,Mexico City,8851080,158,28,117856,9243
2020-09-17,Mexico,NA,Mexico City,8851080,995,32,118851,9275
2020-09-18,Mexico,NA,Mexico City,8851080,896,32,119747,9307
2020-09-19,Mexico,NA,Mexico City,8851080,486,28,120233,9335
2020-09-20,Mexico,NA,Mexico City,8851080,167,25,120400,9360
2020-09-21,Mexico,NA,Mexico City,8851080,489,28,120889,9388
2020-09-22,Mexico,NA,Mexico City,8851080,166,27,121055,9415
2020-09-23,Mexico,NA,Mexico City,8851080,31,6,121086,9421
2020-03-23,Mexico,NA,Michoacan,4351037,3,0,12,0
2020-03-24,Mexico,NA,Michoacan,4351037,3,0,15,0
2020-03-25,Mexico,NA,Michoacan,4351037,2,0,17,0
2020-03-26,Mexico,NA,Michoacan,4351037,3,1,20,1
2020-03-27,Mexico,NA,Michoacan,4351037,1,0,21,1
2020-03-28,Mexico,NA,Michoacan,4351037,1,0,22,1
2020-03-29,Mexico,NA,Michoacan,4351037,3,0,25,1
2020-03-31,Mexico,NA,Michoacan,4351037,4,0,29,1
2020-04-01,Mexico,NA,Michoacan,4351037,4,0,33,1
2020-04-02,Mexico,NA,Michoacan,4351037,1,0,34,1
2020-04-03,Mexico,NA,Michoacan,4351037,6,2,40,3
2020-04-04,Mexico,NA,Michoacan,4351037,2,1,42,4
2020-04-05,Mexico,NA,Michoacan,4351037,2,0,44,4
2020-04-06,Mexico,NA,Michoacan,4351037,6,1,50,5
2020-04-07,Mexico,NA,Michoacan,4351037,6,0,56,5
2020-04-08,Mexico,NA,Michoacan,4351037,4,1,60,6
2020-04-09,Mexico,NA,Michoacan,4351037,9,1,69,7
2020-04-10,Mexico,NA,Michoacan,4351037,3,1,72,8
2020-04-11,Mexico,NA,Michoacan,4351037,2,1,74,9
2020-04-12,Mexico,NA,Michoacan,4351037,4,0,78,9
2020-04-13,Mexico,NA,Michoacan,4351037,13,4,91,13
2020-04-14,Mexico,NA,Michoacan,4351037,16,2,107,15
2020-04-15,Mexico,NA,Michoacan,4351037,9,1,116,16
2020-04-16,Mexico,NA,Michoacan,4351037,8,2,124,18
2020-04-17,Mexico,NA,Michoacan,4351037,14,0,138,18
2020-04-18,Mexico,NA,Michoacan,4351037,7,1,145,19
2020-04-19,Mexico,NA,Michoacan,4351037,8,2,153,21
2020-04-20,Mexico,NA,Michoacan,4351037,28,4,181,25
2020-04-21,Mexico,NA,Michoacan,4351037,12,0,193,25
2020-04-22,Mexico,NA,Michoacan,4351037,12,1,205,26
2020-04-23,Mexico,NA,Michoacan,4351037,20,3,225,29
2020-04-24,Mexico,NA,Michoacan,4351037,23,2,248,31
2020-04-25,Mexico,NA,Michoacan,4351037,27,4,275,35
2020-04-26,Mexico,NA,Michoacan,4351037,20,3,295,38
2020-04-27,Mexico,NA,Michoacan,4351037,32,1,327,39
2020-04-28,Mexico,NA,Michoacan,4351037,29,3,356,42
2020-04-29,Mexico,NA,Michoacan,4351037,23,5,379,47
2020-04-30,Mexico,NA,Michoacan,4351037,26,5,405,52
2020-05-01,Mexico,NA,Michoacan,4351037,24,2,429,54
2020-05-02,Mexico,NA,Michoacan,4351037,16,1,445,55
2020-05-03,Mexico,NA,Michoacan,4351037,27,1,472,56
2020-05-04,Mexico,NA,Michoacan,4351037,43,4,515,60
2020-05-05,Mexico,NA,Michoacan,4351037,21,5,536,65
2020-05-06,Mexico,NA,Michoacan,4351037,35,0,571,65
2020-05-07,Mexico,NA,Michoacan,4351037,29,2,600,67
2020-05-08,Mexico,NA,Michoacan,4351037,43,4,643,71
2020-05-09,Mexico,NA,Michoacan,4351037,45,4,688,75
2020-05-10,Mexico,NA,Michoacan,4351037,25,3,713,78
2020-05-11,Mexico,NA,Michoacan,4351037,69,3,782,81
2020-05-12,Mexico,NA,Michoacan,4351037,58,2,840,83
2020-05-13,Mexico,NA,Michoacan,4351037,101,6,941,89
2020-05-14,Mexico,NA,Michoacan,4351037,77,10,1018,99
2020-05-15,Mexico,NA,Michoacan,4351037,103,4,1121,103
2020-05-16,Mexico,NA,Michoacan,4351037,43,6,1164,109
2020-05-17,Mexico,NA,Michoacan,4351037,27,7,1191,116
2020-05-18,Mexico,NA,Michoacan,4351037,67,4,1258,120
2020-05-19,Mexico,NA,Michoacan,4351037,66,8,1324,128
2020-05-20,Mexico,NA,Michoacan,4351037,101,9,1425,137
2020-05-21,Mexico,NA,Michoacan,4351037,79,10,1504,147
2020-05-22,Mexico,NA,Michoacan,4351037,95,7,1599,154
2020-05-23,Mexico,NA,Michoacan,4351037,21,4,1620,158
2020-05-24,Mexico,NA,Michoacan,4351037,35,9,1655,167
2020-05-25,Mexico,NA,Michoacan,4351037,119,11,1774,178
2020-05-26,Mexico,NA,Michoacan,4351037,101,6,1875,184
2020-05-27,Mexico,NA,Michoacan,4351037,90,12,1965,196
2020-05-28,Mexico,NA,Michoacan,4351037,112,8,2077,204
2020-05-29,Mexico,NA,Michoacan,4351037,128,3,2205,207
2020-05-30,Mexico,NA,Michoacan,4351037,47,4,2252,211
2020-05-31,Mexico,NA,Michoacan,4351037,46,8,2298,219
2020-06-01,Mexico,NA,Michoacan,4351037,168,8,2466,227
2020-06-02,Mexico,NA,Michoacan,4351037,126,6,2592,233
2020-06-03,Mexico,NA,Michoacan,4351037,148,7,2740,240
2020-06-04,Mexico,NA,Michoacan,4351037,143,14,2883,254
2020-06-05,Mexico,NA,Michoacan,4351037,131,7,3014,261
2020-06-06,Mexico,NA,Michoacan,4351037,72,9,3086,270
2020-06-07,Mexico,NA,Michoacan,4351037,39,7,3125,277
2020-06-08,Mexico,NA,Michoacan,4351037,190,12,3315,289
2020-06-09,Mexico,NA,Michoacan,4351037,196,8,3511,297
2020-06-10,Mexico,NA,Michoacan,4351037,152,11,3663,308
2020-06-11,Mexico,NA,Michoacan,4351037,172,12,3835,320
2020-06-12,Mexico,NA,Michoacan,4351037,196,9,4031,329
2020-06-13,Mexico,NA,Michoacan,4351037,79,14,4110,343
2020-06-14,Mexico,NA,Michoacan,4351037,48,18,4158,361
2020-06-15,Mexico,NA,Michoacan,4351037,203,20,4361,381
2020-06-16,Mexico,NA,Michoacan,4351037,194,16,4555,397
2020-06-17,Mexico,NA,Michoacan,4351037,200,24,4755,421
2020-06-18,Mexico,NA,Michoacan,4351037,164,12,4919,433
2020-06-19,Mexico,NA,Michoacan,4351037,244,14,5163,447
2020-06-20,Mexico,NA,Michoacan,4351037,122,14,5285,461
2020-06-21,Mexico,NA,Michoacan,4351037,50,10,5335,471
2020-06-22,Mexico,NA,Michoacan,4351037,219,8,5554,479
2020-06-23,Mexico,NA,Michoacan,4351037,196,10,5750,489
2020-06-24,Mexico,NA,Michoacan,4351037,168,10,5918,499
2020-06-25,Mexico,NA,Michoacan,4351037,155,6,6073,505
2020-06-26,Mexico,NA,Michoacan,4351037,104,8,6177,513
2020-06-27,Mexico,NA,Michoacan,4351037,70,17,6247,530
2020-06-28,Mexico,NA,Michoacan,4351037,29,11,6276,541
2020-06-29,Mexico,NA,Michoacan,4351037,171,6,6447,547
2020-06-30,Mexico,NA,Michoacan,4351037,166,7,6613,554
2020-07-01,Mexico,NA,Michoacan,4351037,116,12,6729,566
2020-07-02,Mexico,NA,Michoacan,4351037,119,9,6848,575
2020-07-03,Mexico,NA,Michoacan,4351037,126,5,6974,580
2020-07-04,Mexico,NA,Michoacan,4351037,43,8,7017,588
2020-07-05,Mexico,NA,Michoacan,4351037,33,10,7050,598
2020-07-06,Mexico,NA,Michoacan,4351037,137,10,7187,608
2020-07-07,Mexico,NA,Michoacan,4351037,127,7,7314,615
2020-07-08,Mexico,NA,Michoacan,4351037,121,10,7435,625
2020-07-09,Mexico,NA,Michoacan,4351037,113,5,7548,630
2020-07-10,Mexico,NA,Michoacan,4351037,115,8,7663,638
2020-07-11,Mexico,NA,Michoacan,4351037,68,15,7731,653
2020-07-12,Mexico,NA,Michoacan,4351037,42,10,7773,663
2020-07-13,Mexico,NA,Michoacan,4351037,143,12,7916,675
2020-07-14,Mexico,NA,Michoacan,4351037,141,8,8057,683
2020-07-15,Mexico,NA,Michoacan,4351037,131,14,8188,697
2020-07-16,Mexico,NA,Michoacan,4351037,119,6,8307,703
2020-07-17,Mexico,NA,Michoacan,4351037,158,13,8465,716
2020-07-18,Mexico,NA,Michoacan,4351037,84,4,8549,720
2020-07-19,Mexico,NA,Michoacan,4351037,46,5,8595,725
2020-07-20,Mexico,NA,Michoacan,4351037,191,5,8786,730
2020-07-21,Mexico,NA,Michoacan,4351037,170,3,8956,733
2020-07-22,Mexico,NA,Michoacan,4351037,163,5,9119,738
2020-07-23,Mexico,NA,Michoacan,4351037,188,8,9307,746
2020-07-24,Mexico,NA,Michoacan,4351037,181,11,9488,757
2020-07-25,Mexico,NA,Michoacan,4351037,79,15,9567,772
2020-07-26,Mexico,NA,Michoacan,4351037,59,17,9626,789
2020-07-27,Mexico,NA,Michoacan,4351037,204,13,9830,802
2020-07-28,Mexico,NA,Michoacan,4351037,232,11,10062,813
2020-07-29,Mexico,NA,Michoacan,4351037,205,15,10267,828
2020-07-30,Mexico,NA,Michoacan,4351037,176,8,10443,836
2020-07-31,Mexico,NA,Michoacan,4351037,174,8,10617,844
2020-08-01,Mexico,NA,Michoacan,4351037,74,18,10691,862
2020-08-02,Mexico,NA,Michoacan,4351037,46,8,10737,870
2020-08-03,Mexico,NA,Michoacan,4351037,202,19,10939,889
2020-08-04,Mexico,NA,Michoacan,4351037,189,7,11128,896
2020-08-05,Mexico,NA,Michoacan,4351037,196,10,11324,906
2020-08-06,Mexico,NA,Michoacan,4351037,200,12,11524,918
2020-08-07,Mexico,NA,Michoacan,4351037,204,15,11728,933
2020-08-08,Mexico,NA,Michoacan,4351037,87,15,11815,948
2020-08-09,Mexico,NA,Michoacan,4351037,67,19,11882,967
2020-08-10,Mexico,NA,Michoacan,4351037,246,16,12128,983
2020-08-11,Mexico,NA,Michoacan,4351037,261,14,12389,997
2020-08-12,Mexico,NA,Michoacan,4351037,193,16,12582,1013
2020-08-13,Mexico,NA,Michoacan,4351037,166,9,12748,1022
2020-08-14,Mexico,NA,Michoacan,4351037,203,11,12951,1033
2020-08-15,Mexico,NA,Michoacan,4351037,81,14,13032,1047
2020-08-16,Mexico,NA,Michoacan,4351037,59,16,13091,1063
2020-08-17,Mexico,NA,Michoacan,4351037,274,20,13365,1083
2020-08-18,Mexico,NA,Michoacan,4351037,244,14,13609,1097
2020-08-19,Mexico,NA,Michoacan,4351037,217,17,13826,1114
2020-08-20,Mexico,NA,Michoacan,4351037,233,6,14059,1120
2020-08-21,Mexico,NA,Michoacan,4351037,204,16,14263,1136
2020-08-22,Mexico,NA,Michoacan,4351037,83,16,14346,1152
2020-08-23,Mexico,NA,Michoacan,4351037,68,18,14414,1170
2020-08-24,Mexico,NA,Michoacan,4351037,282,11,14696,1181
2020-08-25,Mexico,NA,Michoacan,4351037,240,13,14936,1194
2020-08-26,Mexico,NA,Michoacan,4351037,216,15,15152,1209
2020-08-27,Mexico,NA,Michoacan,4351037,213,12,15365,1221
2020-08-28,Mexico,NA,Michoacan,4351037,215,19,15580,1240
2020-08-29,Mexico,NA,Michoacan,4351037,81,19,15661,1259
2020-08-30,Mexico,NA,Michoacan,4351037,79,18,15740,1277
2020-08-31,Mexico,NA,Michoacan,4351037,282,16,16022,1293
2020-09-01,Mexico,NA,Michoacan,4351037,269,19,16291,1312
2020-09-02,Mexico,NA,Michoacan,4351037,234,13,16525,1325
2020-09-03,Mexico,NA,Michoacan,4351037,234,23,16759,1348
2020-09-04,Mexico,NA,Michoacan,4351037,199,14,16958,1362
2020-09-05,Mexico,NA,Michoacan,4351037,84,12,17042,1374
2020-09-06,Mexico,NA,Michoacan,4351037,61,18,17103,1392
2020-09-07,Mexico,NA,Michoacan,4351037,251,10,17354,1402
2020-09-08,Mexico,NA,Michoacan,4351037,246,14,17600,1416
2020-09-09,Mexico,NA,Michoacan,4351037,229,15,17829,1431
2020-09-10,Mexico,NA,Michoacan,4351037,245,18,18074,1449
2020-09-11,Mexico,NA,Michoacan,4351037,180,8,18254,1457
2020-09-12,Mexico,NA,Michoacan,4351037,70,17,18324,1474
2020-09-13,Mexico,NA,Michoacan,4351037,69,10,18393,1484
2020-09-14,Mexico,NA,Michoacan,4351037,244,22,18637,1506
2020-09-15,Mexico,NA,Michoacan,4351037,200,13,18837,1519
2020-09-16,Mexico,NA,Michoacan,4351037,84,18,18921,1537
2020-09-17,Mexico,NA,Michoacan,4351037,207,9,19128,1546
2020-09-18,Mexico,NA,Michoacan,4351037,155,7,19283,1553
2020-09-19,Mexico,NA,Michoacan,4351037,65,9,19348,1562
2020-09-20,Mexico,NA,Michoacan,4351037,26,12,19374,1574
2020-09-21,Mexico,NA,Michoacan,4351037,47,9,19421,1583
2020-09-22,Mexico,NA,Michoacan,4351037,9,6,19430,1589
2020-09-23,Mexico,NA,Michoacan,4351037,1,2,19431,1591
2020-03-24,Mexico,NA,Morelos,1777227,3,0,11,0
2020-03-28,Mexico,NA,Morelos,1777227,3,1,14,1
2020-03-29,Mexico,NA,Morelos,1777227,1,1,15,2
2020-03-30,Mexico,NA,Morelos,1777227,1,0,16,2
2020-03-31,Mexico,NA,Morelos,1777227,1,1,17,3
2020-04-01,Mexico,NA,Morelos,1777227,3,1,20,4
2020-04-02,Mexico,NA,Morelos,1777227,8,0,28,4
2020-04-03,Mexico,NA,Morelos,1777227,1,0,29,4
2020-04-04,Mexico,NA,Morelos,1777227,3,0,32,4
2020-04-05,Mexico,NA,Morelos,1777227,3,0,35,4
2020-04-06,Mexico,NA,Morelos,1777227,8,1,43,5
2020-04-07,Mexico,NA,Morelos,1777227,7,1,50,6
2020-04-08,Mexico,NA,Morelos,1777227,6,1,56,7
2020-04-09,Mexico,NA,Morelos,1777227,8,0,64,7
2020-04-10,Mexico,NA,Morelos,1777227,3,1,67,8
2020-04-11,Mexico,NA,Morelos,1777227,2,0,69,8
2020-04-12,Mexico,NA,Morelos,1777227,4,0,73,8
2020-04-13,Mexico,NA,Morelos,1777227,9,3,82,11
2020-04-14,Mexico,NA,Morelos,1777227,11,1,93,12
2020-04-15,Mexico,NA,Morelos,1777227,10,2,103,14
2020-04-16,Mexico,NA,Morelos,1777227,8,1,111,15
2020-04-17,Mexico,NA,Morelos,1777227,12,3,123,18
2020-04-18,Mexico,NA,Morelos,1777227,9,0,132,18
2020-04-19,Mexico,NA,Morelos,1777227,18,4,150,22
2020-04-20,Mexico,NA,Morelos,1777227,33,6,183,28
2020-04-21,Mexico,NA,Morelos,1777227,22,6,205,34
2020-04-22,Mexico,NA,Morelos,1777227,32,8,237,42
2020-04-23,Mexico,NA,Morelos,1777227,30,6,267,48
2020-04-24,Mexico,NA,Morelos,1777227,36,4,303,52
2020-04-25,Mexico,NA,Morelos,1777227,14,7,317,59
2020-04-26,Mexico,NA,Morelos,1777227,34,8,351,67
2020-04-27,Mexico,NA,Morelos,1777227,48,7,399,74
2020-04-28,Mexico,NA,Morelos,1777227,30,9,429,83
2020-04-29,Mexico,NA,Morelos,1777227,50,11,479,94
2020-04-30,Mexico,NA,Morelos,1777227,41,8,520,102
2020-05-01,Mexico,NA,Morelos,1777227,35,15,555,111
2020-05-02,Mexico,NA,Morelos,1777227,29,16,584,116
2020-05-03,Mexico,NA,Morelos,1777227,50,12,634,126
2020-05-04,Mexico,NA,Morelos,1777227,56,20,690,138
2020-05-05,Mexico,NA,Morelos,1777227,53,16,743,148
2020-05-06,Mexico,NA,Morelos,1777227,56,14,799,159
2020-05-07,Mexico,NA,Morelos,1777227,49,12,848,169
2020-05-08,Mexico,NA,Morelos,1777227,44,13,892,178
2020-05-09,Mexico,NA,Morelos,1777227,27,13,919,183
2020-05-10,Mexico,NA,Morelos,1777227,32,16,951,190
2020-05-11,Mexico,NA,Morelos,1777227,64,16,1015,203
2020-05-12,Mexico,NA,Morelos,1777227,58,12,1073,214
2020-05-13,Mexico,NA,Morelos,1777227,60,22,1133,226
2020-05-14,Mexico,NA,Morelos,1777227,43,10,1176,235
2020-05-15,Mexico,NA,Morelos,1777227,54,10,1230,246
2020-05-16,Mexico,NA,Morelos,1777227,28,9,1258,251
2020-05-17,Mexico,NA,Morelos,1777227,26,10,1284,256
2020-05-18,Mexico,NA,Morelos,1777227,48,15,1332,266
2020-05-19,Mexico,NA,Morelos,1777227,54,18,1386,277
2020-05-20,Mexico,NA,Morelos,1777227,49,22,1435,287
2020-05-21,Mexico,NA,Morelos,1777227,53,15,1488,297
2020-05-22,Mexico,NA,Morelos,1777227,64,9,1552,310
2020-05-23,Mexico,NA,Morelos,1777227,25,15,1577,315
2020-05-24,Mexico,NA,Morelos,1777227,21,7,1598,319
2020-05-25,Mexico,NA,Morelos,1777227,73,9,1671,334
2020-05-26,Mexico,NA,Morelos,1777227,76,10,1747,349
2020-05-27,Mexico,NA,Morelos,1777227,41,6,1788,357
2020-05-28,Mexico,NA,Morelos,1777227,61,7,1849,369
2020-05-29,Mexico,NA,Morelos,1777227,51,5,1900,380
2020-05-30,Mexico,NA,Morelos,1777227,27,7,1927,385
2020-05-31,Mexico,NA,Morelos,1777227,32,12,1959,391
2020-06-01,Mexico,NA,Morelos,1777227,63,13,2022,404
2020-06-02,Mexico,NA,Morelos,1777227,51,13,2073,414
2020-06-03,Mexico,NA,Morelos,1777227,56,6,2129,425
2020-06-04,Mexico,NA,Morelos,1777227,46,7,2175,435
2020-06-05,Mexico,NA,Morelos,1777227,58,8,2233,446
2020-06-06,Mexico,NA,Morelos,1777227,26,11,2259,451
2020-06-07,Mexico,NA,Morelos,1777227,21,9,2280,456
2020-06-08,Mexico,NA,Morelos,1777227,88,9,2368,473
2020-06-09,Mexico,NA,Morelos,1777227,56,9,2424,484
2020-06-10,Mexico,NA,Morelos,1777227,53,12,2477,495
2020-06-11,Mexico,NA,Morelos,1777227,58,9,2535,507
2020-06-12,Mexico,NA,Morelos,1777227,58,8,2593,518
2020-06-13,Mexico,NA,Morelos,1777227,38,10,2631,526
2020-06-14,Mexico,NA,Morelos,1777227,31,11,2662,532
2020-06-15,Mexico,NA,Morelos,1777227,64,7,2726,545
2020-06-16,Mexico,NA,Morelos,1777227,59,11,2785,557
2020-06-17,Mexico,NA,Morelos,1777227,47,7,2832,566
2020-06-18,Mexico,NA,Morelos,1777227,38,5,2870,574
2020-06-19,Mexico,NA,Morelos,1777227,61,9,2931,586
2020-06-20,Mexico,NA,Morelos,1777227,21,3,2952,590
2020-06-21,Mexico,NA,Morelos,1777227,17,9,2969,593
2020-06-22,Mexico,NA,Morelos,1777227,34,7,3003,600
2020-06-23,Mexico,NA,Morelos,1777227,43,9,3046,609
2020-06-24,Mexico,NA,Morelos,1777227,59,4,3105,621
2020-06-25,Mexico,NA,Morelos,1777227,29,1,3134,626
2020-06-26,Mexico,NA,Morelos,1777227,36,8,3170,634
2020-06-27,Mexico,NA,Morelos,1777227,15,3,3185,637
2020-06-28,Mexico,NA,Morelos,1777227,18,4,3203,640
2020-06-29,Mexico,NA,Morelos,1777227,53,9,3256,651
2020-06-30,Mexico,NA,Morelos,1777227,30,6,3286,657
2020-07-01,Mexico,NA,Morelos,1777227,39,8,3325,665
2020-07-02,Mexico,NA,Morelos,1777227,36,4,3361,672
2020-07-03,Mexico,NA,Morelos,1777227,35,6,3396,679
2020-07-04,Mexico,NA,Morelos,1777227,11,5,3407,681
2020-07-05,Mexico,NA,Morelos,1777227,12,4,3419,683
2020-07-06,Mexico,NA,Morelos,1777227,41,3,3460,692
2020-07-07,Mexico,NA,Morelos,1777227,38,3,3498,699
2020-07-08,Mexico,NA,Morelos,1777227,24,4,3522,704
2020-07-09,Mexico,NA,Morelos,1777227,34,4,3556,711
2020-07-10,Mexico,NA,Morelos,1777227,38,7,3594,718
2020-07-11,Mexico,NA,Morelos,1777227,14,4,3608,721
2020-07-12,Mexico,NA,Morelos,1777227,17,2,3625,725
2020-07-13,Mexico,NA,Morelos,1777227,50,7,3675,735
2020-07-14,Mexico,NA,Morelos,1777227,42,4,3717,743
2020-07-15,Mexico,NA,Morelos,1777227,38,3,3755,751
2020-07-16,Mexico,NA,Morelos,1777227,39,5,3794,758
2020-07-17,Mexico,NA,Morelos,1777227,40,4,3834,766
2020-07-18,Mexico,NA,Morelos,1777227,13,3,3847,769
2020-07-19,Mexico,NA,Morelos,1777227,15,8,3862,772
2020-07-20,Mexico,NA,Morelos,1777227,48,3,3910,782
2020-07-21,Mexico,NA,Morelos,1777227,41,5,3951,790
2020-07-22,Mexico,NA,Morelos,1777227,35,1,3986,797
2020-07-23,Mexico,NA,Morelos,1777227,39,4,4025,805
2020-07-24,Mexico,NA,Morelos,1777227,36,12,4061,812
2020-07-25,Mexico,NA,Morelos,1777227,19,4,4080,816
2020-07-26,Mexico,NA,Morelos,1777227,20,3,4100,820
2020-07-27,Mexico,NA,Morelos,1777227,50,2,4150,830
2020-07-28,Mexico,NA,Morelos,1777227,48,3,4198,839
2020-07-29,Mexico,NA,Morelos,1777227,44,2,4242,848
2020-07-30,Mexico,NA,Morelos,1777227,49,2,4291,858
2020-07-31,Mexico,NA,Morelos,1777227,47,3,4338,864
2020-08-01,Mexico,NA,Morelos,1777227,19,4,4357,868
2020-08-02,Mexico,NA,Morelos,1777227,18,3,4375,871
2020-08-03,Mexico,NA,Morelos,1777227,39,10,4414,881
2020-08-04,Mexico,NA,Morelos,1777227,50,7,4464,888
2020-08-05,Mexico,NA,Morelos,1777227,32,5,4496,893
2020-08-06,Mexico,NA,Morelos,1777227,46,9,4542,902
2020-08-07,Mexico,NA,Morelos,1777227,41,6,4583,908
2020-08-08,Mexico,NA,Morelos,1777227,15,4,4598,912
2020-08-09,Mexico,NA,Morelos,1777227,20,4,4618,916
2020-08-10,Mexico,NA,Morelos,1777227,46,5,4664,921
2020-08-11,Mexico,NA,Morelos,1777227,55,9,4719,930
2020-08-12,Mexico,NA,Morelos,1777227,45,2,4764,932
2020-08-13,Mexico,NA,Morelos,1777227,37,6,4801,938
2020-08-14,Mexico,NA,Morelos,1777227,40,4,4841,942
2020-08-15,Mexico,NA,Morelos,1777227,20,2,4861,944
2020-08-16,Mexico,NA,Morelos,1777227,8,8,4869,952
2020-08-17,Mexico,NA,Morelos,1777227,52,5,4921,957
2020-08-18,Mexico,NA,Morelos,1777227,46,5,4967,962
2020-08-19,Mexico,NA,Morelos,1777227,29,2,4996,964
2020-08-20,Mexico,NA,Morelos,1777227,42,2,5038,966
2020-08-21,Mexico,NA,Morelos,1777227,24,3,5062,969
2020-08-22,Mexico,NA,Morelos,1777227,16,3,5078,972
2020-08-23,Mexico,NA,Morelos,1777227,7,5,5085,977
2020-08-24,Mexico,NA,Morelos,1777227,48,3,5133,980
2020-08-25,Mexico,NA,Morelos,1777227,47,6,5180,986
2020-08-26,Mexico,NA,Morelos,1777227,36,6,5216,992
2020-08-27,Mexico,NA,Morelos,1777227,41,2,5257,994
2020-08-28,Mexico,NA,Morelos,1777227,37,5,5294,999
2020-08-29,Mexico,NA,Morelos,1777227,11,3,5305,1002
2020-08-30,Mexico,NA,Morelos,1777227,6,4,5311,1006
2020-08-31,Mexico,NA,Morelos,1777227,48,6,5359,1012
2020-09-01,Mexico,NA,Morelos,1777227,33,1,5392,1013
2020-09-02,Mexico,NA,Morelos,1777227,27,5,5419,1018
2020-09-03,Mexico,NA,Morelos,1777227,24,5,5443,1023
2020-09-04,Mexico,NA,Morelos,1777227,25,3,5468,1026
2020-09-05,Mexico,NA,Morelos,1777227,13,2,5481,1028
2020-09-06,Mexico,NA,Morelos,1777227,3,2,5484,1030
2020-09-07,Mexico,NA,Morelos,1777227,30,6,5514,1036
2020-09-08,Mexico,NA,Morelos,1777227,32,0,5546,1036
2020-09-09,Mexico,NA,Morelos,1777227,33,2,5579,1038
2020-09-10,Mexico,NA,Morelos,1777227,32,2,5611,1040
2020-09-11,Mexico,NA,Morelos,1777227,18,1,5629,1041
2020-09-12,Mexico,NA,Morelos,1777227,3,2,5632,1043
2020-09-13,Mexico,NA,Morelos,1777227,9,1,5641,1044
2020-09-14,Mexico,NA,Morelos,1777227,37,1,5678,1045
2020-09-15,Mexico,NA,Morelos,1777227,20,3,5698,1048
2020-09-16,Mexico,NA,Morelos,1777227,9,2,5707,1050
2020-09-17,Mexico,NA,Morelos,1777227,28,2,5735,1052
2020-09-18,Mexico,NA,Morelos,1777227,22,2,5757,1054
2020-09-19,Mexico,NA,Morelos,1777227,9,2,5766,1056
2020-09-20,Mexico,NA,Morelos,1777227,5,2,5771,1058
2020-09-21,Mexico,NA,Morelos,1777227,26,4,5797,1062
2020-09-22,Mexico,NA,Morelos,1777227,14,2,5811,1064
2020-09-23,Mexico,NA,Morelos,1777227,4,0,5815,1064
2020-04-03,Mexico,NA,Nayarit,1084979,1,0,11,1
2020-04-04,Mexico,NA,Nayarit,1084979,4,0,15,1
2020-04-05,Mexico,NA,Nayarit,1084979,2,0,17,1
2020-04-06,Mexico,NA,Nayarit,1084979,2,0,19,1
2020-04-07,Mexico,NA,Nayarit,1084979,2,0,21,1
2020-04-08,Mexico,NA,Nayarit,1084979,2,3,23,4
2020-04-09,Mexico,NA,Nayarit,1084979,2,1,25,5
2020-04-11,Mexico,NA,Nayarit,1084979,2,0,27,5
2020-04-12,Mexico,NA,Nayarit,1084979,4,1,31,6
2020-04-13,Mexico,NA,Nayarit,1084979,4,0,35,6
2020-04-14,Mexico,NA,Nayarit,1084979,2,0,37,6
2020-04-15,Mexico,NA,Nayarit,1084979,2,0,39,6
2020-04-16,Mexico,NA,Nayarit,1084979,3,0,42,6
2020-04-17,Mexico,NA,Nayarit,1084979,4,1,46,7
2020-04-18,Mexico,NA,Nayarit,1084979,3,0,49,7
2020-04-19,Mexico,NA,Nayarit,1084979,2,0,51,7
2020-04-20,Mexico,NA,Nayarit,1084979,1,2,52,9
2020-04-21,Mexico,NA,Nayarit,1084979,4,0,56,9
2020-04-22,Mexico,NA,Nayarit,1084979,4,0,60,9
2020-04-23,Mexico,NA,Nayarit,1084979,6,0,66,9
2020-04-24,Mexico,NA,Nayarit,1084979,4,0,70,9
2020-04-25,Mexico,NA,Nayarit,1084979,3,0,73,9
2020-04-26,Mexico,NA,Nayarit,1084979,6,1,79,10
2020-04-27,Mexico,NA,Nayarit,1084979,11,1,90,11
2020-04-28,Mexico,NA,Nayarit,1084979,15,0,105,11
2020-04-29,Mexico,NA,Nayarit,1084979,6,0,111,11
2020-04-30,Mexico,NA,Nayarit,1084979,13,0,124,11
2020-05-01,Mexico,NA,Nayarit,1084979,7,0,131,11
2020-05-02,Mexico,NA,Nayarit,1084979,15,1,146,12
2020-05-03,Mexico,NA,Nayarit,1084979,15,2,161,14
2020-05-04,Mexico,NA,Nayarit,1084979,16,3,177,17
2020-05-05,Mexico,NA,Nayarit,1084979,24,2,201,19
2020-05-06,Mexico,NA,Nayarit,1084979,17,0,218,19
2020-05-07,Mexico,NA,Nayarit,1084979,15,1,233,20
2020-05-08,Mexico,NA,Nayarit,1084979,6,1,239,21
2020-05-09,Mexico,NA,Nayarit,1084979,7,0,246,21
2020-05-10,Mexico,NA,Nayarit,1084979,9,2,255,23
2020-05-11,Mexico,NA,Nayarit,1084979,20,1,275,24
2020-05-12,Mexico,NA,Nayarit,1084979,18,0,293,24
2020-05-13,Mexico,NA,Nayarit,1084979,15,0,308,24
2020-05-14,Mexico,NA,Nayarit,1084979,19,4,327,28
2020-05-15,Mexico,NA,Nayarit,1084979,17,2,344,30
2020-05-16,Mexico,NA,Nayarit,1084979,3,2,347,32
2020-05-17,Mexico,NA,Nayarit,1084979,6,3,353,35
2020-05-18,Mexico,NA,Nayarit,1084979,18,2,371,37
2020-05-19,Mexico,NA,Nayarit,1084979,24,3,395,40
2020-05-20,Mexico,NA,Nayarit,1084979,18,0,413,40
2020-05-21,Mexico,NA,Nayarit,1084979,19,2,432,42
2020-05-22,Mexico,NA,Nayarit,1084979,26,1,458,43
2020-05-23,Mexico,NA,Nayarit,1084979,13,0,471,43
2020-05-24,Mexico,NA,Nayarit,1084979,8,2,479,45
2020-05-25,Mexico,NA,Nayarit,1084979,19,0,498,45
2020-05-26,Mexico,NA,Nayarit,1084979,29,3,527,48
2020-05-27,Mexico,NA,Nayarit,1084979,35,5,562,53
2020-05-28,Mexico,NA,Nayarit,1084979,33,6,595,59
2020-05-29,Mexico,NA,Nayarit,1084979,30,2,625,61
2020-05-30,Mexico,NA,Nayarit,1084979,22,6,647,67
2020-05-31,Mexico,NA,Nayarit,1084979,11,5,658,72
2020-06-01,Mexico,NA,Nayarit,1084979,23,1,681,73
2020-06-02,Mexico,NA,Nayarit,1084979,43,6,724,79
2020-06-03,Mexico,NA,Nayarit,1084979,34,3,758,82
2020-06-04,Mexico,NA,Nayarit,1084979,29,4,787,86
2020-06-05,Mexico,NA,Nayarit,1084979,38,0,825,86
2020-06-06,Mexico,NA,Nayarit,1084979,23,8,848,94
2020-06-07,Mexico,NA,Nayarit,1084979,16,4,864,98
2020-06-08,Mexico,NA,Nayarit,1084979,42,7,906,105
2020-06-09,Mexico,NA,Nayarit,1084979,40,5,946,110
2020-06-10,Mexico,NA,Nayarit,1084979,32,3,978,113
2020-06-11,Mexico,NA,Nayarit,1084979,45,4,1023,117
2020-06-12,Mexico,NA,Nayarit,1084979,57,1,1080,118
2020-06-13,Mexico,NA,Nayarit,1084979,27,1,1107,119
2020-06-14,Mexico,NA,Nayarit,1084979,21,8,1128,127
2020-06-15,Mexico,NA,Nayarit,1084979,49,4,1177,131
2020-06-16,Mexico,NA,Nayarit,1084979,35,5,1212,136
2020-06-17,Mexico,NA,Nayarit,1084979,43,7,1255,143
2020-06-18,Mexico,NA,Nayarit,1084979,46,5,1301,148
2020-06-19,Mexico,NA,Nayarit,1084979,44,9,1345,157
2020-06-20,Mexico,NA,Nayarit,1084979,31,9,1376,166
2020-06-21,Mexico,NA,Nayarit,1084979,33,9,1409,175
2020-06-22,Mexico,NA,Nayarit,1084979,77,3,1486,178
2020-06-23,Mexico,NA,Nayarit,1084979,49,6,1535,184
2020-06-24,Mexico,NA,Nayarit,1084979,48,5,1583,189
2020-06-25,Mexico,NA,Nayarit,1084979,43,8,1626,197
2020-06-26,Mexico,NA,Nayarit,1084979,49,1,1675,198
2020-06-27,Mexico,NA,Nayarit,1084979,44,6,1719,204
2020-06-28,Mexico,NA,Nayarit,1084979,24,8,1743,212
2020-06-29,Mexico,NA,Nayarit,1084979,59,7,1802,219
2020-06-30,Mexico,NA,Nayarit,1084979,60,4,1862,223
2020-07-01,Mexico,NA,Nayarit,1084979,61,1,1923,224
2020-07-02,Mexico,NA,Nayarit,1084979,53,1,1976,225
2020-07-03,Mexico,NA,Nayarit,1084979,60,4,2036,229
2020-07-04,Mexico,NA,Nayarit,1084979,42,3,2078,232
2020-07-05,Mexico,NA,Nayarit,1084979,19,7,2097,239
2020-07-06,Mexico,NA,Nayarit,1084979,77,7,2174,246
2020-07-07,Mexico,NA,Nayarit,1084979,63,6,2237,252
2020-07-08,Mexico,NA,Nayarit,1084979,43,5,2280,257
2020-07-09,Mexico,NA,Nayarit,1084979,60,8,2340,265
2020-07-10,Mexico,NA,Nayarit,1084979,79,4,2419,269
2020-07-11,Mexico,NA,Nayarit,1084979,42,5,2461,274
2020-07-12,Mexico,NA,Nayarit,1084979,32,6,2493,280
2020-07-13,Mexico,NA,Nayarit,1084979,74,8,2567,288
2020-07-14,Mexico,NA,Nayarit,1084979,52,6,2619,294
2020-07-15,Mexico,NA,Nayarit,1084979,63,4,2682,298
2020-07-16,Mexico,NA,Nayarit,1084979,67,5,2749,303
2020-07-17,Mexico,NA,Nayarit,1084979,61,6,2810,309
2020-07-18,Mexico,NA,Nayarit,1084979,51,4,2861,313
2020-07-19,Mexico,NA,Nayarit,1084979,39,13,2900,326
2020-07-20,Mexico,NA,Nayarit,1084979,75,5,2975,331
2020-07-21,Mexico,NA,Nayarit,1084979,73,9,3048,340
2020-07-22,Mexico,NA,Nayarit,1084979,85,7,3133,347
2020-07-23,Mexico,NA,Nayarit,1084979,65,10,3198,357
2020-07-24,Mexico,NA,Nayarit,1084979,82,1,3280,358
2020-07-25,Mexico,NA,Nayarit,1084979,33,9,3313,367
2020-07-26,Mexico,NA,Nayarit,1084979,32,8,3345,375
2020-07-27,Mexico,NA,Nayarit,1084979,78,7,3423,382
2020-07-28,Mexico,NA,Nayarit,1084979,61,9,3484,391
2020-07-29,Mexico,NA,Nayarit,1084979,50,10,3534,401
2020-07-30,Mexico,NA,Nayarit,1084979,55,6,3589,407
2020-07-31,Mexico,NA,Nayarit,1084979,63,3,3652,410
2020-08-01,Mexico,NA,Nayarit,1084979,37,7,3689,417
2020-08-02,Mexico,NA,Nayarit,1084979,30,11,3719,428
2020-08-03,Mexico,NA,Nayarit,1084979,67,6,3786,434
2020-08-04,Mexico,NA,Nayarit,1084979,68,6,3854,440
2020-08-05,Mexico,NA,Nayarit,1084979,57,7,3911,447
2020-08-06,Mexico,NA,Nayarit,1084979,54,7,3965,454
2020-08-07,Mexico,NA,Nayarit,1084979,50,3,4015,457
2020-08-08,Mexico,NA,Nayarit,1084979,45,7,4060,464
2020-08-09,Mexico,NA,Nayarit,1084979,37,7,4097,471
2020-08-10,Mexico,NA,Nayarit,1084979,67,6,4164,477
2020-08-11,Mexico,NA,Nayarit,1084979,52,3,4216,480
2020-08-12,Mexico,NA,Nayarit,1084979,72,2,4288,482
2020-08-13,Mexico,NA,Nayarit,1084979,68,6,4356,488
2020-08-14,Mexico,NA,Nayarit,1084979,53,9,4409,497
2020-08-15,Mexico,NA,Nayarit,1084979,39,11,4448,508
2020-08-16,Mexico,NA,Nayarit,1084979,25,3,4473,511
2020-08-17,Mexico,NA,Nayarit,1084979,50,9,4523,520
2020-08-18,Mexico,NA,Nayarit,1084979,55,8,4578,528
2020-08-19,Mexico,NA,Nayarit,1084979,52,6,4630,534
2020-08-20,Mexico,NA,Nayarit,1084979,34,15,4664,549
2020-08-21,Mexico,NA,Nayarit,1084979,44,4,4708,553
2020-08-22,Mexico,NA,Nayarit,1084979,33,7,4741,560
2020-08-23,Mexico,NA,Nayarit,1084979,22,3,4763,563
2020-08-24,Mexico,NA,Nayarit,1084979,85,5,4848,568
2020-08-25,Mexico,NA,Nayarit,1084979,50,8,4898,576
2020-08-26,Mexico,NA,Nayarit,1084979,54,7,4952,583
2020-08-27,Mexico,NA,Nayarit,1084979,39,8,4991,591
2020-08-28,Mexico,NA,Nayarit,1084979,30,3,5021,594
2020-08-29,Mexico,NA,Nayarit,1084979,21,6,5042,600
2020-08-30,Mexico,NA,Nayarit,1084979,26,12,5068,612
2020-08-31,Mexico,NA,Nayarit,1084979,46,4,5114,616
2020-09-01,Mexico,NA,Nayarit,1084979,54,4,5168,620
2020-09-02,Mexico,NA,Nayarit,1084979,36,4,5204,624
2020-09-03,Mexico,NA,Nayarit,1084979,47,6,5251,630
2020-09-04,Mexico,NA,Nayarit,1084979,30,8,5281,638
2020-09-05,Mexico,NA,Nayarit,1084979,20,6,5301,644
2020-09-06,Mexico,NA,Nayarit,1084979,20,2,5321,646
2020-09-07,Mexico,NA,Nayarit,1084979,55,8,5376,654
2020-09-08,Mexico,NA,Nayarit,1084979,38,6,5414,660
2020-09-09,Mexico,NA,Nayarit,1084979,39,5,5453,665
2020-09-10,Mexico,NA,Nayarit,1084979,32,1,5485,666
2020-09-11,Mexico,NA,Nayarit,1084979,26,6,5511,672
2020-09-12,Mexico,NA,Nayarit,1084979,10,5,5521,677
2020-09-13,Mexico,NA,Nayarit,1084979,30,2,5551,679
2020-09-14,Mexico,NA,Nayarit,1084979,45,8,5596,687
2020-09-15,Mexico,NA,Nayarit,1084979,20,8,5616,695
2020-09-16,Mexico,NA,Nayarit,1084979,18,3,5634,698
2020-09-17,Mexico,NA,Nayarit,1084979,47,5,5681,703
2020-09-18,Mexico,NA,Nayarit,1084979,39,1,5720,704
2020-09-19,Mexico,NA,Nayarit,1084979,25,4,5745,708
2020-09-20,Mexico,NA,Nayarit,1084979,19,5,5764,713
2020-09-21,Mexico,NA,Nayarit,1084979,33,6,5797,719
2020-09-22,Mexico,NA,Nayarit,1084979,13,4,5810,723
2020-09-23,Mexico,NA,Nayarit,1084979,3,1,5813,724
2020-03-13,Mexico,NA,Nuevo Leon,4653458,5,0,12,0
2020-03-14,Mexico,NA,Nuevo Leon,4653458,6,0,18,0
2020-03-16,Mexico,NA,Nuevo Leon,4653458,6,0,24,0
2020-03-17,Mexico,NA,Nuevo Leon,4653458,6,0,30,0
2020-03-18,Mexico,NA,Nuevo Leon,4653458,9,0,39,0
2020-03-19,Mexico,NA,Nuevo Leon,4653458,4,0,43,0
2020-03-20,Mexico,NA,Nuevo Leon,4653458,12,0,55,0
2020-03-21,Mexico,NA,Nuevo Leon,4653458,4,0,59,0
2020-03-22,Mexico,NA,Nuevo Leon,4653458,4,0,63,0
2020-03-23,Mexico,NA,Nuevo Leon,4653458,5,0,68,0
2020-03-24,Mexico,NA,Nuevo Leon,4653458,5,0,73,0
2020-03-26,Mexico,NA,Nuevo Leon,4653458,1,0,74,0
2020-03-27,Mexico,NA,Nuevo Leon,4653458,8,0,82,0
2020-03-28,Mexico,NA,Nuevo Leon,4653458,2,0,84,0
2020-03-29,Mexico,NA,Nuevo Leon,4653458,3,0,87,0
2020-03-30,Mexico,NA,Nuevo Leon,4653458,4,0,91,0
2020-04-02,Mexico,NA,Nuevo Leon,4653458,6,0,97,0
2020-04-03,Mexico,NA,Nuevo Leon,4653458,2,2,99,2
2020-04-04,Mexico,NA,Nuevo Leon,4653458,3,0,102,2
2020-04-05,Mexico,NA,Nuevo Leon,4653458,1,1,103,3
2020-04-06,Mexico,NA,Nuevo Leon,4653458,10,0,113,3
2020-04-07,Mexico,NA,Nuevo Leon,4653458,7,2,120,5
2020-04-08,Mexico,NA,Nuevo Leon,4653458,9,0,129,5
2020-04-09,Mexico,NA,Nuevo Leon,4653458,1,0,130,5
2020-04-10,Mexico,NA,Nuevo Leon,4653458,22,0,152,5
2020-04-11,Mexico,NA,Nuevo Leon,4653458,8,0,160,5
2020-04-12,Mexico,NA,Nuevo Leon,4653458,15,0,175,5
2020-04-13,Mexico,NA,Nuevo Leon,4653458,20,1,195,6
2020-04-14,Mexico,NA,Nuevo Leon,4653458,18,0,213,6
2020-04-15,Mexico,NA,Nuevo Leon,4653458,6,0,219,6
2020-04-16,Mexico,NA,Nuevo Leon,4653458,12,1,231,7
2020-04-17,Mexico,NA,Nuevo Leon,4653458,9,0,240,7
2020-04-18,Mexico,NA,Nuevo Leon,4653458,6,0,246,7
2020-04-19,Mexico,NA,Nuevo Leon,4653458,2,1,248,8
2020-04-20,Mexico,NA,Nuevo Leon,4653458,12,1,260,9
2020-04-21,Mexico,NA,Nuevo Leon,4653458,17,0,277,9
2020-04-22,Mexico,NA,Nuevo Leon,4653458,17,2,294,11
2020-04-23,Mexico,NA,Nuevo Leon,4653458,6,1,300,12
2020-04-24,Mexico,NA,Nuevo Leon,4653458,6,1,306,13
2020-04-25,Mexico,NA,Nuevo Leon,4653458,6,1,312,14
2020-04-26,Mexico,NA,Nuevo Leon,4653458,8,1,320,15
2020-04-27,Mexico,NA,Nuevo Leon,4653458,20,2,340,17
2020-04-28,Mexico,NA,Nuevo Leon,4653458,28,2,368,19
2020-04-29,Mexico,NA,Nuevo Leon,4653458,22,2,390,21
2020-04-30,Mexico,NA,Nuevo Leon,4653458,28,1,418,22
2020-05-01,Mexico,NA,Nuevo Leon,4653458,27,2,445,24
2020-05-02,Mexico,NA,Nuevo Leon,4653458,22,3,467,27
2020-05-03,Mexico,NA,Nuevo Leon,4653458,9,2,476,29
2020-05-04,Mexico,NA,Nuevo Leon,4653458,40,2,516,31
2020-05-05,Mexico,NA,Nuevo Leon,4653458,63,3,579,34
2020-05-06,Mexico,NA,Nuevo Leon,4653458,26,2,605,36
2020-05-07,Mexico,NA,Nuevo Leon,4653458,24,2,629,38
2020-05-08,Mexico,NA,Nuevo Leon,4653458,31,0,660,38
2020-05-09,Mexico,NA,Nuevo Leon,4653458,27,3,687,41
2020-05-10,Mexico,NA,Nuevo Leon,4653458,21,3,708,44
2020-05-11,Mexico,NA,Nuevo Leon,4653458,42,3,750,47
2020-05-12,Mexico,NA,Nuevo Leon,4653458,36,4,786,51
2020-05-13,Mexico,NA,Nuevo Leon,4653458,68,4,854,55
2020-05-14,Mexico,NA,Nuevo Leon,4653458,38,3,892,58
2020-05-15,Mexico,NA,Nuevo Leon,4653458,76,4,968,62
2020-05-16,Mexico,NA,Nuevo Leon,4653458,30,3,998,65
2020-05-17,Mexico,NA,Nuevo Leon,4653458,11,3,1009,68
2020-05-18,Mexico,NA,Nuevo Leon,4653458,47,4,1056,72
2020-05-19,Mexico,NA,Nuevo Leon,4653458,39,5,1095,77
2020-05-20,Mexico,NA,Nuevo Leon,4653458,61,6,1156,83
2020-05-21,Mexico,NA,Nuevo Leon,4653458,35,3,1191,86
2020-05-22,Mexico,NA,Nuevo Leon,4653458,50,3,1241,89
2020-05-23,Mexico,NA,Nuevo Leon,4653458,35,2,1276,91
2020-05-24,Mexico,NA,Nuevo Leon,4653458,26,1,1302,92
2020-05-25,Mexico,NA,Nuevo Leon,4653458,81,9,1383,101
2020-05-26,Mexico,NA,Nuevo Leon,4653458,118,5,1501,106
2020-05-27,Mexico,NA,Nuevo Leon,4653458,69,4,1570,110
2020-05-28,Mexico,NA,Nuevo Leon,4653458,63,4,1633,114
2020-05-29,Mexico,NA,Nuevo Leon,4653458,68,6,1701,120
2020-05-30,Mexico,NA,Nuevo Leon,4653458,42,3,1743,123
2020-05-31,Mexico,NA,Nuevo Leon,4653458,21,2,1764,125
2020-06-01,Mexico,NA,Nuevo Leon,4653458,84,4,1848,129
2020-06-02,Mexico,NA,Nuevo Leon,4653458,94,2,1942,131
2020-06-03,Mexico,NA,Nuevo Leon,4653458,75,8,2017,139
2020-06-04,Mexico,NA,Nuevo Leon,4653458,131,10,2148,149
2020-06-05,Mexico,NA,Nuevo Leon,4653458,147,3,2295,152
2020-06-06,Mexico,NA,Nuevo Leon,4653458,77,7,2372,159
2020-06-07,Mexico,NA,Nuevo Leon,4653458,43,3,2415,162
2020-06-08,Mexico,NA,Nuevo Leon,4653458,203,5,2618,167
2020-06-09,Mexico,NA,Nuevo Leon,4653458,154,6,2772,173
2020-06-10,Mexico,NA,Nuevo Leon,4653458,222,7,2994,180
2020-06-11,Mexico,NA,Nuevo Leon,4653458,199,5,3193,185
2020-06-12,Mexico,NA,Nuevo Leon,4653458,244,10,3437,195
2020-06-13,Mexico,NA,Nuevo Leon,4653458,165,10,3602,205
2020-06-14,Mexico,NA,Nuevo Leon,4653458,104,6,3706,211
2020-06-15,Mexico,NA,Nuevo Leon,4653458,276,13,3982,224
2020-06-16,Mexico,NA,Nuevo Leon,4653458,215,11,4197,235
2020-06-17,Mexico,NA,Nuevo Leon,4653458,179,11,4376,246
2020-06-18,Mexico,NA,Nuevo Leon,4653458,230,11,4606,257
2020-06-19,Mexico,NA,Nuevo Leon,4653458,212,10,4818,267
2020-06-20,Mexico,NA,Nuevo Leon,4653458,173,7,4991,274
2020-06-21,Mexico,NA,Nuevo Leon,4653458,103,14,5094,288
2020-06-22,Mexico,NA,Nuevo Leon,4653458,295,13,5389,301
2020-06-23,Mexico,NA,Nuevo Leon,4653458,310,11,5699,312
2020-06-24,Mexico,NA,Nuevo Leon,4653458,306,11,6005,323
2020-06-25,Mexico,NA,Nuevo Leon,4653458,315,10,6320,333
2020-06-26,Mexico,NA,Nuevo Leon,4653458,326,21,6646,354
2020-06-27,Mexico,NA,Nuevo Leon,4653458,209,13,6855,367
2020-06-28,Mexico,NA,Nuevo Leon,4653458,175,14,7030,381
2020-06-29,Mexico,NA,Nuevo Leon,4653458,405,16,7435,397
2020-06-30,Mexico,NA,Nuevo Leon,4653458,373,23,7808,420
2020-07-01,Mexico,NA,Nuevo Leon,4653458,431,20,8239,440
2020-07-02,Mexico,NA,Nuevo Leon,4653458,342,28,8581,468
2020-07-03,Mexico,NA,Nuevo Leon,4653458,346,23,8927,491
2020-07-04,Mexico,NA,Nuevo Leon,4653458,229,19,9156,510
2020-07-05,Mexico,NA,Nuevo Leon,4653458,195,28,9351,538
2020-07-06,Mexico,NA,Nuevo Leon,4653458,532,27,9883,565
2020-07-07,Mexico,NA,Nuevo Leon,4653458,491,24,10374,589
2020-07-08,Mexico,NA,Nuevo Leon,4653458,454,24,10828,613
2020-07-09,Mexico,NA,Nuevo Leon,4653458,495,27,11323,640
2020-07-10,Mexico,NA,Nuevo Leon,4653458,460,17,11783,657
2020-07-11,Mexico,NA,Nuevo Leon,4653458,318,23,12101,680
2020-07-12,Mexico,NA,Nuevo Leon,4653458,239,26,12340,706
2020-07-13,Mexico,NA,Nuevo Leon,4653458,572,33,12912,739
2020-07-14,Mexico,NA,Nuevo Leon,4653458,576,30,13488,769
2020-07-15,Mexico,NA,Nuevo Leon,4653458,578,40,14066,809
2020-07-16,Mexico,NA,Nuevo Leon,4653458,560,30,14626,839
2020-07-17,Mexico,NA,Nuevo Leon,4653458,516,29,15142,868
2020-07-18,Mexico,NA,Nuevo Leon,4653458,246,37,15388,905
2020-07-19,Mexico,NA,Nuevo Leon,4653458,190,33,15578,938
2020-07-20,Mexico,NA,Nuevo Leon,4653458,565,29,16143,967
2020-07-21,Mexico,NA,Nuevo Leon,4653458,579,36,16722,1003
2020-07-22,Mexico,NA,Nuevo Leon,4653458,520,42,17242,1045
2020-07-23,Mexico,NA,Nuevo Leon,4653458,603,37,17845,1082
2020-07-24,Mexico,NA,Nuevo Leon,4653458,542,40,18387,1122
2020-07-25,Mexico,NA,Nuevo Leon,4653458,269,29,18656,1151
2020-07-26,Mexico,NA,Nuevo Leon,4653458,133,36,18789,1187
2020-07-27,Mexico,NA,Nuevo Leon,4653458,214,46,19003,1233
2020-07-28,Mexico,NA,Nuevo Leon,4653458,361,48,19364,1281
2020-07-29,Mexico,NA,Nuevo Leon,4653458,294,29,19658,1310
2020-07-30,Mexico,NA,Nuevo Leon,4653458,348,31,20006,1341
2020-07-31,Mexico,NA,Nuevo Leon,4653458,330,31,20336,1372
2020-08-01,Mexico,NA,Nuevo Leon,4653458,123,33,20459,1405
2020-08-02,Mexico,NA,Nuevo Leon,4653458,106,36,20565,1441
2020-08-03,Mexico,NA,Nuevo Leon,4653458,365,31,20930,1472
2020-08-04,Mexico,NA,Nuevo Leon,4653458,396,37,21326,1509
2020-08-05,Mexico,NA,Nuevo Leon,4653458,367,40,21693,1549
2020-08-06,Mexico,NA,Nuevo Leon,4653458,358,43,22051,1592
2020-08-07,Mexico,NA,Nuevo Leon,4653458,394,46,22445,1638
2020-08-08,Mexico,NA,Nuevo Leon,4653458,204,27,22649,1665
2020-08-09,Mexico,NA,Nuevo Leon,4653458,155,45,22804,1710
2020-08-10,Mexico,NA,Nuevo Leon,4653458,374,33,23178,1743
2020-08-11,Mexico,NA,Nuevo Leon,4653458,366,32,23544,1775
2020-08-12,Mexico,NA,Nuevo Leon,4653458,362,33,23906,1808
2020-08-13,Mexico,NA,Nuevo Leon,4653458,402,41,24308,1849
2020-08-14,Mexico,NA,Nuevo Leon,4653458,343,27,24651,1876
2020-08-15,Mexico,NA,Nuevo Leon,4653458,195,31,24846,1907
2020-08-16,Mexico,NA,Nuevo Leon,4653458,152,39,24998,1946
2020-08-17,Mexico,NA,Nuevo Leon,4653458,423,35,25421,1981
2020-08-18,Mexico,NA,Nuevo Leon,4653458,379,24,25800,2005
2020-08-19,Mexico,NA,Nuevo Leon,4653458,408,31,26208,2036
2020-08-20,Mexico,NA,Nuevo Leon,4653458,383,38,26591,2074
2020-08-21,Mexico,NA,Nuevo Leon,4653458,324,32,26915,2106
2020-08-22,Mexico,NA,Nuevo Leon,4653458,220,34,27135,2140
2020-08-23,Mexico,NA,Nuevo Leon,4653458,143,24,27278,2164
2020-08-24,Mexico,NA,Nuevo Leon,4653458,401,28,27679,2192
2020-08-25,Mexico,NA,Nuevo Leon,4653458,512,22,28191,2214
2020-08-26,Mexico,NA,Nuevo Leon,4653458,527,27,28718,2241
2020-08-27,Mexico,NA,Nuevo Leon,4653458,480,22,29198,2263
2020-08-28,Mexico,NA,Nuevo Leon,4653458,515,25,29713,2288
2020-08-29,Mexico,NA,Nuevo Leon,4653458,213,28,29926,2316
2020-08-30,Mexico,NA,Nuevo Leon,4653458,142,31,30068,2347
2020-08-31,Mexico,NA,Nuevo Leon,4653458,390,32,30458,2379
2020-09-01,Mexico,NA,Nuevo Leon,4653458,436,26,30894,2405
2020-09-02,Mexico,NA,Nuevo Leon,4653458,449,26,31343,2431
2020-09-03,Mexico,NA,Nuevo Leon,4653458,457,30,31800,2461
2020-09-04,Mexico,NA,Nuevo Leon,4653458,428,31,32228,2492
2020-09-05,Mexico,NA,Nuevo Leon,4653458,135,23,32363,2515
2020-09-06,Mexico,NA,Nuevo Leon,4653458,121,18,32484,2533
2020-09-07,Mexico,NA,Nuevo Leon,4653458,389,23,32873,2556
2020-09-08,Mexico,NA,Nuevo Leon,4653458,485,31,33358,2587
2020-09-09,Mexico,NA,Nuevo Leon,4653458,467,22,33825,2609
2020-09-10,Mexico,NA,Nuevo Leon,4653458,325,30,34150,2639
2020-09-11,Mexico,NA,Nuevo Leon,4653458,334,21,34484,2660
2020-09-12,Mexico,NA,Nuevo Leon,4653458,162,26,34646,2686
2020-09-13,Mexico,NA,Nuevo Leon,4653458,108,27,34754,2713
2020-09-14,Mexico,NA,Nuevo Leon,4653458,452,28,35206,2741
2020-09-15,Mexico,NA,Nuevo Leon,4653458,273,24,35479,2765
2020-09-16,Mexico,NA,Nuevo Leon,4653458,174,17,35653,2782
2020-09-17,Mexico,NA,Nuevo Leon,4653458,482,27,36135,2809
2020-09-18,Mexico,NA,Nuevo Leon,4653458,477,20,36612,2829
2020-09-19,Mexico,NA,Nuevo Leon,4653458,191,21,36803,2850
2020-09-20,Mexico,NA,Nuevo Leon,4653458,107,20,36910,2870
2020-09-21,Mexico,NA,Nuevo Leon,4653458,177,26,37087,2896
2020-09-22,Mexico,NA,Nuevo Leon,4653458,13,13,37100,2909
2020-09-23,Mexico,NA,Nuevo Leon,4653458,32,5,37132,2914
2020-03-25,Mexico,NA,Oaxaca,3801962,3,0,12,0
2020-03-26,Mexico,NA,Oaxaca,3801962,3,0,15,0
2020-03-27,Mexico,NA,Oaxaca,3801962,1,0,16,0
2020-03-28,Mexico,NA,Oaxaca,3801962,1,0,17,0
2020-03-29,Mexico,NA,Oaxaca,3801962,2,1,19,1
2020-03-30,Mexico,NA,Oaxaca,3801962,2,0,21,1
2020-03-31,Mexico,NA,Oaxaca,3801962,6,0,27,1
2020-04-01,Mexico,NA,Oaxaca,3801962,1,0,28,1
2020-04-03,Mexico,NA,Oaxaca,3801962,3,0,31,1
2020-04-04,Mexico,NA,Oaxaca,3801962,2,0,33,1
2020-04-05,Mexico,NA,Oaxaca,3801962,2,0,35,1
2020-04-06,Mexico,NA,Oaxaca,3801962,5,0,40,1
2020-04-08,Mexico,NA,Oaxaca,3801962,5,0,45,1
2020-04-09,Mexico,NA,Oaxaca,3801962,1,1,46,2
2020-04-10,Mexico,NA,Oaxaca,3801962,2,0,48,2
2020-04-11,Mexico,NA,Oaxaca,3801962,2,1,50,3
2020-04-12,Mexico,NA,Oaxaca,3801962,2,0,52,3
2020-04-13,Mexico,NA,Oaxaca,3801962,5,0,57,3
2020-04-14,Mexico,NA,Oaxaca,3801962,4,1,61,4
2020-04-15,Mexico,NA,Oaxaca,3801962,7,0,68,4
2020-04-16,Mexico,NA,Oaxaca,3801962,5,1,73,5
2020-04-17,Mexico,NA,Oaxaca,3801962,8,1,81,6
2020-04-18,Mexico,NA,Oaxaca,3801962,6,0,87,6
2020-04-19,Mexico,NA,Oaxaca,3801962,3,1,90,7
2020-04-20,Mexico,NA,Oaxaca,3801962,6,1,96,8
2020-04-21,Mexico,NA,Oaxaca,3801962,4,1,100,9
2020-04-22,Mexico,NA,Oaxaca,3801962,9,1,109,10
2020-04-23,Mexico,NA,Oaxaca,3801962,8,4,117,14
2020-04-24,Mexico,NA,Oaxaca,3801962,15,1,132,15
2020-04-25,Mexico,NA,Oaxaca,3801962,7,0,139,15
2020-04-26,Mexico,NA,Oaxaca,3801962,13,1,152,16
2020-04-27,Mexico,NA,Oaxaca,3801962,9,3,161,19
2020-04-28,Mexico,NA,Oaxaca,3801962,18,0,179,19
2020-04-29,Mexico,NA,Oaxaca,3801962,12,1,191,20
2020-04-30,Mexico,NA,Oaxaca,3801962,12,4,203,24
2020-05-01,Mexico,NA,Oaxaca,3801962,15,1,218,25
2020-05-02,Mexico,NA,Oaxaca,3801962,9,1,227,26
2020-05-03,Mexico,NA,Oaxaca,3801962,14,2,241,28
2020-05-04,Mexico,NA,Oaxaca,3801962,25,4,266,32
2020-05-05,Mexico,NA,Oaxaca,3801962,34,3,300,35
2020-05-06,Mexico,NA,Oaxaca,3801962,24,4,324,39
2020-05-07,Mexico,NA,Oaxaca,3801962,24,4,348,43
2020-05-08,Mexico,NA,Oaxaca,3801962,23,5,371,48
2020-05-09,Mexico,NA,Oaxaca,3801962,15,4,386,52
2020-05-10,Mexico,NA,Oaxaca,3801962,28,2,414,54
2020-05-11,Mexico,NA,Oaxaca,3801962,54,4,468,58
2020-05-12,Mexico,NA,Oaxaca,3801962,66,5,534,63
2020-05-13,Mexico,NA,Oaxaca,3801962,69,6,603,69
2020-05-14,Mexico,NA,Oaxaca,3801962,66,7,669,76
2020-05-15,Mexico,NA,Oaxaca,3801962,78,8,747,84
2020-05-16,Mexico,NA,Oaxaca,3801962,65,3,812,87
2020-05-17,Mexico,NA,Oaxaca,3801962,17,7,829,94
2020-05-18,Mexico,NA,Oaxaca,3801962,122,7,951,101
2020-05-19,Mexico,NA,Oaxaca,3801962,74,12,1025,113
2020-05-20,Mexico,NA,Oaxaca,3801962,76,5,1101,118
2020-05-21,Mexico,NA,Oaxaca,3801962,103,3,1204,121
2020-05-22,Mexico,NA,Oaxaca,3801962,83,8,1287,129
2020-05-23,Mexico,NA,Oaxaca,3801962,83,9,1370,138
2020-05-24,Mexico,NA,Oaxaca,3801962,37,14,1407,152
2020-05-25,Mexico,NA,Oaxaca,3801962,104,12,1511,164
2020-05-26,Mexico,NA,Oaxaca,3801962,80,8,1591,172
2020-05-27,Mexico,NA,Oaxaca,3801962,92,11,1683,183
2020-05-28,Mexico,NA,Oaxaca,3801962,128,9,1811,192
2020-05-29,Mexico,NA,Oaxaca,3801962,121,13,1932,205
2020-05-30,Mexico,NA,Oaxaca,3801962,114,16,2046,221
2020-05-31,Mexico,NA,Oaxaca,3801962,48,16,2094,237
2020-06-01,Mexico,NA,Oaxaca,3801962,152,14,2246,251
2020-06-02,Mexico,NA,Oaxaca,3801962,155,13,2401,264
2020-06-03,Mexico,NA,Oaxaca,3801962,146,6,2547,270
2020-06-04,Mexico,NA,Oaxaca,3801962,191,14,2738,284
2020-06-05,Mexico,NA,Oaxaca,3801962,176,5,2914,289
2020-06-06,Mexico,NA,Oaxaca,3801962,145,14,3059,303
2020-06-07,Mexico,NA,Oaxaca,3801962,55,17,3114,320
2020-06-08,Mexico,NA,Oaxaca,3801962,183,17,3297,337
2020-06-09,Mexico,NA,Oaxaca,3801962,160,24,3457,361
2020-06-10,Mexico,NA,Oaxaca,3801962,172,22,3629,383
2020-06-11,Mexico,NA,Oaxaca,3801962,156,12,3785,395
2020-06-12,Mexico,NA,Oaxaca,3801962,150,18,3935,413
2020-06-13,Mexico,NA,Oaxaca,3801962,160,26,4095,439
2020-06-14,Mexico,NA,Oaxaca,3801962,72,12,4167,451
2020-06-15,Mexico,NA,Oaxaca,3801962,199,17,4366,468
2020-06-16,Mexico,NA,Oaxaca,3801962,154,21,4520,489
2020-06-17,Mexico,NA,Oaxaca,3801962,190,21,4710,510
2020-06-18,Mexico,NA,Oaxaca,3801962,169,12,4879,522
2020-06-19,Mexico,NA,Oaxaca,3801962,165,10,5044,532
2020-06-20,Mexico,NA,Oaxaca,3801962,135,6,5179,538
2020-06-21,Mexico,NA,Oaxaca,3801962,45,16,5224,554
2020-06-22,Mexico,NA,Oaxaca,3801962,209,19,5433,573
2020-06-23,Mexico,NA,Oaxaca,3801962,183,21,5616,594
2020-06-24,Mexico,NA,Oaxaca,3801962,167,15,5783,609
2020-06-25,Mexico,NA,Oaxaca,3801962,180,12,5963,621
2020-06-26,Mexico,NA,Oaxaca,3801962,177,16,6140,637
2020-06-27,Mexico,NA,Oaxaca,3801962,139,12,6279,649
2020-06-28,Mexico,NA,Oaxaca,3801962,74,9,6353,658
2020-06-29,Mexico,NA,Oaxaca,3801962,192,5,6545,663
2020-06-30,Mexico,NA,Oaxaca,3801962,170,10,6715,673
2020-07-01,Mexico,NA,Oaxaca,3801962,218,18,6933,691
2020-07-02,Mexico,NA,Oaxaca,3801962,212,7,7145,698
2020-07-03,Mexico,NA,Oaxaca,3801962,210,11,7355,709
2020-07-04,Mexico,NA,Oaxaca,3801962,163,17,7518,726
2020-07-05,Mexico,NA,Oaxaca,3801962,52,16,7570,742
2020-07-06,Mexico,NA,Oaxaca,3801962,263,14,7833,756
2020-07-07,Mexico,NA,Oaxaca,3801962,232,16,8065,772
2020-07-08,Mexico,NA,Oaxaca,3801962,200,9,8265,781
2020-07-09,Mexico,NA,Oaxaca,3801962,166,14,8431,795
2020-07-10,Mexico,NA,Oaxaca,3801962,188,15,8619,810
2020-07-11,Mexico,NA,Oaxaca,3801962,107,10,8726,820
2020-07-12,Mexico,NA,Oaxaca,3801962,37,13,8763,833
2020-07-13,Mexico,NA,Oaxaca,3801962,168,17,8931,850
2020-07-14,Mexico,NA,Oaxaca,3801962,179,17,9110,867
2020-07-15,Mexico,NA,Oaxaca,3801962,134,15,9244,882
2020-07-16,Mexico,NA,Oaxaca,3801962,158,10,9402,892
2020-07-17,Mexico,NA,Oaxaca,3801962,144,13,9546,905
2020-07-18,Mexico,NA,Oaxaca,3801962,107,7,9653,912
2020-07-19,Mexico,NA,Oaxaca,3801962,63,18,9716,930
2020-07-20,Mexico,NA,Oaxaca,3801962,186,10,9902,940
2020-07-21,Mexico,NA,Oaxaca,3801962,172,10,10074,950
2020-07-22,Mexico,NA,Oaxaca,3801962,169,18,10243,968
2020-07-23,Mexico,NA,Oaxaca,3801962,147,13,10390,981
2020-07-24,Mexico,NA,Oaxaca,3801962,158,13,10548,994
2020-07-25,Mexico,NA,Oaxaca,3801962,114,6,10662,1000
2020-07-26,Mexico,NA,Oaxaca,3801962,53,4,10715,1004
2020-07-27,Mexico,NA,Oaxaca,3801962,168,10,10883,1014
2020-07-28,Mexico,NA,Oaxaca,3801962,141,16,11024,1030
2020-07-29,Mexico,NA,Oaxaca,3801962,154,7,11178,1037
2020-07-30,Mexico,NA,Oaxaca,3801962,131,9,11309,1046
2020-07-31,Mexico,NA,Oaxaca,3801962,120,11,11429,1057
2020-08-01,Mexico,NA,Oaxaca,3801962,68,8,11497,1065
2020-08-02,Mexico,NA,Oaxaca,3801962,27,12,11524,1077
2020-08-03,Mexico,NA,Oaxaca,3801962,126,15,11650,1092
2020-08-04,Mexico,NA,Oaxaca,3801962,154,9,11804,1101
2020-08-05,Mexico,NA,Oaxaca,3801962,117,11,11921,1112
2020-08-06,Mexico,NA,Oaxaca,3801962,98,14,12019,1126
2020-08-07,Mexico,NA,Oaxaca,3801962,75,13,12094,1139
2020-08-08,Mexico,NA,Oaxaca,3801962,89,10,12183,1149
2020-08-09,Mexico,NA,Oaxaca,3801962,23,9,12206,1158
2020-08-10,Mexico,NA,Oaxaca,3801962,120,7,12326,1165
2020-08-11,Mexico,NA,Oaxaca,3801962,93,8,12419,1173
2020-08-12,Mexico,NA,Oaxaca,3801962,107,10,12526,1183
2020-08-13,Mexico,NA,Oaxaca,3801962,123,10,12649,1193
2020-08-14,Mexico,NA,Oaxaca,3801962,97,11,12746,1204
2020-08-15,Mexico,NA,Oaxaca,3801962,91,9,12837,1213
2020-08-16,Mexico,NA,Oaxaca,3801962,24,11,12861,1224
2020-08-17,Mexico,NA,Oaxaca,3801962,103,5,12964,1229
2020-08-18,Mexico,NA,Oaxaca,3801962,115,8,13079,1237
2020-08-19,Mexico,NA,Oaxaca,3801962,86,6,13165,1243
2020-08-20,Mexico,NA,Oaxaca,3801962,83,11,13248,1254
2020-08-21,Mexico,NA,Oaxaca,3801962,98,4,13346,1258
2020-08-22,Mexico,NA,Oaxaca,3801962,68,3,13414,1261
2020-08-23,Mexico,NA,Oaxaca,3801962,23,6,13437,1267
2020-08-24,Mexico,NA,Oaxaca,3801962,143,6,13580,1273
2020-08-25,Mexico,NA,Oaxaca,3801962,85,5,13665,1278
2020-08-26,Mexico,NA,Oaxaca,3801962,87,9,13752,1287
2020-08-27,Mexico,NA,Oaxaca,3801962,108,3,13860,1290
2020-08-28,Mexico,NA,Oaxaca,3801962,67,3,13927,1293
2020-08-29,Mexico,NA,Oaxaca,3801962,68,4,13995,1297
2020-08-30,Mexico,NA,Oaxaca,3801962,20,9,14015,1306
2020-08-31,Mexico,NA,Oaxaca,3801962,94,5,14109,1311
2020-09-01,Mexico,NA,Oaxaca,3801962,116,7,14225,1318
2020-09-02,Mexico,NA,Oaxaca,3801962,88,3,14313,1321
2020-09-03,Mexico,NA,Oaxaca,3801962,123,6,14436,1327
2020-09-04,Mexico,NA,Oaxaca,3801962,95,5,14531,1332
2020-09-05,Mexico,NA,Oaxaca,3801962,84,8,14615,1340
2020-09-06,Mexico,NA,Oaxaca,3801962,26,5,14641,1345
2020-09-07,Mexico,NA,Oaxaca,3801962,125,4,14766,1349
2020-09-08,Mexico,NA,Oaxaca,3801962,107,6,14873,1355
2020-09-09,Mexico,NA,Oaxaca,3801962,132,6,15005,1361
2020-09-10,Mexico,NA,Oaxaca,3801962,107,4,15112,1365
2020-09-11,Mexico,NA,Oaxaca,3801962,74,1,15186,1366
2020-09-12,Mexico,NA,Oaxaca,3801962,161,2,15347,1368
2020-09-13,Mexico,NA,Oaxaca,3801962,21,9,15368,1377
2020-09-14,Mexico,NA,Oaxaca,3801962,131,5,15499,1382
2020-09-15,Mexico,NA,Oaxaca,3801962,142,6,15641,1388
2020-09-16,Mexico,NA,Oaxaca,3801962,117,5,15758,1393
2020-09-17,Mexico,NA,Oaxaca,3801962,147,3,15905,1396
2020-09-18,Mexico,NA,Oaxaca,3801962,78,2,15983,1398
2020-09-19,Mexico,NA,Oaxaca,3801962,49,7,16032,1405
2020-09-20,Mexico,NA,Oaxaca,3801962,18,4,16050,1409
2020-09-21,Mexico,NA,Oaxaca,3801962,65,5,16115,1414
2020-09-22,Mexico,NA,Oaxaca,3801962,39,5,16154,1419
2020-09-23,Mexico,NA,Oaxaca,3801962,3,1,16157,1420
2020-03-15,Mexico,NA,Puebla,5779829,3,0,12,0
2020-03-16,Mexico,NA,Puebla,5779829,2,0,14,0
2020-03-17,Mexico,NA,Puebla,5779829,5,0,19,0
2020-03-18,Mexico,NA,Puebla,5779829,6,0,25,0
2020-03-19,Mexico,NA,Puebla,5779829,7,0,32,0
2020-03-20,Mexico,NA,Puebla,5779829,5,0,37,0
2020-03-21,Mexico,NA,Puebla,5779829,4,0,41,0
2020-03-22,Mexico,NA,Puebla,5779829,2,0,43,0
2020-03-23,Mexico,NA,Puebla,5779829,8,0,51,0
2020-03-24,Mexico,NA,Puebla,5779829,16,0,67,0
2020-03-25,Mexico,NA,Puebla,5779829,6,0,73,0
2020-03-26,Mexico,NA,Puebla,5779829,15,0,88,0
2020-03-27,Mexico,NA,Puebla,5779829,9,1,97,1
2020-03-28,Mexico,NA,Puebla,5779829,13,1,110,2
2020-03-29,Mexico,NA,Puebla,5779829,4,0,114,2
2020-03-30,Mexico,NA,Puebla,5779829,15,0,129,2
2020-03-31,Mexico,NA,Puebla,5779829,21,1,150,3
2020-04-01,Mexico,NA,Puebla,5779829,16,1,166,4
2020-04-02,Mexico,NA,Puebla,5779829,19,1,185,5
2020-04-03,Mexico,NA,Puebla,5779829,14,2,199,7
2020-04-04,Mexico,NA,Puebla,5779829,11,3,210,10
2020-04-05,Mexico,NA,Puebla,5779829,8,3,218,13
2020-04-06,Mexico,NA,Puebla,5779829,24,4,242,17
2020-04-07,Mexico,NA,Puebla,5779829,13,8,255,25
2020-04-08,Mexico,NA,Puebla,5779829,23,1,278,26
2020-04-09,Mexico,NA,Puebla,5779829,11,2,289,28
2020-04-10,Mexico,NA,Puebla,5779829,8,5,297,33
2020-04-11,Mexico,NA,Puebla,5779829,15,5,312,38
2020-04-12,Mexico,NA,Puebla,5779829,5,2,317,40
2020-04-13,Mexico,NA,Puebla,5779829,25,3,342,43
2020-04-14,Mexico,NA,Puebla,5779829,16,4,358,47
2020-04-15,Mexico,NA,Puebla,5779829,28,4,386,51
2020-04-16,Mexico,NA,Puebla,5779829,21,5,407,56
2020-04-17,Mexico,NA,Puebla,5779829,30,5,437,61
2020-04-18,Mexico,NA,Puebla,5779829,24,7,461,68
2020-04-19,Mexico,NA,Puebla,5779829,18,7,479,75
2020-04-20,Mexico,NA,Puebla,5779829,31,8,510,83
2020-04-21,Mexico,NA,Puebla,5779829,22,3,532,86
2020-04-22,Mexico,NA,Puebla,5779829,27,7,559,93
2020-04-23,Mexico,NA,Puebla,5779829,32,5,591,98
2020-04-24,Mexico,NA,Puebla,5779829,40,6,631,104
2020-04-25,Mexico,NA,Puebla,5779829,43,6,674,110
2020-04-26,Mexico,NA,Puebla,5779829,24,9,698,119
2020-04-27,Mexico,NA,Puebla,5779829,35,5,733,124
2020-04-28,Mexico,NA,Puebla,5779829,43,12,776,136
2020-04-29,Mexico,NA,Puebla,5779829,44,9,820,145
2020-04-30,Mexico,NA,Puebla,5779829,46,8,866,153
2020-05-01,Mexico,NA,Puebla,5779829,41,12,907,165
2020-05-02,Mexico,NA,Puebla,5779829,42,5,949,170
2020-05-03,Mexico,NA,Puebla,5779829,37,13,986,183
2020-05-04,Mexico,NA,Puebla,5779829,46,13,1032,196
2020-05-05,Mexico,NA,Puebla,5779829,34,13,1066,209
2020-05-06,Mexico,NA,Puebla,5779829,49,8,1115,217
2020-05-07,Mexico,NA,Puebla,5779829,63,11,1178,228
2020-05-08,Mexico,NA,Puebla,5779829,46,8,1224,236
2020-05-09,Mexico,NA,Puebla,5779829,48,8,1272,244
2020-05-10,Mexico,NA,Puebla,5779829,36,5,1308,249
2020-05-11,Mexico,NA,Puebla,5779829,71,15,1379,264
2020-05-12,Mexico,NA,Puebla,5779829,74,17,1453,281
2020-05-13,Mexico,NA,Puebla,5779829,91,14,1544,295
2020-05-14,Mexico,NA,Puebla,5779829,106,14,1650,309
2020-05-15,Mexico,NA,Puebla,5779829,104,17,1754,326
2020-05-16,Mexico,NA,Puebla,5779829,78,15,1832,341
2020-05-17,Mexico,NA,Puebla,5779829,66,13,1898,354
2020-05-18,Mexico,NA,Puebla,5779829,129,10,2027,364
2020-05-19,Mexico,NA,Puebla,5779829,126,21,2153,385
2020-05-20,Mexico,NA,Puebla,5779829,118,23,2271,408
2020-05-21,Mexico,NA,Puebla,5779829,143,18,2414,426
2020-05-22,Mexico,NA,Puebla,5779829,171,28,2585,454
2020-05-23,Mexico,NA,Puebla,5779829,146,23,2731,477
2020-05-24,Mexico,NA,Puebla,5779829,80,18,2811,495
2020-05-25,Mexico,NA,Puebla,5779829,165,28,2976,523
2020-05-26,Mexico,NA,Puebla,5779829,160,21,3136,544
2020-05-27,Mexico,NA,Puebla,5779829,187,19,3323,563
2020-05-28,Mexico,NA,Puebla,5779829,163,24,3486,587
2020-05-29,Mexico,NA,Puebla,5779829,149,19,3635,606
2020-05-30,Mexico,NA,Puebla,5779829,116,23,3751,629
2020-05-31,Mexico,NA,Puebla,5779829,61,25,3812,654
2020-06-01,Mexico,NA,Puebla,5779829,184,35,3996,689
2020-06-02,Mexico,NA,Puebla,5779829,164,32,4160,721
2020-06-03,Mexico,NA,Puebla,5779829,192,26,4352,747
2020-06-04,Mexico,NA,Puebla,5779829,204,33,4556,780
2020-06-05,Mexico,NA,Puebla,5779829,204,20,4760,800
2020-06-06,Mexico,NA,Puebla,5779829,123,35,4883,835
2020-06-07,Mexico,NA,Puebla,5779829,92,29,4975,864
2020-06-08,Mexico,NA,Puebla,5779829,301,24,5276,888
2020-06-09,Mexico,NA,Puebla,5779829,236,31,5512,919
2020-06-10,Mexico,NA,Puebla,5779829,246,32,5758,951
2020-06-11,Mexico,NA,Puebla,5779829,295,19,6053,970
2020-06-12,Mexico,NA,Puebla,5779829,305,36,6358,1006
2020-06-13,Mexico,NA,Puebla,5779829,172,36,6530,1042
2020-06-14,Mexico,NA,Puebla,5779829,144,35,6674,1077
2020-06-15,Mexico,NA,Puebla,5779829,438,36,7112,1113
2020-06-16,Mexico,NA,Puebla,5779829,413,40,7525,1153
2020-06-17,Mexico,NA,Puebla,5779829,415,38,7940,1191
2020-06-18,Mexico,NA,Puebla,5779829,505,40,8445,1231
2020-06-19,Mexico,NA,Puebla,5779829,431,25,8876,1256
2020-06-20,Mexico,NA,Puebla,5779829,212,34,9088,1290
2020-06-21,Mexico,NA,Puebla,5779829,168,46,9256,1336
2020-06-22,Mexico,NA,Puebla,5779829,489,49,9745,1385
2020-06-23,Mexico,NA,Puebla,5779829,409,28,10154,1413
2020-06-24,Mexico,NA,Puebla,5779829,364,23,10518,1436
2020-06-25,Mexico,NA,Puebla,5779829,448,23,10966,1459
2020-06-26,Mexico,NA,Puebla,5779829,352,28,11318,1487
2020-06-27,Mexico,NA,Puebla,5779829,183,22,11501,1509
2020-06-28,Mexico,NA,Puebla,5779829,142,27,11643,1536
2020-06-29,Mexico,NA,Puebla,5779829,335,33,11978,1569
2020-06-30,Mexico,NA,Puebla,5779829,354,37,12332,1606
2020-07-01,Mexico,NA,Puebla,5779829,317,34,12649,1640
2020-07-02,Mexico,NA,Puebla,5779829,274,29,12923,1669
2020-07-03,Mexico,NA,Puebla,5779829,273,48,13196,1717
2020-07-04,Mexico,NA,Puebla,5779829,175,37,13371,1754
2020-07-05,Mexico,NA,Puebla,5779829,132,41,13503,1795
2020-07-06,Mexico,NA,Puebla,5779829,330,41,13833,1836
2020-07-07,Mexico,NA,Puebla,5779829,339,37,14172,1873
2020-07-08,Mexico,NA,Puebla,5779829,324,40,14496,1913
2020-07-09,Mexico,NA,Puebla,5779829,322,33,14818,1946
2020-07-10,Mexico,NA,Puebla,5779829,317,30,15135,1976
2020-07-11,Mexico,NA,Puebla,5779829,174,29,15309,2005
2020-07-12,Mexico,NA,Puebla,5779829,172,38,15481,2043
2020-07-13,Mexico,NA,Puebla,5779829,417,59,15898,2102
2020-07-14,Mexico,NA,Puebla,5779829,420,25,16318,2127
2020-07-15,Mexico,NA,Puebla,5779829,402,31,16720,2158
2020-07-16,Mexico,NA,Puebla,5779829,385,44,17105,2202
2020-07-17,Mexico,NA,Puebla,5779829,379,40,17484,2242
2020-07-18,Mexico,NA,Puebla,5779829,184,41,17668,2283
2020-07-19,Mexico,NA,Puebla,5779829,160,37,17828,2320
2020-07-20,Mexico,NA,Puebla,5779829,475,39,18303,2359
2020-07-21,Mexico,NA,Puebla,5779829,355,45,18658,2404
2020-07-22,Mexico,NA,Puebla,5779829,379,40,19037,2444
2020-07-23,Mexico,NA,Puebla,5779829,346,42,19383,2486
2020-07-24,Mexico,NA,Puebla,5779829,339,41,19722,2527
2020-07-25,Mexico,NA,Puebla,5779829,224,46,19946,2573
2020-07-26,Mexico,NA,Puebla,5779829,105,43,20051,2616
2020-07-27,Mexico,NA,Puebla,5779829,435,36,20486,2652
2020-07-28,Mexico,NA,Puebla,5779829,328,33,20814,2685
2020-07-29,Mexico,NA,Puebla,5779829,334,44,21148,2729
2020-07-30,Mexico,NA,Puebla,5779829,334,47,21482,2776
2020-07-31,Mexico,NA,Puebla,5779829,250,37,21732,2813
2020-08-01,Mexico,NA,Puebla,5779829,134,33,21866,2846
2020-08-02,Mexico,NA,Puebla,5779829,96,32,21962,2878
2020-08-03,Mexico,NA,Puebla,5779829,308,30,22270,2908
2020-08-04,Mexico,NA,Puebla,5779829,276,31,22546,2939
2020-08-05,Mexico,NA,Puebla,5779829,295,33,22841,2972
2020-08-06,Mexico,NA,Puebla,5779829,319,30,23160,3002
2020-08-07,Mexico,NA,Puebla,5779829,259,31,23419,3033
2020-08-08,Mexico,NA,Puebla,5779829,163,22,23582,3055
2020-08-09,Mexico,NA,Puebla,5779829,96,23,23678,3078
2020-08-10,Mexico,NA,Puebla,5779829,295,35,23973,3113
2020-08-11,Mexico,NA,Puebla,5779829,286,40,24259,3153
2020-08-12,Mexico,NA,Puebla,5779829,260,27,24519,3180
2020-08-13,Mexico,NA,Puebla,5779829,238,32,24757,3212
2020-08-14,Mexico,NA,Puebla,5779829,218,28,24975,3240
2020-08-15,Mexico,NA,Puebla,5779829,121,37,25096,3277
2020-08-16,Mexico,NA,Puebla,5779829,80,34,25176,3311
2020-08-17,Mexico,NA,Puebla,5779829,250,25,25426,3336
2020-08-18,Mexico,NA,Puebla,5779829,221,17,25647,3353
2020-08-19,Mexico,NA,Puebla,5779829,209,30,25856,3383
2020-08-20,Mexico,NA,Puebla,5779829,195,25,26051,3408
2020-08-21,Mexico,NA,Puebla,5779829,189,17,26240,3425
2020-08-22,Mexico,NA,Puebla,5779829,128,19,26368,3444
2020-08-23,Mexico,NA,Puebla,5779829,78,14,26446,3458
2020-08-24,Mexico,NA,Puebla,5779829,260,25,26706,3483
2020-08-25,Mexico,NA,Puebla,5779829,208,21,26914,3504
2020-08-26,Mexico,NA,Puebla,5779829,204,17,27118,3521
2020-08-27,Mexico,NA,Puebla,5779829,190,18,27308,3539
2020-08-28,Mexico,NA,Puebla,5779829,197,16,27505,3555
2020-08-29,Mexico,NA,Puebla,5779829,84,18,27589,3573
2020-08-30,Mexico,NA,Puebla,5779829,92,24,27681,3597
2020-08-31,Mexico,NA,Puebla,5779829,198,28,27879,3625
2020-09-01,Mexico,NA,Puebla,5779829,182,11,28061,3636
2020-09-02,Mexico,NA,Puebla,5779829,179,20,28240,3656
2020-09-03,Mexico,NA,Puebla,5779829,172,15,28412,3671
2020-09-04,Mexico,NA,Puebla,5779829,160,21,28572,3692
2020-09-05,Mexico,NA,Puebla,5779829,101,25,28673,3717
2020-09-06,Mexico,NA,Puebla,5779829,65,18,28738,3735
2020-09-07,Mexico,NA,Puebla,5779829,165,13,28903,3748
2020-09-08,Mexico,NA,Puebla,5779829,141,24,29044,3772
2020-09-09,Mexico,NA,Puebla,5779829,170,18,29214,3790
2020-09-10,Mexico,NA,Puebla,5779829,158,12,29372,3802
2020-09-11,Mexico,NA,Puebla,5779829,122,15,29494,3817
2020-09-12,Mexico,NA,Puebla,5779829,60,11,29554,3828
2020-09-13,Mexico,NA,Puebla,5779829,50,17,29604,3845
2020-09-14,Mexico,NA,Puebla,5779829,173,14,29777,3859
2020-09-15,Mexico,NA,Puebla,5779829,104,15,29881,3874
2020-09-16,Mexico,NA,Puebla,5779829,67,5,29948,3879
2020-09-17,Mexico,NA,Puebla,5779829,161,20,30109,3899
2020-09-18,Mexico,NA,Puebla,5779829,124,9,30233,3908
2020-09-19,Mexico,NA,Puebla,5779829,76,8,30309,3916
2020-09-20,Mexico,NA,Puebla,5779829,43,8,30352,3924
2020-09-21,Mexico,NA,Puebla,5779829,129,8,30481,3932
2020-09-22,Mexico,NA,Puebla,5779829,65,6,30546,3938
2020-09-23,Mexico,NA,Puebla,5779829,2,2,30548,3940
2020-03-18,Mexico,NA,Queretaro,1827937,2,0,11,0
2020-03-19,Mexico,NA,Queretaro,1827937,3,0,14,0
2020-03-21,Mexico,NA,Queretaro,1827937,1,0,15,0
2020-03-23,Mexico,NA,Queretaro,1827937,3,0,18,0
2020-03-24,Mexico,NA,Queretaro,1827937,4,0,22,0
2020-03-25,Mexico,NA,Queretaro,1827937,2,0,24,0
2020-03-26,Mexico,NA,Queretaro,1827937,1,0,25,0
2020-03-27,Mexico,NA,Queretaro,1827937,4,0,29,0
2020-03-28,Mexico,NA,Queretaro,1827937,2,1,31,1
2020-03-29,Mexico,NA,Queretaro,1827937,1,0,32,1
2020-03-30,Mexico,NA,Queretaro,1827937,1,0,33,1
2020-03-31,Mexico,NA,Queretaro,1827937,5,0,38,1
2020-04-01,Mexico,NA,Queretaro,1827937,3,0,41,1
2020-04-02,Mexico,NA,Queretaro,1827937,1,1,42,2
2020-04-03,Mexico,NA,Queretaro,1827937,3,0,45,2
2020-04-04,Mexico,NA,Queretaro,1827937,1,0,46,2
2020-04-06,Mexico,NA,Queretaro,1827937,4,0,50,2
2020-04-07,Mexico,NA,Queretaro,1827937,5,0,55,2
2020-04-08,Mexico,NA,Queretaro,1827937,3,0,58,2
2020-04-09,Mexico,NA,Queretaro,1827937,3,0,61,2
2020-04-10,Mexico,NA,Queretaro,1827937,2,0,63,2
2020-04-11,Mexico,NA,Queretaro,1827937,3,1,66,3
2020-04-12,Mexico,NA,Queretaro,1827937,1,0,67,3
2020-04-13,Mexico,NA,Queretaro,1827937,8,0,75,3
2020-04-14,Mexico,NA,Queretaro,1827937,8,1,83,4
2020-04-15,Mexico,NA,Queretaro,1827937,3,1,86,5
2020-04-16,Mexico,NA,Queretaro,1827937,6,0,92,5
2020-04-17,Mexico,NA,Queretaro,1827937,5,0,97,5
2020-04-18,Mexico,NA,Queretaro,1827937,2,0,99,5
2020-04-19,Mexico,NA,Queretaro,1827937,2,0,101,5
2020-04-20,Mexico,NA,Queretaro,1827937,5,0,106,5
2020-04-21,Mexico,NA,Queretaro,1827937,2,1,108,6
2020-04-22,Mexico,NA,Queretaro,1827937,7,0,115,6
2020-04-23,Mexico,NA,Queretaro,1827937,9,0,124,6
2020-04-24,Mexico,NA,Queretaro,1827937,10,0,134,6
2020-04-25,Mexico,NA,Queretaro,1827937,1,1,135,7
2020-04-26,Mexico,NA,Queretaro,1827937,2,1,137,8
2020-04-27,Mexico,NA,Queretaro,1827937,3,1,140,9
2020-04-28,Mexico,NA,Queretaro,1827937,9,0,149,9
2020-04-29,Mexico,NA,Queretaro,1827937,12,1,161,10
2020-04-30,Mexico,NA,Queretaro,1827937,6,1,167,11
2020-05-01,Mexico,NA,Queretaro,1827937,8,1,175,12
2020-05-02,Mexico,NA,Queretaro,1827937,12,1,187,13
2020-05-03,Mexico,NA,Queretaro,1827937,4,1,191,14
2020-05-04,Mexico,NA,Queretaro,1827937,10,2,201,16
2020-05-05,Mexico,NA,Queretaro,1827937,10,1,211,17
2020-05-06,Mexico,NA,Queretaro,1827937,9,2,220,19
2020-05-07,Mexico,NA,Queretaro,1827937,14,0,234,19
2020-05-08,Mexico,NA,Queretaro,1827937,26,0,260,19
2020-05-09,Mexico,NA,Queretaro,1827937,26,0,286,19
2020-05-10,Mexico,NA,Queretaro,1827937,19,4,305,23
2020-05-11,Mexico,NA,Queretaro,1827937,47,2,352,25
2020-05-12,Mexico,NA,Queretaro,1827937,34,3,386,28
2020-05-13,Mexico,NA,Queretaro,1827937,29,1,415,29
2020-05-14,Mexico,NA,Queretaro,1827937,41,2,456,31
2020-05-15,Mexico,NA,Queretaro,1827937,49,4,505,35
2020-05-16,Mexico,NA,Queretaro,1827937,28,8,533,43
2020-05-17,Mexico,NA,Queretaro,1827937,17,8,550,51
2020-05-18,Mexico,NA,Queretaro,1827937,47,1,597,52
2020-05-19,Mexico,NA,Queretaro,1827937,61,3,658,55
2020-05-20,Mexico,NA,Queretaro,1827937,42,5,700,60
2020-05-21,Mexico,NA,Queretaro,1827937,37,9,737,69
2020-05-22,Mexico,NA,Queretaro,1827937,36,2,773,71
2020-05-23,Mexico,NA,Queretaro,1827937,22,5,795,76
2020-05-24,Mexico,NA,Queretaro,1827937,12,3,807,79
2020-05-25,Mexico,NA,Queretaro,1827937,52,5,859,84
2020-05-26,Mexico,NA,Queretaro,1827937,38,5,897,89
2020-05-27,Mexico,NA,Queretaro,1827937,36,6,933,95
2020-05-28,Mexico,NA,Queretaro,1827937,31,2,964,97
2020-05-29,Mexico,NA,Queretaro,1827937,37,6,1001,103
2020-05-30,Mexico,NA,Queretaro,1827937,27,2,1028,105
2020-05-31,Mexico,NA,Queretaro,1827937,21,7,1049,112
2020-06-01,Mexico,NA,Queretaro,1827937,39,5,1088,117
2020-06-02,Mexico,NA,Queretaro,1827937,50,6,1138,123
2020-06-03,Mexico,NA,Queretaro,1827937,47,5,1185,128
2020-06-04,Mexico,NA,Queretaro,1827937,44,9,1229,137
2020-06-05,Mexico,NA,Queretaro,1827937,36,3,1265,140
2020-06-06,Mexico,NA,Queretaro,1827937,30,7,1295,147
2020-06-07,Mexico,NA,Queretaro,1827937,28,7,1323,154
2020-06-08,Mexico,NA,Queretaro,1827937,53,3,1376,157
2020-06-09,Mexico,NA,Queretaro,1827937,43,7,1419,164
2020-06-10,Mexico,NA,Queretaro,1827937,39,2,1458,166
2020-06-11,Mexico,NA,Queretaro,1827937,33,8,1491,174
2020-06-12,Mexico,NA,Queretaro,1827937,41,7,1532,181
2020-06-13,Mexico,NA,Queretaro,1827937,34,9,1566,190
2020-06-14,Mexico,NA,Queretaro,1827937,22,4,1588,194
2020-06-15,Mexico,NA,Queretaro,1827937,59,7,1647,201
2020-06-16,Mexico,NA,Queretaro,1827937,46,7,1693,208
2020-06-17,Mexico,NA,Queretaro,1827937,44,5,1737,213
2020-06-18,Mexico,NA,Queretaro,1827937,40,6,1777,219
2020-06-19,Mexico,NA,Queretaro,1827937,29,6,1806,225
2020-06-20,Mexico,NA,Queretaro,1827937,32,5,1838,230
2020-06-21,Mexico,NA,Queretaro,1827937,16,3,1854,233
2020-06-22,Mexico,NA,Queretaro,1827937,51,5,1905,238
2020-06-23,Mexico,NA,Queretaro,1827937,40,5,1945,243
2020-06-24,Mexico,NA,Queretaro,1827937,42,3,1987,246
2020-06-25,Mexico,NA,Queretaro,1827937,38,3,2025,249
2020-06-26,Mexico,NA,Queretaro,1827937,44,5,2069,254
2020-06-27,Mexico,NA,Queretaro,1827937,24,9,2093,263
2020-06-28,Mexico,NA,Queretaro,1827937,21,5,2114,268
2020-06-29,Mexico,NA,Queretaro,1827937,60,6,2174,274
2020-06-30,Mexico,NA,Queretaro,1827937,49,5,2223,279
2020-07-01,Mexico,NA,Queretaro,1827937,53,6,2276,285
2020-07-02,Mexico,NA,Queretaro,1827937,64,10,2340,295
2020-07-03,Mexico,NA,Queretaro,1827937,33,5,2373,300
2020-07-04,Mexico,NA,Queretaro,1827937,23,8,2396,308
2020-07-05,Mexico,NA,Queretaro,1827937,32,6,2428,314
2020-07-06,Mexico,NA,Queretaro,1827937,55,5,2483,319
2020-07-07,Mexico,NA,Queretaro,1827937,76,7,2559,326
2020-07-08,Mexico,NA,Queretaro,1827937,63,10,2622,336
2020-07-09,Mexico,NA,Queretaro,1827937,66,4,2688,340
2020-07-10,Mexico,NA,Queretaro,1827937,58,3,2746,343
2020-07-11,Mexico,NA,Queretaro,1827937,48,1,2794,344
2020-07-12,Mexico,NA,Queretaro,1827937,32,7,2826,351
2020-07-13,Mexico,NA,Queretaro,1827937,87,8,2913,359
2020-07-14,Mexico,NA,Queretaro,1827937,60,3,2973,362
2020-07-15,Mexico,NA,Queretaro,1827937,91,4,3064,366
2020-07-16,Mexico,NA,Queretaro,1827937,70,7,3134,373
2020-07-17,Mexico,NA,Queretaro,1827937,80,8,3214,381
2020-07-18,Mexico,NA,Queretaro,1827937,46,5,3260,386
2020-07-19,Mexico,NA,Queretaro,1827937,32,8,3292,394
2020-07-20,Mexico,NA,Queretaro,1827937,84,8,3376,402
2020-07-21,Mexico,NA,Queretaro,1827937,74,3,3450,405
2020-07-22,Mexico,NA,Queretaro,1827937,74,8,3524,413
2020-07-23,Mexico,NA,Queretaro,1827937,69,6,3593,419
2020-07-24,Mexico,NA,Queretaro,1827937,53,4,3646,423
2020-07-25,Mexico,NA,Queretaro,1827937,49,6,3695,429
2020-07-26,Mexico,NA,Queretaro,1827937,37,8,3732,437
2020-07-27,Mexico,NA,Queretaro,1827937,84,3,3816,440
2020-07-28,Mexico,NA,Queretaro,1827937,83,6,3899,446
2020-07-29,Mexico,NA,Queretaro,1827937,86,5,3985,451
2020-07-30,Mexico,NA,Queretaro,1827937,77,7,4062,458
2020-07-31,Mexico,NA,Queretaro,1827937,79,9,4141,467
2020-08-01,Mexico,NA,Queretaro,1827937,48,9,4189,476
2020-08-02,Mexico,NA,Queretaro,1827937,30,11,4219,487
2020-08-03,Mexico,NA,Queretaro,1827937,98,3,4317,490
2020-08-04,Mexico,NA,Queretaro,1827937,90,4,4407,494
2020-08-05,Mexico,NA,Queretaro,1827937,73,10,4480,504
2020-08-06,Mexico,NA,Queretaro,1827937,103,8,4583,512
2020-08-07,Mexico,NA,Queretaro,1827937,82,4,4665,516
2020-08-08,Mexico,NA,Queretaro,1827937,43,9,4708,525
2020-08-09,Mexico,NA,Queretaro,1827937,34,7,4742,532
2020-08-10,Mexico,NA,Queretaro,1827937,117,10,4859,542
2020-08-11,Mexico,NA,Queretaro,1827937,91,6,4950,548
2020-08-12,Mexico,NA,Queretaro,1827937,97,3,5047,551
2020-08-13,Mexico,NA,Queretaro,1827937,71,5,5118,556
2020-08-14,Mexico,NA,Queretaro,1827937,102,10,5220,566
2020-08-15,Mexico,NA,Queretaro,1827937,61,10,5281,576
2020-08-16,Mexico,NA,Queretaro,1827937,52,7,5333,583
2020-08-17,Mexico,NA,Queretaro,1827937,103,3,5436,586
2020-08-18,Mexico,NA,Queretaro,1827937,84,9,5520,595
2020-08-19,Mexico,NA,Queretaro,1827937,117,11,5637,606
2020-08-20,Mexico,NA,Queretaro,1827937,91,8,5728,614
2020-08-21,Mexico,NA,Queretaro,1827937,89,7,5817,621
2020-08-22,Mexico,NA,Queretaro,1827937,50,13,5867,634
2020-08-23,Mexico,NA,Queretaro,1827937,30,6,5897,640
2020-08-24,Mexico,NA,Queretaro,1827937,138,5,6035,645
2020-08-25,Mexico,NA,Queretaro,1827937,131,12,6166,657
2020-08-26,Mexico,NA,Queretaro,1827937,135,10,6301,667
2020-08-27,Mexico,NA,Queretaro,1827937,110,7,6411,674
2020-08-28,Mexico,NA,Queretaro,1827937,99,6,6510,680
2020-08-29,Mexico,NA,Queretaro,1827937,82,13,6592,693
2020-08-30,Mexico,NA,Queretaro,1827937,60,16,6652,709
2020-08-31,Mexico,NA,Queretaro,1827937,132,11,6784,720
2020-09-01,Mexico,NA,Queretaro,1827937,155,6,6939,726
2020-09-02,Mexico,NA,Queretaro,1827937,107,7,7046,733
2020-09-03,Mexico,NA,Queretaro,1827937,108,8,7154,741
2020-09-04,Mexico,NA,Queretaro,1827937,119,9,7273,750
2020-09-05,Mexico,NA,Queretaro,1827937,58,12,7331,762
2020-09-06,Mexico,NA,Queretaro,1827937,46,6,7377,768
2020-09-07,Mexico,NA,Queretaro,1827937,101,17,7478,785
2020-09-08,Mexico,NA,Queretaro,1827937,100,7,7578,792
2020-09-09,Mexico,NA,Queretaro,1827937,105,10,7683,802
2020-09-10,Mexico,NA,Queretaro,1827937,70,14,7753,816
2020-09-11,Mexico,NA,Queretaro,1827937,92,12,7845,828
2020-09-12,Mexico,NA,Queretaro,1827937,34,7,7879,835
2020-09-13,Mexico,NA,Queretaro,1827937,40,10,7919,845
2020-09-14,Mexico,NA,Queretaro,1827937,103,10,8022,855
2020-09-15,Mexico,NA,Queretaro,1827937,72,6,8094,861
2020-09-16,Mexico,NA,Queretaro,1827937,30,6,8124,867
2020-09-17,Mexico,NA,Queretaro,1827937,68,4,8192,871
2020-09-18,Mexico,NA,Queretaro,1827937,65,6,8257,877
2020-09-19,Mexico,NA,Queretaro,1827937,49,7,8306,884
2020-09-20,Mexico,NA,Queretaro,1827937,38,4,8344,888
2020-09-21,Mexico,NA,Queretaro,1827937,100,6,8444,894
2020-09-22,Mexico,NA,Queretaro,1827937,71,7,8515,901
2020-09-23,Mexico,NA,Queretaro,1827937,37,1,8552,902
2020-03-17,Mexico,NA,Quintana Roo,1325578,4,0,14,0
2020-03-18,Mexico,NA,Quintana Roo,1325578,2,0,16,0
2020-03-19,Mexico,NA,Quintana Roo,1325578,5,0,21,0
2020-03-20,Mexico,NA,Quintana Roo,1325578,1,0,22,0
2020-03-21,Mexico,NA,Quintana Roo,1325578,3,0,25,0
2020-03-22,Mexico,NA,Quintana Roo,1325578,4,0,29,0
2020-03-23,Mexico,NA,Quintana Roo,1325578,3,0,32,0
2020-03-24,Mexico,NA,Quintana Roo,1325578,8,0,40,0
2020-03-25,Mexico,NA,Quintana Roo,1325578,10,0,50,0
2020-03-26,Mexico,NA,Quintana Roo,1325578,9,1,59,1
2020-03-27,Mexico,NA,Quintana Roo,1325578,7,1,66,2
2020-03-28,Mexico,NA,Quintana Roo,1325578,7,1,73,3
2020-03-29,Mexico,NA,Quintana Roo,1325578,3,0,76,3
2020-03-30,Mexico,NA,Quintana Roo,1325578,22,0,98,3
2020-03-31,Mexico,NA,Quintana Roo,1325578,15,2,113,5
2020-04-01,Mexico,NA,Quintana Roo,1325578,24,1,137,6
2020-04-02,Mexico,NA,Quintana Roo,1325578,11,2,148,8
2020-04-03,Mexico,NA,Quintana Roo,1325578,13,2,161,10
2020-04-04,Mexico,NA,Quintana Roo,1325578,8,1,169,11
2020-04-05,Mexico,NA,Quintana Roo,1325578,10,1,179,12
2020-04-06,Mexico,NA,Quintana Roo,1325578,32,2,211,14
2020-04-07,Mexico,NA,Quintana Roo,1325578,23,2,234,16
2020-04-08,Mexico,NA,Quintana Roo,1325578,26,3,260,19
2020-04-09,Mexico,NA,Quintana Roo,1325578,9,3,269,22
2020-04-10,Mexico,NA,Quintana Roo,1325578,22,2,291,24
2020-04-11,Mexico,NA,Quintana Roo,1325578,17,2,308,26
2020-04-12,Mexico,NA,Quintana Roo,1325578,22,5,330,31
2020-04-13,Mexico,NA,Quintana Roo,1325578,22,5,352,36
2020-04-14,Mexico,NA,Quintana Roo,1325578,17,3,369,39
2020-04-15,Mexico,NA,Quintana Roo,1325578,20,0,389,39
2020-04-16,Mexico,NA,Quintana Roo,1325578,31,1,420,40
2020-04-17,Mexico,NA,Quintana Roo,1325578,34,4,454,44
2020-04-18,Mexico,NA,Quintana Roo,1325578,45,6,499,50
2020-04-19,Mexico,NA,Quintana Roo,1325578,23,7,522,57
2020-04-20,Mexico,NA,Quintana Roo,1325578,45,10,567,67
2020-04-21,Mexico,NA,Quintana Roo,1325578,42,8,609,75
2020-04-22,Mexico,NA,Quintana Roo,1325578,34,6,643,81
2020-04-23,Mexico,NA,Quintana Roo,1325578,47,7,690,88
2020-04-24,Mexico,NA,Quintana Roo,1325578,23,16,713,104
2020-04-25,Mexico,NA,Quintana Roo,1325578,31,10,744,114
2020-04-26,Mexico,NA,Quintana Roo,1325578,31,10,775,124
2020-04-27,Mexico,NA,Quintana Roo,1325578,43,14,818,138
2020-04-28,Mexico,NA,Quintana Roo,1325578,42,9,860,147
2020-04-29,Mexico,NA,Quintana Roo,1325578,38,12,898,159
2020-04-30,Mexico,NA,Quintana Roo,1325578,34,11,932,170
2020-05-01,Mexico,NA,Quintana Roo,1325578,32,14,964,184
2020-05-02,Mexico,NA,Quintana Roo,1325578,70,5,1034,189
2020-05-03,Mexico,NA,Quintana Roo,1325578,29,8,1063,197
2020-05-04,Mexico,NA,Quintana Roo,1325578,32,6,1095,203
2020-05-05,Mexico,NA,Quintana Roo,1325578,25,7,1120,210
2020-05-06,Mexico,NA,Quintana Roo,1325578,41,9,1161,219
2020-05-07,Mexico,NA,Quintana Roo,1325578,39,8,1200,227
2020-05-08,Mexico,NA,Quintana Roo,1325578,28,5,1228,232
2020-05-09,Mexico,NA,Quintana Roo,1325578,20,9,1248,241
2020-05-10,Mexico,NA,Quintana Roo,1325578,23,8,1271,249
2020-05-11,Mexico,NA,Quintana Roo,1325578,45,6,1316,255
2020-05-12,Mexico,NA,Quintana Roo,1325578,37,12,1353,267
2020-05-13,Mexico,NA,Quintana Roo,1325578,27,7,1380,274
2020-05-14,Mexico,NA,Quintana Roo,1325578,39,11,1419,283
2020-05-15,Mexico,NA,Quintana Roo,1325578,21,10,1440,288
2020-05-16,Mexico,NA,Quintana Roo,1325578,18,6,1458,291
2020-05-17,Mexico,NA,Quintana Roo,1325578,13,5,1471,294
2020-05-18,Mexico,NA,Quintana Roo,1325578,44,10,1515,303
2020-05-19,Mexico,NA,Quintana Roo,1325578,34,8,1549,309
2020-05-20,Mexico,NA,Quintana Roo,1325578,45,4,1594,318
2020-05-21,Mexico,NA,Quintana Roo,1325578,41,6,1635,327
2020-05-22,Mexico,NA,Quintana Roo,1325578,45,5,1680,336
2020-05-23,Mexico,NA,Quintana Roo,1325578,39,3,1719,342
2020-05-24,Mexico,NA,Quintana Roo,1325578,25,10,1744,348
2020-05-25,Mexico,NA,Quintana Roo,1325578,49,6,1793,358
2020-05-26,Mexico,NA,Quintana Roo,1325578,33,6,1826,364
2020-05-27,Mexico,NA,Quintana Roo,1325578,42,7,1868,371
2020-05-28,Mexico,NA,Quintana Roo,1325578,44,7,1912,378
2020-05-29,Mexico,NA,Quintana Roo,1325578,46,8,1958,386
2020-05-30,Mexico,NA,Quintana Roo,1325578,26,8,1984,394
2020-05-31,Mexico,NA,Quintana Roo,1325578,22,7,2006,401
2020-06-01,Mexico,NA,Quintana Roo,1325578,45,12,2051,410
2020-06-02,Mexico,NA,Quintana Roo,1325578,63,7,2114,420
2020-06-03,Mexico,NA,Quintana Roo,1325578,44,4,2158,424
2020-06-04,Mexico,NA,Quintana Roo,1325578,38,5,2196,429
2020-06-05,Mexico,NA,Quintana Roo,1325578,39,8,2235,437
2020-06-06,Mexico,NA,Quintana Roo,1325578,23,9,2258,446
2020-06-07,Mexico,NA,Quintana Roo,1325578,29,12,2287,457
2020-06-08,Mexico,NA,Quintana Roo,1325578,53,6,2340,464
2020-06-09,Mexico,NA,Quintana Roo,1325578,51,7,2391,471
2020-06-10,Mexico,NA,Quintana Roo,1325578,57,8,2448,479
2020-06-11,Mexico,NA,Quintana Roo,1325578,56,4,2504,483
2020-06-12,Mexico,NA,Quintana Roo,1325578,50,6,2554,489
2020-06-13,Mexico,NA,Quintana Roo,1325578,32,7,2586,496
2020-06-14,Mexico,NA,Quintana Roo,1325578,52,6,2638,502
2020-06-15,Mexico,NA,Quintana Roo,1325578,90,5,2728,507
2020-06-16,Mexico,NA,Quintana Roo,1325578,63,6,2791,513
2020-06-17,Mexico,NA,Quintana Roo,1325578,64,7,2855,520
2020-06-18,Mexico,NA,Quintana Roo,1325578,68,6,2923,526
2020-06-19,Mexico,NA,Quintana Roo,1325578,82,5,3005,531
2020-06-20,Mexico,NA,Quintana Roo,1325578,38,5,3043,536
2020-06-21,Mexico,NA,Quintana Roo,1325578,53,8,3096,544
2020-06-22,Mexico,NA,Quintana Roo,1325578,109,9,3205,553
2020-06-23,Mexico,NA,Quintana Roo,1325578,92,6,3297,559
2020-06-24,Mexico,NA,Quintana Roo,1325578,82,8,3379,567
2020-06-25,Mexico,NA,Quintana Roo,1325578,99,10,3478,577
2020-06-26,Mexico,NA,Quintana Roo,1325578,137,10,3615,587
2020-06-27,Mexico,NA,Quintana Roo,1325578,60,6,3675,593
2020-06-28,Mexico,NA,Quintana Roo,1325578,62,10,3737,603
2020-06-29,Mexico,NA,Quintana Roo,1325578,175,13,3912,616
2020-06-30,Mexico,NA,Quintana Roo,1325578,150,9,4062,625
2020-07-01,Mexico,NA,Quintana Roo,1325578,128,11,4190,636
2020-07-02,Mexico,NA,Quintana Roo,1325578,152,8,4342,644
2020-07-03,Mexico,NA,Quintana Roo,1325578,128,13,4470,657
2020-07-04,Mexico,NA,Quintana Roo,1325578,75,6,4545,663
2020-07-05,Mexico,NA,Quintana Roo,1325578,60,17,4605,680
2020-07-06,Mexico,NA,Quintana Roo,1325578,196,11,4801,691
2020-07-07,Mexico,NA,Quintana Roo,1325578,160,14,4961,705
2020-07-08,Mexico,NA,Quintana Roo,1325578,173,13,5134,718
2020-07-09,Mexico,NA,Quintana Roo,1325578,171,23,5305,741
2020-07-10,Mexico,NA,Quintana Roo,1325578,153,21,5458,762
2020-07-11,Mexico,NA,Quintana Roo,1325578,88,16,5546,778
2020-07-12,Mexico,NA,Quintana Roo,1325578,74,15,5620,793
2020-07-13,Mexico,NA,Quintana Roo,1325578,193,12,5813,805
2020-07-14,Mexico,NA,Quintana Roo,1325578,183,19,5996,824
2020-07-15,Mexico,NA,Quintana Roo,1325578,147,12,6143,836
2020-07-16,Mexico,NA,Quintana Roo,1325578,145,11,6288,847
2020-07-17,Mexico,NA,Quintana Roo,1325578,137,23,6425,870
2020-07-18,Mexico,NA,Quintana Roo,1325578,69,13,6494,883
2020-07-19,Mexico,NA,Quintana Roo,1325578,59,15,6553,898
2020-07-20,Mexico,NA,Quintana Roo,1325578,179,27,6732,925
2020-07-21,Mexico,NA,Quintana Roo,1325578,149,24,6881,949
2020-07-22,Mexico,NA,Quintana Roo,1325578,171,14,7052,963
2020-07-23,Mexico,NA,Quintana Roo,1325578,151,16,7203,979
2020-07-24,Mexico,NA,Quintana Roo,1325578,156,16,7359,995
2020-07-25,Mexico,NA,Quintana Roo,1325578,62,14,7421,1009
2020-07-26,Mexico,NA,Quintana Roo,1325578,60,14,7481,1023
2020-07-27,Mexico,NA,Quintana Roo,1325578,175,13,7656,1036
2020-07-28,Mexico,NA,Quintana Roo,1325578,141,16,7797,1052
2020-07-29,Mexico,NA,Quintana Roo,1325578,154,12,7951,1064
2020-07-30,Mexico,NA,Quintana Roo,1325578,118,17,8069,1081
2020-07-31,Mexico,NA,Quintana Roo,1325578,124,18,8193,1099
2020-08-01,Mexico,NA,Quintana Roo,1325578,66,10,8259,1109
2020-08-02,Mexico,NA,Quintana Roo,1325578,72,19,8331,1128
2020-08-03,Mexico,NA,Quintana Roo,1325578,136,21,8467,1149
2020-08-04,Mexico,NA,Quintana Roo,1325578,124,18,8591,1167
2020-08-05,Mexico,NA,Quintana Roo,1325578,104,10,8695,1177
2020-08-06,Mexico,NA,Quintana Roo,1325578,103,13,8798,1190
2020-08-07,Mexico,NA,Quintana Roo,1325578,94,13,8892,1203
2020-08-08,Mexico,NA,Quintana Roo,1325578,35,19,8927,1222
2020-08-09,Mexico,NA,Quintana Roo,1325578,48,12,8975,1234
2020-08-10,Mexico,NA,Quintana Roo,1325578,140,18,9115,1252
2020-08-11,Mexico,NA,Quintana Roo,1325578,88,21,9203,1273
2020-08-12,Mexico,NA,Quintana Roo,1325578,96,11,9299,1284
2020-08-13,Mexico,NA,Quintana Roo,1325578,73,7,9372,1291
2020-08-14,Mexico,NA,Quintana Roo,1325578,77,8,9449,1299
2020-08-15,Mexico,NA,Quintana Roo,1325578,42,14,9491,1313
2020-08-16,Mexico,NA,Quintana Roo,1325578,53,8,9544,1321
2020-08-17,Mexico,NA,Quintana Roo,1325578,103,11,9647,1332
2020-08-18,Mexico,NA,Quintana Roo,1325578,75,13,9722,1345
2020-08-19,Mexico,NA,Quintana Roo,1325578,64,14,9786,1359
2020-08-20,Mexico,NA,Quintana Roo,1325578,70,13,9856,1372
2020-08-21,Mexico,NA,Quintana Roo,1325578,84,10,9940,1382
2020-08-22,Mexico,NA,Quintana Roo,1325578,28,11,9968,1393
2020-08-23,Mexico,NA,Quintana Roo,1325578,38,15,10006,1408
2020-08-24,Mexico,NA,Quintana Roo,1325578,116,15,10122,1423
2020-08-25,Mexico,NA,Quintana Roo,1325578,74,11,10196,1434
2020-08-26,Mexico,NA,Quintana Roo,1325578,83,11,10279,1445
2020-08-27,Mexico,NA,Quintana Roo,1325578,76,7,10355,1452
2020-08-28,Mexico,NA,Quintana Roo,1325578,66,4,10421,1456
2020-08-29,Mexico,NA,Quintana Roo,1325578,28,6,10449,1462
2020-08-30,Mexico,NA,Quintana Roo,1325578,48,10,10497,1472
2020-08-31,Mexico,NA,Quintana Roo,1325578,91,6,10588,1478
2020-09-01,Mexico,NA,Quintana Roo,1325578,74,3,10662,1481
2020-09-02,Mexico,NA,Quintana Roo,1325578,63,7,10725,1488
2020-09-03,Mexico,NA,Quintana Roo,1325578,51,13,10776,1501
2020-09-04,Mexico,NA,Quintana Roo,1325578,50,8,10826,1509
2020-09-05,Mexico,NA,Quintana Roo,1325578,26,6,10852,1515
2020-09-06,Mexico,NA,Quintana Roo,1325578,26,4,10878,1519
2020-09-07,Mexico,NA,Quintana Roo,1325578,83,11,10961,1530
2020-09-08,Mexico,NA,Quintana Roo,1325578,68,4,11029,1534
2020-09-09,Mexico,NA,Quintana Roo,1325578,48,6,11077,1540
2020-09-10,Mexico,NA,Quintana Roo,1325578,47,7,11124,1547
2020-09-11,Mexico,NA,Quintana Roo,1325578,28,3,11152,1550
2020-09-12,Mexico,NA,Quintana Roo,1325578,18,6,11170,1556
2020-09-13,Mexico,NA,Quintana Roo,1325578,15,10,11185,1566
2020-09-14,Mexico,NA,Quintana Roo,1325578,63,5,11248,1571
2020-09-15,Mexico,NA,Quintana Roo,1325578,41,6,11289,1577
2020-09-16,Mexico,NA,Quintana Roo,1325578,21,6,11310,1583
2020-09-17,Mexico,NA,Quintana Roo,1325578,57,4,11367,1587
2020-09-18,Mexico,NA,Quintana Roo,1325578,55,9,11422,1596
2020-09-19,Mexico,NA,Quintana Roo,1325578,32,3,11454,1599
2020-09-20,Mexico,NA,Quintana Roo,1325578,17,6,11471,1605
2020-09-21,Mexico,NA,Quintana Roo,1325578,55,7,11526,1612
2020-09-22,Mexico,NA,Quintana Roo,1325578,28,8,11554,1620
2020-09-23,Mexico,NA,Quintana Roo,1325578,1,2,11555,1622
2020-03-19,Mexico,NA,San Luis Potosi,2585518,3,0,12,0
2020-03-20,Mexico,NA,San Luis Potosi,2585518,3,0,15,0
2020-03-21,Mexico,NA,San Luis Potosi,2585518,4,0,19,0
2020-03-22,Mexico,NA,San Luis Potosi,2585518,1,0,20,0
2020-03-23,Mexico,NA,San Luis Potosi,2585518,2,0,22,0
2020-03-24,Mexico,NA,San Luis Potosi,2585518,0,1,22,1
2020-03-25,Mexico,NA,San Luis Potosi,2585518,0,1,22,2
2020-03-26,Mexico,NA,San Luis Potosi,2585518,1,0,23,2
2020-03-27,Mexico,NA,San Luis Potosi,2585518,7,0,30,2
2020-03-29,Mexico,NA,San Luis Potosi,2585518,6,0,36,2
2020-03-30,Mexico,NA,San Luis Potosi,2585518,3,1,39,3
2020-03-31,Mexico,NA,San Luis Potosi,2585518,2,0,41,3
2020-04-04,Mexico,NA,San Luis Potosi,2585518,3,0,44,3
2020-04-05,Mexico,NA,San Luis Potosi,2585518,2,0,46,3
2020-04-06,Mexico,NA,San Luis Potosi,2585518,3,1,49,4
2020-04-07,Mexico,NA,San Luis Potosi,2585518,5,0,54,4
2020-04-08,Mexico,NA,San Luis Potosi,2585518,2,0,56,4
2020-04-09,Mexico,NA,San Luis Potosi,2585518,4,0,60,4
2020-04-10,Mexico,NA,San Luis Potosi,2585518,1,0,61,4
2020-04-11,Mexico,NA,San Luis Potosi,2585518,3,0,64,4
2020-04-13,Mexico,NA,San Luis Potosi,2585518,1,0,65,4
2020-04-14,Mexico,NA,San Luis Potosi,2585518,1,0,66,4
2020-04-15,Mexico,NA,San Luis Potosi,2585518,2,0,68,4
2020-04-16,Mexico,NA,San Luis Potosi,2585518,2,0,70,4
2020-04-17,Mexico,NA,San Luis Potosi,2585518,8,1,78,5
2020-04-18,Mexico,NA,San Luis Potosi,2585518,1,1,79,6
2020-04-20,Mexico,NA,San Luis Potosi,2585518,1,0,80,6
2020-04-21,Mexico,NA,San Luis Potosi,2585518,3,0,83,6
2020-04-22,Mexico,NA,San Luis Potosi,2585518,3,0,86,6
2020-04-23,Mexico,NA,San Luis Potosi,2585518,5,1,91,7
2020-04-24,Mexico,NA,San Luis Potosi,2585518,6,0,97,7
2020-04-25,Mexico,NA,San Luis Potosi,2585518,8,0,105,7
2020-04-26,Mexico,NA,San Luis Potosi,2585518,3,1,108,8
2020-04-27,Mexico,NA,San Luis Potosi,2585518,14,0,122,8
2020-04-28,Mexico,NA,San Luis Potosi,2585518,18,0,140,8
2020-04-29,Mexico,NA,San Luis Potosi,2585518,9,1,149,9
2020-04-30,Mexico,NA,San Luis Potosi,2585518,10,1,159,10
2020-05-01,Mexico,NA,San Luis Potosi,2585518,14,0,173,10
2020-05-02,Mexico,NA,San Luis Potosi,2585518,14,0,187,10
2020-05-03,Mexico,NA,San Luis Potosi,2585518,10,1,197,11
2020-05-04,Mexico,NA,San Luis Potosi,2585518,27,2,224,13
2020-05-05,Mexico,NA,San Luis Potosi,2585518,16,1,240,14
2020-05-06,Mexico,NA,San Luis Potosi,2585518,34,1,274,15
2020-05-07,Mexico,NA,San Luis Potosi,2585518,13,1,287,16
2020-05-08,Mexico,NA,San Luis Potosi,2585518,26,1,313,17
2020-05-09,Mexico,NA,San Luis Potosi,2585518,12,1,325,18
2020-05-10,Mexico,NA,San Luis Potosi,2585518,19,0,344,18
2020-05-11,Mexico,NA,San Luis Potosi,2585518,31,1,375,19
2020-05-12,Mexico,NA,San Luis Potosi,2585518,23,1,398,20
2020-05-13,Mexico,NA,San Luis Potosi,2585518,25,0,423,20
2020-05-14,Mexico,NA,San Luis Potosi,2585518,35,1,458,21
2020-05-15,Mexico,NA,San Luis Potosi,2585518,27,2,485,23
2020-05-16,Mexico,NA,San Luis Potosi,2585518,25,4,510,27
2020-05-17,Mexico,NA,San Luis Potosi,2585518,15,5,525,32
2020-05-18,Mexico,NA,San Luis Potosi,2585518,34,2,559,34
2020-05-19,Mexico,NA,San Luis Potosi,2585518,27,0,586,34
2020-05-20,Mexico,NA,San Luis Potosi,2585518,40,3,626,37
2020-05-21,Mexico,NA,San Luis Potosi,2585518,37,1,663,38
2020-05-22,Mexico,NA,San Luis Potosi,2585518,55,2,718,40
2020-05-23,Mexico,NA,San Luis Potosi,2585518,20,3,738,43
2020-05-24,Mexico,NA,San Luis Potosi,2585518,21,2,759,45
2020-05-25,Mexico,NA,San Luis Potosi,2585518,49,3,808,48
2020-05-26,Mexico,NA,San Luis Potosi,2585518,39,3,847,51
2020-05-27,Mexico,NA,San Luis Potosi,2585518,60,1,907,52
2020-05-28,Mexico,NA,San Luis Potosi,2585518,38,1,945,53
2020-05-29,Mexico,NA,San Luis Potosi,2585518,50,2,995,55
2020-05-30,Mexico,NA,San Luis Potosi,2585518,24,2,1019,57
2020-05-31,Mexico,NA,San Luis Potosi,2585518,18,4,1037,61
2020-06-01,Mexico,NA,San Luis Potosi,2585518,52,6,1089,67
2020-06-02,Mexico,NA,San Luis Potosi,2585518,54,1,1143,68
2020-06-03,Mexico,NA,San Luis Potosi,2585518,77,5,1220,73
2020-06-04,Mexico,NA,San Luis Potosi,2585518,80,5,1300,78
2020-06-05,Mexico,NA,San Luis Potosi,2585518,76,2,1376,80
2020-06-06,Mexico,NA,San Luis Potosi,2585518,59,8,1435,88
2020-06-07,Mexico,NA,San Luis Potosi,2585518,49,6,1484,94
2020-06-08,Mexico,NA,San Luis Potosi,2585518,115,6,1599,100
2020-06-09,Mexico,NA,San Luis Potosi,2585518,93,3,1692,103
2020-06-10,Mexico,NA,San Luis Potosi,2585518,85,4,1777,107
2020-06-11,Mexico,NA,San Luis Potosi,2585518,78,8,1855,115
2020-06-12,Mexico,NA,San Luis Potosi,2585518,60,4,1915,119
2020-06-13,Mexico,NA,San Luis Potosi,2585518,31,2,1946,121
2020-06-14,Mexico,NA,San Luis Potosi,2585518,23,2,1969,123
2020-06-15,Mexico,NA,San Luis Potosi,2585518,115,0,2084,123
2020-06-16,Mexico,NA,San Luis Potosi,2585518,102,7,2186,130
2020-06-17,Mexico,NA,San Luis Potosi,2585518,114,2,2300,132
2020-06-18,Mexico,NA,San Luis Potosi,2585518,94,2,2394,134
2020-06-19,Mexico,NA,San Luis Potosi,2585518,98,3,2492,137
2020-06-20,Mexico,NA,San Luis Potosi,2585518,51,5,2543,142
2020-06-21,Mexico,NA,San Luis Potosi,2585518,40,7,2583,149
2020-06-22,Mexico,NA,San Luis Potosi,2585518,125,7,2708,156
2020-06-23,Mexico,NA,San Luis Potosi,2585518,129,6,2837,162
2020-06-24,Mexico,NA,San Luis Potosi,2585518,118,12,2955,174
2020-06-25,Mexico,NA,San Luis Potosi,2585518,124,10,3079,184
2020-06-26,Mexico,NA,San Luis Potosi,2585518,108,7,3187,191
2020-06-27,Mexico,NA,San Luis Potosi,2585518,95,4,3282,195
2020-06-28,Mexico,NA,San Luis Potosi,2585518,43,8,3325,203
2020-06-29,Mexico,NA,San Luis Potosi,2585518,140,4,3465,207
2020-06-30,Mexico,NA,San Luis Potosi,2585518,142,11,3607,218
2020-07-01,Mexico,NA,San Luis Potosi,2585518,148,8,3755,226
2020-07-02,Mexico,NA,San Luis Potosi,2585518,155,3,3910,229
2020-07-03,Mexico,NA,San Luis Potosi,2585518,170,5,4080,234
2020-07-04,Mexico,NA,San Luis Potosi,2585518,78,3,4158,237
2020-07-05,Mexico,NA,San Luis Potosi,2585518,56,7,4214,244
2020-07-06,Mexico,NA,San Luis Potosi,2585518,210,12,4424,256
2020-07-07,Mexico,NA,San Luis Potosi,2585518,194,10,4618,266
2020-07-08,Mexico,NA,San Luis Potosi,2585518,204,7,4822,273
2020-07-09,Mexico,NA,San Luis Potosi,2585518,231,10,5053,283
2020-07-10,Mexico,NA,San Luis Potosi,2585518,270,12,5323,295
2020-07-11,Mexico,NA,San Luis Potosi,2585518,177,6,5500,301
2020-07-12,Mexico,NA,San Luis Potosi,2585518,105,13,5605,314
2020-07-13,Mexico,NA,San Luis Potosi,2585518,356,15,5961,329
2020-07-14,Mexico,NA,San Luis Potosi,2585518,354,16,6315,345
2020-07-15,Mexico,NA,San Luis Potosi,2585518,420,17,6735,362
2020-07-16,Mexico,NA,San Luis Potosi,2585518,361,23,7096,385
2020-07-17,Mexico,NA,San Luis Potosi,2585518,405,16,7501,401
2020-07-18,Mexico,NA,San Luis Potosi,2585518,219,11,7720,412
2020-07-19,Mexico,NA,San Luis Potosi,2585518,241,18,7961,430
2020-07-20,Mexico,NA,San Luis Potosi,2585518,420,18,8381,448
2020-07-21,Mexico,NA,San Luis Potosi,2585518,411,23,8792,471
2020-07-22,Mexico,NA,San Luis Potosi,2585518,384,27,9176,498
2020-07-23,Mexico,NA,San Luis Potosi,2585518,399,32,9575,530
2020-07-24,Mexico,NA,San Luis Potosi,2585518,396,21,9971,551
2020-07-25,Mexico,NA,San Luis Potosi,2585518,246,24,10217,575
2020-07-26,Mexico,NA,San Luis Potosi,2585518,142,17,10359,592
2020-07-27,Mexico,NA,San Luis Potosi,2585518,398,22,10757,614
2020-07-28,Mexico,NA,San Luis Potosi,2585518,407,33,11164,647
2020-07-29,Mexico,NA,San Luis Potosi,2585518,374,17,11538,664
2020-07-30,Mexico,NA,San Luis Potosi,2585518,297,22,11835,686
2020-07-31,Mexico,NA,San Luis Potosi,2585518,344,27,12179,713
2020-08-01,Mexico,NA,San Luis Potosi,2585518,201,16,12380,729
2020-08-02,Mexico,NA,San Luis Potosi,2585518,124,23,12504,752
2020-08-03,Mexico,NA,San Luis Potosi,2585518,347,30,12851,782
2020-08-04,Mexico,NA,San Luis Potosi,2585518,335,25,13186,807
2020-08-05,Mexico,NA,San Luis Potosi,2585518,354,27,13540,834
2020-08-06,Mexico,NA,San Luis Potosi,2585518,342,22,13882,856
2020-08-07,Mexico,NA,San Luis Potosi,2585518,285,23,14167,879
2020-08-08,Mexico,NA,San Luis Potosi,2585518,183,23,14350,902
2020-08-09,Mexico,NA,San Luis Potosi,2585518,113,24,14463,926
2020-08-10,Mexico,NA,San Luis Potosi,2585518,294,23,14757,949
2020-08-11,Mexico,NA,San Luis Potosi,2585518,252,31,15009,980
2020-08-12,Mexico,NA,San Luis Potosi,2585518,273,26,15282,1006
2020-08-13,Mexico,NA,San Luis Potosi,2585518,250,24,15532,1030
2020-08-14,Mexico,NA,San Luis Potosi,2585518,267,30,15799,1060
2020-08-15,Mexico,NA,San Luis Potosi,2585518,147,16,15946,1076
2020-08-16,Mexico,NA,San Luis Potosi,2585518,149,11,16095,1087
2020-08-17,Mexico,NA,San Luis Potosi,2585518,315,23,16410,1110
2020-08-18,Mexico,NA,San Luis Potosi,2585518,280,15,16690,1125
2020-08-19,Mexico,NA,San Luis Potosi,2585518,275,11,16965,1136
2020-08-20,Mexico,NA,San Luis Potosi,2585518,261,24,17226,1160
2020-08-21,Mexico,NA,San Luis Potosi,2585518,283,18,17509,1178
2020-08-22,Mexico,NA,San Luis Potosi,2585518,160,21,17669,1199
2020-08-23,Mexico,NA,San Luis Potosi,2585518,99,11,17768,1210
2020-08-24,Mexico,NA,San Luis Potosi,2585518,295,32,18063,1242
2020-08-25,Mexico,NA,San Luis Potosi,2585518,246,23,18309,1265
2020-08-26,Mexico,NA,San Luis Potosi,2585518,274,16,18583,1281
2020-08-27,Mexico,NA,San Luis Potosi,2585518,193,19,18776,1300
2020-08-28,Mexico,NA,San Luis Potosi,2585518,184,18,18960,1318
2020-08-29,Mexico,NA,San Luis Potosi,2585518,111,11,19071,1329
2020-08-30,Mexico,NA,San Luis Potosi,2585518,108,19,19179,1348
2020-08-31,Mexico,NA,San Luis Potosi,2585518,265,14,19444,1362
2020-09-01,Mexico,NA,San Luis Potosi,2585518,223,14,19667,1376
2020-09-02,Mexico,NA,San Luis Potosi,2585518,259,27,19926,1403
2020-09-03,Mexico,NA,San Luis Potosi,2585518,194,10,20120,1413
2020-09-04,Mexico,NA,San Luis Potosi,2585518,177,13,20297,1426
2020-09-05,Mexico,NA,San Luis Potosi,2585518,83,17,20380,1443
2020-09-06,Mexico,NA,San Luis Potosi,2585518,60,16,20440,1459
2020-09-07,Mexico,NA,San Luis Potosi,2585518,200,16,20640,1475
2020-09-08,Mexico,NA,San Luis Potosi,2585518,168,18,20808,1493
2020-09-09,Mexico,NA,San Luis Potosi,2585518,163,15,20971,1508
2020-09-10,Mexico,NA,San Luis Potosi,2585518,151,9,21122,1517
2020-09-11,Mexico,NA,San Luis Potosi,2585518,148,9,21270,1526
2020-09-12,Mexico,NA,San Luis Potosi,2585518,57,7,21327,1533
2020-09-13,Mexico,NA,San Luis Potosi,2585518,65,11,21392,1544
2020-09-14,Mexico,NA,San Luis Potosi,2585518,196,11,21588,1555
2020-09-15,Mexico,NA,San Luis Potosi,2585518,130,21,21718,1576
2020-09-16,Mexico,NA,San Luis Potosi,2585518,67,8,21785,1584
2020-09-17,Mexico,NA,San Luis Potosi,2585518,121,5,21906,1589
2020-09-18,Mexico,NA,San Luis Potosi,2585518,149,11,22055,1600
2020-09-19,Mexico,NA,San Luis Potosi,2585518,70,3,22125,1603
2020-09-20,Mexico,NA,San Luis Potosi,2585518,28,9,22153,1612
2020-09-21,Mexico,NA,San Luis Potosi,2585518,28,8,22181,1620
2020-09-22,Mexico,NA,San Luis Potosi,2585518,10,5,22191,1625
2020-09-23,Mexico,NA,San Luis Potosi,2585518,2,1,22193,1626
2020-03-23,Mexico,NA,Sinaloa,2767761,3,0,11,0
2020-03-24,Mexico,NA,Sinaloa,2767761,7,0,18,0
2020-03-25,Mexico,NA,Sinaloa,2767761,8,0,26,0
2020-03-26,Mexico,NA,Sinaloa,2767761,9,1,35,1
2020-03-27,Mexico,NA,Sinaloa,2767761,10,0,45,1
2020-03-28,Mexico,NA,Sinaloa,2767761,7,1,52,2
2020-03-29,Mexico,NA,Sinaloa,2767761,7,1,59,3
2020-03-30,Mexico,NA,Sinaloa,2767761,12,0,71,3
2020-03-31,Mexico,NA,Sinaloa,2767761,16,1,87,4
2020-04-01,Mexico,NA,Sinaloa,2767761,14,2,101,6
2020-04-02,Mexico,NA,Sinaloa,2767761,28,3,129,9
2020-04-03,Mexico,NA,Sinaloa,2767761,10,2,139,11
2020-04-04,Mexico,NA,Sinaloa,2767761,14,5,153,16
2020-04-05,Mexico,NA,Sinaloa,2767761,15,0,168,16
2020-04-06,Mexico,NA,Sinaloa,2767761,32,1,200,17
2020-04-07,Mexico,NA,Sinaloa,2767761,23,3,223,20
2020-04-08,Mexico,NA,Sinaloa,2767761,29,6,252,26
2020-04-09,Mexico,NA,Sinaloa,2767761,12,7,264,33
2020-04-10,Mexico,NA,Sinaloa,2767761,33,10,297,43
2020-04-11,Mexico,NA,Sinaloa,2767761,25,8,322,51
2020-04-12,Mexico,NA,Sinaloa,2767761,23,7,345,58
2020-04-13,Mexico,NA,Sinaloa,2767761,51,8,396,66
2020-04-14,Mexico,NA,Sinaloa,2767761,47,5,443,71
2020-04-15,Mexico,NA,Sinaloa,2767761,51,6,494,77
2020-04-16,Mexico,NA,Sinaloa,2767761,41,4,535,81
2020-04-17,Mexico,NA,Sinaloa,2767761,44,5,579,86
2020-04-18,Mexico,NA,Sinaloa,2767761,34,5,613,91
2020-04-19,Mexico,NA,Sinaloa,2767761,32,4,645,95
2020-04-20,Mexico,NA,Sinaloa,2767761,64,10,709,105
2020-04-21,Mexico,NA,Sinaloa,2767761,47,6,756,111
2020-04-22,Mexico,NA,Sinaloa,2767761,53,8,809,119
2020-04-23,Mexico,NA,Sinaloa,2767761,68,7,877,126
2020-04-24,Mexico,NA,Sinaloa,2767761,70,6,947,132
2020-04-25,Mexico,NA,Sinaloa,2767761,50,11,997,143
2020-04-26,Mexico,NA,Sinaloa,2767761,38,10,1035,153
2020-04-27,Mexico,NA,Sinaloa,2767761,82,10,1117,163
2020-04-28,Mexico,NA,Sinaloa,2767761,46,8,1163,171
2020-04-29,Mexico,NA,Sinaloa,2767761,55,11,1218,182
2020-04-30,Mexico,NA,Sinaloa,2767761,57,12,1275,194
2020-05-01,Mexico,NA,Sinaloa,2767761,58,16,1333,210
2020-05-02,Mexico,NA,Sinaloa,2767761,48,6,1381,216
2020-05-03,Mexico,NA,Sinaloa,2767761,32,9,1413,225
2020-05-04,Mexico,NA,Sinaloa,2767761,78,12,1491,237
2020-05-05,Mexico,NA,Sinaloa,2767761,54,21,1545,258
2020-05-06,Mexico,NA,Sinaloa,2767761,85,6,1630,264
2020-05-07,Mexico,NA,Sinaloa,2767761,64,13,1694,277
2020-05-08,Mexico,NA,Sinaloa,2767761,62,11,1756,288
2020-05-09,Mexico,NA,Sinaloa,2767761,53,4,1809,292
2020-05-10,Mexico,NA,Sinaloa,2767761,41,6,1850,298
2020-05-11,Mexico,NA,Sinaloa,2767761,69,13,1919,311
2020-05-12,Mexico,NA,Sinaloa,2767761,85,15,2004,326
2020-05-13,Mexico,NA,Sinaloa,2767761,78,4,2082,330
2020-05-14,Mexico,NA,Sinaloa,2767761,98,17,2180,347
2020-05-15,Mexico,NA,Sinaloa,2767761,96,17,2276,364
2020-05-16,Mexico,NA,Sinaloa,2767761,68,14,2344,378
2020-05-17,Mexico,NA,Sinaloa,2767761,65,19,2409,397
2020-05-18,Mexico,NA,Sinaloa,2767761,141,18,2550,415
2020-05-19,Mexico,NA,Sinaloa,2767761,104,15,2654,430
2020-05-20,Mexico,NA,Sinaloa,2767761,121,15,2775,445
2020-05-21,Mexico,NA,Sinaloa,2767761,116,24,2891,469
2020-05-22,Mexico,NA,Sinaloa,2767761,142,16,3033,485
2020-05-23,Mexico,NA,Sinaloa,2767761,60,19,3093,504
2020-05-24,Mexico,NA,Sinaloa,2767761,80,15,3173,519
2020-05-25,Mexico,NA,Sinaloa,2767761,169,18,3342,537
2020-05-26,Mexico,NA,Sinaloa,2767761,182,17,3524,554
2020-05-27,Mexico,NA,Sinaloa,2767761,191,28,3715,582
2020-05-28,Mexico,NA,Sinaloa,2767761,159,23,3874,605
2020-05-29,Mexico,NA,Sinaloa,2767761,182,22,4056,627
2020-05-30,Mexico,NA,Sinaloa,2767761,131,23,4187,650
2020-05-31,Mexico,NA,Sinaloa,2767761,69,28,4256,678
2020-06-01,Mexico,NA,Sinaloa,2767761,207,30,4463,708
2020-06-02,Mexico,NA,Sinaloa,2767761,173,27,4636,735
2020-06-03,Mexico,NA,Sinaloa,2767761,211,40,4847,775
2020-06-04,Mexico,NA,Sinaloa,2767761,190,27,5037,802
2020-06-05,Mexico,NA,Sinaloa,2767761,215,34,5252,836
2020-06-06,Mexico,NA,Sinaloa,2767761,153,25,5405,861
2020-06-07,Mexico,NA,Sinaloa,2767761,102,31,5507,892
2020-06-08,Mexico,NA,Sinaloa,2767761,211,37,5718,929
2020-06-09,Mexico,NA,Sinaloa,2767761,240,20,5958,949
2020-06-10,Mexico,NA,Sinaloa,2767761,225,22,6183,971
2020-06-11,Mexico,NA,Sinaloa,2767761,231,21,6414,992
2020-06-12,Mexico,NA,Sinaloa,2767761,291,48,6705,1040
2020-06-13,Mexico,NA,Sinaloa,2767761,91,26,6796,1066
2020-06-14,Mexico,NA,Sinaloa,2767761,85,26,6881,1092
2020-06-15,Mexico,NA,Sinaloa,2767761,187,31,7068,1123
2020-06-16,Mexico,NA,Sinaloa,2767761,207,30,7275,1153
2020-06-17,Mexico,NA,Sinaloa,2767761,191,31,7466,1184
2020-06-18,Mexico,NA,Sinaloa,2767761,163,28,7629,1212
2020-06-19,Mexico,NA,Sinaloa,2767761,173,22,7802,1234
2020-06-20,Mexico,NA,Sinaloa,2767761,136,24,7938,1258
2020-06-21,Mexico,NA,Sinaloa,2767761,85,34,8023,1292
2020-06-22,Mexico,NA,Sinaloa,2767761,209,33,8232,1325
2020-06-23,Mexico,NA,Sinaloa,2767761,198,31,8430,1356
2020-06-24,Mexico,NA,Sinaloa,2767761,207,29,8637,1385
2020-06-25,Mexico,NA,Sinaloa,2767761,137,30,8774,1415
2020-06-26,Mexico,NA,Sinaloa,2767761,182,27,8956,1442
2020-06-27,Mexico,NA,Sinaloa,2767761,94,35,9050,1477
2020-06-28,Mexico,NA,Sinaloa,2767761,80,30,9130,1507
2020-06-29,Mexico,NA,Sinaloa,2767761,172,29,9302,1536
2020-06-30,Mexico,NA,Sinaloa,2767761,168,22,9470,1558
2020-07-01,Mexico,NA,Sinaloa,2767761,188,20,9658,1578
2020-07-02,Mexico,NA,Sinaloa,2767761,149,25,9807,1603
2020-07-03,Mexico,NA,Sinaloa,2767761,161,36,9968,1639
2020-07-04,Mexico,NA,Sinaloa,2767761,95,27,10063,1666
2020-07-05,Mexico,NA,Sinaloa,2767761,83,41,10146,1707
2020-07-06,Mexico,NA,Sinaloa,2767761,150,30,10296,1737
2020-07-07,Mexico,NA,Sinaloa,2767761,183,30,10479,1767
2020-07-08,Mexico,NA,Sinaloa,2767761,171,29,10650,1796
2020-07-09,Mexico,NA,Sinaloa,2767761,156,34,10806,1830
2020-07-10,Mexico,NA,Sinaloa,2767761,161,15,10967,1845
2020-07-11,Mexico,NA,Sinaloa,2767761,90,22,11057,1867
2020-07-12,Mexico,NA,Sinaloa,2767761,98,29,11155,1896
2020-07-13,Mexico,NA,Sinaloa,2767761,190,37,11345,1933
2020-07-14,Mexico,NA,Sinaloa,2767761,176,29,11521,1962
2020-07-15,Mexico,NA,Sinaloa,2767761,163,33,11684,1995
2020-07-16,Mexico,NA,Sinaloa,2767761,128,24,11812,2019
2020-07-17,Mexico,NA,Sinaloa,2767761,143,33,11955,2052
2020-07-18,Mexico,NA,Sinaloa,2767761,74,22,12029,2074
2020-07-19,Mexico,NA,Sinaloa,2767761,52,38,12081,2112
2020-07-20,Mexico,NA,Sinaloa,2767761,143,30,12224,2142
2020-07-21,Mexico,NA,Sinaloa,2767761,132,18,12356,2160
2020-07-22,Mexico,NA,Sinaloa,2767761,127,23,12483,2183
2020-07-23,Mexico,NA,Sinaloa,2767761,129,23,12612,2206
2020-07-24,Mexico,NA,Sinaloa,2767761,121,23,12733,2229
2020-07-25,Mexico,NA,Sinaloa,2767761,71,25,12804,2254
2020-07-26,Mexico,NA,Sinaloa,2767761,78,28,12882,2282
2020-07-27,Mexico,NA,Sinaloa,2767761,193,31,13075,2313
2020-07-28,Mexico,NA,Sinaloa,2767761,149,18,13224,2331
2020-07-29,Mexico,NA,Sinaloa,2767761,140,20,13364,2351
2020-07-30,Mexico,NA,Sinaloa,2767761,130,16,13494,2367
2020-07-31,Mexico,NA,Sinaloa,2767761,102,26,13596,2393
2020-08-01,Mexico,NA,Sinaloa,2767761,73,21,13669,2414
2020-08-02,Mexico,NA,Sinaloa,2767761,49,9,13718,2423
2020-08-03,Mexico,NA,Sinaloa,2767761,158,19,13876,2442
2020-08-04,Mexico,NA,Sinaloa,2767761,126,29,14002,2471
2020-08-05,Mexico,NA,Sinaloa,2767761,115,14,14117,2485
2020-08-06,Mexico,NA,Sinaloa,2767761,123,21,14240,2506
2020-08-07,Mexico,NA,Sinaloa,2767761,112,23,14352,2529
2020-08-08,Mexico,NA,Sinaloa,2767761,68,14,14420,2543
2020-08-09,Mexico,NA,Sinaloa,2767761,59,27,14479,2570
2020-08-10,Mexico,NA,Sinaloa,2767761,129,14,14608,2584
2020-08-11,Mexico,NA,Sinaloa,2767761,108,14,14716,2598
2020-08-12,Mexico,NA,Sinaloa,2767761,117,18,14833,2616
2020-08-13,Mexico,NA,Sinaloa,2767761,114,22,14947,2638
2020-08-14,Mexico,NA,Sinaloa,2767761,109,15,15056,2653
2020-08-15,Mexico,NA,Sinaloa,2767761,56,6,15112,2659
2020-08-16,Mexico,NA,Sinaloa,2767761,42,12,15154,2671
2020-08-17,Mexico,NA,Sinaloa,2767761,122,18,15276,2689
2020-08-18,Mexico,NA,Sinaloa,2767761,115,12,15391,2701
2020-08-19,Mexico,NA,Sinaloa,2767761,133,22,15524,2723
2020-08-20,Mexico,NA,Sinaloa,2767761,109,20,15633,2743
2020-08-21,Mexico,NA,Sinaloa,2767761,103,14,15736,2757
2020-08-22,Mexico,NA,Sinaloa,2767761,47,19,15783,2776
2020-08-23,Mexico,NA,Sinaloa,2767761,50,11,15833,2787
2020-08-24,Mexico,NA,Sinaloa,2767761,110,16,15943,2803
2020-08-25,Mexico,NA,Sinaloa,2767761,123,14,16066,2817
2020-08-26,Mexico,NA,Sinaloa,2767761,126,8,16192,2825
2020-08-27,Mexico,NA,Sinaloa,2767761,100,10,16292,2835
2020-08-28,Mexico,NA,Sinaloa,2767761,101,12,16393,2847
2020-08-29,Mexico,NA,Sinaloa,2767761,48,14,16441,2861
2020-08-30,Mexico,NA,Sinaloa,2767761,47,16,16488,2877
2020-08-31,Mexico,NA,Sinaloa,2767761,121,13,16609,2890
2020-09-01,Mexico,NA,Sinaloa,2767761,137,10,16746,2900
2020-09-02,Mexico,NA,Sinaloa,2767761,147,8,16893,2908
2020-09-03,Mexico,NA,Sinaloa,2767761,76,16,16969,2924
2020-09-04,Mexico,NA,Sinaloa,2767761,114,11,17083,2935
2020-09-05,Mexico,NA,Sinaloa,2767761,31,14,17114,2949
2020-09-06,Mexico,NA,Sinaloa,2767761,41,10,17155,2959
2020-09-07,Mexico,NA,Sinaloa,2767761,105,15,17260,2974
2020-09-08,Mexico,NA,Sinaloa,2767761,102,6,17362,2980
2020-09-09,Mexico,NA,Sinaloa,2767761,84,10,17446,2990
2020-09-10,Mexico,NA,Sinaloa,2767761,91,16,17537,3006
2020-09-11,Mexico,NA,Sinaloa,2767761,98,10,17635,3016
2020-09-12,Mexico,NA,Sinaloa,2767761,41,12,17676,3028
2020-09-13,Mexico,NA,Sinaloa,2767761,35,9,17711,3037
2020-09-14,Mexico,NA,Sinaloa,2767761,125,7,17836,3044
2020-09-15,Mexico,NA,Sinaloa,2767761,48,7,17884,3051
2020-09-16,Mexico,NA,Sinaloa,2767761,28,13,17912,3064
2020-09-17,Mexico,NA,Sinaloa,2767761,98,6,18010,3070
2020-09-18,Mexico,NA,Sinaloa,2767761,84,6,18094,3076
2020-09-19,Mexico,NA,Sinaloa,2767761,22,11,18116,3087
2020-09-20,Mexico,NA,Sinaloa,2767761,12,7,18128,3094
2020-09-21,Mexico,NA,Sinaloa,2767761,53,6,18181,3100
2020-09-22,Mexico,NA,Sinaloa,2767761,9,7,18190,3107
2020-09-23,Mexico,NA,Sinaloa,2767761,7,0,18197,3107
2020-03-24,Mexico,NA,Sonora,2662480,4,0,12,0
2020-03-25,Mexico,NA,Sonora,2662480,3,0,15,0
2020-03-26,Mexico,NA,Sonora,2662480,1,0,16,0
2020-03-27,Mexico,NA,Sonora,2662480,5,0,21,0
2020-03-28,Mexico,NA,Sonora,2662480,4,0,25,0
2020-03-30,Mexico,NA,Sonora,2662480,2,1,27,1
2020-03-31,Mexico,NA,Sonora,2662480,5,0,32,1
2020-04-01,Mexico,NA,Sonora,2662480,1,0,33,1
2020-04-02,Mexico,NA,Sonora,2662480,3,0,36,1
2020-04-03,Mexico,NA,Sonora,2662480,1,0,37,1
2020-04-04,Mexico,NA,Sonora,2662480,7,0,44,1
2020-04-05,Mexico,NA,Sonora,2662480,2,2,46,3
2020-04-06,Mexico,NA,Sonora,2662480,11,1,57,4
2020-04-07,Mexico,NA,Sonora,2662480,14,1,71,5
2020-04-08,Mexico,NA,Sonora,2662480,16,1,87,6
2020-04-09,Mexico,NA,Sonora,2662480,7,1,94,7
2020-04-10,Mexico,NA,Sonora,2662480,7,0,101,7
2020-04-11,Mexico,NA,Sonora,2662480,6,1,107,8
2020-04-12,Mexico,NA,Sonora,2662480,3,3,110,11
2020-04-13,Mexico,NA,Sonora,2662480,18,0,128,11
2020-04-14,Mexico,NA,Sonora,2662480,9,1,137,12
2020-04-15,Mexico,NA,Sonora,2662480,13,2,150,14
2020-04-16,Mexico,NA,Sonora,2662480,15,0,165,14
2020-04-17,Mexico,NA,Sonora,2662480,15,1,180,15
2020-04-18,Mexico,NA,Sonora,2662480,14,0,194,15
2020-04-19,Mexico,NA,Sonora,2662480,7,2,201,17
2020-04-20,Mexico,NA,Sonora,2662480,9,3,210,20
2020-04-21,Mexico,NA,Sonora,2662480,15,3,225,23
2020-04-22,Mexico,NA,Sonora,2662480,22,3,247,26
2020-04-23,Mexico,NA,Sonora,2662480,9,1,256,27
2020-04-24,Mexico,NA,Sonora,2662480,21,1,277,28
2020-04-25,Mexico,NA,Sonora,2662480,9,1,286,29
2020-04-26,Mexico,NA,Sonora,2662480,15,0,301,29
2020-04-27,Mexico,NA,Sonora,2662480,35,3,336,32
2020-04-28,Mexico,NA,Sonora,2662480,15,1,351,33
2020-04-29,Mexico,NA,Sonora,2662480,17,3,368,36
2020-04-30,Mexico,NA,Sonora,2662480,34,1,402,37
2020-05-01,Mexico,NA,Sonora,2662480,24,1,426,38
2020-05-02,Mexico,NA,Sonora,2662480,32,3,458,41
2020-05-03,Mexico,NA,Sonora,2662480,26,1,484,42
2020-05-04,Mexico,NA,Sonora,2662480,67,2,551,44
2020-05-05,Mexico,NA,Sonora,2662480,64,0,615,44
2020-05-06,Mexico,NA,Sonora,2662480,46,0,661,44
2020-05-07,Mexico,NA,Sonora,2662480,44,4,705,48
2020-05-08,Mexico,NA,Sonora,2662480,58,2,763,50
2020-05-09,Mexico,NA,Sonora,2662480,53,2,816,52
2020-05-10,Mexico,NA,Sonora,2662480,29,4,845,56
2020-05-11,Mexico,NA,Sonora,2662480,81,4,926,60
2020-05-12,Mexico,NA,Sonora,2662480,77,1,1003,61
2020-05-13,Mexico,NA,Sonora,2662480,113,4,1116,65
2020-05-14,Mexico,NA,Sonora,2662480,86,7,1202,72
2020-05-15,Mexico,NA,Sonora,2662480,109,5,1311,77
2020-05-16,Mexico,NA,Sonora,2662480,69,7,1380,84
2020-05-17,Mexico,NA,Sonora,2662480,62,9,1442,93
2020-05-18,Mexico,NA,Sonora,2662480,172,7,1614,100
2020-05-19,Mexico,NA,Sonora,2662480,157,10,1771,110
2020-05-20,Mexico,NA,Sonora,2662480,155,10,1926,120
2020-05-21,Mexico,NA,Sonora,2662480,180,4,2106,124
2020-05-22,Mexico,NA,Sonora,2662480,158,9,2264,133
2020-05-23,Mexico,NA,Sonora,2662480,134,14,2398,147
2020-05-24,Mexico,NA,Sonora,2662480,108,11,2506,158
2020-05-25,Mexico,NA,Sonora,2662480,234,14,2740,172
2020-05-26,Mexico,NA,Sonora,2662480,285,17,3025,189
2020-05-27,Mexico,NA,Sonora,2662480,238,12,3263,201
2020-05-28,Mexico,NA,Sonora,2662480,267,14,3530,215
2020-05-29,Mexico,NA,Sonora,2662480,217,24,3747,239
2020-05-30,Mexico,NA,Sonora,2662480,148,18,3895,257
2020-05-31,Mexico,NA,Sonora,2662480,126,13,4021,270
2020-06-01,Mexico,NA,Sonora,2662480,251,21,4272,291
2020-06-02,Mexico,NA,Sonora,2662480,249,13,4521,304
2020-06-03,Mexico,NA,Sonora,2662480,253,16,4774,320
2020-06-04,Mexico,NA,Sonora,2662480,247,24,5021,344
2020-06-05,Mexico,NA,Sonora,2662480,256,35,5277,379
2020-06-06,Mexico,NA,Sonora,2662480,164,26,5441,405
2020-06-07,Mexico,NA,Sonora,2662480,117,22,5558,427
2020-06-08,Mexico,NA,Sonora,2662480,273,29,5831,456
2020-06-09,Mexico,NA,Sonora,2662480,293,24,6124,480
2020-06-10,Mexico,NA,Sonora,2662480,265,33,6389,513
2020-06-11,Mexico,NA,Sonora,2662480,278,33,6667,546
2020-06-12,Mexico,NA,Sonora,2662480,261,36,6928,582
2020-06-13,Mexico,NA,Sonora,2662480,168,26,7096,608
2020-06-14,Mexico,NA,Sonora,2662480,135,31,7231,639
2020-06-15,Mexico,NA,Sonora,2662480,296,41,7527,680
2020-06-16,Mexico,NA,Sonora,2662480,316,42,7843,722
2020-06-17,Mexico,NA,Sonora,2662480,329,34,8172,756
2020-06-18,Mexico,NA,Sonora,2662480,281,41,8453,797
2020-06-19,Mexico,NA,Sonora,2662480,306,31,8759,828
2020-06-20,Mexico,NA,Sonora,2662480,190,37,8949,865
2020-06-21,Mexico,NA,Sonora,2662480,161,25,9110,890
2020-06-22,Mexico,NA,Sonora,2662480,360,39,9470,929
2020-06-23,Mexico,NA,Sonora,2662480,363,54,9833,983
2020-06-24,Mexico,NA,Sonora,2662480,350,49,10183,1032
2020-06-25,Mexico,NA,Sonora,2662480,382,47,10565,1079
2020-06-26,Mexico,NA,Sonora,2662480,339,40,10904,1119
2020-06-27,Mexico,NA,Sonora,2662480,200,36,11104,1155
2020-06-28,Mexico,NA,Sonora,2662480,181,45,11285,1200
2020-06-29,Mexico,NA,Sonora,2662480,371,44,11656,1244
2020-06-30,Mexico,NA,Sonora,2662480,461,37,12117,1281
2020-07-01,Mexico,NA,Sonora,2662480,385,43,12502,1324
2020-07-02,Mexico,NA,Sonora,2662480,408,41,12910,1365
2020-07-03,Mexico,NA,Sonora,2662480,347,39,13257,1404
2020-07-04,Mexico,NA,Sonora,2662480,186,44,13443,1448
2020-07-05,Mexico,NA,Sonora,2662480,227,40,13670,1488
2020-07-06,Mexico,NA,Sonora,2662480,482,46,14152,1534
2020-07-07,Mexico,NA,Sonora,2662480,425,42,14577,1576
2020-07-08,Mexico,NA,Sonora,2662480,396,40,14973,1616
2020-07-09,Mexico,NA,Sonora,2662480,362,50,15335,1666
2020-07-10,Mexico,NA,Sonora,2662480,327,51,15662,1717
2020-07-11,Mexico,NA,Sonora,2662480,199,45,15861,1762
2020-07-12,Mexico,NA,Sonora,2662480,137,40,15998,1802
2020-07-13,Mexico,NA,Sonora,2662480,352,44,16350,1846
2020-07-14,Mexico,NA,Sonora,2662480,276,51,16626,1897
2020-07-15,Mexico,NA,Sonora,2662480,228,38,16854,1935
2020-07-16,Mexico,NA,Sonora,2662480,223,45,17077,1980
2020-07-17,Mexico,NA,Sonora,2662480,192,31,17269,2011
2020-07-18,Mexico,NA,Sonora,2662480,92,37,17361,2048
2020-07-19,Mexico,NA,Sonora,2662480,93,35,17454,2083
2020-07-20,Mexico,NA,Sonora,2662480,239,31,17693,2114
2020-07-21,Mexico,NA,Sonora,2662480,194,46,17887,2160
2020-07-22,Mexico,NA,Sonora,2662480,180,22,18067,2182
2020-07-23,Mexico,NA,Sonora,2662480,165,38,18232,2220
2020-07-24,Mexico,NA,Sonora,2662480,160,22,18392,2242
2020-07-25,Mexico,NA,Sonora,2662480,75,22,18467,2264
2020-07-26,Mexico,NA,Sonora,2662480,86,32,18553,2296
2020-07-27,Mexico,NA,Sonora,2662480,196,34,18749,2330
2020-07-28,Mexico,NA,Sonora,2662480,163,25,18912,2355
2020-07-29,Mexico,NA,Sonora,2662480,183,20,19095,2375
2020-07-30,Mexico,NA,Sonora,2662480,172,27,19267,2402
2020-07-31,Mexico,NA,Sonora,2662480,119,18,19386,2420
2020-08-01,Mexico,NA,Sonora,2662480,88,14,19474,2434
2020-08-02,Mexico,NA,Sonora,2662480,81,12,19555,2446
2020-08-03,Mexico,NA,Sonora,2662480,210,19,19765,2465
2020-08-04,Mexico,NA,Sonora,2662480,142,25,19907,2490
2020-08-05,Mexico,NA,Sonora,2662480,134,12,20041,2502
2020-08-06,Mexico,NA,Sonora,2662480,129,14,20170,2516
2020-08-07,Mexico,NA,Sonora,2662480,116,19,20286,2535
2020-08-08,Mexico,NA,Sonora,2662480,62,12,20348,2547
2020-08-09,Mexico,NA,Sonora,2662480,67,6,20415,2553
2020-08-10,Mexico,NA,Sonora,2662480,147,6,20562,2559
2020-08-11,Mexico,NA,Sonora,2662480,144,22,20706,2581
2020-08-12,Mexico,NA,Sonora,2662480,149,12,20855,2593
2020-08-13,Mexico,NA,Sonora,2662480,142,14,20997,2607
2020-08-14,Mexico,NA,Sonora,2662480,130,11,21127,2618
2020-08-15,Mexico,NA,Sonora,2662480,62,7,21189,2625
2020-08-16,Mexico,NA,Sonora,2662480,56,15,21245,2640
2020-08-17,Mexico,NA,Sonora,2662480,169,15,21414,2655
2020-08-18,Mexico,NA,Sonora,2662480,107,8,21521,2663
2020-08-19,Mexico,NA,Sonora,2662480,116,12,21637,2675
2020-08-20,Mexico,NA,Sonora,2662480,85,9,21722,2684
2020-08-21,Mexico,NA,Sonora,2662480,93,9,21815,2693
2020-08-22,Mexico,NA,Sonora,2662480,64,3,21879,2696
2020-08-23,Mexico,NA,Sonora,2662480,45,6,21924,2702
2020-08-24,Mexico,NA,Sonora,2662480,106,9,22030,2711
2020-08-25,Mexico,NA,Sonora,2662480,128,6,22158,2717
2020-08-26,Mexico,NA,Sonora,2662480,117,9,22275,2726
2020-08-27,Mexico,NA,Sonora,2662480,91,5,22366,2731
2020-08-28,Mexico,NA,Sonora,2662480,95,8,22461,2739
2020-08-29,Mexico,NA,Sonora,2662480,48,5,22509,2744
2020-08-30,Mexico,NA,Sonora,2662480,37,3,22546,2747
2020-08-31,Mexico,NA,Sonora,2662480,121,8,22667,2755
2020-09-01,Mexico,NA,Sonora,2662480,113,2,22780,2757
2020-09-02,Mexico,NA,Sonora,2662480,97,7,22877,2764
2020-09-03,Mexico,NA,Sonora,2662480,77,6,22954,2770
2020-09-04,Mexico,NA,Sonora,2662480,113,8,23067,2778
2020-09-05,Mexico,NA,Sonora,2662480,29,2,23096,2780
2020-09-06,Mexico,NA,Sonora,2662480,44,8,23140,2788
2020-09-07,Mexico,NA,Sonora,2662480,102,6,23242,2794
2020-09-08,Mexico,NA,Sonora,2662480,131,4,23373,2798
2020-09-09,Mexico,NA,Sonora,2662480,129,5,23502,2803
2020-09-10,Mexico,NA,Sonora,2662480,69,2,23571,2805
2020-09-11,Mexico,NA,Sonora,2662480,55,2,23626,2807
2020-09-12,Mexico,NA,Sonora,2662480,37,1,23663,2808
2020-09-13,Mexico,NA,Sonora,2662480,31,5,23694,2813
2020-09-14,Mexico,NA,Sonora,2662480,115,2,23809,2815
2020-09-15,Mexico,NA,Sonora,2662480,68,2,23877,2817
2020-09-16,Mexico,NA,Sonora,2662480,52,2,23929,2819
2020-09-17,Mexico,NA,Sonora,2662480,84,2,24013,2821
2020-09-18,Mexico,NA,Sonora,2662480,75,1,24088,2822
2020-09-19,Mexico,NA,Sonora,2662480,32,7,24120,2829
2020-09-20,Mexico,NA,Sonora,2662480,8,5,24128,2834
2020-09-21,Mexico,NA,Sonora,2662480,14,2,24142,2836
2020-09-22,Mexico,NA,Sonora,2662480,4,1,24146,2837
2020-09-23,Mexico,NA,Sonora,2662480,2,3,24148,2840
2020-03-11,Mexico,NA,State of Mexico,15175862,2,0,11,0
2020-03-12,Mexico,NA,State of Mexico,15175862,3,0,14,0
2020-03-13,Mexico,NA,State of Mexico,15175862,12,0,26,0
2020-03-14,Mexico,NA,State of Mexico,15175862,4,0,30,0
2020-03-15,Mexico,NA,State of Mexico,15175862,10,0,40,0
2020-03-16,Mexico,NA,State of Mexico,15175862,6,0,46,0
2020-03-17,Mexico,NA,State of Mexico,15175862,7,0,53,0
2020-03-18,Mexico,NA,State of Mexico,15175862,6,1,59,1
2020-03-19,Mexico,NA,State of Mexico,15175862,13,0,72,1
2020-03-20,Mexico,NA,State of Mexico,15175862,10,0,82,1
2020-03-21,Mexico,NA,State of Mexico,15175862,5,0,87,1
2020-03-22,Mexico,NA,State of Mexico,15175862,5,0,92,1
2020-03-23,Mexico,NA,State of Mexico,15175862,15,0,107,1
2020-03-24,Mexico,NA,State of Mexico,15175862,23,0,130,1
2020-03-25,Mexico,NA,State of Mexico,15175862,26,0,156,1
2020-03-26,Mexico,NA,State of Mexico,15175862,27,0,183,1
2020-03-27,Mexico,NA,State of Mexico,15175862,43,0,226,1
2020-03-28,Mexico,NA,State of Mexico,15175862,27,4,253,5
2020-03-29,Mexico,NA,State of Mexico,15175862,18,1,271,6
2020-03-30,Mexico,NA,State of Mexico,15175862,55,1,326,7
2020-03-31,Mexico,NA,State of Mexico,15175862,34,2,360,9
2020-04-01,Mexico,NA,State of Mexico,15175862,50,1,410,10
2020-04-02,Mexico,NA,State of Mexico,15175862,50,5,460,15
2020-04-03,Mexico,NA,State of Mexico,15175862,51,3,511,18
2020-04-04,Mexico,NA,State of Mexico,15175862,34,5,545,23
2020-04-05,Mexico,NA,State of Mexico,15175862,41,5,586,28
2020-04-06,Mexico,NA,State of Mexico,15175862,84,4,670,32
2020-04-07,Mexico,NA,State of Mexico,15175862,73,10,743,42
2020-04-08,Mexico,NA,State of Mexico,15175862,88,6,831,48
2020-04-09,Mexico,NA,State of Mexico,15175862,62,5,893,53
2020-04-10,Mexico,NA,State of Mexico,15175862,94,7,987,60
2020-04-11,Mexico,NA,State of Mexico,15175862,78,13,1065,73
2020-04-12,Mexico,NA,State of Mexico,15175862,84,17,1149,90
2020-04-13,Mexico,NA,State of Mexico,15175862,157,19,1306,109
2020-04-14,Mexico,NA,State of Mexico,15175862,161,16,1467,125
2020-04-15,Mexico,NA,State of Mexico,15175862,185,18,1652,143
2020-04-16,Mexico,NA,State of Mexico,15175862,190,18,1842,161
2020-04-17,Mexico,NA,State of Mexico,15175862,161,23,2003,184
2020-04-18,Mexico,NA,State of Mexico,15175862,159,28,2162,212
2020-04-19,Mexico,NA,State of Mexico,15175862,155,27,2317,239
2020-04-20,Mexico,NA,State of Mexico,15175862,264,37,2581,276
2020-04-21,Mexico,NA,State of Mexico,15175862,284,38,2865,314
2020-04-22,Mexico,NA,State of Mexico,15175862,252,40,3117,354
2020-04-23,Mexico,NA,State of Mexico,15175862,274,37,3391,391
2020-04-24,Mexico,NA,State of Mexico,15175862,312,54,3703,445
2020-04-25,Mexico,NA,State of Mexico,15175862,197,48,3900,493
2020-04-26,Mexico,NA,State of Mexico,15175862,214,68,4114,561
2020-04-27,Mexico,NA,State of Mexico,15175862,366,51,4480,612
2020-04-28,Mexico,NA,State of Mexico,15175862,347,59,4827,671
2020-04-29,Mexico,NA,State of Mexico,15175862,323,72,5150,743
2020-04-30,Mexico,NA,State of Mexico,15175862,303,65,5453,808
2020-05-01,Mexico,NA,State of Mexico,15175862,276,78,5729,886
2020-05-02,Mexico,NA,State of Mexico,15175862,235,66,5964,952
2020-05-03,Mexico,NA,State of Mexico,15175862,252,65,6216,1017
2020-05-04,Mexico,NA,State of Mexico,15175862,498,94,6714,1111
2020-05-05,Mexico,NA,State of Mexico,15175862,352,67,7066,1178
2020-05-06,Mexico,NA,State of Mexico,15175862,352,58,7418,1236
2020-05-07,Mexico,NA,State of Mexico,15175862,445,66,7863,1302
2020-05-08,Mexico,NA,State of Mexico,15175862,435,64,8298,1366
2020-05-09,Mexico,NA,State of Mexico,15175862,264,64,8562,1430
2020-05-10,Mexico,NA,State of Mexico,15175862,253,65,8815,1495
2020-05-11,Mexico,NA,State of Mexico,15175862,588,71,9403,1566
2020-05-12,Mexico,NA,State of Mexico,15175862,547,59,9950,1625
2020-05-13,Mexico,NA,State of Mexico,15175862,586,87,10536,1712
2020-05-14,Mexico,NA,State of Mexico,15175862,542,74,11078,1786
2020-05-15,Mexico,NA,State of Mexico,15175862,625,94,11703,1880
2020-05-16,Mexico,NA,State of Mexico,15175862,369,87,12072,1967
2020-05-17,Mexico,NA,State of Mexico,15175862,325,103,12397,2070
2020-05-18,Mexico,NA,State of Mexico,15175862,703,93,13100,2163
2020-05-19,Mexico,NA,State of Mexico,15175862,586,101,13686,2264
2020-05-20,Mexico,NA,State of Mexico,15175862,662,82,14348,2346
2020-05-21,Mexico,NA,State of Mexico,15175862,690,102,15038,2448
2020-05-22,Mexico,NA,State of Mexico,15175862,711,100,15749,2548
2020-05-23,Mexico,NA,State of Mexico,15175862,326,88,16075,2636
2020-05-24,Mexico,NA,State of Mexico,15175862,365,108,16440,2744
2020-05-25,Mexico,NA,State of Mexico,15175862,808,106,17248,2850
2020-05-26,Mexico,NA,State of Mexico,15175862,703,116,17951,2966
2020-05-27,Mexico,NA,State of Mexico,15175862,776,103,18727,3069
2020-05-28,Mexico,NA,State of Mexico,15175862,697,100,19424,3169
2020-05-29,Mexico,NA,State of Mexico,15175862,709,104,20133,3273
2020-05-30,Mexico,NA,State of Mexico,15175862,400,113,20533,3386
2020-05-31,Mexico,NA,State of Mexico,15175862,339,112,20872,3498
2020-06-01,Mexico,NA,State of Mexico,15175862,856,113,21728,3611
2020-06-02,Mexico,NA,State of Mexico,15175862,808,100,22536,3711
2020-06-03,Mexico,NA,State of Mexico,15175862,939,126,23475,3837
2020-06-04,Mexico,NA,State of Mexico,15175862,801,110,24276,3947
2020-06-05,Mexico,NA,State of Mexico,15175862,816,103,25092,4050
2020-06-06,Mexico,NA,State of Mexico,15175862,411,110,25503,4160
2020-06-07,Mexico,NA,State of Mexico,15175862,423,118,25926,4278
2020-06-08,Mexico,NA,State of Mexico,15175862,1062,118,26988,4396
2020-06-09,Mexico,NA,State of Mexico,15175862,893,131,27881,4527
2020-06-10,Mexico,NA,State of Mexico,15175862,899,119,28780,4646
2020-06-11,Mexico,NA,State of Mexico,15175862,749,123,29529,4769
2020-06-12,Mexico,NA,State of Mexico,15175862,750,111,30279,4880
2020-06-13,Mexico,NA,State of Mexico,15175862,375,108,30654,4988
2020-06-14,Mexico,NA,State of Mexico,15175862,377,106,31031,5094
2020-06-15,Mexico,NA,State of Mexico,15175862,882,126,31913,5220
2020-06-16,Mexico,NA,State of Mexico,15175862,866,131,32779,5351
2020-06-17,Mexico,NA,State of Mexico,15175862,776,115,33555,5466
2020-06-18,Mexico,NA,State of Mexico,15175862,753,96,34308,5562
2020-06-19,Mexico,NA,State of Mexico,15175862,755,115,35063,5677
2020-06-20,Mexico,NA,State of Mexico,15175862,376,81,35439,5758
2020-06-21,Mexico,NA,State of Mexico,15175862,258,88,35697,5846
2020-06-22,Mexico,NA,State of Mexico,15175862,765,98,36462,5944
2020-06-23,Mexico,NA,State of Mexico,15175862,666,90,37128,6034
2020-06-24,Mexico,NA,State of Mexico,15175862,704,83,37832,6117
2020-06-25,Mexico,NA,State of Mexico,15175862,592,72,38424,6189
2020-06-26,Mexico,NA,State of Mexico,15175862,693,85,39117,6274
2020-06-27,Mexico,NA,State of Mexico,15175862,280,94,39397,6368
2020-06-28,Mexico,NA,State of Mexico,15175862,270,93,39667,6461
2020-06-29,Mexico,NA,State of Mexico,15175862,831,125,40498,6586
2020-06-30,Mexico,NA,State of Mexico,15175862,634,89,41132,6675
2020-07-01,Mexico,NA,State of Mexico,15175862,840,88,41972,6763
2020-07-02,Mexico,NA,State of Mexico,15175862,656,98,42628,6861
2020-07-03,Mexico,NA,State of Mexico,15175862,683,63,43311,6924
2020-07-04,Mexico,NA,State of Mexico,15175862,333,73,43644,6997
2020-07-05,Mexico,NA,State of Mexico,15175862,264,88,43908,7085
2020-07-06,Mexico,NA,State of Mexico,15175862,733,113,44641,7198
2020-07-07,Mexico,NA,State of Mexico,15175862,651,79,45292,7277
2020-07-08,Mexico,NA,State of Mexico,15175862,663,87,45955,7364
2020-07-09,Mexico,NA,State of Mexico,15175862,516,82,46471,7446
2020-07-10,Mexico,NA,State of Mexico,15175862,688,77,47159,7523
2020-07-11,Mexico,NA,State of Mexico,15175862,262,95,47421,7618
2020-07-12,Mexico,NA,State of Mexico,15175862,225,75,47646,7693
2020-07-13,Mexico,NA,State of Mexico,15175862,674,67,48320,7760
2020-07-14,Mexico,NA,State of Mexico,15175862,595,77,48915,7837
2020-07-15,Mexico,NA,State of Mexico,15175862,702,79,49617,7916
2020-07-16,Mexico,NA,State of Mexico,15175862,611,88,50228,8004
2020-07-17,Mexico,NA,State of Mexico,15175862,619,71,50847,8075
2020-07-18,Mexico,NA,State of Mexico,15175862,280,78,51127,8153
2020-07-19,Mexico,NA,State of Mexico,15175862,272,84,51399,8237
2020-07-20,Mexico,NA,State of Mexico,15175862,789,70,52188,8307
2020-07-21,Mexico,NA,State of Mexico,15175862,769,72,52957,8379
2020-07-22,Mexico,NA,State of Mexico,15175862,705,62,53662,8441
2020-07-23,Mexico,NA,State of Mexico,15175862,578,68,54240,8509
2020-07-24,Mexico,NA,State of Mexico,15175862,589,68,54829,8577
2020-07-25,Mexico,NA,State of Mexico,15175862,235,72,55064,8649
2020-07-26,Mexico,NA,State of Mexico,15175862,194,66,55258,8715
2020-07-27,Mexico,NA,State of Mexico,15175862,687,71,55945,8786
2020-07-28,Mexico,NA,State of Mexico,15175862,589,57,56534,8843
2020-07-29,Mexico,NA,State of Mexico,15175862,645,61,57179,8904
2020-07-30,Mexico,NA,State of Mexico,15175862,546,58,57725,8962
2020-07-31,Mexico,NA,State of Mexico,15175862,537,58,58262,9020
2020-08-01,Mexico,NA,State of Mexico,15175862,255,69,58517,9089
2020-08-02,Mexico,NA,State of Mexico,15175862,209,57,58726,9146
2020-08-03,Mexico,NA,State of Mexico,15175862,643,64,59369,9210
2020-08-04,Mexico,NA,State of Mexico,15175862,616,63,59985,9273
2020-08-05,Mexico,NA,State of Mexico,15175862,577,61,60562,9334
2020-08-06,Mexico,NA,State of Mexico,15175862,513,66,61075,9400
2020-08-07,Mexico,NA,State of Mexico,15175862,542,46,61617,9446
2020-08-08,Mexico,NA,State of Mexico,15175862,225,48,61842,9494
2020-08-09,Mexico,NA,State of Mexico,15175862,180,64,62022,9558
2020-08-10,Mexico,NA,State of Mexico,15175862,612,73,62634,9631
2020-08-11,Mexico,NA,State of Mexico,15175862,516,49,63150,9680
2020-08-12,Mexico,NA,State of Mexico,15175862,515,50,63665,9730
2020-08-13,Mexico,NA,State of Mexico,15175862,501,53,64166,9783
2020-08-14,Mexico,NA,State of Mexico,15175862,456,52,64622,9835
2020-08-15,Mexico,NA,State of Mexico,15175862,233,49,64855,9884
2020-08-16,Mexico,NA,State of Mexico,15175862,147,56,65002,9940
2020-08-17,Mexico,NA,State of Mexico,15175862,551,48,65553,9988
2020-08-18,Mexico,NA,State of Mexico,15175862,553,49,66106,10037
2020-08-19,Mexico,NA,State of Mexico,15175862,447,59,66553,10096
2020-08-20,Mexico,NA,State of Mexico,15175862,454,39,67007,10135
2020-08-21,Mexico,NA,State of Mexico,15175862,493,51,67500,10186
2020-08-22,Mexico,NA,State of Mexico,15175862,210,44,67710,10230
2020-08-23,Mexico,NA,State of Mexico,15175862,195,56,67905,10286
2020-08-24,Mexico,NA,State of Mexico,15175862,531,45,68436,10331
2020-08-25,Mexico,NA,State of Mexico,15175862,537,40,68973,10371
2020-08-26,Mexico,NA,State of Mexico,15175862,454,36,69427,10407
2020-08-27,Mexico,NA,State of Mexico,15175862,472,54,69899,10461
2020-08-28,Mexico,NA,State of Mexico,15175862,503,55,70402,10516
2020-08-29,Mexico,NA,State of Mexico,15175862,212,43,70614,10559
2020-08-30,Mexico,NA,State of Mexico,15175862,141,42,70755,10601
2020-08-31,Mexico,NA,State of Mexico,15175862,564,43,71319,10644
2020-09-01,Mexico,NA,State of Mexico,15175862,505,44,71824,10688
2020-09-02,Mexico,NA,State of Mexico,15175862,548,50,72372,10738
2020-09-03,Mexico,NA,State of Mexico,15175862,433,47,72805,10785
2020-09-04,Mexico,NA,State of Mexico,15175862,474,34,73279,10819
2020-09-05,Mexico,NA,State of Mexico,15175862,207,42,73486,10861
2020-09-06,Mexico,NA,State of Mexico,15175862,140,57,73626,10918
2020-09-07,Mexico,NA,State of Mexico,15175862,516,41,74142,10959
2020-09-08,Mexico,NA,State of Mexico,15175862,481,30,74623,10989
2020-09-09,Mexico,NA,State of Mexico,15175862,456,38,75079,11027
2020-09-10,Mexico,NA,State of Mexico,15175862,474,33,75553,11060
2020-09-11,Mexico,NA,State of Mexico,15175862,464,43,76017,11103
2020-09-12,Mexico,NA,State of Mexico,15175862,190,45,76207,11148
2020-09-13,Mexico,NA,State of Mexico,15175862,161,33,76368,11181
2020-09-14,Mexico,NA,State of Mexico,15175862,531,26,76899,11207
2020-09-15,Mexico,NA,State of Mexico,15175862,271,44,77170,11251
2020-09-16,Mexico,NA,State of Mexico,15175862,138,46,77308,11297
2020-09-17,Mexico,NA,State of Mexico,15175862,423,34,77731,11331
2020-09-18,Mexico,NA,State of Mexico,15175862,503,33,78234,11364
2020-09-19,Mexico,NA,State of Mexico,15175862,144,41,78378,11405
2020-09-20,Mexico,NA,State of Mexico,15175862,103,43,78481,11448
2020-09-21,Mexico,NA,State of Mexico,15175862,318,33,78799,11481
2020-09-22,Mexico,NA,State of Mexico,15175862,83,27,78882,11508
2020-09-23,Mexico,NA,State of Mexico,15175862,26,6,78908,11514
2020-03-23,Mexico,NA,Tabasco,2238603,3,0,11,0
2020-03-24,Mexico,NA,Tabasco,2238603,12,0,23,0
2020-03-25,Mexico,NA,Tabasco,2238603,3,0,26,0
2020-03-26,Mexico,NA,Tabasco,2238603,5,0,31,0
2020-03-27,Mexico,NA,Tabasco,2238603,11,0,42,0
2020-03-28,Mexico,NA,Tabasco,2238603,1,0,43,0
2020-03-29,Mexico,NA,Tabasco,2238603,9,0,52,0
2020-03-30,Mexico,NA,Tabasco,2238603,10,0,62,0
2020-03-31,Mexico,NA,Tabasco,2238603,11,1,73,1
2020-04-01,Mexico,NA,Tabasco,2238603,9,3,82,4
2020-04-02,Mexico,NA,Tabasco,2238603,15,0,97,4
2020-04-03,Mexico,NA,Tabasco,2238603,20,1,117,5
2020-04-04,Mexico,NA,Tabasco,2238603,3,0,120,5
2020-04-05,Mexico,NA,Tabasco,2238603,9,3,129,8
2020-04-06,Mexico,NA,Tabasco,2238603,7,3,136,11
2020-04-07,Mexico,NA,Tabasco,2238603,13,0,149,11
2020-04-08,Mexico,NA,Tabasco,2238603,18,1,167,12
2020-04-09,Mexico,NA,Tabasco,2238603,11,1,178,13
2020-04-10,Mexico,NA,Tabasco,2238603,15,0,193,13
2020-04-11,Mexico,NA,Tabasco,2238603,19,1,212,14
2020-04-12,Mexico,NA,Tabasco,2238603,27,2,239,16
2020-04-13,Mexico,NA,Tabasco,2238603,30,4,269,20
2020-04-14,Mexico,NA,Tabasco,2238603,47,5,316,25
2020-04-15,Mexico,NA,Tabasco,2238603,39,3,355,28
2020-04-16,Mexico,NA,Tabasco,2238603,43,3,398,31
2020-04-17,Mexico,NA,Tabasco,2238603,56,10,454,41
2020-04-18,Mexico,NA,Tabasco,2238603,48,9,502,50
2020-04-19,Mexico,NA,Tabasco,2238603,41,8,543,58
2020-04-20,Mexico,NA,Tabasco,2238603,72,8,615,66
2020-04-21,Mexico,NA,Tabasco,2238603,85,3,700,69
2020-04-22,Mexico,NA,Tabasco,2238603,65,10,765,79
2020-04-23,Mexico,NA,Tabasco,2238603,65,11,830,90
2020-04-24,Mexico,NA,Tabasco,2238603,66,7,896,97
2020-04-25,Mexico,NA,Tabasco,2238603,43,10,939,107
2020-04-26,Mexico,NA,Tabasco,2238603,41,10,980,117
2020-04-27,Mexico,NA,Tabasco,2238603,59,6,1039,123
2020-04-28,Mexico,NA,Tabasco,2238603,58,9,1097,132
2020-04-29,Mexico,NA,Tabasco,2238603,50,9,1147,141
2020-04-30,Mexico,NA,Tabasco,2238603,84,10,1231,151
2020-05-01,Mexico,NA,Tabasco,2238603,54,17,1285,168
2020-05-02,Mexico,NA,Tabasco,2238603,48,13,1333,181
2020-05-03,Mexico,NA,Tabasco,2238603,46,13,1379,194
2020-05-04,Mexico,NA,Tabasco,2238603,85,14,1464,208
2020-05-05,Mexico,NA,Tabasco,2238603,72,7,1536,215
2020-05-06,Mexico,NA,Tabasco,2238603,95,15,1631,230
2020-05-07,Mexico,NA,Tabasco,2238603,104,11,1735,241
2020-05-08,Mexico,NA,Tabasco,2238603,81,23,1816,264
2020-05-09,Mexico,NA,Tabasco,2238603,53,13,1869,277
2020-05-10,Mexico,NA,Tabasco,2238603,65,13,1934,290
2020-05-11,Mexico,NA,Tabasco,2238603,115,15,2049,305
2020-05-12,Mexico,NA,Tabasco,2238603,87,11,2136,316
2020-05-13,Mexico,NA,Tabasco,2238603,116,13,2252,329
2020-05-14,Mexico,NA,Tabasco,2238603,127,15,2379,344
2020-05-15,Mexico,NA,Tabasco,2238603,145,24,2524,368
2020-05-16,Mexico,NA,Tabasco,2238603,86,17,2610,385
2020-05-17,Mexico,NA,Tabasco,2238603,81,17,2691,402
2020-05-18,Mexico,NA,Tabasco,2238603,122,14,2813,416
2020-05-19,Mexico,NA,Tabasco,2238603,106,16,2919,432
2020-05-20,Mexico,NA,Tabasco,2238603,162,21,3081,453
2020-05-21,Mexico,NA,Tabasco,2238603,142,19,3223,472
2020-05-22,Mexico,NA,Tabasco,2238603,139,23,3362,495
2020-05-23,Mexico,NA,Tabasco,2238603,97,21,3459,516
2020-05-24,Mexico,NA,Tabasco,2238603,83,17,3542,533
2020-05-25,Mexico,NA,Tabasco,2238603,175,13,3717,546
2020-05-26,Mexico,NA,Tabasco,2238603,198,22,3915,568
2020-05-27,Mexico,NA,Tabasco,2238603,224,18,4139,586
2020-05-28,Mexico,NA,Tabasco,2238603,222,20,4361,606
2020-05-29,Mexico,NA,Tabasco,2238603,172,18,4533,624
2020-05-30,Mexico,NA,Tabasco,2238603,103,28,4636,652
2020-05-31,Mexico,NA,Tabasco,2238603,74,11,4710,663
2020-06-01,Mexico,NA,Tabasco,2238603,205,24,4915,687
2020-06-02,Mexico,NA,Tabasco,2238603,161,20,5076,707
2020-06-03,Mexico,NA,Tabasco,2238603,180,17,5256,724
2020-06-04,Mexico,NA,Tabasco,2238603,188,17,5444,741
2020-06-05,Mexico,NA,Tabasco,2238603,177,17,5621,758
2020-06-06,Mexico,NA,Tabasco,2238603,133,11,5754,769
2020-06-07,Mexico,NA,Tabasco,2238603,108,18,5862,787
2020-06-08,Mexico,NA,Tabasco,2238603,286,15,6148,802
2020-06-09,Mexico,NA,Tabasco,2238603,295,16,6443,818
2020-06-10,Mexico,NA,Tabasco,2238603,316,17,6759,835
2020-06-11,Mexico,NA,Tabasco,2238603,275,12,7034,847
2020-06-12,Mexico,NA,Tabasco,2238603,367,18,7401,865
2020-06-13,Mexico,NA,Tabasco,2238603,180,17,7581,882
2020-06-14,Mexico,NA,Tabasco,2238603,106,17,7687,899
2020-06-15,Mexico,NA,Tabasco,2238603,310,21,7997,920
2020-06-16,Mexico,NA,Tabasco,2238603,313,26,8310,946
2020-06-17,Mexico,NA,Tabasco,2238603,311,15,8621,961
2020-06-18,Mexico,NA,Tabasco,2238603,318,22,8939,983
2020-06-19,Mexico,NA,Tabasco,2238603,296,18,9235,1001
2020-06-20,Mexico,NA,Tabasco,2238603,194,10,9429,1011
2020-06-21,Mexico,NA,Tabasco,2238603,106,23,9535,1034
2020-06-22,Mexico,NA,Tabasco,2238603,273,16,9808,1050
2020-06-23,Mexico,NA,Tabasco,2238603,277,14,10085,1064
2020-06-24,Mexico,NA,Tabasco,2238603,287,14,10372,1078
2020-06-25,Mexico,NA,Tabasco,2238603,321,22,10693,1100
2020-06-26,Mexico,NA,Tabasco,2238603,258,22,10951,1122
2020-06-27,Mexico,NA,Tabasco,2238603,196,26,11147,1148
2020-06-28,Mexico,NA,Tabasco,2238603,150,25,11297,1173
2020-06-29,Mexico,NA,Tabasco,2238603,389,25,11686,1198
2020-06-30,Mexico,NA,Tabasco,2238603,406,29,12092,1227
2020-07-01,Mexico,NA,Tabasco,2238603,405,18,12497,1245
2020-07-02,Mexico,NA,Tabasco,2238603,423,27,12920,1272
2020-07-03,Mexico,NA,Tabasco,2238603,346,24,13266,1296
2020-07-04,Mexico,NA,Tabasco,2238603,152,17,13418,1313
2020-07-05,Mexico,NA,Tabasco,2238603,136,31,13554,1344
2020-07-06,Mexico,NA,Tabasco,2238603,330,41,13884,1385
2020-07-07,Mexico,NA,Tabasco,2238603,376,35,14260,1420
2020-07-08,Mexico,NA,Tabasco,2238603,403,24,14663,1444
2020-07-09,Mexico,NA,Tabasco,2238603,425,33,15088,1477
2020-07-10,Mexico,NA,Tabasco,2238603,344,36,15432,1513
2020-07-11,Mexico,NA,Tabasco,2238603,205,35,15637,1548
2020-07-12,Mexico,NA,Tabasco,2238603,201,31,15838,1579
2020-07-13,Mexico,NA,Tabasco,2238603,427,39,16265,1618
2020-07-14,Mexico,NA,Tabasco,2238603,462,29,16727,1647
2020-07-15,Mexico,NA,Tabasco,2238603,456,29,17183,1676
2020-07-16,Mexico,NA,Tabasco,2238603,403,35,17586,1711
2020-07-17,Mexico,NA,Tabasco,2238603,454,39,18040,1750
2020-07-18,Mexico,NA,Tabasco,2238603,233,25,18273,1775
2020-07-19,Mexico,NA,Tabasco,2238603,204,29,18477,1804
2020-07-20,Mexico,NA,Tabasco,2238603,449,34,18926,1838
2020-07-21,Mexico,NA,Tabasco,2238603,459,37,19385,1875
2020-07-22,Mexico,NA,Tabasco,2238603,400,32,19785,1907
2020-07-23,Mexico,NA,Tabasco,2238603,433,30,20218,1937
2020-07-24,Mexico,NA,Tabasco,2238603,439,21,20657,1958
2020-07-25,Mexico,NA,Tabasco,2238603,209,32,20866,1990
2020-07-26,Mexico,NA,Tabasco,2238603,201,24,21067,2014
2020-07-27,Mexico,NA,Tabasco,2238603,456,27,21523,2041
2020-07-28,Mexico,NA,Tabasco,2238603,400,27,21923,2068
2020-07-29,Mexico,NA,Tabasco,2238603,410,21,22333,2089
2020-07-30,Mexico,NA,Tabasco,2238603,345,33,22678,2122
2020-07-31,Mexico,NA,Tabasco,2238603,354,26,23032,2148
2020-08-01,Mexico,NA,Tabasco,2238603,177,25,23209,2173
2020-08-02,Mexico,NA,Tabasco,2238603,120,20,23329,2193
2020-08-03,Mexico,NA,Tabasco,2238603,279,21,23608,2214
2020-08-04,Mexico,NA,Tabasco,2238603,251,17,23859,2231
2020-08-05,Mexico,NA,Tabasco,2238603,281,20,24140,2251
2020-08-06,Mexico,NA,Tabasco,2238603,293,15,24433,2266
2020-08-07,Mexico,NA,Tabasco,2238603,250,12,24683,2278
2020-08-08,Mexico,NA,Tabasco,2238603,111,18,24794,2296
2020-08-09,Mexico,NA,Tabasco,2238603,90,20,24884,2316
2020-08-10,Mexico,NA,Tabasco,2238603,264,23,25148,2339
2020-08-11,Mexico,NA,Tabasco,2238603,254,18,25402,2357
2020-08-12,Mexico,NA,Tabasco,2238603,194,22,25596,2379
2020-08-13,Mexico,NA,Tabasco,2238603,211,19,25807,2398
2020-08-14,Mexico,NA,Tabasco,2238603,215,14,26022,2412
2020-08-15,Mexico,NA,Tabasco,2238603,108,11,26130,2423
2020-08-16,Mexico,NA,Tabasco,2238603,84,18,26214,2441
2020-08-17,Mexico,NA,Tabasco,2238603,199,8,26413,2449
2020-08-18,Mexico,NA,Tabasco,2238603,196,10,26609,2459
2020-08-19,Mexico,NA,Tabasco,2238603,252,13,26861,2472
2020-08-20,Mexico,NA,Tabasco,2238603,167,10,27028,2482
2020-08-21,Mexico,NA,Tabasco,2238603,189,11,27217,2493
2020-08-22,Mexico,NA,Tabasco,2238603,83,11,27300,2504
2020-08-23,Mexico,NA,Tabasco,2238603,79,8,27379,2512
2020-08-24,Mexico,NA,Tabasco,2238603,150,12,27529,2524
2020-08-25,Mexico,NA,Tabasco,2238603,192,6,27721,2530
2020-08-26,Mexico,NA,Tabasco,2238603,199,20,27920,2550
2020-08-27,Mexico,NA,Tabasco,2238603,217,17,28137,2567
2020-08-28,Mexico,NA,Tabasco,2238603,210,4,28347,2571
2020-08-29,Mexico,NA,Tabasco,2238603,108,14,28455,2585
2020-08-30,Mexico,NA,Tabasco,2238603,79,8,28534,2593
2020-08-31,Mexico,NA,Tabasco,2238603,186,11,28720,2604
2020-09-01,Mexico,NA,Tabasco,2238603,206,10,28926,2614
2020-09-02,Mexico,NA,Tabasco,2238603,184,3,29110,2617
2020-09-03,Mexico,NA,Tabasco,2238603,115,12,29225,2629
2020-09-04,Mexico,NA,Tabasco,2238603,143,8,29368,2637
2020-09-05,Mexico,NA,Tabasco,2238603,71,3,29439,2640
2020-09-06,Mexico,NA,Tabasco,2238603,76,6,29515,2646
2020-09-07,Mexico,NA,Tabasco,2238603,150,9,29665,2655
2020-09-08,Mexico,NA,Tabasco,2238603,135,6,29800,2661
2020-09-09,Mexico,NA,Tabasco,2238603,81,5,29881,2666
2020-09-10,Mexico,NA,Tabasco,2238603,123,4,30004,2670
2020-09-11,Mexico,NA,Tabasco,2238603,125,4,30129,2674
2020-09-12,Mexico,NA,Tabasco,2238603,87,7,30216,2681
2020-09-13,Mexico,NA,Tabasco,2238603,86,4,30302,2685
2020-09-14,Mexico,NA,Tabasco,2238603,154,6,30456,2691
2020-09-15,Mexico,NA,Tabasco,2238603,128,3,30584,2694
2020-09-16,Mexico,NA,Tabasco,2238603,47,7,30631,2701
2020-09-17,Mexico,NA,Tabasco,2238603,158,4,30789,2705
2020-09-18,Mexico,NA,Tabasco,2238603,138,3,30927,2708
2020-09-19,Mexico,NA,Tabasco,2238603,64,7,30991,2715
2020-09-20,Mexico,NA,Tabasco,2238603,46,3,31037,2718
2020-09-21,Mexico,NA,Tabasco,2238603,120,9,31157,2727
2020-09-22,Mexico,NA,Tabasco,2238603,93,3,31250,2730
2020-09-23,Mexico,NA,Tabasco,2238603,5,1,31255,2731
2020-03-28,Mexico,NA,Tamaulipas,3268554,3,0,12,0
2020-03-29,Mexico,NA,Tamaulipas,3268554,3,0,15,0
2020-03-30,Mexico,NA,Tamaulipas,3268554,4,0,19,0
2020-03-31,Mexico,NA,Tamaulipas,3268554,5,0,24,0
2020-04-01,Mexico,NA,Tamaulipas,3268554,9,0,33,0
2020-04-02,Mexico,NA,Tamaulipas,3268554,1,0,34,0
2020-04-03,Mexico,NA,Tamaulipas,3268554,9,1,43,1
2020-04-04,Mexico,NA,Tamaulipas,3268554,3,1,46,2
2020-04-05,Mexico,NA,Tamaulipas,3268554,4,0,50,2
2020-04-06,Mexico,NA,Tamaulipas,3268554,10,1,60,3
2020-04-07,Mexico,NA,Tamaulipas,3268554,7,0,67,3
2020-04-08,Mexico,NA,Tamaulipas,3268554,3,0,70,3
2020-04-09,Mexico,NA,Tamaulipas,3268554,5,0,75,3
2020-04-10,Mexico,NA,Tamaulipas,3268554,11,0,86,3
2020-04-11,Mexico,NA,Tamaulipas,3268554,5,0,91,3
2020-04-12,Mexico,NA,Tamaulipas,3268554,9,0,100,3
2020-04-13,Mexico,NA,Tamaulipas,3268554,14,0,114,3
2020-04-14,Mexico,NA,Tamaulipas,3268554,19,1,133,4
2020-04-15,Mexico,NA,Tamaulipas,3268554,16,1,149,5
2020-04-16,Mexico,NA,Tamaulipas,3268554,27,0,176,5
2020-04-17,Mexico,NA,Tamaulipas,3268554,31,1,207,6
2020-04-18,Mexico,NA,Tamaulipas,3268554,15,0,222,6
2020-04-19,Mexico,NA,Tamaulipas,3268554,11,0,233,6
2020-04-20,Mexico,NA,Tamaulipas,3268554,27,4,260,10
2020-04-21,Mexico,NA,Tamaulipas,3268554,21,0,281,10
2020-04-22,Mexico,NA,Tamaulipas,3268554,30,0,311,10
2020-04-23,Mexico,NA,Tamaulipas,3268554,34,3,345,13
2020-04-24,Mexico,NA,Tamaulipas,3268554,28,1,373,14
2020-04-25,Mexico,NA,Tamaulipas,3268554,40,3,413,17
2020-04-26,Mexico,NA,Tamaulipas,3268554,34,1,447,18
2020-04-27,Mexico,NA,Tamaulipas,3268554,30,2,477,20
2020-04-28,Mexico,NA,Tamaulipas,3268554,42,1,519,21
2020-04-29,Mexico,NA,Tamaulipas,3268554,36,0,555,21
2020-04-30,Mexico,NA,Tamaulipas,3268554,18,3,573,24
2020-05-01,Mexico,NA,Tamaulipas,3268554,33,2,606,26
2020-05-02,Mexico,NA,Tamaulipas,3268554,32,3,638,29
2020-05-03,Mexico,NA,Tamaulipas,3268554,25,1,663,30
2020-05-04,Mexico,NA,Tamaulipas,3268554,44,1,707,31
2020-05-05,Mexico,NA,Tamaulipas,3268554,37,1,744,32
2020-05-06,Mexico,NA,Tamaulipas,3268554,49,3,793,35
2020-05-07,Mexico,NA,Tamaulipas,3268554,46,4,839,39
2020-05-08,Mexico,NA,Tamaulipas,3268554,31,6,870,45
2020-05-09,Mexico,NA,Tamaulipas,3268554,28,3,898,48
2020-05-10,Mexico,NA,Tamaulipas,3268554,22,4,920,52
2020-05-11,Mexico,NA,Tamaulipas,3268554,43,4,963,56
2020-05-12,Mexico,NA,Tamaulipas,3268554,52,3,1015,59
2020-05-13,Mexico,NA,Tamaulipas,3268554,43,3,1058,62
2020-05-14,Mexico,NA,Tamaulipas,3268554,36,6,1094,68
2020-05-15,Mexico,NA,Tamaulipas,3268554,66,2,1160,70
2020-05-16,Mexico,NA,Tamaulipas,3268554,49,3,1209,73
2020-05-17,Mexico,NA,Tamaulipas,3268554,17,0,1226,73
2020-05-18,Mexico,NA,Tamaulipas,3268554,64,4,1290,77
2020-05-19,Mexico,NA,Tamaulipas,3268554,51,5,1341,82
2020-05-20,Mexico,NA,Tamaulipas,3268554,69,2,1410,84
2020-05-21,Mexico,NA,Tamaulipas,3268554,72,5,1482,89
2020-05-22,Mexico,NA,Tamaulipas,3268554,91,4,1573,93
2020-05-23,Mexico,NA,Tamaulipas,3268554,70,3,1643,96
2020-05-24,Mexico,NA,Tamaulipas,3268554,35,5,1678,101
2020-05-25,Mexico,NA,Tamaulipas,3268554,117,4,1795,105
2020-05-26,Mexico,NA,Tamaulipas,3268554,118,3,1913,108
2020-05-27,Mexico,NA,Tamaulipas,3268554,111,4,2024,112
2020-05-28,Mexico,NA,Tamaulipas,3268554,67,10,2091,122
2020-05-29,Mexico,NA,Tamaulipas,3268554,98,2,2189,124
2020-05-30,Mexico,NA,Tamaulipas,3268554,68,7,2257,131
2020-05-31,Mexico,NA,Tamaulipas,3268554,50,9,2307,140
2020-06-01,Mexico,NA,Tamaulipas,3268554,133,6,2440,146
2020-06-02,Mexico,NA,Tamaulipas,3268554,102,6,2542,152
2020-06-03,Mexico,NA,Tamaulipas,3268554,95,7,2637,159
2020-06-04,Mexico,NA,Tamaulipas,3268554,102,5,2739,164
2020-06-05,Mexico,NA,Tamaulipas,3268554,114,2,2853,166
2020-06-06,Mexico,NA,Tamaulipas,3268554,81,2,2934,168
2020-06-07,Mexico,NA,Tamaulipas,3268554,70,5,3004,173
2020-06-08,Mexico,NA,Tamaulipas,3268554,140,7,3144,180
2020-06-09,Mexico,NA,Tamaulipas,3268554,139,7,3283,187
2020-06-10,Mexico,NA,Tamaulipas,3268554,182,9,3465,196
2020-06-11,Mexico,NA,Tamaulipas,3268554,134,5,3599,201
2020-06-12,Mexico,NA,Tamaulipas,3268554,238,11,3837,212
2020-06-13,Mexico,NA,Tamaulipas,3268554,140,6,3977,218
2020-06-14,Mexico,NA,Tamaulipas,3268554,126,20,4103,238
2020-06-15,Mexico,NA,Tamaulipas,3268554,259,15,4362,253
2020-06-16,Mexico,NA,Tamaulipas,3268554,302,13,4664,266
2020-06-17,Mexico,NA,Tamaulipas,3268554,212,19,4876,285
2020-06-18,Mexico,NA,Tamaulipas,3268554,222,22,5098,307
2020-06-19,Mexico,NA,Tamaulipas,3268554,225,20,5323,327
2020-06-20,Mexico,NA,Tamaulipas,3268554,195,9,5518,336
2020-06-21,Mexico,NA,Tamaulipas,3268554,125,17,5643,353
2020-06-22,Mexico,NA,Tamaulipas,3268554,328,28,5971,381
2020-06-23,Mexico,NA,Tamaulipas,3268554,298,21,6269,402
2020-06-24,Mexico,NA,Tamaulipas,3268554,305,13,6574,415
2020-06-25,Mexico,NA,Tamaulipas,3268554,386,23,6960,438
2020-06-26,Mexico,NA,Tamaulipas,3268554,443,27,7403,465
2020-06-27,Mexico,NA,Tamaulipas,3268554,229,29,7632,494
2020-06-28,Mexico,NA,Tamaulipas,3268554,174,28,7806,522
2020-06-29,Mexico,NA,Tamaulipas,3268554,508,29,8314,551
2020-06-30,Mexico,NA,Tamaulipas,3268554,386,32,8700,583
2020-07-01,Mexico,NA,Tamaulipas,3268554,438,19,9138,602
2020-07-02,Mexico,NA,Tamaulipas,3268554,376,28,9514,630
2020-07-03,Mexico,NA,Tamaulipas,3268554,386,17,9900,647
2020-07-04,Mexico,NA,Tamaulipas,3268554,216,38,10116,685
2020-07-05,Mexico,NA,Tamaulipas,3268554,186,38,10302,723
2020-07-06,Mexico,NA,Tamaulipas,3268554,424,41,10726,764
2020-07-07,Mexico,NA,Tamaulipas,3268554,480,36,11206,800
2020-07-08,Mexico,NA,Tamaulipas,3268554,428,31,11634,831
2020-07-09,Mexico,NA,Tamaulipas,3268554,422,20,12056,851
2020-07-10,Mexico,NA,Tamaulipas,3268554,338,21,12394,872
2020-07-11,Mexico,NA,Tamaulipas,3268554,237,14,12631,886
2020-07-12,Mexico,NA,Tamaulipas,3268554,142,16,12773,902
2020-07-13,Mexico,NA,Tamaulipas,3268554,432,37,13205,939
2020-07-14,Mexico,NA,Tamaulipas,3268554,509,17,13714,956
2020-07-15,Mexico,NA,Tamaulipas,3268554,479,24,14193,980
2020-07-16,Mexico,NA,Tamaulipas,3268554,481,35,14674,1015
2020-07-17,Mexico,NA,Tamaulipas,3268554,425,26,15099,1041
2020-07-18,Mexico,NA,Tamaulipas,3268554,269,28,15368,1069
2020-07-19,Mexico,NA,Tamaulipas,3268554,226,30,15594,1099
2020-07-20,Mexico,NA,Tamaulipas,3268554,445,29,16039,1128
2020-07-21,Mexico,NA,Tamaulipas,3268554,416,32,16455,1160
2020-07-22,Mexico,NA,Tamaulipas,3268554,397,21,16852,1181
2020-07-23,Mexico,NA,Tamaulipas,3268554,357,34,17209,1215
2020-07-24,Mexico,NA,Tamaulipas,3268554,391,26,17600,1241
2020-07-25,Mexico,NA,Tamaulipas,3268554,235,21,17835,1262
2020-07-26,Mexico,NA,Tamaulipas,3268554,97,32,17932,1294
2020-07-27,Mexico,NA,Tamaulipas,3268554,298,32,18230,1326
2020-07-28,Mexico,NA,Tamaulipas,3268554,321,23,18551,1349
2020-07-29,Mexico,NA,Tamaulipas,3268554,350,28,18901,1377
2020-07-30,Mexico,NA,Tamaulipas,3268554,264,26,19165,1403
2020-07-31,Mexico,NA,Tamaulipas,3268554,211,23,19376,1426
2020-08-01,Mexico,NA,Tamaulipas,3268554,184,26,19560,1452
2020-08-02,Mexico,NA,Tamaulipas,3268554,85,27,19645,1479
2020-08-03,Mexico,NA,Tamaulipas,3268554,327,20,19972,1499
2020-08-04,Mexico,NA,Tamaulipas,3268554,288,28,20260,1527
2020-08-05,Mexico,NA,Tamaulipas,3268554,256,21,20516,1548
2020-08-06,Mexico,NA,Tamaulipas,3268554,270,22,20786,1570
2020-08-07,Mexico,NA,Tamaulipas,3268554,301,17,21087,1587
2020-08-08,Mexico,NA,Tamaulipas,3268554,212,21,21299,1608
2020-08-09,Mexico,NA,Tamaulipas,3268554,118,24,21417,1632
2020-08-10,Mexico,NA,Tamaulipas,3268554,313,18,21730,1650
2020-08-11,Mexico,NA,Tamaulipas,3268554,341,19,22071,1669
2020-08-12,Mexico,NA,Tamaulipas,3268554,231,23,22302,1692
2020-08-13,Mexico,NA,Tamaulipas,3268554,210,15,22512,1707
2020-08-14,Mexico,NA,Tamaulipas,3268554,228,11,22740,1718
2020-08-15,Mexico,NA,Tamaulipas,3268554,122,18,22862,1736
2020-08-16,Mexico,NA,Tamaulipas,3268554,90,20,22952,1756
2020-08-17,Mexico,NA,Tamaulipas,3268554,242,16,23194,1772
2020-08-18,Mexico,NA,Tamaulipas,3268554,223,21,23417,1793
2020-08-19,Mexico,NA,Tamaulipas,3268554,151,12,23568,1805
2020-08-20,Mexico,NA,Tamaulipas,3268554,191,11,23759,1816
2020-08-21,Mexico,NA,Tamaulipas,3268554,262,19,24021,1835
2020-08-22,Mexico,NA,Tamaulipas,3268554,87,13,24108,1848
2020-08-23,Mexico,NA,Tamaulipas,3268554,65,11,24173,1859
2020-08-24,Mexico,NA,Tamaulipas,3268554,184,15,24357,1874
2020-08-25,Mexico,NA,Tamaulipas,3268554,160,7,24517,1881
2020-08-26,Mexico,NA,Tamaulipas,3268554,180,14,24697,1895
2020-08-27,Mexico,NA,Tamaulipas,3268554,166,12,24863,1907
2020-08-28,Mexico,NA,Tamaulipas,3268554,175,13,25038,1920
2020-08-29,Mexico,NA,Tamaulipas,3268554,75,12,25113,1932
2020-08-30,Mexico,NA,Tamaulipas,3268554,86,12,25199,1944
2020-08-31,Mexico,NA,Tamaulipas,3268554,245,9,25444,1953
2020-09-01,Mexico,NA,Tamaulipas,3268554,249,16,25693,1969
2020-09-02,Mexico,NA,Tamaulipas,3268554,244,6,25937,1975
2020-09-03,Mexico,NA,Tamaulipas,3268554,240,9,26177,1984
2020-09-04,Mexico,NA,Tamaulipas,3268554,216,4,26393,1988
2020-09-05,Mexico,NA,Tamaulipas,3268554,118,4,26511,1992
2020-09-06,Mexico,NA,Tamaulipas,3268554,64,12,26575,2004
2020-09-07,Mexico,NA,Tamaulipas,3268554,215,12,26790,2016
2020-09-08,Mexico,NA,Tamaulipas,3268554,190,10,26980,2026
2020-09-09,Mexico,NA,Tamaulipas,3268554,161,11,27141,2037
2020-09-10,Mexico,NA,Tamaulipas,3268554,156,6,27297,2043
2020-09-11,Mexico,NA,Tamaulipas,3268554,151,9,27448,2052
2020-09-12,Mexico,NA,Tamaulipas,3268554,74,13,27522,2065
2020-09-13,Mexico,NA,Tamaulipas,3268554,30,4,27552,2069
2020-09-14,Mexico,NA,Tamaulipas,3268554,132,9,27684,2078
2020-09-15,Mexico,NA,Tamaulipas,3268554,121,6,27805,2084
2020-09-16,Mexico,NA,Tamaulipas,3268554,45,7,27850,2091
2020-09-17,Mexico,NA,Tamaulipas,3268554,128,1,27978,2092
2020-09-18,Mexico,NA,Tamaulipas,3268554,83,4,28061,2096
2020-09-19,Mexico,NA,Tamaulipas,3268554,56,6,28117,2102
2020-09-20,Mexico,NA,Tamaulipas,3268554,34,5,28151,2107
2020-09-21,Mexico,NA,Tamaulipas,3268554,78,6,28229,2113
2020-09-22,Mexico,NA,Tamaulipas,3268554,25,5,28254,2118
2020-09-23,Mexico,NA,Tamaulipas,3268554,2,2,28256,2120
2020-04-02,Mexico,NA,Tlaxcala,1169936,1,0,11,0
2020-04-04,Mexico,NA,Tlaxcala,1169936,2,0,13,0
2020-04-05,Mexico,NA,Tlaxcala,1169936,6,0,19,0
2020-04-06,Mexico,NA,Tlaxcala,1169936,8,0,27,0
2020-04-07,Mexico,NA,Tlaxcala,1169936,7,0,34,0
2020-04-08,Mexico,NA,Tlaxcala,1169936,6,1,40,1
2020-04-09,Mexico,NA,Tlaxcala,1169936,1,0,41,1
2020-04-10,Mexico,NA,Tlaxcala,1169936,6,0,47,1
2020-04-11,Mexico,NA,Tlaxcala,1169936,8,0,55,1
2020-04-12,Mexico,NA,Tlaxcala,1169936,2,3,57,4
2020-04-13,Mexico,NA,Tlaxcala,1169936,7,0,64,4
2020-04-14,Mexico,NA,Tlaxcala,1169936,7,2,71,6
2020-04-15,Mexico,NA,Tlaxcala,1169936,5,0,76,6
2020-04-16,Mexico,NA,Tlaxcala,1169936,9,0,85,6
2020-04-17,Mexico,NA,Tlaxcala,1169936,6,1,91,7
2020-04-18,Mexico,NA,Tlaxcala,1169936,3,0,94,7
2020-04-19,Mexico,NA,Tlaxcala,1169936,10,2,104,9
2020-04-20,Mexico,NA,Tlaxcala,1169936,9,0,113,9
2020-04-21,Mexico,NA,Tlaxcala,1169936,11,2,124,11
2020-04-22,Mexico,NA,Tlaxcala,1169936,8,2,132,13
2020-04-23,Mexico,NA,Tlaxcala,1169936,12,1,144,14
2020-04-24,Mexico,NA,Tlaxcala,1169936,15,1,159,15
2020-04-25,Mexico,NA,Tlaxcala,1169936,21,2,180,17
2020-04-26,Mexico,NA,Tlaxcala,1169936,13,2,193,19
2020-04-27,Mexico,NA,Tlaxcala,1169936,14,4,207,23
2020-04-28,Mexico,NA,Tlaxcala,1169936,24,4,231,27
2020-04-29,Mexico,NA,Tlaxcala,1169936,9,5,240,32
2020-04-30,Mexico,NA,Tlaxcala,1169936,16,3,256,35
2020-05-01,Mexico,NA,Tlaxcala,1169936,9,2,265,37
2020-05-02,Mexico,NA,Tlaxcala,1169936,16,3,281,40
2020-05-03,Mexico,NA,Tlaxcala,1169936,7,2,288,42
2020-05-04,Mexico,NA,Tlaxcala,1169936,25,6,313,48
2020-05-05,Mexico,NA,Tlaxcala,1169936,16,4,329,52
2020-05-06,Mexico,NA,Tlaxcala,1169936,23,3,352,55
2020-05-07,Mexico,NA,Tlaxcala,1169936,17,2,369,57
2020-05-08,Mexico,NA,Tlaxcala,1169936,20,7,389,64
2020-05-09,Mexico,NA,Tlaxcala,1169936,20,1,409,65
2020-05-10,Mexico,NA,Tlaxcala,1169936,16,1,425,66
2020-05-11,Mexico,NA,Tlaxcala,1169936,36,10,461,76
2020-05-12,Mexico,NA,Tlaxcala,1169936,36,9,497,85
2020-05-13,Mexico,NA,Tlaxcala,1169936,41,4,538,89
2020-05-14,Mexico,NA,Tlaxcala,1169936,21,2,559,91
2020-05-15,Mexico,NA,Tlaxcala,1169936,37,8,596,99
2020-05-16,Mexico,NA,Tlaxcala,1169936,29,9,625,108
2020-05-17,Mexico,NA,Tlaxcala,1169936,25,7,650,115
2020-05-18,Mexico,NA,Tlaxcala,1169936,42,3,692,118
2020-05-19,Mexico,NA,Tlaxcala,1169936,51,6,743,124
2020-05-20,Mexico,NA,Tlaxcala,1169936,42,5,785,129
2020-05-21,Mexico,NA,Tlaxcala,1169936,50,5,835,134
2020-05-22,Mexico,NA,Tlaxcala,1169936,44,2,879,136
2020-05-23,Mexico,NA,Tlaxcala,1169936,28,5,907,141
2020-05-24,Mexico,NA,Tlaxcala,1169936,16,13,923,154
2020-05-25,Mexico,NA,Tlaxcala,1169936,59,3,982,157
2020-05-26,Mexico,NA,Tlaxcala,1169936,37,6,1019,163
2020-05-27,Mexico,NA,Tlaxcala,1169936,39,5,1058,168
2020-05-28,Mexico,NA,Tlaxcala,1169936,45,9,1103,177
2020-05-29,Mexico,NA,Tlaxcala,1169936,45,5,1148,182
2020-05-30,Mexico,NA,Tlaxcala,1169936,39,0,1187,182
2020-05-31,Mexico,NA,Tlaxcala,1169936,25,10,1212,192
2020-06-01,Mexico,NA,Tlaxcala,1169936,65,9,1277,201
2020-06-02,Mexico,NA,Tlaxcala,1169936,45,9,1322,210
2020-06-03,Mexico,NA,Tlaxcala,1169936,59,6,1381,216
2020-06-04,Mexico,NA,Tlaxcala,1169936,55,14,1436,230
2020-06-05,Mexico,NA,Tlaxcala,1169936,48,5,1484,235
2020-06-06,Mexico,NA,Tlaxcala,1169936,34,7,1518,242
2020-06-07,Mexico,NA,Tlaxcala,1169936,28,7,1546,249
2020-06-08,Mexico,NA,Tlaxcala,1169936,68,14,1614,263
2020-06-09,Mexico,NA,Tlaxcala,1169936,53,10,1667,273
2020-06-10,Mexico,NA,Tlaxcala,1169936,63,16,1730,289
2020-06-11,Mexico,NA,Tlaxcala,1169936,53,11,1783,300
2020-06-12,Mexico,NA,Tlaxcala,1169936,55,7,1838,307
2020-06-13,Mexico,NA,Tlaxcala,1169936,26,8,1864,315
2020-06-14,Mexico,NA,Tlaxcala,1169936,31,6,1895,321
2020-06-15,Mexico,NA,Tlaxcala,1169936,61,6,1956,327
2020-06-16,Mexico,NA,Tlaxcala,1169936,55,9,2011,336
2020-06-17,Mexico,NA,Tlaxcala,1169936,74,5,2085,341
2020-06-18,Mexico,NA,Tlaxcala,1169936,55,9,2140,350
2020-06-19,Mexico,NA,Tlaxcala,1169936,48,7,2188,357
2020-06-20,Mexico,NA,Tlaxcala,1169936,33,13,2221,370
2020-06-21,Mexico,NA,Tlaxcala,1169936,29,11,2250,381
2020-06-22,Mexico,NA,Tlaxcala,1169936,67,4,2317,385
2020-06-23,Mexico,NA,Tlaxcala,1169936,85,5,2402,390
2020-06-24,Mexico,NA,Tlaxcala,1169936,75,8,2477,398
2020-06-25,Mexico,NA,Tlaxcala,1169936,65,6,2542,404
2020-06-26,Mexico,NA,Tlaxcala,1169936,89,13,2631,417
2020-06-27,Mexico,NA,Tlaxcala,1169936,28,10,2659,427
2020-06-28,Mexico,NA,Tlaxcala,1169936,49,5,2708,432
2020-06-29,Mexico,NA,Tlaxcala,1169936,86,8,2794,440
2020-06-30,Mexico,NA,Tlaxcala,1169936,94,9,2888,449
2020-07-01,Mexico,NA,Tlaxcala,1169936,78,10,2966,459
2020-07-02,Mexico,NA,Tlaxcala,1169936,102,10,3068,469
2020-07-03,Mexico,NA,Tlaxcala,1169936,92,7,3160,476
2020-07-04,Mexico,NA,Tlaxcala,1169936,28,7,3188,483
2020-07-05,Mexico,NA,Tlaxcala,1169936,49,9,3237,492
2020-07-06,Mexico,NA,Tlaxcala,1169936,76,9,3313,501
2020-07-07,Mexico,NA,Tlaxcala,1169936,98,14,3411,515
2020-07-08,Mexico,NA,Tlaxcala,1169936,60,13,3471,528
2020-07-09,Mexico,NA,Tlaxcala,1169936,84,11,3555,539
2020-07-10,Mexico,NA,Tlaxcala,1169936,81,11,3636,550
2020-07-11,Mexico,NA,Tlaxcala,1169936,42,12,3678,562
2020-07-12,Mexico,NA,Tlaxcala,1169936,32,12,3710,574
2020-07-13,Mexico,NA,Tlaxcala,1169936,72,8,3782,582
2020-07-14,Mexico,NA,Tlaxcala,1169936,98,20,3880,602
2020-07-15,Mexico,NA,Tlaxcala,1169936,101,18,3981,620
2020-07-16,Mexico,NA,Tlaxcala,1169936,99,11,4080,631
2020-07-17,Mexico,NA,Tlaxcala,1169936,98,12,4178,643
2020-07-18,Mexico,NA,Tlaxcala,1169936,53,17,4231,660
2020-07-19,Mexico,NA,Tlaxcala,1169936,55,12,4286,672
2020-07-20,Mexico,NA,Tlaxcala,1169936,98,14,4384,686
2020-07-21,Mexico,NA,Tlaxcala,1169936,77,13,4461,699
2020-07-22,Mexico,NA,Tlaxcala,1169936,87,18,4548,717
2020-07-23,Mexico,NA,Tlaxcala,1169936,76,14,4624,731
2020-07-24,Mexico,NA,Tlaxcala,1169936,89,11,4713,742
2020-07-25,Mexico,NA,Tlaxcala,1169936,36,10,4749,752
2020-07-26,Mexico,NA,Tlaxcala,1169936,44,17,4793,769
2020-07-27,Mexico,NA,Tlaxcala,1169936,110,12,4903,781
2020-07-28,Mexico,NA,Tlaxcala,1169936,87,10,4990,791
2020-07-29,Mexico,NA,Tlaxcala,1169936,92,10,5082,801
2020-07-30,Mexico,NA,Tlaxcala,1169936,84,7,5166,808
2020-07-31,Mexico,NA,Tlaxcala,1169936,71,8,5237,816
2020-08-01,Mexico,NA,Tlaxcala,1169936,43,14,5280,830
2020-08-02,Mexico,NA,Tlaxcala,1169936,18,7,5298,837
2020-08-03,Mexico,NA,Tlaxcala,1169936,77,9,5375,846
2020-08-04,Mexico,NA,Tlaxcala,1169936,80,16,5455,862
2020-08-05,Mexico,NA,Tlaxcala,1169936,75,7,5530,869
2020-08-06,Mexico,NA,Tlaxcala,1169936,61,5,5591,874
2020-08-07,Mexico,NA,Tlaxcala,1169936,60,4,5651,878
2020-08-08,Mexico,NA,Tlaxcala,1169936,33,12,5684,890
2020-08-09,Mexico,NA,Tlaxcala,1169936,18,5,5702,895
2020-08-10,Mexico,NA,Tlaxcala,1169936,85,13,5787,908
2020-08-11,Mexico,NA,Tlaxcala,1169936,56,10,5843,918
2020-08-12,Mexico,NA,Tlaxcala,1169936,67,3,5910,921
2020-08-13,Mexico,NA,Tlaxcala,1169936,73,4,5983,925
2020-08-14,Mexico,NA,Tlaxcala,1169936,48,4,6031,929
2020-08-15,Mexico,NA,Tlaxcala,1169936,33,4,6064,933
2020-08-16,Mexico,NA,Tlaxcala,1169936,16,6,6080,939
2020-08-17,Mexico,NA,Tlaxcala,1169936,73,3,6153,942
2020-08-18,Mexico,NA,Tlaxcala,1169936,54,8,6207,950
2020-08-19,Mexico,NA,Tlaxcala,1169936,43,3,6250,953
2020-08-20,Mexico,NA,Tlaxcala,1169936,76,11,6326,964
2020-08-21,Mexico,NA,Tlaxcala,1169936,59,4,6385,968
2020-08-22,Mexico,NA,Tlaxcala,1169936,31,6,6416,974
2020-08-23,Mexico,NA,Tlaxcala,1169936,18,3,6434,977
2020-08-24,Mexico,NA,Tlaxcala,1169936,88,4,6522,981
2020-08-25,Mexico,NA,Tlaxcala,1169936,69,3,6591,984
2020-08-26,Mexico,NA,Tlaxcala,1169936,66,5,6657,989
2020-08-27,Mexico,NA,Tlaxcala,1169936,36,5,6693,994
2020-08-28,Mexico,NA,Tlaxcala,1169936,48,10,6741,1004
2020-08-29,Mexico,NA,Tlaxcala,1169936,20,8,6761,1012
2020-08-30,Mexico,NA,Tlaxcala,1169936,19,2,6780,1014
2020-08-31,Mexico,NA,Tlaxcala,1169936,45,5,6825,1019
2020-09-01,Mexico,NA,Tlaxcala,1169936,38,11,6863,1030
2020-09-02,Mexico,NA,Tlaxcala,1169936,39,2,6902,1032
2020-09-03,Mexico,NA,Tlaxcala,1169936,48,4,6950,1036
2020-09-04,Mexico,NA,Tlaxcala,1169936,53,5,7003,1041
2020-09-05,Mexico,NA,Tlaxcala,1169936,45,5,7048,1046
2020-09-06,Mexico,NA,Tlaxcala,1169936,26,3,7074,1049
2020-09-07,Mexico,NA,Tlaxcala,1169936,35,3,7109,1052
2020-09-08,Mexico,NA,Tlaxcala,1169936,38,2,7147,1054
2020-09-09,Mexico,NA,Tlaxcala,1169936,27,0,7174,1054
2020-09-10,Mexico,NA,Tlaxcala,1169936,29,1,7203,1055
2020-09-11,Mexico,NA,Tlaxcala,1169936,25,3,7228,1058
2020-09-12,Mexico,NA,Tlaxcala,1169936,18,3,7246,1061
2020-09-13,Mexico,NA,Tlaxcala,1169936,18,3,7264,1064
2020-09-14,Mexico,NA,Tlaxcala,1169936,54,2,7318,1066
2020-09-15,Mexico,NA,Tlaxcala,1169936,16,2,7334,1068
2020-09-16,Mexico,NA,Tlaxcala,1169936,9,4,7343,1072
2020-09-17,Mexico,NA,Tlaxcala,1169936,35,4,7378,1076
2020-09-18,Mexico,NA,Tlaxcala,1169936,22,1,7400,1077
2020-09-19,Mexico,NA,Tlaxcala,1169936,8,0,7408,1077
2020-09-20,Mexico,NA,Tlaxcala,1169936,3,1,7411,1078
2020-09-21,Mexico,NA,Tlaxcala,1169936,23,1,7434,1079
2020-09-22,Mexico,NA,Tlaxcala,1169936,12,2,7446,1081
2020-09-23,Mexico,NA,Tlaxcala,1169936,2,1,7448,1082
2020-03-19,Mexico,NA,Veracruz,7643194,5,0,14,0
2020-03-20,Mexico,NA,Veracruz,7643194,1,0,15,0
2020-03-21,Mexico,NA,Veracruz,7643194,1,0,16,0
2020-03-23,Mexico,NA,Veracruz,7643194,4,0,20,0
2020-03-24,Mexico,NA,Veracruz,7643194,2,0,22,0
2020-03-25,Mexico,NA,Veracruz,7643194,2,0,24,0
2020-03-26,Mexico,NA,Veracruz,7643194,5,0,29,0
2020-03-27,Mexico,NA,Veracruz,7643194,1,0,30,0
2020-03-28,Mexico,NA,Veracruz,7643194,1,1,31,1
2020-03-29,Mexico,NA,Veracruz,7643194,1,0,32,1
2020-03-30,Mexico,NA,Veracruz,7643194,4,0,36,1
2020-03-31,Mexico,NA,Veracruz,7643194,2,0,38,1
2020-04-01,Mexico,NA,Veracruz,7643194,9,1,47,2
2020-04-02,Mexico,NA,Veracruz,7643194,6,0,53,2
2020-04-03,Mexico,NA,Veracruz,7643194,8,1,61,3
2020-04-04,Mexico,NA,Veracruz,7643194,2,0,63,3
2020-04-05,Mexico,NA,Veracruz,7643194,2,0,65,3
2020-04-06,Mexico,NA,Veracruz,7643194,6,0,71,3
2020-04-07,Mexico,NA,Veracruz,7643194,11,0,82,3
2020-04-08,Mexico,NA,Veracruz,7643194,4,0,86,3
2020-04-09,Mexico,NA,Veracruz,7643194,12,1,98,4
2020-04-10,Mexico,NA,Veracruz,7643194,9,0,107,4
2020-04-11,Mexico,NA,Veracruz,7643194,14,0,121,4
2020-04-12,Mexico,NA,Veracruz,7643194,9,3,130,7
2020-04-13,Mexico,NA,Veracruz,7643194,15,1,145,8
2020-04-14,Mexico,NA,Veracruz,7643194,13,1,158,9
2020-04-15,Mexico,NA,Veracruz,7643194,29,0,187,9
2020-04-16,Mexico,NA,Veracruz,7643194,39,1,226,10
2020-04-17,Mexico,NA,Veracruz,7643194,35,1,261,11
2020-04-18,Mexico,NA,Veracruz,7643194,18,3,279,14
2020-04-19,Mexico,NA,Veracruz,7643194,19,6,298,20
2020-04-20,Mexico,NA,Veracruz,7643194,37,4,335,24
2020-04-21,Mexico,NA,Veracruz,7643194,46,3,381,27
2020-04-22,Mexico,NA,Veracruz,7643194,29,6,410,33
2020-04-23,Mexico,NA,Veracruz,7643194,51,2,461,35
2020-04-24,Mexico,NA,Veracruz,7643194,49,4,510,39
2020-04-25,Mexico,NA,Veracruz,7643194,44,9,554,48
2020-04-26,Mexico,NA,Veracruz,7643194,30,10,584,58
2020-04-27,Mexico,NA,Veracruz,7643194,67,6,651,64
2020-04-28,Mexico,NA,Veracruz,7643194,75,3,726,67
2020-04-29,Mexico,NA,Veracruz,7643194,74,12,800,79
2020-04-30,Mexico,NA,Veracruz,7643194,64,3,864,82
2020-05-01,Mexico,NA,Veracruz,7643194,66,7,930,89
2020-05-02,Mexico,NA,Veracruz,7643194,65,15,995,104
2020-05-03,Mexico,NA,Veracruz,7643194,58,13,1053,117
2020-05-04,Mexico,NA,Veracruz,7643194,94,12,1147,129
2020-05-05,Mexico,NA,Veracruz,7643194,103,15,1250,144
2020-05-06,Mexico,NA,Veracruz,7643194,109,18,1359,162
2020-05-07,Mexico,NA,Veracruz,7643194,120,13,1479,175
2020-05-08,Mexico,NA,Veracruz,7643194,104,19,1583,194
2020-05-09,Mexico,NA,Veracruz,7643194,79,28,1662,222
2020-05-10,Mexico,NA,Veracruz,7643194,70,22,1732,244
2020-05-11,Mexico,NA,Veracruz,7643194,138,25,1870,269
2020-05-12,Mexico,NA,Veracruz,7643194,126,24,1996,293
2020-05-13,Mexico,NA,Veracruz,7643194,133,20,2129,313
2020-05-14,Mexico,NA,Veracruz,7643194,170,36,2299,349
2020-05-15,Mexico,NA,Veracruz,7643194,194,25,2493,374
2020-05-16,Mexico,NA,Veracruz,7643194,132,19,2625,393
2020-05-17,Mexico,NA,Veracruz,7643194,87,22,2712,415
2020-05-18,Mexico,NA,Veracruz,7643194,165,32,2877,447
2020-05-19,Mexico,NA,Veracruz,7643194,156,37,3033,484
2020-05-20,Mexico,NA,Veracruz,7643194,182,37,3215,521
2020-05-21,Mexico,NA,Veracruz,7643194,174,27,3389,548
2020-05-22,Mexico,NA,Veracruz,7643194,176,33,3565,581
2020-05-23,Mexico,NA,Veracruz,7643194,116,28,3681,609
2020-05-24,Mexico,NA,Veracruz,7643194,106,30,3787,639
2020-05-25,Mexico,NA,Veracruz,7643194,212,30,3999,669
2020-05-26,Mexico,NA,Veracruz,7643194,197,34,4196,703
2020-05-27,Mexico,NA,Veracruz,7643194,186,24,4382,727
2020-05-28,Mexico,NA,Veracruz,7643194,178,31,4560,758
2020-05-29,Mexico,NA,Veracruz,7643194,188,25,4748,783
2020-05-30,Mexico,NA,Veracruz,7643194,136,39,4884,822
2020-05-31,Mexico,NA,Veracruz,7643194,113,27,4997,849
2020-06-01,Mexico,NA,Veracruz,7643194,239,35,5236,884
2020-06-02,Mexico,NA,Veracruz,7643194,188,34,5424,918
2020-06-03,Mexico,NA,Veracruz,7643194,196,35,5620,953
2020-06-04,Mexico,NA,Veracruz,7643194,233,26,5853,979
2020-06-05,Mexico,NA,Veracruz,7643194,209,40,6062,1019
2020-06-06,Mexico,NA,Veracruz,7643194,111,29,6173,1048
2020-06-07,Mexico,NA,Veracruz,7643194,102,33,6275,1081
2020-06-08,Mexico,NA,Veracruz,7643194,218,43,6493,1124
2020-06-09,Mexico,NA,Veracruz,7643194,224,39,6717,1163
2020-06-10,Mexico,NA,Veracruz,7643194,235,41,6952,1204
2020-06-11,Mexico,NA,Veracruz,7643194,211,33,7163,1237
2020-06-12,Mexico,NA,Veracruz,7643194,191,33,7354,1270
2020-06-13,Mexico,NA,Veracruz,7643194,137,31,7491,1301
2020-06-14,Mexico,NA,Veracruz,7643194,138,35,7629,1336
2020-06-15,Mexico,NA,Veracruz,7643194,337,41,7966,1377
2020-06-16,Mexico,NA,Veracruz,7643194,309,42,8275,1419
2020-06-17,Mexico,NA,Veracruz,7643194,249,31,8524,1450
2020-06-18,Mexico,NA,Veracruz,7643194,263,31,8787,1481
2020-06-19,Mexico,NA,Veracruz,7643194,280,35,9067,1516
2020-06-20,Mexico,NA,Veracruz,7643194,166,42,9233,1558
2020-06-21,Mexico,NA,Veracruz,7643194,140,40,9373,1598
2020-06-22,Mexico,NA,Veracruz,7643194,370,26,9743,1624
2020-06-23,Mexico,NA,Veracruz,7643194,301,30,10044,1654
2020-06-24,Mexico,NA,Veracruz,7643194,299,34,10343,1688
2020-06-25,Mexico,NA,Veracruz,7643194,314,44,10657,1732
2020-06-26,Mexico,NA,Veracruz,7643194,323,36,10980,1768
2020-06-27,Mexico,NA,Veracruz,7643194,164,41,11144,1809
2020-06-28,Mexico,NA,Veracruz,7643194,162,38,11306,1847
2020-06-29,Mexico,NA,Veracruz,7643194,354,42,11660,1889
2020-06-30,Mexico,NA,Veracruz,7643194,383,31,12043,1920
2020-07-01,Mexico,NA,Veracruz,7643194,391,24,12434,1944
2020-07-02,Mexico,NA,Veracruz,7643194,375,28,12809,1972
2020-07-03,Mexico,NA,Veracruz,7643194,394,33,13203,2005
2020-07-04,Mexico,NA,Veracruz,7643194,173,38,13376,2043
2020-07-05,Mexico,NA,Veracruz,7643194,197,40,13573,2083
2020-07-06,Mexico,NA,Veracruz,7643194,379,45,13952,2128
2020-07-07,Mexico,NA,Veracruz,7643194,426,40,14378,2168
2020-07-08,Mexico,NA,Veracruz,7643194,404,52,14782,2220
2020-07-09,Mexico,NA,Veracruz,7643194,407,44,15189,2264
2020-07-10,Mexico,NA,Veracruz,7643194,343,44,15532,2308
2020-07-11,Mexico,NA,Veracruz,7643194,256,28,15788,2336
2020-07-12,Mexico,NA,Veracruz,7643194,218,29,16006,2365
2020-07-13,Mexico,NA,Veracruz,7643194,466,39,16472,2404
2020-07-14,Mexico,NA,Veracruz,7643194,454,36,16926,2440
2020-07-15,Mexico,NA,Veracruz,7643194,522,39,17448,2479
2020-07-16,Mexico,NA,Veracruz,7643194,443,51,17891,2530
2020-07-17,Mexico,NA,Veracruz,7643194,387,42,18278,2572
2020-07-18,Mexico,NA,Veracruz,7643194,246,43,18524,2615
2020-07-19,Mexico,NA,Veracruz,7643194,211,47,18735,2662
2020-07-20,Mexico,NA,Veracruz,7643194,486,43,19221,2705
2020-07-21,Mexico,NA,Veracruz,7643194,487,40,19708,2745
2020-07-22,Mexico,NA,Veracruz,7643194,429,36,20137,2781
2020-07-23,Mexico,NA,Veracruz,7643194,410,35,20547,2816
2020-07-24,Mexico,NA,Veracruz,7643194,456,39,21003,2855
2020-07-25,Mexico,NA,Veracruz,7643194,206,43,21209,2898
2020-07-26,Mexico,NA,Veracruz,7643194,234,47,21443,2945
2020-07-27,Mexico,NA,Veracruz,7643194,466,42,21909,2987
2020-07-28,Mexico,NA,Veracruz,7643194,366,42,22275,3029
2020-07-29,Mexico,NA,Veracruz,7643194,349,47,22624,3076
2020-07-30,Mexico,NA,Veracruz,7643194,340,35,22964,3111
2020-07-31,Mexico,NA,Veracruz,7643194,293,34,23257,3145
2020-08-01,Mexico,NA,Veracruz,7643194,171,30,23428,3175
2020-08-02,Mexico,NA,Veracruz,7643194,174,47,23602,3222
2020-08-03,Mexico,NA,Veracruz,7643194,361,40,23963,3262
2020-08-04,Mexico,NA,Veracruz,7643194,302,34,24265,3296
2020-08-05,Mexico,NA,Veracruz,7643194,298,28,24563,3324
2020-08-06,Mexico,NA,Veracruz,7643194,248,25,24811,3349
2020-08-07,Mexico,NA,Veracruz,7643194,278,29,25089,3378
2020-08-08,Mexico,NA,Veracruz,7643194,122,34,25211,3412
2020-08-09,Mexico,NA,Veracruz,7643194,112,27,25323,3439
2020-08-10,Mexico,NA,Veracruz,7643194,308,30,25631,3469
2020-08-11,Mexico,NA,Veracruz,7643194,250,26,25881,3495
2020-08-12,Mexico,NA,Veracruz,7643194,245,34,26126,3529
2020-08-13,Mexico,NA,Veracruz,7643194,241,30,26367,3559
2020-08-14,Mexico,NA,Veracruz,7643194,203,22,26570,3581
2020-08-15,Mexico,NA,Veracruz,7643194,108,20,26678,3601
2020-08-16,Mexico,NA,Veracruz,7643194,114,25,26792,3626
2020-08-17,Mexico,NA,Veracruz,7643194,265,23,27057,3649
2020-08-18,Mexico,NA,Veracruz,7643194,243,15,27300,3664
2020-08-19,Mexico,NA,Veracruz,7643194,206,29,27506,3693
2020-08-20,Mexico,NA,Veracruz,7643194,169,29,27675,3722
2020-08-21,Mexico,NA,Veracruz,7643194,164,20,27839,3742
2020-08-22,Mexico,NA,Veracruz,7643194,92,22,27931,3764
2020-08-23,Mexico,NA,Veracruz,7643194,101,19,28032,3783
2020-08-24,Mexico,NA,Veracruz,7643194,242,14,28274,3797
2020-08-25,Mexico,NA,Veracruz,7643194,224,17,28498,3814
2020-08-26,Mexico,NA,Veracruz,7643194,219,14,28717,3828
2020-08-27,Mexico,NA,Veracruz,7643194,183,16,28900,3844
2020-08-28,Mexico,NA,Veracruz,7643194,159,19,29059,3863
2020-08-29,Mexico,NA,Veracruz,7643194,102,17,29161,3880
2020-08-30,Mexico,NA,Veracruz,7643194,97,22,29258,3902
2020-08-31,Mexico,NA,Veracruz,7643194,230,20,29488,3922
2020-09-01,Mexico,NA,Veracruz,7643194,252,20,29740,3942
2020-09-02,Mexico,NA,Veracruz,7643194,249,18,29989,3960
2020-09-03,Mexico,NA,Veracruz,7643194,194,16,30183,3976
2020-09-04,Mexico,NA,Veracruz,7643194,176,17,30359,3993
2020-09-05,Mexico,NA,Veracruz,7643194,77,13,30436,4006
2020-09-06,Mexico,NA,Veracruz,7643194,81,13,30517,4019
2020-09-07,Mexico,NA,Veracruz,7643194,187,22,30704,4041
2020-09-08,Mexico,NA,Veracruz,7643194,216,12,30920,4053
2020-09-09,Mexico,NA,Veracruz,7643194,189,15,31109,4068
2020-09-10,Mexico,NA,Veracruz,7643194,171,18,31280,4086
2020-09-11,Mexico,NA,Veracruz,7643194,170,12,31450,4098
2020-09-12,Mexico,NA,Veracruz,7643194,67,20,31517,4118
2020-09-13,Mexico,NA,Veracruz,7643194,78,9,31595,4127
2020-09-14,Mexico,NA,Veracruz,7643194,163,16,31758,4143
2020-09-15,Mexico,NA,Veracruz,7643194,62,16,31820,4159
2020-09-16,Mexico,NA,Veracruz,7643194,86,18,31906,4177
2020-09-17,Mexico,NA,Veracruz,7643194,210,11,32116,4188
2020-09-18,Mexico,NA,Veracruz,7643194,137,11,32253,4199
2020-09-19,Mexico,NA,Veracruz,7643194,52,6,32305,4205
2020-09-20,Mexico,NA,Veracruz,7643194,42,9,32347,4214
2020-09-21,Mexico,NA,Veracruz,7643194,43,12,32390,4226
2020-09-22,Mexico,NA,Veracruz,7643194,2,5,32392,4231
2020-03-17,Mexico,NA,Yucatan,1955577,6,0,13,0
2020-03-19,Mexico,NA,Yucatan,1955577,2,0,15,0
2020-03-20,Mexico,NA,Yucatan,1955577,6,0,21,0
2020-03-22,Mexico,NA,Yucatan,1955577,8,0,29,0
2020-03-23,Mexico,NA,Yucatan,1955577,5,0,34,0
2020-03-24,Mexico,NA,Yucatan,1955577,8,0,42,0
2020-03-25,Mexico,NA,Yucatan,1955577,3,0,45,0
2020-03-27,Mexico,NA,Yucatan,1955577,3,0,48,0
2020-03-28,Mexico,NA,Yucatan,1955577,4,0,52,0
2020-03-29,Mexico,NA,Yucatan,1955577,2,0,54,0
2020-03-30,Mexico,NA,Yucatan,1955577,10,0,64,0
2020-03-31,Mexico,NA,Yucatan,1955577,4,0,68,0
2020-04-01,Mexico,NA,Yucatan,1955577,9,0,77,0
2020-04-02,Mexico,NA,Yucatan,1955577,3,0,80,0
2020-04-03,Mexico,NA,Yucatan,1955577,9,2,89,2
2020-04-04,Mexico,NA,Yucatan,1955577,2,0,91,2
2020-04-05,Mexico,NA,Yucatan,1955577,5,0,96,2
2020-04-06,Mexico,NA,Yucatan,1955577,13,1,109,3
2020-04-07,Mexico,NA,Yucatan,1955577,12,2,121,5
2020-04-08,Mexico,NA,Yucatan,1955577,9,0,130,5
2020-04-09,Mexico,NA,Yucatan,1955577,11,0,141,5
2020-04-10,Mexico,NA,Yucatan,1955577,4,3,145,8
2020-04-11,Mexico,NA,Yucatan,1955577,6,0,151,8
2020-04-12,Mexico,NA,Yucatan,1955577,7,0,158,8
2020-04-13,Mexico,NA,Yucatan,1955577,18,1,176,9
2020-04-14,Mexico,NA,Yucatan,1955577,18,0,194,9
2020-04-15,Mexico,NA,Yucatan,1955577,27,3,221,12
2020-04-16,Mexico,NA,Yucatan,1955577,12,1,233,13
2020-04-17,Mexico,NA,Yucatan,1955577,15,1,248,14
2020-04-18,Mexico,NA,Yucatan,1955577,6,0,254,14
2020-04-19,Mexico,NA,Yucatan,1955577,8,1,262,15
2020-04-20,Mexico,NA,Yucatan,1955577,26,2,288,17
2020-04-21,Mexico,NA,Yucatan,1955577,20,3,308,20
2020-04-22,Mexico,NA,Yucatan,1955577,22,1,330,21
2020-04-23,Mexico,NA,Yucatan,1955577,34,4,364,25
2020-04-24,Mexico,NA,Yucatan,1955577,34,2,398,27
2020-04-25,Mexico,NA,Yucatan,1955577,24,2,422,29
2020-04-26,Mexico,NA,Yucatan,1955577,20,1,442,30
2020-04-27,Mexico,NA,Yucatan,1955577,38,1,480,31
2020-04-28,Mexico,NA,Yucatan,1955577,43,3,523,34
2020-04-29,Mexico,NA,Yucatan,1955577,31,3,554,37
2020-04-30,Mexico,NA,Yucatan,1955577,60,1,614,38
2020-05-01,Mexico,NA,Yucatan,1955577,26,2,640,40
2020-05-02,Mexico,NA,Yucatan,1955577,29,5,669,45
2020-05-03,Mexico,NA,Yucatan,1955577,30,2,699,47
2020-05-04,Mexico,NA,Yucatan,1955577,49,2,748,49
2020-05-05,Mexico,NA,Yucatan,1955577,44,7,792,56
2020-05-06,Mexico,NA,Yucatan,1955577,34,4,826,60
2020-05-07,Mexico,NA,Yucatan,1955577,37,3,863,63
2020-05-08,Mexico,NA,Yucatan,1955577,36,2,899,65
2020-05-09,Mexico,NA,Yucatan,1955577,19,1,918,66
2020-05-10,Mexico,NA,Yucatan,1955577,27,7,945,73
2020-05-11,Mexico,NA,Yucatan,1955577,45,6,990,79
2020-05-12,Mexico,NA,Yucatan,1955577,52,7,1042,86
2020-05-13,Mexico,NA,Yucatan,1955577,59,5,1101,91
2020-05-14,Mexico,NA,Yucatan,1955577,58,7,1159,98
2020-05-15,Mexico,NA,Yucatan,1955577,42,1,1201,99
2020-05-16,Mexico,NA,Yucatan,1955577,32,3,1233,102
2020-05-17,Mexico,NA,Yucatan,1955577,49,8,1282,110
2020-05-18,Mexico,NA,Yucatan,1955577,54,5,1336,115
2020-05-19,Mexico,NA,Yucatan,1955577,53,3,1389,118
2020-05-20,Mexico,NA,Yucatan,1955577,57,11,1446,129
2020-05-21,Mexico,NA,Yucatan,1955577,71,5,1517,134
2020-05-22,Mexico,NA,Yucatan,1955577,62,6,1579,140
2020-05-23,Mexico,NA,Yucatan,1955577,34,8,1613,148
2020-05-24,Mexico,NA,Yucatan,1955577,30,2,1643,150
2020-05-25,Mexico,NA,Yucatan,1955577,53,7,1696,157
2020-05-26,Mexico,NA,Yucatan,1955577,57,10,1753,167
2020-05-27,Mexico,NA,Yucatan,1955577,61,9,1814,176
2020-05-28,Mexico,NA,Yucatan,1955577,60,8,1874,184
2020-05-29,Mexico,NA,Yucatan,1955577,46,7,1920,191
2020-05-30,Mexico,NA,Yucatan,1955577,29,9,1949,200
2020-05-31,Mexico,NA,Yucatan,1955577,25,5,1974,205
2020-06-01,Mexico,NA,Yucatan,1955577,58,10,2032,215
2020-06-02,Mexico,NA,Yucatan,1955577,48,8,2080,223
2020-06-03,Mexico,NA,Yucatan,1955577,50,2,2130,225
2020-06-04,Mexico,NA,Yucatan,1955577,44,5,2174,230
2020-06-05,Mexico,NA,Yucatan,1955577,34,4,2208,234
2020-06-06,Mexico,NA,Yucatan,1955577,44,6,2252,240
2020-06-07,Mexico,NA,Yucatan,1955577,36,4,2288,244
2020-06-08,Mexico,NA,Yucatan,1955577,89,5,2377,249
2020-06-09,Mexico,NA,Yucatan,1955577,68,9,2445,258
2020-06-10,Mexico,NA,Yucatan,1955577,75,10,2520,268
2020-06-11,Mexico,NA,Yucatan,1955577,84,6,2604,274
2020-06-12,Mexico,NA,Yucatan,1955577,67,5,2671,279
2020-06-13,Mexico,NA,Yucatan,1955577,41,8,2712,287
2020-06-14,Mexico,NA,Yucatan,1955577,59,12,2771,299
2020-06-15,Mexico,NA,Yucatan,1955577,104,13,2875,312
2020-06-16,Mexico,NA,Yucatan,1955577,97,6,2972,318
2020-06-17,Mexico,NA,Yucatan,1955577,118,7,3090,325
2020-06-18,Mexico,NA,Yucatan,1955577,101,10,3191,335
2020-06-19,Mexico,NA,Yucatan,1955577,110,3,3301,338
2020-06-20,Mexico,NA,Yucatan,1955577,95,9,3396,347
2020-06-21,Mexico,NA,Yucatan,1955577,89,9,3485,356
2020-06-22,Mexico,NA,Yucatan,1955577,144,7,3629,363
2020-06-23,Mexico,NA,Yucatan,1955577,153,12,3782,375
2020-06-24,Mexico,NA,Yucatan,1955577,173,21,3955,396
2020-06-25,Mexico,NA,Yucatan,1955577,189,17,4144,413
2020-06-26,Mexico,NA,Yucatan,1955577,143,8,4287,421
2020-06-27,Mexico,NA,Yucatan,1955577,98,6,4385,427
2020-06-28,Mexico,NA,Yucatan,1955577,71,7,4456,434
2020-06-29,Mexico,NA,Yucatan,1955577,192,15,4648,449
2020-06-30,Mexico,NA,Yucatan,1955577,160,23,4808,472
2020-07-01,Mexico,NA,Yucatan,1955577,165,15,4973,487
2020-07-02,Mexico,NA,Yucatan,1955577,156,10,5129,497
2020-07-03,Mexico,NA,Yucatan,1955577,195,15,5324,512
2020-07-04,Mexico,NA,Yucatan,1955577,71,16,5395,528
2020-07-05,Mexico,NA,Yucatan,1955577,72,8,5467,536
2020-07-06,Mexico,NA,Yucatan,1955577,174,19,5641,555
2020-07-07,Mexico,NA,Yucatan,1955577,183,22,5824,577
2020-07-08,Mexico,NA,Yucatan,1955577,182,15,6006,592
2020-07-09,Mexico,NA,Yucatan,1955577,187,14,6193,606
2020-07-10,Mexico,NA,Yucatan,1955577,180,23,6373,629
2020-07-11,Mexico,NA,Yucatan,1955577,89,11,6462,640
2020-07-12,Mexico,NA,Yucatan,1955577,94,14,6556,654
2020-07-13,Mexico,NA,Yucatan,1955577,198,19,6754,673
2020-07-14,Mexico,NA,Yucatan,1955577,189,15,6943,688
2020-07-15,Mexico,NA,Yucatan,1955577,192,26,7135,714
2020-07-16,Mexico,NA,Yucatan,1955577,207,15,7342,729
2020-07-17,Mexico,NA,Yucatan,1955577,187,7,7529,736
2020-07-18,Mexico,NA,Yucatan,1955577,94,16,7623,752
2020-07-19,Mexico,NA,Yucatan,1955577,85,15,7708,767
2020-07-20,Mexico,NA,Yucatan,1955577,252,18,7960,785
2020-07-21,Mexico,NA,Yucatan,1955577,233,23,8193,808
2020-07-22,Mexico,NA,Yucatan,1955577,246,29,8439,837
2020-07-23,Mexico,NA,Yucatan,1955577,236,25,8675,862
2020-07-24,Mexico,NA,Yucatan,1955577,247,17,8922,879
2020-07-25,Mexico,NA,Yucatan,1955577,100,13,9022,892
2020-07-26,Mexico,NA,Yucatan,1955577,92,13,9114,905
2020-07-27,Mexico,NA,Yucatan,1955577,262,20,9376,925
2020-07-28,Mexico,NA,Yucatan,1955577,330,21,9706,946
2020-07-29,Mexico,NA,Yucatan,1955577,293,14,9999,960
2020-07-30,Mexico,NA,Yucatan,1955577,369,8,10368,968
2020-07-31,Mexico,NA,Yucatan,1955577,235,17,10603,985
2020-08-01,Mexico,NA,Yucatan,1955577,122,21,10725,1006
2020-08-02,Mexico,NA,Yucatan,1955577,80,18,10805,1024
2020-08-03,Mexico,NA,Yucatan,1955577,211,19,11016,1043
2020-08-04,Mexico,NA,Yucatan,1955577,194,18,11210,1061
2020-08-05,Mexico,NA,Yucatan,1955577,176,16,11386,1077
2020-08-06,Mexico,NA,Yucatan,1955577,170,19,11556,1096
2020-08-07,Mexico,NA,Yucatan,1955577,158,11,11714,1107
2020-08-08,Mexico,NA,Yucatan,1955577,118,15,11832,1122
2020-08-09,Mexico,NA,Yucatan,1955577,97,14,11929,1136
2020-08-10,Mexico,NA,Yucatan,1955577,156,20,12085,1156
2020-08-11,Mexico,NA,Yucatan,1955577,177,16,12262,1172
2020-08-12,Mexico,NA,Yucatan,1955577,135,14,12397,1186
2020-08-13,Mexico,NA,Yucatan,1955577,144,20,12541,1206
2020-08-14,Mexico,NA,Yucatan,1955577,181,10,12722,1216
2020-08-15,Mexico,NA,Yucatan,1955577,103,14,12825,1230
2020-08-16,Mexico,NA,Yucatan,1955577,95,9,12920,1239
2020-08-17,Mexico,NA,Yucatan,1955577,177,12,13097,1251
2020-08-18,Mexico,NA,Yucatan,1955577,218,16,13315,1267
2020-08-19,Mexico,NA,Yucatan,1955577,137,10,13452,1277
2020-08-20,Mexico,NA,Yucatan,1955577,173,9,13625,1286
2020-08-21,Mexico,NA,Yucatan,1955577,152,20,13777,1306
2020-08-22,Mexico,NA,Yucatan,1955577,59,13,13836,1319
2020-08-23,Mexico,NA,Yucatan,1955577,108,7,13944,1326
2020-08-24,Mexico,NA,Yucatan,1955577,185,5,14129,1331
2020-08-25,Mexico,NA,Yucatan,1955577,169,13,14298,1344
2020-08-26,Mexico,NA,Yucatan,1955577,136,8,14434,1352
2020-08-27,Mexico,NA,Yucatan,1955577,252,12,14686,1364
2020-08-28,Mexico,NA,Yucatan,1955577,223,6,14909,1370
2020-08-29,Mexico,NA,Yucatan,1955577,49,4,14958,1374
2020-08-30,Mexico,NA,Yucatan,1955577,49,9,15007,1383
2020-08-31,Mexico,NA,Yucatan,1955577,172,8,15179,1391
2020-09-01,Mexico,NA,Yucatan,1955577,139,11,15318,1402
2020-09-02,Mexico,NA,Yucatan,1955577,169,15,15487,1417
2020-09-03,Mexico,NA,Yucatan,1955577,166,12,15653,1429
2020-09-04,Mexico,NA,Yucatan,1955577,137,8,15790,1437
2020-09-05,Mexico,NA,Yucatan,1955577,65,8,15855,1445
2020-09-06,Mexico,NA,Yucatan,1955577,72,8,15927,1453
2020-09-07,Mexico,NA,Yucatan,1955577,185,6,16112,1459
2020-09-08,Mexico,NA,Yucatan,1955577,177,3,16289,1462
2020-09-09,Mexico,NA,Yucatan,1955577,150,10,16439,1472
2020-09-10,Mexico,NA,Yucatan,1955577,144,7,16583,1479
2020-09-11,Mexico,NA,Yucatan,1955577,134,5,16717,1484
2020-09-12,Mexico,NA,Yucatan,1955577,68,2,16785,1486
2020-09-13,Mexico,NA,Yucatan,1955577,55,3,16840,1489
2020-09-14,Mexico,NA,Yucatan,1955577,97,3,16937,1492
2020-09-15,Mexico,NA,Yucatan,1955577,114,9,17051,1501
2020-09-16,Mexico,NA,Yucatan,1955577,38,4,17089,1505
2020-09-17,Mexico,NA,Yucatan,1955577,157,4,17246,1509
2020-09-18,Mexico,NA,Yucatan,1955577,117,4,17363,1513
2020-09-19,Mexico,NA,Yucatan,1955577,66,2,17429,1515
2020-09-20,Mexico,NA,Yucatan,1955577,39,6,17468,1521
2020-09-21,Mexico,NA,Yucatan,1955577,114,4,17582,1525
2020-09-22,Mexico,NA,Yucatan,1955577,88,1,17670,1526
2020-09-23,Mexico,NA,Yucatan,1955577,13,1,17683,1527
2020-04-02,Mexico,NA,Zacatecas,1490668,1,0,11,1
2020-04-04,Mexico,NA,Zacatecas,1490668,1,1,12,2
2020-04-05,Mexico,NA,Zacatecas,1490668,1,0,13,2
2020-04-06,Mexico,NA,Zacatecas,1490668,1,0,14,2
2020-04-08,Mexico,NA,Zacatecas,1490668,2,0,16,2
2020-04-09,Mexico,NA,Zacatecas,1490668,2,0,18,2
2020-04-11,Mexico,NA,Zacatecas,1490668,2,0,20,2
2020-04-12,Mexico,NA,Zacatecas,1490668,1,0,21,2
2020-04-14,Mexico,NA,Zacatecas,1490668,1,0,22,2
2020-04-15,Mexico,NA,Zacatecas,1490668,6,0,28,2
2020-04-16,Mexico,NA,Zacatecas,1490668,3,0,31,2
2020-04-17,Mexico,NA,Zacatecas,1490668,2,0,33,2
2020-04-18,Mexico,NA,Zacatecas,1490668,7,0,40,2
2020-04-19,Mexico,NA,Zacatecas,1490668,1,1,41,3
2020-04-20,Mexico,NA,Zacatecas,1490668,9,0,50,3
2020-04-21,Mexico,NA,Zacatecas,1490668,2,0,52,3
2020-04-22,Mexico,NA,Zacatecas,1490668,2,0,54,3
2020-04-23,Mexico,NA,Zacatecas,1490668,8,1,62,4
2020-04-24,Mexico,NA,Zacatecas,1490668,5,0,67,4
2020-04-25,Mexico,NA,Zacatecas,1490668,4,0,71,4
2020-04-26,Mexico,NA,Zacatecas,1490668,3,1,74,5
2020-04-27,Mexico,NA,Zacatecas,1490668,4,1,78,6
2020-04-28,Mexico,NA,Zacatecas,1490668,10,1,88,7
2020-04-29,Mexico,NA,Zacatecas,1490668,9,1,97,8
2020-04-30,Mexico,NA,Zacatecas,1490668,4,1,101,9
2020-05-01,Mexico,NA,Zacatecas,1490668,7,1,108,10
2020-05-02,Mexico,NA,Zacatecas,1490668,7,3,115,13
2020-05-03,Mexico,NA,Zacatecas,1490668,2,3,117,16
2020-05-04,Mexico,NA,Zacatecas,1490668,5,1,122,17
2020-05-05,Mexico,NA,Zacatecas,1490668,5,1,127,18
2020-05-06,Mexico,NA,Zacatecas,1490668,11,0,138,18
2020-05-07,Mexico,NA,Zacatecas,1490668,9,0,147,18
2020-05-08,Mexico,NA,Zacatecas,1490668,9,0,156,18
2020-05-09,Mexico,NA,Zacatecas,1490668,4,1,160,19
2020-05-10,Mexico,NA,Zacatecas,1490668,2,1,162,20
2020-05-11,Mexico,NA,Zacatecas,1490668,10,0,172,20
2020-05-12,Mexico,NA,Zacatecas,1490668,3,1,175,21
2020-05-13,Mexico,NA,Zacatecas,1490668,8,1,183,22
2020-05-14,Mexico,NA,Zacatecas,1490668,13,1,196,23
2020-05-15,Mexico,NA,Zacatecas,1490668,8,2,204,25
2020-05-16,Mexico,NA,Zacatecas,1490668,3,0,207,25
2020-05-17,Mexico,NA,Zacatecas,1490668,3,1,210,26
2020-05-18,Mexico,NA,Zacatecas,1490668,6,0,216,26
2020-05-19,Mexico,NA,Zacatecas,1490668,0,2,216,28
2020-05-20,Mexico,NA,Zacatecas,1490668,15,0,231,28
2020-05-21,Mexico,NA,Zacatecas,1490668,5,0,236,28
2020-05-22,Mexico,NA,Zacatecas,1490668,9,1,245,29
2020-05-23,Mexico,NA,Zacatecas,1490668,11,1,256,30
2020-05-24,Mexico,NA,Zacatecas,1490668,6,0,262,30
2020-05-25,Mexico,NA,Zacatecas,1490668,11,1,273,31
2020-05-26,Mexico,NA,Zacatecas,1490668,12,1,285,32
2020-05-27,Mexico,NA,Zacatecas,1490668,4,1,289,33
2020-05-28,Mexico,NA,Zacatecas,1490668,7,1,296,34
2020-05-29,Mexico,NA,Zacatecas,1490668,15,1,311,35
2020-05-30,Mexico,NA,Zacatecas,1490668,7,1,318,36
2020-05-31,Mexico,NA,Zacatecas,1490668,5,1,323,37
2020-06-01,Mexico,NA,Zacatecas,1490668,16,1,339,38
2020-06-02,Mexico,NA,Zacatecas,1490668,13,3,352,41
2020-06-03,Mexico,NA,Zacatecas,1490668,16,2,368,43
2020-06-04,Mexico,NA,Zacatecas,1490668,17,2,385,45
2020-06-05,Mexico,NA,Zacatecas,1490668,17,2,402,47
2020-06-06,Mexico,NA,Zacatecas,1490668,14,1,416,48
2020-06-07,Mexico,NA,Zacatecas,1490668,12,3,428,51
2020-06-08,Mexico,NA,Zacatecas,1490668,20,5,448,56
2020-06-09,Mexico,NA,Zacatecas,1490668,27,2,475,58
2020-06-10,Mexico,NA,Zacatecas,1490668,34,2,509,60
2020-06-11,Mexico,NA,Zacatecas,1490668,19,2,528,62
2020-06-12,Mexico,NA,Zacatecas,1490668,25,1,553,63
2020-06-13,Mexico,NA,Zacatecas,1490668,19,0,572,63
2020-06-14,Mexico,NA,Zacatecas,1490668,10,4,582,67
2020-06-15,Mexico,NA,Zacatecas,1490668,37,3,619,70
2020-06-16,Mexico,NA,Zacatecas,1490668,34,2,653,72
2020-06-17,Mexico,NA,Zacatecas,1490668,20,5,673,77
2020-06-18,Mexico,NA,Zacatecas,1490668,23,6,696,83
2020-06-19,Mexico,NA,Zacatecas,1490668,16,1,712,84
2020-06-20,Mexico,NA,Zacatecas,1490668,11,2,723,86
2020-06-21,Mexico,NA,Zacatecas,1490668,9,2,732,88
2020-06-22,Mexico,NA,Zacatecas,1490668,22,1,754,89
2020-06-23,Mexico,NA,Zacatecas,1490668,29,2,783,91
2020-06-24,Mexico,NA,Zacatecas,1490668,24,1,807,92
2020-06-25,Mexico,NA,Zacatecas,1490668,32,2,839,94
2020-06-26,Mexico,NA,Zacatecas,1490668,31,3,870,97
2020-06-27,Mexico,NA,Zacatecas,1490668,15,0,885,97
2020-06-28,Mexico,NA,Zacatecas,1490668,24,4,909,101
2020-06-29,Mexico,NA,Zacatecas,1490668,43,3,952,104
2020-06-30,Mexico,NA,Zacatecas,1490668,54,4,1006,108
2020-07-01,Mexico,NA,Zacatecas,1490668,45,3,1051,111
2020-07-02,Mexico,NA,Zacatecas,1490668,47,6,1098,117
2020-07-03,Mexico,NA,Zacatecas,1490668,49,4,1147,121
2020-07-04,Mexico,NA,Zacatecas,1490668,22,2,1169,123
2020-07-05,Mexico,NA,Zacatecas,1490668,20,1,1189,124
2020-07-06,Mexico,NA,Zacatecas,1490668,58,3,1247,127
2020-07-07,Mexico,NA,Zacatecas,1490668,45,7,1292,134
2020-07-08,Mexico,NA,Zacatecas,1490668,54,5,1346,139
2020-07-09,Mexico,NA,Zacatecas,1490668,38,3,1384,142
2020-07-10,Mexico,NA,Zacatecas,1490668,46,6,1430,148
2020-07-11,Mexico,NA,Zacatecas,1490668,55,4,1485,152
2020-07-12,Mexico,NA,Zacatecas,1490668,32,4,1517,156
2020-07-13,Mexico,NA,Zacatecas,1490668,46,1,1563,157
2020-07-14,Mexico,NA,Zacatecas,1490668,61,6,1624,163
2020-07-15,Mexico,NA,Zacatecas,1490668,76,8,1700,171
2020-07-16,Mexico,NA,Zacatecas,1490668,99,5,1799,176
2020-07-17,Mexico,NA,Zacatecas,1490668,55,3,1854,179
2020-07-18,Mexico,NA,Zacatecas,1490668,45,6,1899,185
2020-07-19,Mexico,NA,Zacatecas,1490668,25,5,1924,190
2020-07-20,Mexico,NA,Zacatecas,1490668,88,5,2012,195
2020-07-21,Mexico,NA,Zacatecas,1490668,85,6,2097,201
2020-07-22,Mexico,NA,Zacatecas,1490668,96,2,2193,203
2020-07-23,Mexico,NA,Zacatecas,1490668,81,8,2274,211
2020-07-24,Mexico,NA,Zacatecas,1490668,85,9,2359,220
2020-07-25,Mexico,NA,Zacatecas,1490668,62,8,2421,228
2020-07-26,Mexico,NA,Zacatecas,1490668,26,13,2447,241
2020-07-27,Mexico,NA,Zacatecas,1490668,78,2,2525,243
2020-07-28,Mexico,NA,Zacatecas,1490668,130,7,2655,250
2020-07-29,Mexico,NA,Zacatecas,1490668,73,8,2728,258
2020-07-30,Mexico,NA,Zacatecas,1490668,104,4,2832,262
2020-07-31,Mexico,NA,Zacatecas,1490668,78,7,2910,269
2020-08-01,Mexico,NA,Zacatecas,1490668,50,12,2960,281
2020-08-02,Mexico,NA,Zacatecas,1490668,42,6,3002,287
2020-08-03,Mexico,NA,Zacatecas,1490668,96,10,3098,297
2020-08-04,Mexico,NA,Zacatecas,1490668,87,7,3185,304
2020-08-05,Mexico,NA,Zacatecas,1490668,85,10,3270,314
2020-08-06,Mexico,NA,Zacatecas,1490668,100,11,3370,325
2020-08-07,Mexico,NA,Zacatecas,1490668,87,9,3457,334
2020-08-08,Mexico,NA,Zacatecas,1490668,93,17,3550,351
2020-08-09,Mexico,NA,Zacatecas,1490668,59,10,3609,361
2020-08-10,Mexico,NA,Zacatecas,1490668,110,6,3719,367
2020-08-11,Mexico,NA,Zacatecas,1490668,170,8,3889,375
2020-08-12,Mexico,NA,Zacatecas,1490668,135,8,4024,383
2020-08-13,Mexico,NA,Zacatecas,1490668,64,7,4088,390
2020-08-14,Mexico,NA,Zacatecas,1490668,72,5,4160,395
2020-08-15,Mexico,NA,Zacatecas,1490668,63,9,4223,404
2020-08-16,Mexico,NA,Zacatecas,1490668,47,2,4270,406
2020-08-17,Mexico,NA,Zacatecas,1490668,79,12,4349,418
2020-08-18,Mexico,NA,Zacatecas,1490668,101,5,4450,423
2020-08-19,Mexico,NA,Zacatecas,1490668,85,6,4535,429
2020-08-20,Mexico,NA,Zacatecas,1490668,95,7,4630,436
2020-08-21,Mexico,NA,Zacatecas,1490668,93,6,4723,442
2020-08-22,Mexico,NA,Zacatecas,1490668,49,13,4772,455
2020-08-23,Mexico,NA,Zacatecas,1490668,44,8,4816,463
2020-08-24,Mexico,NA,Zacatecas,1490668,94,9,4910,472
2020-08-25,Mexico,NA,Zacatecas,1490668,113,5,5023,477
2020-08-26,Mexico,NA,Zacatecas,1490668,86,9,5109,486
2020-08-27,Mexico,NA,Zacatecas,1490668,97,10,5206,496
2020-08-28,Mexico,NA,Zacatecas,1490668,95,5,5301,501
2020-08-29,Mexico,NA,Zacatecas,1490668,40,12,5341,513
2020-08-30,Mexico,NA,Zacatecas,1490668,32,5,5373,518
2020-08-31,Mexico,NA,Zacatecas,1490668,65,12,5438,530
2020-09-01,Mexico,NA,Zacatecas,1490668,89,10,5527,540
2020-09-02,Mexico,NA,Zacatecas,1490668,124,8,5651,548
2020-09-03,Mexico,NA,Zacatecas,1490668,77,6,5728,554
2020-09-04,Mexico,NA,Zacatecas,1490668,102,9,5830,563
2020-09-05,Mexico,NA,Zacatecas,1490668,52,5,5882,568
2020-09-06,Mexico,NA,Zacatecas,1490668,38,10,5920,578
2020-09-07,Mexico,NA,Zacatecas,1490668,74,13,5994,591
2020-09-08,Mexico,NA,Zacatecas,1490668,77,8,6071,599
2020-09-09,Mexico,NA,Zacatecas,1490668,76,13,6147,612
2020-09-10,Mexico,NA,Zacatecas,1490668,103,5,6250,617
2020-09-11,Mexico,NA,Zacatecas,1490668,88,4,6338,621
2020-09-12,Mexico,NA,Zacatecas,1490668,37,5,6375,626
2020-09-13,Mexico,NA,Zacatecas,1490668,35,4,6410,630
2020-09-14,Mexico,NA,Zacatecas,1490668,69,4,6479,634
2020-09-15,Mexico,NA,Zacatecas,1490668,90,8,6569,642
2020-09-16,Mexico,NA,Zacatecas,1490668,41,5,6610,647
2020-09-17,Mexico,NA,Zacatecas,1490668,107,4,6717,651
2020-09-18,Mexico,NA,Zacatecas,1490668,69,4,6786,655
2020-09-19,Mexico,NA,Zacatecas,1490668,31,5,6817,660
2020-09-20,Mexico,NA,Zacatecas,1490668,17,6,6834,666
2020-09-21,Mexico,NA,Zacatecas,1490668,69,4,6903,670
2020-09-22,Mexico,NA,Zacatecas,1490668,76,3,6979,673
2020-09-23,Mexico,NA,Zacatecas,1490668,15,3,6994,676
2020-03-13,Netherlands,NA,Drenthe,492167,0,0,13,0
2020-03-14,Netherlands,NA,Drenthe,492167,2,0,15,0
2020-03-15,Netherlands,NA,Drenthe,492167,0,0,15,0
2020-03-16,Netherlands,NA,Drenthe,492167,1,0,16,0
2020-03-17,Netherlands,NA,Drenthe,492167,1,0,17,0
2020-03-18,Netherlands,NA,Drenthe,492167,5,0,22,0
2020-03-19,Netherlands,NA,Drenthe,492167,3,1,25,1
2020-03-20,Netherlands,NA,Drenthe,492167,12,0,37,1
2020-03-21,Netherlands,NA,Drenthe,492167,1,0,38,1
2020-03-22,Netherlands,NA,Drenthe,492167,4,0,42,1
2020-03-23,Netherlands,NA,Drenthe,492167,7,1,49,2
2020-03-24,Netherlands,NA,Drenthe,492167,6,0,55,2
2020-03-25,Netherlands,NA,Drenthe,492167,5,0,60,2
2020-03-26,Netherlands,NA,Drenthe,492167,11,0,71,2
2020-03-27,Netherlands,NA,Drenthe,492167,8,1,79,3
2020-03-28,Netherlands,NA,Drenthe,492167,18,0,97,3
2020-03-29,Netherlands,NA,Drenthe,492167,15,0,112,3
2020-03-30,Netherlands,NA,Drenthe,492167,4,0,116,3
2020-03-31,Netherlands,NA,Drenthe,492167,7,1,123,4
2020-04-01,Netherlands,NA,Drenthe,492167,19,1,142,5
2020-04-02,Netherlands,NA,Drenthe,492167,15,3,157,8
2020-04-03,Netherlands,NA,Drenthe,492167,13,1,170,9
2020-04-04,Netherlands,NA,Drenthe,492167,22,2,192,11
2020-04-05,Netherlands,NA,Drenthe,492167,15,0,207,11
2020-04-06,Netherlands,NA,Drenthe,492167,8,0,215,11
2020-04-07,Netherlands,NA,Drenthe,492167,4,2,219,13
2020-04-08,Netherlands,NA,Drenthe,492167,13,0,232,13
2020-04-09,Netherlands,NA,Drenthe,492167,17,0,249,13
2020-04-10,Netherlands,NA,Drenthe,492167,17,0,266,13
2020-04-11,Netherlands,NA,Drenthe,492167,23,1,289,14
2020-04-12,Netherlands,NA,Drenthe,492167,15,0,304,14
2020-04-13,Netherlands,NA,Drenthe,492167,9,0,313,14
2020-04-14,Netherlands,NA,Drenthe,492167,6,0,319,14
2020-04-15,Netherlands,NA,Drenthe,492167,6,5,325,19
2020-04-16,Netherlands,NA,Drenthe,492167,15,1,340,20
2020-04-17,Netherlands,NA,Drenthe,492167,15,1,355,21
2020-04-18,Netherlands,NA,Drenthe,492167,18,2,373,23
2020-04-19,Netherlands,NA,Drenthe,492167,12,0,385,23
2020-04-20,Netherlands,NA,Drenthe,492167,9,0,394,23
2020-04-21,Netherlands,NA,Drenthe,492167,6,1,400,24
2020-04-22,Netherlands,NA,Drenthe,492167,5,2,405,26
2020-04-23,Netherlands,NA,Drenthe,492167,16,0,421,26
2020-04-24,Netherlands,NA,Drenthe,492167,16,2,437,28
2020-04-25,Netherlands,NA,Drenthe,492167,12,0,449,28
2020-04-26,Netherlands,NA,Drenthe,492167,0,0,449,28
2020-04-27,Netherlands,NA,Drenthe,492167,12,0,461,28
2020-04-28,Netherlands,NA,Drenthe,492167,0,0,461,28
2020-04-29,Netherlands,NA,Drenthe,492167,6,3,467,31
2020-04-30,Netherlands,NA,Drenthe,492167,6,0,473,31
2020-05-01,Netherlands,NA,Drenthe,492167,2,0,475,31
2020-05-02,Netherlands,NA,Drenthe,492167,6,1,481,32
2020-05-03,Netherlands,NA,Drenthe,492167,0,0,481,32
2020-05-04,Netherlands,NA,Drenthe,492167,4,0,485,32
2020-05-05,Netherlands,NA,Drenthe,492167,4,0,489,32
2020-05-06,Netherlands,NA,Drenthe,492167,2,0,491,32
2020-05-07,Netherlands,NA,Drenthe,492167,0,0,491,32
2020-05-08,Netherlands,NA,Drenthe,492167,1,0,492,32
2020-05-09,Netherlands,NA,Drenthe,492167,1,6,493,38
2020-05-10,Netherlands,NA,Drenthe,492167,1,0,494,38
2020-05-11,Netherlands,NA,Drenthe,492167,1,0,495,38
2020-05-12,Netherlands,NA,Drenthe,492167,1,0,496,38
2020-05-13,Netherlands,NA,Drenthe,492167,1,0,497,38
2020-05-14,Netherlands,NA,Drenthe,492167,0,0,497,38
2020-05-15,Netherlands,NA,Drenthe,492167,1,2,498,40
2020-05-16,Netherlands,NA,Drenthe,492167,0,0,498,40
2020-05-17,Netherlands,NA,Drenthe,492167,0,0,498,40
2020-05-18,Netherlands,NA,Drenthe,492167,1,0,499,40
2020-05-19,Netherlands,NA,Drenthe,492167,0,0,499,40
2020-05-20,Netherlands,NA,Drenthe,492167,2,0,501,40
2020-05-21,Netherlands,NA,Drenthe,492167,0,0,501,40
2020-05-22,Netherlands,NA,Drenthe,492167,2,0,503,40
2020-05-23,Netherlands,NA,Drenthe,492167,3,0,506,40
2020-05-24,Netherlands,NA,Drenthe,492167,0,0,506,40
2020-05-25,Netherlands,NA,Drenthe,492167,1,0,507,40
2020-05-26,Netherlands,NA,Drenthe,492167,0,0,507,40
2020-05-27,Netherlands,NA,Drenthe,492167,0,0,507,40
2020-05-28,Netherlands,NA,Drenthe,492167,0,0,507,40
2020-05-29,Netherlands,NA,Drenthe,492167,0,0,507,40
2020-05-30,Netherlands,NA,Drenthe,492167,0,0,507,40
2020-05-31,Netherlands,NA,Drenthe,492167,4,0,511,40
2020-06-01,Netherlands,NA,Drenthe,492167,0,0,511,40
2020-06-02,Netherlands,NA,Drenthe,492167,2,0,513,40
2020-06-03,Netherlands,NA,Drenthe,492167,0,0,513,40
2020-06-04,Netherlands,NA,Drenthe,492167,2,0,515,40
2020-06-05,Netherlands,NA,Drenthe,492167,3,0,518,40
2020-06-06,Netherlands,NA,Drenthe,492167,1,0,519,40
2020-06-07,Netherlands,NA,Drenthe,492167,4,0,523,40
2020-06-08,Netherlands,NA,Drenthe,492167,0,0,523,40
2020-06-09,Netherlands,NA,Drenthe,492167,0,0,523,40
2020-06-10,Netherlands,NA,Drenthe,492167,1,0,524,40
2020-06-11,Netherlands,NA,Drenthe,492167,1,0,525,40
2020-06-12,Netherlands,NA,Drenthe,492167,0,0,525,40
2020-06-13,Netherlands,NA,Drenthe,492167,0,0,525,40
2020-06-14,Netherlands,NA,Drenthe,492167,3,0,528,40
2020-06-15,Netherlands,NA,Drenthe,492167,1,0,529,40
2020-06-16,Netherlands,NA,Drenthe,492167,0,0,529,40
2020-06-17,Netherlands,NA,Drenthe,492167,2,0,531,40
2020-06-18,Netherlands,NA,Drenthe,492167,1,0,532,40
2020-06-19,Netherlands,NA,Drenthe,492167,0,1,532,41
2020-06-20,Netherlands,NA,Drenthe,492167,1,0,533,41
2020-06-21,Netherlands,NA,Drenthe,492167,0,0,533,41
2020-06-22,Netherlands,NA,Drenthe,492167,0,0,533,41
2020-06-23,Netherlands,NA,Drenthe,492167,0,0,533,41
2020-06-24,Netherlands,NA,Drenthe,492167,0,0,533,41
2020-06-25,Netherlands,NA,Drenthe,492167,0,0,533,41
2020-06-26,Netherlands,NA,Drenthe,492167,0,0,533,41
2020-06-27,Netherlands,NA,Drenthe,492167,0,0,533,41
2020-06-28,Netherlands,NA,Drenthe,492167,0,0,533,41
2020-06-29,Netherlands,NA,Drenthe,492167,0,0,533,41
2020-06-30,Netherlands,NA,Drenthe,492167,0,0,533,41
2020-07-01,Netherlands,NA,Drenthe,492167,0,0,533,41
2020-07-02,Netherlands,NA,Drenthe,492167,1,0,534,41
2020-07-03,Netherlands,NA,Drenthe,492167,0,0,534,41
2020-07-04,Netherlands,NA,Drenthe,492167,0,0,534,41
2020-07-05,Netherlands,NA,Drenthe,492167,0,0,534,41
2020-07-06,Netherlands,NA,Drenthe,492167,0,0,534,41
2020-07-07,Netherlands,NA,Drenthe,492167,0,0,534,41
2020-07-08,Netherlands,NA,Drenthe,492167,1,0,534,41
2020-07-09,Netherlands,NA,Drenthe,492167,0,0,534,41
2020-07-10,Netherlands,NA,Drenthe,492167,1,0,534,41
2020-07-11,Netherlands,NA,Drenthe,492167,0,0,534,41
2020-07-12,Netherlands,NA,Drenthe,492167,0,0,534,41
2020-07-13,Netherlands,NA,Drenthe,492167,0,0,534,41
2020-07-14,Netherlands,NA,Drenthe,492167,0,0,534,41
2020-07-15,Netherlands,NA,Drenthe,492167,2,0,534,41
2020-07-16,Netherlands,NA,Drenthe,492167,0,0,534,41
2020-07-17,Netherlands,NA,Drenthe,492167,2,0,536,41
2020-07-18,Netherlands,NA,Drenthe,492167,3,0,539,41
2020-07-19,Netherlands,NA,Drenthe,492167,0,0,539,41
2020-07-20,Netherlands,NA,Drenthe,492167,0,0,539,41
2020-07-21,Netherlands,NA,Drenthe,492167,1,0,540,41
2020-07-22,Netherlands,NA,Drenthe,492167,2,0,542,41
2020-07-23,Netherlands,NA,Drenthe,492167,3,0,545,41
2020-07-24,Netherlands,NA,Drenthe,492167,1,0,546,41
2020-07-25,Netherlands,NA,Drenthe,492167,2,0,548,41
2020-07-26,Netherlands,NA,Drenthe,492167,1,0,549,41
2020-07-27,Netherlands,NA,Drenthe,492167,0,0,549,41
2020-07-28,Netherlands,NA,Drenthe,492167,0,0,549,41
2020-07-29,Netherlands,NA,Drenthe,492167,0,0,549,41
2020-07-30,Netherlands,NA,Drenthe,492167,1,0,550,41
2020-07-31,Netherlands,NA,Drenthe,492167,1,0,551,41
2020-08-01,Netherlands,NA,Drenthe,492167,1,0,552,41
2020-08-02,Netherlands,NA,Drenthe,492167,1,0,553,41
2020-08-03,Netherlands,NA,Drenthe,492167,1,0,554,41
2020-08-04,Netherlands,NA,Drenthe,492167,0,0,554,41
2020-08-05,Netherlands,NA,Drenthe,492167,5,0,559,41
2020-08-06,Netherlands,NA,Drenthe,492167,3,0,562,41
2020-08-07,Netherlands,NA,Drenthe,492167,1,0,563,41
2020-08-08,Netherlands,NA,Drenthe,492167,3,0,566,41
2020-08-09,Netherlands,NA,Drenthe,492167,5,0,571,41
2020-08-10,Netherlands,NA,Drenthe,492167,0,0,571,41
2020-08-11,Netherlands,NA,Drenthe,492167,2,0,573,41
2020-08-12,Netherlands,NA,Drenthe,492167,2,0,575,41
2020-08-13,Netherlands,NA,Drenthe,492167,3,0,578,41
2020-08-14,Netherlands,NA,Drenthe,492167,1,0,579,41
2020-08-15,Netherlands,NA,Drenthe,492167,2,0,581,41
2020-08-16,Netherlands,NA,Drenthe,492167,1,0,582,41
2020-08-17,Netherlands,NA,Drenthe,492167,3,0,585,41
2020-08-18,Netherlands,NA,Drenthe,492167,1,0,586,41
2020-08-19,Netherlands,NA,Drenthe,492167,1,0,587,41
2020-08-20,Netherlands,NA,Drenthe,492167,3,0,590,41
2020-08-21,Netherlands,NA,Drenthe,492167,2,0,592,41
2020-08-22,Netherlands,NA,Drenthe,492167,3,0,595,41
2020-08-23,Netherlands,NA,Drenthe,492167,4,0,599,41
2020-08-24,Netherlands,NA,Drenthe,492167,0,0,599,41
2020-08-25,Netherlands,NA,Drenthe,492167,3,0,602,41
2020-08-26,Netherlands,NA,Drenthe,492167,1,0,603,41
2020-08-27,Netherlands,NA,Drenthe,492167,2,0,605,41
2020-08-28,Netherlands,NA,Drenthe,492167,1,0,606,41
2020-08-29,Netherlands,NA,Drenthe,492167,1,0,607,41
2020-08-30,Netherlands,NA,Drenthe,492167,2,0,609,41
2020-08-31,Netherlands,NA,Drenthe,492167,1,0,610,41
2020-09-01,Netherlands,NA,Drenthe,492167,0,0,610,41
2020-09-02,Netherlands,NA,Drenthe,492167,0,0,610,41
2020-09-03,Netherlands,NA,Drenthe,492167,2,0,612,41
2020-09-04,Netherlands,NA,Drenthe,492167,3,0,615,41
2020-09-05,Netherlands,NA,Drenthe,492167,2,0,617,41
2020-09-06,Netherlands,NA,Drenthe,492167,3,0,620,41
2020-09-07,Netherlands,NA,Drenthe,492167,6,0,626,41
2020-09-08,Netherlands,NA,Drenthe,492167,0,0,626,41
2020-09-09,Netherlands,NA,Drenthe,492167,3,0,629,41
2020-09-10,Netherlands,NA,Drenthe,492167,7,0,636,41
2020-09-11,Netherlands,NA,Drenthe,492167,1,0,637,41
2020-09-12,Netherlands,NA,Drenthe,492167,5,0,642,41
2020-09-13,Netherlands,NA,Drenthe,492167,8,0,650,41
2020-09-14,Netherlands,NA,Drenthe,492167,5,0,655,41
2020-09-15,Netherlands,NA,Drenthe,492167,8,0,663,41
2020-09-16,Netherlands,NA,Drenthe,492167,10,0,673,41
2020-09-17,Netherlands,NA,Drenthe,492167,15,0,688,41
2020-09-18,Netherlands,NA,Drenthe,492167,18,0,706,41
2020-09-19,Netherlands,NA,Drenthe,492167,16,0,722,41
2020-09-20,Netherlands,NA,Drenthe,492167,23,0,745,41
2020-09-21,Netherlands,NA,Drenthe,492167,46,0,791,41
2020-09-22,Netherlands,NA,Drenthe,492167,16,0,807,41
2020-09-23,Netherlands,NA,Drenthe,492167,35,0,842,41
2020-03-14,Netherlands,NA,Flevoland,416546,7,0,14,0
2020-03-15,Netherlands,NA,Flevoland,416546,5,0,19,0
2020-03-16,Netherlands,NA,Flevoland,416546,3,0,22,0
2020-03-17,Netherlands,NA,Flevoland,416546,2,0,24,0
2020-03-18,Netherlands,NA,Flevoland,416546,6,0,30,0
2020-03-19,Netherlands,NA,Flevoland,416546,6,0,36,0
2020-03-20,Netherlands,NA,Flevoland,416546,14,0,50,0
2020-03-21,Netherlands,NA,Flevoland,416546,1,0,51,0
2020-03-22,Netherlands,NA,Flevoland,416546,7,1,58,1
2020-03-23,Netherlands,NA,Flevoland,416546,7,1,65,2
2020-03-24,Netherlands,NA,Flevoland,416546,7,1,72,3
2020-03-25,Netherlands,NA,Flevoland,416546,11,1,83,4
2020-03-26,Netherlands,NA,Flevoland,416546,10,1,93,5
2020-03-27,Netherlands,NA,Flevoland,416546,13,0,106,5
2020-03-28,Netherlands,NA,Flevoland,416546,12,0,118,5
2020-03-29,Netherlands,NA,Flevoland,416546,17,0,135,5
2020-03-30,Netherlands,NA,Flevoland,416546,7,0,142,5
2020-03-31,Netherlands,NA,Flevoland,416546,19,1,161,6
2020-04-01,Netherlands,NA,Flevoland,416546,23,1,184,7
2020-04-02,Netherlands,NA,Flevoland,416546,14,1,198,8
2020-04-03,Netherlands,NA,Flevoland,416546,22,3,220,11
2020-04-04,Netherlands,NA,Flevoland,416546,9,2,229,13
2020-04-05,Netherlands,NA,Flevoland,416546,17,1,246,14
2020-04-06,Netherlands,NA,Flevoland,416546,7,0,253,14
2020-04-07,Netherlands,NA,Flevoland,416546,13,1,266,15
2020-04-08,Netherlands,NA,Flevoland,416546,19,2,285,17
2020-04-09,Netherlands,NA,Flevoland,416546,14,4,299,21
2020-04-10,Netherlands,NA,Flevoland,416546,28,0,327,21
2020-04-11,Netherlands,NA,Flevoland,416546,37,1,364,22
2020-04-12,Netherlands,NA,Flevoland,416546,15,0,379,22
2020-04-13,Netherlands,NA,Flevoland,416546,34,1,413,23
2020-04-14,Netherlands,NA,Flevoland,416546,8,1,421,24
2020-04-15,Netherlands,NA,Flevoland,416546,15,1,436,25
2020-04-16,Netherlands,NA,Flevoland,416546,21,1,457,26
2020-04-17,Netherlands,NA,Flevoland,416546,48,0,505,26
2020-04-18,Netherlands,NA,Flevoland,416546,46,0,551,26
2020-04-19,Netherlands,NA,Flevoland,416546,21,0,572,26
2020-04-20,Netherlands,NA,Flevoland,416546,6,1,578,27
2020-04-21,Netherlands,NA,Flevoland,416546,21,3,599,30
2020-04-22,Netherlands,NA,Flevoland,416546,21,2,620,32
2020-04-23,Netherlands,NA,Flevoland,416546,28,0,648,32
2020-04-24,Netherlands,NA,Flevoland,416546,12,0,660,32
2020-04-25,Netherlands,NA,Flevoland,416546,25,3,685,35
2020-04-26,Netherlands,NA,Flevoland,416546,21,7,706,42
2020-04-27,Netherlands,NA,Flevoland,416546,5,2,711,44
2020-04-28,Netherlands,NA,Flevoland,416546,3,1,714,45
2020-04-29,Netherlands,NA,Flevoland,416546,9,1,723,46
2020-04-30,Netherlands,NA,Flevoland,416546,9,1,732,47
2020-05-01,Netherlands,NA,Flevoland,416546,14,4,746,51
2020-05-02,Netherlands,NA,Flevoland,416546,16,4,762,55
2020-05-03,Netherlands,NA,Flevoland,416546,2,0,764,55
2020-05-04,Netherlands,NA,Flevoland,416546,6,1,770,56
2020-05-05,Netherlands,NA,Flevoland,416546,15,2,785,58
2020-05-06,Netherlands,NA,Flevoland,416546,17,0,802,58
2020-05-07,Netherlands,NA,Flevoland,416546,5,7,807,65
2020-05-08,Netherlands,NA,Flevoland,416546,13,1,820,66
2020-05-09,Netherlands,NA,Flevoland,416546,14,5,834,71
2020-05-10,Netherlands,NA,Flevoland,416546,15,0,849,71
2020-05-11,Netherlands,NA,Flevoland,416546,1,0,850,71
2020-05-12,Netherlands,NA,Flevoland,416546,8,1,858,72
2020-05-13,Netherlands,NA,Flevoland,416546,3,1,861,73
2020-05-14,Netherlands,NA,Flevoland,416546,2,0,863,73
2020-05-15,Netherlands,NA,Flevoland,416546,6,8,869,81
2020-05-16,Netherlands,NA,Flevoland,416546,4,1,873,82
2020-05-17,Netherlands,NA,Flevoland,416546,6,0,879,82
2020-05-18,Netherlands,NA,Flevoland,416546,2,0,881,82
2020-05-19,Netherlands,NA,Flevoland,416546,1,0,882,82
2020-05-20,Netherlands,NA,Flevoland,416546,6,0,888,82
2020-05-21,Netherlands,NA,Flevoland,416546,5,0,893,82
2020-05-22,Netherlands,NA,Flevoland,416546,4,0,897,82
2020-05-23,Netherlands,NA,Flevoland,416546,0,0,897,82
2020-05-24,Netherlands,NA,Flevoland,416546,2,0,899,82
2020-05-25,Netherlands,NA,Flevoland,416546,1,0,900,82
2020-05-26,Netherlands,NA,Flevoland,416546,6,1,906,83
2020-05-27,Netherlands,NA,Flevoland,416546,5,2,911,85
2020-05-28,Netherlands,NA,Flevoland,416546,4,2,915,87
2020-05-29,Netherlands,NA,Flevoland,416546,3,0,918,87
2020-05-30,Netherlands,NA,Flevoland,416546,2,1,920,88
2020-05-31,Netherlands,NA,Flevoland,416546,6,0,926,88
2020-06-01,Netherlands,NA,Flevoland,416546,2,0,928,88
2020-06-02,Netherlands,NA,Flevoland,416546,0,0,928,88
2020-06-03,Netherlands,NA,Flevoland,416546,2,1,930,89
2020-06-04,Netherlands,NA,Flevoland,416546,8,0,938,89
2020-06-05,Netherlands,NA,Flevoland,416546,3,0,941,89
2020-06-06,Netherlands,NA,Flevoland,416546,4,0,945,89
2020-06-07,Netherlands,NA,Flevoland,416546,2,0,947,89
2020-06-08,Netherlands,NA,Flevoland,416546,0,0,947,89
2020-06-09,Netherlands,NA,Flevoland,416546,1,0,948,89
2020-06-10,Netherlands,NA,Flevoland,416546,3,0,951,89
2020-06-11,Netherlands,NA,Flevoland,416546,1,0,952,89
2020-06-12,Netherlands,NA,Flevoland,416546,3,0,955,89
2020-06-13,Netherlands,NA,Flevoland,416546,1,1,956,90
2020-06-14,Netherlands,NA,Flevoland,416546,2,0,958,90
2020-06-15,Netherlands,NA,Flevoland,416546,7,1,965,91
2020-06-16,Netherlands,NA,Flevoland,416546,1,0,966,91
2020-06-17,Netherlands,NA,Flevoland,416546,2,0,968,91
2020-06-18,Netherlands,NA,Flevoland,416546,3,0,971,91
2020-06-19,Netherlands,NA,Flevoland,416546,3,0,974,91
2020-06-20,Netherlands,NA,Flevoland,416546,0,0,974,91
2020-06-21,Netherlands,NA,Flevoland,416546,0,0,974,91
2020-06-22,Netherlands,NA,Flevoland,416546,0,0,974,91
2020-06-23,Netherlands,NA,Flevoland,416546,0,0,974,91
2020-06-24,Netherlands,NA,Flevoland,416546,4,0,976,91
2020-06-25,Netherlands,NA,Flevoland,416546,1,0,977,91
2020-06-26,Netherlands,NA,Flevoland,416546,0,0,977,91
2020-06-27,Netherlands,NA,Flevoland,416546,2,0,979,91
2020-06-28,Netherlands,NA,Flevoland,416546,2,0,981,91
2020-06-29,Netherlands,NA,Flevoland,416546,0,0,981,91
2020-06-30,Netherlands,NA,Flevoland,416546,3,0,984,91
2020-07-01,Netherlands,NA,Flevoland,416546,1,0,985,91
2020-07-02,Netherlands,NA,Flevoland,416546,0,0,985,91
2020-07-03,Netherlands,NA,Flevoland,416546,1,1,986,92
2020-07-04,Netherlands,NA,Flevoland,416546,2,0,988,92
2020-07-05,Netherlands,NA,Flevoland,416546,0,0,988,92
2020-07-06,Netherlands,NA,Flevoland,416546,0,0,988,92
2020-07-07,Netherlands,NA,Flevoland,416546,0,0,988,92
2020-07-08,Netherlands,NA,Flevoland,416546,0,0,988,92
2020-07-09,Netherlands,NA,Flevoland,416546,0,0,988,92
2020-07-10,Netherlands,NA,Flevoland,416546,0,0,988,92
2020-07-11,Netherlands,NA,Flevoland,416546,0,0,988,92
2020-07-12,Netherlands,NA,Flevoland,416546,0,0,988,92
2020-07-13,Netherlands,NA,Flevoland,416546,0,0,988,92
2020-07-14,Netherlands,NA,Flevoland,416546,0,0,988,92
2020-07-15,Netherlands,NA,Flevoland,416546,0,0,988,92
2020-07-16,Netherlands,NA,Flevoland,416546,0,0,988,92
2020-07-17,Netherlands,NA,Flevoland,416546,0,0,988,92
2020-07-18,Netherlands,NA,Flevoland,416546,0,0,988,92
2020-07-19,Netherlands,NA,Flevoland,416546,0,0,988,92
2020-07-20,Netherlands,NA,Flevoland,416546,1,0,988,92
2020-07-21,Netherlands,NA,Flevoland,416546,1,0,988,92
2020-07-22,Netherlands,NA,Flevoland,416546,0,0,988,92
2020-07-23,Netherlands,NA,Flevoland,416546,1,0,988,92
2020-07-24,Netherlands,NA,Flevoland,416546,2,0,988,92
2020-07-25,Netherlands,NA,Flevoland,416546,3,0,989,92
2020-07-26,Netherlands,NA,Flevoland,416546,1,0,990,92
2020-07-27,Netherlands,NA,Flevoland,416546,1,0,991,92
2020-07-28,Netherlands,NA,Flevoland,416546,2,0,993,92
2020-07-29,Netherlands,NA,Flevoland,416546,4,1,997,93
2020-07-30,Netherlands,NA,Flevoland,416546,1,0,998,93
2020-07-31,Netherlands,NA,Flevoland,416546,9,0,1007,93
2020-08-01,Netherlands,NA,Flevoland,416546,8,0,1015,93
2020-08-02,Netherlands,NA,Flevoland,416546,4,0,1019,93
2020-08-03,Netherlands,NA,Flevoland,416546,8,0,1027,93
2020-08-04,Netherlands,NA,Flevoland,416546,6,0,1033,93
2020-08-05,Netherlands,NA,Flevoland,416546,3,0,1036,93
2020-08-06,Netherlands,NA,Flevoland,416546,5,0,1041,93
2020-08-07,Netherlands,NA,Flevoland,416546,5,0,1046,93
2020-08-08,Netherlands,NA,Flevoland,416546,4,0,1050,93
2020-08-09,Netherlands,NA,Flevoland,416546,5,0,1055,93
2020-08-10,Netherlands,NA,Flevoland,416546,2,0,1057,93
2020-08-11,Netherlands,NA,Flevoland,416546,45,0,1102,93
2020-08-12,Netherlands,NA,Flevoland,416546,10,0,1112,93
2020-08-13,Netherlands,NA,Flevoland,416546,9,0,1121,93
2020-08-14,Netherlands,NA,Flevoland,416546,19,0,1140,93
2020-08-15,Netherlands,NA,Flevoland,416546,6,0,1146,93
2020-08-16,Netherlands,NA,Flevoland,416546,10,0,1156,93
2020-08-17,Netherlands,NA,Flevoland,416546,13,0,1169,93
2020-08-18,Netherlands,NA,Flevoland,416546,7,0,1176,93
2020-08-19,Netherlands,NA,Flevoland,416546,15,0,1191,93
2020-08-20,Netherlands,NA,Flevoland,416546,13,0,1204,93
2020-08-21,Netherlands,NA,Flevoland,416546,13,0,1217,93
2020-08-22,Netherlands,NA,Flevoland,416546,16,0,1233,93
2020-08-23,Netherlands,NA,Flevoland,416546,11,0,1244,93
2020-08-24,Netherlands,NA,Flevoland,416546,6,0,1250,93
2020-08-25,Netherlands,NA,Flevoland,416546,12,0,1262,93
2020-08-26,Netherlands,NA,Flevoland,416546,8,0,1270,93
2020-08-27,Netherlands,NA,Flevoland,416546,9,1,1279,94
2020-08-28,Netherlands,NA,Flevoland,416546,12,0,1291,94
2020-08-29,Netherlands,NA,Flevoland,416546,16,0,1307,94
2020-08-30,Netherlands,NA,Flevoland,416546,8,0,1315,94
2020-08-31,Netherlands,NA,Flevoland,416546,3,0,1318,94
2020-09-01,Netherlands,NA,Flevoland,416546,13,1,1331,95
2020-09-02,Netherlands,NA,Flevoland,416546,14,0,1345,95
2020-09-03,Netherlands,NA,Flevoland,416546,17,0,1362,95
2020-09-04,Netherlands,NA,Flevoland,416546,8,0,1370,95
2020-09-05,Netherlands,NA,Flevoland,416546,17,0,1387,95
2020-09-06,Netherlands,NA,Flevoland,416546,24,0,1411,95
2020-09-07,Netherlands,NA,Flevoland,416546,18,0,1429,95
2020-09-08,Netherlands,NA,Flevoland,416546,19,0,1448,95
2020-09-09,Netherlands,NA,Flevoland,416546,27,0,1475,95
2020-09-10,Netherlands,NA,Flevoland,416546,16,1,1491,96
2020-09-11,Netherlands,NA,Flevoland,416546,25,0,1516,96
2020-09-12,Netherlands,NA,Flevoland,416546,22,0,1538,96
2020-09-13,Netherlands,NA,Flevoland,416546,23,0,1561,96
2020-09-14,Netherlands,NA,Flevoland,416546,27,0,1588,96
2020-09-15,Netherlands,NA,Flevoland,416546,25,0,1613,96
2020-09-16,Netherlands,NA,Flevoland,416546,40,0,1653,96
2020-09-17,Netherlands,NA,Flevoland,416546,30,0,1683,96
2020-09-18,Netherlands,NA,Flevoland,416546,31,1,1714,97
2020-09-19,Netherlands,NA,Flevoland,416546,48,0,1762,97
2020-09-20,Netherlands,NA,Flevoland,416546,25,0,1787,97
2020-09-21,Netherlands,NA,Flevoland,416546,25,0,1812,97
2020-09-22,Netherlands,NA,Flevoland,416546,40,1,1852,98
2020-09-23,Netherlands,NA,Flevoland,416546,49,1,1901,99
2020-03-16,Netherlands,NA,Friesland,647672,3,0,13,0
2020-03-17,Netherlands,NA,Friesland,647672,1,0,14,0
2020-03-18,Netherlands,NA,Friesland,647672,4,0,18,0
2020-03-19,Netherlands,NA,Friesland,647672,2,1,20,1
2020-03-20,Netherlands,NA,Friesland,647672,19,0,39,1
2020-03-21,Netherlands,NA,Friesland,647672,0,0,39,1
2020-03-22,Netherlands,NA,Friesland,647672,1,0,39,1
2020-03-23,Netherlands,NA,Friesland,647672,5,0,39,1
2020-03-24,Netherlands,NA,Friesland,647672,2,0,41,1
2020-03-25,Netherlands,NA,Friesland,647672,10,0,51,1
2020-03-26,Netherlands,NA,Friesland,647672,17,1,68,2
2020-03-27,Netherlands,NA,Friesland,647672,13,1,81,3
2020-03-28,Netherlands,NA,Friesland,647672,15,0,96,3
2020-03-29,Netherlands,NA,Friesland,647672,23,1,119,4
2020-03-30,Netherlands,NA,Friesland,647672,5,2,124,6
2020-03-31,Netherlands,NA,Friesland,647672,7,5,131,11
2020-04-01,Netherlands,NA,Friesland,647672,14,0,145,11
2020-04-02,Netherlands,NA,Friesland,647672,20,2,165,13
2020-04-03,Netherlands,NA,Friesland,647672,17,1,182,14
2020-04-04,Netherlands,NA,Friesland,647672,17,2,199,16
2020-04-05,Netherlands,NA,Friesland,647672,16,0,215,16
2020-04-06,Netherlands,NA,Friesland,647672,7,3,222,19
2020-04-07,Netherlands,NA,Friesland,647672,6,2,228,21
2020-04-08,Netherlands,NA,Friesland,647672,33,0,261,21
2020-04-09,Netherlands,NA,Friesland,647672,36,1,297,22
2020-04-10,Netherlands,NA,Friesland,647672,32,1,329,23
2020-04-11,Netherlands,NA,Friesland,647672,15,0,344,23
2020-04-12,Netherlands,NA,Friesland,647672,18,1,362,24
2020-04-13,Netherlands,NA,Friesland,647672,13,4,375,28
2020-04-14,Netherlands,NA,Friesland,647672,9,1,384,29
2020-04-15,Netherlands,NA,Friesland,647672,10,1,394,30
2020-04-16,Netherlands,NA,Friesland,647672,29,5,423,35
2020-04-17,Netherlands,NA,Friesland,647672,22,1,445,36
2020-04-18,Netherlands,NA,Friesland,647672,11,2,456,38
2020-04-19,Netherlands,NA,Friesland,647672,14,2,470,40
2020-04-20,Netherlands,NA,Friesland,647672,3,3,473,43
2020-04-21,Netherlands,NA,Friesland,647672,6,3,479,46
2020-04-22,Netherlands,NA,Friesland,647672,13,0,492,46
2020-04-23,Netherlands,NA,Friesland,647672,7,2,499,48
2020-04-24,Netherlands,NA,Friesland,647672,12,3,511,51
2020-04-25,Netherlands,NA,Friesland,647672,4,1,515,52
2020-04-26,Netherlands,NA,Friesland,647672,4,0,519,52
2020-04-27,Netherlands,NA,Friesland,647672,1,0,520,52
2020-04-28,Netherlands,NA,Friesland,647672,2,1,522,53
2020-04-29,Netherlands,NA,Friesland,647672,4,2,526,55
2020-04-30,Netherlands,NA,Friesland,647672,3,2,529,57
2020-05-01,Netherlands,NA,Friesland,647672,3,0,532,57
2020-05-02,Netherlands,NA,Friesland,647672,5,0,537,57
2020-05-03,Netherlands,NA,Friesland,647672,0,1,537,58
2020-05-04,Netherlands,NA,Friesland,647672,2,0,539,58
2020-05-05,Netherlands,NA,Friesland,647672,1,1,540,59
2020-05-06,Netherlands,NA,Friesland,647672,5,0,545,59
2020-05-07,Netherlands,NA,Friesland,647672,3,0,548,59
2020-05-08,Netherlands,NA,Friesland,647672,19,0,567,59
2020-05-09,Netherlands,NA,Friesland,647672,4,0,571,59
2020-05-10,Netherlands,NA,Friesland,647672,5,0,576,59
2020-05-11,Netherlands,NA,Friesland,647672,6,0,582,59
2020-05-12,Netherlands,NA,Friesland,647672,6,0,588,59
2020-05-13,Netherlands,NA,Friesland,647672,2,0,590,59
2020-05-14,Netherlands,NA,Friesland,647672,2,1,592,60
2020-05-15,Netherlands,NA,Friesland,647672,2,0,594,60
2020-05-16,Netherlands,NA,Friesland,647672,2,0,596,60
2020-05-17,Netherlands,NA,Friesland,647672,1,0,597,60
2020-05-18,Netherlands,NA,Friesland,647672,1,0,598,60
2020-05-19,Netherlands,NA,Friesland,647672,0,0,598,60
2020-05-20,Netherlands,NA,Friesland,647672,2,0,600,60
2020-05-21,Netherlands,NA,Friesland,647672,2,0,602,60
2020-05-22,Netherlands,NA,Friesland,647672,2,2,604,62
2020-05-23,Netherlands,NA,Friesland,647672,0,0,604,62
2020-05-24,Netherlands,NA,Friesland,647672,1,0,605,62
2020-05-25,Netherlands,NA,Friesland,647672,0,0,605,62
2020-05-26,Netherlands,NA,Friesland,647672,0,0,605,62
2020-05-27,Netherlands,NA,Friesland,647672,1,0,606,62
2020-05-28,Netherlands,NA,Friesland,647672,0,0,606,62
2020-05-29,Netherlands,NA,Friesland,647672,2,2,608,64
2020-05-30,Netherlands,NA,Friesland,647672,0,0,608,64
2020-05-31,Netherlands,NA,Friesland,647672,0,0,608,64
2020-06-01,Netherlands,NA,Friesland,647672,0,0,608,64
2020-06-02,Netherlands,NA,Friesland,647672,0,0,608,64
2020-06-03,Netherlands,NA,Friesland,647672,0,0,608,64
2020-06-04,Netherlands,NA,Friesland,647672,3,1,611,65
2020-06-05,Netherlands,NA,Friesland,647672,1,0,612,65
2020-06-06,Netherlands,NA,Friesland,647672,0,0,612,65
2020-06-07,Netherlands,NA,Friesland,647672,1,0,613,65
2020-06-08,Netherlands,NA,Friesland,647672,1,0,614,65
2020-06-09,Netherlands,NA,Friesland,647672,2,0,616,65
2020-06-10,Netherlands,NA,Friesland,647672,1,0,617,65
2020-06-11,Netherlands,NA,Friesland,647672,2,0,619,65
2020-06-12,Netherlands,NA,Friesland,647672,4,0,623,65
2020-06-13,Netherlands,NA,Friesland,647672,4,0,627,65
2020-06-14,Netherlands,NA,Friesland,647672,0,0,627,65
2020-06-15,Netherlands,NA,Friesland,647672,1,0,628,65
2020-06-16,Netherlands,NA,Friesland,647672,0,0,628,65
2020-06-17,Netherlands,NA,Friesland,647672,2,0,630,65
2020-06-18,Netherlands,NA,Friesland,647672,0,0,630,65
2020-06-19,Netherlands,NA,Friesland,647672,0,0,630,65
2020-06-20,Netherlands,NA,Friesland,647672,0,0,630,65
2020-06-21,Netherlands,NA,Friesland,647672,0,0,630,65
2020-06-22,Netherlands,NA,Friesland,647672,0,0,630,65
2020-06-23,Netherlands,NA,Friesland,647672,0,0,630,65
2020-06-24,Netherlands,NA,Friesland,647672,1,0,630,65
2020-06-25,Netherlands,NA,Friesland,647672,2,0,632,65
2020-06-26,Netherlands,NA,Friesland,647672,0,0,632,65
2020-06-27,Netherlands,NA,Friesland,647672,1,0,633,65
2020-06-28,Netherlands,NA,Friesland,647672,1,0,634,65
2020-06-29,Netherlands,NA,Friesland,647672,0,0,634,65
2020-06-30,Netherlands,NA,Friesland,647672,0,0,634,65
2020-07-01,Netherlands,NA,Friesland,647672,0,0,634,65
2020-07-02,Netherlands,NA,Friesland,647672,2,0,634,65
2020-07-03,Netherlands,NA,Friesland,647672,0,0,634,65
2020-07-04,Netherlands,NA,Friesland,647672,1,4,634,69
2020-07-05,Netherlands,NA,Friesland,647672,1,0,635,69
2020-07-06,Netherlands,NA,Friesland,647672,0,0,635,69
2020-07-07,Netherlands,NA,Friesland,647672,0,0,635,69
2020-07-08,Netherlands,NA,Friesland,647672,1,0,636,69
2020-07-09,Netherlands,NA,Friesland,647672,0,0,636,69
2020-07-10,Netherlands,NA,Friesland,647672,1,0,637,69
2020-07-11,Netherlands,NA,Friesland,647672,0,0,637,69
2020-07-12,Netherlands,NA,Friesland,647672,1,0,638,69
2020-07-13,Netherlands,NA,Friesland,647672,0,0,638,69
2020-07-14,Netherlands,NA,Friesland,647672,1,0,639,69
2020-07-15,Netherlands,NA,Friesland,647672,0,0,639,69
2020-07-16,Netherlands,NA,Friesland,647672,2,0,641,69
2020-07-17,Netherlands,NA,Friesland,647672,1,0,642,69
2020-07-18,Netherlands,NA,Friesland,647672,1,0,643,69
2020-07-19,Netherlands,NA,Friesland,647672,0,0,643,69
2020-07-20,Netherlands,NA,Friesland,647672,0,0,643,69
2020-07-21,Netherlands,NA,Friesland,647672,0,0,643,69
2020-07-22,Netherlands,NA,Friesland,647672,2,0,645,69
2020-07-23,Netherlands,NA,Friesland,647672,0,0,645,69
2020-07-24,Netherlands,NA,Friesland,647672,2,0,647,69
2020-07-25,Netherlands,NA,Friesland,647672,0,0,647,69
2020-07-26,Netherlands,NA,Friesland,647672,0,0,647,69
2020-07-27,Netherlands,NA,Friesland,647672,1,0,648,69
2020-07-28,Netherlands,NA,Friesland,647672,0,0,648,69
2020-07-29,Netherlands,NA,Friesland,647672,1,0,649,69
2020-07-30,Netherlands,NA,Friesland,647672,1,0,650,69
2020-07-31,Netherlands,NA,Friesland,647672,2,0,652,69
2020-08-01,Netherlands,NA,Friesland,647672,1,0,653,69
2020-08-02,Netherlands,NA,Friesland,647672,3,0,656,69
2020-08-03,Netherlands,NA,Friesland,647672,1,0,657,69
2020-08-04,Netherlands,NA,Friesland,647672,0,0,657,69
2020-08-05,Netherlands,NA,Friesland,647672,0,0,657,69
2020-08-06,Netherlands,NA,Friesland,647672,0,0,657,69
2020-08-07,Netherlands,NA,Friesland,647672,1,0,658,69
2020-08-08,Netherlands,NA,Friesland,647672,3,0,661,69
2020-08-09,Netherlands,NA,Friesland,647672,2,0,663,69
2020-08-10,Netherlands,NA,Friesland,647672,14,0,677,69
2020-08-11,Netherlands,NA,Friesland,647672,13,0,690,69
2020-08-12,Netherlands,NA,Friesland,647672,11,0,701,69
2020-08-13,Netherlands,NA,Friesland,647672,9,0,710,69
2020-08-14,Netherlands,NA,Friesland,647672,11,0,721,69
2020-08-15,Netherlands,NA,Friesland,647672,5,0,726,69
2020-08-16,Netherlands,NA,Friesland,647672,6,0,732,69
2020-08-17,Netherlands,NA,Friesland,647672,11,0,743,69
2020-08-18,Netherlands,NA,Friesland,647672,12,0,755,69
2020-08-19,Netherlands,NA,Friesland,647672,8,0,763,69
2020-08-20,Netherlands,NA,Friesland,647672,4,0,767,69
2020-08-21,Netherlands,NA,Friesland,647672,4,0,771,69
2020-08-22,Netherlands,NA,Friesland,647672,6,0,777,69
2020-08-23,Netherlands,NA,Friesland,647672,7,0,784,69
2020-08-24,Netherlands,NA,Friesland,647672,5,0,789,69
2020-08-25,Netherlands,NA,Friesland,647672,4,0,793,69
2020-08-26,Netherlands,NA,Friesland,647672,8,0,801,69
2020-08-27,Netherlands,NA,Friesland,647672,3,0,804,69
2020-08-28,Netherlands,NA,Friesland,647672,3,0,807,69
2020-08-29,Netherlands,NA,Friesland,647672,7,0,814,69
2020-08-30,Netherlands,NA,Friesland,647672,5,0,819,69
2020-08-31,Netherlands,NA,Friesland,647672,5,0,824,69
2020-09-01,Netherlands,NA,Friesland,647672,1,0,825,69
2020-09-02,Netherlands,NA,Friesland,647672,2,0,827,69
2020-09-03,Netherlands,NA,Friesland,647672,5,0,832,69
2020-09-04,Netherlands,NA,Friesland,647672,6,0,838,69
2020-09-05,Netherlands,NA,Friesland,647672,2,0,840,69
2020-09-06,Netherlands,NA,Friesland,647672,6,0,846,69
2020-09-07,Netherlands,NA,Friesland,647672,8,0,854,69
2020-09-08,Netherlands,NA,Friesland,647672,1,0,855,69
2020-09-09,Netherlands,NA,Friesland,647672,9,0,864,69
2020-09-10,Netherlands,NA,Friesland,647672,5,0,869,69
2020-09-11,Netherlands,NA,Friesland,647672,6,0,875,69
2020-09-12,Netherlands,NA,Friesland,647672,5,0,880,69
2020-09-13,Netherlands,NA,Friesland,647672,10,0,890,69
2020-09-14,Netherlands,NA,Friesland,647672,12,0,902,69
2020-09-15,Netherlands,NA,Friesland,647672,19,0,921,69
2020-09-16,Netherlands,NA,Friesland,647672,17,0,938,69
2020-09-17,Netherlands,NA,Friesland,647672,24,0,962,69
2020-09-18,Netherlands,NA,Friesland,647672,22,0,984,69
2020-09-19,Netherlands,NA,Friesland,647672,27,0,1011,69
2020-09-20,Netherlands,NA,Friesland,647672,45,0,1056,69
2020-09-21,Netherlands,NA,Friesland,647672,27,0,1083,69
2020-09-22,Netherlands,NA,Friesland,647672,30,0,1113,69
2020-09-23,Netherlands,NA,Friesland,647672,29,0,1142,69
2020-03-13,Netherlands,NA,Gelderland,2071972,0,0,64,0
2020-03-14,Netherlands,NA,Gelderland,2071972,12,1,76,1
2020-03-15,Netherlands,NA,Gelderland,2071972,24,0,100,1
2020-03-16,Netherlands,NA,Gelderland,2071972,35,0,135,1
2020-03-17,Netherlands,NA,Gelderland,2071972,38,0,173,1
2020-03-18,Netherlands,NA,Gelderland,2071972,37,0,210,1
2020-03-19,Netherlands,NA,Gelderland,2071972,30,1,240,2
2020-03-20,Netherlands,NA,Gelderland,2071972,122,3,362,5
2020-03-21,Netherlands,NA,Gelderland,2071972,6,2,368,7
2020-03-22,Netherlands,NA,Gelderland,2071972,60,1,428,8
2020-03-23,Netherlands,NA,Gelderland,2071972,83,8,511,16
2020-03-24,Netherlands,NA,Gelderland,2071972,74,11,585,27
2020-03-25,Netherlands,NA,Gelderland,2071972,103,6,688,33
2020-03-26,Netherlands,NA,Gelderland,2071972,122,12,810,45
2020-03-27,Netherlands,NA,Gelderland,2071972,131,10,941,55
2020-03-28,Netherlands,NA,Gelderland,2071972,131,7,1072,62
2020-03-29,Netherlands,NA,Gelderland,2071972,182,13,1254,75
2020-03-30,Netherlands,NA,Gelderland,2071972,102,18,1356,93
2020-03-31,Netherlands,NA,Gelderland,2071972,99,24,1455,117
2020-04-01,Netherlands,NA,Gelderland,2071972,140,27,1595,144
2020-04-02,Netherlands,NA,Gelderland,2071972,113,12,1708,156
2020-04-03,Netherlands,NA,Gelderland,2071972,151,19,1859,175
2020-04-04,Netherlands,NA,Gelderland,2071972,97,12,1956,187
2020-04-05,Netherlands,NA,Gelderland,2071972,119,14,2075,201
2020-04-06,Netherlands,NA,Gelderland,2071972,104,18,2179,219
2020-04-07,Netherlands,NA,Gelderland,2071972,92,23,2271,242
2020-04-08,Netherlands,NA,Gelderland,2071972,90,18,2361,260
2020-04-09,Netherlands,NA,Gelderland,2071972,136,18,2497,278
2020-04-10,Netherlands,NA,Gelderland,2071972,160,14,2657,292
2020-04-11,Netherlands,NA,Gelderland,2071972,154,9,2811,301
2020-04-12,Netherlands,NA,Gelderland,2071972,167,11,2978,312
2020-04-13,Netherlands,NA,Gelderland,2071972,208,5,3186,317
2020-04-14,Netherlands,NA,Gelderland,2071972,115,16,3301,333
2020-04-15,Netherlands,NA,Gelderland,2071972,116,24,3417,357
2020-04-16,Netherlands,NA,Gelderland,2071972,121,17,3538,374
2020-04-17,Netherlands,NA,Gelderland,2071972,162,19,3700,393
2020-04-18,Netherlands,NA,Gelderland,2071972,160,19,3860,412
2020-04-19,Netherlands,NA,Gelderland,2071972,202,10,4062,422
2020-04-20,Netherlands,NA,Gelderland,2071972,141,10,4203,432
2020-04-21,Netherlands,NA,Gelderland,2071972,99,20,4302,452
2020-04-22,Netherlands,NA,Gelderland,2071972,89,15,4391,467
2020-04-23,Netherlands,NA,Gelderland,2071972,135,19,4526,486
2020-04-24,Netherlands,NA,Gelderland,2071972,111,19,4637,505
2020-04-25,Netherlands,NA,Gelderland,2071972,94,13,4731,518
2020-04-26,Netherlands,NA,Gelderland,2071972,72,6,4803,524
2020-04-27,Netherlands,NA,Gelderland,2071972,41,4,4844,528
2020-04-28,Netherlands,NA,Gelderland,2071972,23,8,4867,536
2020-04-29,Netherlands,NA,Gelderland,2071972,76,20,4943,556
2020-04-30,Netherlands,NA,Gelderland,2071972,59,10,5002,566
2020-05-01,Netherlands,NA,Gelderland,2071972,71,10,5073,576
2020-05-02,Netherlands,NA,Gelderland,2071972,68,7,5141,583
2020-05-03,Netherlands,NA,Gelderland,2071972,63,7,5204,590
2020-05-04,Netherlands,NA,Gelderland,2071972,24,3,5228,593
2020-05-05,Netherlands,NA,Gelderland,2071972,29,12,5257,605
2020-05-06,Netherlands,NA,Gelderland,2071972,33,6,5290,611
2020-05-07,Netherlands,NA,Gelderland,2071972,25,3,5315,614
2020-05-08,Netherlands,NA,Gelderland,2071972,37,2,5352,616
2020-05-09,Netherlands,NA,Gelderland,2071972,16,8,5368,624
2020-05-10,Netherlands,NA,Gelderland,2071972,25,4,5393,628
2020-05-11,Netherlands,NA,Gelderland,2071972,22,1,5415,629
2020-05-12,Netherlands,NA,Gelderland,2071972,25,3,5440,632
2020-05-13,Netherlands,NA,Gelderland,2071972,18,2,5458,634
2020-05-14,Netherlands,NA,Gelderland,2071972,25,4,5483,638
2020-05-15,Netherlands,NA,Gelderland,2071972,16,6,5499,644
2020-05-16,Netherlands,NA,Gelderland,2071972,20,2,5519,646
2020-05-17,Netherlands,NA,Gelderland,2071972,26,1,5545,647
2020-05-18,Netherlands,NA,Gelderland,2071972,13,3,5558,650
2020-05-19,Netherlands,NA,Gelderland,2071972,16,3,5574,653
2020-05-20,Netherlands,NA,Gelderland,2071972,21,1,5595,654
2020-05-21,Netherlands,NA,Gelderland,2071972,20,2,5615,656
2020-05-22,Netherlands,NA,Gelderland,2071972,29,0,5644,656
2020-05-23,Netherlands,NA,Gelderland,2071972,24,1,5668,657
2020-05-24,Netherlands,NA,Gelderland,2071972,36,0,5704,657
2020-05-25,Netherlands,NA,Gelderland,2071972,45,0,5749,657
2020-05-26,Netherlands,NA,Gelderland,2071972,28,3,5777,660
2020-05-27,Netherlands,NA,Gelderland,2071972,36,1,5813,661
2020-05-28,Netherlands,NA,Gelderland,2071972,39,3,5852,664
2020-05-29,Netherlands,NA,Gelderland,2071972,44,0,5896,664
2020-05-30,Netherlands,NA,Gelderland,2071972,32,2,5928,666
2020-05-31,Netherlands,NA,Gelderland,2071972,27,1,5955,667
2020-06-01,Netherlands,NA,Gelderland,2071972,21,0,5976,667
2020-06-02,Netherlands,NA,Gelderland,2071972,18,2,5994,669
2020-06-03,Netherlands,NA,Gelderland,2071972,9,1,6003,670
2020-06-04,Netherlands,NA,Gelderland,2071972,21,0,6024,670
2020-06-05,Netherlands,NA,Gelderland,2071972,35,1,6059,671
2020-06-06,Netherlands,NA,Gelderland,2071972,26,0,6085,671
2020-06-07,Netherlands,NA,Gelderland,2071972,30,0,6115,671
2020-06-08,Netherlands,NA,Gelderland,2071972,36,1,6151,672
2020-06-09,Netherlands,NA,Gelderland,2071972,20,0,6171,672
2020-06-10,Netherlands,NA,Gelderland,2071972,30,1,6201,673
2020-06-11,Netherlands,NA,Gelderland,2071972,19,0,6220,673
2020-06-12,Netherlands,NA,Gelderland,2071972,31,0,6251,673
2020-06-13,Netherlands,NA,Gelderland,2071972,21,1,6272,674
2020-06-14,Netherlands,NA,Gelderland,2071972,18,1,6290,675
2020-06-15,Netherlands,NA,Gelderland,2071972,40,1,6330,676
2020-06-16,Netherlands,NA,Gelderland,2071972,4,1,6334,677
2020-06-17,Netherlands,NA,Gelderland,2071972,9,1,6343,678
2020-06-18,Netherlands,NA,Gelderland,2071972,14,0,6357,678
2020-06-19,Netherlands,NA,Gelderland,2071972,15,2,6372,680
2020-06-20,Netherlands,NA,Gelderland,2071972,12,1,6384,681
2020-06-21,Netherlands,NA,Gelderland,2071972,13,0,6397,681
2020-06-22,Netherlands,NA,Gelderland,2071972,11,0,6408,681
2020-06-23,Netherlands,NA,Gelderland,2071972,5,0,6413,681
2020-06-24,Netherlands,NA,Gelderland,2071972,3,0,6416,681
2020-06-25,Netherlands,NA,Gelderland,2071972,15,1,6431,682
2020-06-26,Netherlands,NA,Gelderland,2071972,9,0,6440,682
2020-06-27,Netherlands,NA,Gelderland,2071972,16,0,6456,682
2020-06-28,Netherlands,NA,Gelderland,2071972,6,0,6462,682
2020-06-29,Netherlands,NA,Gelderland,2071972,9,1,6471,683
2020-06-30,Netherlands,NA,Gelderland,2071972,1,1,6472,684
2020-07-01,Netherlands,NA,Gelderland,2071972,6,1,6478,685
2020-07-02,Netherlands,NA,Gelderland,2071972,6,1,6484,686
2020-07-03,Netherlands,NA,Gelderland,2071972,3,0,6487,686
2020-07-04,Netherlands,NA,Gelderland,2071972,1,0,6488,686
2020-07-05,Netherlands,NA,Gelderland,2071972,4,0,6492,686
2020-07-06,Netherlands,NA,Gelderland,2071972,2,0,6494,686
2020-07-07,Netherlands,NA,Gelderland,2071972,1,0,6495,686
2020-07-08,Netherlands,NA,Gelderland,2071972,5,0,6500,686
2020-07-09,Netherlands,NA,Gelderland,2071972,2,0,6502,686
2020-07-10,Netherlands,NA,Gelderland,2071972,4,0,6506,686
2020-07-11,Netherlands,NA,Gelderland,2071972,2,0,6508,686
2020-07-12,Netherlands,NA,Gelderland,2071972,5,0,6513,686
2020-07-13,Netherlands,NA,Gelderland,2071972,4,0,6517,686
2020-07-14,Netherlands,NA,Gelderland,2071972,8,0,6525,686
2020-07-15,Netherlands,NA,Gelderland,2071972,6,0,6531,686
2020-07-16,Netherlands,NA,Gelderland,2071972,0,0,6531,686
2020-07-17,Netherlands,NA,Gelderland,2071972,0,0,6531,686
2020-07-18,Netherlands,NA,Gelderland,2071972,6,0,6531,686
2020-07-19,Netherlands,NA,Gelderland,2071972,3,0,6531,686
2020-07-20,Netherlands,NA,Gelderland,2071972,7,0,6534,686
2020-07-21,Netherlands,NA,Gelderland,2071972,10,0,6544,686
2020-07-22,Netherlands,NA,Gelderland,2071972,6,0,6550,686
2020-07-23,Netherlands,NA,Gelderland,2071972,3,0,6553,686
2020-07-24,Netherlands,NA,Gelderland,2071972,5,0,6558,686
2020-07-25,Netherlands,NA,Gelderland,2071972,7,0,6565,686
2020-07-26,Netherlands,NA,Gelderland,2071972,12,0,6577,686
2020-07-27,Netherlands,NA,Gelderland,2071972,6,0,6583,686
2020-07-28,Netherlands,NA,Gelderland,2071972,5,0,6588,686
2020-07-29,Netherlands,NA,Gelderland,2071972,5,0,6593,686
2020-07-30,Netherlands,NA,Gelderland,2071972,12,0,6605,686
2020-07-31,Netherlands,NA,Gelderland,2071972,15,0,6620,686
2020-08-01,Netherlands,NA,Gelderland,2071972,22,0,6642,686
2020-08-02,Netherlands,NA,Gelderland,2071972,14,0,6656,686
2020-08-03,Netherlands,NA,Gelderland,2071972,1,0,6657,686
2020-08-04,Netherlands,NA,Gelderland,2071972,8,0,6665,686
2020-08-05,Netherlands,NA,Gelderland,2071972,7,0,6672,686
2020-08-06,Netherlands,NA,Gelderland,2071972,19,0,6691,686
2020-08-07,Netherlands,NA,Gelderland,2071972,23,0,6714,686
2020-08-08,Netherlands,NA,Gelderland,2071972,19,0,6733,686
2020-08-09,Netherlands,NA,Gelderland,2071972,31,0,6764,686
2020-08-10,Netherlands,NA,Gelderland,2071972,20,0,6784,686
2020-08-11,Netherlands,NA,Gelderland,2071972,35,1,6819,686
2020-08-12,Netherlands,NA,Gelderland,2071972,32,0,6851,686
2020-08-13,Netherlands,NA,Gelderland,2071972,25,0,6876,686
2020-08-14,Netherlands,NA,Gelderland,2071972,25,0,6901,686
2020-08-15,Netherlands,NA,Gelderland,2071972,21,0,6922,686
2020-08-16,Netherlands,NA,Gelderland,2071972,29,0,6951,686
2020-08-17,Netherlands,NA,Gelderland,2071972,19,0,6970,686
2020-08-18,Netherlands,NA,Gelderland,2071972,21,0,6991,686
2020-08-19,Netherlands,NA,Gelderland,2071972,33,1,7024,686
2020-08-20,Netherlands,NA,Gelderland,2071972,26,0,7050,686
2020-08-21,Netherlands,NA,Gelderland,2071972,36,0,7086,686
2020-08-22,Netherlands,NA,Gelderland,2071972,29,1,7115,687
2020-08-23,Netherlands,NA,Gelderland,2071972,41,0,7156,687
2020-08-24,Netherlands,NA,Gelderland,2071972,52,0,7208,687
2020-08-25,Netherlands,NA,Gelderland,2071972,36,0,7244,687
2020-08-26,Netherlands,NA,Gelderland,2071972,35,1,7279,688
2020-08-27,Netherlands,NA,Gelderland,2071972,36,0,7315,688
2020-08-28,Netherlands,NA,Gelderland,2071972,44,0,7359,688
2020-08-29,Netherlands,NA,Gelderland,2071972,31,0,7390,688
2020-08-30,Netherlands,NA,Gelderland,2071972,34,0,7424,688
2020-08-31,Netherlands,NA,Gelderland,2071972,27,0,7451,688
2020-09-01,Netherlands,NA,Gelderland,2071972,29,0,7480,688
2020-09-02,Netherlands,NA,Gelderland,2071972,41,0,7521,688
2020-09-03,Netherlands,NA,Gelderland,2071972,32,1,7553,689
2020-09-04,Netherlands,NA,Gelderland,2071972,39,0,7592,689
2020-09-05,Netherlands,NA,Gelderland,2071972,45,0,7637,689
2020-09-06,Netherlands,NA,Gelderland,2071972,73,1,7710,690
2020-09-07,Netherlands,NA,Gelderland,2071972,68,0,7778,690
2020-09-08,Netherlands,NA,Gelderland,2071972,70,1,7848,691
2020-09-09,Netherlands,NA,Gelderland,2071972,88,0,7936,691
2020-09-10,Netherlands,NA,Gelderland,2071972,94,0,8030,691
2020-09-11,Netherlands,NA,Gelderland,2071972,90,0,8120,691
2020-09-12,Netherlands,NA,Gelderland,2071972,109,1,8229,692
2020-09-13,Netherlands,NA,Gelderland,2071972,72,0,8301,692
2020-09-14,Netherlands,NA,Gelderland,2071972,131,0,8432,692
2020-09-15,Netherlands,NA,Gelderland,2071972,118,0,8550,692
2020-09-16,Netherlands,NA,Gelderland,2071972,139,0,8689,692
2020-09-17,Netherlands,NA,Gelderland,2071972,139,0,8828,692
2020-09-18,Netherlands,NA,Gelderland,2071972,141,0,8969,692
2020-09-19,Netherlands,NA,Gelderland,2071972,157,0,9126,692
2020-09-20,Netherlands,NA,Gelderland,2071972,131,1,9257,693
2020-09-21,Netherlands,NA,Gelderland,2071972,224,0,9481,693
2020-09-22,Netherlands,NA,Gelderland,2071972,168,0,9649,693
2020-09-23,Netherlands,NA,Gelderland,2071972,257,0,9906,693
2020-03-18,Netherlands,NA,Groningen,583990,5,0,15,0
2020-03-19,Netherlands,NA,Groningen,583990,14,0,29,0
2020-03-20,Netherlands,NA,Groningen,583990,15,0,44,0
2020-03-21,Netherlands,NA,Groningen,583990,3,0,47,0
2020-03-22,Netherlands,NA,Groningen,583990,10,0,57,0
2020-03-23,Netherlands,NA,Groningen,583990,11,0,68,0
2020-03-24,Netherlands,NA,Groningen,583990,0,0,68,0
2020-03-25,Netherlands,NA,Groningen,583990,14,0,82,0
2020-03-26,Netherlands,NA,Groningen,583990,29,1,111,1
2020-03-27,Netherlands,NA,Groningen,583990,11,0,122,1
2020-03-28,Netherlands,NA,Groningen,583990,12,0,134,1
2020-03-29,Netherlands,NA,Groningen,583990,7,0,141,1
2020-03-30,Netherlands,NA,Groningen,583990,6,0,147,1
2020-03-31,Netherlands,NA,Groningen,583990,11,1,158,2
2020-04-01,Netherlands,NA,Groningen,583990,8,0,166,2
2020-04-02,Netherlands,NA,Groningen,583990,6,0,172,2
2020-04-03,Netherlands,NA,Groningen,583990,6,2,178,4
2020-04-04,Netherlands,NA,Groningen,583990,7,1,185,5
2020-04-05,Netherlands,NA,Groningen,583990,13,0,198,5
2020-04-06,Netherlands,NA,Groningen,583990,4,0,202,5
2020-04-07,Netherlands,NA,Groningen,583990,2,1,204,6
2020-04-08,Netherlands,NA,Groningen,583990,18,0,222,6
2020-04-09,Netherlands,NA,Groningen,583990,7,0,229,6
2020-04-10,Netherlands,NA,Groningen,583990,12,0,241,6
2020-04-11,Netherlands,NA,Groningen,583990,14,1,255,7
2020-04-12,Netherlands,NA,Groningen,583990,10,1,265,8
2020-04-13,Netherlands,NA,Groningen,583990,8,0,273,8
2020-04-14,Netherlands,NA,Groningen,583990,1,0,274,8
2020-04-15,Netherlands,NA,Groningen,583990,6,0,280,8
2020-04-16,Netherlands,NA,Groningen,583990,5,0,285,8
2020-04-17,Netherlands,NA,Groningen,583990,6,1,291,9
2020-04-18,Netherlands,NA,Groningen,583990,3,0,294,9
2020-04-19,Netherlands,NA,Groningen,583990,5,0,299,9
2020-04-20,Netherlands,NA,Groningen,583990,4,0,303,9
2020-04-21,Netherlands,NA,Groningen,583990,4,0,307,9
2020-04-22,Netherlands,NA,Groningen,583990,3,0,310,9
2020-04-23,Netherlands,NA,Groningen,583990,4,2,314,11
2020-04-24,Netherlands,NA,Groningen,583990,9,1,323,12
2020-04-25,Netherlands,NA,Groningen,583990,3,0,326,12
2020-04-26,Netherlands,NA,Groningen,583990,0,0,326,12
2020-04-27,Netherlands,NA,Groningen,583990,0,0,326,12
2020-04-28,Netherlands,NA,Groningen,583990,0,0,326,12
2020-04-29,Netherlands,NA,Groningen,583990,1,1,327,13
2020-04-30,Netherlands,NA,Groningen,583990,3,0,330,13
2020-05-01,Netherlands,NA,Groningen,583990,3,0,333,13
2020-05-02,Netherlands,NA,Groningen,583990,0,0,333,13
2020-05-03,Netherlands,NA,Groningen,583990,0,0,333,13
2020-05-04,Netherlands,NA,Groningen,583990,1,0,334,13
2020-05-05,Netherlands,NA,Groningen,583990,3,0,337,13
2020-05-06,Netherlands,NA,Groningen,583990,1,0,338,13
2020-05-07,Netherlands,NA,Groningen,583990,1,1,339,14
2020-05-08,Netherlands,NA,Groningen,583990,0,0,339,14
2020-05-09,Netherlands,NA,Groningen,583990,0,0,339,14
2020-05-10,Netherlands,NA,Groningen,583990,1,0,340,14
2020-05-11,Netherlands,NA,Groningen,583990,3,0,343,14
2020-05-12,Netherlands,NA,Groningen,583990,0,0,343,14
2020-05-13,Netherlands,NA,Groningen,583990,0,0,343,14
2020-05-14,Netherlands,NA,Groningen,583990,1,0,344,14
2020-05-15,Netherlands,NA,Groningen,583990,0,1,344,15
2020-05-16,Netherlands,NA,Groningen,583990,0,0,344,15
2020-05-17,Netherlands,NA,Groningen,583990,0,0,344,15
2020-05-18,Netherlands,NA,Groningen,583990,0,0,344,15
2020-05-19,Netherlands,NA,Groningen,583990,0,0,344,15
2020-05-20,Netherlands,NA,Groningen,583990,0,0,344,15
2020-05-21,Netherlands,NA,Groningen,583990,2,0,346,15
2020-05-22,Netherlands,NA,Groningen,583990,0,0,346,15
2020-05-23,Netherlands,NA,Groningen,583990,0,1,346,16
2020-05-24,Netherlands,NA,Groningen,583990,0,0,346,16
2020-05-25,Netherlands,NA,Groningen,583990,0,0,346,16
2020-05-26,Netherlands,NA,Groningen,583990,0,0,346,16
2020-05-27,Netherlands,NA,Groningen,583990,0,1,346,17
2020-05-28,Netherlands,NA,Groningen,583990,1,0,347,17
2020-05-29,Netherlands,NA,Groningen,583990,0,0,347,17
2020-05-30,Netherlands,NA,Groningen,583990,1,0,348,17
2020-05-31,Netherlands,NA,Groningen,583990,1,0,349,17
2020-06-01,Netherlands,NA,Groningen,583990,0,0,349,17
2020-06-02,Netherlands,NA,Groningen,583990,0,0,349,17
2020-06-03,Netherlands,NA,Groningen,583990,0,0,349,17
2020-06-04,Netherlands,NA,Groningen,583990,1,0,350,17
2020-06-05,Netherlands,NA,Groningen,583990,0,0,350,17
2020-06-06,Netherlands,NA,Groningen,583990,2,0,352,17
2020-06-07,Netherlands,NA,Groningen,583990,0,0,352,17
2020-06-08,Netherlands,NA,Groningen,583990,0,0,352,17
2020-06-09,Netherlands,NA,Groningen,583990,0,0,352,17
2020-06-10,Netherlands,NA,Groningen,583990,0,0,352,17
2020-06-11,Netherlands,NA,Groningen,583990,1,0,353,17
2020-06-12,Netherlands,NA,Groningen,583990,1,0,354,17
2020-06-13,Netherlands,NA,Groningen,583990,0,0,354,17
2020-06-14,Netherlands,NA,Groningen,583990,2,0,356,17
2020-06-15,Netherlands,NA,Groningen,583990,0,0,356,17
2020-06-16,Netherlands,NA,Groningen,583990,0,0,356,17
2020-06-17,Netherlands,NA,Groningen,583990,1,0,357,17
2020-06-18,Netherlands,NA,Groningen,583990,2,0,359,17
2020-06-19,Netherlands,NA,Groningen,583990,0,0,359,17
2020-06-20,Netherlands,NA,Groningen,583990,0,0,359,17
2020-06-21,Netherlands,NA,Groningen,583990,0,0,359,17
2020-06-22,Netherlands,NA,Groningen,583990,0,0,359,17
2020-06-23,Netherlands,NA,Groningen,583990,0,0,359,17
2020-06-24,Netherlands,NA,Groningen,583990,3,0,362,17
2020-06-25,Netherlands,NA,Groningen,583990,0,0,362,17
2020-06-26,Netherlands,NA,Groningen,583990,0,0,362,17
2020-06-27,Netherlands,NA,Groningen,583990,0,0,362,17
2020-06-28,Netherlands,NA,Groningen,583990,0,0,362,17
2020-06-29,Netherlands,NA,Groningen,583990,0,0,362,17
2020-06-30,Netherlands,NA,Groningen,583990,0,0,362,17
2020-07-01,Netherlands,NA,Groningen,583990,0,0,362,17
2020-07-02,Netherlands,NA,Groningen,583990,0,0,362,17
2020-07-03,Netherlands,NA,Groningen,583990,0,0,362,17
2020-07-04,Netherlands,NA,Groningen,583990,0,0,362,17
2020-07-05,Netherlands,NA,Groningen,583990,2,0,364,17
2020-07-06,Netherlands,NA,Groningen,583990,0,0,364,17
2020-07-07,Netherlands,NA,Groningen,583990,0,0,364,17
2020-07-08,Netherlands,NA,Groningen,583990,1,0,365,17
2020-07-09,Netherlands,NA,Groningen,583990,1,0,366,17
2020-07-10,Netherlands,NA,Groningen,583990,0,0,366,17
2020-07-11,Netherlands,NA,Groningen,583990,1,0,367,17
2020-07-12,Netherlands,NA,Groningen,583990,0,0,367,17
2020-07-13,Netherlands,NA,Groningen,583990,0,0,367,17
2020-07-14,Netherlands,NA,Groningen,583990,0,0,367,17
2020-07-15,Netherlands,NA,Groningen,583990,0,0,367,17
2020-07-16,Netherlands,NA,Groningen,583990,0,0,367,17
2020-07-17,Netherlands,NA,Groningen,583990,0,0,367,17
2020-07-18,Netherlands,NA,Groningen,583990,0,0,367,17
2020-07-19,Netherlands,NA,Groningen,583990,1,0,368,17
2020-07-20,Netherlands,NA,Groningen,583990,0,0,368,17
2020-07-21,Netherlands,NA,Groningen,583990,1,0,369,17
2020-07-22,Netherlands,NA,Groningen,583990,0,0,369,17
2020-07-23,Netherlands,NA,Groningen,583990,0,0,369,17
2020-07-24,Netherlands,NA,Groningen,583990,1,0,370,17
2020-07-25,Netherlands,NA,Groningen,583990,2,0,372,17
2020-07-26,Netherlands,NA,Groningen,583990,3,0,375,17
2020-07-27,Netherlands,NA,Groningen,583990,2,0,377,17
2020-07-28,Netherlands,NA,Groningen,583990,2,0,379,17
2020-07-29,Netherlands,NA,Groningen,583990,1,0,380,17
2020-07-30,Netherlands,NA,Groningen,583990,2,0,382,17
2020-07-31,Netherlands,NA,Groningen,583990,3,0,385,17
2020-08-01,Netherlands,NA,Groningen,583990,3,0,388,17
2020-08-02,Netherlands,NA,Groningen,583990,2,0,390,17
2020-08-03,Netherlands,NA,Groningen,583990,3,0,393,17
2020-08-04,Netherlands,NA,Groningen,583990,7,0,400,17
2020-08-05,Netherlands,NA,Groningen,583990,5,0,405,17
2020-08-06,Netherlands,NA,Groningen,583990,6,0,411,17
2020-08-07,Netherlands,NA,Groningen,583990,7,0,418,17
2020-08-08,Netherlands,NA,Groningen,583990,7,0,425,17
2020-08-09,Netherlands,NA,Groningen,583990,7,0,432,17
2020-08-10,Netherlands,NA,Groningen,583990,9,0,441,17
2020-08-11,Netherlands,NA,Groningen,583990,5,0,446,17
2020-08-12,Netherlands,NA,Groningen,583990,10,0,456,17
2020-08-13,Netherlands,NA,Groningen,583990,14,0,470,17
2020-08-14,Netherlands,NA,Groningen,583990,12,0,482,17
2020-08-15,Netherlands,NA,Groningen,583990,8,0,490,17
2020-08-16,Netherlands,NA,Groningen,583990,10,0,500,17
2020-08-17,Netherlands,NA,Groningen,583990,9,0,509,17
2020-08-18,Netherlands,NA,Groningen,583990,11,0,520,17
2020-08-19,Netherlands,NA,Groningen,583990,5,0,525,17
2020-08-20,Netherlands,NA,Groningen,583990,8,0,533,17
2020-08-21,Netherlands,NA,Groningen,583990,7,0,540,17
2020-08-22,Netherlands,NA,Groningen,583990,9,0,549,17
2020-08-23,Netherlands,NA,Groningen,583990,6,0,555,17
2020-08-24,Netherlands,NA,Groningen,583990,3,0,558,17
2020-08-25,Netherlands,NA,Groningen,583990,5,2,563,19
2020-08-26,Netherlands,NA,Groningen,583990,5,0,568,19
2020-08-27,Netherlands,NA,Groningen,583990,6,0,574,19
2020-08-28,Netherlands,NA,Groningen,583990,10,0,584,19
2020-08-29,Netherlands,NA,Groningen,583990,4,0,588,19
2020-08-30,Netherlands,NA,Groningen,583990,2,0,590,19
2020-08-31,Netherlands,NA,Groningen,583990,8,0,598,19
2020-09-01,Netherlands,NA,Groningen,583990,2,0,600,19
2020-09-02,Netherlands,NA,Groningen,583990,4,0,604,19
2020-09-03,Netherlands,NA,Groningen,583990,8,0,612,19
2020-09-04,Netherlands,NA,Groningen,583990,7,0,619,19
2020-09-05,Netherlands,NA,Groningen,583990,7,0,626,19
2020-09-06,Netherlands,NA,Groningen,583990,6,0,632,19
2020-09-07,Netherlands,NA,Groningen,583990,12,0,644,19
2020-09-08,Netherlands,NA,Groningen,583990,13,0,657,19
2020-09-09,Netherlands,NA,Groningen,583990,16,0,673,19
2020-09-10,Netherlands,NA,Groningen,583990,17,0,690,19
2020-09-11,Netherlands,NA,Groningen,583990,29,0,719,19
2020-09-12,Netherlands,NA,Groningen,583990,34,0,753,19
2020-09-13,Netherlands,NA,Groningen,583990,22,0,775,19
2020-09-14,Netherlands,NA,Groningen,583990,34,0,809,19
2020-09-15,Netherlands,NA,Groningen,583990,41,0,850,19
2020-09-16,Netherlands,NA,Groningen,583990,34,0,884,19
2020-09-17,Netherlands,NA,Groningen,583990,36,0,920,19
2020-09-18,Netherlands,NA,Groningen,583990,42,0,962,19
2020-09-19,Netherlands,NA,Groningen,583990,49,0,1011,19
2020-09-20,Netherlands,NA,Groningen,583990,53,0,1064,19
2020-09-21,Netherlands,NA,Groningen,583990,80,0,1144,19
2020-09-22,Netherlands,NA,Groningen,583990,85,0,1229,19
2020-09-23,Netherlands,NA,Groningen,583990,86,0,1315,19
2020-03-13,Netherlands,NA,Limburg,1116137,0,0,67,3
2020-03-14,Netherlands,NA,Limburg,1116137,37,0,104,3
2020-03-15,Netherlands,NA,Limburg,1116137,25,1,129,4
2020-03-16,Netherlands,NA,Limburg,1116137,20,1,149,5
2020-03-17,Netherlands,NA,Limburg,1116137,48,5,197,10
2020-03-18,Netherlands,NA,Limburg,1116137,61,4,258,14
2020-03-19,Netherlands,NA,Limburg,1116137,33,5,291,19
2020-03-20,Netherlands,NA,Limburg,1116137,105,6,396,25
2020-03-21,Netherlands,NA,Limburg,1116137,14,1,410,26
2020-03-22,Netherlands,NA,Limburg,1116137,29,11,439,37
2020-03-23,Netherlands,NA,Limburg,1116137,43,12,482,49
2020-03-24,Netherlands,NA,Limburg,1116137,192,11,674,60
2020-03-25,Netherlands,NA,Limburg,1116137,94,8,768,68
2020-03-26,Netherlands,NA,Limburg,1116137,94,16,862,84
2020-03-27,Netherlands,NA,Limburg,1116137,86,16,948,100
2020-03-28,Netherlands,NA,Limburg,1116137,130,15,1078,115
2020-03-29,Netherlands,NA,Limburg,1116137,95,22,1173,137
2020-03-30,Netherlands,NA,Limburg,1116137,114,20,1287,157
2020-03-31,Netherlands,NA,Limburg,1116137,115,14,1402,171
2020-04-01,Netherlands,NA,Limburg,1116137,87,13,1489,184
2020-04-02,Netherlands,NA,Limburg,1116137,88,40,1577,224
2020-04-03,Netherlands,NA,Limburg,1116137,112,8,1689,232
2020-04-04,Netherlands,NA,Limburg,1116137,50,18,1739,250
2020-04-05,Netherlands,NA,Limburg,1116137,143,23,1882,273
2020-04-06,Netherlands,NA,Limburg,1116137,107,13,1989,286
2020-04-07,Netherlands,NA,Limburg,1116137,91,47,2080,333
2020-04-08,Netherlands,NA,Limburg,1116137,80,21,2160,354
2020-04-09,Netherlands,NA,Limburg,1116137,124,19,2284,373
2020-04-10,Netherlands,NA,Limburg,1116137,103,14,2387,387
2020-04-11,Netherlands,NA,Limburg,1116137,127,13,2514,400
2020-04-12,Netherlands,NA,Limburg,1116137,119,20,2633,420
2020-04-13,Netherlands,NA,Limburg,1116137,44,7,2677,427
2020-04-14,Netherlands,NA,Limburg,1116137,185,24,2862,451
2020-04-15,Netherlands,NA,Limburg,1116137,45,14,2907,465
2020-04-16,Netherlands,NA,Limburg,1116137,98,13,3005,478
2020-04-17,Netherlands,NA,Limburg,1116137,136,13,3141,491
2020-04-18,Netherlands,NA,Limburg,1116137,113,14,3254,505
2020-04-19,Netherlands,NA,Limburg,1116137,98,7,3352,512
2020-04-20,Netherlands,NA,Limburg,1116137,83,9,3435,521
2020-04-21,Netherlands,NA,Limburg,1116137,86,7,3521,528
2020-04-22,Netherlands,NA,Limburg,1116137,93,10,3614,538
2020-04-23,Netherlands,NA,Limburg,1116137,77,9,3691,547
2020-04-24,Netherlands,NA,Limburg,1116137,103,15,3794,562
2020-04-25,Netherlands,NA,Limburg,1116137,47,17,3841,579
2020-04-26,Netherlands,NA,Limburg,1116137,52,9,3893,588
2020-04-27,Netherlands,NA,Limburg,1116137,65,6,3958,594
2020-04-28,Netherlands,NA,Limburg,1116137,18,2,3976,596
2020-04-29,Netherlands,NA,Limburg,1116137,48,11,4024,607
2020-04-30,Netherlands,NA,Limburg,1116137,59,10,4083,617
2020-05-01,Netherlands,NA,Limburg,1116137,39,9,4122,626
2020-05-02,Netherlands,NA,Limburg,1116137,49,11,4171,637
2020-05-03,Netherlands,NA,Limburg,1116137,24,6,4195,643
2020-05-04,Netherlands,NA,Limburg,1116137,44,4,4239,647
2020-05-05,Netherlands,NA,Limburg,1116137,15,4,4254,651
2020-05-06,Netherlands,NA,Limburg,1116137,20,5,4274,656
2020-05-07,Netherlands,NA,Limburg,1116137,24,8,4298,664
2020-05-08,Netherlands,NA,Limburg,1116137,44,5,4342,669
2020-05-09,Netherlands,NA,Limburg,1116137,23,4,4365,673
2020-05-10,Netherlands,NA,Limburg,1116137,27,5,4392,678
2020-05-11,Netherlands,NA,Limburg,1116137,18,5,4410,683
2020-05-12,Netherlands,NA,Limburg,1116137,10,1,4420,684
2020-05-13,Netherlands,NA,Limburg,1116137,21,8,4441,692
2020-05-14,Netherlands,NA,Limburg,1116137,19,4,4460,696
2020-05-15,Netherlands,NA,Limburg,1116137,36,4,4496,700
2020-05-16,Netherlands,NA,Limburg,1116137,16,2,4512,702
2020-05-17,Netherlands,NA,Limburg,1116137,8,2,4520,704
2020-05-18,Netherlands,NA,Limburg,1116137,11,3,4531,707
2020-05-19,Netherlands,NA,Limburg,1116137,3,0,4534,707
2020-05-20,Netherlands,NA,Limburg,1116137,4,3,4538,710
2020-05-21,Netherlands,NA,Limburg,1116137,16,3,4554,713
2020-05-22,Netherlands,NA,Limburg,1116137,18,3,4572,716
2020-05-23,Netherlands,NA,Limburg,1116137,30,2,4602,718
2020-05-24,Netherlands,NA,Limburg,1116137,7,3,4609,721
2020-05-25,Netherlands,NA,Limburg,1116137,17,0,4626,721
2020-05-26,Netherlands,NA,Limburg,1116137,7,2,4633,723
2020-05-27,Netherlands,NA,Limburg,1116137,5,0,4638,723
2020-05-28,Netherlands,NA,Limburg,1116137,14,6,4652,729
2020-05-29,Netherlands,NA,Limburg,1116137,11,1,4663,730
2020-05-30,Netherlands,NA,Limburg,1116137,6,2,4669,732
2020-05-31,Netherlands,NA,Limburg,1116137,9,1,4678,733
2020-06-01,Netherlands,NA,Limburg,1116137,9,2,4687,735
2020-06-02,Netherlands,NA,Limburg,1116137,7,0,4694,735
2020-06-03,Netherlands,NA,Limburg,1116137,9,1,4703,736
2020-06-04,Netherlands,NA,Limburg,1116137,7,2,4710,738
2020-06-05,Netherlands,NA,Limburg,1116137,18,0,4728,738
2020-06-06,Netherlands,NA,Limburg,1116137,15,0,4743,738
2020-06-07,Netherlands,NA,Limburg,1116137,14,1,4757,739
2020-06-08,Netherlands,NA,Limburg,1116137,8,0,4765,739
2020-06-09,Netherlands,NA,Limburg,1116137,11,3,4776,742
2020-06-10,Netherlands,NA,Limburg,1116137,6,1,4782,743
2020-06-11,Netherlands,NA,Limburg,1116137,9,1,4791,744
2020-06-12,Netherlands,NA,Limburg,1116137,8,1,4799,745
2020-06-13,Netherlands,NA,Limburg,1116137,12,0,4811,745
2020-06-14,Netherlands,NA,Limburg,1116137,9,1,4820,746
2020-06-15,Netherlands,NA,Limburg,1116137,2,1,4822,747
2020-06-16,Netherlands,NA,Limburg,1116137,4,0,4826,747
2020-06-17,Netherlands,NA,Limburg,1116137,4,0,4830,747
2020-06-18,Netherlands,NA,Limburg,1116137,6,0,4836,747
2020-06-19,Netherlands,NA,Limburg,1116137,4,0,4840,747
2020-06-20,Netherlands,NA,Limburg,1116137,4,1,4844,748
2020-06-21,Netherlands,NA,Limburg,1116137,5,0,4849,748
2020-06-22,Netherlands,NA,Limburg,1116137,2,0,4851,748
2020-06-23,Netherlands,NA,Limburg,1116137,2,0,4853,748
2020-06-24,Netherlands,NA,Limburg,1116137,3,0,4856,748
2020-06-25,Netherlands,NA,Limburg,1116137,4,1,4860,749
2020-06-26,Netherlands,NA,Limburg,1116137,1,0,4861,749
2020-06-27,Netherlands,NA,Limburg,1116137,0,0,4861,749
2020-06-28,Netherlands,NA,Limburg,1116137,1,0,4862,749
2020-06-29,Netherlands,NA,Limburg,1116137,1,0,4863,749
2020-06-30,Netherlands,NA,Limburg,1116137,0,0,4863,749
2020-07-01,Netherlands,NA,Limburg,1116137,3,0,4866,749
2020-07-02,Netherlands,NA,Limburg,1116137,3,0,4869,749
2020-07-03,Netherlands,NA,Limburg,1116137,5,0,4874,749
2020-07-04,Netherlands,NA,Limburg,1116137,1,0,4875,749
2020-07-05,Netherlands,NA,Limburg,1116137,1,0,4876,749
2020-07-06,Netherlands,NA,Limburg,1116137,1,0,4877,749
2020-07-07,Netherlands,NA,Limburg,1116137,1,0,4878,749
2020-07-08,Netherlands,NA,Limburg,1116137,1,0,4879,749
2020-07-09,Netherlands,NA,Limburg,1116137,2,0,4881,749
2020-07-10,Netherlands,NA,Limburg,1116137,2,0,4883,749
2020-07-11,Netherlands,NA,Limburg,1116137,0,0,4883,749
2020-07-12,Netherlands,NA,Limburg,1116137,3,0,4886,749
2020-07-13,Netherlands,NA,Limburg,1116137,1,0,4887,749
2020-07-14,Netherlands,NA,Limburg,1116137,0,1,4887,750
2020-07-15,Netherlands,NA,Limburg,1116137,5,0,4887,750
2020-07-16,Netherlands,NA,Limburg,1116137,1,0,4887,750
2020-07-17,Netherlands,NA,Limburg,1116137,1,1,4887,751
2020-07-18,Netherlands,NA,Limburg,1116137,5,1,4890,752
2020-07-19,Netherlands,NA,Limburg,1116137,1,0,4891,752
2020-07-20,Netherlands,NA,Limburg,1116137,4,0,4895,752
2020-07-21,Netherlands,NA,Limburg,1116137,3,1,4898,753
2020-07-22,Netherlands,NA,Limburg,1116137,1,0,4899,753
2020-07-23,Netherlands,NA,Limburg,1116137,0,0,4899,753
2020-07-24,Netherlands,NA,Limburg,1116137,4,0,4903,753
2020-07-25,Netherlands,NA,Limburg,1116137,3,0,4906,753
2020-07-26,Netherlands,NA,Limburg,1116137,2,0,4908,753
2020-07-27,Netherlands,NA,Limburg,1116137,4,0,4912,753
2020-07-28,Netherlands,NA,Limburg,1116137,2,1,4914,754
2020-07-29,Netherlands,NA,Limburg,1116137,3,0,4917,754
2020-07-30,Netherlands,NA,Limburg,1116137,4,0,4921,754
2020-07-31,Netherlands,NA,Limburg,1116137,2,0,4923,754
2020-08-01,Netherlands,NA,Limburg,1116137,7,0,4930,754
2020-08-02,Netherlands,NA,Limburg,1116137,3,0,4933,754
2020-08-03,Netherlands,NA,Limburg,1116137,5,0,4938,754
2020-08-04,Netherlands,NA,Limburg,1116137,4,0,4942,754
2020-08-05,Netherlands,NA,Limburg,1116137,7,0,4949,754
2020-08-06,Netherlands,NA,Limburg,1116137,2,0,4951,754
2020-08-07,Netherlands,NA,Limburg,1116137,9,0,4960,754
2020-08-08,Netherlands,NA,Limburg,1116137,7,0,4967,754
2020-08-09,Netherlands,NA,Limburg,1116137,17,0,4984,754
2020-08-10,Netherlands,NA,Limburg,1116137,12,0,4996,754
2020-08-11,Netherlands,NA,Limburg,1116137,21,0,5017,754
2020-08-12,Netherlands,NA,Limburg,1116137,13,0,5030,754
2020-08-13,Netherlands,NA,Limburg,1116137,17,0,5047,754
2020-08-14,Netherlands,NA,Limburg,1116137,18,0,5065,754
2020-08-15,Netherlands,NA,Limburg,1116137,36,0,5101,754
2020-08-16,Netherlands,NA,Limburg,1116137,21,0,5122,754
2020-08-17,Netherlands,NA,Limburg,1116137,6,0,5128,754
2020-08-18,Netherlands,NA,Limburg,1116137,11,0,5139,754
2020-08-19,Netherlands,NA,Limburg,1116137,13,0,5152,754
2020-08-20,Netherlands,NA,Limburg,1116137,23,0,5175,754
2020-08-21,Netherlands,NA,Limburg,1116137,23,0,5198,754
2020-08-22,Netherlands,NA,Limburg,1116137,23,1,5221,755
2020-08-23,Netherlands,NA,Limburg,1116137,28,0,5249,755
2020-08-24,Netherlands,NA,Limburg,1116137,19,0,5268,755
2020-08-25,Netherlands,NA,Limburg,1116137,25,0,5293,755
2020-08-26,Netherlands,NA,Limburg,1116137,24,0,5317,755
2020-08-27,Netherlands,NA,Limburg,1116137,22,0,5339,755
2020-08-28,Netherlands,NA,Limburg,1116137,18,0,5357,755
2020-08-29,Netherlands,NA,Limburg,1116137,26,1,5383,756
2020-08-30,Netherlands,NA,Limburg,1116137,17,0,5400,756
2020-08-31,Netherlands,NA,Limburg,1116137,24,0,5424,756
2020-09-01,Netherlands,NA,Limburg,1116137,19,0,5443,756
2020-09-02,Netherlands,NA,Limburg,1116137,23,0,5466,756
2020-09-03,Netherlands,NA,Limburg,1116137,17,0,5483,756
2020-09-04,Netherlands,NA,Limburg,1116137,26,1,5509,757
2020-09-05,Netherlands,NA,Limburg,1116137,22,0,5531,757
2020-09-06,Netherlands,NA,Limburg,1116137,25,0,5556,757
2020-09-07,Netherlands,NA,Limburg,1116137,18,0,5574,757
2020-09-08,Netherlands,NA,Limburg,1116137,18,0,5592,757
2020-09-09,Netherlands,NA,Limburg,1116137,26,0,5618,757
2020-09-10,Netherlands,NA,Limburg,1116137,31,1,5649,758
2020-09-11,Netherlands,NA,Limburg,1116137,36,0,5685,758
2020-09-12,Netherlands,NA,Limburg,1116137,37,0,5722,758
2020-09-13,Netherlands,NA,Limburg,1116137,38,0,5760,758
2020-09-14,Netherlands,NA,Limburg,1116137,34,0,5794,758
2020-09-15,Netherlands,NA,Limburg,1116137,25,0,5819,758
2020-09-16,Netherlands,NA,Limburg,1116137,33,0,5852,758
2020-09-17,Netherlands,NA,Limburg,1116137,48,1,5900,759
2020-09-18,Netherlands,NA,Limburg,1116137,32,0,5932,759
2020-09-19,Netherlands,NA,Limburg,1116137,58,1,5990,760
2020-09-20,Netherlands,NA,Limburg,1116137,38,0,6028,760
2020-09-21,Netherlands,NA,Limburg,1116137,39,0,6067,760
2020-09-22,Netherlands,NA,Limburg,1116137,37,0,6104,760
2020-09-23,Netherlands,NA,Limburg,1116137,63,0,6167,760
2020-03-13,Netherlands,NA,North Brabant,2544806,0,0,360,5
2020-03-14,Netherlands,NA,North Brabant,2544806,43,1,403,6
2020-03-15,Netherlands,NA,North Brabant,2544806,43,7,446,13
2020-03-16,Netherlands,NA,North Brabant,2544806,108,3,554,16
2020-03-17,Netherlands,NA,North Brabant,2544806,80,11,634,27
2020-03-18,Netherlands,NA,North Brabant,2544806,94,10,728,37
2020-03-19,Netherlands,NA,North Brabant,2544806,114,12,842,49
2020-03-20,Netherlands,NA,North Brabant,2544806,265,13,1107,62
2020-03-21,Netherlands,NA,North Brabant,2544806,40,17,1147,79
2020-03-22,Netherlands,NA,North Brabant,2544806,221,22,1368,101
2020-03-23,Netherlands,NA,North Brabant,2544806,152,3,1520,104
2020-03-24,Netherlands,NA,North Brabant,2544806,178,21,1698,125
2020-03-25,Netherlands,NA,North Brabant,2544806,177,48,1875,173
2020-03-26,Netherlands,NA,North Brabant,2544806,242,26,2117,199
2020-03-27,Netherlands,NA,North Brabant,2544806,329,52,2446,251
2020-03-28,Netherlands,NA,North Brabant,2544806,260,33,2706,284
2020-03-29,Netherlands,NA,North Brabant,2544806,271,55,2977,339
2020-03-30,Netherlands,NA,North Brabant,2544806,214,29,3191,368
2020-03-31,Netherlands,NA,North Brabant,2544806,184,77,3375,445
2020-04-01,Netherlands,NA,North Brabant,2544806,153,34,3528,479
2020-04-02,Netherlands,NA,North Brabant,2544806,224,46,3752,525
2020-04-03,Netherlands,NA,North Brabant,2544806,160,51,3912,576
2020-04-04,Netherlands,NA,North Brabant,2544806,136,52,4048,628
2020-04-05,Netherlands,NA,North Brabant,2544806,176,33,4224,661
2020-04-06,Netherlands,NA,North Brabant,2544806,191,10,4415,671
2020-04-07,Netherlands,NA,North Brabant,2544806,154,69,4569,740
2020-04-08,Netherlands,NA,North Brabant,2544806,182,40,4751,780
2020-04-09,Netherlands,NA,North Brabant,2544806,202,42,4953,822
2020-04-10,Netherlands,NA,North Brabant,2544806,248,25,5201,847
2020-04-11,Netherlands,NA,North Brabant,2544806,158,32,5359,879
2020-04-12,Netherlands,NA,North Brabant,2544806,244,20,5603,899
2020-04-13,Netherlands,NA,North Brabant,2544806,136,19,5739,918
2020-04-14,Netherlands,NA,North Brabant,2544806,168,24,5907,942
2020-04-15,Netherlands,NA,North Brabant,2544806,114,41,6021,983
2020-04-16,Netherlands,NA,North Brabant,2544806,205,58,6226,1041
2020-04-17,Netherlands,NA,North Brabant,2544806,167,31,6393,1072
2020-04-18,Netherlands,NA,North Brabant,2544806,184,35,6577,1107
2020-04-19,Netherlands,NA,North Brabant,2544806,166,21,6743,1128
2020-04-20,Netherlands,NA,North Brabant,2544806,156,15,6899,1143
2020-04-21,Netherlands,NA,North Brabant,2544806,137,42,7036,1185
2020-04-22,Netherlands,NA,North Brabant,2544806,117,36,7153,1221
2020-04-23,Netherlands,NA,North Brabant,2544806,124,21,7277,1242
2020-04-24,Netherlands,NA,North Brabant,2544806,153,14,7430,1256
2020-04-25,Netherlands,NA,North Brabant,2544806,120,24,7550,1280
2020-04-26,Netherlands,NA,North Brabant,2544806,144,15,7694,1295
2020-04-27,Netherlands,NA,North Brabant,2544806,97,7,7791,1302
2020-04-28,Netherlands,NA,North Brabant,2544806,38,14,7829,1316
2020-04-29,Netherlands,NA,North Brabant,2544806,33,17,7862,1333
2020-04-30,Netherlands,NA,North Brabant,2544806,102,14,7964,1347
2020-05-01,Netherlands,NA,North Brabant,2544806,88,9,8052,1356
2020-05-02,Netherlands,NA,North Brabant,2544806,83,26,8135,1382
2020-05-03,Netherlands,NA,North Brabant,2544806,74,5,8209,1387
2020-05-04,Netherlands,NA,North Brabant,2544806,36,3,8245,1390
2020-05-05,Netherlands,NA,North Brabant,2544806,36,11,8281,1401
2020-05-06,Netherlands,NA,North Brabant,2544806,16,5,8297,1406
2020-05-07,Netherlands,NA,North Brabant,2544806,52,14,8349,1420
2020-05-08,Netherlands,NA,North Brabant,2544806,36,7,8385,1427
2020-05-09,Netherlands,NA,North Brabant,2544806,54,17,8439,1444
2020-05-10,Netherlands,NA,North Brabant,2544806,28,4,8467,1448
2020-05-11,Netherlands,NA,North Brabant,2544806,21,0,8488,1448
2020-05-12,Netherlands,NA,North Brabant,2544806,37,15,8525,1463
2020-05-13,Netherlands,NA,North Brabant,2544806,18,6,8543,1469
2020-05-14,Netherlands,NA,North Brabant,2544806,47,3,8590,1472
2020-05-15,Netherlands,NA,North Brabant,2544806,21,5,8611,1477
2020-05-16,Netherlands,NA,North Brabant,2544806,33,1,8644,1478
2020-05-17,Netherlands,NA,North Brabant,2544806,11,0,8655,1478
2020-05-18,Netherlands,NA,North Brabant,2544806,18,2,8673,1480
2020-05-19,Netherlands,NA,North Brabant,2544806,19,3,8692,1483
2020-05-20,Netherlands,NA,North Brabant,2544806,29,5,8721,1488
2020-05-21,Netherlands,NA,North Brabant,2544806,21,1,8742,1489
2020-05-22,Netherlands,NA,North Brabant,2544806,16,1,8758,1490
2020-05-23,Netherlands,NA,North Brabant,2544806,31,1,8789,1491
2020-05-24,Netherlands,NA,North Brabant,2544806,24,1,8813,1492
2020-05-25,Netherlands,NA,North Brabant,2544806,16,0,8829,1492
2020-05-26,Netherlands,NA,North Brabant,2544806,26,3,8855,1495
2020-05-27,Netherlands,NA,North Brabant,2544806,21,3,8876,1498
2020-05-28,Netherlands,NA,North Brabant,2544806,45,7,8921,1505
2020-05-29,Netherlands,NA,North Brabant,2544806,22,3,8943,1508
2020-05-30,Netherlands,NA,North Brabant,2544806,24,2,8967,1510
2020-05-31,Netherlands,NA,North Brabant,2544806,36,0,9003,1510
2020-06-01,Netherlands,NA,North Brabant,2544806,7,0,9010,1510
2020-06-02,Netherlands,NA,North Brabant,2544806,21,1,9031,1511
2020-06-03,Netherlands,NA,North Brabant,2544806,17,0,9048,1511
2020-06-04,Netherlands,NA,North Brabant,2544806,34,3,9082,1514
2020-06-05,Netherlands,NA,North Brabant,2544806,41,3,9123,1517
2020-06-06,Netherlands,NA,North Brabant,2544806,29,1,9152,1518
2020-06-07,Netherlands,NA,North Brabant,2544806,20,0,9172,1518
2020-06-08,Netherlands,NA,North Brabant,2544806,38,1,9210,1519
2020-06-09,Netherlands,NA,North Brabant,2544806,22,0,9232,1519
2020-06-10,Netherlands,NA,North Brabant,2544806,27,1,9259,1520
2020-06-11,Netherlands,NA,North Brabant,2544806,28,0,9287,1520
2020-06-12,Netherlands,NA,North Brabant,2544806,40,4,9327,1524
2020-06-13,Netherlands,NA,North Brabant,2544806,34,0,9361,1524
2020-06-14,Netherlands,NA,North Brabant,2544806,21,0,9382,1524
2020-06-15,Netherlands,NA,North Brabant,2544806,11,2,9393,1526
2020-06-16,Netherlands,NA,North Brabant,2544806,27,1,9420,1527
2020-06-17,Netherlands,NA,North Brabant,2544806,23,0,9443,1527
2020-06-18,Netherlands,NA,North Brabant,2544806,14,1,9457,1528
2020-06-19,Netherlands,NA,North Brabant,2544806,20,0,9477,1528
2020-06-20,Netherlands,NA,North Brabant,2544806,7,1,9484,1529
2020-06-21,Netherlands,NA,North Brabant,2544806,16,1,9500,1530
2020-06-22,Netherlands,NA,North Brabant,2544806,8,0,9508,1530
2020-06-23,Netherlands,NA,North Brabant,2544806,10,1,9518,1531
2020-06-24,Netherlands,NA,North Brabant,2544806,18,0,9536,1531
2020-06-25,Netherlands,NA,North Brabant,2544806,16,0,9552,1531
2020-06-26,Netherlands,NA,North Brabant,2544806,14,2,9566,1533
2020-06-27,Netherlands,NA,North Brabant,2544806,8,0,9574,1533
2020-06-28,Netherlands,NA,North Brabant,2544806,2,0,9576,1533
2020-06-29,Netherlands,NA,North Brabant,2544806,12,0,9588,1533
2020-06-30,Netherlands,NA,North Brabant,2544806,5,2,9593,1535
2020-07-01,Netherlands,NA,North Brabant,2544806,8,0,9601,1535
2020-07-02,Netherlands,NA,North Brabant,2544806,8,1,9609,1536
2020-07-03,Netherlands,NA,North Brabant,2544806,7,0,9616,1536
2020-07-04,Netherlands,NA,North Brabant,2544806,13,0,9629,1536
2020-07-05,Netherlands,NA,North Brabant,2544806,9,0,9638,1536
2020-07-06,Netherlands,NA,North Brabant,2544806,3,0,9641,1536
2020-07-07,Netherlands,NA,North Brabant,2544806,12,0,9653,1536
2020-07-08,Netherlands,NA,North Brabant,2544806,10,1,9663,1537
2020-07-09,Netherlands,NA,North Brabant,2544806,9,0,9672,1537
2020-07-10,Netherlands,NA,North Brabant,2544806,12,0,9684,1537
2020-07-11,Netherlands,NA,North Brabant,2544806,14,0,9698,1537
2020-07-12,Netherlands,NA,North Brabant,2544806,19,0,9717,1537
2020-07-13,Netherlands,NA,North Brabant,2544806,13,0,9730,1537
2020-07-14,Netherlands,NA,North Brabant,2544806,0,0,9730,1537
2020-07-15,Netherlands,NA,North Brabant,2544806,5,0,9730,1537
2020-07-16,Netherlands,NA,North Brabant,2544806,16,0,9730,1537
2020-07-17,Netherlands,NA,North Brabant,2544806,17,0,9747,1537
2020-07-18,Netherlands,NA,North Brabant,2544806,16,0,9763,1537
2020-07-19,Netherlands,NA,North Brabant,2544806,19,0,9782,1537
2020-07-20,Netherlands,NA,North Brabant,2544806,23,0,9805,1537
2020-07-21,Netherlands,NA,North Brabant,2544806,14,0,9819,1537
2020-07-22,Netherlands,NA,North Brabant,2544806,26,0,9845,1537
2020-07-23,Netherlands,NA,North Brabant,2544806,9,0,9854,1537
2020-07-24,Netherlands,NA,North Brabant,2544806,24,0,9878,1537
2020-07-25,Netherlands,NA,North Brabant,2544806,14,0,9892,1537
2020-07-26,Netherlands,NA,North Brabant,2544806,27,0,9919,1537
2020-07-27,Netherlands,NA,North Brabant,2544806,16,1,9935,1537
2020-07-28,Netherlands,NA,North Brabant,2544806,35,0,9970,1537
2020-07-29,Netherlands,NA,North Brabant,2544806,39,0,10009,1537
2020-07-30,Netherlands,NA,North Brabant,2544806,43,0,10052,1537
2020-07-31,Netherlands,NA,North Brabant,2544806,36,0,10088,1537
2020-08-01,Netherlands,NA,North Brabant,2544806,50,0,10138,1537
2020-08-02,Netherlands,NA,North Brabant,2544806,61,1,10199,1537
2020-08-03,Netherlands,NA,North Brabant,2544806,53,0,10252,1537
2020-08-04,Netherlands,NA,North Brabant,2544806,51,0,10303,1537
2020-08-05,Netherlands,NA,North Brabant,2544806,53,1,10356,1538
2020-08-06,Netherlands,NA,North Brabant,2544806,60,0,10416,1538
2020-08-07,Netherlands,NA,North Brabant,2544806,70,1,10486,1539
2020-08-08,Netherlands,NA,North Brabant,2544806,72,2,10558,1541
2020-08-09,Netherlands,NA,North Brabant,2544806,85,0,10643,1541
2020-08-10,Netherlands,NA,North Brabant,2544806,66,0,10709,1541
2020-08-11,Netherlands,NA,North Brabant,2544806,107,0,10816,1541
2020-08-12,Netherlands,NA,North Brabant,2544806,57,1,10873,1542
2020-08-13,Netherlands,NA,North Brabant,2544806,51,1,10924,1543
2020-08-14,Netherlands,NA,North Brabant,2544806,71,0,10995,1543
2020-08-15,Netherlands,NA,North Brabant,2544806,69,1,11064,1544
2020-08-16,Netherlands,NA,North Brabant,2544806,72,1,11136,1545
2020-08-17,Netherlands,NA,North Brabant,2544806,61,0,11197,1545
2020-08-18,Netherlands,NA,North Brabant,2544806,67,1,11264,1546
2020-08-19,Netherlands,NA,North Brabant,2544806,66,0,11330,1546
2020-08-20,Netherlands,NA,North Brabant,2544806,50,0,11380,1546
2020-08-21,Netherlands,NA,North Brabant,2544806,82,0,11462,1546
2020-08-22,Netherlands,NA,North Brabant,2544806,61,1,11523,1547
2020-08-23,Netherlands,NA,North Brabant,2544806,68,0,11591,1547
2020-08-24,Netherlands,NA,North Brabant,2544806,85,0,11676,1547
2020-08-25,Netherlands,NA,North Brabant,2544806,59,0,11735,1547
2020-08-26,Netherlands,NA,North Brabant,2544806,99,0,11834,1547
2020-08-27,Netherlands,NA,North Brabant,2544806,72,0,11906,1547
2020-08-28,Netherlands,NA,North Brabant,2544806,88,0,11994,1547
2020-08-29,Netherlands,NA,North Brabant,2544806,86,0,12080,1547
2020-08-30,Netherlands,NA,North Brabant,2544806,65,0,12145,1547
2020-08-31,Netherlands,NA,North Brabant,2544806,70,0,12215,1547
2020-09-01,Netherlands,NA,North Brabant,2544806,51,1,12266,1548
2020-09-02,Netherlands,NA,North Brabant,2544806,70,2,12336,1550
2020-09-03,Netherlands,NA,North Brabant,2544806,64,0,12400,1550
2020-09-04,Netherlands,NA,North Brabant,2544806,74,0,12474,1550
2020-09-05,Netherlands,NA,North Brabant,2544806,80,0,12554,1550
2020-09-06,Netherlands,NA,North Brabant,2544806,97,1,12651,1551
2020-09-07,Netherlands,NA,North Brabant,2544806,86,0,12737,1551
2020-09-08,Netherlands,NA,North Brabant,2544806,90,0,12827,1551
2020-09-09,Netherlands,NA,North Brabant,2544806,114,0,12941,1551
2020-09-10,Netherlands,NA,North Brabant,2544806,84,0,13025,1551
2020-09-11,Netherlands,NA,North Brabant,2544806,101,0,13126,1551
2020-09-12,Netherlands,NA,North Brabant,2544806,112,0,13238,1551
2020-09-13,Netherlands,NA,North Brabant,2544806,119,0,13357,1551
2020-09-14,Netherlands,NA,North Brabant,2544806,113,0,13470,1551
2020-09-15,Netherlands,NA,North Brabant,2544806,109,0,13579,1551
2020-09-16,Netherlands,NA,North Brabant,2544806,122,0,13701,1551
2020-09-17,Netherlands,NA,North Brabant,2544806,168,1,13869,1552
2020-09-18,Netherlands,NA,North Brabant,2544806,196,0,14065,1552
2020-09-19,Netherlands,NA,North Brabant,2544806,213,0,14278,1552
2020-09-20,Netherlands,NA,North Brabant,2544806,144,0,14422,1552
2020-09-21,Netherlands,NA,North Brabant,2544806,248,0,14670,1552
2020-09-22,Netherlands,NA,North Brabant,2544806,265,0,14935,1552
2020-09-23,Netherlands,NA,North Brabant,2544806,316,2,15251,1554
2020-03-13,Netherlands,NA,North Holland,2853359,0,0,63,0
2020-03-14,Netherlands,NA,North Holland,2853359,20,0,83,0
2020-03-15,Netherlands,NA,North Holland,2853359,7,0,90,0
2020-03-16,Netherlands,NA,North Holland,2853359,26,0,116,0
2020-03-17,Netherlands,NA,North Holland,2853359,36,0,152,0
2020-03-18,Netherlands,NA,North Holland,2853359,22,0,174,0
2020-03-19,Netherlands,NA,North Holland,2853359,71,1,245,1
2020-03-20,Netherlands,NA,North Holland,2853359,220,1,465,2
2020-03-21,Netherlands,NA,North Holland,2853359,0,2,465,4
2020-03-22,Netherlands,NA,North Holland,2853359,71,2,508,6
2020-03-23,Netherlands,NA,North Holland,2853359,63,4,571,10
2020-03-24,Netherlands,NA,North Holland,2853359,138,7,709,17
2020-03-25,Netherlands,NA,North Holland,2853359,128,6,837,23
2020-03-26,Netherlands,NA,North Holland,2853359,160,7,997,30
2020-03-27,Netherlands,NA,North Holland,2853359,197,10,1194,40
2020-03-28,Netherlands,NA,North Holland,2853359,168,12,1362,52
2020-03-29,Netherlands,NA,North Holland,2853359,153,12,1515,64
2020-03-30,Netherlands,NA,North Holland,2853359,146,12,1661,76
2020-03-31,Netherlands,NA,North Holland,2853359,149,24,1810,100
2020-04-01,Netherlands,NA,North Holland,2853359,172,17,1982,117
2020-04-02,Netherlands,NA,North Holland,2853359,182,24,2164,141
2020-04-03,Netherlands,NA,North Holland,2853359,168,9,2332,150
2020-04-04,Netherlands,NA,North Holland,2853359,167,29,2499,179
2020-04-05,Netherlands,NA,North Holland,2853359,229,16,2728,195
2020-04-06,Netherlands,NA,North Holland,2853359,117,10,2845,205
2020-04-07,Netherlands,NA,North Holland,2853359,122,22,2967,227
2020-04-08,Netherlands,NA,North Holland,2853359,131,31,3098,258
2020-04-09,Netherlands,NA,North Holland,2853359,179,21,3277,279
2020-04-10,Netherlands,NA,North Holland,2853359,228,11,3505,290
2020-04-11,Netherlands,NA,North Holland,2853359,152,28,3657,318
2020-04-12,Netherlands,NA,North Holland,2853359,175,14,3832,332
2020-04-13,Netherlands,NA,North Holland,2853359,100,16,3932,348
2020-04-14,Netherlands,NA,North Holland,2853359,106,15,4038,363
2020-04-15,Netherlands,NA,North Holland,2853359,105,37,4143,400
2020-04-16,Netherlands,NA,North Holland,2853359,143,18,4286,418
2020-04-17,Netherlands,NA,North Holland,2853359,207,18,4493,436
2020-04-18,Netherlands,NA,North Holland,2853359,152,20,4645,456
2020-04-19,Netherlands,NA,North Holland,2853359,132,11,4777,467
2020-04-20,Netherlands,NA,North Holland,2853359,98,9,4875,476
2020-04-21,Netherlands,NA,North Holland,2853359,101,23,4976,499
2020-04-22,Netherlands,NA,North Holland,2853359,108,14,5084,513
2020-04-23,Netherlands,NA,North Holland,2853359,143,17,5227,530
2020-04-24,Netherlands,NA,North Holland,2853359,84,14,5311,544
2020-04-25,Netherlands,NA,North Holland,2853359,73,11,5384,555
2020-04-26,Netherlands,NA,North Holland,2853359,88,10,5472,565
2020-04-27,Netherlands,NA,North Holland,2853359,43,5,5515,570
2020-04-28,Netherlands,NA,North Holland,2853359,36,6,5551,576
2020-04-29,Netherlands,NA,North Holland,2853359,72,24,5623,600
2020-04-30,Netherlands,NA,North Holland,2853359,52,9,5675,609
2020-05-01,Netherlands,NA,North Holland,2853359,78,7,5753,616
2020-05-02,Netherlands,NA,North Holland,2853359,72,7,5825,623
2020-05-03,Netherlands,NA,North Holland,2853359,34,33,5859,656
2020-05-04,Netherlands,NA,North Holland,2853359,24,7,5883,663
2020-05-05,Netherlands,NA,North Holland,2853359,68,14,5951,677
2020-05-06,Netherlands,NA,North Holland,2853359,59,8,6010,685
2020-05-07,Netherlands,NA,North Holland,2853359,49,18,6059,703
2020-05-08,Netherlands,NA,North Holland,2853359,44,8,6103,711
2020-05-09,Netherlands,NA,North Holland,2853359,47,7,6150,718
2020-05-10,Netherlands,NA,North Holland,2853359,38,1,6188,719
2020-05-11,Netherlands,NA,North Holland,2853359,37,2,6225,721
2020-05-12,Netherlands,NA,North Holland,2853359,24,9,6249,730
2020-05-13,Netherlands,NA,North Holland,2853359,34,8,6283,738
2020-05-14,Netherlands,NA,North Holland,2853359,52,8,6335,746
2020-05-15,Netherlands,NA,North Holland,2853359,38,10,6373,756
2020-05-16,Netherlands,NA,North Holland,2853359,28,5,6401,761
2020-05-17,Netherlands,NA,North Holland,2853359,14,5,6415,766
2020-05-18,Netherlands,NA,North Holland,2853359,16,2,6431,768
2020-05-19,Netherlands,NA,North Holland,2853359,16,1,6447,769
2020-05-20,Netherlands,NA,North Holland,2853359,30,1,6477,770
2020-05-21,Netherlands,NA,North Holland,2853359,32,4,6509,774
2020-05-22,Netherlands,NA,North Holland,2853359,34,5,6543,779
2020-05-23,Netherlands,NA,North Holland,2853359,22,1,6565,780
2020-05-24,Netherlands,NA,North Holland,2853359,12,3,6577,783
2020-05-25,Netherlands,NA,North Holland,2853359,8,3,6585,786
2020-05-26,Netherlands,NA,North Holland,2853359,8,6,6593,792
2020-05-27,Netherlands,NA,North Holland,2853359,30,2,6623,794
2020-05-28,Netherlands,NA,North Holland,2853359,15,2,6638,796
2020-05-29,Netherlands,NA,North Holland,2853359,13,1,6651,797
2020-05-30,Netherlands,NA,North Holland,2853359,21,1,6672,798
2020-05-31,Netherlands,NA,North Holland,2853359,23,1,6695,799
2020-06-01,Netherlands,NA,North Holland,2853359,11,1,6706,800
2020-06-02,Netherlands,NA,North Holland,2853359,5,1,6711,801
2020-06-03,Netherlands,NA,North Holland,2853359,7,1,6718,802
2020-06-04,Netherlands,NA,North Holland,2853359,11,0,6729,802
2020-06-05,Netherlands,NA,North Holland,2853359,11,2,6740,804
2020-06-06,Netherlands,NA,North Holland,2853359,9,1,6749,805
2020-06-07,Netherlands,NA,North Holland,2853359,82,0,6831,805
2020-06-08,Netherlands,NA,North Holland,2853359,28,1,6859,806
2020-06-09,Netherlands,NA,North Holland,2853359,15,3,6874,809
2020-06-10,Netherlands,NA,North Holland,2853359,32,1,6906,810
2020-06-11,Netherlands,NA,North Holland,2853359,31,0,6937,810
2020-06-12,Netherlands,NA,North Holland,2853359,15,0,6952,810
2020-06-13,Netherlands,NA,North Holland,2853359,32,0,6984,810
2020-06-14,Netherlands,NA,North Holland,2853359,21,0,7005,810
2020-06-15,Netherlands,NA,North Holland,2853359,24,0,7029,810
2020-06-16,Netherlands,NA,North Holland,2853359,29,0,7058,810
2020-06-17,Netherlands,NA,North Holland,2853359,23,3,7081,813
2020-06-18,Netherlands,NA,North Holland,2853359,25,1,7106,814
2020-06-19,Netherlands,NA,North Holland,2853359,11,0,7117,814
2020-06-20,Netherlands,NA,North Holland,2853359,10,0,7127,814
2020-06-21,Netherlands,NA,North Holland,2853359,5,0,7132,814
2020-06-22,Netherlands,NA,North Holland,2853359,7,0,7139,814
2020-06-23,Netherlands,NA,North Holland,2853359,12,1,7151,815
2020-06-24,Netherlands,NA,North Holland,2853359,17,1,7168,816
2020-06-25,Netherlands,NA,North Holland,2853359,10,0,7178,816
2020-06-26,Netherlands,NA,North Holland,2853359,16,0,7194,816
2020-06-27,Netherlands,NA,North Holland,2853359,15,0,7209,816
2020-06-28,Netherlands,NA,North Holland,2853359,11,0,7220,816
2020-06-29,Netherlands,NA,North Holland,2853359,9,0,7229,816
2020-06-30,Netherlands,NA,North Holland,2853359,10,0,7239,816
2020-07-01,Netherlands,NA,North Holland,2853359,12,0,7251,816
2020-07-02,Netherlands,NA,North Holland,2853359,19,0,7270,816
2020-07-03,Netherlands,NA,North Holland,2853359,20,0,7290,816
2020-07-04,Netherlands,NA,North Holland,2853359,12,0,7302,816
2020-07-05,Netherlands,NA,North Holland,2853359,10,0,7312,816
2020-07-06,Netherlands,NA,North Holland,2853359,5,0,7317,816
2020-07-07,Netherlands,NA,North Holland,2853359,7,0,7324,816
2020-07-08,Netherlands,NA,North Holland,2853359,12,0,7336,816
2020-07-09,Netherlands,NA,North Holland,2853359,7,1,7343,817
2020-07-10,Netherlands,NA,North Holland,2853359,13,1,7356,818
2020-07-11,Netherlands,NA,North Holland,2853359,13,0,7369,818
2020-07-12,Netherlands,NA,North Holland,2853359,9,0,7378,818
2020-07-13,Netherlands,NA,North Holland,2853359,16,0,7394,818
2020-07-14,Netherlands,NA,North Holland,2853359,8,0,7402,818
2020-07-15,Netherlands,NA,North Holland,2853359,14,0,7416,818
2020-07-16,Netherlands,NA,North Holland,2853359,24,0,7440,818
2020-07-17,Netherlands,NA,North Holland,2853359,19,0,7459,818
2020-07-18,Netherlands,NA,North Holland,2853359,20,0,7479,818
2020-07-19,Netherlands,NA,North Holland,2853359,44,0,7523,818
2020-07-20,Netherlands,NA,North Holland,2853359,35,0,7558,818
2020-07-21,Netherlands,NA,North Holland,2853359,34,0,7592,818
2020-07-22,Netherlands,NA,North Holland,2853359,36,1,7628,818
2020-07-23,Netherlands,NA,North Holland,2853359,31,0,7659,818
2020-07-24,Netherlands,NA,North Holland,2853359,41,0,7700,818
2020-07-25,Netherlands,NA,North Holland,2853359,31,0,7731,818
2020-07-26,Netherlands,NA,North Holland,2853359,46,0,7777,818
2020-07-27,Netherlands,NA,North Holland,2853359,61,0,7838,818
2020-07-28,Netherlands,NA,North Holland,2853359,49,0,7887,818
2020-07-29,Netherlands,NA,North Holland,2853359,43,0,7930,818
2020-07-30,Netherlands,NA,North Holland,2853359,96,0,8026,818
2020-07-31,Netherlands,NA,North Holland,2853359,72,0,8098,818
2020-08-01,Netherlands,NA,North Holland,2853359,95,0,8193,818
2020-08-02,Netherlands,NA,North Holland,2853359,58,0,8251,818
2020-08-03,Netherlands,NA,North Holland,2853359,72,0,8323,818
2020-08-04,Netherlands,NA,North Holland,2853359,178,0,8501,818
2020-08-05,Netherlands,NA,North Holland,2853359,89,0,8590,818
2020-08-06,Netherlands,NA,North Holland,2853359,201,0,8791,818
2020-08-07,Netherlands,NA,North Holland,2853359,115,0,8906,818
2020-08-08,Netherlands,NA,North Holland,2853359,134,1,9040,818
2020-08-09,Netherlands,NA,North Holland,2853359,128,0,9168,818
2020-08-10,Netherlands,NA,North Holland,2853359,210,0,9378,818
2020-08-11,Netherlands,NA,North Holland,2853359,185,0,9563,818
2020-08-12,Netherlands,NA,North Holland,2853359,154,0,9717,818
2020-08-13,Netherlands,NA,North Holland,2853359,120,3,9837,819
2020-08-14,Netherlands,NA,North Holland,2853359,194,1,10031,820
2020-08-15,Netherlands,NA,North Holland,2853359,194,0,10225,820
2020-08-16,Netherlands,NA,North Holland,2853359,130,0,10355,820
2020-08-17,Netherlands,NA,North Holland,2853359,162,0,10517,820
2020-08-18,Netherlands,NA,North Holland,2853359,157,2,10674,822
2020-08-19,Netherlands,NA,North Holland,2853359,156,1,10830,823
2020-08-20,Netherlands,NA,North Holland,2853359,166,0,10996,823
2020-08-21,Netherlands,NA,North Holland,2853359,140,0,11136,823
2020-08-22,Netherlands,NA,North Holland,2853359,88,0,11224,823
2020-08-23,Netherlands,NA,North Holland,2853359,105,0,11329,823
2020-08-24,Netherlands,NA,North Holland,2853359,168,2,11497,825
2020-08-25,Netherlands,NA,North Holland,2853359,142,0,11639,825
2020-08-26,Netherlands,NA,North Holland,2853359,132,0,11771,825
2020-08-27,Netherlands,NA,North Holland,2853359,132,0,11903,825
2020-08-28,Netherlands,NA,North Holland,2853359,133,1,12036,826
2020-08-29,Netherlands,NA,North Holland,2853359,127,1,12163,827
2020-08-30,Netherlands,NA,North Holland,2853359,101,0,12264,827
2020-08-31,Netherlands,NA,North Holland,2853359,160,0,12424,827
2020-09-01,Netherlands,NA,North Holland,2853359,130,1,12554,828
2020-09-02,Netherlands,NA,North Holland,2853359,198,1,12752,829
2020-09-03,Netherlands,NA,North Holland,2853359,151,0,12903,829
2020-09-04,Netherlands,NA,North Holland,2853359,207,1,13110,830
2020-09-05,Netherlands,NA,North Holland,2853359,180,0,13290,830
2020-09-06,Netherlands,NA,North Holland,2853359,207,0,13497,830
2020-09-07,Netherlands,NA,North Holland,2853359,215,0,13712,830
2020-09-08,Netherlands,NA,North Holland,2853359,299,0,14011,830
2020-09-09,Netherlands,NA,North Holland,2853359,263,0,14274,830
2020-09-10,Netherlands,NA,North Holland,2853359,224,0,14498,830
2020-09-11,Netherlands,NA,North Holland,2853359,304,2,14802,832
2020-09-12,Netherlands,NA,North Holland,2853359,312,0,15114,832
2020-09-13,Netherlands,NA,North Holland,2853359,326,1,15440,833
2020-09-14,Netherlands,NA,North Holland,2853359,315,1,15755,834
2020-09-15,Netherlands,NA,North Holland,2853359,412,2,16167,836
2020-09-16,Netherlands,NA,North Holland,2853359,413,0,16580,836
2020-09-17,Netherlands,NA,North Holland,2853359,432,2,17012,838
2020-09-18,Netherlands,NA,North Holland,2853359,561,0,17573,838
2020-09-19,Netherlands,NA,North Holland,2853359,514,2,18087,840
2020-09-20,Netherlands,NA,North Holland,2853359,490,1,18577,841
2020-09-21,Netherlands,NA,North Holland,2853359,464,1,19041,842
2020-09-22,Netherlands,NA,North Holland,2853359,621,1,19662,843
2020-09-23,Netherlands,NA,North Holland,2853359,523,0,20185,843
2020-03-13,Netherlands,NA,Overijssel,1156431,0,0,18,0
2020-03-14,Netherlands,NA,Overijssel,1156431,5,1,23,1
2020-03-15,Netherlands,NA,Overijssel,1156431,5,0,28,1
2020-03-16,Netherlands,NA,Overijssel,1156431,8,0,36,1
2020-03-17,Netherlands,NA,Overijssel,1156431,9,0,45,1
2020-03-18,Netherlands,NA,Overijssel,1156431,13,1,58,1
2020-03-19,Netherlands,NA,Overijssel,1156431,15,0,73,1
2020-03-20,Netherlands,NA,Overijssel,1156431,57,1,130,2
2020-03-21,Netherlands,NA,Overijssel,1156431,31,2,161,4
2020-03-22,Netherlands,NA,Overijssel,1156431,27,2,188,6
2020-03-23,Netherlands,NA,Overijssel,1156431,29,2,217,8
2020-03-24,Netherlands,NA,Overijssel,1156431,31,3,248,11
2020-03-25,Netherlands,NA,Overijssel,1156431,69,3,317,14
2020-03-26,Netherlands,NA,Overijssel,1156431,71,4,388,18
2020-03-27,Netherlands,NA,Overijssel,1156431,58,4,446,22
2020-03-28,Netherlands,NA,Overijssel,1156431,69,10,515,32
2020-03-29,Netherlands,NA,Overijssel,1156431,73,5,588,37
2020-03-30,Netherlands,NA,Overijssel,1156431,57,2,645,39
2020-03-31,Netherlands,NA,Overijssel,1156431,41,11,686,50
2020-04-01,Netherlands,NA,Overijssel,1156431,78,12,764,62
2020-04-02,Netherlands,NA,Overijssel,1156431,87,10,851,72
2020-04-03,Netherlands,NA,Overijssel,1156431,77,8,928,80
2020-04-04,Netherlands,NA,Overijssel,1156431,110,16,1038,96
2020-04-05,Netherlands,NA,Overijssel,1156431,79,3,1117,99
2020-04-06,Netherlands,NA,Overijssel,1156431,75,13,1192,112
2020-04-07,Netherlands,NA,Overijssel,1156431,66,14,1258,126
2020-04-08,Netherlands,NA,Overijssel,1156431,67,4,1325,130
2020-04-09,Netherlands,NA,Overijssel,1156431,77,2,1402,132
2020-04-10,Netherlands,NA,Overijssel,1156431,191,9,1593,141
2020-04-11,Netherlands,NA,Overijssel,1156431,95,8,1688,149
2020-04-12,Netherlands,NA,Overijssel,1156431,73,5,1761,154
2020-04-13,Netherlands,NA,Overijssel,1156431,56,5,1817,159
2020-04-14,Netherlands,NA,Overijssel,1156431,57,4,1874,163
2020-04-15,Netherlands,NA,Overijssel,1156431,51,9,1925,172
2020-04-16,Netherlands,NA,Overijssel,1156431,90,7,2015,179
2020-04-17,Netherlands,NA,Overijssel,1156431,115,6,2130,185
2020-04-18,Netherlands,NA,Overijssel,1156431,57,4,2187,189
2020-04-19,Netherlands,NA,Overijssel,1156431,75,1,2262,190
2020-04-20,Netherlands,NA,Overijssel,1156431,48,2,2310,192
2020-04-21,Netherlands,NA,Overijssel,1156431,64,13,2374,205
2020-04-22,Netherlands,NA,Overijssel,1156431,37,7,2411,212
2020-04-23,Netherlands,NA,Overijssel,1156431,61,6,2472,218
2020-04-24,Netherlands,NA,Overijssel,1156431,48,5,2520,223
2020-04-25,Netherlands,NA,Overijssel,1156431,38,15,2558,238
2020-04-26,Netherlands,NA,Overijssel,1156431,46,5,2604,243
2020-04-27,Netherlands,NA,Overijssel,1156431,9,0,2613,243
2020-04-28,Netherlands,NA,Overijssel,1156431,5,3,2618,246
2020-04-29,Netherlands,NA,Overijssel,1156431,30,2,2648,248
2020-04-30,Netherlands,NA,Overijssel,1156431,39,3,2687,251
2020-05-01,Netherlands,NA,Overijssel,1156431,18,20,2705,271
2020-05-02,Netherlands,NA,Overijssel,1156431,27,0,2732,271
2020-05-03,Netherlands,NA,Overijssel,1156431,19,0,2751,271
2020-05-04,Netherlands,NA,Overijssel,1156431,12,1,2763,272
2020-05-05,Netherlands,NA,Overijssel,1156431,17,5,2780,277
2020-05-06,Netherlands,NA,Overijssel,1156431,9,1,2789,278
2020-05-07,Netherlands,NA,Overijssel,1156431,18,1,2807,279
2020-05-08,Netherlands,NA,Overijssel,1156431,21,2,2828,281
2020-05-09,Netherlands,NA,Overijssel,1156431,17,2,2845,283
2020-05-10,Netherlands,NA,Overijssel,1156431,7,1,2852,284
2020-05-11,Netherlands,NA,Overijssel,1156431,0,1,2852,285
2020-05-12,Netherlands,NA,Overijssel,1156431,12,2,2858,287
2020-05-13,Netherlands,NA,Overijssel,1156431,13,3,2871,290
2020-05-14,Netherlands,NA,Overijssel,1156431,12,2,2883,292
2020-05-15,Netherlands,NA,Overijssel,1156431,6,1,2889,293
2020-05-16,Netherlands,NA,Overijssel,1156431,11,0,2900,293
2020-05-17,Netherlands,NA,Overijssel,1156431,4,0,2904,293
2020-05-18,Netherlands,NA,Overijssel,1156431,1,1,2905,294
2020-05-19,Netherlands,NA,Overijssel,1156431,6,0,2911,294
2020-05-20,Netherlands,NA,Overijssel,1156431,8,4,2919,298
2020-05-21,Netherlands,NA,Overijssel,1156431,8,1,2927,299
2020-05-22,Netherlands,NA,Overijssel,1156431,7,0,2934,299
2020-05-23,Netherlands,NA,Overijssel,1156431,9,1,2943,300
2020-05-24,Netherlands,NA,Overijssel,1156431,7,0,2950,300
2020-05-25,Netherlands,NA,Overijssel,1156431,5,2,2955,302
2020-05-26,Netherlands,NA,Overijssel,1156431,6,0,2961,302
2020-05-27,Netherlands,NA,Overijssel,1156431,6,0,2967,302
2020-05-28,Netherlands,NA,Overijssel,1156431,5,2,2972,304
2020-05-29,Netherlands,NA,Overijssel,1156431,2,3,2974,307
2020-05-30,Netherlands,NA,Overijssel,1156431,3,0,2977,307
2020-05-31,Netherlands,NA,Overijssel,1156431,4,0,2981,307
2020-06-01,Netherlands,NA,Overijssel,1156431,1,0,2982,307
2020-06-02,Netherlands,NA,Overijssel,1156431,0,0,2982,307
2020-06-03,Netherlands,NA,Overijssel,1156431,0,0,2982,307
2020-06-04,Netherlands,NA,Overijssel,1156431,5,1,2987,307
2020-06-05,Netherlands,NA,Overijssel,1156431,4,0,2991,307
2020-06-06,Netherlands,NA,Overijssel,1156431,7,0,2998,307
2020-06-07,Netherlands,NA,Overijssel,1156431,4,0,3002,307
2020-06-08,Netherlands,NA,Overijssel,1156431,4,0,3006,307
2020-06-09,Netherlands,NA,Overijssel,1156431,4,0,3010,307
2020-06-10,Netherlands,NA,Overijssel,1156431,4,1,3014,308
2020-06-11,Netherlands,NA,Overijssel,1156431,2,0,3016,308
2020-06-12,Netherlands,NA,Overijssel,1156431,1,0,3017,308
2020-06-13,Netherlands,NA,Overijssel,1156431,0,0,3017,308
2020-06-14,Netherlands,NA,Overijssel,1156431,9,0,3025,308
2020-06-15,Netherlands,NA,Overijssel,1156431,12,0,3037,308
2020-06-16,Netherlands,NA,Overijssel,1156431,6,0,3043,308
2020-06-17,Netherlands,NA,Overijssel,1156431,1,0,3044,308
2020-06-18,Netherlands,NA,Overijssel,1156431,3,0,3047,308
2020-06-19,Netherlands,NA,Overijssel,1156431,4,0,3051,308
2020-06-20,Netherlands,NA,Overijssel,1156431,4,0,3055,308
2020-06-21,Netherlands,NA,Overijssel,1156431,13,0,3068,308
2020-06-22,Netherlands,NA,Overijssel,1156431,5,0,3073,308
2020-06-23,Netherlands,NA,Overijssel,1156431,1,0,3074,308
2020-06-24,Netherlands,NA,Overijssel,1156431,3,0,3077,308
2020-06-25,Netherlands,NA,Overijssel,1156431,2,0,3079,308
2020-06-26,Netherlands,NA,Overijssel,1156431,5,1,3084,309
2020-06-27,Netherlands,NA,Overijssel,1156431,1,0,3085,309
2020-06-28,Netherlands,NA,Overijssel,1156431,6,0,3091,309
2020-06-29,Netherlands,NA,Overijssel,1156431,4,0,3095,309
2020-06-30,Netherlands,NA,Overijssel,1156431,3,0,3098,309
2020-07-01,Netherlands,NA,Overijssel,1156431,2,0,3100,309
2020-07-02,Netherlands,NA,Overijssel,1156431,2,0,3102,309
2020-07-03,Netherlands,NA,Overijssel,1156431,5,0,3107,309
2020-07-04,Netherlands,NA,Overijssel,1156431,0,1,3107,310
2020-07-05,Netherlands,NA,Overijssel,1156431,3,0,3110,310
2020-07-06,Netherlands,NA,Overijssel,1156431,1,0,3111,310
2020-07-07,Netherlands,NA,Overijssel,1156431,4,0,3115,310
2020-07-08,Netherlands,NA,Overijssel,1156431,2,0,3117,310
2020-07-09,Netherlands,NA,Overijssel,1156431,0,0,3117,310
2020-07-10,Netherlands,NA,Overijssel,1156431,2,0,3117,310
2020-07-11,Netherlands,NA,Overijssel,1156431,4,1,3120,311
2020-07-12,Netherlands,NA,Overijssel,1156431,4,0,3124,311
2020-07-13,Netherlands,NA,Overijssel,1156431,1,0,3125,311
2020-07-14,Netherlands,NA,Overijssel,1156431,1,0,3126,311
2020-07-15,Netherlands,NA,Overijssel,1156431,5,0,3131,311
2020-07-16,Netherlands,NA,Overijssel,1156431,2,0,3133,311
2020-07-17,Netherlands,NA,Overijssel,1156431,4,0,3137,311
2020-07-18,Netherlands,NA,Overijssel,1156431,2,0,3139,311
2020-07-19,Netherlands,NA,Overijssel,1156431,4,0,3143,311
2020-07-20,Netherlands,NA,Overijssel,1156431,10,0,3153,311
2020-07-21,Netherlands,NA,Overijssel,1156431,3,0,3156,311
2020-07-22,Netherlands,NA,Overijssel,1156431,4,0,3160,311
2020-07-23,Netherlands,NA,Overijssel,1156431,0,0,3160,311
2020-07-24,Netherlands,NA,Overijssel,1156431,1,0,3161,311
2020-07-25,Netherlands,NA,Overijssel,1156431,2,0,3163,311
2020-07-26,Netherlands,NA,Overijssel,1156431,1,0,3164,311
2020-07-27,Netherlands,NA,Overijssel,1156431,4,0,3168,311
2020-07-28,Netherlands,NA,Overijssel,1156431,0,0,3168,311
2020-07-29,Netherlands,NA,Overijssel,1156431,6,0,3174,311
2020-07-30,Netherlands,NA,Overijssel,1156431,0,0,3174,311
2020-07-31,Netherlands,NA,Overijssel,1156431,3,0,3177,311
2020-08-01,Netherlands,NA,Overijssel,1156431,7,0,3184,311
2020-08-02,Netherlands,NA,Overijssel,1156431,3,0,3187,311
2020-08-03,Netherlands,NA,Overijssel,1156431,7,0,3194,311
2020-08-04,Netherlands,NA,Overijssel,1156431,3,0,3197,311
2020-08-05,Netherlands,NA,Overijssel,1156431,5,0,3202,311
2020-08-06,Netherlands,NA,Overijssel,1156431,11,0,3213,311
2020-08-07,Netherlands,NA,Overijssel,1156431,12,0,3225,311
2020-08-08,Netherlands,NA,Overijssel,1156431,10,0,3235,311
2020-08-09,Netherlands,NA,Overijssel,1156431,5,0,3240,311
2020-08-10,Netherlands,NA,Overijssel,1156431,8,0,3248,311
2020-08-11,Netherlands,NA,Overijssel,1156431,7,0,3255,311
2020-08-12,Netherlands,NA,Overijssel,1156431,14,0,3269,311
2020-08-13,Netherlands,NA,Overijssel,1156431,15,0,3284,311
2020-08-14,Netherlands,NA,Overijssel,1156431,17,0,3301,311
2020-08-15,Netherlands,NA,Overijssel,1156431,7,0,3308,311
2020-08-16,Netherlands,NA,Overijssel,1156431,11,0,3319,311
2020-08-17,Netherlands,NA,Overijssel,1156431,9,0,3328,311
2020-08-18,Netherlands,NA,Overijssel,1156431,15,0,3343,311
2020-08-19,Netherlands,NA,Overijssel,1156431,8,0,3351,311
2020-08-20,Netherlands,NA,Overijssel,1156431,18,1,3369,312
2020-08-21,Netherlands,NA,Overijssel,1156431,24,0,3393,312
2020-08-22,Netherlands,NA,Overijssel,1156431,15,0,3408,312
2020-08-23,Netherlands,NA,Overijssel,1156431,13,0,3421,312
2020-08-24,Netherlands,NA,Overijssel,1156431,12,0,3433,312
2020-08-25,Netherlands,NA,Overijssel,1156431,5,0,3438,312
2020-08-26,Netherlands,NA,Overijssel,1156431,16,2,3454,314
2020-08-27,Netherlands,NA,Overijssel,1156431,6,0,3460,314
2020-08-28,Netherlands,NA,Overijssel,1156431,7,0,3467,314
2020-08-29,Netherlands,NA,Overijssel,1156431,13,0,3480,314
2020-08-30,Netherlands,NA,Overijssel,1156431,12,0,3492,314
2020-08-31,Netherlands,NA,Overijssel,1156431,10,0,3502,314
2020-09-01,Netherlands,NA,Overijssel,1156431,3,0,3505,314
2020-09-02,Netherlands,NA,Overijssel,1156431,18,0,3523,314
2020-09-03,Netherlands,NA,Overijssel,1156431,16,0,3539,314
2020-09-04,Netherlands,NA,Overijssel,1156431,9,0,3548,314
2020-09-05,Netherlands,NA,Overijssel,1156431,17,0,3565,314
2020-09-06,Netherlands,NA,Overijssel,1156431,24,0,3589,314
2020-09-07,Netherlands,NA,Overijssel,1156431,15,0,3604,314
2020-09-08,Netherlands,NA,Overijssel,1156431,13,0,3617,314
2020-09-09,Netherlands,NA,Overijssel,1156431,27,0,3644,314
2020-09-10,Netherlands,NA,Overijssel,1156431,24,0,3668,314
2020-09-11,Netherlands,NA,Overijssel,1156431,33,0,3701,314
2020-09-12,Netherlands,NA,Overijssel,1156431,17,0,3718,314
2020-09-13,Netherlands,NA,Overijssel,1156431,31,0,3749,314
2020-09-14,Netherlands,NA,Overijssel,1156431,44,0,3793,314
2020-09-15,Netherlands,NA,Overijssel,1156431,41,0,3834,314
2020-09-16,Netherlands,NA,Overijssel,1156431,44,0,3878,314
2020-09-17,Netherlands,NA,Overijssel,1156431,60,0,3938,314
2020-09-18,Netherlands,NA,Overijssel,1156431,40,0,3978,314
2020-09-19,Netherlands,NA,Overijssel,1156431,63,0,4041,314
2020-09-20,Netherlands,NA,Overijssel,1156431,71,0,4112,314
2020-09-21,Netherlands,NA,Overijssel,1156431,55,0,4167,314
2020-09-22,Netherlands,NA,Overijssel,1156431,64,0,4231,314
2020-09-23,Netherlands,NA,Overijssel,1156431,67,0,4298,314
2020-03-13,Netherlands,NA,South Holland,3709139,0,0,81,0
2020-03-14,Netherlands,NA,South Holland,3709139,14,0,95,0
2020-03-15,Netherlands,NA,South Holland,3709139,15,0,110,0
2020-03-16,Netherlands,NA,South Holland,3709139,26,0,136,0
2020-03-17,Netherlands,NA,South Holland,3709139,39,0,175,0
2020-03-18,Netherlands,NA,South Holland,3709139,57,0,232,0
2020-03-19,Netherlands,NA,South Holland,3709139,71,0,303,0
2020-03-20,Netherlands,NA,South Holland,3709139,222,2,525,2
2020-03-21,Netherlands,NA,South Holland,3709139,0,2,525,4
2020-03-22,Netherlands,NA,South Holland,3709139,99,2,578,6
2020-03-23,Netherlands,NA,South Holland,3709139,62,3,640,9
2020-03-24,Netherlands,NA,South Holland,3709139,109,2,749,11
2020-03-25,Netherlands,NA,South Holland,3709139,130,4,879,15
2020-03-26,Netherlands,NA,South Holland,3709139,153,5,1032,20
2020-03-27,Netherlands,NA,South Holland,3709139,205,7,1237,27
2020-03-28,Netherlands,NA,South Holland,3709139,259,10,1496,37
2020-03-29,Netherlands,NA,South Holland,3709139,154,13,1650,50
2020-03-30,Netherlands,NA,South Holland,3709139,143,7,1793,57
2020-03-31,Netherlands,NA,South Holland,3709139,139,6,1932,63
2020-04-01,Netherlands,NA,South Holland,3709139,248,19,2180,82
2020-04-02,Netherlands,NA,South Holland,3709139,222,12,2402,94
2020-04-03,Netherlands,NA,South Holland,3709139,203,27,2605,121
2020-04-04,Netherlands,NA,South Holland,3709139,200,16,2805,137
2020-04-05,Netherlands,NA,South Holland,3709139,288,13,3093,150
2020-04-06,Netherlands,NA,South Holland,3709139,244,22,3337,172
2020-04-07,Netherlands,NA,South Holland,3709139,139,37,3476,209
2020-04-08,Netherlands,NA,South Holland,3709139,244,16,3720,225
2020-04-09,Netherlands,NA,South Holland,3709139,312,26,4032,251
2020-04-10,Netherlands,NA,South Holland,3709139,215,32,4247,283
2020-04-11,Netherlands,NA,South Holland,3709139,405,28,4652,311
2020-04-12,Netherlands,NA,South Holland,3709139,223,12,4875,323
2020-04-13,Netherlands,NA,South Holland,3709139,255,20,5130,343
2020-04-14,Netherlands,NA,South Holland,3709139,141,19,5271,362
2020-04-15,Netherlands,NA,South Holland,3709139,195,36,5466,398
2020-04-16,Netherlands,NA,South Holland,3709139,272,50,5738,448
2020-04-17,Netherlands,NA,South Holland,3709139,264,44,6002,492
2020-04-18,Netherlands,NA,South Holland,3709139,301,35,6303,527
2020-04-19,Netherlands,NA,South Holland,3709139,262,24,6565,551
2020-04-20,Netherlands,NA,South Holland,3709139,139,9,6704,560
2020-04-21,Netherlands,NA,South Holland,3709139,143,39,6847,599
2020-04-22,Netherlands,NA,South Holland,3709139,170,41,7017,640
2020-04-23,Netherlands,NA,South Holland,3709139,210,34,7227,674
2020-04-24,Netherlands,NA,South Holland,3709139,172,36,7399,710
2020-04-25,Netherlands,NA,South Holland,3709139,187,30,7586,740
2020-04-26,Netherlands,NA,South Holland,3709139,140,9,7726,749
2020-04-27,Netherlands,NA,South Holland,3709139,94,13,7820,762
2020-04-28,Netherlands,NA,South Holland,3709139,19,11,7839,773
2020-04-29,Netherlands,NA,South Holland,3709139,94,56,7933,829
2020-04-30,Netherlands,NA,South Holland,3709139,139,24,8072,853
2020-05-01,Netherlands,NA,South Holland,3709139,116,36,8188,889
2020-05-02,Netherlands,NA,South Holland,3709139,93,31,8281,920
2020-05-03,Netherlands,NA,South Holland,3709139,89,14,8370,934
2020-05-04,Netherlands,NA,South Holland,3709139,31,4,8401,938
2020-05-05,Netherlands,NA,South Holland,3709139,82,29,8483,967
2020-05-06,Netherlands,NA,South Holland,3709139,55,9,8538,976
2020-05-07,Netherlands,NA,South Holland,3709139,97,26,8635,1002
2020-05-08,Netherlands,NA,South Holland,3709139,84,38,8719,1040
2020-05-09,Netherlands,NA,South Holland,3709139,84,13,8803,1053
2020-05-10,Netherlands,NA,South Holland,3709139,69,2,8872,1055
2020-05-11,Netherlands,NA,South Holland,3709139,46,3,8918,1058
2020-05-12,Netherlands,NA,South Holland,3709139,61,19,8979,1077
2020-05-13,Netherlands,NA,South Holland,3709139,96,15,9075,1092
2020-05-14,Netherlands,NA,South Holland,3709139,86,4,9161,1096
2020-05-15,Netherlands,NA,South Holland,3709139,56,15,9217,1111
2020-05-16,Netherlands,NA,South Holland,3709139,56,14,9273,1125
2020-05-17,Netherlands,NA,South Holland,3709139,36,0,9309,1125
2020-05-18,Netherlands,NA,South Holland,3709139,64,2,9373,1127
2020-05-19,Netherlands,NA,South Holland,3709139,35,13,9408,1140
2020-05-20,Netherlands,NA,South Holland,3709139,59,16,9467,1156
2020-05-21,Netherlands,NA,South Holland,3709139,87,15,9554,1171
2020-05-22,Netherlands,NA,South Holland,3709139,50,0,9604,1171
2020-05-23,Netherlands,NA,South Holland,3709139,37,13,9641,1184
2020-05-24,Netherlands,NA,South Holland,3709139,45,3,9686,1187
2020-05-25,Netherlands,NA,South Holland,3709139,50,1,9736,1188
2020-05-26,Netherlands,NA,South Holland,3709139,31,11,9767,1199
2020-05-27,Netherlands,NA,South Holland,3709139,64,6,9831,1205
2020-05-28,Netherlands,NA,South Holland,3709139,39,7,9870,1212
2020-05-29,Netherlands,NA,South Holland,3709139,41,15,9911,1227
2020-05-30,Netherlands,NA,South Holland,3709139,28,10,9939,1237
2020-05-31,Netherlands,NA,South Holland,3709139,31,1,9970,1238
2020-06-01,Netherlands,NA,South Holland,3709139,32,0,10002,1238
2020-06-02,Netherlands,NA,South Holland,3709139,23,1,10025,1239
2020-06-03,Netherlands,NA,South Holland,3709139,30,6,10055,1245
2020-06-04,Netherlands,NA,South Holland,3709139,67,3,10122,1248
2020-06-05,Netherlands,NA,South Holland,3709139,61,6,10183,1254
2020-06-06,Netherlands,NA,South Holland,3709139,68,4,10251,1258
2020-06-07,Netherlands,NA,South Holland,3709139,58,0,10309,1258
2020-06-08,Netherlands,NA,South Holland,3709139,38,0,10347,1258
2020-06-09,Netherlands,NA,South Holland,3709139,74,8,10421,1266
2020-06-10,Netherlands,NA,South Holland,3709139,50,6,10471,1272
2020-06-11,Netherlands,NA,South Holland,3709139,57,0,10528,1272
2020-06-12,Netherlands,NA,South Holland,3709139,83,2,10611,1273
2020-06-13,Netherlands,NA,South Holland,3709139,53,2,10664,1275
2020-06-14,Netherlands,NA,South Holland,3709139,41,0,10705,1275
2020-06-15,Netherlands,NA,South Holland,3709139,44,0,10749,1275
2020-06-16,Netherlands,NA,South Holland,3709139,48,3,10797,1278
2020-06-17,Netherlands,NA,South Holland,3709139,40,0,10837,1278
2020-06-18,Netherlands,NA,South Holland,3709139,48,2,10885,1280
2020-06-19,Netherlands,NA,South Holland,3709139,34,0,10919,1280
2020-06-20,Netherlands,NA,South Holland,3709139,36,5,10955,1285
2020-06-21,Netherlands,NA,South Holland,3709139,25,0,10980,1285
2020-06-22,Netherlands,NA,South Holland,3709139,25,0,11005,1285
2020-06-23,Netherlands,NA,South Holland,3709139,24,2,11029,1287
2020-06-24,Netherlands,NA,South Holland,3709139,25,1,11054,1288
2020-06-25,Netherlands,NA,South Holland,3709139,41,1,11095,1289
2020-06-26,Netherlands,NA,South Holland,3709139,38,0,11133,1289
2020-06-27,Netherlands,NA,South Holland,3709139,24,1,11157,1290
2020-06-28,Netherlands,NA,South Holland,3709139,36,0,11193,1290
2020-06-29,Netherlands,NA,South Holland,3709139,35,1,11228,1291
2020-06-30,Netherlands,NA,South Holland,3709139,27,2,11255,1293
2020-07-01,Netherlands,NA,South Holland,3709139,25,1,11280,1294
2020-07-02,Netherlands,NA,South Holland,3709139,32,1,11312,1295
2020-07-03,Netherlands,NA,South Holland,3709139,28,0,11340,1295
2020-07-04,Netherlands,NA,South Holland,3709139,22,1,11362,1296
2020-07-05,Netherlands,NA,South Holland,3709139,27,0,11389,1296
2020-07-06,Netherlands,NA,South Holland,3709139,23,1,11412,1297
2020-07-07,Netherlands,NA,South Holland,3709139,10,3,11422,1300
2020-07-08,Netherlands,NA,South Holland,3709139,18,2,11440,1302
2020-07-09,Netherlands,NA,South Holland,3709139,23,0,11463,1302
2020-07-10,Netherlands,NA,South Holland,3709139,18,0,11481,1302
2020-07-11,Netherlands,NA,South Holland,3709139,35,0,11516,1302
2020-07-12,Netherlands,NA,South Holland,3709139,49,0,11565,1302
2020-07-13,Netherlands,NA,South Holland,3709139,25,0,11590,1302
2020-07-14,Netherlands,NA,South Holland,3709139,52,0,11642,1302
2020-07-15,Netherlands,NA,South Holland,3709139,48,1,11690,1303
2020-07-16,Netherlands,NA,South Holland,3709139,45,1,11735,1304
2020-07-17,Netherlands,NA,South Holland,3709139,51,1,11786,1305
2020-07-18,Netherlands,NA,South Holland,3709139,48,0,11834,1305
2020-07-19,Netherlands,NA,South Holland,3709139,52,0,11886,1305
2020-07-20,Netherlands,NA,South Holland,3709139,73,0,11959,1305
2020-07-21,Netherlands,NA,South Holland,3709139,80,0,12039,1305
2020-07-22,Netherlands,NA,South Holland,3709139,73,2,12112,1306
2020-07-23,Netherlands,NA,South Holland,3709139,92,0,12204,1306
2020-07-24,Netherlands,NA,South Holland,3709139,102,0,12306,1306
2020-07-25,Netherlands,NA,South Holland,3709139,46,1,12352,1307
2020-07-26,Netherlands,NA,South Holland,3709139,98,0,12450,1307
2020-07-27,Netherlands,NA,South Holland,3709139,90,0,12540,1307
2020-07-28,Netherlands,NA,South Holland,3709139,110,2,12650,1309
2020-07-29,Netherlands,NA,South Holland,3709139,108,1,12758,1310
2020-07-30,Netherlands,NA,South Holland,3709139,146,0,12904,1310
2020-07-31,Netherlands,NA,South Holland,3709139,156,0,13060,1310
2020-08-01,Netherlands,NA,South Holland,3709139,202,1,13262,1311
2020-08-02,Netherlands,NA,South Holland,3709139,185,0,13447,1311
2020-08-03,Netherlands,NA,South Holland,3709139,195,0,13642,1311
2020-08-04,Netherlands,NA,South Holland,3709139,195,0,13837,1311
2020-08-05,Netherlands,NA,South Holland,3709139,215,1,14052,1312
2020-08-06,Netherlands,NA,South Holland,3709139,236,0,14288,1312
2020-08-07,Netherlands,NA,South Holland,3709139,220,0,14508,1312
2020-08-08,Netherlands,NA,South Holland,3709139,183,0,14691,1312
2020-08-09,Netherlands,NA,South Holland,3709139,240,0,14931,1312
2020-08-10,Netherlands,NA,South Holland,3709139,253,0,15184,1312
2020-08-11,Netherlands,NA,South Holland,3709139,287,1,15471,1313
2020-08-12,Netherlands,NA,South Holland,3709139,294,1,15765,1314
2020-08-13,Netherlands,NA,South Holland,3709139,247,0,16012,1314
2020-08-14,Netherlands,NA,South Holland,3709139,227,1,16239,1315
2020-08-15,Netherlands,NA,South Holland,3709139,267,1,16506,1316
2020-08-16,Netherlands,NA,South Holland,3709139,168,2,16674,1318
2020-08-17,Netherlands,NA,South Holland,3709139,155,0,16829,1318
2020-08-18,Netherlands,NA,South Holland,3709139,160,0,16989,1318
2020-08-19,Netherlands,NA,South Holland,3709139,187,4,17176,1322
2020-08-20,Netherlands,NA,South Holland,3709139,179,9,17355,1331
2020-08-21,Netherlands,NA,South Holland,3709139,162,4,17517,1335
2020-08-22,Netherlands,NA,South Holland,3709139,191,2,17708,1337
2020-08-23,Netherlands,NA,South Holland,3709139,127,0,17835,1337
2020-08-24,Netherlands,NA,South Holland,3709139,185,0,18020,1337
2020-08-25,Netherlands,NA,South Holland,3709139,98,2,18118,1339
2020-08-26,Netherlands,NA,South Holland,3709139,204,2,18322,1341
2020-08-27,Netherlands,NA,South Holland,3709139,160,2,18482,1343
2020-08-28,Netherlands,NA,South Holland,3709139,154,0,18636,1343
2020-08-29,Netherlands,NA,South Holland,3709139,138,1,18774,1344
2020-08-30,Netherlands,NA,South Holland,3709139,206,0,18980,1344
2020-08-31,Netherlands,NA,South Holland,3709139,165,0,19145,1344
2020-09-01,Netherlands,NA,South Holland,3709139,176,2,19321,1346
2020-09-02,Netherlands,NA,South Holland,3709139,287,2,19608,1348
2020-09-03,Netherlands,NA,South Holland,3709139,248,0,19856,1348
2020-09-04,Netherlands,NA,South Holland,3709139,278,0,20134,1348
2020-09-05,Netherlands,NA,South Holland,3709139,196,3,20330,1350
2020-09-06,Netherlands,NA,South Holland,3709139,373,0,20703,1350
2020-09-07,Netherlands,NA,South Holland,3709139,257,0,20960,1350
2020-09-08,Netherlands,NA,South Holland,3709139,329,0,21289,1350
2020-09-09,Netherlands,NA,South Holland,3709139,449,2,21738,1352
2020-09-10,Netherlands,NA,South Holland,3709139,278,1,22016,1353
2020-09-11,Netherlands,NA,South Holland,3709139,529,1,22545,1354
2020-09-12,Netherlands,NA,South Holland,3709139,435,0,22980,1354
2020-09-13,Netherlands,NA,South Holland,3709139,350,0,23330,1354
2020-09-14,Netherlands,NA,South Holland,3709139,471,1,23801,1355
2020-09-15,Netherlands,NA,South Holland,3709139,457,0,24258,1355
2020-09-16,Netherlands,NA,South Holland,3709139,557,2,24815,1357
2020-09-17,Netherlands,NA,South Holland,3709139,574,2,25389,1359
2020-09-18,Netherlands,NA,South Holland,3709139,699,6,26088,1365
2020-09-19,Netherlands,NA,South Holland,3709139,556,0,26644,1365
2020-09-20,Netherlands,NA,South Holland,3709139,664,2,27308,1366
2020-09-21,Netherlands,NA,South Holland,3709139,782,1,28090,1367
2020-09-22,Netherlands,NA,South Holland,3709139,731,3,28821,1370
2020-09-23,Netherlands,NA,South Holland,3709139,692,2,29513,1372
2020-03-13,Netherlands,NA,Utrecht,1306912,0,0,83,0
2020-03-14,Netherlands,NA,Utrecht,1306912,4,0,87,0
2020-03-15,Netherlands,NA,Utrecht,1306912,22,0,109,0
2020-03-16,Netherlands,NA,Utrecht,1306912,31,0,140,0
2020-03-17,Netherlands,NA,Utrecht,1306912,33,0,173,0
2020-03-18,Netherlands,NA,Utrecht,1306912,24,1,197,1
2020-03-19,Netherlands,NA,Utrecht,1306912,40,0,237,1
2020-03-20,Netherlands,NA,Utrecht,1306912,101,1,338,2
2020-03-21,Netherlands,NA,Utrecht,1306912,0,3,338,5
2020-03-22,Netherlands,NA,Utrecht,1306912,31,1,346,6
2020-03-23,Netherlands,NA,Utrecht,1306912,57,0,403,6
2020-03-24,Netherlands,NA,Utrecht,1306912,59,4,462,10
2020-03-25,Netherlands,NA,Utrecht,1306912,89,3,551,13
2020-03-26,Netherlands,NA,Utrecht,1306912,83,5,634,18
2020-03-27,Netherlands,NA,Utrecht,1306912,89,10,723,28
2020-03-28,Netherlands,NA,Utrecht,1306912,82,4,805,32
2020-03-29,Netherlands,NA,Utrecht,1306912,83,9,888,41
2020-03-30,Netherlands,NA,Utrecht,1306912,74,1,962,42
2020-03-31,Netherlands,NA,Utrecht,1306912,62,10,1024,52
2020-04-01,Netherlands,NA,Utrecht,1306912,64,8,1088,60
2020-04-02,Netherlands,NA,Utrecht,1306912,94,15,1182,75
2020-04-03,Netherlands,NA,Utrecht,1306912,69,14,1251,89
2020-04-04,Netherlands,NA,Utrecht,1306912,60,11,1311,100
2020-04-05,Netherlands,NA,Utrecht,1306912,97,12,1408,112
2020-04-06,Netherlands,NA,Utrecht,1306912,53,9,1461,121
2020-04-07,Netherlands,NA,Utrecht,1306912,51,14,1512,135
2020-04-08,Netherlands,NA,Utrecht,1306912,72,9,1584,144
2020-04-09,Netherlands,NA,Utrecht,1306912,58,11,1642,155
2020-04-10,Netherlands,NA,Utrecht,1306912,60,9,1702,164
2020-04-11,Netherlands,NA,Utrecht,1306912,55,9,1757,173
2020-04-12,Netherlands,NA,Utrecht,1306912,76,8,1833,181
2020-04-13,Netherlands,NA,Utrecht,1306912,70,9,1903,190
2020-04-14,Netherlands,NA,Utrecht,1306912,66,17,1969,207
2020-04-15,Netherlands,NA,Utrecht,1306912,68,16,2037,223
2020-04-16,Netherlands,NA,Utrecht,1306912,65,8,2102,231
2020-04-17,Netherlands,NA,Utrecht,1306912,69,9,2171,240
2020-04-18,Netherlands,NA,Utrecht,1306912,66,10,2237,250
2020-04-19,Netherlands,NA,Utrecht,1306912,57,6,2294,256
2020-04-20,Netherlands,NA,Utrecht,1306912,46,9,2340,265
2020-04-21,Netherlands,NA,Utrecht,1306912,54,14,2394,279
2020-04-22,Netherlands,NA,Utrecht,1306912,48,8,2442,287
2020-04-23,Netherlands,NA,Utrecht,1306912,63,10,2505,297
2020-04-24,Netherlands,NA,Utrecht,1306912,67,2,2572,299
2020-04-25,Netherlands,NA,Utrecht,1306912,43,6,2615,305
2020-04-26,Netherlands,NA,Utrecht,1306912,69,4,2684,309
2020-04-27,Netherlands,NA,Utrecht,1306912,28,6,2712,315
2020-04-28,Netherlands,NA,Utrecht,1306912,25,3,2737,318
2020-04-29,Netherlands,NA,Utrecht,1306912,22,7,2759,325
2020-04-30,Netherlands,NA,Utrecht,1306912,43,10,2802,335
2020-05-01,Netherlands,NA,Utrecht,1306912,37,3,2839,338
2020-05-02,Netherlands,NA,Utrecht,1306912,30,9,2869,347
2020-05-03,Netherlands,NA,Utrecht,1306912,25,3,2894,350
2020-05-04,Netherlands,NA,Utrecht,1306912,19,1,2913,351
2020-05-05,Netherlands,NA,Utrecht,1306912,50,7,2963,358
2020-05-06,Netherlands,NA,Utrecht,1306912,6,2,2969,360
2020-05-07,Netherlands,NA,Utrecht,1306912,167,5,3136,365
2020-05-08,Netherlands,NA,Utrecht,1306912,22,5,3158,370
2020-05-09,Netherlands,NA,Utrecht,1306912,26,1,3184,371
2020-05-10,Netherlands,NA,Utrecht,1306912,25,1,3209,372
2020-05-11,Netherlands,NA,Utrecht,1306912,11,4,3220,376
2020-05-12,Netherlands,NA,Utrecht,1306912,11,2,3231,378
2020-05-13,Netherlands,NA,Utrecht,1306912,20,6,3251,384
2020-05-14,Netherlands,NA,Utrecht,1306912,21,2,3272,386
2020-05-15,Netherlands,NA,Utrecht,1306912,14,1,3286,387
2020-05-16,Netherlands,NA,Utrecht,1306912,25,2,3311,389
2020-05-17,Netherlands,NA,Utrecht,1306912,16,2,3327,391
2020-05-18,Netherlands,NA,Utrecht,1306912,17,0,3344,391
2020-05-19,Netherlands,NA,Utrecht,1306912,10,1,3354,392
2020-05-20,Netherlands,NA,Utrecht,1306912,18,3,3372,395
2020-05-21,Netherlands,NA,Utrecht,1306912,25,1,3397,396
2020-05-22,Netherlands,NA,Utrecht,1306912,23,1,3420,397
2020-05-23,Netherlands,NA,Utrecht,1306912,20,2,3440,399
2020-05-24,Netherlands,NA,Utrecht,1306912,19,1,3459,400
2020-05-25,Netherlands,NA,Utrecht,1306912,20,2,3479,402
2020-05-26,Netherlands,NA,Utrecht,1306912,11,0,3490,402
2020-05-27,Netherlands,NA,Utrecht,1306912,24,0,3514,402
2020-05-28,Netherlands,NA,Utrecht,1306912,21,3,3535,405
2020-05-29,Netherlands,NA,Utrecht,1306912,23,3,3558,408
2020-05-30,Netherlands,NA,Utrecht,1306912,13,2,3571,410
2020-05-31,Netherlands,NA,Utrecht,1306912,37,0,3608,410
2020-06-01,Netherlands,NA,Utrecht,1306912,16,3,3624,413
2020-06-02,Netherlands,NA,Utrecht,1306912,21,0,3645,413
2020-06-03,Netherlands,NA,Utrecht,1306912,13,1,3658,414
2020-06-04,Netherlands,NA,Utrecht,1306912,30,1,3688,415
2020-06-05,Netherlands,NA,Utrecht,1306912,27,3,3715,418
2020-06-06,Netherlands,NA,Utrecht,1306912,18,0,3733,418
2020-06-07,Netherlands,NA,Utrecht,1306912,19,1,3752,419
2020-06-08,Netherlands,NA,Utrecht,1306912,13,0,3765,419
2020-06-09,Netherlands,NA,Utrecht,1306912,17,0,3782,419
2020-06-10,Netherlands,NA,Utrecht,1306912,23,0,3805,419
2020-06-11,Netherlands,NA,Utrecht,1306912,14,2,3819,421
2020-06-12,Netherlands,NA,Utrecht,1306912,21,2,3840,423
2020-06-13,Netherlands,NA,Utrecht,1306912,10,0,3850,423
2020-06-14,Netherlands,NA,Utrecht,1306912,12,0,3862,423
2020-06-15,Netherlands,NA,Utrecht,1306912,17,1,3879,424
2020-06-16,Netherlands,NA,Utrecht,1306912,18,0,3897,424
2020-06-17,Netherlands,NA,Utrecht,1306912,12,0,3909,424
2020-06-18,Netherlands,NA,Utrecht,1306912,3,0,3912,424
2020-06-19,Netherlands,NA,Utrecht,1306912,8,0,3920,424
2020-06-20,Netherlands,NA,Utrecht,1306912,8,0,3928,424
2020-06-21,Netherlands,NA,Utrecht,1306912,14,0,3942,424
2020-06-22,Netherlands,NA,Utrecht,1306912,7,0,3949,424
2020-06-23,Netherlands,NA,Utrecht,1306912,10,1,3959,425
2020-06-24,Netherlands,NA,Utrecht,1306912,5,0,3964,425
2020-06-25,Netherlands,NA,Utrecht,1306912,17,0,3981,425
2020-06-26,Netherlands,NA,Utrecht,1306912,9,0,3990,425
2020-06-27,Netherlands,NA,Utrecht,1306912,6,1,3996,426
2020-06-28,Netherlands,NA,Utrecht,1306912,8,0,4004,426
2020-06-29,Netherlands,NA,Utrecht,1306912,9,0,4013,426
2020-06-30,Netherlands,NA,Utrecht,1306912,5,0,4018,426
2020-07-01,Netherlands,NA,Utrecht,1306912,4,0,4022,426
2020-07-02,Netherlands,NA,Utrecht,1306912,1,0,4023,426
2020-07-03,Netherlands,NA,Utrecht,1306912,2,1,4025,427
2020-07-04,Netherlands,NA,Utrecht,1306912,11,0,4036,427
2020-07-05,Netherlands,NA,Utrecht,1306912,13,1,4049,428
2020-07-06,Netherlands,NA,Utrecht,1306912,6,0,4055,428
2020-07-07,Netherlands,NA,Utrecht,1306912,3,1,4058,429
2020-07-08,Netherlands,NA,Utrecht,1306912,0,0,4058,429
2020-07-09,Netherlands,NA,Utrecht,1306912,12,1,4070,430
2020-07-10,Netherlands,NA,Utrecht,1306912,0,0,4070,430
2020-07-11,Netherlands,NA,Utrecht,1306912,9,0,4076,430
2020-07-12,Netherlands,NA,Utrecht,1306912,7,0,4083,430
2020-07-13,Netherlands,NA,Utrecht,1306912,9,0,4092,430
2020-07-14,Netherlands,NA,Utrecht,1306912,8,0,4100,430
2020-07-15,Netherlands,NA,Utrecht,1306912,14,0,4114,430
2020-07-16,Netherlands,NA,Utrecht,1306912,14,1,4128,430
2020-07-17,Netherlands,NA,Utrecht,1306912,9,0,4137,430
2020-07-18,Netherlands,NA,Utrecht,1306912,10,0,4147,430
2020-07-19,Netherlands,NA,Utrecht,1306912,15,0,4162,430
2020-07-20,Netherlands,NA,Utrecht,1306912,24,0,4186,430
2020-07-21,Netherlands,NA,Utrecht,1306912,10,0,4196,430
2020-07-22,Netherlands,NA,Utrecht,1306912,13,0,4209,430
2020-07-23,Netherlands,NA,Utrecht,1306912,16,0,4225,430
2020-07-24,Netherlands,NA,Utrecht,1306912,4,0,4229,430
2020-07-25,Netherlands,NA,Utrecht,1306912,19,0,4248,430
2020-07-26,Netherlands,NA,Utrecht,1306912,16,0,4264,430
2020-07-27,Netherlands,NA,Utrecht,1306912,9,0,4273,430
2020-07-28,Netherlands,NA,Utrecht,1306912,10,1,4283,430
2020-07-29,Netherlands,NA,Utrecht,1306912,24,0,4307,430
2020-07-30,Netherlands,NA,Utrecht,1306912,23,0,4330,430
2020-07-31,Netherlands,NA,Utrecht,1306912,36,0,4366,430
2020-08-01,Netherlands,NA,Utrecht,1306912,22,0,4388,430
2020-08-02,Netherlands,NA,Utrecht,1306912,24,0,4412,430
2020-08-03,Netherlands,NA,Utrecht,1306912,17,0,4429,430
2020-08-04,Netherlands,NA,Utrecht,1306912,26,1,4455,431
2020-08-05,Netherlands,NA,Utrecht,1306912,25,1,4480,432
2020-08-06,Netherlands,NA,Utrecht,1306912,51,0,4531,432
2020-08-07,Netherlands,NA,Utrecht,1306912,51,0,4582,432
2020-08-08,Netherlands,NA,Utrecht,1306912,36,0,4618,432
2020-08-09,Netherlands,NA,Utrecht,1306912,34,0,4652,432
2020-08-10,Netherlands,NA,Utrecht,1306912,33,0,4685,432
2020-08-11,Netherlands,NA,Utrecht,1306912,43,0,4728,432
2020-08-12,Netherlands,NA,Utrecht,1306912,44,0,4772,432
2020-08-13,Netherlands,NA,Utrecht,1306912,51,0,4823,432
2020-08-14,Netherlands,NA,Utrecht,1306912,36,0,4859,432
2020-08-15,Netherlands,NA,Utrecht,1306912,29,0,4888,432
2020-08-16,Netherlands,NA,Utrecht,1306912,35,0,4923,432
2020-08-17,Netherlands,NA,Utrecht,1306912,31,0,4954,432
2020-08-18,Netherlands,NA,Utrecht,1306912,23,0,4977,432
2020-08-19,Netherlands,NA,Utrecht,1306912,45,0,5022,432
2020-08-20,Netherlands,NA,Utrecht,1306912,33,0,5055,432
2020-08-21,Netherlands,NA,Utrecht,1306912,35,0,5090,432
2020-08-22,Netherlands,NA,Utrecht,1306912,48,0,5138,432
2020-08-23,Netherlands,NA,Utrecht,1306912,32,0,5170,432
2020-08-24,Netherlands,NA,Utrecht,1306912,35,0,5205,432
2020-08-25,Netherlands,NA,Utrecht,1306912,24,0,5229,432
2020-08-26,Netherlands,NA,Utrecht,1306912,38,1,5267,433
2020-08-27,Netherlands,NA,Utrecht,1306912,49,0,5316,433
2020-08-28,Netherlands,NA,Utrecht,1306912,34,1,5350,434
2020-08-29,Netherlands,NA,Utrecht,1306912,38,1,5388,435
2020-08-30,Netherlands,NA,Utrecht,1306912,50,0,5438,435
2020-08-31,Netherlands,NA,Utrecht,1306912,49,0,5487,435
2020-09-01,Netherlands,NA,Utrecht,1306912,37,1,5524,436
2020-09-02,Netherlands,NA,Utrecht,1306912,70,0,5594,436
2020-09-03,Netherlands,NA,Utrecht,1306912,32,0,5626,436
2020-09-04,Netherlands,NA,Utrecht,1306912,73,0,5699,436
2020-09-05,Netherlands,NA,Utrecht,1306912,66,1,5765,437
2020-09-06,Netherlands,NA,Utrecht,1306912,71,0,5836,437
2020-09-07,Netherlands,NA,Utrecht,1306912,85,0,5921,437
2020-09-08,Netherlands,NA,Utrecht,1306912,97,0,6018,437
2020-09-09,Netherlands,NA,Utrecht,1306912,102,0,6120,437
2020-09-10,Netherlands,NA,Utrecht,1306912,45,0,6165,437
2020-09-11,Netherlands,NA,Utrecht,1306912,97,0,6262,437
2020-09-12,Netherlands,NA,Utrecht,1306912,110,0,6372,437
2020-09-13,Netherlands,NA,Utrecht,1306912,67,0,6439,437
2020-09-14,Netherlands,NA,Utrecht,1306912,108,0,6547,437
2020-09-15,Netherlands,NA,Utrecht,1306912,112,0,6659,437
2020-09-16,Netherlands,NA,Utrecht,1306912,115,0,6774,437
2020-09-17,Netherlands,NA,Utrecht,1306912,179,0,6953,437
2020-09-18,Netherlands,NA,Utrecht,1306912,163,0,7116,437
2020-09-19,Netherlands,NA,Utrecht,1306912,144,0,7260,437
2020-09-20,Netherlands,NA,Utrecht,1306912,131,0,7391,437
2020-09-21,Netherlands,NA,Utrecht,1306912,183,0,7574,437
2020-09-22,Netherlands,NA,Utrecht,1306912,158,5,7732,442
2020-09-23,Netherlands,NA,Utrecht,1306912,202,0,7934,442
2020-03-15,Netherlands,NA,Zeeland,383032,2,0,12,0
2020-03-16,Netherlands,NA,Zeeland,383032,5,0,17,0
2020-03-17,Netherlands,NA,Zeeland,383032,3,0,20,0
2020-03-18,Netherlands,NA,Zeeland,383032,6,0,26,0
2020-03-19,Netherlands,NA,Zeeland,383032,5,0,31,0
2020-03-20,Netherlands,NA,Zeeland,383032,13,0,44,0
2020-03-21,Netherlands,NA,Zeeland,383032,2,1,46,1
2020-03-22,Netherlands,NA,Zeeland,383032,2,2,48,3
2020-03-23,Netherlands,NA,Zeeland,383032,6,0,54,3
2020-03-24,Netherlands,NA,Zeeland,383032,8,1,62,4
2020-03-25,Netherlands,NA,Zeeland,383032,14,1,76,5
2020-03-26,Netherlands,NA,Zeeland,383032,14,0,90,5
2020-03-27,Netherlands,NA,Zeeland,383032,18,0,108,5
2020-03-28,Netherlands,NA,Zeeland,383032,12,2,120,7
2020-03-29,Netherlands,NA,Zeeland,383032,13,1,133,8
2020-03-30,Netherlands,NA,Zeeland,383032,14,2,147,10
2020-03-31,Netherlands,NA,Zeeland,383032,13,2,160,12
2020-04-01,Netherlands,NA,Zeeland,383032,17,2,177,14
2020-04-02,Netherlands,NA,Zeeland,383032,16,2,193,16
2020-04-03,Netherlands,NA,Zeeland,383032,23,6,216,22
2020-04-04,Netherlands,NA,Zeeland,383032,19,3,235,25
2020-04-05,Netherlands,NA,Zeeland,383032,7,1,242,26
2020-04-06,Netherlands,NA,Zeeland,383032,37,0,279,26
2020-04-07,Netherlands,NA,Zeeland,383032,30,2,309,28
2020-04-08,Netherlands,NA,Zeeland,383032,19,6,328,34
2020-04-09,Netherlands,NA,Zeeland,383032,30,0,358,34
2020-04-10,Netherlands,NA,Zeeland,383032,26,0,384,34
2020-04-11,Netherlands,NA,Zeeland,383032,27,2,411,36
2020-04-12,Netherlands,NA,Zeeland,383032,15,1,426,37
2020-04-13,Netherlands,NA,Zeeland,383032,26,1,452,38
2020-04-14,Netherlands,NA,Zeeland,383032,18,1,470,39
2020-04-15,Netherlands,NA,Zeeland,383032,5,3,475,42
2020-04-16,Netherlands,NA,Zeeland,383032,2,2,477,44
2020-04-17,Netherlands,NA,Zeeland,383032,20,1,497,45
2020-04-18,Netherlands,NA,Zeeland,383032,11,0,508,45
2020-04-19,Netherlands,NA,Zeeland,383032,13,0,521,45
2020-04-20,Netherlands,NA,Zeeland,383032,7,0,528,45
2020-04-21,Netherlands,NA,Zeeland,383032,4,0,532,45
2020-04-22,Netherlands,NA,Zeeland,383032,8,3,540,48
2020-04-23,Netherlands,NA,Zeeland,383032,14,1,554,49
2020-04-24,Netherlands,NA,Zeeland,383032,3,1,557,50
2020-04-25,Netherlands,NA,Zeeland,383032,3,0,560,50
2020-04-26,Netherlands,NA,Zeeland,383032,4,1,564,51
2020-04-27,Netherlands,NA,Zeeland,383032,2,0,566,51
2020-04-28,Netherlands,NA,Zeeland,383032,10,0,576,51
2020-04-29,Netherlands,NA,Zeeland,383032,1,1,577,52
2020-04-30,Netherlands,NA,Zeeland,383032,3,0,580,52
2020-05-01,Netherlands,NA,Zeeland,383032,3,0,583,52
2020-05-02,Netherlands,NA,Zeeland,383032,3,0,586,52
2020-05-03,Netherlands,NA,Zeeland,383032,2,0,588,52
2020-05-04,Netherlands,NA,Zeeland,383032,5,1,593,53
2020-05-05,Netherlands,NA,Zeeland,383032,2,0,595,53
2020-05-06,Netherlands,NA,Zeeland,383032,12,0,607,53
2020-05-07,Netherlands,NA,Zeeland,383032,8,1,615,54
2020-05-08,Netherlands,NA,Zeeland,383032,5,3,620,57
2020-05-09,Netherlands,NA,Zeeland,383032,1,1,621,58
2020-05-10,Netherlands,NA,Zeeland,383032,3,0,624,58
2020-05-11,Netherlands,NA,Zeeland,383032,2,0,626,58
2020-05-12,Netherlands,NA,Zeeland,383032,1,1,627,59
2020-05-13,Netherlands,NA,Zeeland,383032,1,3,628,62
2020-05-14,Netherlands,NA,Zeeland,383032,2,0,630,62
2020-05-15,Netherlands,NA,Zeeland,383032,4,0,634,62
2020-05-16,Netherlands,NA,Zeeland,383032,0,0,634,62
2020-05-17,Netherlands,NA,Zeeland,383032,1,0,635,62
2020-05-18,Netherlands,NA,Zeeland,383032,4,1,639,63
2020-05-19,Netherlands,NA,Zeeland,383032,1,0,640,63
2020-05-20,Netherlands,NA,Zeeland,383032,3,0,643,63
2020-05-21,Netherlands,NA,Zeeland,383032,8,0,651,63
2020-05-22,Netherlands,NA,Zeeland,383032,2,1,653,64
2020-05-23,Netherlands,NA,Zeeland,383032,4,1,657,65
2020-05-24,Netherlands,NA,Zeeland,383032,4,0,661,65
2020-05-25,Netherlands,NA,Zeeland,383032,6,0,667,65
2020-05-26,Netherlands,NA,Zeeland,383032,1,0,668,65
2020-05-27,Netherlands,NA,Zeeland,383032,3,0,671,65
2020-05-28,Netherlands,NA,Zeeland,383032,3,0,674,65
2020-05-29,Netherlands,NA,Zeeland,383032,12,0,686,65
2020-05-30,Netherlands,NA,Zeeland,383032,1,0,687,65
2020-05-31,Netherlands,NA,Zeeland,383032,5,1,692,66
2020-06-01,Netherlands,NA,Zeeland,383032,1,0,693,66
2020-06-02,Netherlands,NA,Zeeland,383032,4,0,697,66
2020-06-03,Netherlands,NA,Zeeland,383032,2,0,699,66
2020-06-04,Netherlands,NA,Zeeland,383032,6,1,705,67
2020-06-05,Netherlands,NA,Zeeland,383032,3,0,708,67
2020-06-06,Netherlands,NA,Zeeland,383032,1,0,709,67
2020-06-07,Netherlands,NA,Zeeland,383032,2,0,711,67
2020-06-08,Netherlands,NA,Zeeland,383032,0,0,711,67
2020-06-09,Netherlands,NA,Zeeland,383032,0,1,711,68
2020-06-10,Netherlands,NA,Zeeland,383032,5,0,716,68
2020-06-11,Netherlands,NA,Zeeland,383032,1,0,717,68
2020-06-12,Netherlands,NA,Zeeland,383032,1,0,718,68
2020-06-13,Netherlands,NA,Zeeland,383032,3,0,721,68
2020-06-14,Netherlands,NA,Zeeland,383032,1,0,722,68
2020-06-15,Netherlands,NA,Zeeland,383032,2,0,724,68
2020-06-16,Netherlands,NA,Zeeland,383032,0,0,724,68
2020-06-17,Netherlands,NA,Zeeland,383032,0,0,724,68
2020-06-18,Netherlands,NA,Zeeland,383032,2,0,726,68
2020-06-19,Netherlands,NA,Zeeland,383032,0,0,726,68
2020-06-20,Netherlands,NA,Zeeland,383032,1,0,727,68
2020-06-21,Netherlands,NA,Zeeland,383032,0,0,727,68
2020-06-22,Netherlands,NA,Zeeland,383032,1,0,728,68
2020-06-23,Netherlands,NA,Zeeland,383032,1,0,729,68
2020-06-24,Netherlands,NA,Zeeland,383032,1,0,730,68
2020-06-25,Netherlands,NA,Zeeland,383032,1,0,731,68
2020-06-26,Netherlands,NA,Zeeland,383032,1,0,732,68
2020-06-27,Netherlands,NA,Zeeland,383032,0,0,732,68
2020-06-28,Netherlands,NA,Zeeland,383032,0,0,732,68
2020-06-29,Netherlands,NA,Zeeland,383032,0,0,732,68
2020-06-30,Netherlands,NA,Zeeland,383032,0,1,732,69
2020-07-01,Netherlands,NA,Zeeland,383032,0,0,732,69
2020-07-02,Netherlands,NA,Zeeland,383032,2,0,734,69
2020-07-03,Netherlands,NA,Zeeland,383032,1,0,735,69
2020-07-04,Netherlands,NA,Zeeland,383032,1,0,736,69
2020-07-05,Netherlands,NA,Zeeland,383032,3,0,739,69
2020-07-06,Netherlands,NA,Zeeland,383032,0,0,739,69
2020-07-07,Netherlands,NA,Zeeland,383032,0,0,739,69
2020-07-08,Netherlands,NA,Zeeland,383032,1,0,740,69
2020-07-09,Netherlands,NA,Zeeland,383032,0,0,740,69
2020-07-10,Netherlands,NA,Zeeland,383032,0,0,740,69
2020-07-11,Netherlands,NA,Zeeland,383032,2,0,742,69
2020-07-12,Netherlands,NA,Zeeland,383032,0,0,742,69
2020-07-13,Netherlands,NA,Zeeland,383032,2,0,744,69
2020-07-14,Netherlands,NA,Zeeland,383032,7,0,751,69
2020-07-15,Netherlands,NA,Zeeland,383032,8,0,759,69
2020-07-16,Netherlands,NA,Zeeland,383032,6,0,765,69
2020-07-17,Netherlands,NA,Zeeland,383032,6,0,771,69
2020-07-18,Netherlands,NA,Zeeland,383032,14,0,785,69
2020-07-19,Netherlands,NA,Zeeland,383032,6,0,791,69
2020-07-20,Netherlands,NA,Zeeland,383032,6,0,797,69
2020-07-21,Netherlands,NA,Zeeland,383032,3,0,800,69
2020-07-22,Netherlands,NA,Zeeland,383032,3,0,803,69
2020-07-23,Netherlands,NA,Zeeland,383032,6,0,809,69
2020-07-24,Netherlands,NA,Zeeland,383032,6,0,815,69
2020-07-25,Netherlands,NA,Zeeland,383032,7,0,822,69
2020-07-26,Netherlands,NA,Zeeland,383032,5,0,827,69
2020-07-27,Netherlands,NA,Zeeland,383032,8,0,835,69
2020-07-28,Netherlands,NA,Zeeland,383032,8,0,843,69
2020-07-29,Netherlands,NA,Zeeland,383032,8,0,851,69
2020-07-30,Netherlands,NA,Zeeland,383032,8,0,859,69
2020-07-31,Netherlands,NA,Zeeland,383032,4,0,863,69
2020-08-01,Netherlands,NA,Zeeland,383032,4,0,867,69
2020-08-02,Netherlands,NA,Zeeland,383032,5,0,872,69
2020-08-03,Netherlands,NA,Zeeland,383032,8,0,880,69
2020-08-04,Netherlands,NA,Zeeland,383032,10,0,890,69
2020-08-05,Netherlands,NA,Zeeland,383032,6,0,896,69
2020-08-06,Netherlands,NA,Zeeland,383032,5,0,901,69
2020-08-07,Netherlands,NA,Zeeland,383032,4,0,905,69
2020-08-08,Netherlands,NA,Zeeland,383032,7,0,912,69
2020-08-09,Netherlands,NA,Zeeland,383032,6,0,918,69
2020-08-10,Netherlands,NA,Zeeland,383032,0,0,918,69
2020-08-11,Netherlands,NA,Zeeland,383032,26,0,944,69
2020-08-12,Netherlands,NA,Zeeland,383032,6,0,950,69
2020-08-13,Netherlands,NA,Zeeland,383032,4,0,954,69
2020-08-14,Netherlands,NA,Zeeland,383032,3,0,957,69
2020-08-15,Netherlands,NA,Zeeland,383032,5,0,962,69
2020-08-16,Netherlands,NA,Zeeland,383032,5,0,967,69
2020-08-17,Netherlands,NA,Zeeland,383032,1,0,968,69
2020-08-18,Netherlands,NA,Zeeland,383032,3,0,971,69
2020-08-19,Netherlands,NA,Zeeland,383032,9,0,980,69
2020-08-20,Netherlands,NA,Zeeland,383032,7,0,987,69
2020-08-21,Netherlands,NA,Zeeland,383032,6,0,993,69
2020-08-22,Netherlands,NA,Zeeland,383032,15,0,1008,69
2020-08-23,Netherlands,NA,Zeeland,383032,9,0,1017,69
2020-08-24,Netherlands,NA,Zeeland,383032,5,0,1022,69
2020-08-25,Netherlands,NA,Zeeland,383032,2,1,1024,70
2020-08-26,Netherlands,NA,Zeeland,383032,1,2,1025,72
2020-08-27,Netherlands,NA,Zeeland,383032,7,0,1032,72
2020-08-28,Netherlands,NA,Zeeland,383032,4,0,1036,72
2020-08-29,Netherlands,NA,Zeeland,383032,12,0,1048,72
2020-08-30,Netherlands,NA,Zeeland,383032,3,0,1051,72
2020-08-31,Netherlands,NA,Zeeland,383032,3,0,1054,72
2020-09-01,Netherlands,NA,Zeeland,383032,0,0,1054,72
2020-09-02,Netherlands,NA,Zeeland,383032,2,0,1056,72
2020-09-03,Netherlands,NA,Zeeland,383032,3,0,1059,72
2020-09-04,Netherlands,NA,Zeeland,383032,6,0,1065,72
2020-09-05,Netherlands,NA,Zeeland,383032,10,0,1075,72
2020-09-06,Netherlands,NA,Zeeland,383032,12,0,1087,72
2020-09-07,Netherlands,NA,Zeeland,383032,3,0,1090,72
2020-09-08,Netherlands,NA,Zeeland,383032,7,0,1097,72
2020-09-09,Netherlands,NA,Zeeland,383032,4,0,1101,72
2020-09-10,Netherlands,NA,Zeeland,383032,0,0,1101,72
2020-09-11,Netherlands,NA,Zeeland,383032,14,0,1115,72
2020-09-12,Netherlands,NA,Zeeland,383032,10,0,1125,72
2020-09-13,Netherlands,NA,Zeeland,383032,10,0,1135,72
2020-09-14,Netherlands,NA,Zeeland,383032,4,0,1139,72
2020-09-15,Netherlands,NA,Zeeland,383032,8,0,1147,72
2020-09-16,Netherlands,NA,Zeeland,383032,8,0,1155,72
2020-09-17,Netherlands,NA,Zeeland,383032,22,0,1177,72
2020-09-18,Netherlands,NA,Zeeland,383032,15,0,1192,72
2020-09-19,Netherlands,NA,Zeeland,383032,18,0,1210,72
2020-09-20,Netherlands,NA,Zeeland,383032,14,0,1224,72
2020-09-21,Netherlands,NA,Zeeland,383032,22,0,1246,72
2020-09-22,Netherlands,NA,Zeeland,383032,6,0,1252,72
2020-09-23,Netherlands,NA,Zeeland,383032,18,0,1270,72
2020-04-08,Peru,NA,Amazonas,379384,5,0,14,0
2020-04-09,Peru,NA,Amazonas,379384,5,0,19,0
2020-04-12,Peru,NA,Amazonas,379384,8,0,27,0
2020-04-14,Peru,NA,Amazonas,379384,8,0,35,0
2020-04-15,Peru,NA,Amazonas,379384,11,0,46,0
2020-04-16,Peru,NA,Amazonas,379384,3,0,49,0
2020-04-17,Peru,NA,Amazonas,379384,1,0,50,0
2020-04-18,Peru,NA,Amazonas,379384,3,0,53,0
2020-04-19,Peru,NA,Amazonas,379384,1,0,54,0
2020-04-20,Peru,NA,Amazonas,379384,3,0,57,0
2020-04-21,Peru,NA,Amazonas,379384,7,0,64,0
2020-04-22,Peru,NA,Amazonas,379384,2,0,66,0
2020-04-23,Peru,NA,Amazonas,379384,2,0,68,0
2020-04-24,Peru,NA,Amazonas,379384,6,0,74,0
2020-04-25,Peru,NA,Amazonas,379384,9,0,83,0
2020-04-26,Peru,NA,Amazonas,379384,8,0,91,0
2020-04-27,Peru,NA,Amazonas,379384,14,0,105,0
2020-04-28,Peru,NA,Amazonas,379384,9,0,114,0
2020-04-29,Peru,NA,Amazonas,379384,14,0,128,0
2020-04-30,Peru,NA,Amazonas,379384,37,0,165,0
2020-05-01,Peru,NA,Amazonas,379384,85,1,250,1
2020-05-02,Peru,NA,Amazonas,379384,50,0,300,1
2020-05-03,Peru,NA,Amazonas,379384,2,1,302,2
2020-05-04,Peru,NA,Amazonas,379384,26,1,328,3
2020-05-05,Peru,NA,Amazonas,379384,12,2,340,5
2020-05-06,Peru,NA,Amazonas,379384,11,2,351,7
2020-05-07,Peru,NA,Amazonas,379384,9,0,360,7
2020-05-08,Peru,NA,Amazonas,379384,20,0,380,7
2020-05-09,Peru,NA,Amazonas,379384,4,1,384,8
2020-05-10,Peru,NA,Amazonas,379384,0,3,384,11
2020-05-11,Peru,NA,Amazonas,379384,12,1,396,12
2020-05-12,Peru,NA,Amazonas,379384,11,0,407,12
2020-05-13,Peru,NA,Amazonas,379384,8,2,415,14
2020-05-14,Peru,NA,Amazonas,379384,3,1,418,15
2020-05-15,Peru,NA,Amazonas,379384,23,1,441,16
2020-05-16,Peru,NA,Amazonas,379384,32,2,473,18
2020-05-17,Peru,NA,Amazonas,379384,1,1,474,19
2020-05-18,Peru,NA,Amazonas,379384,20,1,494,20
2020-05-19,Peru,NA,Amazonas,379384,30,1,524,21
2020-05-20,Peru,NA,Amazonas,379384,12,1,536,22
2020-05-21,Peru,NA,Amazonas,379384,54,1,590,23
2020-05-22,Peru,NA,Amazonas,379384,25,0,615,23
2020-05-23,Peru,NA,Amazonas,379384,8,0,623,23
2020-05-24,Peru,NA,Amazonas,379384,5,0,628,23
2020-05-25,Peru,NA,Amazonas,379384,50,0,678,23
2020-05-26,Peru,NA,Amazonas,379384,22,0,700,23
2020-05-27,Peru,NA,Amazonas,379384,19,1,719,24
2020-05-28,Peru,NA,Amazonas,379384,25,2,744,26
2020-05-29,Peru,NA,Amazonas,379384,13,0,757,26
2020-05-30,Peru,NA,Amazonas,379384,13,0,770,26
2020-05-31,Peru,NA,Amazonas,379384,12,0,782,26
2020-06-01,Peru,NA,Amazonas,379384,14,2,796,28
2020-06-02,Peru,NA,Amazonas,379384,14,2,810,30
2020-06-03,Peru,NA,Amazonas,379384,35,6,845,36
2020-06-04,Peru,NA,Amazonas,379384,36,4,881,40
2020-06-05,Peru,NA,Amazonas,379384,49,0,930,40
2020-06-06,Peru,NA,Amazonas,379384,37,1,967,41
2020-06-07,Peru,NA,Amazonas,379384,12,0,979,41
2020-06-08,Peru,NA,Amazonas,379384,58,2,1037,43
2020-06-09,Peru,NA,Amazonas,379384,75,2,1112,45
2020-06-10,Peru,NA,Amazonas,379384,60,0,1172,45
2020-06-11,Peru,NA,Amazonas,379384,44,1,1216,46
2020-06-12,Peru,NA,Amazonas,379384,71,3,1287,49
2020-06-13,Peru,NA,Amazonas,379384,67,1,1354,50
2020-06-14,Peru,NA,Amazonas,379384,16,1,1370,51
2020-06-15,Peru,NA,Amazonas,379384,199,4,1569,55
2020-06-16,Peru,NA,Amazonas,379384,58,3,1627,58
2020-06-17,Peru,NA,Amazonas,379384,62,3,1689,61
2020-06-18,Peru,NA,Amazonas,379384,35,3,1724,64
2020-06-19,Peru,NA,Amazonas,379384,79,1,1803,65
2020-06-20,Peru,NA,Amazonas,379384,46,2,1849,67
2020-06-21,Peru,NA,Amazonas,379384,13,5,1862,72
2020-06-22,Peru,NA,Amazonas,379384,46,1,1908,73
2020-06-23,Peru,NA,Amazonas,379384,45,0,1953,73
2020-06-24,Peru,NA,Amazonas,379384,174,4,2127,77
2020-06-25,Peru,NA,Amazonas,379384,59,3,2186,80
2020-06-26,Peru,NA,Amazonas,379384,52,6,2238,86
2020-06-27,Peru,NA,Amazonas,379384,55,5,2293,91
2020-06-28,Peru,NA,Amazonas,379384,28,5,2321,96
2020-06-29,Peru,NA,Amazonas,379384,29,6,2350,102
2020-06-30,Peru,NA,Amazonas,379384,101,3,2451,105
2020-07-01,Peru,NA,Amazonas,379384,72,2,2523,107
2020-07-02,Peru,NA,Amazonas,379384,72,2,2595,109
2020-07-03,Peru,NA,Amazonas,379384,206,3,2801,112
2020-07-04,Peru,NA,Amazonas,379384,84,3,2885,115
2020-07-05,Peru,NA,Amazonas,379384,23,3,2908,118
2020-07-06,Peru,NA,Amazonas,379384,145,5,3053,123
2020-07-07,Peru,NA,Amazonas,379384,121,1,3174,124
2020-07-08,Peru,NA,Amazonas,379384,121,0,3295,124
2020-07-09,Peru,NA,Amazonas,379384,68,2,3363,126
2020-07-10,Peru,NA,Amazonas,379384,78,6,3441,132
2020-07-11,Peru,NA,Amazonas,379384,92,3,3533,135
2020-07-12,Peru,NA,Amazonas,379384,90,1,3623,136
2020-07-13,Peru,NA,Amazonas,379384,85,3,3708,139
2020-07-14,Peru,NA,Amazonas,379384,119,1,3827,140
2020-07-15,Peru,NA,Amazonas,379384,85,4,3912,144
2020-07-16,Peru,NA,Amazonas,379384,116,0,4028,144
2020-07-17,Peru,NA,Amazonas,379384,332,0,4360,144
2020-07-18,Peru,NA,Amazonas,379384,156,2,4516,146
2020-07-19,Peru,NA,Amazonas,379384,48,4,4564,150
2020-07-20,Peru,NA,Amazonas,379384,147,2,4711,152
2020-07-21,Peru,NA,Amazonas,379384,117,1,4828,153
2020-07-22,Peru,NA,Amazonas,379384,168,3,4996,156
2020-07-23,Peru,NA,Amazonas,379384,216,2,5212,158
2020-07-24,Peru,NA,Amazonas,379384,324,2,5536,160
2020-07-25,Peru,NA,Amazonas,379384,215,4,5751,164
2020-07-26,Peru,NA,Amazonas,379384,49,2,5800,166
2020-07-27,Peru,NA,Amazonas,379384,190,1,5990,167
2020-07-28,Peru,NA,Amazonas,379384,63,0,6053,167
2020-07-29,Peru,NA,Amazonas,379384,146,1,6199,168
2020-07-30,Peru,NA,Amazonas,379384,138,1,6337,169
2020-07-31,Peru,NA,Amazonas,379384,171,2,6508,171
2020-08-01,Peru,NA,Amazonas,379384,250,1,6758,172
2020-08-02,Peru,NA,Amazonas,379384,46,1,6804,173
2020-08-03,Peru,NA,Amazonas,379384,151,1,6955,174
2020-08-04,Peru,NA,Amazonas,379384,191,1,7146,175
2020-08-05,Peru,NA,Amazonas,379384,150,0,7296,175
2020-08-06,Peru,NA,Amazonas,379384,227,0,7523,175
2020-08-07,Peru,NA,Amazonas,379384,161,2,7684,177
2020-08-08,Peru,NA,Amazonas,379384,140,0,7824,177
2020-08-09,Peru,NA,Amazonas,379384,13,3,7837,180
2020-08-10,Peru,NA,Amazonas,379384,228,4,8065,184
2020-08-11,Peru,NA,Amazonas,379384,183,1,8248,185
2020-08-12,Peru,NA,Amazonas,379384,180,0,8428,185
2020-08-13,Peru,NA,Amazonas,379384,265,1,8693,186
2020-08-14,Peru,NA,Amazonas,379384,250,0,8943,186
2020-08-15,Peru,NA,Amazonas,379384,91,0,9034,186
2020-08-16,Peru,NA,Amazonas,379384,40,0,9074,186
2020-08-17,Peru,NA,Amazonas,379384,191,0,9265,186
2020-08-18,Peru,NA,Amazonas,379384,148,0,9413,186
2020-08-19,Peru,NA,Amazonas,379384,228,0,9641,186
2020-08-20,Peru,NA,Amazonas,379384,250,0,9891,186
2020-08-21,Peru,NA,Amazonas,379384,200,2,10091,188
2020-08-22,Peru,NA,Amazonas,379384,165,0,10256,188
2020-08-23,Peru,NA,Amazonas,379384,39,0,10295,188
2020-08-24,Peru,NA,Amazonas,379384,174,2,10469,190
2020-08-25,Peru,NA,Amazonas,379384,314,0,10783,190
2020-08-26,Peru,NA,Amazonas,379384,188,0,10971,190
2020-08-27,Peru,NA,Amazonas,379384,204,0,11175,190
2020-08-28,Peru,NA,Amazonas,379384,104,0,11279,190
2020-08-29,Peru,NA,Amazonas,379384,107,0,11386,190
2020-08-30,Peru,NA,Amazonas,379384,18,1,11404,191
2020-08-31,Peru,NA,Amazonas,379384,97,0,11501,191
2020-09-01,Peru,NA,Amazonas,379384,95,1,11596,192
2020-09-02,Peru,NA,Amazonas,379384,74,0,11670,192
2020-09-03,Peru,NA,Amazonas,379384,45,0,11715,192
2020-09-04,Peru,NA,Amazonas,379384,248,0,11963,192
2020-09-05,Peru,NA,Amazonas,379384,29,2,11992,194
2020-09-06,Peru,NA,Amazonas,379384,31,3,12023,197
2020-09-07,Peru,NA,Amazonas,379384,104,2,12127,199
2020-09-08,Peru,NA,Amazonas,379384,169,1,12296,200
2020-09-09,Peru,NA,Amazonas,379384,120,2,12416,202
2020-09-10,Peru,NA,Amazonas,379384,44,0,12460,202
2020-09-11,Peru,NA,Amazonas,379384,153,0,12613,202
2020-09-12,Peru,NA,Amazonas,379384,131,1,12744,203
2020-09-13,Peru,NA,Amazonas,379384,38,0,12782,203
2020-09-14,Peru,NA,Amazonas,379384,118,0,12900,203
2020-09-15,Peru,NA,Amazonas,379384,114,0,13014,203
2020-09-16,Peru,NA,Amazonas,379384,85,1,13099,204
2020-09-17,Peru,NA,Amazonas,379384,134,0,13233,204
2020-09-18,Peru,NA,Amazonas,379384,92,1,13325,205
2020-09-19,Peru,NA,Amazonas,379384,154,2,13479,207
2020-09-20,Peru,NA,Amazonas,379384,84,0,13563,207
2020-09-21,Peru,NA,Amazonas,379384,103,1,13666,208
2020-09-22,Peru,NA,Amazonas,379384,41,0,13707,208
2020-03-29,Peru,NA,Ancash,1083519,5,0,11,1
2020-03-31,Peru,NA,Ancash,1083519,2,0,13,1
2020-04-02,Peru,NA,Ancash,1083519,2,0,15,1
2020-04-04,Peru,NA,Ancash,1083519,9,0,24,1
2020-04-05,Peru,NA,Ancash,1083519,7,1,31,2
2020-04-06,Peru,NA,Ancash,1083519,13,0,44,2
2020-04-07,Peru,NA,Ancash,1083519,26,3,70,5
2020-04-08,Peru,NA,Ancash,1083519,10,2,80,7
2020-04-09,Peru,NA,Ancash,1083519,12,0,92,7
2020-04-10,Peru,NA,Ancash,1083519,16,0,108,7
2020-04-11,Peru,NA,Ancash,1083519,25,0,133,7
2020-04-12,Peru,NA,Ancash,1083519,7,2,140,9
2020-04-13,Peru,NA,Ancash,1083519,19,3,159,12
2020-04-14,Peru,NA,Ancash,1083519,28,3,187,15
2020-04-15,Peru,NA,Ancash,1083519,42,3,229,18
2020-04-16,Peru,NA,Ancash,1083519,37,3,266,21
2020-04-17,Peru,NA,Ancash,1083519,25,1,291,22
2020-04-18,Peru,NA,Ancash,1083519,56,5,347,27
2020-04-19,Peru,NA,Ancash,1083519,10,8,357,35
2020-04-20,Peru,NA,Ancash,1083519,34,4,391,39
2020-04-21,Peru,NA,Ancash,1083519,45,1,436,40
2020-04-22,Peru,NA,Ancash,1083519,30,1,466,41
2020-04-23,Peru,NA,Ancash,1083519,46,8,512,49
2020-04-24,Peru,NA,Ancash,1083519,56,7,568,56
2020-04-25,Peru,NA,Ancash,1083519,56,4,624,60
2020-04-26,Peru,NA,Ancash,1083519,12,5,636,65
2020-04-27,Peru,NA,Ancash,1083519,43,14,679,79
2020-04-28,Peru,NA,Ancash,1083519,98,2,777,81
2020-04-29,Peru,NA,Ancash,1083519,71,4,848,85
2020-04-30,Peru,NA,Ancash,1083519,108,8,956,93
2020-05-01,Peru,NA,Ancash,1083519,66,4,1022,97
2020-05-02,Peru,NA,Ancash,1083519,119,10,1141,107
2020-05-03,Peru,NA,Ancash,1083519,25,7,1166,114
2020-05-04,Peru,NA,Ancash,1083519,108,5,1274,119
2020-05-05,Peru,NA,Ancash,1083519,125,6,1399,125
2020-05-06,Peru,NA,Ancash,1083519,74,16,1473,141
2020-05-07,Peru,NA,Ancash,1083519,78,12,1551,153
2020-05-08,Peru,NA,Ancash,1083519,53,11,1604,164
2020-05-09,Peru,NA,Ancash,1083519,69,11,1673,175
2020-05-10,Peru,NA,Ancash,1083519,11,9,1684,184
2020-05-11,Peru,NA,Ancash,1083519,121,6,1805,190
2020-05-12,Peru,NA,Ancash,1083519,101,10,1906,200
2020-05-13,Peru,NA,Ancash,1083519,152,12,2058,212
2020-05-14,Peru,NA,Ancash,1083519,179,5,2237,217
2020-05-15,Peru,NA,Ancash,1083519,166,5,2403,222
2020-05-16,Peru,NA,Ancash,1083519,103,12,2506,234
2020-05-17,Peru,NA,Ancash,1083519,49,12,2555,246
2020-05-18,Peru,NA,Ancash,1083519,97,12,2652,258
2020-05-19,Peru,NA,Ancash,1083519,281,7,2933,265
2020-05-20,Peru,NA,Ancash,1083519,125,3,3058,268
2020-05-21,Peru,NA,Ancash,1083519,134,10,3192,278
2020-05-22,Peru,NA,Ancash,1083519,181,4,3373,282
2020-05-23,Peru,NA,Ancash,1083519,140,6,3513,288
2020-05-24,Peru,NA,Ancash,1083519,52,14,3565,302
2020-05-25,Peru,NA,Ancash,1083519,179,13,3744,315
2020-05-26,Peru,NA,Ancash,1083519,187,12,3931,327
2020-05-27,Peru,NA,Ancash,1083519,226,14,4157,341
2020-05-28,Peru,NA,Ancash,1083519,242,17,4399,358
2020-05-29,Peru,NA,Ancash,1083519,175,14,4574,372
2020-05-30,Peru,NA,Ancash,1083519,146,11,4720,383
2020-05-31,Peru,NA,Ancash,1083519,34,16,4754,399
2020-06-01,Peru,NA,Ancash,1083519,137,14,4891,413
2020-06-02,Peru,NA,Ancash,1083519,139,18,5030,431
2020-06-03,Peru,NA,Ancash,1083519,119,13,5149,444
2020-06-04,Peru,NA,Ancash,1083519,113,17,5262,461
2020-06-05,Peru,NA,Ancash,1083519,83,11,5345,472
2020-06-06,Peru,NA,Ancash,1083519,112,12,5457,484
2020-06-07,Peru,NA,Ancash,1083519,103,23,5560,507
2020-06-08,Peru,NA,Ancash,1083519,169,15,5729,522
2020-06-09,Peru,NA,Ancash,1083519,127,16,5856,538
2020-06-10,Peru,NA,Ancash,1083519,134,9,5990,547
2020-06-11,Peru,NA,Ancash,1083519,135,10,6125,557
2020-06-12,Peru,NA,Ancash,1083519,120,21,6245,578
2020-06-13,Peru,NA,Ancash,1083519,146,18,6391,596
2020-06-14,Peru,NA,Ancash,1083519,90,10,6481,606
2020-06-15,Peru,NA,Ancash,1083519,113,20,6594,626
2020-06-16,Peru,NA,Ancash,1083519,121,11,6715,637
2020-06-17,Peru,NA,Ancash,1083519,100,7,6815,644
2020-06-18,Peru,NA,Ancash,1083519,127,11,6942,655
2020-06-19,Peru,NA,Ancash,1083519,104,16,7046,671
2020-06-20,Peru,NA,Ancash,1083519,104,12,7150,683
2020-06-21,Peru,NA,Ancash,1083519,59,11,7209,694
2020-06-22,Peru,NA,Ancash,1083519,117,13,7326,707
2020-06-23,Peru,NA,Ancash,1083519,117,9,7443,716
2020-06-24,Peru,NA,Ancash,1083519,127,8,7570,724
2020-06-25,Peru,NA,Ancash,1083519,101,8,7671,732
2020-06-26,Peru,NA,Ancash,1083519,111,14,7782,746
2020-06-27,Peru,NA,Ancash,1083519,78,9,7860,755
2020-06-28,Peru,NA,Ancash,1083519,39,20,7899,775
2020-06-29,Peru,NA,Ancash,1083519,129,13,8028,788
2020-06-30,Peru,NA,Ancash,1083519,132,11,8160,799
2020-07-01,Peru,NA,Ancash,1083519,145,9,8305,808
2020-07-02,Peru,NA,Ancash,1083519,125,8,8430,816
2020-07-03,Peru,NA,Ancash,1083519,136,8,8566,824
2020-07-04,Peru,NA,Ancash,1083519,127,2,8693,826
2020-07-05,Peru,NA,Ancash,1083519,47,7,8740,833
2020-07-06,Peru,NA,Ancash,1083519,170,6,8910,839
2020-07-07,Peru,NA,Ancash,1083519,199,9,9109,848
2020-07-08,Peru,NA,Ancash,1083519,88,5,9197,853
2020-07-09,Peru,NA,Ancash,1083519,50,2,9247,855
2020-07-10,Peru,NA,Ancash,1083519,151,7,9398,862
2020-07-11,Peru,NA,Ancash,1083519,189,8,9587,870
2020-07-12,Peru,NA,Ancash,1083519,103,6,9690,876
2020-07-13,Peru,NA,Ancash,1083519,55,6,9745,882
2020-07-14,Peru,NA,Ancash,1083519,148,4,9893,886
2020-07-15,Peru,NA,Ancash,1083519,94,10,9987,896
2020-07-16,Peru,NA,Ancash,1083519,130,7,10117,903
2020-07-17,Peru,NA,Ancash,1083519,97,9,10214,912
2020-07-18,Peru,NA,Ancash,1083519,154,9,10368,921
2020-07-19,Peru,NA,Ancash,1083519,67,10,10435,931
2020-07-20,Peru,NA,Ancash,1083519,130,3,10565,934
2020-07-21,Peru,NA,Ancash,1083519,95,5,10660,939
2020-07-22,Peru,NA,Ancash,1083519,144,7,10804,946
2020-07-23,Peru,NA,Ancash,1083519,239,6,11043,952
2020-07-24,Peru,NA,Ancash,1083519,166,11,11209,963
2020-07-25,Peru,NA,Ancash,1083519,201,8,11410,971
2020-07-26,Peru,NA,Ancash,1083519,51,3,11461,974
2020-07-27,Peru,NA,Ancash,1083519,256,3,11717,977
2020-07-28,Peru,NA,Ancash,1083519,83,5,11800,982
2020-07-29,Peru,NA,Ancash,1083519,198,7,11998,989
2020-07-30,Peru,NA,Ancash,1083519,205,7,12203,996
2020-07-31,Peru,NA,Ancash,1083519,243,2,12446,998
2020-08-01,Peru,NA,Ancash,1083519,198,5,12644,1003
2020-08-02,Peru,NA,Ancash,1083519,89,6,12733,1009
2020-08-03,Peru,NA,Ancash,1083519,242,4,12975,1013
2020-08-04,Peru,NA,Ancash,1083519,262,12,13237,1025
2020-08-05,Peru,NA,Ancash,1083519,250,10,13487,1035
2020-08-06,Peru,NA,Ancash,1083519,203,4,13690,1039
2020-08-07,Peru,NA,Ancash,1083519,180,5,13870,1044
2020-08-08,Peru,NA,Ancash,1083519,241,5,14111,1049
2020-08-09,Peru,NA,Ancash,1083519,89,4,14200,1053
2020-08-10,Peru,NA,Ancash,1083519,240,5,14440,1058
2020-08-11,Peru,NA,Ancash,1083519,227,6,14667,1064
2020-08-12,Peru,NA,Ancash,1083519,191,4,14858,1068
2020-08-13,Peru,NA,Ancash,1083519,208,7,15066,1075
2020-08-14,Peru,NA,Ancash,1083519,253,10,15319,1085
2020-08-15,Peru,NA,Ancash,1083519,265,7,15584,1092
2020-08-16,Peru,NA,Ancash,1083519,54,6,15638,1098
2020-08-17,Peru,NA,Ancash,1083519,270,11,15908,1109
2020-08-18,Peru,NA,Ancash,1083519,203,4,16111,1113
2020-08-19,Peru,NA,Ancash,1083519,245,3,16356,1116
2020-08-20,Peru,NA,Ancash,1083519,228,4,16584,1120
2020-08-21,Peru,NA,Ancash,1083519,240,4,16824,1124
2020-08-22,Peru,NA,Ancash,1083519,174,4,16998,1128
2020-08-23,Peru,NA,Ancash,1083519,55,6,17053,1134
2020-08-24,Peru,NA,Ancash,1083519,228,4,17281,1138
2020-08-25,Peru,NA,Ancash,1083519,290,3,17571,1141
2020-08-26,Peru,NA,Ancash,1083519,329,7,17900,1148
2020-08-27,Peru,NA,Ancash,1083519,158,4,18058,1152
2020-08-28,Peru,NA,Ancash,1083519,324,4,18382,1156
2020-08-29,Peru,NA,Ancash,1083519,157,11,18539,1167
2020-08-30,Peru,NA,Ancash,1083519,59,3,18598,1170
2020-08-31,Peru,NA,Ancash,1083519,191,1,18789,1171
2020-09-01,Peru,NA,Ancash,1083519,182,4,18971,1175
2020-09-02,Peru,NA,Ancash,1083519,145,3,19116,1178
2020-09-03,Peru,NA,Ancash,1083519,61,5,19177,1183
2020-09-04,Peru,NA,Ancash,1083519,232,6,19409,1189
2020-09-05,Peru,NA,Ancash,1083519,131,8,19540,1197
2020-09-06,Peru,NA,Ancash,1083519,65,7,19605,1204
2020-09-07,Peru,NA,Ancash,1083519,124,6,19729,1210
2020-09-08,Peru,NA,Ancash,1083519,114,4,19843,1214
2020-09-09,Peru,NA,Ancash,1083519,184,3,20027,1217
2020-09-10,Peru,NA,Ancash,1083519,123,5,20150,1222
2020-09-11,Peru,NA,Ancash,1083519,222,5,20372,1227
2020-09-12,Peru,NA,Ancash,1083519,313,2,20685,1229
2020-09-13,Peru,NA,Ancash,1083519,61,3,20746,1232
2020-09-14,Peru,NA,Ancash,1083519,184,4,20930,1236
2020-09-15,Peru,NA,Ancash,1083519,137,3,21067,1239
2020-09-16,Peru,NA,Ancash,1083519,239,1,21306,1240
2020-09-17,Peru,NA,Ancash,1083519,131,8,21437,1248
2020-09-18,Peru,NA,Ancash,1083519,135,8,21572,1256
2020-09-19,Peru,NA,Ancash,1083519,118,8,21690,1264
2020-09-20,Peru,NA,Ancash,1083519,34,4,21724,1268
2020-09-21,Peru,NA,Ancash,1083519,145,2,21869,1270
2020-09-22,Peru,NA,Ancash,1083519,69,5,21938,1275
2020-04-13,Peru,NA,Apurimac,405759,7,0,13,0
2020-04-14,Peru,NA,Apurimac,405759,10,0,23,0
2020-04-15,Peru,NA,Apurimac,405759,4,0,27,0
2020-04-16,Peru,NA,Apurimac,405759,4,0,31,0
2020-04-17,Peru,NA,Apurimac,405759,6,0,37,0
2020-04-18,Peru,NA,Apurimac,405759,5,0,42,0
2020-04-20,Peru,NA,Apurimac,405759,1,0,43,0
2020-04-21,Peru,NA,Apurimac,405759,8,0,51,0
2020-04-22,Peru,NA,Apurimac,405759,4,0,55,0
2020-04-23,Peru,NA,Apurimac,405759,5,0,60,0
2020-04-24,Peru,NA,Apurimac,405759,2,0,62,0
2020-04-25,Peru,NA,Apurimac,405759,19,0,81,0
2020-04-26,Peru,NA,Apurimac,405759,5,0,86,0
2020-04-27,Peru,NA,Apurimac,405759,12,0,98,0
2020-04-28,Peru,NA,Apurimac,405759,10,0,108,0
2020-04-29,Peru,NA,Apurimac,405759,13,0,121,0
2020-04-30,Peru,NA,Apurimac,405759,35,0,156,0
2020-05-02,Peru,NA,Apurimac,405759,5,0,161,0
2020-05-04,Peru,NA,Apurimac,405759,6,0,167,0
2020-05-05,Peru,NA,Apurimac,405759,3,0,170,0
2020-05-06,Peru,NA,Apurimac,405759,1,0,171,0
2020-05-09,Peru,NA,Apurimac,405759,1,0,172,0
2020-05-11,Peru,NA,Apurimac,405759,3,0,175,0
2020-05-12,Peru,NA,Apurimac,405759,5,0,180,0
2020-05-13,Peru,NA,Apurimac,405759,2,0,182,0
2020-05-14,Peru,NA,Apurimac,405759,2,0,184,0
2020-05-15,Peru,NA,Apurimac,405759,3,0,187,0
2020-05-17,Peru,NA,Apurimac,405759,2,0,189,0
2020-05-18,Peru,NA,Apurimac,405759,4,0,193,0
2020-05-19,Peru,NA,Apurimac,405759,3,0,196,0
2020-05-21,Peru,NA,Apurimac,405759,5,0,201,0
2020-05-22,Peru,NA,Apurimac,405759,14,0,215,0
2020-05-23,Peru,NA,Apurimac,405759,9,0,224,0
2020-05-24,Peru,NA,Apurimac,405759,0,1,224,1
2020-05-25,Peru,NA,Apurimac,405759,22,0,246,1
2020-05-26,Peru,NA,Apurimac,405759,2,0,248,1
2020-05-27,Peru,NA,Apurimac,405759,8,0,256,1
2020-05-28,Peru,NA,Apurimac,405759,9,1,265,2
2020-05-29,Peru,NA,Apurimac,405759,9,2,274,4
2020-05-30,Peru,NA,Apurimac,405759,9,0,283,4
2020-05-31,Peru,NA,Apurimac,405759,3,0,286,4
2020-06-01,Peru,NA,Apurimac,405759,6,0,292,4
2020-06-02,Peru,NA,Apurimac,405759,13,0,305,4
2020-06-03,Peru,NA,Apurimac,405759,11,0,316,4
2020-06-04,Peru,NA,Apurimac,405759,18,1,334,5
2020-06-05,Peru,NA,Apurimac,405759,12,0,346,5
2020-06-06,Peru,NA,Apurimac,405759,13,0,359,5
2020-06-07,Peru,NA,Apurimac,405759,5,1,364,6
2020-06-08,Peru,NA,Apurimac,405759,10,2,374,8
2020-06-09,Peru,NA,Apurimac,405759,14,0,388,8
2020-06-10,Peru,NA,Apurimac,405759,5,0,393,8
2020-06-11,Peru,NA,Apurimac,405759,13,0,406,8
2020-06-12,Peru,NA,Apurimac,405759,13,0,419,8
2020-06-13,Peru,NA,Apurimac,405759,3,1,422,9
2020-06-14,Peru,NA,Apurimac,405759,1,1,423,10
2020-06-15,Peru,NA,Apurimac,405759,4,0,427,10
2020-06-16,Peru,NA,Apurimac,405759,1,1,428,11
2020-06-17,Peru,NA,Apurimac,405759,8,0,436,11
2020-06-18,Peru,NA,Apurimac,405759,6,1,442,12
2020-06-19,Peru,NA,Apurimac,405759,4,0,446,12
2020-06-20,Peru,NA,Apurimac,405759,26,1,472,13
2020-06-21,Peru,NA,Apurimac,405759,25,2,497,15
2020-06-22,Peru,NA,Apurimac,405759,6,0,503,15
2020-06-23,Peru,NA,Apurimac,405759,11,0,514,15
2020-06-24,Peru,NA,Apurimac,405759,5,1,519,16
2020-06-25,Peru,NA,Apurimac,405759,8,0,527,16
2020-06-26,Peru,NA,Apurimac,405759,18,1,545,17
2020-06-27,Peru,NA,Apurimac,405759,11,0,556,17
2020-06-28,Peru,NA,Apurimac,405759,0,2,556,19
2020-06-29,Peru,NA,Apurimac,405759,4,1,560,20
2020-06-30,Peru,NA,Apurimac,405759,8,0,568,20
2020-07-01,Peru,NA,Apurimac,405759,6,0,574,20
2020-07-02,Peru,NA,Apurimac,405759,9,1,583,21
2020-07-03,Peru,NA,Apurimac,405759,8,0,591,21
2020-07-04,Peru,NA,Apurimac,405759,5,0,596,21
2020-07-05,Peru,NA,Apurimac,405759,3,0,599,21
2020-07-06,Peru,NA,Apurimac,405759,6,1,605,22
2020-07-07,Peru,NA,Apurimac,405759,11,0,616,22
2020-07-08,Peru,NA,Apurimac,405759,2,1,618,23
2020-07-09,Peru,NA,Apurimac,405759,3,0,621,23
2020-07-10,Peru,NA,Apurimac,405759,14,1,635,24
2020-07-11,Peru,NA,Apurimac,405759,28,0,663,24
2020-07-12,Peru,NA,Apurimac,405759,1,0,664,24
2020-07-13,Peru,NA,Apurimac,405759,1,0,665,24
2020-07-14,Peru,NA,Apurimac,405759,6,0,671,24
2020-07-15,Peru,NA,Apurimac,405759,11,2,682,26
2020-07-16,Peru,NA,Apurimac,405759,12,0,694,26
2020-07-17,Peru,NA,Apurimac,405759,13,0,707,26
2020-07-18,Peru,NA,Apurimac,405759,19,2,726,28
2020-07-19,Peru,NA,Apurimac,405759,2,0,728,28
2020-07-20,Peru,NA,Apurimac,405759,11,1,739,29
2020-07-21,Peru,NA,Apurimac,405759,17,1,756,30
2020-07-22,Peru,NA,Apurimac,405759,14,2,770,32
2020-07-23,Peru,NA,Apurimac,405759,14,0,784,32
2020-07-24,Peru,NA,Apurimac,405759,20,1,804,33
2020-07-25,Peru,NA,Apurimac,405759,16,3,820,36
2020-07-26,Peru,NA,Apurimac,405759,11,1,831,37
2020-07-27,Peru,NA,Apurimac,405759,20,0,851,37
2020-07-28,Peru,NA,Apurimac,405759,14,1,865,38
2020-07-29,Peru,NA,Apurimac,405759,25,1,890,39
2020-07-30,Peru,NA,Apurimac,405759,40,1,930,40
2020-07-31,Peru,NA,Apurimac,405759,49,1,979,41
2020-08-01,Peru,NA,Apurimac,405759,22,0,1001,41
2020-08-02,Peru,NA,Apurimac,405759,11,0,1012,41
2020-08-03,Peru,NA,Apurimac,405759,58,0,1070,41
2020-08-04,Peru,NA,Apurimac,405759,43,1,1113,42
2020-08-05,Peru,NA,Apurimac,405759,73,0,1186,42
2020-08-06,Peru,NA,Apurimac,405759,65,0,1251,42
2020-08-07,Peru,NA,Apurimac,405759,49,1,1300,43
2020-08-08,Peru,NA,Apurimac,405759,52,4,1352,47
2020-08-09,Peru,NA,Apurimac,405759,20,0,1372,47
2020-08-10,Peru,NA,Apurimac,405759,91,1,1463,48
2020-08-11,Peru,NA,Apurimac,405759,90,0,1553,48
2020-08-12,Peru,NA,Apurimac,405759,83,2,1636,50
2020-08-13,Peru,NA,Apurimac,405759,62,1,1698,51
2020-08-14,Peru,NA,Apurimac,405759,97,2,1795,53
2020-08-15,Peru,NA,Apurimac,405759,47,0,1842,53
2020-08-16,Peru,NA,Apurimac,405759,11,2,1853,55
2020-08-17,Peru,NA,Apurimac,405759,106,0,1959,55
2020-08-18,Peru,NA,Apurimac,405759,65,0,2024,55
2020-08-19,Peru,NA,Apurimac,405759,58,1,2082,56
2020-08-20,Peru,NA,Apurimac,405759,81,1,2163,57
2020-08-21,Peru,NA,Apurimac,405759,83,1,2246,58
2020-08-22,Peru,NA,Apurimac,405759,85,0,2331,58
2020-08-23,Peru,NA,Apurimac,405759,9,2,2340,60
2020-08-24,Peru,NA,Apurimac,405759,89,0,2429,60
2020-08-25,Peru,NA,Apurimac,405759,126,0,2555,60
2020-08-26,Peru,NA,Apurimac,405759,106,1,2661,61
2020-08-27,Peru,NA,Apurimac,405759,67,1,2728,62
2020-08-28,Peru,NA,Apurimac,405759,97,1,2825,63
2020-08-29,Peru,NA,Apurimac,405759,60,1,2885,64
2020-08-30,Peru,NA,Apurimac,405759,17,1,2902,65
2020-08-31,Peru,NA,Apurimac,405759,103,0,3005,65
2020-09-01,Peru,NA,Apurimac,405759,56,2,3061,67
2020-09-02,Peru,NA,Apurimac,405759,57,0,3118,67
2020-09-03,Peru,NA,Apurimac,405759,29,2,3147,69
2020-09-04,Peru,NA,Apurimac,405759,218,0,3365,69
2020-09-05,Peru,NA,Apurimac,405759,30,0,3395,69
2020-09-06,Peru,NA,Apurimac,405759,25,2,3420,71
2020-09-07,Peru,NA,Apurimac,405759,120,3,3540,74
2020-09-08,Peru,NA,Apurimac,405759,127,1,3667,75
2020-09-09,Peru,NA,Apurimac,405759,153,0,3820,75
2020-09-10,Peru,NA,Apurimac,405759,19,1,3839,76
2020-09-11,Peru,NA,Apurimac,405759,116,1,3955,77
2020-09-12,Peru,NA,Apurimac,405759,45,0,4000,77
2020-09-13,Peru,NA,Apurimac,405759,30,1,4030,78
2020-09-14,Peru,NA,Apurimac,405759,56,1,4086,79
2020-09-15,Peru,NA,Apurimac,405759,52,0,4138,79
2020-09-16,Peru,NA,Apurimac,405759,61,0,4199,79
2020-09-17,Peru,NA,Apurimac,405759,85,0,4284,79
2020-09-18,Peru,NA,Apurimac,405759,75,0,4359,79
2020-09-19,Peru,NA,Apurimac,405759,33,2,4392,81
2020-09-20,Peru,NA,Apurimac,405759,4,3,4396,84
2020-09-21,Peru,NA,Apurimac,405759,50,2,4446,86
2020-09-22,Peru,NA,Apurimac,405759,46,1,4492,87
2020-03-25,Peru,NA,Arequipa,1382730,5,0,15,0
2020-03-29,Peru,NA,Arequipa,1382730,6,1,21,1
2020-03-30,Peru,NA,Arequipa,1382730,5,0,26,1
2020-03-31,Peru,NA,Arequipa,1382730,4,1,30,2
2020-04-02,Peru,NA,Arequipa,1382730,7,0,37,2
2020-04-04,Peru,NA,Arequipa,1382730,14,4,51,6
2020-04-05,Peru,NA,Arequipa,1382730,9,0,60,6
2020-04-06,Peru,NA,Arequipa,1382730,7,0,67,6
2020-04-07,Peru,NA,Arequipa,1382730,4,0,71,6
2020-04-08,Peru,NA,Arequipa,1382730,5,0,76,6
2020-04-09,Peru,NA,Arequipa,1382730,6,0,82,6
2020-04-10,Peru,NA,Arequipa,1382730,2,0,84,6
2020-04-11,Peru,NA,Arequipa,1382730,12,0,96,6
2020-04-12,Peru,NA,Arequipa,1382730,15,1,111,7
2020-04-13,Peru,NA,Arequipa,1382730,12,2,123,9
2020-04-14,Peru,NA,Arequipa,1382730,13,0,136,9
2020-04-15,Peru,NA,Arequipa,1382730,27,1,163,10
2020-04-16,Peru,NA,Arequipa,1382730,41,1,204,11
2020-04-17,Peru,NA,Arequipa,1382730,12,0,216,11
2020-04-18,Peru,NA,Arequipa,1382730,33,0,249,11
2020-04-19,Peru,NA,Arequipa,1382730,3,3,252,14
2020-04-20,Peru,NA,Arequipa,1382730,28,1,280,15
2020-04-21,Peru,NA,Arequipa,1382730,28,0,308,15
2020-04-22,Peru,NA,Arequipa,1382730,43,0,351,15
2020-04-23,Peru,NA,Arequipa,1382730,56,1,407,16
2020-04-24,Peru,NA,Arequipa,1382730,66,0,473,16
2020-04-25,Peru,NA,Arequipa,1382730,24,2,497,18
2020-04-26,Peru,NA,Arequipa,1382730,4,0,501,18
2020-04-27,Peru,NA,Arequipa,1382730,76,0,577,18
2020-04-28,Peru,NA,Arequipa,1382730,76,0,653,18
2020-04-29,Peru,NA,Arequipa,1382730,111,0,764,18
2020-04-30,Peru,NA,Arequipa,1382730,69,0,833,18
2020-05-01,Peru,NA,Arequipa,1382730,38,1,871,19
2020-05-02,Peru,NA,Arequipa,1382730,31,1,902,20
2020-05-03,Peru,NA,Arequipa,1382730,7,0,909,20
2020-05-04,Peru,NA,Arequipa,1382730,60,0,969,20
2020-05-05,Peru,NA,Arequipa,1382730,57,0,1026,20
2020-05-06,Peru,NA,Arequipa,1382730,56,0,1082,20
2020-05-07,Peru,NA,Arequipa,1382730,47,3,1129,23
2020-05-08,Peru,NA,Arequipa,1382730,39,0,1168,23
2020-05-09,Peru,NA,Arequipa,1382730,59,0,1227,23
2020-05-10,Peru,NA,Arequipa,1382730,25,1,1252,24
2020-05-11,Peru,NA,Arequipa,1382730,51,1,1303,25
2020-05-12,Peru,NA,Arequipa,1382730,104,0,1407,25
2020-05-13,Peru,NA,Arequipa,1382730,112,0,1519,25
2020-05-14,Peru,NA,Arequipa,1382730,121,0,1640,25
2020-05-15,Peru,NA,Arequipa,1382730,96,0,1736,25
2020-05-16,Peru,NA,Arequipa,1382730,85,1,1821,26
2020-05-17,Peru,NA,Arequipa,1382730,8,0,1829,26
2020-05-18,Peru,NA,Arequipa,1382730,86,4,1915,30
2020-05-19,Peru,NA,Arequipa,1382730,122,2,2037,32
2020-05-20,Peru,NA,Arequipa,1382730,156,1,2193,33
2020-05-21,Peru,NA,Arequipa,1382730,144,1,2337,34
2020-05-22,Peru,NA,Arequipa,1382730,197,2,2534,36
2020-05-23,Peru,NA,Arequipa,1382730,146,4,2680,40
2020-05-24,Peru,NA,Arequipa,1382730,35,2,2715,42
2020-05-25,Peru,NA,Arequipa,1382730,192,0,2907,42
2020-05-26,Peru,NA,Arequipa,1382730,128,1,3035,43
2020-05-27,Peru,NA,Arequipa,1382730,186,3,3221,46
2020-05-28,Peru,NA,Arequipa,1382730,186,2,3407,48
2020-05-29,Peru,NA,Arequipa,1382730,173,6,3580,54
2020-05-30,Peru,NA,Arequipa,1382730,96,5,3676,59
2020-05-31,Peru,NA,Arequipa,1382730,20,5,3696,64
2020-06-01,Peru,NA,Arequipa,1382730,63,1,3759,65
2020-06-02,Peru,NA,Arequipa,1382730,99,1,3858,66
2020-06-03,Peru,NA,Arequipa,1382730,55,5,3913,71
2020-06-04,Peru,NA,Arequipa,1382730,51,3,3964,74
2020-06-05,Peru,NA,Arequipa,1382730,118,1,4082,75
2020-06-06,Peru,NA,Arequipa,1382730,138,0,4220,75
2020-06-07,Peru,NA,Arequipa,1382730,34,5,4254,80
2020-06-08,Peru,NA,Arequipa,1382730,105,6,4359,86
2020-06-09,Peru,NA,Arequipa,1382730,126,10,4485,96
2020-06-10,Peru,NA,Arequipa,1382730,144,4,4629,100
2020-06-11,Peru,NA,Arequipa,1382730,104,10,4733,110
2020-06-12,Peru,NA,Arequipa,1382730,119,11,4852,121
2020-06-13,Peru,NA,Arequipa,1382730,174,3,5026,124
2020-06-14,Peru,NA,Arequipa,1382730,19,6,5045,130
2020-06-15,Peru,NA,Arequipa,1382730,94,6,5139,136
2020-06-16,Peru,NA,Arequipa,1382730,90,13,5229,149
2020-06-17,Peru,NA,Arequipa,1382730,168,11,5397,160
2020-06-18,Peru,NA,Arequipa,1382730,68,9,5465,169
2020-06-19,Peru,NA,Arequipa,1382730,114,5,5579,174
2020-06-20,Peru,NA,Arequipa,1382730,74,7,5653,181
2020-06-21,Peru,NA,Arequipa,1382730,118,13,5771,194
2020-06-22,Peru,NA,Arequipa,1382730,115,9,5886,203
2020-06-23,Peru,NA,Arequipa,1382730,188,15,6074,218
2020-06-24,Peru,NA,Arequipa,1382730,231,6,6305,224
2020-06-25,Peru,NA,Arequipa,1382730,153,3,6458,227
2020-06-26,Peru,NA,Arequipa,1382730,166,13,6624,240
2020-06-27,Peru,NA,Arequipa,1382730,273,5,6897,245
2020-06-28,Peru,NA,Arequipa,1382730,58,15,6955,260
2020-06-29,Peru,NA,Arequipa,1382730,58,8,7013,268
2020-06-30,Peru,NA,Arequipa,1382730,134,11,7147,279
2020-07-01,Peru,NA,Arequipa,1382730,187,16,7334,295
2020-07-02,Peru,NA,Arequipa,1382730,118,10,7452,305
2020-07-03,Peru,NA,Arequipa,1382730,120,12,7572,317
2020-07-04,Peru,NA,Arequipa,1382730,212,7,7784,324
2020-07-05,Peru,NA,Arequipa,1382730,68,14,7852,338
2020-07-06,Peru,NA,Arequipa,1382730,78,10,7930,348
2020-07-07,Peru,NA,Arequipa,1382730,176,10,8106,358
2020-07-08,Peru,NA,Arequipa,1382730,168,13,8274,371
2020-07-09,Peru,NA,Arequipa,1382730,135,12,8409,383
2020-07-10,Peru,NA,Arequipa,1382730,334,22,8743,405
2020-07-11,Peru,NA,Arequipa,1382730,324,16,9067,421
2020-07-12,Peru,NA,Arequipa,1382730,54,21,9121,442
2020-07-13,Peru,NA,Arequipa,1382730,122,22,9243,464
2020-07-14,Peru,NA,Arequipa,1382730,207,25,9450,489
2020-07-15,Peru,NA,Arequipa,1382730,258,21,9708,510
2020-07-16,Peru,NA,Arequipa,1382730,213,13,9921,523
2020-07-17,Peru,NA,Arequipa,1382730,200,26,10121,549
2020-07-18,Peru,NA,Arequipa,1382730,324,21,10445,570
2020-07-19,Peru,NA,Arequipa,1382730,70,15,10515,585
2020-07-20,Peru,NA,Arequipa,1382730,162,15,10677,600
2020-07-21,Peru,NA,Arequipa,1382730,399,16,11076,616
2020-07-22,Peru,NA,Arequipa,1382730,524,27,11600,643
2020-07-23,Peru,NA,Arequipa,1382730,347,21,11947,664
2020-07-24,Peru,NA,Arequipa,1382730,403,15,12350,679
2020-07-25,Peru,NA,Arequipa,1382730,461,18,12811,697
2020-07-26,Peru,NA,Arequipa,1382730,102,14,12913,711
2020-07-27,Peru,NA,Arequipa,1382730,501,15,13414,726
2020-07-28,Peru,NA,Arequipa,1382730,148,7,13562,733
2020-07-29,Peru,NA,Arequipa,1382730,363,8,13925,741
2020-07-30,Peru,NA,Arequipa,1382730,547,15,14472,756
2020-07-31,Peru,NA,Arequipa,1382730,640,14,15112,770
2020-08-01,Peru,NA,Arequipa,1382730,666,21,15778,791
2020-08-02,Peru,NA,Arequipa,1382730,96,16,15874,807
2020-08-03,Peru,NA,Arequipa,1382730,698,14,16572,821
2020-08-04,Peru,NA,Arequipa,1382730,612,25,17184,846
2020-08-05,Peru,NA,Arequipa,1382730,842,9,18026,855
2020-08-06,Peru,NA,Arequipa,1382730,840,27,18866,882
2020-08-07,Peru,NA,Arequipa,1382730,680,13,19546,895
2020-08-08,Peru,NA,Arequipa,1382730,613,11,20159,906
2020-08-09,Peru,NA,Arequipa,1382730,117,19,20276,925
2020-08-10,Peru,NA,Arequipa,1382730,669,16,20945,941
2020-08-11,Peru,NA,Arequipa,1382730,691,10,21636,951
2020-08-12,Peru,NA,Arequipa,1382730,786,10,22422,961
2020-08-13,Peru,NA,Arequipa,1382730,856,12,23278,973
2020-08-14,Peru,NA,Arequipa,1382730,723,11,24001,984
2020-08-15,Peru,NA,Arequipa,1382730,498,8,24499,992
2020-08-16,Peru,NA,Arequipa,1382730,114,13,24613,1005
2020-08-17,Peru,NA,Arequipa,1382730,687,18,25300,1023
2020-08-18,Peru,NA,Arequipa,1382730,622,7,25922,1030
2020-08-19,Peru,NA,Arequipa,1382730,886,9,26808,1039
2020-08-20,Peru,NA,Arequipa,1382730,1388,17,28196,1056
2020-08-21,Peru,NA,Arequipa,1382730,756,12,28952,1068
2020-08-22,Peru,NA,Arequipa,1382730,897,10,29849,1078
2020-08-23,Peru,NA,Arequipa,1382730,51,5,29900,1083
2020-08-24,Peru,NA,Arequipa,1382730,397,12,30297,1095
2020-08-25,Peru,NA,Arequipa,1382730,890,11,31187,1106
2020-08-26,Peru,NA,Arequipa,1382730,554,15,31741,1121
2020-08-27,Peru,NA,Arequipa,1382730,596,11,32337,1132
2020-08-28,Peru,NA,Arequipa,1382730,460,5,32797,1137
2020-08-29,Peru,NA,Arequipa,1382730,435,8,33232,1145
2020-08-30,Peru,NA,Arequipa,1382730,107,14,33339,1159
2020-08-31,Peru,NA,Arequipa,1382730,495,11,33834,1170
2020-09-01,Peru,NA,Arequipa,1382730,395,7,34229,1177
2020-09-02,Peru,NA,Arequipa,1382730,351,9,34580,1186
2020-09-03,Peru,NA,Arequipa,1382730,163,7,34743,1193
2020-09-04,Peru,NA,Arequipa,1382730,580,6,35323,1199
2020-09-05,Peru,NA,Arequipa,1382730,223,6,35546,1205
2020-09-06,Peru,NA,Arequipa,1382730,55,7,35601,1212
2020-09-07,Peru,NA,Arequipa,1382730,345,9,35946,1221
2020-09-08,Peru,NA,Arequipa,1382730,784,5,36730,1226
2020-09-09,Peru,NA,Arequipa,1382730,285,3,37015,1229
2020-09-10,Peru,NA,Arequipa,1382730,116,7,37131,1236
2020-09-11,Peru,NA,Arequipa,1382730,757,9,37888,1245
2020-09-12,Peru,NA,Arequipa,1382730,199,8,38087,1253
2020-09-13,Peru,NA,Arequipa,1382730,64,12,38151,1265
2020-09-14,Peru,NA,Arequipa,1382730,447,9,38598,1274
2020-09-15,Peru,NA,Arequipa,1382730,259,5,38857,1279
2020-09-16,Peru,NA,Arequipa,1382730,241,7,39098,1286
2020-09-17,Peru,NA,Arequipa,1382730,241,11,39339,1297
2020-09-18,Peru,NA,Arequipa,1382730,236,5,39575,1302
2020-09-19,Peru,NA,Arequipa,1382730,174,8,39749,1310
2020-09-20,Peru,NA,Arequipa,1382730,39,4,39788,1314
2020-09-21,Peru,NA,Arequipa,1382730,352,6,40140,1320
2020-09-22,Peru,NA,Arequipa,1382730,54,3,40194,1323
2020-04-10,Peru,NA,Ayacucho,616176,2,0,12,0
2020-04-13,Peru,NA,Ayacucho,616176,5,0,17,0
2020-04-14,Peru,NA,Ayacucho,616176,5,0,22,0
2020-04-15,Peru,NA,Ayacucho,616176,4,0,26,0
2020-04-16,Peru,NA,Ayacucho,616176,1,0,27,0
2020-04-17,Peru,NA,Ayacucho,616176,4,0,31,0
2020-04-19,Peru,NA,Ayacucho,616176,3,0,34,0
2020-04-20,Peru,NA,Ayacucho,616176,3,0,37,0
2020-04-21,Peru,NA,Ayacucho,616176,1,0,38,0
2020-04-22,Peru,NA,Ayacucho,616176,2,0,40,0
2020-04-23,Peru,NA,Ayacucho,616176,2,0,42,0
2020-04-24,Peru,NA,Ayacucho,616176,5,0,47,0
2020-04-25,Peru,NA,Ayacucho,616176,7,0,54,0
2020-04-26,Peru,NA,Ayacucho,616176,13,0,67,0
2020-04-27,Peru,NA,Ayacucho,616176,18,0,85,0
2020-04-28,Peru,NA,Ayacucho,616176,13,0,98,0
2020-04-29,Peru,NA,Ayacucho,616176,32,0,130,0
2020-04-30,Peru,NA,Ayacucho,616176,21,0,151,0
2020-05-01,Peru,NA,Ayacucho,616176,26,0,177,0
2020-05-02,Peru,NA,Ayacucho,616176,20,0,197,0
2020-05-03,Peru,NA,Ayacucho,616176,5,2,202,2
2020-05-04,Peru,NA,Ayacucho,616176,27,2,229,4
2020-05-05,Peru,NA,Ayacucho,616176,18,0,247,4
2020-05-06,Peru,NA,Ayacucho,616176,23,0,270,4
2020-05-07,Peru,NA,Ayacucho,616176,15,1,285,5
2020-05-08,Peru,NA,Ayacucho,616176,25,0,310,5
2020-05-09,Peru,NA,Ayacucho,616176,11,1,321,6
2020-05-10,Peru,NA,Ayacucho,616176,2,0,323,6
2020-05-11,Peru,NA,Ayacucho,616176,15,0,338,6
2020-05-12,Peru,NA,Ayacucho,616176,19,0,357,6
2020-05-13,Peru,NA,Ayacucho,616176,20,0,377,6
2020-05-14,Peru,NA,Ayacucho,616176,13,1,390,7
2020-05-15,Peru,NA,Ayacucho,616176,50,1,440,8
2020-05-16,Peru,NA,Ayacucho,616176,40,1,480,9
2020-05-17,Peru,NA,Ayacucho,616176,9,1,489,10
2020-05-18,Peru,NA,Ayacucho,616176,15,1,504,11
2020-05-19,Peru,NA,Ayacucho,616176,17,2,521,13
2020-05-20,Peru,NA,Ayacucho,616176,17,2,538,15
2020-05-21,Peru,NA,Ayacucho,616176,22,0,560,15
2020-05-22,Peru,NA,Ayacucho,616176,41,0,601,15
2020-05-23,Peru,NA,Ayacucho,616176,36,0,637,15
2020-05-24,Peru,NA,Ayacucho,616176,6,1,643,16
2020-05-25,Peru,NA,Ayacucho,616176,27,1,670,17
2020-05-26,Peru,NA,Ayacucho,616176,24,0,694,17
2020-05-27,Peru,NA,Ayacucho,616176,53,1,747,18
2020-05-28,Peru,NA,Ayacucho,616176,30,0,777,18
2020-05-29,Peru,NA,Ayacucho,616176,17,2,794,20
2020-05-30,Peru,NA,Ayacucho,616176,51,1,845,21
2020-05-31,Peru,NA,Ayacucho,616176,4,2,849,23
2020-06-01,Peru,NA,Ayacucho,616176,33,2,882,25
2020-06-02,Peru,NA,Ayacucho,616176,27,0,909,25
2020-06-03,Peru,NA,Ayacucho,616176,18,1,927,26
2020-06-04,Peru,NA,Ayacucho,616176,40,1,967,27
2020-06-05,Peru,NA,Ayacucho,616176,18,0,985,27
2020-06-06,Peru,NA,Ayacucho,616176,29,0,1014,27
2020-06-07,Peru,NA,Ayacucho,616176,10,0,1024,27
2020-06-08,Peru,NA,Ayacucho,616176,41,1,1065,28
2020-06-09,Peru,NA,Ayacucho,616176,32,3,1097,31
2020-06-10,Peru,NA,Ayacucho,616176,20,4,1117,35
2020-06-11,Peru,NA,Ayacucho,616176,38,0,1155,35
2020-06-12,Peru,NA,Ayacucho,616176,37,2,1192,37
2020-06-13,Peru,NA,Ayacucho,616176,60,3,1252,40
2020-06-14,Peru,NA,Ayacucho,616176,8,2,1260,42
2020-06-15,Peru,NA,Ayacucho,616176,60,1,1320,43
2020-06-16,Peru,NA,Ayacucho,616176,28,2,1348,45
2020-06-17,Peru,NA,Ayacucho,616176,41,2,1389,47
2020-06-18,Peru,NA,Ayacucho,616176,43,2,1432,49
2020-06-19,Peru,NA,Ayacucho,616176,77,1,1509,50
2020-06-20,Peru,NA,Ayacucho,616176,21,1,1530,51
2020-06-21,Peru,NA,Ayacucho,616176,12,6,1542,57
2020-06-22,Peru,NA,Ayacucho,616176,34,1,1576,58
2020-06-23,Peru,NA,Ayacucho,616176,45,1,1621,59
2020-06-24,Peru,NA,Ayacucho,616176,48,1,1669,60
2020-06-25,Peru,NA,Ayacucho,616176,29,1,1698,61
2020-06-26,Peru,NA,Ayacucho,616176,30,3,1728,64
2020-06-27,Peru,NA,Ayacucho,616176,27,2,1755,66
2020-06-28,Peru,NA,Ayacucho,616176,11,3,1766,69
2020-06-29,Peru,NA,Ayacucho,616176,32,2,1798,71
2020-06-30,Peru,NA,Ayacucho,616176,43,2,1841,73
2020-07-01,Peru,NA,Ayacucho,616176,32,1,1873,74
2020-07-02,Peru,NA,Ayacucho,616176,48,1,1921,75
2020-07-03,Peru,NA,Ayacucho,616176,25,3,1946,78
2020-07-04,Peru,NA,Ayacucho,616176,48,2,1994,80
2020-07-05,Peru,NA,Ayacucho,616176,14,2,2008,82
2020-07-06,Peru,NA,Ayacucho,616176,48,3,2056,85
2020-07-07,Peru,NA,Ayacucho,616176,43,4,2099,89
2020-07-08,Peru,NA,Ayacucho,616176,58,1,2157,90
2020-07-09,Peru,NA,Ayacucho,616176,33,3,2190,93
2020-07-10,Peru,NA,Ayacucho,616176,71,1,2261,94
2020-07-11,Peru,NA,Ayacucho,616176,50,5,2311,99
2020-07-12,Peru,NA,Ayacucho,616176,23,7,2334,106
2020-07-13,Peru,NA,Ayacucho,616176,39,2,2373,108
2020-07-14,Peru,NA,Ayacucho,616176,79,5,2452,113
2020-07-15,Peru,NA,Ayacucho,616176,75,4,2527,117
2020-07-16,Peru,NA,Ayacucho,616176,90,8,2617,125
2020-07-17,Peru,NA,Ayacucho,616176,115,1,2732,126
2020-07-18,Peru,NA,Ayacucho,616176,106,4,2838,130
2020-07-19,Peru,NA,Ayacucho,616176,25,4,2863,134
2020-07-20,Peru,NA,Ayacucho,616176,106,5,2969,139
2020-07-21,Peru,NA,Ayacucho,616176,84,6,3053,145
2020-07-22,Peru,NA,Ayacucho,616176,123,5,3176,150
2020-07-23,Peru,NA,Ayacucho,616176,79,8,3255,158
2020-07-24,Peru,NA,Ayacucho,616176,108,8,3363,166
2020-07-25,Peru,NA,Ayacucho,616176,134,3,3497,169
2020-07-26,Peru,NA,Ayacucho,616176,24,7,3521,176
2020-07-27,Peru,NA,Ayacucho,616176,125,8,3646,184
2020-07-28,Peru,NA,Ayacucho,616176,123,1,3769,185
2020-07-29,Peru,NA,Ayacucho,616176,121,4,3890,189
2020-07-30,Peru,NA,Ayacucho,616176,129,7,4019,196
2020-07-31,Peru,NA,Ayacucho,616176,123,5,4142,201
2020-08-01,Peru,NA,Ayacucho,616176,123,4,4265,205
2020-08-02,Peru,NA,Ayacucho,616176,36,4,4301,209
2020-08-03,Peru,NA,Ayacucho,616176,124,6,4425,215
2020-08-04,Peru,NA,Ayacucho,616176,119,6,4544,221
2020-08-05,Peru,NA,Ayacucho,616176,148,2,4692,223
2020-08-06,Peru,NA,Ayacucho,616176,175,1,4867,224
2020-08-07,Peru,NA,Ayacucho,616176,176,2,5043,226
2020-08-08,Peru,NA,Ayacucho,616176,121,2,5164,228
2020-08-09,Peru,NA,Ayacucho,616176,61,0,5225,228
2020-08-10,Peru,NA,Ayacucho,616176,158,0,5383,228
2020-08-11,Peru,NA,Ayacucho,616176,197,0,5580,228
2020-08-12,Peru,NA,Ayacucho,616176,192,1,5772,229
2020-08-13,Peru,NA,Ayacucho,616176,192,0,5964,229
2020-08-14,Peru,NA,Ayacucho,616176,183,2,6147,231
2020-08-15,Peru,NA,Ayacucho,616176,127,2,6274,233
2020-08-16,Peru,NA,Ayacucho,616176,67,1,6341,234
2020-08-17,Peru,NA,Ayacucho,616176,187,1,6528,235
2020-08-18,Peru,NA,Ayacucho,616176,198,5,6726,240
2020-08-19,Peru,NA,Ayacucho,616176,186,1,6912,241
2020-08-20,Peru,NA,Ayacucho,616176,245,3,7157,244
2020-08-21,Peru,NA,Ayacucho,616176,170,1,7327,245
2020-08-22,Peru,NA,Ayacucho,616176,199,4,7526,249
2020-08-23,Peru,NA,Ayacucho,616176,21,0,7547,249
2020-08-24,Peru,NA,Ayacucho,616176,140,2,7687,251
2020-08-25,Peru,NA,Ayacucho,616176,217,2,7904,253
2020-08-26,Peru,NA,Ayacucho,616176,150,3,8054,256
2020-08-27,Peru,NA,Ayacucho,616176,160,0,8214,256
2020-08-28,Peru,NA,Ayacucho,616176,145,1,8359,257
2020-08-29,Peru,NA,Ayacucho,616176,102,2,8461,259
2020-08-30,Peru,NA,Ayacucho,616176,34,1,8495,260
2020-08-31,Peru,NA,Ayacucho,616176,107,1,8602,261
2020-09-01,Peru,NA,Ayacucho,616176,160,4,8762,265
2020-09-02,Peru,NA,Ayacucho,616176,110,2,8872,267
2020-09-03,Peru,NA,Ayacucho,616176,80,4,8952,271
2020-09-04,Peru,NA,Ayacucho,616176,256,2,9208,273
2020-09-05,Peru,NA,Ayacucho,616176,61,3,9269,276
2020-09-06,Peru,NA,Ayacucho,616176,23,1,9292,277
2020-09-07,Peru,NA,Ayacucho,616176,166,2,9458,279
2020-09-08,Peru,NA,Ayacucho,616176,145,0,9603,279
2020-09-09,Peru,NA,Ayacucho,616176,156,2,9759,281
2020-09-10,Peru,NA,Ayacucho,616176,67,1,9826,282
2020-09-11,Peru,NA,Ayacucho,616176,123,0,9949,282
2020-09-12,Peru,NA,Ayacucho,616176,104,1,10053,283
2020-09-13,Peru,NA,Ayacucho,616176,26,1,10079,284
2020-09-14,Peru,NA,Ayacucho,616176,108,2,10187,286
2020-09-15,Peru,NA,Ayacucho,616176,131,0,10318,286
2020-09-16,Peru,NA,Ayacucho,616176,136,0,10454,286
2020-09-17,Peru,NA,Ayacucho,616176,117,0,10571,286
2020-09-18,Peru,NA,Ayacucho,616176,123,0,10694,286
2020-09-19,Peru,NA,Ayacucho,616176,106,3,10800,289
2020-09-20,Peru,NA,Ayacucho,616176,24,0,10824,289
2020-09-21,Peru,NA,Ayacucho,616176,88,3,10912,292
2020-09-22,Peru,NA,Ayacucho,616176,25,2,10937,294
2020-04-08,Peru,NA,Cajamarca,1341012,3,0,11,0
2020-04-09,Peru,NA,Cajamarca,1341012,6,0,17,0
2020-04-11,Peru,NA,Cajamarca,1341012,1,0,18,0
2020-04-12,Peru,NA,Cajamarca,1341012,1,0,19,0
2020-04-13,Peru,NA,Cajamarca,1341012,4,2,23,2
2020-04-14,Peru,NA,Cajamarca,1341012,7,0,30,2
2020-04-15,Peru,NA,Cajamarca,1341012,10,0,40,2
2020-04-16,Peru,NA,Cajamarca,1341012,6,1,46,3
2020-04-17,Peru,NA,Cajamarca,1341012,10,0,56,3
2020-04-18,Peru,NA,Cajamarca,1341012,7,0,63,3
2020-04-19,Peru,NA,Cajamarca,1341012,2,0,65,3
2020-04-20,Peru,NA,Cajamarca,1341012,11,1,76,4
2020-04-21,Peru,NA,Cajamarca,1341012,9,0,85,4
2020-04-22,Peru,NA,Cajamarca,1341012,35,0,120,4
2020-04-23,Peru,NA,Cajamarca,1341012,8,0,128,4
2020-04-24,Peru,NA,Cajamarca,1341012,22,0,150,4
2020-04-25,Peru,NA,Cajamarca,1341012,17,1,167,5
2020-04-26,Peru,NA,Cajamarca,1341012,3,0,170,5
2020-04-27,Peru,NA,Cajamarca,1341012,11,2,181,7
2020-04-28,Peru,NA,Cajamarca,1341012,14,0,195,7
2020-04-29,Peru,NA,Cajamarca,1341012,29,2,224,9
2020-04-30,Peru,NA,Cajamarca,1341012,48,0,272,9
2020-05-01,Peru,NA,Cajamarca,1341012,19,1,291,10
2020-05-02,Peru,NA,Cajamarca,1341012,29,0,320,10
2020-05-03,Peru,NA,Cajamarca,1341012,13,0,333,10
2020-05-04,Peru,NA,Cajamarca,1341012,15,0,348,10
2020-05-05,Peru,NA,Cajamarca,1341012,17,0,365,10
2020-05-06,Peru,NA,Cajamarca,1341012,11,1,376,11
2020-05-07,Peru,NA,Cajamarca,1341012,8,0,384,11
2020-05-08,Peru,NA,Cajamarca,1341012,12,0,396,11
2020-05-09,Peru,NA,Cajamarca,1341012,6,1,402,12
2020-05-10,Peru,NA,Cajamarca,1341012,2,1,404,13
2020-05-11,Peru,NA,Cajamarca,1341012,13,0,417,13
2020-05-12,Peru,NA,Cajamarca,1341012,22,0,439,13
2020-05-13,Peru,NA,Cajamarca,1341012,3,0,442,13
2020-05-14,Peru,NA,Cajamarca,1341012,12,1,454,14
2020-05-15,Peru,NA,Cajamarca,1341012,20,0,474,14
2020-05-16,Peru,NA,Cajamarca,1341012,13,3,487,17
2020-05-17,Peru,NA,Cajamarca,1341012,2,0,489,17
2020-05-18,Peru,NA,Cajamarca,1341012,20,2,509,19
2020-05-19,Peru,NA,Cajamarca,1341012,28,2,537,21
2020-05-20,Peru,NA,Cajamarca,1341012,28,0,565,21
2020-05-21,Peru,NA,Cajamarca,1341012,19,0,584,21
2020-05-22,Peru,NA,Cajamarca,1341012,29,2,613,23
2020-05-23,Peru,NA,Cajamarca,1341012,50,0,663,23
2020-05-24,Peru,NA,Cajamarca,1341012,7,0,670,23
2020-05-25,Peru,NA,Cajamarca,1341012,33,1,703,24
2020-05-26,Peru,NA,Cajamarca,1341012,31,0,734,24
2020-05-27,Peru,NA,Cajamarca,1341012,20,0,754,24
2020-05-28,Peru,NA,Cajamarca,1341012,32,2,786,26
2020-05-29,Peru,NA,Cajamarca,1341012,20,1,806,27
2020-05-30,Peru,NA,Cajamarca,1341012,18,2,824,29
2020-05-31,Peru,NA,Cajamarca,1341012,5,1,829,30
2020-06-01,Peru,NA,Cajamarca,1341012,30,1,859,31
2020-06-02,Peru,NA,Cajamarca,1341012,23,0,882,31
2020-06-03,Peru,NA,Cajamarca,1341012,34,3,916,34
2020-06-04,Peru,NA,Cajamarca,1341012,21,2,937,36
2020-06-05,Peru,NA,Cajamarca,1341012,53,0,990,36
2020-06-06,Peru,NA,Cajamarca,1341012,44,3,1034,39
2020-06-07,Peru,NA,Cajamarca,1341012,14,2,1048,41
2020-06-08,Peru,NA,Cajamarca,1341012,44,2,1092,43
2020-06-09,Peru,NA,Cajamarca,1341012,44,3,1136,46
2020-06-10,Peru,NA,Cajamarca,1341012,47,2,1183,48
2020-06-11,Peru,NA,Cajamarca,1341012,50,2,1233,50
2020-06-12,Peru,NA,Cajamarca,1341012,68,3,1301,53
2020-06-13,Peru,NA,Cajamarca,1341012,55,2,1356,55
2020-06-14,Peru,NA,Cajamarca,1341012,23,1,1379,56
2020-06-15,Peru,NA,Cajamarca,1341012,45,5,1424,61
2020-06-16,Peru,NA,Cajamarca,1341012,15,3,1439,64
2020-06-17,Peru,NA,Cajamarca,1341012,57,2,1496,66
2020-06-18,Peru,NA,Cajamarca,1341012,58,3,1554,69
2020-06-19,Peru,NA,Cajamarca,1341012,48,4,1602,73
2020-06-20,Peru,NA,Cajamarca,1341012,54,4,1656,77
2020-06-21,Peru,NA,Cajamarca,1341012,15,2,1671,79
2020-06-22,Peru,NA,Cajamarca,1341012,76,6,1747,85
2020-06-23,Peru,NA,Cajamarca,1341012,73,4,1820,89
2020-06-24,Peru,NA,Cajamarca,1341012,93,5,1913,94
2020-06-25,Peru,NA,Cajamarca,1341012,76,1,1989,95
2020-06-26,Peru,NA,Cajamarca,1341012,84,7,2073,102
2020-06-27,Peru,NA,Cajamarca,1341012,62,11,2135,113
2020-06-28,Peru,NA,Cajamarca,1341012,30,11,2165,124
2020-06-29,Peru,NA,Cajamarca,1341012,57,10,2222,134
2020-06-30,Peru,NA,Cajamarca,1341012,93,9,2315,143
2020-07-01,Peru,NA,Cajamarca,1341012,66,6,2381,149
2020-07-02,Peru,NA,Cajamarca,1341012,159,10,2540,159
2020-07-03,Peru,NA,Cajamarca,1341012,95,8,2635,167
2020-07-04,Peru,NA,Cajamarca,1341012,113,6,2748,173
2020-07-05,Peru,NA,Cajamarca,1341012,99,11,2847,184
2020-07-06,Peru,NA,Cajamarca,1341012,151,16,2998,200
2020-07-07,Peru,NA,Cajamarca,1341012,168,7,3166,207
2020-07-08,Peru,NA,Cajamarca,1341012,139,11,3305,218
2020-07-09,Peru,NA,Cajamarca,1341012,66,4,3371,222
2020-07-10,Peru,NA,Cajamarca,1341012,182,4,3553,226
2020-07-11,Peru,NA,Cajamarca,1341012,171,4,3724,230
2020-07-12,Peru,NA,Cajamarca,1341012,102,2,3826,232
2020-07-13,Peru,NA,Cajamarca,1341012,98,0,3924,232
2020-07-14,Peru,NA,Cajamarca,1341012,140,3,4064,235
2020-07-15,Peru,NA,Cajamarca,1341012,154,1,4218,236
2020-07-16,Peru,NA,Cajamarca,1341012,101,5,4319,241
2020-07-17,Peru,NA,Cajamarca,1341012,100,2,4419,243
2020-07-18,Peru,NA,Cajamarca,1341012,196,2,4615,245
2020-07-19,Peru,NA,Cajamarca,1341012,71,4,4686,249
2020-07-20,Peru,NA,Cajamarca,1341012,107,2,4793,251
2020-07-21,Peru,NA,Cajamarca,1341012,141,1,4934,252
2020-07-22,Peru,NA,Cajamarca,1341012,184,2,5118,254
2020-07-23,Peru,NA,Cajamarca,1341012,146,3,5264,257
2020-07-24,Peru,NA,Cajamarca,1341012,189,5,5453,262
2020-07-25,Peru,NA,Cajamarca,1341012,236,8,5689,270
2020-07-26,Peru,NA,Cajamarca,1341012,78,4,5767,274
2020-07-27,Peru,NA,Cajamarca,1341012,250,3,6017,277
2020-07-28,Peru,NA,Cajamarca,1341012,157,2,6174,279
2020-07-29,Peru,NA,Cajamarca,1341012,421,2,6595,281
2020-07-30,Peru,NA,Cajamarca,1341012,430,2,7025,283
2020-07-31,Peru,NA,Cajamarca,1341012,643,2,7668,285
2020-08-01,Peru,NA,Cajamarca,1341012,278,5,7946,290
2020-08-02,Peru,NA,Cajamarca,1341012,79,3,8025,293
2020-08-03,Peru,NA,Cajamarca,1341012,289,5,8314,298
2020-08-04,Peru,NA,Cajamarca,1341012,251,7,8565,305
2020-08-05,Peru,NA,Cajamarca,1341012,286,1,8851,306
2020-08-06,Peru,NA,Cajamarca,1341012,342,10,9193,316
2020-08-07,Peru,NA,Cajamarca,1341012,300,4,9493,320
2020-08-08,Peru,NA,Cajamarca,1341012,412,4,9905,324
2020-08-09,Peru,NA,Cajamarca,1341012,172,3,10077,327
2020-08-10,Peru,NA,Cajamarca,1341012,377,8,10454,335
2020-08-11,Peru,NA,Cajamarca,1341012,296,3,10750,338
2020-08-12,Peru,NA,Cajamarca,1341012,346,4,11096,342
2020-08-13,Peru,NA,Cajamarca,1341012,362,2,11458,344
2020-08-14,Peru,NA,Cajamarca,1341012,503,5,11961,349
2020-08-15,Peru,NA,Cajamarca,1341012,242,1,12203,350
2020-08-16,Peru,NA,Cajamarca,1341012,84,3,12287,353
2020-08-17,Peru,NA,Cajamarca,1341012,369,3,12656,356
2020-08-18,Peru,NA,Cajamarca,1341012,387,2,13043,358
2020-08-19,Peru,NA,Cajamarca,1341012,327,4,13370,362
2020-08-20,Peru,NA,Cajamarca,1341012,273,1,13643,363
2020-08-21,Peru,NA,Cajamarca,1341012,408,3,14051,366
2020-08-22,Peru,NA,Cajamarca,1341012,302,3,14353,369
2020-08-23,Peru,NA,Cajamarca,1341012,43,4,14396,373
2020-08-24,Peru,NA,Cajamarca,1341012,362,2,14758,375
2020-08-25,Peru,NA,Cajamarca,1341012,464,2,15222,377
2020-08-26,Peru,NA,Cajamarca,1341012,221,2,15443,379
2020-08-27,Peru,NA,Cajamarca,1341012,179,1,15622,380
2020-08-28,Peru,NA,Cajamarca,1341012,234,3,15856,383
2020-08-29,Peru,NA,Cajamarca,1341012,160,2,16016,385
2020-08-30,Peru,NA,Cajamarca,1341012,64,3,16080,388
2020-08-31,Peru,NA,Cajamarca,1341012,148,0,16228,388
2020-09-01,Peru,NA,Cajamarca,1341012,232,5,16460,393
2020-09-02,Peru,NA,Cajamarca,1341012,157,4,16617,397
2020-09-03,Peru,NA,Cajamarca,1341012,91,0,16708,397
2020-09-04,Peru,NA,Cajamarca,1341012,439,3,17147,400
2020-09-05,Peru,NA,Cajamarca,1341012,83,3,17230,403
2020-09-06,Peru,NA,Cajamarca,1341012,28,4,17258,407
2020-09-07,Peru,NA,Cajamarca,1341012,147,1,17405,408
2020-09-08,Peru,NA,Cajamarca,1341012,169,4,17574,412
2020-09-09,Peru,NA,Cajamarca,1341012,138,4,17712,416
2020-09-10,Peru,NA,Cajamarca,1341012,88,1,17800,417
2020-09-11,Peru,NA,Cajamarca,1341012,265,3,18065,420
2020-09-12,Peru,NA,Cajamarca,1341012,103,3,18168,423
2020-09-13,Peru,NA,Cajamarca,1341012,39,3,18207,426
2020-09-14,Peru,NA,Cajamarca,1341012,138,0,18345,426
2020-09-15,Peru,NA,Cajamarca,1341012,164,11,18509,437
2020-09-16,Peru,NA,Cajamarca,1341012,114,2,18623,439
2020-09-17,Peru,NA,Cajamarca,1341012,139,2,18762,441
2020-09-18,Peru,NA,Cajamarca,1341012,92,0,18854,441
2020-09-19,Peru,NA,Cajamarca,1341012,102,7,18956,448
2020-09-20,Peru,NA,Cajamarca,1341012,26,1,18982,449
2020-09-21,Peru,NA,Cajamarca,1341012,70,0,19052,449
2020-09-22,Peru,NA,Cajamarca,1341012,27,1,19079,450
2020-03-25,Peru,NA,Callao,994494,5,0,15,1
2020-03-26,Peru,NA,Callao,994494,2,0,17,1
2020-03-27,Peru,NA,Callao,994494,1,0,18,1
2020-03-28,Peru,NA,Callao,994494,5,0,23,1
2020-03-29,Peru,NA,Callao,994494,10,0,33,1
2020-03-30,Peru,NA,Callao,994494,1,0,34,1
2020-03-31,Peru,NA,Callao,994494,12,2,46,3
2020-04-01,Peru,NA,Callao,994494,22,3,68,6
2020-04-02,Peru,NA,Callao,994494,6,2,74,8
2020-04-03,Peru,NA,Callao,994494,14,1,88,9
2020-04-04,Peru,NA,Callao,994494,174,2,262,11
2020-04-05,Peru,NA,Callao,994494,48,1,310,12
2020-04-06,Peru,NA,Callao,994494,66,4,376,16
2020-04-07,Peru,NA,Callao,994494,51,1,427,17
2020-04-08,Peru,NA,Callao,994494,127,1,554,18
2020-04-09,Peru,NA,Callao,994494,48,3,602,21
2020-04-10,Peru,NA,Callao,994494,88,4,690,25
2020-04-11,Peru,NA,Callao,994494,303,3,993,28
2020-04-12,Peru,NA,Callao,994494,38,4,1031,32
2020-04-13,Peru,NA,Callao,994494,311,5,1342,37
2020-04-14,Peru,NA,Callao,994494,83,6,1425,43
2020-04-15,Peru,NA,Callao,994494,100,3,1525,46
2020-04-16,Peru,NA,Callao,994494,100,8,1625,54
2020-04-17,Peru,NA,Callao,994494,116,6,1741,60
2020-04-18,Peru,NA,Callao,994494,107,8,1848,68
2020-04-19,Peru,NA,Callao,994494,79,3,1927,71
2020-04-20,Peru,NA,Callao,994494,374,7,2301,78
2020-04-21,Peru,NA,Callao,994494,432,12,2733,90
2020-04-22,Peru,NA,Callao,994494,124,8,2857,98
2020-04-23,Peru,NA,Callao,994494,159,12,3016,110
2020-04-24,Peru,NA,Callao,994494,124,16,3140,126
2020-04-25,Peru,NA,Callao,994494,170,6,3310,132
2020-04-26,Peru,NA,Callao,994494,67,12,3377,144
2020-04-27,Peru,NA,Callao,994494,230,9,3607,153
2020-04-28,Peru,NA,Callao,994494,199,8,3806,161
2020-04-29,Peru,NA,Callao,994494,189,15,3995,176
2020-04-30,Peru,NA,Callao,994494,255,16,4250,192
2020-05-01,Peru,NA,Callao,994494,115,10,4365,202
2020-05-02,Peru,NA,Callao,994494,214,12,4579,214
2020-05-03,Peru,NA,Callao,994494,95,17,4674,231
2020-05-04,Peru,NA,Callao,994494,200,16,4874,247
2020-05-05,Peru,NA,Callao,994494,270,16,5144,263
2020-05-06,Peru,NA,Callao,994494,253,20,5397,283
2020-05-07,Peru,NA,Callao,994494,329,18,5726,301
2020-05-08,Peru,NA,Callao,994494,224,20,5950,321
2020-05-09,Peru,NA,Callao,994494,185,16,6135,337
2020-05-10,Peru,NA,Callao,994494,42,18,6177,355
2020-05-11,Peru,NA,Callao,994494,212,20,6389,375
2020-05-12,Peru,NA,Callao,994494,316,17,6705,392
2020-05-13,Peru,NA,Callao,994494,351,9,7056,401
2020-05-14,Peru,NA,Callao,994494,325,21,7381,422
2020-05-15,Peru,NA,Callao,994494,310,21,7691,443
2020-05-16,Peru,NA,Callao,994494,215,23,7906,466
2020-05-17,Peru,NA,Callao,994494,108,27,8014,493
2020-05-18,Peru,NA,Callao,994494,238,24,8252,517
2020-05-19,Peru,NA,Callao,994494,382,20,8634,537
2020-05-20,Peru,NA,Callao,994494,349,32,8983,569
2020-05-21,Peru,NA,Callao,994494,382,32,9365,601
2020-05-22,Peru,NA,Callao,994494,428,28,9793,629
2020-05-23,Peru,NA,Callao,994494,346,29,10139,658
2020-05-24,Peru,NA,Callao,994494,72,31,10211,689
2020-05-25,Peru,NA,Callao,994494,409,12,10620,701
2020-05-26,Peru,NA,Callao,994494,496,23,11116,724
2020-05-27,Peru,NA,Callao,994494,510,20,11626,744
2020-05-28,Peru,NA,Callao,994494,509,24,12135,768
2020-05-29,Peru,NA,Callao,994494,358,28,12493,796
2020-05-30,Peru,NA,Callao,994494,250,22,12743,818
2020-05-31,Peru,NA,Callao,994494,142,23,12885,841
2020-06-01,Peru,NA,Callao,994494,188,24,13073,865
2020-06-02,Peru,NA,Callao,994494,187,24,13260,889
2020-06-03,Peru,NA,Callao,994494,154,34,13414,923
2020-06-04,Peru,NA,Callao,994494,214,10,13628,933
2020-06-05,Peru,NA,Callao,994494,241,11,13869,944
2020-06-06,Peru,NA,Callao,994494,266,12,14135,956
2020-06-07,Peru,NA,Callao,994494,98,3,14233,959
2020-06-08,Peru,NA,Callao,994494,278,10,14511,969
2020-06-09,Peru,NA,Callao,994494,213,9,14724,978
2020-06-10,Peru,NA,Callao,994494,418,8,15142,986
2020-06-11,Peru,NA,Callao,994494,329,16,15471,1002
2020-06-12,Peru,NA,Callao,994494,293,5,15764,1007
2020-06-13,Peru,NA,Callao,994494,199,13,15963,1020
2020-06-14,Peru,NA,Callao,994494,150,12,16113,1032
2020-06-15,Peru,NA,Callao,994494,130,13,16243,1045
2020-06-16,Peru,NA,Callao,994494,99,21,16342,1066
2020-06-17,Peru,NA,Callao,994494,228,8,16570,1074
2020-06-18,Peru,NA,Callao,994494,244,7,16814,1081
2020-06-19,Peru,NA,Callao,994494,180,14,16994,1095
2020-06-20,Peru,NA,Callao,994494,136,14,17130,1109
2020-06-21,Peru,NA,Callao,994494,83,9,17213,1118
2020-06-22,Peru,NA,Callao,994494,125,5,17338,1123
2020-06-23,Peru,NA,Callao,994494,90,8,17428,1131
2020-06-24,Peru,NA,Callao,994494,93,9,17521,1140
2020-06-25,Peru,NA,Callao,994494,179,12,17700,1152
2020-06-26,Peru,NA,Callao,994494,206,12,17906,1164
2020-06-27,Peru,NA,Callao,994494,108,15,18014,1179
2020-06-28,Peru,NA,Callao,994494,30,8,18044,1187
2020-06-29,Peru,NA,Callao,994494,69,6,18113,1193
2020-06-30,Peru,NA,Callao,994494,146,8,18259,1201
2020-07-01,Peru,NA,Callao,994494,57,10,18316,1211
2020-07-02,Peru,NA,Callao,994494,57,3,18373,1214
2020-07-03,Peru,NA,Callao,994494,84,4,18457,1218
2020-07-04,Peru,NA,Callao,994494,61,8,18518,1226
2020-07-05,Peru,NA,Callao,994494,35,6,18553,1232
2020-07-06,Peru,NA,Callao,994494,91,9,18644,1241
2020-07-07,Peru,NA,Callao,994494,166,5,18810,1246
2020-07-08,Peru,NA,Callao,994494,92,10,18902,1256
2020-07-09,Peru,NA,Callao,994494,116,9,19018,1265
2020-07-10,Peru,NA,Callao,994494,118,5,19136,1270
2020-07-11,Peru,NA,Callao,994494,80,8,19216,1278
2020-07-12,Peru,NA,Callao,994494,61,7,19277,1285
2020-07-13,Peru,NA,Callao,994494,57,3,19334,1288
2020-07-14,Peru,NA,Callao,994494,61,10,19395,1298
2020-07-15,Peru,NA,Callao,994494,157,13,19552,1311
2020-07-16,Peru,NA,Callao,994494,163,7,19715,1318
2020-07-17,Peru,NA,Callao,994494,205,9,19920,1327
2020-07-18,Peru,NA,Callao,994494,142,6,20062,1333
2020-07-19,Peru,NA,Callao,994494,24,9,20086,1342
2020-07-20,Peru,NA,Callao,994494,61,3,20147,1345
2020-07-21,Peru,NA,Callao,994494,111,4,20258,1349
2020-07-22,Peru,NA,Callao,994494,179,9,20437,1358
2020-07-23,Peru,NA,Callao,994494,195,11,20632,1369
2020-07-24,Peru,NA,Callao,994494,165,6,20797,1375
2020-07-25,Peru,NA,Callao,994494,159,1,20956,1376
2020-07-26,Peru,NA,Callao,994494,70,0,21026,1376
2020-07-27,Peru,NA,Callao,994494,191,0,21217,1376
2020-07-28,Peru,NA,Callao,994494,54,0,21271,1376
2020-07-29,Peru,NA,Callao,994494,160,0,21431,1376
2020-07-30,Peru,NA,Callao,994494,184,0,21615,1376
2020-07-31,Peru,NA,Callao,994494,252,0,21867,1376
2020-08-01,Peru,NA,Callao,994494,174,0,22041,1376
2020-08-02,Peru,NA,Callao,994494,74,0,22115,1376
2020-08-03,Peru,NA,Callao,994494,271,0,22386,1376
2020-08-04,Peru,NA,Callao,994494,208,3,22594,1379
2020-08-05,Peru,NA,Callao,994494,219,7,22813,1386
2020-08-06,Peru,NA,Callao,994494,228,13,23041,1399
2020-08-07,Peru,NA,Callao,994494,186,8,23227,1407
2020-08-08,Peru,NA,Callao,994494,198,10,23425,1417
2020-08-09,Peru,NA,Callao,994494,69,5,23494,1422
2020-08-10,Peru,NA,Callao,994494,218,2,23712,1424
2020-08-11,Peru,NA,Callao,994494,326,9,24038,1433
2020-08-12,Peru,NA,Callao,994494,409,5,24447,1438
2020-08-13,Peru,NA,Callao,994494,275,6,24722,1444
2020-08-14,Peru,NA,Callao,994494,231,12,24953,1456
2020-08-15,Peru,NA,Callao,994494,254,6,25207,1462
2020-08-16,Peru,NA,Callao,994494,71,5,25278,1467
2020-08-17,Peru,NA,Callao,994494,204,12,25482,1479
2020-08-18,Peru,NA,Callao,994494,232,2,25714,1481
2020-08-19,Peru,NA,Callao,994494,243,5,25957,1486
2020-08-20,Peru,NA,Callao,994494,278,13,26235,1499
2020-08-21,Peru,NA,Callao,994494,218,6,26453,1505
2020-08-22,Peru,NA,Callao,994494,152,9,26605,1514
2020-08-23,Peru,NA,Callao,994494,23,7,26628,1521
2020-08-24,Peru,NA,Callao,994494,318,6,26946,1527
2020-08-25,Peru,NA,Callao,994494,245,6,27191,1533
2020-08-26,Peru,NA,Callao,994494,230,6,27421,1539
2020-08-27,Peru,NA,Callao,994494,181,12,27602,1551
2020-08-28,Peru,NA,Callao,994494,226,7,27828,1558
2020-08-29,Peru,NA,Callao,994494,128,5,27956,1563
2020-08-30,Peru,NA,Callao,994494,70,6,28026,1569
2020-08-31,Peru,NA,Callao,994494,166,3,28192,1572
2020-09-01,Peru,NA,Callao,994494,167,8,28359,1580
2020-09-02,Peru,NA,Callao,994494,184,5,28543,1585
2020-09-03,Peru,NA,Callao,994494,131,4,28674,1589
2020-09-04,Peru,NA,Callao,994494,229,4,28903,1593
2020-09-05,Peru,NA,Callao,994494,99,8,29002,1601
2020-09-06,Peru,NA,Callao,994494,43,8,29045,1609
2020-09-07,Peru,NA,Callao,994494,152,7,29197,1616
2020-09-08,Peru,NA,Callao,994494,240,6,29437,1622
2020-09-09,Peru,NA,Callao,994494,203,7,29640,1629
2020-09-10,Peru,NA,Callao,994494,262,5,29902,1634
2020-09-11,Peru,NA,Callao,994494,311,5,30213,1639
2020-09-12,Peru,NA,Callao,994494,219,9,30432,1648
2020-09-13,Peru,NA,Callao,994494,46,9,30478,1657
2020-09-14,Peru,NA,Callao,994494,189,6,30667,1663
2020-09-15,Peru,NA,Callao,994494,125,3,30792,1666
2020-09-16,Peru,NA,Callao,994494,159,7,30951,1673
2020-09-17,Peru,NA,Callao,994494,147,7,31098,1680
2020-09-18,Peru,NA,Callao,994494,133,5,31231,1685
2020-09-19,Peru,NA,Callao,994494,160,12,31391,1697
2020-09-20,Peru,NA,Callao,994494,34,6,31425,1703
2020-09-21,Peru,NA,Callao,994494,108,4,31533,1707
2020-09-22,Peru,NA,Callao,994494,91,6,31624,1713
2020-03-27,Peru,NA,Cusco,1205527,1,2,11,2
2020-03-28,Peru,NA,Cusco,1205527,6,0,17,3
2020-03-29,Peru,NA,Cusco,1205527,8,0,25,3
2020-03-30,Peru,NA,Cusco,1205527,1,0,26,3
2020-03-31,Peru,NA,Cusco,1205527,8,0,34,3
2020-04-01,Peru,NA,Cusco,1205527,4,0,38,3
2020-04-02,Peru,NA,Cusco,1205527,7,1,45,4
2020-04-03,Peru,NA,Cusco,1205527,4,0,49,4
2020-04-04,Peru,NA,Cusco,1205527,11,0,60,4
2020-04-05,Peru,NA,Cusco,1205527,2,0,62,4
2020-04-06,Peru,NA,Cusco,1205527,1,0,63,4
2020-04-08,Peru,NA,Cusco,1205527,3,0,66,4
2020-04-09,Peru,NA,Cusco,1205527,2,0,68,4
2020-04-10,Peru,NA,Cusco,1205527,3,0,71,4
2020-04-11,Peru,NA,Cusco,1205527,43,0,114,4
2020-04-13,Peru,NA,Cusco,1205527,1,0,115,4
2020-04-14,Peru,NA,Cusco,1205527,3,0,118,4
2020-04-15,Peru,NA,Cusco,1205527,1,0,119,4
2020-04-16,Peru,NA,Cusco,1205527,9,0,128,4
2020-04-17,Peru,NA,Cusco,1205527,12,0,140,4
2020-04-18,Peru,NA,Cusco,1205527,15,0,155,4
2020-04-20,Peru,NA,Cusco,1205527,15,0,170,4
2020-04-21,Peru,NA,Cusco,1205527,7,0,177,4
2020-04-22,Peru,NA,Cusco,1205527,19,1,196,5
2020-04-23,Peru,NA,Cusco,1205527,14,1,210,6
2020-04-24,Peru,NA,Cusco,1205527,3,0,213,6
2020-04-25,Peru,NA,Cusco,1205527,11,0,224,6
2020-04-26,Peru,NA,Cusco,1205527,1,1,225,7
2020-04-27,Peru,NA,Cusco,1205527,14,0,239,7
2020-04-28,Peru,NA,Cusco,1205527,23,0,262,7
2020-04-29,Peru,NA,Cusco,1205527,22,0,284,7
2020-04-30,Peru,NA,Cusco,1205527,34,0,318,7
2020-05-01,Peru,NA,Cusco,1205527,6,0,324,7
2020-05-02,Peru,NA,Cusco,1205527,13,0,337,7
2020-05-03,Peru,NA,Cusco,1205527,2,0,339,7
2020-05-04,Peru,NA,Cusco,1205527,8,0,347,7
2020-05-05,Peru,NA,Cusco,1205527,26,0,373,7
2020-05-06,Peru,NA,Cusco,1205527,50,0,423,7
2020-05-07,Peru,NA,Cusco,1205527,48,0,471,7
2020-05-08,Peru,NA,Cusco,1205527,49,0,520,7
2020-05-09,Peru,NA,Cusco,1205527,11,0,531,7
2020-05-10,Peru,NA,Cusco,1205527,2,0,533,7
2020-05-11,Peru,NA,Cusco,1205527,56,0,589,7
2020-05-12,Peru,NA,Cusco,1205527,33,1,622,8
2020-05-13,Peru,NA,Cusco,1205527,47,2,669,10
2020-05-14,Peru,NA,Cusco,1205527,31,0,700,10
2020-05-15,Peru,NA,Cusco,1205527,6,2,706,12
2020-05-16,Peru,NA,Cusco,1205527,10,0,716,12
2020-05-18,Peru,NA,Cusco,1205527,7,0,723,12
2020-05-19,Peru,NA,Cusco,1205527,40,1,763,13
2020-05-20,Peru,NA,Cusco,1205527,31,0,794,13
2020-05-21,Peru,NA,Cusco,1205527,41,0,835,13
2020-05-22,Peru,NA,Cusco,1205527,44,0,879,13
2020-05-23,Peru,NA,Cusco,1205527,32,0,911,13
2020-05-24,Peru,NA,Cusco,1205527,6,0,917,13
2020-05-25,Peru,NA,Cusco,1205527,51,0,968,13
2020-05-26,Peru,NA,Cusco,1205527,30,0,998,13
2020-05-27,Peru,NA,Cusco,1205527,37,0,1035,13
2020-05-28,Peru,NA,Cusco,1205527,46,0,1081,13
2020-05-29,Peru,NA,Cusco,1205527,57,0,1138,13
2020-05-30,Peru,NA,Cusco,1205527,19,0,1157,13
2020-05-31,Peru,NA,Cusco,1205527,1,0,1158,13
2020-06-01,Peru,NA,Cusco,1205527,25,0,1183,13
2020-06-02,Peru,NA,Cusco,1205527,23,0,1206,13
2020-06-03,Peru,NA,Cusco,1205527,14,2,1220,15
2020-06-04,Peru,NA,Cusco,1205527,30,2,1250,17
2020-06-05,Peru,NA,Cusco,1205527,18,1,1268,18
2020-06-06,Peru,NA,Cusco,1205527,40,0,1308,18
2020-06-07,Peru,NA,Cusco,1205527,20,1,1328,19
2020-06-08,Peru,NA,Cusco,1205527,17,0,1345,19
2020-06-09,Peru,NA,Cusco,1205527,37,1,1382,20
2020-06-10,Peru,NA,Cusco,1205527,35,0,1417,20
2020-06-11,Peru,NA,Cusco,1205527,19,1,1436,21
2020-06-12,Peru,NA,Cusco,1205527,48,1,1484,22
2020-06-13,Peru,NA,Cusco,1205527,18,3,1502,25
2020-06-14,Peru,NA,Cusco,1205527,9,1,1511,26
2020-06-15,Peru,NA,Cusco,1205527,15,1,1526,27
2020-06-16,Peru,NA,Cusco,1205527,13,1,1539,28
2020-06-17,Peru,NA,Cusco,1205527,22,4,1561,32
2020-06-18,Peru,NA,Cusco,1205527,13,0,1574,32
2020-06-19,Peru,NA,Cusco,1205527,21,2,1595,34
2020-06-20,Peru,NA,Cusco,1205527,35,0,1630,34
2020-06-21,Peru,NA,Cusco,1205527,1,0,1631,34
2020-06-22,Peru,NA,Cusco,1205527,16,0,1647,34
2020-06-23,Peru,NA,Cusco,1205527,29,0,1676,34
2020-06-24,Peru,NA,Cusco,1205527,14,1,1690,35
2020-06-25,Peru,NA,Cusco,1205527,18,3,1708,38
2020-06-26,Peru,NA,Cusco,1205527,41,1,1749,39
2020-06-27,Peru,NA,Cusco,1205527,31,1,1780,40
2020-06-28,Peru,NA,Cusco,1205527,6,2,1786,42
2020-06-29,Peru,NA,Cusco,1205527,29,1,1815,43
2020-06-30,Peru,NA,Cusco,1205527,27,1,1842,44
2020-07-01,Peru,NA,Cusco,1205527,18,0,1860,44
2020-07-02,Peru,NA,Cusco,1205527,36,0,1896,44
2020-07-03,Peru,NA,Cusco,1205527,27,1,1923,45
2020-07-04,Peru,NA,Cusco,1205527,45,1,1968,46
2020-07-05,Peru,NA,Cusco,1205527,26,1,1994,47
2020-07-06,Peru,NA,Cusco,1205527,40,0,2034,47
2020-07-07,Peru,NA,Cusco,1205527,38,1,2072,48
2020-07-08,Peru,NA,Cusco,1205527,28,0,2100,48
2020-07-09,Peru,NA,Cusco,1205527,25,1,2125,49
2020-07-10,Peru,NA,Cusco,1205527,94,0,2219,49
2020-07-11,Peru,NA,Cusco,1205527,87,2,2306,51
2020-07-12,Peru,NA,Cusco,1205527,13,1,2319,52
2020-07-13,Peru,NA,Cusco,1205527,82,0,2401,52
2020-07-14,Peru,NA,Cusco,1205527,67,2,2468,54
2020-07-15,Peru,NA,Cusco,1205527,70,1,2538,55
2020-07-16,Peru,NA,Cusco,1205527,54,5,2592,60
2020-07-17,Peru,NA,Cusco,1205527,85,2,2677,62
2020-07-18,Peru,NA,Cusco,1205527,120,4,2797,66
2020-07-19,Peru,NA,Cusco,1205527,25,1,2822,67
2020-07-20,Peru,NA,Cusco,1205527,86,5,2908,72
2020-07-21,Peru,NA,Cusco,1205527,138,2,3046,74
2020-07-22,Peru,NA,Cusco,1205527,214,10,3260,84
2020-07-23,Peru,NA,Cusco,1205527,61,1,3321,85
2020-07-24,Peru,NA,Cusco,1205527,175,1,3496,86
2020-07-25,Peru,NA,Cusco,1205527,188,4,3684,90
2020-07-26,Peru,NA,Cusco,1205527,172,2,3856,92
2020-07-27,Peru,NA,Cusco,1205527,154,2,4010,94
2020-07-28,Peru,NA,Cusco,1205527,86,5,4096,99
2020-07-29,Peru,NA,Cusco,1205527,255,2,4351,101
2020-07-30,Peru,NA,Cusco,1205527,198,6,4549,107
2020-07-31,Peru,NA,Cusco,1205527,339,8,4888,115
2020-08-01,Peru,NA,Cusco,1205527,161,10,5049,125
2020-08-02,Peru,NA,Cusco,1205527,80,9,5129,134
2020-08-03,Peru,NA,Cusco,1205527,236,4,5365,138
2020-08-04,Peru,NA,Cusco,1205527,258,10,5623,148
2020-08-05,Peru,NA,Cusco,1205527,242,2,5865,150
2020-08-06,Peru,NA,Cusco,1205527,313,8,6178,158
2020-08-07,Peru,NA,Cusco,1205527,345,6,6523,164
2020-08-08,Peru,NA,Cusco,1205527,194,6,6717,170
2020-08-09,Peru,NA,Cusco,1205527,224,1,6941,171
2020-08-10,Peru,NA,Cusco,1205527,323,6,7264,177
2020-08-11,Peru,NA,Cusco,1205527,401,5,7665,182
2020-08-12,Peru,NA,Cusco,1205527,374,7,8039,189
2020-08-13,Peru,NA,Cusco,1205527,408,5,8447,194
2020-08-14,Peru,NA,Cusco,1205527,396,9,8843,203
2020-08-15,Peru,NA,Cusco,1205527,307,4,9150,207
2020-08-16,Peru,NA,Cusco,1205527,64,6,9214,213
2020-08-17,Peru,NA,Cusco,1205527,339,5,9553,218
2020-08-18,Peru,NA,Cusco,1205527,470,6,10023,224
2020-08-19,Peru,NA,Cusco,1205527,448,10,10471,234
2020-08-20,Peru,NA,Cusco,1205527,763,12,11234,246
2020-08-21,Peru,NA,Cusco,1205527,643,8,11877,254
2020-08-22,Peru,NA,Cusco,1205527,532,7,12409,261
2020-08-23,Peru,NA,Cusco,1205527,64,3,12473,264
2020-08-24,Peru,NA,Cusco,1205527,740,9,13213,273
2020-08-25,Peru,NA,Cusco,1205527,558,7,13771,280
2020-08-26,Peru,NA,Cusco,1205527,346,9,14117,289
2020-08-27,Peru,NA,Cusco,1205527,348,13,14465,302
2020-08-28,Peru,NA,Cusco,1205527,654,8,15119,310
2020-08-29,Peru,NA,Cusco,1205527,277,11,15396,321
2020-08-30,Peru,NA,Cusco,1205527,39,5,15435,326
2020-08-31,Peru,NA,Cusco,1205527,266,4,15701,330
2020-09-01,Peru,NA,Cusco,1205527,224,2,15925,332
2020-09-02,Peru,NA,Cusco,1205527,264,7,16189,339
2020-09-03,Peru,NA,Cusco,1205527,96,2,16285,341
2020-09-04,Peru,NA,Cusco,1205527,375,1,16660,342
2020-09-05,Peru,NA,Cusco,1205527,119,7,16779,349
2020-09-06,Peru,NA,Cusco,1205527,159,2,16938,351
2020-09-07,Peru,NA,Cusco,1205527,268,2,17206,353
2020-09-08,Peru,NA,Cusco,1205527,297,5,17503,358
2020-09-09,Peru,NA,Cusco,1205527,256,5,17759,363
2020-09-10,Peru,NA,Cusco,1205527,106,4,17865,367
2020-09-11,Peru,NA,Cusco,1205527,485,6,18350,373
2020-09-12,Peru,NA,Cusco,1205527,172,2,18522,375
2020-09-13,Peru,NA,Cusco,1205527,38,1,18560,376
2020-09-14,Peru,NA,Cusco,1205527,241,6,18801,382
2020-09-15,Peru,NA,Cusco,1205527,167,4,18968,386
2020-09-16,Peru,NA,Cusco,1205527,127,0,19095,386
2020-09-17,Peru,NA,Cusco,1205527,128,1,19223,387
2020-09-18,Peru,NA,Cusco,1205527,112,0,19335,387
2020-09-19,Peru,NA,Cusco,1205527,109,2,19444,389
2020-09-20,Peru,NA,Cusco,1205527,31,4,19475,393
2020-09-21,Peru,NA,Cusco,1205527,144,5,19619,398
2020-09-22,Peru,NA,Cusco,1205527,49,0,19668,398
2020-04-11,Peru,NA,Huancavelica,347639,2,0,11,1
2020-04-12,Peru,NA,Huancavelica,347639,2,0,13,1
2020-04-13,Peru,NA,Huancavelica,347639,1,0,14,1
2020-04-14,Peru,NA,Huancavelica,347639,1,0,15,1
2020-04-15,Peru,NA,Huancavelica,347639,4,0,19,1
2020-04-16,Peru,NA,Huancavelica,347639,6,0,25,1
2020-04-17,Peru,NA,Huancavelica,347639,1,0,26,1
2020-04-19,Peru,NA,Huancavelica,347639,2,0,28,1
2020-04-20,Peru,NA,Huancavelica,347639,3,1,31,2
2020-04-21,Peru,NA,Huancavelica,347639,1,0,32,2
2020-04-22,Peru,NA,Huancavelica,347639,4,0,36,2
2020-04-23,Peru,NA,Huancavelica,347639,3,0,39,2
2020-04-24,Peru,NA,Huancavelica,347639,3,0,42,2
2020-04-25,Peru,NA,Huancavelica,347639,14,0,56,2
2020-04-26,Peru,NA,Huancavelica,347639,11,0,67,2
2020-04-27,Peru,NA,Huancavelica,347639,18,0,85,2
2020-04-28,Peru,NA,Huancavelica,347639,13,0,98,2
2020-04-29,Peru,NA,Huancavelica,347639,20,0,118,2
2020-04-30,Peru,NA,Huancavelica,347639,17,0,135,2
2020-05-01,Peru,NA,Huancavelica,347639,68,0,203,2
2020-05-02,Peru,NA,Huancavelica,347639,61,0,264,2
2020-05-03,Peru,NA,Huancavelica,347639,25,0,289,2
2020-05-04,Peru,NA,Huancavelica,347639,12,0,301,2
2020-05-05,Peru,NA,Huancavelica,347639,36,0,337,2
2020-05-06,Peru,NA,Huancavelica,347639,3,0,340,2
2020-05-07,Peru,NA,Huancavelica,347639,5,0,345,2
2020-05-08,Peru,NA,Huancavelica,347639,13,0,358,2
2020-05-09,Peru,NA,Huancavelica,347639,5,0,363,2
2020-05-10,Peru,NA,Huancavelica,347639,1,0,364,2
2020-05-11,Peru,NA,Huancavelica,347639,1,0,365,2
2020-05-12,Peru,NA,Huancavelica,347639,1,0,366,2
2020-05-13,Peru,NA,Huancavelica,347639,5,0,371,2
2020-05-14,Peru,NA,Huancavelica,347639,12,0,383,2
2020-05-15,Peru,NA,Huancavelica,347639,6,0,389,2
2020-05-16,Peru,NA,Huancavelica,347639,5,0,394,2
2020-05-17,Peru,NA,Huancavelica,347639,9,0,403,2
2020-05-18,Peru,NA,Huancavelica,347639,6,0,409,2
2020-05-19,Peru,NA,Huancavelica,347639,16,0,425,2
2020-05-20,Peru,NA,Huancavelica,347639,10,0,435,2
2020-05-21,Peru,NA,Huancavelica,347639,17,0,452,2
2020-05-22,Peru,NA,Huancavelica,347639,24,0,476,2
2020-05-23,Peru,NA,Huancavelica,347639,6,0,482,2
2020-05-24,Peru,NA,Huancavelica,347639,7,0,489,2
2020-05-25,Peru,NA,Huancavelica,347639,12,0,501,2
2020-05-26,Peru,NA,Huancavelica,347639,9,0,510,2
2020-05-27,Peru,NA,Huancavelica,347639,14,0,524,2
2020-05-28,Peru,NA,Huancavelica,347639,10,0,534,2
2020-05-29,Peru,NA,Huancavelica,347639,11,0,545,2
2020-05-30,Peru,NA,Huancavelica,347639,11,0,556,2
2020-05-31,Peru,NA,Huancavelica,347639,3,0,559,2
2020-06-01,Peru,NA,Huancavelica,347639,12,0,571,2
2020-06-02,Peru,NA,Huancavelica,347639,5,0,576,2
2020-06-03,Peru,NA,Huancavelica,347639,29,1,605,3
2020-06-04,Peru,NA,Huancavelica,347639,15,0,620,3
2020-06-05,Peru,NA,Huancavelica,347639,7,0,627,3
2020-06-06,Peru,NA,Huancavelica,347639,11,2,638,5
2020-06-07,Peru,NA,Huancavelica,347639,13,0,651,5
2020-06-08,Peru,NA,Huancavelica,347639,13,1,664,6
2020-06-09,Peru,NA,Huancavelica,347639,16,0,680,6
2020-06-10,Peru,NA,Huancavelica,347639,17,0,697,6
2020-06-11,Peru,NA,Huancavelica,347639,17,0,714,6
2020-06-12,Peru,NA,Huancavelica,347639,13,0,727,6
2020-06-13,Peru,NA,Huancavelica,347639,12,1,739,7
2020-06-14,Peru,NA,Huancavelica,347639,6,0,745,7
2020-06-15,Peru,NA,Huancavelica,347639,14,2,759,9
2020-06-16,Peru,NA,Huancavelica,347639,3,2,762,11
2020-06-17,Peru,NA,Huancavelica,347639,4,0,766,11
2020-06-18,Peru,NA,Huancavelica,347639,3,0,769,11
2020-06-19,Peru,NA,Huancavelica,347639,7,0,776,11
2020-06-20,Peru,NA,Huancavelica,347639,11,0,787,11
2020-06-21,Peru,NA,Huancavelica,347639,4,0,791,11
2020-06-22,Peru,NA,Huancavelica,347639,6,0,797,11
2020-06-23,Peru,NA,Huancavelica,347639,13,1,810,12
2020-06-24,Peru,NA,Huancavelica,347639,19,0,829,12
2020-06-25,Peru,NA,Huancavelica,347639,11,1,840,13
2020-06-26,Peru,NA,Huancavelica,347639,4,0,844,13
2020-06-27,Peru,NA,Huancavelica,347639,25,0,869,13
2020-06-28,Peru,NA,Huancavelica,347639,8,0,877,13
2020-06-29,Peru,NA,Huancavelica,347639,15,0,892,13
2020-06-30,Peru,NA,Huancavelica,347639,7,1,899,14
2020-07-01,Peru,NA,Huancavelica,347639,11,0,910,14
2020-07-02,Peru,NA,Huancavelica,347639,11,1,921,15
2020-07-03,Peru,NA,Huancavelica,347639,15,0,936,15
2020-07-04,Peru,NA,Huancavelica,347639,18,2,954,17
2020-07-05,Peru,NA,Huancavelica,347639,24,1,978,18
2020-07-06,Peru,NA,Huancavelica,347639,24,2,1002,20
2020-07-07,Peru,NA,Huancavelica,347639,14,1,1016,21
2020-07-08,Peru,NA,Huancavelica,347639,11,3,1027,24
2020-07-09,Peru,NA,Huancavelica,347639,9,2,1036,26
2020-07-10,Peru,NA,Huancavelica,347639,20,0,1056,26
2020-07-11,Peru,NA,Huancavelica,347639,16,0,1072,26
2020-07-12,Peru,NA,Huancavelica,347639,24,0,1096,26
2020-07-13,Peru,NA,Huancavelica,347639,15,0,1111,26
2020-07-14,Peru,NA,Huancavelica,347639,19,0,1130,26
2020-07-15,Peru,NA,Huancavelica,347639,10,0,1140,26
2020-07-16,Peru,NA,Huancavelica,347639,18,2,1158,28
2020-07-17,Peru,NA,Huancavelica,347639,49,1,1207,29
2020-07-18,Peru,NA,Huancavelica,347639,27,0,1234,29
2020-07-19,Peru,NA,Huancavelica,347639,17,1,1251,30
2020-07-20,Peru,NA,Huancavelica,347639,42,0,1293,30
2020-07-21,Peru,NA,Huancavelica,347639,6,2,1299,32
2020-07-22,Peru,NA,Huancavelica,347639,59,0,1358,32
2020-07-23,Peru,NA,Huancavelica,347639,64,2,1422,34
2020-07-24,Peru,NA,Huancavelica,347639,32,0,1454,34
2020-07-25,Peru,NA,Huancavelica,347639,39,3,1493,37
2020-07-26,Peru,NA,Huancavelica,347639,31,1,1524,38
2020-07-27,Peru,NA,Huancavelica,347639,42,0,1566,38
2020-07-28,Peru,NA,Huancavelica,347639,40,0,1606,38
2020-07-29,Peru,NA,Huancavelica,347639,102,1,1708,39
2020-07-30,Peru,NA,Huancavelica,347639,57,0,1765,39
2020-07-31,Peru,NA,Huancavelica,347639,71,0,1836,39
2020-08-01,Peru,NA,Huancavelica,347639,80,0,1916,39
2020-08-02,Peru,NA,Huancavelica,347639,26,1,1942,40
2020-08-03,Peru,NA,Huancavelica,347639,63,0,2005,40
2020-08-04,Peru,NA,Huancavelica,347639,91,0,2096,40
2020-08-05,Peru,NA,Huancavelica,347639,91,0,2187,40
2020-08-06,Peru,NA,Huancavelica,347639,106,2,2293,42
2020-08-07,Peru,NA,Huancavelica,347639,139,0,2432,42
2020-08-08,Peru,NA,Huancavelica,347639,120,2,2552,44
2020-08-09,Peru,NA,Huancavelica,347639,30,1,2582,45
2020-08-10,Peru,NA,Huancavelica,347639,85,5,2667,50
2020-08-11,Peru,NA,Huancavelica,347639,140,1,2807,51
2020-08-12,Peru,NA,Huancavelica,347639,162,2,2969,53
2020-08-13,Peru,NA,Huancavelica,347639,172,5,3141,58
2020-08-14,Peru,NA,Huancavelica,347639,127,2,3268,60
2020-08-15,Peru,NA,Huancavelica,347639,157,0,3425,60
2020-08-16,Peru,NA,Huancavelica,347639,69,2,3494,62
2020-08-17,Peru,NA,Huancavelica,347639,155,0,3649,62
2020-08-18,Peru,NA,Huancavelica,347639,153,1,3802,63
2020-08-19,Peru,NA,Huancavelica,347639,208,0,4010,63
2020-08-20,Peru,NA,Huancavelica,347639,133,1,4143,64
2020-08-21,Peru,NA,Huancavelica,347639,108,2,4251,66
2020-08-22,Peru,NA,Huancavelica,347639,71,3,4322,69
2020-08-23,Peru,NA,Huancavelica,347639,10,4,4332,73
2020-08-24,Peru,NA,Huancavelica,347639,80,4,4412,77
2020-08-25,Peru,NA,Huancavelica,347639,147,0,4559,77
2020-08-26,Peru,NA,Huancavelica,347639,99,0,4658,77
2020-08-27,Peru,NA,Huancavelica,347639,40,3,4698,80
2020-08-28,Peru,NA,Huancavelica,347639,71,2,4769,82
2020-08-29,Peru,NA,Huancavelica,347639,66,2,4835,84
2020-08-30,Peru,NA,Huancavelica,347639,69,0,4904,84
2020-08-31,Peru,NA,Huancavelica,347639,60,0,4964,84
2020-09-01,Peru,NA,Huancavelica,347639,70,3,5034,87
2020-09-02,Peru,NA,Huancavelica,347639,88,0,5122,87
2020-09-03,Peru,NA,Huancavelica,347639,17,1,5139,88
2020-09-04,Peru,NA,Huancavelica,347639,198,1,5337,89
2020-09-05,Peru,NA,Huancavelica,347639,8,1,5345,90
2020-09-06,Peru,NA,Huancavelica,347639,9,1,5354,91
2020-09-07,Peru,NA,Huancavelica,347639,97,1,5451,92
2020-09-08,Peru,NA,Huancavelica,347639,106,1,5557,93
2020-09-09,Peru,NA,Huancavelica,347639,121,1,5678,94
2020-09-10,Peru,NA,Huancavelica,347639,11,0,5689,94
2020-09-11,Peru,NA,Huancavelica,347639,86,0,5775,94
2020-09-12,Peru,NA,Huancavelica,347639,67,4,5842,98
2020-09-13,Peru,NA,Huancavelica,347639,35,2,5877,100
2020-09-14,Peru,NA,Huancavelica,347639,93,0,5970,100
2020-09-15,Peru,NA,Huancavelica,347639,43,0,6013,100
2020-09-16,Peru,NA,Huancavelica,347639,53,3,6066,103
2020-09-17,Peru,NA,Huancavelica,347639,88,0,6154,103
2020-09-18,Peru,NA,Huancavelica,347639,69,1,6223,104
2020-09-19,Peru,NA,Huancavelica,347639,70,1,6293,105
2020-09-20,Peru,NA,Huancavelica,347639,18,2,6311,107
2020-09-21,Peru,NA,Huancavelica,347639,55,1,6366,108
2020-09-22,Peru,NA,Huancavelica,347639,12,0,6378,108
2020-04-07,Peru,NA,Huanuco,721047,2,0,12,1
2020-04-08,Peru,NA,Huanuco,721047,5,0,17,1
2020-04-09,Peru,NA,Huanuco,721047,7,0,24,1
2020-04-10,Peru,NA,Huanuco,721047,3,0,27,1
2020-04-11,Peru,NA,Huanuco,721047,7,0,34,1
2020-04-12,Peru,NA,Huanuco,721047,4,0,38,1
2020-04-13,Peru,NA,Huanuco,721047,5,0,43,1
2020-04-14,Peru,NA,Huanuco,721047,10,0,53,1
2020-04-15,Peru,NA,Huanuco,721047,14,0,67,1
2020-04-16,Peru,NA,Huanuco,721047,11,0,78,1
2020-04-17,Peru,NA,Huanuco,721047,38,0,116,1
2020-04-18,Peru,NA,Huanuco,721047,20,0,136,1
2020-04-19,Peru,NA,Huanuco,721047,4,0,140,1
2020-04-20,Peru,NA,Huanuco,721047,7,0,147,1
2020-04-21,Peru,NA,Huanuco,721047,10,0,157,1
2020-04-22,Peru,NA,Huanuco,721047,5,0,162,1
2020-04-23,Peru,NA,Huanuco,721047,9,0,171,1
2020-04-24,Peru,NA,Huanuco,721047,9,0,180,1
2020-04-25,Peru,NA,Huanuco,721047,48,0,228,1
2020-04-26,Peru,NA,Huanuco,721047,6,0,234,1
2020-04-27,Peru,NA,Huanuco,721047,20,0,254,1
2020-04-28,Peru,NA,Huanuco,721047,15,0,269,1
2020-04-29,Peru,NA,Huanuco,721047,13,0,282,1
2020-04-30,Peru,NA,Huanuco,721047,19,1,301,2
2020-05-01,Peru,NA,Huanuco,721047,8,1,309,3
2020-05-02,Peru,NA,Huanuco,721047,3,1,312,4
2020-05-03,Peru,NA,Huanuco,721047,4,0,316,4
2020-05-04,Peru,NA,Huanuco,721047,16,1,332,5
2020-05-05,Peru,NA,Huanuco,721047,10,3,342,8
2020-05-06,Peru,NA,Huanuco,721047,11,1,353,9
2020-05-07,Peru,NA,Huanuco,721047,12,1,365,10
2020-05-08,Peru,NA,Huanuco,721047,5,0,370,10
2020-05-09,Peru,NA,Huanuco,721047,13,1,383,11
2020-05-10,Peru,NA,Huanuco,721047,2,0,385,11
2020-05-11,Peru,NA,Huanuco,721047,16,0,401,11
2020-05-12,Peru,NA,Huanuco,721047,13,0,414,11
2020-05-13,Peru,NA,Huanuco,721047,62,0,476,11
2020-05-14,Peru,NA,Huanuco,721047,26,0,502,11
2020-05-15,Peru,NA,Huanuco,721047,23,1,525,12
2020-05-16,Peru,NA,Huanuco,721047,8,1,533,13
2020-05-17,Peru,NA,Huanuco,721047,5,2,538,15
2020-05-18,Peru,NA,Huanuco,721047,17,0,555,15
2020-05-19,Peru,NA,Huanuco,721047,20,1,575,16
2020-05-20,Peru,NA,Huanuco,721047,17,2,592,18
2020-05-21,Peru,NA,Huanuco,721047,10,3,602,21
2020-05-22,Peru,NA,Huanuco,721047,36,2,638,23
2020-05-23,Peru,NA,Huanuco,721047,22,1,660,24
2020-05-24,Peru,NA,Huanuco,721047,7,0,667,24
2020-05-25,Peru,NA,Huanuco,721047,30,1,697,25
2020-05-26,Peru,NA,Huanuco,721047,21,1,718,26
2020-05-27,Peru,NA,Huanuco,721047,32,4,750,30
2020-05-28,Peru,NA,Huanuco,721047,24,2,774,32
2020-05-29,Peru,NA,Huanuco,721047,33,2,807,34
2020-05-30,Peru,NA,Huanuco,721047,10,2,817,36
2020-05-31,Peru,NA,Huanuco,721047,9,1,826,37
2020-06-01,Peru,NA,Huanuco,721047,19,0,845,37
2020-06-02,Peru,NA,Huanuco,721047,28,1,873,38
2020-06-03,Peru,NA,Huanuco,721047,38,0,911,38
2020-06-04,Peru,NA,Huanuco,721047,80,3,991,41
2020-06-05,Peru,NA,Huanuco,721047,43,2,1034,43
2020-06-06,Peru,NA,Huanuco,721047,15,4,1049,47
2020-06-07,Peru,NA,Huanuco,721047,14,3,1063,50
2020-06-08,Peru,NA,Huanuco,721047,43,4,1106,54
2020-06-09,Peru,NA,Huanuco,721047,35,3,1141,57
2020-06-10,Peru,NA,Huanuco,721047,36,5,1177,62
2020-06-11,Peru,NA,Huanuco,721047,95,3,1272,65
2020-06-12,Peru,NA,Huanuco,721047,52,3,1324,68
2020-06-13,Peru,NA,Huanuco,721047,49,2,1373,70
2020-06-14,Peru,NA,Huanuco,721047,23,4,1396,74
2020-06-15,Peru,NA,Huanuco,721047,63,5,1459,79
2020-06-16,Peru,NA,Huanuco,721047,37,5,1496,84
2020-06-17,Peru,NA,Huanuco,721047,43,5,1539,89
2020-06-18,Peru,NA,Huanuco,721047,71,2,1610,91
2020-06-19,Peru,NA,Huanuco,721047,61,6,1671,97
2020-06-20,Peru,NA,Huanuco,721047,40,3,1711,100
2020-06-21,Peru,NA,Huanuco,721047,25,8,1736,108
2020-06-22,Peru,NA,Huanuco,721047,34,4,1770,112
2020-06-23,Peru,NA,Huanuco,721047,46,3,1816,115
2020-06-24,Peru,NA,Huanuco,721047,75,5,1891,120
2020-06-25,Peru,NA,Huanuco,721047,59,4,1950,124
2020-06-26,Peru,NA,Huanuco,721047,51,6,2001,130
2020-06-27,Peru,NA,Huanuco,721047,99,3,2100,133
2020-06-28,Peru,NA,Huanuco,721047,81,3,2181,136
2020-06-29,Peru,NA,Huanuco,721047,79,10,2260,146
2020-06-30,Peru,NA,Huanuco,721047,95,0,2355,146
2020-07-01,Peru,NA,Huanuco,721047,83,5,2438,151
2020-07-02,Peru,NA,Huanuco,721047,71,3,2509,154
2020-07-03,Peru,NA,Huanuco,721047,207,3,2716,157
2020-07-04,Peru,NA,Huanuco,721047,243,5,2959,162
2020-07-05,Peru,NA,Huanuco,721047,37,3,2996,165
2020-07-06,Peru,NA,Huanuco,721047,114,4,3110,169
2020-07-07,Peru,NA,Huanuco,721047,157,3,3267,172
2020-07-08,Peru,NA,Huanuco,721047,44,2,3311,174
2020-07-09,Peru,NA,Huanuco,721047,122,2,3433,176
2020-07-10,Peru,NA,Huanuco,721047,121,3,3554,179
2020-07-11,Peru,NA,Huanuco,721047,236,2,3790,181
2020-07-12,Peru,NA,Huanuco,721047,185,9,3975,190
2020-07-13,Peru,NA,Huanuco,721047,76,6,4051,196
2020-07-14,Peru,NA,Huanuco,721047,199,5,4250,201
2020-07-15,Peru,NA,Huanuco,721047,113,5,4363,206
2020-07-16,Peru,NA,Huanuco,721047,145,5,4508,211
2020-07-17,Peru,NA,Huanuco,721047,210,3,4718,214
2020-07-18,Peru,NA,Huanuco,721047,215,4,4933,218
2020-07-19,Peru,NA,Huanuco,721047,88,2,5021,220
2020-07-20,Peru,NA,Huanuco,721047,60,3,5081,223
2020-07-21,Peru,NA,Huanuco,721047,126,5,5207,228
2020-07-22,Peru,NA,Huanuco,721047,141,2,5348,230
2020-07-23,Peru,NA,Huanuco,721047,133,5,5481,235
2020-07-24,Peru,NA,Huanuco,721047,251,3,5732,238
2020-07-25,Peru,NA,Huanuco,721047,134,4,5866,242
2020-07-26,Peru,NA,Huanuco,721047,57,2,5923,244
2020-07-27,Peru,NA,Huanuco,721047,244,1,6167,245
2020-07-28,Peru,NA,Huanuco,721047,171,0,6338,245
2020-07-29,Peru,NA,Huanuco,721047,272,2,6610,247
2020-07-30,Peru,NA,Huanuco,721047,268,2,6878,249
2020-07-31,Peru,NA,Huanuco,721047,196,1,7074,250
2020-08-01,Peru,NA,Huanuco,721047,214,2,7288,252
2020-08-02,Peru,NA,Huanuco,721047,134,1,7422,253
2020-08-03,Peru,NA,Huanuco,721047,202,6,7624,259
2020-08-04,Peru,NA,Huanuco,721047,183,6,7807,265
2020-08-05,Peru,NA,Huanuco,721047,211,1,8018,266
2020-08-06,Peru,NA,Huanuco,721047,166,2,8184,268
2020-08-07,Peru,NA,Huanuco,721047,204,7,8388,275
2020-08-08,Peru,NA,Huanuco,721047,165,3,8553,278
2020-08-09,Peru,NA,Huanuco,721047,139,2,8692,280
2020-08-10,Peru,NA,Huanuco,721047,226,3,8918,283
2020-08-11,Peru,NA,Huanuco,721047,220,0,9138,283
2020-08-12,Peru,NA,Huanuco,721047,195,1,9333,284
2020-08-13,Peru,NA,Huanuco,721047,254,1,9587,285
2020-08-14,Peru,NA,Huanuco,721047,339,7,9926,292
2020-08-15,Peru,NA,Huanuco,721047,502,2,10428,294
2020-08-16,Peru,NA,Huanuco,721047,109,1,10537,295
2020-08-17,Peru,NA,Huanuco,721047,201,1,10738,296
2020-08-18,Peru,NA,Huanuco,721047,224,5,10962,301
2020-08-19,Peru,NA,Huanuco,721047,213,4,11175,305
2020-08-20,Peru,NA,Huanuco,721047,249,1,11424,306
2020-08-21,Peru,NA,Huanuco,721047,227,3,11651,309
2020-08-22,Peru,NA,Huanuco,721047,168,3,11819,312
2020-08-23,Peru,NA,Huanuco,721047,33,4,11852,316
2020-08-24,Peru,NA,Huanuco,721047,251,2,12103,318
2020-08-25,Peru,NA,Huanuco,721047,307,1,12410,319
2020-08-26,Peru,NA,Huanuco,721047,145,2,12555,321
2020-08-27,Peru,NA,Huanuco,721047,136,3,12691,324
2020-08-28,Peru,NA,Huanuco,721047,191,0,12882,324
2020-08-29,Peru,NA,Huanuco,721047,164,3,13046,327
2020-08-30,Peru,NA,Huanuco,721047,40,4,13086,331
2020-08-31,Peru,NA,Huanuco,721047,169,2,13255,333
2020-09-01,Peru,NA,Huanuco,721047,131,2,13386,335
2020-09-02,Peru,NA,Huanuco,721047,151,4,13537,339
2020-09-03,Peru,NA,Huanuco,721047,44,5,13581,344
2020-09-04,Peru,NA,Huanuco,721047,217,0,13798,344
2020-09-05,Peru,NA,Huanuco,721047,28,2,13826,346
2020-09-06,Peru,NA,Huanuco,721047,48,1,13874,347
2020-09-07,Peru,NA,Huanuco,721047,110,0,13984,347
2020-09-08,Peru,NA,Huanuco,721047,96,1,14080,348
2020-09-09,Peru,NA,Huanuco,721047,114,6,14194,354
2020-09-10,Peru,NA,Huanuco,721047,44,3,14238,357
2020-09-11,Peru,NA,Huanuco,721047,181,0,14419,357
2020-09-12,Peru,NA,Huanuco,721047,151,1,14570,358
2020-09-13,Peru,NA,Huanuco,721047,58,0,14628,358
2020-09-14,Peru,NA,Huanuco,721047,163,3,14791,361
2020-09-15,Peru,NA,Huanuco,721047,111,3,14902,364
2020-09-16,Peru,NA,Huanuco,721047,164,2,15066,366
2020-09-17,Peru,NA,Huanuco,721047,133,0,15199,366
2020-09-18,Peru,NA,Huanuco,721047,101,0,15300,366
2020-09-19,Peru,NA,Huanuco,721047,73,2,15373,368
2020-09-20,Peru,NA,Huanuco,721047,27,0,15400,368
2020-09-21,Peru,NA,Huanuco,721047,98,1,15498,369
2020-09-22,Peru,NA,Huanuco,721047,17,0,15515,369
2020-04-03,Peru,NA,Ica,850765,4,1,12,2
2020-04-04,Peru,NA,Ica,850765,5,1,17,3
2020-04-05,Peru,NA,Ica,850765,4,0,21,4
2020-04-06,Peru,NA,Ica,850765,7,0,28,5
2020-04-07,Peru,NA,Ica,850765,9,0,37,5
2020-04-08,Peru,NA,Ica,850765,9,0,46,5
2020-04-09,Peru,NA,Ica,850765,5,2,51,7
2020-04-10,Peru,NA,Ica,850765,15,1,66,8
2020-04-11,Peru,NA,Ica,850765,20,2,86,10
2020-04-12,Peru,NA,Ica,850765,3,1,89,11
2020-04-13,Peru,NA,Ica,850765,27,3,116,14
2020-04-14,Peru,NA,Ica,850765,6,2,122,16
2020-04-15,Peru,NA,Ica,850765,14,1,136,17
2020-04-16,Peru,NA,Ica,850765,23,1,159,18
2020-04-17,Peru,NA,Ica,850765,22,2,181,20
2020-04-18,Peru,NA,Ica,850765,19,1,200,21
2020-04-19,Peru,NA,Ica,850765,4,2,204,23
2020-04-20,Peru,NA,Ica,850765,28,1,232,24
2020-04-21,Peru,NA,Ica,850765,22,2,254,26
2020-04-22,Peru,NA,Ica,850765,32,5,286,31
2020-04-23,Peru,NA,Ica,850765,34,5,320,36
2020-04-24,Peru,NA,Ica,850765,16,2,336,38
2020-04-25,Peru,NA,Ica,850765,30,5,366,43
2020-04-26,Peru,NA,Ica,850765,10,3,376,46
2020-04-27,Peru,NA,Ica,850765,51,3,427,49
2020-04-28,Peru,NA,Ica,850765,92,5,519,54
2020-04-29,Peru,NA,Ica,850765,134,3,653,57
2020-04-30,Peru,NA,Ica,850765,53,9,706,66
2020-05-01,Peru,NA,Ica,850765,38,7,744,73
2020-05-02,Peru,NA,Ica,850765,53,4,797,77
2020-05-03,Peru,NA,Ica,850765,31,8,828,85
2020-05-04,Peru,NA,Ica,850765,70,8,898,93
2020-05-05,Peru,NA,Ica,850765,47,6,945,99
2020-05-06,Peru,NA,Ica,850765,65,8,1010,107
2020-05-07,Peru,NA,Ica,850765,78,6,1088,113
2020-05-08,Peru,NA,Ica,850765,102,8,1190,121
2020-05-09,Peru,NA,Ica,850765,39,3,1229,124
2020-05-10,Peru,NA,Ica,850765,12,3,1241,127
2020-05-11,Peru,NA,Ica,850765,43,14,1284,141
2020-05-12,Peru,NA,Ica,850765,98,5,1382,146
2020-05-13,Peru,NA,Ica,850765,77,6,1459,152
2020-05-14,Peru,NA,Ica,850765,90,5,1549,157
2020-05-15,Peru,NA,Ica,850765,104,6,1653,163
2020-05-16,Peru,NA,Ica,850765,122,6,1775,169
2020-05-17,Peru,NA,Ica,850765,34,4,1809,173
2020-05-18,Peru,NA,Ica,850765,184,11,1993,184
2020-05-19,Peru,NA,Ica,850765,95,12,2088,196
2020-05-20,Peru,NA,Ica,850765,107,12,2195,208
2020-05-21,Peru,NA,Ica,850765,178,7,2373,215
2020-05-22,Peru,NA,Ica,850765,108,15,2481,230
2020-05-23,Peru,NA,Ica,850765,92,3,2573,233
2020-05-24,Peru,NA,Ica,850765,20,15,2593,248
2020-05-25,Peru,NA,Ica,850765,248,14,2841,262
2020-05-26,Peru,NA,Ica,850765,170,14,3011,276
2020-05-27,Peru,NA,Ica,850765,210,6,3221,282
2020-05-28,Peru,NA,Ica,850765,132,13,3353,295
2020-05-29,Peru,NA,Ica,850765,297,18,3650,313
2020-05-30,Peru,NA,Ica,850765,108,12,3758,325
2020-05-31,Peru,NA,Ica,850765,28,16,3786,341
2020-06-01,Peru,NA,Ica,850765,178,23,3964,364
2020-06-02,Peru,NA,Ica,850765,195,11,4159,375
2020-06-03,Peru,NA,Ica,850765,131,25,4290,400
2020-06-04,Peru,NA,Ica,850765,101,24,4391,424
2020-06-05,Peru,NA,Ica,850765,107,14,4498,438
2020-06-06,Peru,NA,Ica,850765,150,19,4648,457
2020-06-07,Peru,NA,Ica,850765,78,13,4726,470
2020-06-08,Peru,NA,Ica,850765,159,15,4885,485
2020-06-09,Peru,NA,Ica,850765,152,16,5037,501
2020-06-10,Peru,NA,Ica,850765,190,23,5227,524
2020-06-11,Peru,NA,Ica,850765,169,18,5396,542
2020-06-12,Peru,NA,Ica,850765,188,14,5584,556
2020-06-13,Peru,NA,Ica,850765,153,22,5737,578
2020-06-14,Peru,NA,Ica,850765,28,23,5765,601
2020-06-15,Peru,NA,Ica,850765,124,12,5889,613
2020-06-16,Peru,NA,Ica,850765,89,26,5978,639
2020-06-17,Peru,NA,Ica,850765,172,20,6150,659
2020-06-18,Peru,NA,Ica,850765,79,23,6229,682
2020-06-19,Peru,NA,Ica,850765,106,16,6335,698
2020-06-20,Peru,NA,Ica,850765,124,30,6459,728
2020-06-21,Peru,NA,Ica,850765,44,23,6503,751
2020-06-22,Peru,NA,Ica,850765,203,20,6706,771
2020-06-23,Peru,NA,Ica,850765,167,20,6873,791
2020-06-24,Peru,NA,Ica,850765,146,21,7019,812
2020-06-25,Peru,NA,Ica,850765,142,23,7161,835
2020-06-26,Peru,NA,Ica,850765,211,16,7372,851
2020-06-27,Peru,NA,Ica,850765,157,14,7529,865
2020-06-28,Peru,NA,Ica,850765,96,18,7625,883
2020-06-29,Peru,NA,Ica,850765,133,16,7758,899
2020-06-30,Peru,NA,Ica,850765,102,18,7860,917
2020-07-01,Peru,NA,Ica,850765,182,12,8042,929
2020-07-02,Peru,NA,Ica,850765,173,6,8215,935
2020-07-03,Peru,NA,Ica,850765,184,11,8399,946
2020-07-04,Peru,NA,Ica,850765,176,16,8575,962
2020-07-05,Peru,NA,Ica,850765,134,10,8709,972
2020-07-06,Peru,NA,Ica,850765,192,12,8901,984
2020-07-07,Peru,NA,Ica,850765,160,15,9061,999
2020-07-08,Peru,NA,Ica,850765,100,8,9161,1007
2020-07-09,Peru,NA,Ica,850765,116,12,9277,1019
2020-07-10,Peru,NA,Ica,850765,192,14,9469,1033
2020-07-11,Peru,NA,Ica,850765,155,16,9624,1049
2020-07-12,Peru,NA,Ica,850765,56,13,9680,1062
2020-07-13,Peru,NA,Ica,850765,97,10,9777,1072
2020-07-14,Peru,NA,Ica,850765,178,14,9955,1086
2020-07-15,Peru,NA,Ica,850765,203,8,10158,1094
2020-07-16,Peru,NA,Ica,850765,210,10,10368,1104
2020-07-17,Peru,NA,Ica,850765,334,11,10702,1115
2020-07-18,Peru,NA,Ica,850765,260,7,10962,1122
2020-07-19,Peru,NA,Ica,850765,59,9,11021,1131
2020-07-20,Peru,NA,Ica,850765,101,10,11122,1141
2020-07-21,Peru,NA,Ica,850765,200,9,11322,1150
2020-07-22,Peru,NA,Ica,850765,263,7,11585,1157
2020-07-23,Peru,NA,Ica,850765,421,10,12006,1167
2020-07-24,Peru,NA,Ica,850765,219,6,12225,1173
2020-07-25,Peru,NA,Ica,850765,249,5,12474,1178
2020-07-26,Peru,NA,Ica,850765,84,6,12558,1184
2020-07-27,Peru,NA,Ica,850765,255,11,12813,1195
2020-07-28,Peru,NA,Ica,850765,113,7,12926,1202
2020-07-29,Peru,NA,Ica,850765,168,10,13094,1212
2020-07-30,Peru,NA,Ica,850765,225,7,13319,1219
2020-07-31,Peru,NA,Ica,850765,328,10,13647,1229
2020-08-01,Peru,NA,Ica,850765,225,11,13872,1240
2020-08-02,Peru,NA,Ica,850765,57,11,13929,1251
2020-08-03,Peru,NA,Ica,850765,325,12,14254,1263
2020-08-04,Peru,NA,Ica,850765,296,13,14550,1276
2020-08-05,Peru,NA,Ica,850765,301,12,14851,1288
2020-08-06,Peru,NA,Ica,850765,412,11,15263,1299
2020-08-07,Peru,NA,Ica,850765,318,11,15581,1310
2020-08-08,Peru,NA,Ica,850765,268,7,15849,1317
2020-08-09,Peru,NA,Ica,850765,106,7,15955,1324
2020-08-10,Peru,NA,Ica,850765,487,11,16442,1335
2020-08-11,Peru,NA,Ica,850765,304,6,16746,1341
2020-08-12,Peru,NA,Ica,850765,277,6,17023,1347
2020-08-13,Peru,NA,Ica,850765,282,1,17305,1348
2020-08-14,Peru,NA,Ica,850765,261,5,17566,1353
2020-08-15,Peru,NA,Ica,850765,167,5,17733,1358
2020-08-16,Peru,NA,Ica,850765,115,13,17848,1371
2020-08-17,Peru,NA,Ica,850765,304,12,18152,1383
2020-08-18,Peru,NA,Ica,850765,275,6,18427,1389
2020-08-19,Peru,NA,Ica,850765,332,2,18759,1391
2020-08-20,Peru,NA,Ica,850765,361,14,19120,1405
2020-08-21,Peru,NA,Ica,850765,406,6,19526,1411
2020-08-22,Peru,NA,Ica,850765,286,7,19812,1418
2020-08-23,Peru,NA,Ica,850765,15,3,19827,1421
2020-08-24,Peru,NA,Ica,850765,335,5,20162,1426
2020-08-25,Peru,NA,Ica,850765,566,3,20728,1429
2020-08-26,Peru,NA,Ica,850765,261,5,20989,1434
2020-08-27,Peru,NA,Ica,850765,324,7,21313,1441
2020-08-28,Peru,NA,Ica,850765,293,5,21606,1446
2020-08-29,Peru,NA,Ica,850765,299,5,21905,1451
2020-08-30,Peru,NA,Ica,850765,62,4,21967,1455
2020-08-31,Peru,NA,Ica,850765,189,2,22156,1457
2020-09-01,Peru,NA,Ica,850765,201,7,22357,1464
2020-09-02,Peru,NA,Ica,850765,237,6,22594,1470
2020-09-03,Peru,NA,Ica,850765,133,11,22727,1481
2020-09-04,Peru,NA,Ica,850765,554,3,23281,1484
2020-09-05,Peru,NA,Ica,850765,149,2,23430,1486
2020-09-06,Peru,NA,Ica,850765,56,5,23486,1491
2020-09-07,Peru,NA,Ica,850765,298,6,23784,1497
2020-09-08,Peru,NA,Ica,850765,249,5,24033,1502
2020-09-09,Peru,NA,Ica,850765,263,1,24296,1503
2020-09-10,Peru,NA,Ica,850765,56,7,24352,1510
2020-09-11,Peru,NA,Ica,850765,333,7,24685,1517
2020-09-12,Peru,NA,Ica,850765,182,6,24867,1523
2020-09-13,Peru,NA,Ica,850765,31,2,24898,1525
2020-09-14,Peru,NA,Ica,850765,185,5,25083,1530
2020-09-15,Peru,NA,Ica,850765,208,5,25291,1535
2020-09-16,Peru,NA,Ica,850765,225,5,25516,1540
2020-09-17,Peru,NA,Ica,850765,202,6,25718,1546
2020-09-18,Peru,NA,Ica,850765,309,3,26027,1549
2020-09-19,Peru,NA,Ica,850765,166,4,26193,1553
2020-09-20,Peru,NA,Ica,850765,26,7,26219,1560
2020-09-21,Peru,NA,Ica,850765,180,2,26399,1562
2020-09-22,Peru,NA,Ica,850765,9,4,26408,1566
2020-03-26,Peru,NA,Junin,1246038,1,0,11,0
2020-03-28,Peru,NA,Junin,1246038,1,0,12,0
2020-03-30,Peru,NA,Junin,1246038,4,1,16,1
2020-04-01,Peru,NA,Junin,1246038,2,0,18,1
2020-04-03,Peru,NA,Junin,1246038,8,0,26,1
2020-04-04,Peru,NA,Junin,1246038,0,1,26,2
2020-04-05,Peru,NA,Junin,1246038,4,0,30,2
2020-04-07,Peru,NA,Junin,1246038,13,0,43,2
2020-04-08,Peru,NA,Junin,1246038,2,0,45,2
2020-04-09,Peru,NA,Junin,1246038,14,0,59,2
2020-04-10,Peru,NA,Junin,1246038,2,0,61,2
2020-04-11,Peru,NA,Junin,1246038,8,0,69,2
2020-04-12,Peru,NA,Junin,1246038,4,0,73,2
2020-04-13,Peru,NA,Junin,1246038,9,1,82,3
2020-04-14,Peru,NA,Junin,1246038,33,2,115,5
2020-04-15,Peru,NA,Junin,1246038,12,0,127,5
2020-04-16,Peru,NA,Junin,1246038,28,0,155,5
2020-04-17,Peru,NA,Junin,1246038,20,0,175,5
2020-04-18,Peru,NA,Junin,1246038,14,2,189,7
2020-04-19,Peru,NA,Junin,1246038,5,1,194,8
2020-04-20,Peru,NA,Junin,1246038,19,0,213,8
2020-04-21,Peru,NA,Junin,1246038,28,0,241,8
2020-04-22,Peru,NA,Junin,1246038,20,1,261,9
2020-04-23,Peru,NA,Junin,1246038,22,1,283,10
2020-04-24,Peru,NA,Junin,1246038,11,0,294,10
2020-04-25,Peru,NA,Junin,1246038,15,1,309,11
2020-04-26,Peru,NA,Junin,1246038,12,2,321,13
2020-04-27,Peru,NA,Junin,1246038,33,1,354,14
2020-04-28,Peru,NA,Junin,1246038,43,0,397,14
2020-04-29,Peru,NA,Junin,1246038,45,0,442,14
2020-04-30,Peru,NA,Junin,1246038,66,0,508,14
2020-05-01,Peru,NA,Junin,1246038,26,0,534,14
2020-05-02,Peru,NA,Junin,1246038,55,2,589,16
2020-05-03,Peru,NA,Junin,1246038,48,1,637,17
2020-05-04,Peru,NA,Junin,1246038,49,3,686,20
2020-05-05,Peru,NA,Junin,1246038,69,0,755,20
2020-05-06,Peru,NA,Junin,1246038,57,0,812,20
2020-05-07,Peru,NA,Junin,1246038,63,0,875,20
2020-05-08,Peru,NA,Junin,1246038,41,4,916,24
2020-05-09,Peru,NA,Junin,1246038,35,3,951,27
2020-05-10,Peru,NA,Junin,1246038,18,6,969,33
2020-05-11,Peru,NA,Junin,1246038,44,2,1013,35
2020-05-12,Peru,NA,Junin,1246038,38,2,1051,37
2020-05-13,Peru,NA,Junin,1246038,74,3,1125,40
2020-05-14,Peru,NA,Junin,1246038,29,0,1154,40
2020-05-15,Peru,NA,Junin,1246038,48,1,1202,41
2020-05-16,Peru,NA,Junin,1246038,43,1,1245,42
2020-05-17,Peru,NA,Junin,1246038,8,5,1253,47
2020-05-18,Peru,NA,Junin,1246038,102,3,1355,50
2020-05-19,Peru,NA,Junin,1246038,41,1,1396,51
2020-05-20,Peru,NA,Junin,1246038,46,3,1442,54
2020-05-21,Peru,NA,Junin,1246038,39,3,1481,57
2020-05-22,Peru,NA,Junin,1246038,54,2,1535,59
2020-05-23,Peru,NA,Junin,1246038,38,1,1573,60
2020-05-24,Peru,NA,Junin,1246038,21,1,1594,61
2020-05-25,Peru,NA,Junin,1246038,51,2,1645,63
2020-05-26,Peru,NA,Junin,1246038,53,3,1698,66
2020-05-27,Peru,NA,Junin,1246038,90,4,1788,70
2020-05-28,Peru,NA,Junin,1246038,68,1,1856,71
2020-05-29,Peru,NA,Junin,1246038,76,3,1932,74
2020-05-30,Peru,NA,Junin,1246038,48,3,1980,77
2020-05-31,Peru,NA,Junin,1246038,15,2,1995,79
2020-06-01,Peru,NA,Junin,1246038,47,2,2042,81
2020-06-02,Peru,NA,Junin,1246038,67,1,2109,82
2020-06-03,Peru,NA,Junin,1246038,46,3,2155,85
2020-06-04,Peru,NA,Junin,1246038,31,3,2186,88
2020-06-05,Peru,NA,Junin,1246038,28,3,2214,91
2020-06-06,Peru,NA,Junin,1246038,50,2,2264,93
2020-06-07,Peru,NA,Junin,1246038,41,2,2305,95
2020-06-08,Peru,NA,Junin,1246038,86,4,2391,99
2020-06-09,Peru,NA,Junin,1246038,58,4,2449,103
2020-06-10,Peru,NA,Junin,1246038,98,8,2547,111
2020-06-11,Peru,NA,Junin,1246038,90,4,2637,115
2020-06-12,Peru,NA,Junin,1246038,69,6,2706,121
2020-06-13,Peru,NA,Junin,1246038,69,10,2775,131
2020-06-14,Peru,NA,Junin,1246038,55,6,2830,137
2020-06-15,Peru,NA,Junin,1246038,61,0,2891,137
2020-06-16,Peru,NA,Junin,1246038,56,9,2947,146
2020-06-17,Peru,NA,Junin,1246038,97,5,3044,151
2020-06-18,Peru,NA,Junin,1246038,86,5,3130,156
2020-06-19,Peru,NA,Junin,1246038,39,1,3169,157
2020-06-20,Peru,NA,Junin,1246038,85,1,3254,158
2020-06-21,Peru,NA,Junin,1246038,28,1,3282,159
2020-06-22,Peru,NA,Junin,1246038,92,4,3374,163
2020-06-23,Peru,NA,Junin,1246038,76,4,3450,167
2020-06-24,Peru,NA,Junin,1246038,62,4,3512,171
2020-06-25,Peru,NA,Junin,1246038,102,4,3614,175
2020-06-26,Peru,NA,Junin,1246038,85,4,3699,179
2020-06-27,Peru,NA,Junin,1246038,82,5,3781,184
2020-06-28,Peru,NA,Junin,1246038,85,2,3866,186
2020-06-29,Peru,NA,Junin,1246038,116,3,3982,189
2020-06-30,Peru,NA,Junin,1246038,68,2,4050,191
2020-07-01,Peru,NA,Junin,1246038,74,6,4124,197
2020-07-02,Peru,NA,Junin,1246038,83,4,4207,201
2020-07-03,Peru,NA,Junin,1246038,121,6,4328,207
2020-07-04,Peru,NA,Junin,1246038,75,6,4403,213
2020-07-05,Peru,NA,Junin,1246038,162,5,4565,218
2020-07-06,Peru,NA,Junin,1246038,188,12,4753,230
2020-07-07,Peru,NA,Junin,1246038,101,10,4854,240
2020-07-08,Peru,NA,Junin,1246038,57,2,4911,242
2020-07-09,Peru,NA,Junin,1246038,26,7,4937,249
2020-07-10,Peru,NA,Junin,1246038,150,6,5087,255
2020-07-11,Peru,NA,Junin,1246038,201,9,5288,264
2020-07-12,Peru,NA,Junin,1246038,114,8,5402,272
2020-07-13,Peru,NA,Junin,1246038,42,8,5444,280
2020-07-14,Peru,NA,Junin,1246038,160,12,5604,292
2020-07-15,Peru,NA,Junin,1246038,77,8,5681,300
2020-07-16,Peru,NA,Junin,1246038,164,11,5845,311
2020-07-17,Peru,NA,Junin,1246038,171,14,6016,325
2020-07-18,Peru,NA,Junin,1246038,175,11,6191,336
2020-07-19,Peru,NA,Junin,1246038,57,4,6248,340
2020-07-20,Peru,NA,Junin,1246038,107,6,6355,346
2020-07-21,Peru,NA,Junin,1246038,120,7,6475,353
2020-07-22,Peru,NA,Junin,1246038,197,11,6672,364
2020-07-23,Peru,NA,Junin,1246038,159,9,6831,373
2020-07-24,Peru,NA,Junin,1246038,153,12,6984,385
2020-07-25,Peru,NA,Junin,1246038,136,7,7120,392
2020-07-26,Peru,NA,Junin,1246038,139,5,7259,397
2020-07-27,Peru,NA,Junin,1246038,239,6,7498,403
2020-07-28,Peru,NA,Junin,1246038,129,12,7627,415
2020-07-29,Peru,NA,Junin,1246038,182,6,7809,421
2020-07-30,Peru,NA,Junin,1246038,169,8,7978,429
2020-07-31,Peru,NA,Junin,1246038,244,4,8222,433
2020-08-01,Peru,NA,Junin,1246038,185,12,8407,445
2020-08-02,Peru,NA,Junin,1246038,107,7,8514,452
2020-08-03,Peru,NA,Junin,1246038,269,6,8783,458
2020-08-04,Peru,NA,Junin,1246038,220,10,9003,468
2020-08-05,Peru,NA,Junin,1246038,238,8,9241,476
2020-08-06,Peru,NA,Junin,1246038,299,3,9540,479
2020-08-07,Peru,NA,Junin,1246038,234,7,9774,486
2020-08-08,Peru,NA,Junin,1246038,157,15,9931,501
2020-08-09,Peru,NA,Junin,1246038,87,8,10018,509
2020-08-10,Peru,NA,Junin,1246038,318,8,10336,517
2020-08-11,Peru,NA,Junin,1246038,228,6,10564,523
2020-08-12,Peru,NA,Junin,1246038,268,11,10832,534
2020-08-13,Peru,NA,Junin,1246038,302,7,11134,541
2020-08-14,Peru,NA,Junin,1246038,457,8,11591,549
2020-08-15,Peru,NA,Junin,1246038,394,7,11985,556
2020-08-16,Peru,NA,Junin,1246038,77,6,12062,562
2020-08-17,Peru,NA,Junin,1246038,384,2,12446,564
2020-08-18,Peru,NA,Junin,1246038,298,4,12744,568
2020-08-19,Peru,NA,Junin,1246038,253,3,12997,571
2020-08-20,Peru,NA,Junin,1246038,243,8,13240,579
2020-08-21,Peru,NA,Junin,1246038,195,7,13435,586
2020-08-22,Peru,NA,Junin,1246038,183,12,13618,598
2020-08-23,Peru,NA,Junin,1246038,67,5,13685,603
2020-08-24,Peru,NA,Junin,1246038,192,8,13877,611
2020-08-25,Peru,NA,Junin,1246038,372,3,14249,614
2020-08-26,Peru,NA,Junin,1246038,305,8,14554,622
2020-08-27,Peru,NA,Junin,1246038,204,7,14758,629
2020-08-28,Peru,NA,Junin,1246038,265,9,15023,638
2020-08-29,Peru,NA,Junin,1246038,244,9,15267,647
2020-08-30,Peru,NA,Junin,1246038,70,7,15337,654
2020-08-31,Peru,NA,Junin,1246038,179,2,15516,656
2020-09-01,Peru,NA,Junin,1246038,159,6,15675,662
2020-09-02,Peru,NA,Junin,1246038,195,3,15870,665
2020-09-03,Peru,NA,Junin,1246038,75,6,15945,671
2020-09-04,Peru,NA,Junin,1246038,331,7,16276,678
2020-09-05,Peru,NA,Junin,1246038,82,4,16358,682
2020-09-06,Peru,NA,Junin,1246038,85,6,16443,688
2020-09-07,Peru,NA,Junin,1246038,159,6,16602,694
2020-09-08,Peru,NA,Junin,1246038,224,3,16826,697
2020-09-09,Peru,NA,Junin,1246038,130,3,16956,700
2020-09-10,Peru,NA,Junin,1246038,106,4,17062,704
2020-09-11,Peru,NA,Junin,1246038,368,3,17430,707
2020-09-12,Peru,NA,Junin,1246038,134,1,17564,708
2020-09-13,Peru,NA,Junin,1246038,52,1,17616,709
2020-09-14,Peru,NA,Junin,1246038,173,2,17789,711
2020-09-15,Peru,NA,Junin,1246038,161,5,17950,716
2020-09-16,Peru,NA,Junin,1246038,138,3,18088,719
2020-09-17,Peru,NA,Junin,1246038,114,4,18202,723
2020-09-18,Peru,NA,Junin,1246038,191,2,18393,725
2020-09-19,Peru,NA,Junin,1246038,162,3,18555,728
2020-09-20,Peru,NA,Junin,1246038,74,5,18629,733
2020-09-21,Peru,NA,Junin,1246038,186,5,18815,738
2020-09-22,Peru,NA,Junin,1246038,61,6,18876,744
2020-03-28,Peru,NA,La Libertad,1778080,2,0,12,2
2020-03-29,Peru,NA,La Libertad,1778080,2,0,14,2
2020-03-30,Peru,NA,La Libertad,1778080,4,0,18,2
2020-03-31,Peru,NA,La Libertad,1778080,11,1,29,3
2020-04-01,Peru,NA,La Libertad,1778080,7,0,36,3
2020-04-02,Peru,NA,La Libertad,1778080,7,1,43,4
2020-04-03,Peru,NA,La Libertad,1778080,5,0,48,4
2020-04-04,Peru,NA,La Libertad,1778080,1,1,49,5
2020-04-05,Peru,NA,La Libertad,1778080,7,0,56,5
2020-04-06,Peru,NA,La Libertad,1778080,4,2,60,7
2020-04-07,Peru,NA,La Libertad,1778080,22,0,82,7
2020-04-08,Peru,NA,La Libertad,1778080,22,1,104,8
2020-04-09,Peru,NA,La Libertad,1778080,7,0,111,8
2020-04-10,Peru,NA,La Libertad,1778080,5,0,116,8
2020-04-11,Peru,NA,La Libertad,1778080,9,0,125,8
2020-04-12,Peru,NA,La Libertad,1778080,3,3,128,11
2020-04-13,Peru,NA,La Libertad,1778080,23,1,151,12
2020-04-14,Peru,NA,La Libertad,1778080,25,3,176,15
2020-04-15,Peru,NA,La Libertad,1778080,27,3,203,18
2020-04-16,Peru,NA,La Libertad,1778080,25,0,228,18
2020-04-17,Peru,NA,La Libertad,1778080,26,1,254,19
2020-04-18,Peru,NA,La Libertad,1778080,27,1,281,20
2020-04-19,Peru,NA,La Libertad,1778080,10,3,291,23
2020-04-20,Peru,NA,La Libertad,1778080,53,2,344,25
2020-04-21,Peru,NA,La Libertad,1778080,45,0,389,25
2020-04-22,Peru,NA,La Libertad,1778080,46,2,435,27
2020-04-23,Peru,NA,La Libertad,1778080,40,4,475,31
2020-04-24,Peru,NA,La Libertad,1778080,22,1,497,32
2020-04-25,Peru,NA,La Libertad,1778080,53,0,550,32
2020-04-26,Peru,NA,La Libertad,1778080,8,7,558,39
2020-04-27,Peru,NA,La Libertad,1778080,71,3,629,42
2020-04-28,Peru,NA,La Libertad,1778080,177,7,806,49
2020-04-29,Peru,NA,La Libertad,1778080,142,3,948,52
2020-04-30,Peru,NA,La Libertad,1778080,136,4,1084,56
2020-05-01,Peru,NA,La Libertad,1778080,54,5,1138,61
2020-05-02,Peru,NA,La Libertad,1778080,116,8,1254,69
2020-05-03,Peru,NA,La Libertad,1778080,52,4,1306,73
2020-05-04,Peru,NA,La Libertad,1778080,126,3,1432,76
2020-05-05,Peru,NA,La Libertad,1778080,151,4,1583,80
2020-05-06,Peru,NA,La Libertad,1778080,112,6,1695,86
2020-05-07,Peru,NA,La Libertad,1778080,54,6,1749,92
2020-05-08,Peru,NA,La Libertad,1778080,73,6,1822,98
2020-05-09,Peru,NA,La Libertad,1778080,84,9,1906,107
2020-05-10,Peru,NA,La Libertad,1778080,38,0,1944,107
2020-05-11,Peru,NA,La Libertad,1778080,58,10,2002,117
2020-05-12,Peru,NA,La Libertad,1778080,105,1,2107,118
2020-05-13,Peru,NA,La Libertad,1778080,72,4,2179,122
2020-05-14,Peru,NA,La Libertad,1778080,85,8,2264,130
2020-05-15,Peru,NA,La Libertad,1778080,212,2,2476,132
2020-05-16,Peru,NA,La Libertad,1778080,145,5,2621,137
2020-05-17,Peru,NA,La Libertad,1778080,6,2,2627,139
2020-05-18,Peru,NA,La Libertad,1778080,120,6,2747,145
2020-05-19,Peru,NA,La Libertad,1778080,134,12,2881,157
2020-05-20,Peru,NA,La Libertad,1778080,142,10,3023,167
2020-05-21,Peru,NA,La Libertad,1778080,268,5,3291,172
2020-05-22,Peru,NA,La Libertad,1778080,234,9,3525,181
2020-05-23,Peru,NA,La Libertad,1778080,187,17,3712,198
2020-05-24,Peru,NA,La Libertad,1778080,68,11,3780,209
2020-05-25,Peru,NA,La Libertad,1778080,269,13,4049,222
2020-05-26,Peru,NA,La Libertad,1778080,182,12,4231,234
2020-05-27,Peru,NA,La Libertad,1778080,181,25,4412,259
2020-05-28,Peru,NA,La Libertad,1778080,307,15,4719,274
2020-05-29,Peru,NA,La Libertad,1778080,160,21,4879,295
2020-05-30,Peru,NA,La Libertad,1778080,173,34,5052,329
2020-05-31,Peru,NA,La Libertad,1778080,100,23,5152,352
2020-06-01,Peru,NA,La Libertad,1778080,226,22,5378,374
2020-06-02,Peru,NA,La Libertad,1778080,101,22,5479,396
2020-06-03,Peru,NA,La Libertad,1778080,97,27,5576,423
2020-06-04,Peru,NA,La Libertad,1778080,178,27,5754,450
2020-06-05,Peru,NA,La Libertad,1778080,126,36,5880,486
2020-06-06,Peru,NA,La Libertad,1778080,153,26,6033,512
2020-06-07,Peru,NA,La Libertad,1778080,46,28,6079,540
2020-06-08,Peru,NA,La Libertad,1778080,192,31,6271,571
2020-06-09,Peru,NA,La Libertad,1778080,258,43,6529,614
2020-06-10,Peru,NA,La Libertad,1778080,327,25,6856,639
2020-06-11,Peru,NA,La Libertad,1778080,210,32,7066,671
2020-06-12,Peru,NA,La Libertad,1778080,223,29,7289,700
2020-06-13,Peru,NA,La Libertad,1778080,203,42,7492,742
2020-06-14,Peru,NA,La Libertad,1778080,72,40,7564,782
2020-06-15,Peru,NA,La Libertad,1778080,220,43,7784,825
2020-06-16,Peru,NA,La Libertad,1778080,127,44,7911,869
2020-06-17,Peru,NA,La Libertad,1778080,250,32,8161,901
2020-06-18,Peru,NA,La Libertad,1778080,142,42,8303,943
2020-06-19,Peru,NA,La Libertad,1778080,218,35,8521,978
2020-06-20,Peru,NA,La Libertad,1778080,193,33,8714,1011
2020-06-21,Peru,NA,La Libertad,1778080,69,36,8783,1047
2020-06-22,Peru,NA,La Libertad,1778080,241,41,9024,1088
2020-06-23,Peru,NA,La Libertad,1778080,246,32,9270,1120
2020-06-24,Peru,NA,La Libertad,1778080,199,40,9469,1160
2020-06-25,Peru,NA,La Libertad,1778080,171,36,9640,1196
2020-06-26,Peru,NA,La Libertad,1778080,225,20,9865,1216
2020-06-27,Peru,NA,La Libertad,1778080,219,37,10084,1253
2020-06-28,Peru,NA,La Libertad,1778080,83,36,10167,1289
2020-06-29,Peru,NA,La Libertad,1778080,113,40,10280,1329
2020-06-30,Peru,NA,La Libertad,1778080,209,42,10489,1371
2020-07-01,Peru,NA,La Libertad,1778080,158,27,10647,1398
2020-07-02,Peru,NA,La Libertad,1778080,214,30,10861,1428
2020-07-03,Peru,NA,La Libertad,1778080,234,21,11095,1449
2020-07-04,Peru,NA,La Libertad,1778080,194,14,11289,1463
2020-07-05,Peru,NA,La Libertad,1778080,43,14,11332,1477
2020-07-06,Peru,NA,La Libertad,1778080,177,17,11509,1494
2020-07-07,Peru,NA,La Libertad,1778080,184,18,11693,1512
2020-07-08,Peru,NA,La Libertad,1778080,115,13,11808,1525
2020-07-09,Peru,NA,La Libertad,1778080,127,7,11935,1532
2020-07-10,Peru,NA,La Libertad,1778080,305,14,12240,1546
2020-07-11,Peru,NA,La Libertad,1778080,204,14,12444,1560
2020-07-12,Peru,NA,La Libertad,1778080,74,15,12518,1575
2020-07-13,Peru,NA,La Libertad,1778080,113,23,12631,1598
2020-07-14,Peru,NA,La Libertad,1778080,122,16,12753,1614
2020-07-15,Peru,NA,La Libertad,1778080,266,14,13019,1628
2020-07-16,Peru,NA,La Libertad,1778080,157,13,13176,1641
2020-07-17,Peru,NA,La Libertad,1778080,171,12,13347,1653
2020-07-18,Peru,NA,La Libertad,1778080,247,10,13594,1663
2020-07-19,Peru,NA,La Libertad,1778080,42,14,13636,1677
2020-07-20,Peru,NA,La Libertad,1778080,113,7,13749,1684
2020-07-21,Peru,NA,La Libertad,1778080,207,12,13956,1696
2020-07-22,Peru,NA,La Libertad,1778080,221,17,14177,1713
2020-07-23,Peru,NA,La Libertad,1778080,263,14,14440,1727
2020-07-24,Peru,NA,La Libertad,1778080,217,14,14657,1741
2020-07-25,Peru,NA,La Libertad,1778080,212,8,14869,1749
2020-07-26,Peru,NA,La Libertad,1778080,51,10,14920,1759
2020-07-27,Peru,NA,La Libertad,1778080,310,11,15230,1770
2020-07-28,Peru,NA,La Libertad,1778080,78,7,15308,1777
2020-07-29,Peru,NA,La Libertad,1778080,286,4,15594,1781
2020-07-30,Peru,NA,La Libertad,1778080,286,10,15880,1791
2020-07-31,Peru,NA,La Libertad,1778080,325,14,16205,1805
2020-08-01,Peru,NA,La Libertad,1778080,230,8,16435,1813
2020-08-02,Peru,NA,La Libertad,1778080,68,10,16503,1823
2020-08-03,Peru,NA,La Libertad,1778080,253,6,16756,1829
2020-08-04,Peru,NA,La Libertad,1778080,269,12,17025,1841
2020-08-05,Peru,NA,La Libertad,1778080,251,6,17276,1847
2020-08-06,Peru,NA,La Libertad,1778080,277,15,17553,1862
2020-08-07,Peru,NA,La Libertad,1778080,301,4,17854,1866
2020-08-08,Peru,NA,La Libertad,1778080,253,8,18107,1874
2020-08-09,Peru,NA,La Libertad,1778080,76,8,18183,1882
2020-08-10,Peru,NA,La Libertad,1778080,299,15,18482,1897
2020-08-11,Peru,NA,La Libertad,1778080,272,10,18754,1907
2020-08-12,Peru,NA,La Libertad,1778080,268,7,19022,1914
2020-08-13,Peru,NA,La Libertad,1778080,270,9,19292,1923
2020-08-14,Peru,NA,La Libertad,1778080,296,11,19588,1934
2020-08-15,Peru,NA,La Libertad,1778080,210,7,19798,1941
2020-08-16,Peru,NA,La Libertad,1778080,62,14,19860,1955
2020-08-17,Peru,NA,La Libertad,1778080,247,4,20107,1959
2020-08-18,Peru,NA,La Libertad,1778080,284,2,20391,1961
2020-08-19,Peru,NA,La Libertad,1778080,301,8,20692,1969
2020-08-20,Peru,NA,La Libertad,1778080,323,11,21015,1980
2020-08-21,Peru,NA,La Libertad,1778080,245,7,21260,1987
2020-08-22,Peru,NA,La Libertad,1778080,219,4,21479,1991
2020-08-23,Peru,NA,La Libertad,1778080,58,7,21537,1998
2020-08-24,Peru,NA,La Libertad,1778080,243,14,21780,2012
2020-08-25,Peru,NA,La Libertad,1778080,381,4,22161,2016
2020-08-26,Peru,NA,La Libertad,1778080,199,7,22360,2023
2020-08-27,Peru,NA,La Libertad,1778080,279,5,22639,2028
2020-08-28,Peru,NA,La Libertad,1778080,274,6,22913,2034
2020-08-29,Peru,NA,La Libertad,1778080,201,8,23114,2042
2020-08-30,Peru,NA,La Libertad,1778080,68,10,23182,2052
2020-08-31,Peru,NA,La Libertad,1778080,185,5,23367,2057
2020-09-01,Peru,NA,La Libertad,1778080,172,10,23539,2067
2020-09-02,Peru,NA,La Libertad,1778080,214,6,23753,2073
2020-09-03,Peru,NA,La Libertad,1778080,128,9,23881,2082
2020-09-04,Peru,NA,La Libertad,1778080,275,9,24156,2091
2020-09-05,Peru,NA,La Libertad,1778080,181,5,24337,2096
2020-09-06,Peru,NA,La Libertad,1778080,29,4,24366,2100
2020-09-07,Peru,NA,La Libertad,1778080,197,11,24563,2111
2020-09-08,Peru,NA,La Libertad,1778080,240,3,24803,2114
2020-09-09,Peru,NA,La Libertad,1778080,193,1,24996,2115
2020-09-10,Peru,NA,La Libertad,1778080,112,6,25108,2121
2020-09-11,Peru,NA,La Libertad,1778080,553,6,25661,2127
2020-09-12,Peru,NA,La Libertad,1778080,232,7,25893,2134
2020-09-13,Peru,NA,La Libertad,1778080,41,3,25934,2137
2020-09-14,Peru,NA,La Libertad,1778080,322,5,26256,2142
2020-09-15,Peru,NA,La Libertad,1778080,303,6,26559,2148
2020-09-16,Peru,NA,La Libertad,1778080,248,5,26807,2153
2020-09-17,Peru,NA,La Libertad,1778080,292,5,27099,2158
2020-09-18,Peru,NA,La Libertad,1778080,193,6,27292,2164
2020-09-19,Peru,NA,La Libertad,1778080,104,10,27396,2174
2020-09-20,Peru,NA,La Libertad,1778080,52,5,27448,2179
2020-09-21,Peru,NA,La Libertad,1778080,146,4,27594,2183
2020-09-22,Peru,NA,La Libertad,1778080,128,3,27722,2186
2020-03-24,Peru,NA,Lambayeque,1197260,4,0,12,0
2020-03-26,Peru,NA,Lambayeque,1197260,1,2,13,2
2020-03-27,Peru,NA,Lambayeque,1197260,2,0,15,2
2020-03-28,Peru,NA,Lambayeque,1197260,7,0,22,2
2020-03-29,Peru,NA,Lambayeque,1197260,1,1,23,3
2020-03-30,Peru,NA,Lambayeque,1197260,8,2,31,5
2020-03-31,Peru,NA,Lambayeque,1197260,4,1,35,6
2020-04-01,Peru,NA,Lambayeque,1197260,1,1,36,7
2020-04-02,Peru,NA,Lambayeque,1197260,5,0,41,7
2020-04-03,Peru,NA,Lambayeque,1197260,31,4,72,11
2020-04-04,Peru,NA,Lambayeque,1197260,49,5,121,16
2020-04-05,Peru,NA,Lambayeque,1197260,8,3,129,19
2020-04-06,Peru,NA,Lambayeque,1197260,28,4,157,23
2020-04-07,Peru,NA,Lambayeque,1197260,156,2,313,25
2020-04-08,Peru,NA,Lambayeque,1197260,75,9,388,34
2020-04-09,Peru,NA,Lambayeque,1197260,20,10,408,44
2020-04-10,Peru,NA,Lambayeque,1197260,59,15,467,59
2020-04-11,Peru,NA,Lambayeque,1197260,67,8,534,67
2020-04-12,Peru,NA,Lambayeque,1197260,56,8,590,75
2020-04-13,Peru,NA,Lambayeque,1197260,59,5,649,80
2020-04-14,Peru,NA,Lambayeque,1197260,60,11,709,91
2020-04-15,Peru,NA,Lambayeque,1197260,176,14,885,105
2020-04-16,Peru,NA,Lambayeque,1197260,86,13,971,118
2020-04-17,Peru,NA,Lambayeque,1197260,77,19,1048,137
2020-04-18,Peru,NA,Lambayeque,1197260,48,15,1096,152
2020-04-19,Peru,NA,Lambayeque,1197260,27,8,1123,160
2020-04-20,Peru,NA,Lambayeque,1197260,146,11,1269,171
2020-04-21,Peru,NA,Lambayeque,1197260,133,10,1402,181
2020-04-22,Peru,NA,Lambayeque,1197260,138,16,1540,197
2020-04-23,Peru,NA,Lambayeque,1197260,177,22,1717,219
2020-04-24,Peru,NA,Lambayeque,1197260,214,20,1931,239
2020-04-25,Peru,NA,Lambayeque,1197260,136,25,2067,264
2020-04-26,Peru,NA,Lambayeque,1197260,71,18,2138,282
2020-04-27,Peru,NA,Lambayeque,1197260,296,25,2434,307
2020-04-28,Peru,NA,Lambayeque,1197260,241,26,2675,333
2020-04-29,Peru,NA,Lambayeque,1197260,251,21,2926,354
2020-04-30,Peru,NA,Lambayeque,1197260,217,26,3143,380
2020-05-01,Peru,NA,Lambayeque,1197260,234,22,3377,402
2020-05-02,Peru,NA,Lambayeque,1197260,146,20,3523,422
2020-05-03,Peru,NA,Lambayeque,1197260,132,24,3655,446
2020-05-04,Peru,NA,Lambayeque,1197260,332,17,3987,463
2020-05-05,Peru,NA,Lambayeque,1197260,234,22,4221,485
2020-05-06,Peru,NA,Lambayeque,1197260,165,28,4386,513
2020-05-07,Peru,NA,Lambayeque,1197260,158,27,4544,540
2020-05-08,Peru,NA,Lambayeque,1197260,154,20,4698,560
2020-05-09,Peru,NA,Lambayeque,1197260,68,20,4766,580
2020-05-10,Peru,NA,Lambayeque,1197260,27,19,4793,599
2020-05-11,Peru,NA,Lambayeque,1197260,127,20,4920,619
2020-05-12,Peru,NA,Lambayeque,1197260,130,16,5050,635
2020-05-13,Peru,NA,Lambayeque,1197260,165,16,5215,651
2020-05-14,Peru,NA,Lambayeque,1197260,182,26,5397,677
2020-05-15,Peru,NA,Lambayeque,1197260,262,22,5659,699
2020-05-16,Peru,NA,Lambayeque,1197260,134,14,5793,713
2020-05-17,Peru,NA,Lambayeque,1197260,27,18,5820,731
2020-05-18,Peru,NA,Lambayeque,1197260,225,20,6045,751
2020-05-19,Peru,NA,Lambayeque,1197260,218,12,6263,763
2020-05-20,Peru,NA,Lambayeque,1197260,134,16,6397,779
2020-05-21,Peru,NA,Lambayeque,1197260,166,20,6563,799
2020-05-22,Peru,NA,Lambayeque,1197260,158,17,6721,816
2020-05-23,Peru,NA,Lambayeque,1197260,200,16,6921,832
2020-05-24,Peru,NA,Lambayeque,1197260,96,17,7017,849
2020-05-25,Peru,NA,Lambayeque,1197260,320,12,7337,861
2020-05-26,Peru,NA,Lambayeque,1197260,460,15,7797,876
2020-05-27,Peru,NA,Lambayeque,1197260,508,18,8305,894
2020-05-28,Peru,NA,Lambayeque,1197260,315,17,8620,911
2020-05-29,Peru,NA,Lambayeque,1197260,242,22,8862,933
2020-05-30,Peru,NA,Lambayeque,1197260,325,14,9187,947
2020-05-31,Peru,NA,Lambayeque,1197260,60,15,9247,962
2020-06-01,Peru,NA,Lambayeque,1197260,154,14,9401,976
2020-06-02,Peru,NA,Lambayeque,1197260,172,8,9573,984
2020-06-03,Peru,NA,Lambayeque,1197260,135,7,9708,991
2020-06-04,Peru,NA,Lambayeque,1197260,178,23,9886,1014
2020-06-05,Peru,NA,Lambayeque,1197260,88,9,9974,1023
2020-06-06,Peru,NA,Lambayeque,1197260,156,10,10130,1033
2020-06-07,Peru,NA,Lambayeque,1197260,115,16,10245,1049
2020-06-08,Peru,NA,Lambayeque,1197260,178,18,10423,1067
2020-06-09,Peru,NA,Lambayeque,1197260,200,18,10623,1085
2020-06-10,Peru,NA,Lambayeque,1197260,256,14,10879,1099
2020-06-11,Peru,NA,Lambayeque,1197260,229,23,11108,1122
2020-06-12,Peru,NA,Lambayeque,1197260,283,13,11391,1135
2020-06-13,Peru,NA,Lambayeque,1197260,204,11,11595,1146
2020-06-14,Peru,NA,Lambayeque,1197260,39,20,11634,1166
2020-06-15,Peru,NA,Lambayeque,1197260,179,14,11813,1180
2020-06-16,Peru,NA,Lambayeque,1197260,127,18,11940,1198
2020-06-17,Peru,NA,Lambayeque,1197260,201,16,12141,1214
2020-06-18,Peru,NA,Lambayeque,1197260,164,15,12305,1229
2020-06-19,Peru,NA,Lambayeque,1197260,179,20,12484,1249
2020-06-20,Peru,NA,Lambayeque,1197260,107,16,12591,1265
2020-06-21,Peru,NA,Lambayeque,1197260,50,7,12641,1272
2020-06-22,Peru,NA,Lambayeque,1197260,174,9,12815,1281
2020-06-23,Peru,NA,Lambayeque,1197260,116,15,12931,1296
2020-06-24,Peru,NA,Lambayeque,1197260,257,17,13188,1313
2020-06-25,Peru,NA,Lambayeque,1197260,142,10,13330,1323
2020-06-26,Peru,NA,Lambayeque,1197260,256,13,13586,1336
2020-06-27,Peru,NA,Lambayeque,1197260,146,13,13732,1349
2020-06-28,Peru,NA,Lambayeque,1197260,31,10,13763,1359
2020-06-29,Peru,NA,Lambayeque,1197260,57,6,13820,1365
2020-06-30,Peru,NA,Lambayeque,1197260,135,4,13955,1369
2020-07-01,Peru,NA,Lambayeque,1197260,133,5,14088,1374
2020-07-02,Peru,NA,Lambayeque,1197260,114,8,14202,1382
2020-07-03,Peru,NA,Lambayeque,1197260,153,4,14355,1386
2020-07-04,Peru,NA,Lambayeque,1197260,88,0,14443,1386
2020-07-05,Peru,NA,Lambayeque,1197260,38,6,14481,1392
2020-07-06,Peru,NA,Lambayeque,1197260,153,2,14634,1394
2020-07-07,Peru,NA,Lambayeque,1197260,106,2,14740,1396
2020-07-08,Peru,NA,Lambayeque,1197260,158,3,14898,1399
2020-07-09,Peru,NA,Lambayeque,1197260,52,4,14950,1403
2020-07-10,Peru,NA,Lambayeque,1197260,162,9,15112,1412
2020-07-11,Peru,NA,Lambayeque,1197260,114,5,15226,1417
2020-07-12,Peru,NA,Lambayeque,1197260,41,1,15267,1418
2020-07-13,Peru,NA,Lambayeque,1197260,66,4,15333,1422
2020-07-14,Peru,NA,Lambayeque,1197260,98,2,15431,1424
2020-07-15,Peru,NA,Lambayeque,1197260,89,3,15520,1427
2020-07-16,Peru,NA,Lambayeque,1197260,102,5,15622,1432
2020-07-17,Peru,NA,Lambayeque,1197260,113,4,15735,1436
2020-07-18,Peru,NA,Lambayeque,1197260,150,2,15885,1438
2020-07-19,Peru,NA,Lambayeque,1197260,23,9,15908,1447
2020-07-20,Peru,NA,Lambayeque,1197260,62,1,15970,1448
2020-07-21,Peru,NA,Lambayeque,1197260,117,4,16087,1452
2020-07-22,Peru,NA,Lambayeque,1197260,152,2,16239,1454
2020-07-23,Peru,NA,Lambayeque,1197260,137,4,16376,1458
2020-07-24,Peru,NA,Lambayeque,1197260,164,0,16540,1458
2020-07-25,Peru,NA,Lambayeque,1197260,143,3,16683,1461
2020-07-26,Peru,NA,Lambayeque,1197260,38,3,16721,1464
2020-07-27,Peru,NA,Lambayeque,1197260,269,4,16990,1468
2020-07-28,Peru,NA,Lambayeque,1197260,57,4,17047,1472
2020-07-29,Peru,NA,Lambayeque,1197260,188,1,17235,1473
2020-07-30,Peru,NA,Lambayeque,1197260,194,3,17429,1476
2020-07-31,Peru,NA,Lambayeque,1197260,167,6,17596,1482
2020-08-01,Peru,NA,Lambayeque,1197260,147,1,17743,1483
2020-08-02,Peru,NA,Lambayeque,1197260,68,9,17811,1492
2020-08-03,Peru,NA,Lambayeque,1197260,184,3,17995,1495
2020-08-04,Peru,NA,Lambayeque,1197260,212,4,18207,1499
2020-08-05,Peru,NA,Lambayeque,1197260,125,7,18332,1506
2020-08-06,Peru,NA,Lambayeque,1197260,218,2,18550,1508
2020-08-07,Peru,NA,Lambayeque,1197260,213,6,18763,1514
2020-08-08,Peru,NA,Lambayeque,1197260,168,3,18931,1517
2020-08-09,Peru,NA,Lambayeque,1197260,36,3,18967,1520
2020-08-10,Peru,NA,Lambayeque,1197260,190,5,19157,1525
2020-08-11,Peru,NA,Lambayeque,1197260,183,2,19340,1527
2020-08-12,Peru,NA,Lambayeque,1197260,190,2,19530,1529
2020-08-13,Peru,NA,Lambayeque,1197260,205,4,19735,1533
2020-08-14,Peru,NA,Lambayeque,1197260,174,11,19909,1544
2020-08-15,Peru,NA,Lambayeque,1197260,160,1,20069,1545
2020-08-16,Peru,NA,Lambayeque,1197260,44,7,20113,1552
2020-08-17,Peru,NA,Lambayeque,1197260,169,2,20282,1554
2020-08-18,Peru,NA,Lambayeque,1197260,151,3,20433,1557
2020-08-19,Peru,NA,Lambayeque,1197260,214,1,20647,1558
2020-08-20,Peru,NA,Lambayeque,1197260,307,3,20954,1561
2020-08-21,Peru,NA,Lambayeque,1197260,191,6,21145,1567
2020-08-22,Peru,NA,Lambayeque,1197260,127,3,21272,1570
2020-08-23,Peru,NA,Lambayeque,1197260,40,2,21312,1572
2020-08-24,Peru,NA,Lambayeque,1197260,124,2,21436,1574
2020-08-25,Peru,NA,Lambayeque,1197260,258,2,21694,1576
2020-08-26,Peru,NA,Lambayeque,1197260,162,1,21856,1577
2020-08-27,Peru,NA,Lambayeque,1197260,162,1,22018,1578
2020-08-28,Peru,NA,Lambayeque,1197260,260,3,22278,1581
2020-08-29,Peru,NA,Lambayeque,1197260,174,3,22452,1584
2020-08-30,Peru,NA,Lambayeque,1197260,41,4,22493,1588
2020-08-31,Peru,NA,Lambayeque,1197260,127,4,22620,1592
2020-09-01,Peru,NA,Lambayeque,1197260,184,1,22804,1593
2020-09-02,Peru,NA,Lambayeque,1197260,113,3,22917,1596
2020-09-03,Peru,NA,Lambayeque,1197260,41,5,22958,1601
2020-09-04,Peru,NA,Lambayeque,1197260,229,4,23187,1605
2020-09-05,Peru,NA,Lambayeque,1197260,106,4,23293,1609
2020-09-06,Peru,NA,Lambayeque,1197260,20,6,23313,1615
2020-09-07,Peru,NA,Lambayeque,1197260,129,4,23442,1619
2020-09-08,Peru,NA,Lambayeque,1197260,101,3,23543,1622
2020-09-09,Peru,NA,Lambayeque,1197260,156,3,23699,1625
2020-09-10,Peru,NA,Lambayeque,1197260,115,3,23814,1628
2020-09-11,Peru,NA,Lambayeque,1197260,228,6,24042,1634
2020-09-12,Peru,NA,Lambayeque,1197260,126,5,24168,1639
2020-09-13,Peru,NA,Lambayeque,1197260,43,1,24211,1640
2020-09-14,Peru,NA,Lambayeque,1197260,188,1,24399,1641
2020-09-15,Peru,NA,Lambayeque,1197260,202,1,24601,1642
2020-09-16,Peru,NA,Lambayeque,1197260,186,3,24787,1645
2020-09-17,Peru,NA,Lambayeque,1197260,147,4,24934,1649
2020-09-18,Peru,NA,Lambayeque,1197260,115,4,25049,1653
2020-09-19,Peru,NA,Lambayeque,1197260,102,3,25151,1656
2020-09-20,Peru,NA,Lambayeque,1197260,52,3,25203,1659
2020-09-21,Peru,NA,Lambayeque,1197260,89,3,25292,1662
2020-09-22,Peru,NA,Lambayeque,1197260,51,5,25343,1667
2020-03-30,Peru,NA,Lima Region,910431,6,0,12,0
2020-03-31,Peru,NA,Lima Region,910431,2,1,14,1
2020-04-01,Peru,NA,Lima Region,910431,3,0,17,1
2020-04-02,Peru,NA,Lima Region,910431,2,1,19,2
2020-04-03,Peru,NA,Lima Region,910431,16,1,35,3
2020-04-04,Peru,NA,Lima Region,910431,19,0,54,3
2020-04-05,Peru,NA,Lima Region,910431,5,1,59,4
2020-04-06,Peru,NA,Lima Region,910431,9,1,68,5
2020-04-07,Peru,NA,Lima Region,910431,18,1,86,6
2020-04-08,Peru,NA,Lima Region,910431,22,2,108,8
2020-04-09,Peru,NA,Lima Region,910431,16,4,124,12
2020-04-10,Peru,NA,Lima Region,910431,26,1,150,13
2020-04-11,Peru,NA,Lima Region,910431,24,3,174,16
2020-04-12,Peru,NA,Lima Region,910431,8,0,182,16
2020-04-13,Peru,NA,Lima Region,910431,18,2,200,18
2020-04-14,Peru,NA,Lima Region,910431,8,2,208,20
2020-04-15,Peru,NA,Lima Region,910431,30,4,238,24
2020-04-16,Peru,NA,Lima Region,910431,23,3,261,27
2020-04-17,Peru,NA,Lima Region,910431,31,7,292,34
2020-04-18,Peru,NA,Lima Region,910431,31,6,323,40
2020-04-19,Peru,NA,Lima Region,910431,38,6,361,46
2020-04-20,Peru,NA,Lima Region,910431,51,4,412,50
2020-04-21,Peru,NA,Lima Region,910431,51,8,463,58
2020-04-22,Peru,NA,Lima Region,910431,70,6,533,64
2020-04-23,Peru,NA,Lima Region,910431,50,7,583,71
2020-04-24,Peru,NA,Lima Region,910431,58,4,641,75
2020-04-25,Peru,NA,Lima Region,910431,88,3,729,78
2020-04-26,Peru,NA,Lima Region,910431,34,4,763,82
2020-04-27,Peru,NA,Lima Region,910431,103,5,866,87
2020-04-28,Peru,NA,Lima Region,910431,66,5,932,92
2020-04-29,Peru,NA,Lima Region,910431,74,4,1006,96
2020-04-30,Peru,NA,Lima Region,910431,146,10,1152,106
2020-05-01,Peru,NA,Lima Region,910431,107,12,1259,118
2020-05-02,Peru,NA,Lima Region,910431,92,15,1351,133
2020-05-03,Peru,NA,Lima Region,910431,65,16,1416,149
2020-05-04,Peru,NA,Lima Region,910431,233,20,1649,169
2020-05-05,Peru,NA,Lima Region,910431,109,32,1758,201
2020-05-06,Peru,NA,Lima Region,910431,49,18,1807,219
2020-05-07,Peru,NA,Lima Region,910431,102,16,1909,235
2020-05-08,Peru,NA,Lima Region,910431,73,15,1982,250
2020-05-09,Peru,NA,Lima Region,910431,43,23,2025,273
2020-05-10,Peru,NA,Lima Region,910431,13,26,2038,299
2020-05-11,Peru,NA,Lima Region,910431,124,24,2162,323
2020-05-12,Peru,NA,Lima Region,910431,95,15,2257,338
2020-05-13,Peru,NA,Lima Region,910431,178,14,2435,352
2020-05-14,Peru,NA,Lima Region,910431,79,20,2514,372
2020-05-15,Peru,NA,Lima Region,910431,210,13,2724,385
2020-05-16,Peru,NA,Lima Region,910431,110,8,2834,393
2020-05-17,Peru,NA,Lima Region,910431,50,8,2884,401
2020-05-18,Peru,NA,Lima Region,910431,198,26,3082,427
2020-05-19,Peru,NA,Lima Region,910431,158,17,3240,444
2020-05-20,Peru,NA,Lima Region,910431,199,32,3439,476
2020-05-21,Peru,NA,Lima Region,910431,99,15,3538,491
2020-05-22,Peru,NA,Lima Region,910431,197,9,3735,500
2020-05-23,Peru,NA,Lima Region,910431,258,7,3993,507
2020-05-24,Peru,NA,Lima Region,910431,59,7,4052,514
2020-05-25,Peru,NA,Lima Region,910431,303,13,4355,527
2020-05-26,Peru,NA,Lima Region,910431,286,12,4641,539
2020-05-27,Peru,NA,Lima Region,910431,256,9,4897,548
2020-05-28,Peru,NA,Lima Region,910431,202,13,5099,561
2020-05-29,Peru,NA,Lima Region,910431,239,12,5338,573
2020-05-30,Peru,NA,Lima Region,910431,194,12,5532,585
2020-05-31,Peru,NA,Lima Region,910431,102,11,5634,596
2020-06-01,Peru,NA,Lima Region,910431,164,14,5798,610
2020-06-02,Peru,NA,Lima Region,910431,125,11,5923,621
2020-06-03,Peru,NA,Lima Region,910431,223,9,6146,630
2020-06-04,Peru,NA,Lima Region,910431,147,11,6293,641
2020-06-05,Peru,NA,Lima Region,910431,241,13,6534,654
2020-06-06,Peru,NA,Lima Region,910431,241,18,6775,672
2020-06-07,Peru,NA,Lima Region,910431,269,12,7044,684
2020-06-08,Peru,NA,Lima Region,910431,264,15,7308,699
2020-06-09,Peru,NA,Lima Region,910431,406,14,7714,713
2020-06-10,Peru,NA,Lima Region,910431,354,23,8068,736
2020-06-11,Peru,NA,Lima Region,910431,480,17,8548,753
2020-06-12,Peru,NA,Lima Region,910431,525,13,9073,766
2020-06-13,Peru,NA,Lima Region,910431,390,10,9463,776
2020-06-14,Peru,NA,Lima Region,910431,305,13,9768,789
2020-06-15,Peru,NA,Lima Region,910431,345,14,10113,803
2020-06-16,Peru,NA,Lima Region,910431,385,24,10498,827
2020-06-17,Peru,NA,Lima Region,910431,448,15,10946,842
2020-06-18,Peru,NA,Lima Region,910431,260,16,11206,858
2020-06-19,Peru,NA,Lima Region,910431,294,17,11500,875
2020-06-20,Peru,NA,Lima Region,910431,446,17,11946,892
2020-06-21,Peru,NA,Lima Region,910431,139,19,12085,911
2020-06-22,Peru,NA,Lima Region,910431,614,17,12699,928
2020-06-23,Peru,NA,Lima Region,910431,391,19,13090,947
2020-06-24,Peru,NA,Lima Region,910431,430,16,13520,963
2020-06-25,Peru,NA,Lima Region,910431,449,21,13969,984
2020-06-26,Peru,NA,Lima Region,910431,345,24,14314,1008
2020-06-27,Peru,NA,Lima Region,910431,235,22,14549,1030
2020-06-28,Peru,NA,Lima Region,910431,93,28,14642,1058
2020-06-29,Peru,NA,Lima Region,910431,242,17,14884,1075
2020-06-30,Peru,NA,Lima Region,910431,209,20,15093,1095
2020-07-01,Peru,NA,Lima Region,910431,311,16,15404,1111
2020-07-02,Peru,NA,Lima Region,910431,250,15,15654,1126
2020-07-03,Peru,NA,Lima Region,910431,277,12,15931,1138
2020-07-04,Peru,NA,Lima Region,910431,195,7,16126,1145
2020-07-05,Peru,NA,Lima Region,910431,199,5,16325,1150
2020-07-06,Peru,NA,Lima Region,910431,295,6,16620,1156
2020-07-07,Peru,NA,Lima Region,910431,317,7,16937,1163
2020-07-08,Peru,NA,Lima Region,910431,184,5,17121,1168
2020-07-09,Peru,NA,Lima Region,910431,178,11,17299,1179
2020-07-10,Peru,NA,Lima Region,910431,328,4,17627,1183
2020-07-11,Peru,NA,Lima Region,910431,354,9,17981,1192
2020-07-12,Peru,NA,Lima Region,910431,244,6,18225,1198
2020-07-13,Peru,NA,Lima Region,910431,412,5,18637,1203
2020-07-14,Peru,NA,Lima Region,910431,616,14,19253,1217
2020-07-15,Peru,NA,Lima Region,910431,449,10,19702,1227
2020-07-16,Peru,NA,Lima Region,910431,541,8,20243,1235
2020-07-17,Peru,NA,Lima Region,910431,469,7,20712,1242
2020-07-18,Peru,NA,Lima Region,910431,392,6,21104,1248
2020-07-19,Peru,NA,Lima Region,910431,120,8,21224,1256
2020-07-20,Peru,NA,Lima Region,910431,590,6,21814,1262
2020-07-21,Peru,NA,Lima Region,910431,446,7,22260,1269
2020-07-22,Peru,NA,Lima Region,910431,601,16,22861,1285
2020-07-23,Peru,NA,Lima Region,910431,501,7,23362,1292
2020-07-24,Peru,NA,Lima Region,910431,503,13,23865,1305
2020-07-25,Peru,NA,Lima Region,910431,272,6,24137,1311
2020-07-26,Peru,NA,Lima Region,910431,226,7,24363,1318
2020-07-27,Peru,NA,Lima Region,910431,443,5,24806,1323
2020-07-28,Peru,NA,Lima Region,910431,240,9,25046,1332
2020-07-29,Peru,NA,Lima Region,910431,320,6,25366,1338
2020-07-30,Peru,NA,Lima Region,910431,466,4,25832,1342
2020-07-31,Peru,NA,Lima Region,910431,428,9,26260,1351
2020-08-01,Peru,NA,Lima Region,910431,332,10,26592,1361
2020-08-02,Peru,NA,Lima Region,910431,218,5,26810,1366
2020-08-03,Peru,NA,Lima Region,910431,530,0,27340,1366
2020-08-04,Peru,NA,Lima Region,910431,532,5,27872,1371
2020-08-05,Peru,NA,Lima Region,910431,577,3,28449,1374
2020-08-06,Peru,NA,Lima Region,910431,474,9,28923,1383
2020-08-07,Peru,NA,Lima Region,910431,414,7,29337,1390
2020-08-08,Peru,NA,Lima Region,910431,563,8,29900,1398
2020-08-09,Peru,NA,Lima Region,910431,402,8,30302,1406
2020-08-10,Peru,NA,Lima Region,910431,366,8,30668,1414
2020-08-11,Peru,NA,Lima Region,910431,494,6,31162,1420
2020-08-12,Peru,NA,Lima Region,910431,704,8,31866,1428
2020-08-13,Peru,NA,Lima Region,910431,619,2,32485,1430
2020-08-14,Peru,NA,Lima Region,910431,699,6,33184,1436
2020-08-15,Peru,NA,Lima Region,910431,637,7,33821,1443
2020-08-16,Peru,NA,Lima Region,910431,418,4,34239,1447
2020-08-17,Peru,NA,Lima Region,910431,591,8,34830,1455
2020-08-18,Peru,NA,Lima Region,910431,703,4,35533,1459
2020-08-19,Peru,NA,Lima Region,910431,606,4,36139,1463
2020-08-20,Peru,NA,Lima Region,910431,469,9,36608,1472
2020-08-21,Peru,NA,Lima Region,910431,375,7,36983,1479
2020-08-22,Peru,NA,Lima Region,910431,352,11,37335,1490
2020-08-23,Peru,NA,Lima Region,910431,257,6,37592,1496
2020-08-24,Peru,NA,Lima Region,910431,417,8,38009,1504
2020-08-25,Peru,NA,Lima Region,910431,469,4,38478,1508
2020-08-26,Peru,NA,Lima Region,910431,751,2,39229,1510
2020-08-27,Peru,NA,Lima Region,910431,688,10,39917,1520
2020-08-28,Peru,NA,Lima Region,910431,754,4,40671,1524
2020-08-29,Peru,NA,Lima Region,910431,640,1,41311,1525
2020-08-30,Peru,NA,Lima Region,910431,264,7,41575,1532
2020-08-31,Peru,NA,Lima Region,910431,373,4,41948,1536
2020-09-01,Peru,NA,Lima Region,910431,459,8,42407,1544
2020-09-02,Peru,NA,Lima Region,910431,378,9,42785,1553
2020-09-03,Peru,NA,Lima Region,910431,269,5,43054,1558
2020-09-04,Peru,NA,Lima Region,910431,575,4,43629,1562
2020-09-05,Peru,NA,Lima Region,910431,256,8,43885,1570
2020-09-06,Peru,NA,Lima Region,910431,141,6,44026,1576
2020-09-07,Peru,NA,Lima Region,910431,385,6,44411,1582
2020-09-08,Peru,NA,Lima Region,910431,321,3,44732,1585
2020-09-09,Peru,NA,Lima Region,910431,514,7,45246,1592
2020-09-10,Peru,NA,Lima Region,910431,226,1,45472,1593
2020-09-11,Peru,NA,Lima Region,910431,272,1,45744,1594
2020-09-12,Peru,NA,Lima Region,910431,308,6,46052,1600
2020-09-13,Peru,NA,Lima Region,910431,203,2,46255,1602
2020-09-14,Peru,NA,Lima Region,910431,285,2,46540,1604
2020-09-15,Peru,NA,Lima Region,910431,356,5,46896,1609
2020-09-16,Peru,NA,Lima Region,910431,306,6,47202,1615
2020-09-17,Peru,NA,Lima Region,910431,393,3,47595,1618
2020-09-18,Peru,NA,Lima Region,910431,411,4,48006,1622
2020-09-19,Peru,NA,Lima Region,910431,245,12,48251,1634
2020-09-20,Peru,NA,Lima Region,910431,164,2,48415,1636
2020-09-21,Peru,NA,Lima Region,910431,289,1,48704,1637
2020-09-22,Peru,NA,Lima Region,910431,236,7,48940,1644
2020-03-18,Peru,NA,Loreto,883510,1,0,11,0
2020-03-19,Peru,NA,Loreto,883510,1,0,12,0
2020-03-20,Peru,NA,Loreto,883510,2,0,14,0
2020-03-21,Peru,NA,Loreto,883510,2,0,16,0
2020-03-22,Peru,NA,Loreto,883510,0,1,16,1
2020-03-24,Peru,NA,Loreto,883510,2,0,18,1
2020-03-26,Peru,NA,Loreto,883510,5,0,23,1
2020-03-27,Peru,NA,Loreto,883510,4,0,27,1
2020-03-28,Peru,NA,Loreto,883510,25,0,52,1
2020-03-29,Peru,NA,Loreto,883510,1,0,53,1
2020-03-30,Peru,NA,Loreto,883510,5,2,58,3
2020-03-31,Peru,NA,Loreto,883510,4,1,62,4
2020-04-01,Peru,NA,Loreto,883510,11,0,73,4
2020-04-02,Peru,NA,Loreto,883510,9,0,82,4
2020-04-03,Peru,NA,Loreto,883510,25,0,107,4
2020-04-04,Peru,NA,Loreto,883510,40,0,147,4
2020-04-05,Peru,NA,Loreto,883510,31,1,178,5
2020-04-06,Peru,NA,Loreto,883510,10,0,188,5
2020-04-07,Peru,NA,Loreto,883510,100,1,288,6
2020-04-08,Peru,NA,Loreto,883510,68,1,356,7
2020-04-09,Peru,NA,Loreto,883510,4,2,360,9
2020-04-10,Peru,NA,Loreto,883510,7,2,367,11
2020-04-11,Peru,NA,Loreto,883510,13,1,380,12
2020-04-12,Peru,NA,Loreto,883510,25,3,405,15
2020-04-13,Peru,NA,Loreto,883510,26,0,431,15
2020-04-14,Peru,NA,Loreto,883510,31,5,462,20
2020-04-15,Peru,NA,Loreto,883510,12,3,474,23
2020-04-16,Peru,NA,Loreto,883510,8,2,482,25
2020-04-17,Peru,NA,Loreto,883510,58,4,540,29
2020-04-18,Peru,NA,Loreto,883510,71,5,611,34
2020-04-19,Peru,NA,Loreto,883510,42,0,653,34
2020-04-20,Peru,NA,Loreto,883510,42,0,695,34
2020-04-21,Peru,NA,Loreto,883510,19,2,714,36
2020-04-22,Peru,NA,Loreto,883510,18,10,732,46
2020-04-23,Peru,NA,Loreto,883510,25,15,757,61
2020-04-24,Peru,NA,Loreto,883510,79,13,836,74
2020-04-25,Peru,NA,Loreto,883510,84,17,920,91
2020-04-26,Peru,NA,Loreto,883510,59,16,979,107
2020-04-27,Peru,NA,Loreto,883510,74,13,1053,120
2020-04-28,Peru,NA,Loreto,883510,173,27,1226,147
2020-04-29,Peru,NA,Loreto,883510,230,27,1456,174
2020-04-30,Peru,NA,Loreto,883510,94,26,1550,200
2020-05-01,Peru,NA,Loreto,883510,147,25,1697,225
2020-05-02,Peru,NA,Loreto,883510,106,27,1803,252
2020-05-03,Peru,NA,Loreto,883510,25,28,1828,280
2020-05-04,Peru,NA,Loreto,883510,133,26,1961,306
2020-05-05,Peru,NA,Loreto,883510,60,25,2021,331
2020-05-06,Peru,NA,Loreto,883510,110,19,2131,350
2020-05-07,Peru,NA,Loreto,883510,76,8,2207,358
2020-05-08,Peru,NA,Loreto,883510,126,15,2333,373
2020-05-09,Peru,NA,Loreto,883510,105,19,2438,392
2020-05-10,Peru,NA,Loreto,883510,51,15,2489,407
2020-05-11,Peru,NA,Loreto,883510,193,22,2682,429
2020-05-12,Peru,NA,Loreto,883510,124,5,2806,434
2020-05-13,Peru,NA,Loreto,883510,157,3,2963,437
2020-05-14,Peru,NA,Loreto,883510,133,8,3096,445
2020-05-15,Peru,NA,Loreto,883510,241,7,3337,452
2020-05-16,Peru,NA,Loreto,883510,156,16,3493,468
2020-05-17,Peru,NA,Loreto,883510,76,15,3569,483
2020-05-18,Peru,NA,Loreto,883510,165,20,3734,503
2020-05-19,Peru,NA,Loreto,883510,257,15,3991,518
2020-05-20,Peru,NA,Loreto,883510,196,7,4187,525
2020-05-21,Peru,NA,Loreto,883510,203,14,4390,539
2020-05-22,Peru,NA,Loreto,883510,152,18,4542,557
2020-05-23,Peru,NA,Loreto,883510,149,15,4691,572
2020-05-24,Peru,NA,Loreto,883510,96,9,4787,581
2020-05-25,Peru,NA,Loreto,883510,135,17,4922,598
2020-05-26,Peru,NA,Loreto,883510,204,10,5126,608
2020-05-27,Peru,NA,Loreto,883510,149,9,5275,617
2020-05-28,Peru,NA,Loreto,883510,83,13,5358,630
2020-05-29,Peru,NA,Loreto,883510,184,14,5542,644
2020-05-30,Peru,NA,Loreto,883510,108,10,5650,654
2020-05-31,Peru,NA,Loreto,883510,290,9,5940,663
2020-06-01,Peru,NA,Loreto,883510,173,17,6113,680
2020-06-02,Peru,NA,Loreto,883510,166,6,6279,686
2020-06-03,Peru,NA,Loreto,883510,89,7,6368,693
2020-06-04,Peru,NA,Loreto,883510,197,9,6565,702
2020-06-05,Peru,NA,Loreto,883510,302,18,6867,720
2020-06-06,Peru,NA,Loreto,883510,184,9,7051,729
2020-06-07,Peru,NA,Loreto,883510,28,7,7079,736
2020-06-08,Peru,NA,Loreto,883510,171,11,7250,747
2020-06-09,Peru,NA,Loreto,883510,119,8,7369,755
2020-06-10,Peru,NA,Loreto,883510,221,8,7590,763
2020-06-11,Peru,NA,Loreto,883510,222,7,7812,770
2020-06-12,Peru,NA,Loreto,883510,196,10,8008,780
2020-06-13,Peru,NA,Loreto,883510,157,5,8165,785
2020-06-14,Peru,NA,Loreto,883510,16,5,8181,790
2020-06-15,Peru,NA,Loreto,883510,68,8,8249,798
2020-06-16,Peru,NA,Loreto,883510,62,3,8311,801
2020-06-17,Peru,NA,Loreto,883510,76,9,8387,810
2020-06-18,Peru,NA,Loreto,883510,136,6,8523,816
2020-06-19,Peru,NA,Loreto,883510,126,6,8649,822
2020-06-20,Peru,NA,Loreto,883510,96,4,8745,826
2020-06-21,Peru,NA,Loreto,883510,15,3,8760,829
2020-06-22,Peru,NA,Loreto,883510,255,3,9015,832
2020-06-23,Peru,NA,Loreto,883510,128,3,9143,835
2020-06-24,Peru,NA,Loreto,883510,37,5,9180,840
2020-06-25,Peru,NA,Loreto,883510,65,0,9245,840
2020-06-26,Peru,NA,Loreto,883510,88,5,9333,845
2020-06-27,Peru,NA,Loreto,883510,44,2,9377,847
2020-06-28,Peru,NA,Loreto,883510,31,3,9408,850
2020-06-29,Peru,NA,Loreto,883510,52,1,9460,851
2020-06-30,Peru,NA,Loreto,883510,57,1,9517,852
2020-07-01,Peru,NA,Loreto,883510,123,1,9640,853
2020-07-02,Peru,NA,Loreto,883510,79,1,9719,854
2020-07-03,Peru,NA,Loreto,883510,64,2,9783,856
2020-07-04,Peru,NA,Loreto,883510,75,1,9858,857
2020-07-05,Peru,NA,Loreto,883510,53,0,9911,857
2020-07-06,Peru,NA,Loreto,883510,113,2,10024,859
2020-07-07,Peru,NA,Loreto,883510,120,1,10144,860
2020-07-08,Peru,NA,Loreto,883510,60,1,10204,861
2020-07-09,Peru,NA,Loreto,883510,60,1,10264,862
2020-07-10,Peru,NA,Loreto,883510,122,3,10386,865
2020-07-11,Peru,NA,Loreto,883510,90,1,10476,866
2020-07-12,Peru,NA,Loreto,883510,50,1,10526,867
2020-07-13,Peru,NA,Loreto,883510,72,1,10598,868
2020-07-14,Peru,NA,Loreto,883510,81,2,10679,870
2020-07-15,Peru,NA,Loreto,883510,87,2,10766,872
2020-07-16,Peru,NA,Loreto,883510,105,0,10871,872
2020-07-17,Peru,NA,Loreto,883510,116,2,10987,874
2020-07-18,Peru,NA,Loreto,883510,100,1,11087,875
2020-07-19,Peru,NA,Loreto,883510,22,0,11109,875
2020-07-20,Peru,NA,Loreto,883510,168,2,11277,877
2020-07-21,Peru,NA,Loreto,883510,102,0,11379,877
2020-07-22,Peru,NA,Loreto,883510,77,1,11456,878
2020-07-23,Peru,NA,Loreto,883510,160,0,11616,878
2020-07-24,Peru,NA,Loreto,883510,162,2,11778,880
2020-07-25,Peru,NA,Loreto,883510,119,0,11897,880
2020-07-26,Peru,NA,Loreto,883510,40,0,11937,880
2020-07-27,Peru,NA,Loreto,883510,186,0,12123,880
2020-07-28,Peru,NA,Loreto,883510,68,1,12191,881
2020-07-29,Peru,NA,Loreto,883510,135,0,12326,881
2020-07-30,Peru,NA,Loreto,883510,164,1,12490,882
2020-07-31,Peru,NA,Loreto,883510,109,0,12599,882
2020-08-01,Peru,NA,Loreto,883510,164,3,12763,885
2020-08-02,Peru,NA,Loreto,883510,51,2,12814,887
2020-08-03,Peru,NA,Loreto,883510,184,1,12998,888
2020-08-04,Peru,NA,Loreto,883510,140,3,13138,891
2020-08-05,Peru,NA,Loreto,883510,101,2,13239,893
2020-08-06,Peru,NA,Loreto,883510,148,2,13387,895
2020-08-07,Peru,NA,Loreto,883510,126,3,13513,898
2020-08-08,Peru,NA,Loreto,883510,109,3,13622,901
2020-08-09,Peru,NA,Loreto,883510,29,1,13651,902
2020-08-10,Peru,NA,Loreto,883510,167,1,13818,903
2020-08-11,Peru,NA,Loreto,883510,144,0,13962,903
2020-08-12,Peru,NA,Loreto,883510,158,0,14120,903
2020-08-13,Peru,NA,Loreto,883510,179,1,14299,904
2020-08-14,Peru,NA,Loreto,883510,204,1,14503,905
2020-08-15,Peru,NA,Loreto,883510,148,0,14651,905
2020-08-16,Peru,NA,Loreto,883510,68,3,14719,908
2020-08-17,Peru,NA,Loreto,883510,153,2,14872,910
2020-08-18,Peru,NA,Loreto,883510,166,1,15038,911
2020-08-19,Peru,NA,Loreto,883510,173,2,15211,913
2020-08-20,Peru,NA,Loreto,883510,213,0,15424,913
2020-08-21,Peru,NA,Loreto,883510,153,2,15577,915
2020-08-22,Peru,NA,Loreto,883510,102,1,15679,916
2020-08-23,Peru,NA,Loreto,883510,38,3,15717,919
2020-08-24,Peru,NA,Loreto,883510,198,0,15915,919
2020-08-25,Peru,NA,Loreto,883510,192,0,16107,919
2020-08-26,Peru,NA,Loreto,883510,134,0,16241,919
2020-08-27,Peru,NA,Loreto,883510,113,2,16354,921
2020-08-28,Peru,NA,Loreto,883510,85,1,16439,922
2020-08-29,Peru,NA,Loreto,883510,67,0,16506,922
2020-08-30,Peru,NA,Loreto,883510,23,0,16529,922
2020-08-31,Peru,NA,Loreto,883510,88,1,16617,923
2020-09-01,Peru,NA,Loreto,883510,157,0,16774,923
2020-09-02,Peru,NA,Loreto,883510,120,0,16894,923
2020-09-03,Peru,NA,Loreto,883510,42,1,16936,924
2020-09-04,Peru,NA,Loreto,883510,152,3,17088,927
2020-09-05,Peru,NA,Loreto,883510,58,2,17146,929
2020-09-06,Peru,NA,Loreto,883510,11,0,17157,929
2020-09-07,Peru,NA,Loreto,883510,118,1,17275,930
2020-09-08,Peru,NA,Loreto,883510,81,2,17356,932
2020-09-09,Peru,NA,Loreto,883510,85,2,17441,934
2020-09-10,Peru,NA,Loreto,883510,49,1,17490,935
2020-09-11,Peru,NA,Loreto,883510,72,1,17562,936
2020-09-12,Peru,NA,Loreto,883510,108,2,17670,938
2020-09-13,Peru,NA,Loreto,883510,64,0,17734,938
2020-09-14,Peru,NA,Loreto,883510,76,0,17810,938
2020-09-15,Peru,NA,Loreto,883510,103,0,17913,938
2020-09-16,Peru,NA,Loreto,883510,67,0,17980,938
2020-09-17,Peru,NA,Loreto,883510,71,2,18051,940
2020-09-18,Peru,NA,Loreto,883510,60,2,18111,942
2020-09-19,Peru,NA,Loreto,883510,38,2,18149,944
2020-09-20,Peru,NA,Loreto,883510,17,0,18166,944
2020-09-21,Peru,NA,Loreto,883510,49,1,18215,945
2020-09-22,Peru,NA,Loreto,883510,10,0,18225,945
2020-04-11,Peru,NA,Madre de Dios,141070,16,0,22,0
2020-04-12,Peru,NA,Madre de Dios,141070,14,0,36,0
2020-04-13,Peru,NA,Madre de Dios,141070,5,0,41,0
2020-04-14,Peru,NA,Madre de Dios,141070,4,0,45,0
2020-04-15,Peru,NA,Madre de Dios,141070,7,0,52,0
2020-04-16,Peru,NA,Madre de Dios,141070,6,0,58,0
2020-04-17,Peru,NA,Madre de Dios,141070,5,0,63,0
2020-04-18,Peru,NA,Madre de Dios,141070,4,0,67,0
2020-04-20,Peru,NA,Madre de Dios,141070,5,0,72,0
2020-04-21,Peru,NA,Madre de Dios,141070,6,0,78,0
2020-04-22,Peru,NA,Madre de Dios,141070,13,0,91,0
2020-04-23,Peru,NA,Madre de Dios,141070,3,0,94,0
2020-04-24,Peru,NA,Madre de Dios,141070,3,0,97,0
2020-04-25,Peru,NA,Madre de Dios,141070,7,1,104,1
2020-04-26,Peru,NA,Madre de Dios,141070,1,0,105,1
2020-04-27,Peru,NA,Madre de Dios,141070,10,0,115,1
2020-04-28,Peru,NA,Madre de Dios,141070,3,0,118,1
2020-04-29,Peru,NA,Madre de Dios,141070,8,0,126,1
2020-04-30,Peru,NA,Madre de Dios,141070,3,0,129,1
2020-05-01,Peru,NA,Madre de Dios,141070,3,0,132,1
2020-05-02,Peru,NA,Madre de Dios,141070,3,0,135,1
2020-05-04,Peru,NA,Madre de Dios,141070,5,0,140,1
2020-05-05,Peru,NA,Madre de Dios,141070,5,0,145,1
2020-05-06,Peru,NA,Madre de Dios,141070,6,1,151,2
2020-05-07,Peru,NA,Madre de Dios,141070,3,0,154,2
2020-05-08,Peru,NA,Madre de Dios,141070,5,0,159,2
2020-05-09,Peru,NA,Madre de Dios,141070,14,1,173,3
2020-05-11,Peru,NA,Madre de Dios,141070,18,0,191,3
2020-05-12,Peru,NA,Madre de Dios,141070,12,0,203,3
2020-05-13,Peru,NA,Madre de Dios,141070,17,0,220,3
2020-05-14,Peru,NA,Madre de Dios,141070,10,0,230,3
2020-05-15,Peru,NA,Madre de Dios,141070,5,1,235,4
2020-05-16,Peru,NA,Madre de Dios,141070,20,0,255,4
2020-05-18,Peru,NA,Madre de Dios,141070,17,0,272,4
2020-05-19,Peru,NA,Madre de Dios,141070,10,0,282,4
2020-05-20,Peru,NA,Madre de Dios,141070,6,3,288,7
2020-05-21,Peru,NA,Madre de Dios,141070,10,1,298,8
2020-05-22,Peru,NA,Madre de Dios,141070,42,0,340,8
2020-05-23,Peru,NA,Madre de Dios,141070,32,0,372,8
2020-05-24,Peru,NA,Madre de Dios,141070,1,1,373,9
2020-05-25,Peru,NA,Madre de Dios,141070,39,0,412,9
2020-05-26,Peru,NA,Madre de Dios,141070,21,0,433,9
2020-05-27,Peru,NA,Madre de Dios,141070,27,0,460,9
2020-05-28,Peru,NA,Madre de Dios,141070,54,0,514,9
2020-05-29,Peru,NA,Madre de Dios,141070,53,0,567,9
2020-05-30,Peru,NA,Madre de Dios,141070,23,0,590,9
2020-05-31,Peru,NA,Madre de Dios,141070,2,1,592,10
2020-06-01,Peru,NA,Madre de Dios,141070,42,0,634,10
2020-06-02,Peru,NA,Madre de Dios,141070,36,0,670,10
2020-06-03,Peru,NA,Madre de Dios,141070,39,2,709,12
2020-06-04,Peru,NA,Madre de Dios,141070,106,3,815,15
2020-06-05,Peru,NA,Madre de Dios,141070,26,3,841,18
2020-06-06,Peru,NA,Madre de Dios,141070,23,2,864,20
2020-06-07,Peru,NA,Madre de Dios,141070,8,0,872,20
2020-06-08,Peru,NA,Madre de Dios,141070,56,4,928,24
2020-06-09,Peru,NA,Madre de Dios,141070,39,2,967,26
2020-06-10,Peru,NA,Madre de Dios,141070,63,3,1030,29
2020-06-11,Peru,NA,Madre de Dios,141070,30,1,1060,30
2020-06-12,Peru,NA,Madre de Dios,141070,34,2,1094,32
2020-06-13,Peru,NA,Madre de Dios,141070,38,3,1132,35
2020-06-14,Peru,NA,Madre de Dios,141070,7,3,1139,38
2020-06-15,Peru,NA,Madre de Dios,141070,64,0,1203,38
2020-06-16,Peru,NA,Madre de Dios,141070,105,1,1308,39
2020-06-17,Peru,NA,Madre de Dios,141070,43,2,1351,41
2020-06-18,Peru,NA,Madre de Dios,141070,24,2,1375,43
2020-06-19,Peru,NA,Madre de Dios,141070,63,1,1438,44
2020-06-20,Peru,NA,Madre de Dios,141070,39,4,1477,48
2020-06-21,Peru,NA,Madre de Dios,141070,5,5,1482,53
2020-06-22,Peru,NA,Madre de Dios,141070,42,4,1524,57
2020-06-23,Peru,NA,Madre de Dios,141070,55,3,1579,60
2020-06-24,Peru,NA,Madre de Dios,141070,42,7,1621,67
2020-06-25,Peru,NA,Madre de Dios,141070,70,1,1691,68
2020-06-26,Peru,NA,Madre de Dios,141070,63,4,1754,72
2020-06-27,Peru,NA,Madre de Dios,141070,81,1,1835,73
2020-06-28,Peru,NA,Madre de Dios,141070,14,3,1849,76
2020-06-29,Peru,NA,Madre de Dios,141070,41,3,1890,79
2020-06-30,Peru,NA,Madre de Dios,141070,74,4,1964,83
2020-07-01,Peru,NA,Madre de Dios,141070,78,5,2042,88
2020-07-02,Peru,NA,Madre de Dios,141070,72,2,2114,90
2020-07-03,Peru,NA,Madre de Dios,141070,72,1,2186,91
2020-07-04,Peru,NA,Madre de Dios,141070,58,0,2244,91
2020-07-05,Peru,NA,Madre de Dios,141070,12,3,2256,94
2020-07-06,Peru,NA,Madre de Dios,141070,58,0,2314,94
2020-07-07,Peru,NA,Madre de Dios,141070,53,2,2367,96
2020-07-08,Peru,NA,Madre de Dios,141070,9,1,2376,97
2020-07-09,Peru,NA,Madre de Dios,141070,11,2,2387,99
2020-07-10,Peru,NA,Madre de Dios,141070,53,0,2440,99
2020-07-11,Peru,NA,Madre de Dios,141070,41,1,2481,100
2020-07-12,Peru,NA,Madre de Dios,141070,13,1,2494,101
2020-07-13,Peru,NA,Madre de Dios,141070,15,0,2509,101
2020-07-14,Peru,NA,Madre de Dios,141070,77,1,2586,102
2020-07-15,Peru,NA,Madre de Dios,141070,2,0,2588,102
2020-07-16,Peru,NA,Madre de Dios,141070,19,1,2607,103
2020-07-17,Peru,NA,Madre de Dios,141070,48,1,2655,104
2020-07-18,Peru,NA,Madre de Dios,141070,43,0,2698,104
2020-07-19,Peru,NA,Madre de Dios,141070,9,1,2707,105
2020-07-20,Peru,NA,Madre de Dios,141070,74,0,2781,105
2020-07-21,Peru,NA,Madre de Dios,141070,58,1,2839,106
2020-07-22,Peru,NA,Madre de Dios,141070,67,0,2906,106
2020-07-23,Peru,NA,Madre de Dios,141070,87,2,2993,108
2020-07-24,Peru,NA,Madre de Dios,141070,93,0,3086,108
2020-07-25,Peru,NA,Madre de Dios,141070,73,0,3159,108
2020-07-26,Peru,NA,Madre de Dios,141070,17,0,3176,108
2020-07-27,Peru,NA,Madre de Dios,141070,104,0,3280,108
2020-07-28,Peru,NA,Madre de Dios,141070,74,1,3354,109
2020-07-29,Peru,NA,Madre de Dios,141070,66,0,3420,109
2020-07-30,Peru,NA,Madre de Dios,141070,116,3,3536,112
2020-07-31,Peru,NA,Madre de Dios,141070,153,0,3689,112
2020-08-01,Peru,NA,Madre de Dios,141070,51,4,3740,116
2020-08-02,Peru,NA,Madre de Dios,141070,18,0,3758,116
2020-08-03,Peru,NA,Madre de Dios,141070,89,0,3847,116
2020-08-04,Peru,NA,Madre de Dios,141070,89,2,3936,118
2020-08-05,Peru,NA,Madre de Dios,141070,98,0,4034,118
2020-08-06,Peru,NA,Madre de Dios,141070,201,0,4235,118
2020-08-07,Peru,NA,Madre de Dios,141070,61,1,4296,119
2020-08-08,Peru,NA,Madre de Dios,141070,41,0,4337,119
2020-08-09,Peru,NA,Madre de Dios,141070,31,0,4368,119
2020-08-10,Peru,NA,Madre de Dios,141070,91,2,4459,121
2020-08-11,Peru,NA,Madre de Dios,141070,79,0,4538,121
2020-08-12,Peru,NA,Madre de Dios,141070,143,1,4681,122
2020-08-13,Peru,NA,Madre de Dios,141070,148,2,4829,124
2020-08-14,Peru,NA,Madre de Dios,141070,107,2,4936,126
2020-08-15,Peru,NA,Madre de Dios,141070,49,1,4985,127
2020-08-16,Peru,NA,Madre de Dios,141070,7,1,4992,128
2020-08-17,Peru,NA,Madre de Dios,141070,75,0,5067,128
2020-08-18,Peru,NA,Madre de Dios,141070,114,0,5181,128
2020-08-19,Peru,NA,Madre de Dios,141070,110,0,5291,128
2020-08-20,Peru,NA,Madre de Dios,141070,107,0,5398,128
2020-08-21,Peru,NA,Madre de Dios,141070,66,0,5464,128
2020-08-22,Peru,NA,Madre de Dios,141070,73,1,5537,129
2020-08-23,Peru,NA,Madre de Dios,141070,11,0,5548,129
2020-08-24,Peru,NA,Madre de Dios,141070,80,0,5628,129
2020-08-25,Peru,NA,Madre de Dios,141070,190,0,5818,129
2020-08-26,Peru,NA,Madre de Dios,141070,128,0,5946,129
2020-08-27,Peru,NA,Madre de Dios,141070,100,0,6046,129
2020-08-28,Peru,NA,Madre de Dios,141070,118,0,6164,129
2020-08-29,Peru,NA,Madre de Dios,141070,86,0,6250,129
2020-08-30,Peru,NA,Madre de Dios,141070,7,0,6257,129
2020-08-31,Peru,NA,Madre de Dios,141070,89,0,6346,129
2020-09-01,Peru,NA,Madre de Dios,141070,70,0,6416,129
2020-09-02,Peru,NA,Madre de Dios,141070,103,0,6519,129
2020-09-03,Peru,NA,Madre de Dios,141070,19,2,6538,131
2020-09-04,Peru,NA,Madre de Dios,141070,81,0,6619,131
2020-09-05,Peru,NA,Madre de Dios,141070,19,0,6638,131
2020-09-06,Peru,NA,Madre de Dios,141070,15,0,6653,131
2020-09-07,Peru,NA,Madre de Dios,141070,48,0,6701,131
2020-09-08,Peru,NA,Madre de Dios,141070,62,1,6763,132
2020-09-09,Peru,NA,Madre de Dios,141070,50,0,6813,132
2020-09-10,Peru,NA,Madre de Dios,141070,93,0,6906,132
2020-09-11,Peru,NA,Madre de Dios,141070,259,0,7165,132
2020-09-12,Peru,NA,Madre de Dios,141070,164,0,7329,132
2020-09-13,Peru,NA,Madre de Dios,141070,10,0,7339,132
2020-09-14,Peru,NA,Madre de Dios,141070,39,2,7378,134
2020-09-15,Peru,NA,Madre de Dios,141070,38,0,7416,134
2020-09-16,Peru,NA,Madre de Dios,141070,36,1,7452,135
2020-09-17,Peru,NA,Madre de Dios,141070,57,1,7509,136
2020-09-18,Peru,NA,Madre de Dios,141070,48,0,7557,136
2020-09-19,Peru,NA,Madre de Dios,141070,53,0,7610,136
2020-09-20,Peru,NA,Madre de Dios,141070,40,0,7650,136
2020-09-21,Peru,NA,Madre de Dios,141070,54,0,7704,136
2020-09-22,Peru,NA,Madre de Dios,141070,11,0,7715,136
2020-03-11,Peru,NA,Metropolitan Municipality of Lima,8574974,6,0,15,0
2020-03-12,Peru,NA,Metropolitan Municipality of Lima,8574974,8,0,23,0
2020-03-13,Peru,NA,Metropolitan Municipality of Lima,8574974,9,0,32,0
2020-03-14,Peru,NA,Metropolitan Municipality of Lima,8574974,15,0,47,0
2020-03-15,Peru,NA,Metropolitan Municipality of Lima,8574974,22,0,69,0
2020-03-16,Peru,NA,Metropolitan Municipality of Lima,8574974,15,0,84,0
2020-03-17,Peru,NA,Metropolitan Municipality of Lima,8574974,16,0,100,0
2020-03-18,Peru,NA,Metropolitan Municipality of Lima,8574974,50,1,150,1
2020-03-19,Peru,NA,Metropolitan Municipality of Lima,8574974,53,3,203,4
2020-03-20,Peru,NA,Metropolitan Municipality of Lima,8574974,26,2,229,6
2020-03-21,Peru,NA,Metropolitan Municipality of Lima,8574974,27,0,256,6
2020-03-22,Peru,NA,Metropolitan Municipality of Lima,8574974,32,0,288,6
2020-03-23,Peru,NA,Metropolitan Municipality of Lima,8574974,26,1,314,7
2020-03-24,Peru,NA,Metropolitan Municipality of Lima,8574974,47,2,361,9
2020-03-25,Peru,NA,Metropolitan Municipality of Lima,8574974,83,0,444,9
2020-03-26,Peru,NA,Metropolitan Municipality of Lima,8574974,38,3,482,12
2020-03-27,Peru,NA,Metropolitan Municipality of Lima,8574974,21,6,503,18
2020-03-28,Peru,NA,Metropolitan Municipality of Lima,8574974,82,3,585,21
2020-03-29,Peru,NA,Metropolitan Municipality of Lima,8574974,107,9,692,30
2020-03-30,Peru,NA,Metropolitan Municipality of Lima,8574974,90,6,782,36
2020-03-31,Peru,NA,Metropolitan Municipality of Lima,8574974,190,12,972,48
2020-04-01,Peru,NA,Metropolitan Municipality of Lima,8574974,58,7,1030,55
2020-04-02,Peru,NA,Metropolitan Municipality of Lima,8574974,168,7,1198,62
2020-04-03,Peru,NA,Metropolitan Municipality of Lima,8574974,170,24,1368,86
2020-04-04,Peru,NA,Metropolitan Municipality of Lima,8574974,480,25,1848,111
2020-04-05,Peru,NA,Metropolitan Municipality of Lima,8574974,308,7,2156,118
2020-04-06,Peru,NA,Metropolitan Municipality of Lima,8574974,473,16,2629,134
2020-04-07,Peru,NA,Metropolitan Municipality of Lima,8574974,614,19,3243,153
2020-04-08,Peru,NA,Metropolitan Municipality of Lima,8574974,673,39,3916,192
2020-04-09,Peru,NA,Metropolitan Municipality of Lima,8574974,607,27,4523,219
2020-04-10,Peru,NA,Metropolitan Municipality of Lima,8574974,763,23,5286,242
2020-04-11,Peru,NA,Metropolitan Municipality of Lima,8574974,742,24,6028,266
2020-04-12,Peru,NA,Metropolitan Municipality of Lima,8574974,509,40,6537,306
2020-04-13,Peru,NA,Metropolitan Municipality of Lima,8574974,694,34,7231,340
2020-04-14,Peru,NA,Metropolitan Municipality of Lima,8574974,606,47,7837,387
2020-04-15,Peru,NA,Metropolitan Municipality of Lima,8574974,746,52,8583,439
2020-04-16,Peru,NA,Metropolitan Municipality of Lima,8574974,813,59,9396,498
2020-04-17,Peru,NA,Metropolitan Municipality of Lima,8574974,541,50,9937,548
2020-04-18,Peru,NA,Metropolitan Municipality of Lima,8574974,835,53,10772,601
2020-04-19,Peru,NA,Metropolitan Municipality of Lima,8574974,800,65,11572,666
2020-04-20,Peru,NA,Metropolitan Municipality of Lima,8574974,1073,72,12645,738
2020-04-21,Peru,NA,Metropolitan Municipality of Lima,8574974,1197,64,13842,802
2020-04-22,Peru,NA,Metropolitan Municipality of Lima,8574974,1363,72,15205,874
2020-04-23,Peru,NA,Metropolitan Municipality of Lima,8574974,1229,49,16434,923
2020-04-24,Peru,NA,Metropolitan Municipality of Lima,8574974,1253,65,17687,988
2020-04-25,Peru,NA,Metropolitan Municipality of Lima,8574974,1327,59,19014,1047
2020-04-26,Peru,NA,Metropolitan Municipality of Lima,8574974,944,74,19958,1121
2020-04-27,Peru,NA,Metropolitan Municipality of Lima,8574974,1870,77,21828,1198
2020-04-28,Peru,NA,Metropolitan Municipality of Lima,8574974,1654,76,23482,1274
2020-04-29,Peru,NA,Metropolitan Municipality of Lima,8574974,2447,60,25929,1334
2020-04-30,Peru,NA,Metropolitan Municipality of Lima,8574974,1652,68,27581,1402
2020-05-01,Peru,NA,Metropolitan Municipality of Lima,8574974,1299,101,28880,1503
2020-05-02,Peru,NA,Metropolitan Municipality of Lima,8574974,1842,77,30722,1580
2020-05-03,Peru,NA,Metropolitan Municipality of Lima,8574974,1157,91,31879,1671
2020-05-04,Peru,NA,Metropolitan Municipality of Lima,8574974,2148,80,34027,1751
2020-05-05,Peru,NA,Metropolitan Municipality of Lima,8574974,2313,83,36340,1834
2020-05-06,Peru,NA,Metropolitan Municipality of Lima,8574974,2211,85,38551,1919
2020-05-07,Peru,NA,Metropolitan Municipality of Lima,8574974,2266,85,40817,2004
2020-05-08,Peru,NA,Metropolitan Municipality of Lima,8574974,1943,88,42760,2092
2020-05-09,Peru,NA,Metropolitan Municipality of Lima,8574974,1360,105,44120,2197
2020-05-10,Peru,NA,Metropolitan Municipality of Lima,8574974,586,97,44706,2294
2020-05-11,Peru,NA,Metropolitan Municipality of Lima,8574974,2225,100,46931,2394
2020-05-12,Peru,NA,Metropolitan Municipality of Lima,8574974,2837,99,49768,2493
2020-05-13,Peru,NA,Metropolitan Municipality of Lima,8574974,2619,97,52387,2590
2020-05-14,Peru,NA,Metropolitan Municipality of Lima,8574974,2063,113,54450,2703
2020-05-15,Peru,NA,Metropolitan Municipality of Lima,8574974,2221,89,56671,2792
2020-05-16,Peru,NA,Metropolitan Municipality of Lima,8574974,2282,94,58953,2886
2020-05-17,Peru,NA,Metropolitan Municipality of Lima,8574974,1241,103,60194,2989
2020-05-18,Peru,NA,Metropolitan Municipality of Lima,8574974,2885,106,63079,3095
2020-05-19,Peru,NA,Metropolitan Municipality of Lima,8574974,2647,98,65726,3193
2020-05-20,Peru,NA,Metropolitan Municipality of Lima,8574974,2748,117,68474,3310
2020-05-21,Peru,NA,Metropolitan Municipality of Lima,8574974,2864,93,71338,3403
2020-05-22,Peru,NA,Metropolitan Municipality of Lima,8574974,3222,107,74560,3510
2020-05-23,Peru,NA,Metropolitan Municipality of Lima,8574974,2792,101,77352,3611
2020-05-24,Peru,NA,Metropolitan Municipality of Lima,8574974,923,133,78275,3744
2020-05-25,Peru,NA,Metropolitan Municipality of Lima,8574974,3839,122,82114,3866
2020-05-26,Peru,NA,Metropolitan Municipality of Lima,8574974,3810,34,85924,3900
2020-05-27,Peru,NA,Metropolitan Municipality of Lima,8574974,4020,64,89944,3964
2020-05-28,Peru,NA,Metropolitan Municipality of Lima,8574974,3377,68,93321,4032
2020-05-29,Peru,NA,Metropolitan Municipality of Lima,8574974,3000,75,96321,4107
2020-05-30,Peru,NA,Metropolitan Municipality of Lima,8574974,2437,81,98758,4188
2020-05-31,Peru,NA,Metropolitan Municipality of Lima,8574974,1300,72,100058,4260
2020-06-01,Peru,NA,Metropolitan Municipality of Lima,8574974,1935,84,101993,4344
2020-06-02,Peru,NA,Metropolitan Municipality of Lima,8574974,1806,74,103799,4418
2020-06-03,Peru,NA,Metropolitan Municipality of Lima,8574974,848,64,104647,4482
2020-06-04,Peru,NA,Metropolitan Municipality of Lima,8574974,1764,76,106411,4558
2020-06-05,Peru,NA,Metropolitan Municipality of Lima,8574974,2612,85,109023,4643
2020-06-06,Peru,NA,Metropolitan Municipality of Lima,8574974,2340,91,111363,4734
2020-06-07,Peru,NA,Metropolitan Municipality of Lima,8574974,1528,62,112891,4796
2020-06-08,Peru,NA,Metropolitan Municipality of Lima,8574974,2069,90,114960,4886
2020-06-09,Peru,NA,Metropolitan Municipality of Lima,8574974,2452,88,117412,4974
2020-06-10,Peru,NA,Metropolitan Municipality of Lima,8574974,2500,122,119912,5096
2020-06-11,Peru,NA,Metropolitan Municipality of Lima,8574974,1825,103,121737,5199
2020-06-12,Peru,NA,Metropolitan Municipality of Lima,8574974,1419,102,123156,5301
2020-06-13,Peru,NA,Metropolitan Municipality of Lima,8574974,1801,90,124957,5391
2020-06-14,Peru,NA,Metropolitan Municipality of Lima,8574974,1374,90,126331,5481
2020-06-15,Peru,NA,Metropolitan Municipality of Lima,8574974,1981,105,128312,5586
2020-06-16,Peru,NA,Metropolitan Municipality of Lima,8574974,1518,71,129830,5657
2020-06-17,Peru,NA,Metropolitan Municipality of Lima,8574974,1419,103,131249,5760
2020-06-18,Peru,NA,Metropolitan Municipality of Lima,8574974,1408,90,132657,5850
2020-06-19,Peru,NA,Metropolitan Municipality of Lima,8574974,1154,86,133811,5936
2020-06-20,Peru,NA,Metropolitan Municipality of Lima,8574974,1351,88,135162,6024
2020-06-21,Peru,NA,Metropolitan Municipality of Lima,8574974,513,73,135675,6097
2020-06-22,Peru,NA,Metropolitan Municipality of Lima,8574974,1600,82,137275,6179
2020-06-23,Peru,NA,Metropolitan Municipality of Lima,8574974,1450,84,138725,6263
2020-06-24,Peru,NA,Metropolitan Municipality of Lima,8574974,1607,72,140332,6335
2020-06-25,Peru,NA,Metropolitan Municipality of Lima,8574974,1709,81,142041,6416
2020-06-26,Peru,NA,Metropolitan Municipality of Lima,8574974,1579,93,143620,6509
2020-06-27,Peru,NA,Metropolitan Municipality of Lima,8574974,1221,79,144841,6588
2020-06-28,Peru,NA,Metropolitan Municipality of Lima,8574974,720,83,145561,6671
2020-06-29,Peru,NA,Metropolitan Municipality of Lima,8574974,964,62,146525,6733
2020-06-30,Peru,NA,Metropolitan Municipality of Lima,8574974,1299,81,147824,6814
2020-07-01,Peru,NA,Metropolitan Municipality of Lima,8574974,1242,64,149066,6878
2020-07-02,Peru,NA,Metropolitan Municipality of Lima,8574974,1049,66,150115,6944
2020-07-03,Peru,NA,Metropolitan Municipality of Lima,8574974,1346,82,151461,7026
2020-07-04,Peru,NA,Metropolitan Municipality of Lima,8574974,1212,70,152673,7096
2020-07-05,Peru,NA,Metropolitan Municipality of Lima,8574974,1026,73,153699,7169
2020-07-06,Peru,NA,Metropolitan Municipality of Lima,8574974,1327,49,155026,7218
2020-07-07,Peru,NA,Metropolitan Municipality of Lima,8574974,1491,60,156517,7278
2020-07-08,Peru,NA,Metropolitan Municipality of Lima,8574974,878,91,157395,7369
2020-07-09,Peru,NA,Metropolitan Municipality of Lima,8574974,998,77,158393,7446
2020-07-10,Peru,NA,Metropolitan Municipality of Lima,8574974,1599,83,159992,7529
2020-07-11,Peru,NA,Metropolitan Municipality of Lima,8574974,1161,74,161153,7603
2020-07-12,Peru,NA,Metropolitan Municipality of Lima,8574974,922,75,162075,7678
2020-07-13,Peru,NA,Metropolitan Municipality of Lima,8574974,1479,68,163554,7746
2020-07-14,Peru,NA,Metropolitan Municipality of Lima,8574974,1429,65,164983,7811
2020-07-15,Peru,NA,Metropolitan Municipality of Lima,8574974,1791,83,166774,7894
2020-07-16,Peru,NA,Metropolitan Municipality of Lima,8574974,1822,75,168596,7969
2020-07-17,Peru,NA,Metropolitan Municipality of Lima,8574974,1817,86,170413,8055
2020-07-18,Peru,NA,Metropolitan Municipality of Lima,8574974,1663,79,172076,8134
2020-07-19,Peru,NA,Metropolitan Municipality of Lima,8574974,1109,79,173185,8213
2020-07-20,Peru,NA,Metropolitan Municipality of Lima,8574974,1401,72,174586,8285
2020-07-21,Peru,NA,Metropolitan Municipality of Lima,8574974,1832,67,176418,8352
2020-07-22,Peru,NA,Metropolitan Municipality of Lima,8574974,2011,70,178429,8422
2020-07-23,Peru,NA,Metropolitan Municipality of Lima,8574974,1776,75,180205,8497
2020-07-24,Peru,NA,Metropolitan Municipality of Lima,8574974,2002,68,182207,8565
2020-07-25,Peru,NA,Metropolitan Municipality of Lima,8574974,1820,70,184027,8635
2020-07-26,Peru,NA,Metropolitan Municipality of Lima,8574974,1446,61,185473,8696
2020-07-27,Peru,NA,Metropolitan Municipality of Lima,8574974,2368,61,187841,8757
2020-07-28,Peru,NA,Metropolitan Municipality of Lima,8574974,1015,78,188856,8835
2020-07-29,Peru,NA,Metropolitan Municipality of Lima,8574974,2430,73,191286,8908
2020-07-30,Peru,NA,Metropolitan Municipality of Lima,8574974,2592,67,193878,8975
2020-07-31,Peru,NA,Metropolitan Municipality of Lima,8574974,2467,73,196345,9048
2020-08-01,Peru,NA,Metropolitan Municipality of Lima,8574974,2619,83,198964,9131
2020-08-02,Peru,NA,Metropolitan Municipality of Lima,8574974,1555,65,200519,9196
2020-08-03,Peru,NA,Metropolitan Municipality of Lima,8574974,2798,0,203317,9196
2020-08-04,Peru,NA,Metropolitan Municipality of Lima,8574974,2729,82,206046,9278
2020-08-05,Peru,NA,Metropolitan Municipality of Lima,8574974,2437,81,208483,9359
2020-08-06,Peru,NA,Metropolitan Municipality of Lima,8574974,2669,108,211152,9467
2020-08-07,Peru,NA,Metropolitan Municipality of Lima,8574974,2297,68,213449,9535
2020-08-08,Peru,NA,Metropolitan Municipality of Lima,8574974,2280,113,215729,9648
2020-08-09,Peru,NA,Metropolitan Municipality of Lima,8574974,1473,73,217202,9721
2020-08-10,Peru,NA,Metropolitan Municipality of Lima,8574974,2592,98,219794,9819
2020-08-11,Peru,NA,Metropolitan Municipality of Lima,8574974,3072,78,222866,9897
2020-08-12,Peru,NA,Metropolitan Municipality of Lima,8574974,3284,82,226150,9979
2020-08-13,Peru,NA,Metropolitan Municipality of Lima,8574974,2908,59,229058,10038
2020-08-14,Peru,NA,Metropolitan Municipality of Lima,8574974,3223,88,232281,10126
2020-08-15,Peru,NA,Metropolitan Municipality of Lima,8574974,3083,64,235364,10190
2020-08-16,Peru,NA,Metropolitan Municipality of Lima,8574974,1738,87,237102,10277
2020-08-17,Peru,NA,Metropolitan Municipality of Lima,8574974,3280,75,240382,10352
2020-08-18,Peru,NA,Metropolitan Municipality of Lima,8574974,2989,42,243371,10394
2020-08-19,Peru,NA,Metropolitan Municipality of Lima,8574974,3039,62,246410,10456
2020-08-20,Peru,NA,Metropolitan Municipality of Lima,8574974,2598,98,249008,10554
2020-08-21,Peru,NA,Metropolitan Municipality of Lima,8574974,2843,75,251851,10629
2020-08-22,Peru,NA,Metropolitan Municipality of Lima,8574974,2399,101,254250,10730
2020-08-23,Peru,NA,Metropolitan Municipality of Lima,8574974,941,69,255191,10799
2020-08-24,Peru,NA,Metropolitan Municipality of Lima,8574974,2445,91,257636,10890
2020-08-25,Peru,NA,Metropolitan Municipality of Lima,8574974,2716,51,260352,10941
2020-08-26,Peru,NA,Metropolitan Municipality of Lima,8574974,2547,70,262899,11011
2020-08-27,Peru,NA,Metropolitan Municipality of Lima,8574974,2338,80,265237,11091
2020-08-28,Peru,NA,Metropolitan Municipality of Lima,8574974,3009,61,268246,11152
2020-08-29,Peru,NA,Metropolitan Municipality of Lima,8574974,1899,88,270145,11240
2020-08-30,Peru,NA,Metropolitan Municipality of Lima,8574974,994,68,271139,11308
2020-08-31,Peru,NA,Metropolitan Municipality of Lima,8574974,2144,69,273283,11377
2020-09-01,Peru,NA,Metropolitan Municipality of Lima,8574974,1951,100,275234,11477
2020-09-02,Peru,NA,Metropolitan Municipality of Lima,8574974,2013,78,277247,11555
2020-09-03,Peru,NA,Metropolitan Municipality of Lima,8574974,1580,62,278827,11617
2020-09-04,Peru,NA,Metropolitan Municipality of Lima,8574974,2646,68,281473,11685
2020-09-05,Peru,NA,Metropolitan Municipality of Lima,8574974,1504,65,282977,11750
2020-09-06,Peru,NA,Metropolitan Municipality of Lima,8574974,778,53,283755,11803
2020-09-07,Peru,NA,Metropolitan Municipality of Lima,8574974,1937,66,285692,11869
2020-09-08,Peru,NA,Metropolitan Municipality of Lima,8574974,1805,58,287497,11927
2020-09-09,Peru,NA,Metropolitan Municipality of Lima,8574974,2017,48,289514,11975
2020-09-10,Peru,NA,Metropolitan Municipality of Lima,8574974,1150,62,290664,12037
2020-09-11,Peru,NA,Metropolitan Municipality of Lima,8574974,3607,55,294271,12092
2020-09-12,Peru,NA,Metropolitan Municipality of Lima,8574974,1794,47,296065,12139
2020-09-13,Peru,NA,Metropolitan Municipality of Lima,8574974,815,47,296880,12186
2020-09-14,Peru,NA,Metropolitan Municipality of Lima,8574974,1541,54,298421,12240
2020-09-15,Peru,NA,Metropolitan Municipality of Lima,8574974,1497,57,299918,12297
2020-09-16,Peru,NA,Metropolitan Municipality of Lima,8574974,1582,32,301500,12329
2020-09-17,Peru,NA,Metropolitan Municipality of Lima,8574974,2152,70,303652,12399
2020-09-18,Peru,NA,Metropolitan Municipality of Lima,8574974,1854,30,305506,12429
2020-09-19,Peru,NA,Metropolitan Municipality of Lima,8574974,1742,85,307248,12514
2020-09-20,Peru,NA,Metropolitan Municipality of Lima,8574974,603,49,307851,12563
2020-09-21,Peru,NA,Metropolitan Municipality of Lima,8574974,1425,55,309276,12618
2020-09-22,Peru,NA,Metropolitan Municipality of Lima,8574974,843,43,310119,12661
2020-04-13,Peru,NA,Moquegua,174863,2,0,12,0
2020-04-14,Peru,NA,Moquegua,174863,6,0,18,0
2020-04-15,Peru,NA,Moquegua,174863,4,0,22,0
2020-04-16,Peru,NA,Moquegua,174863,5,0,27,0
2020-04-17,Peru,NA,Moquegua,174863,5,0,32,0
2020-04-19,Peru,NA,Moquegua,174863,1,0,33,0
2020-04-20,Peru,NA,Moquegua,174863,9,0,42,0
2020-04-21,Peru,NA,Moquegua,174863,8,0,50,0
2020-04-22,Peru,NA,Moquegua,174863,4,0,54,0
2020-04-23,Peru,NA,Moquegua,174863,7,0,61,0
2020-04-24,Peru,NA,Moquegua,174863,16,0,77,0
2020-04-25,Peru,NA,Moquegua,174863,19,0,96,0
2020-04-26,Peru,NA,Moquegua,174863,6,0,102,0
2020-04-27,Peru,NA,Moquegua,174863,3,0,105,0
2020-04-28,Peru,NA,Moquegua,174863,12,1,117,1
2020-04-29,Peru,NA,Moquegua,174863,23,0,140,1
2020-04-30,Peru,NA,Moquegua,174863,10,0,150,1
2020-05-01,Peru,NA,Moquegua,174863,12,0,162,1
2020-05-02,Peru,NA,Moquegua,174863,6,0,168,1
2020-05-04,Peru,NA,Moquegua,174863,16,0,184,1
2020-05-05,Peru,NA,Moquegua,174863,14,0,198,1
2020-05-06,Peru,NA,Moquegua,174863,5,0,203,1
2020-05-07,Peru,NA,Moquegua,174863,4,0,207,1
2020-05-08,Peru,NA,Moquegua,174863,25,0,232,1
2020-05-09,Peru,NA,Moquegua,174863,2,0,234,1
2020-05-11,Peru,NA,Moquegua,174863,5,0,239,1
2020-05-12,Peru,NA,Moquegua,174863,2,0,241,1
2020-05-13,Peru,NA,Moquegua,174863,12,0,253,1
2020-05-14,Peru,NA,Moquegua,174863,9,0,262,1
2020-05-15,Peru,NA,Moquegua,174863,1,1,263,2
2020-05-16,Peru,NA,Moquegua,174863,13,0,276,2
2020-05-17,Peru,NA,Moquegua,174863,1,0,277,2
2020-05-18,Peru,NA,Moquegua,174863,11,1,288,3
2020-05-19,Peru,NA,Moquegua,174863,45,0,333,3
2020-05-20,Peru,NA,Moquegua,174863,64,0,397,3
2020-05-21,Peru,NA,Moquegua,174863,49,1,446,4
2020-05-22,Peru,NA,Moquegua,174863,60,0,506,4
2020-05-23,Peru,NA,Moquegua,174863,36,0,542,4
2020-05-24,Peru,NA,Moquegua,174863,18,0,560,4
2020-05-25,Peru,NA,Moquegua,174863,32,1,592,5
2020-05-26,Peru,NA,Moquegua,174863,27,0,619,5
2020-05-27,Peru,NA,Moquegua,174863,39,0,658,5
2020-05-28,Peru,NA,Moquegua,174863,17,0,675,5
2020-05-29,Peru,NA,Moquegua,174863,16,1,691,6
2020-05-30,Peru,NA,Moquegua,174863,11,0,702,6
2020-05-31,Peru,NA,Moquegua,174863,1,0,703,6
2020-06-01,Peru,NA,Moquegua,174863,8,0,711,6
2020-06-02,Peru,NA,Moquegua,174863,10,0,721,6
2020-06-03,Peru,NA,Moquegua,174863,14,0,735,6
2020-06-04,Peru,NA,Moquegua,174863,22,0,757,6
2020-06-05,Peru,NA,Moquegua,174863,5,0,762,6
2020-06-06,Peru,NA,Moquegua,174863,2,1,764,7
2020-06-07,Peru,NA,Moquegua,174863,2,2,766,9
2020-06-08,Peru,NA,Moquegua,174863,7,0,773,9
2020-06-09,Peru,NA,Moquegua,174863,4,1,777,10
2020-06-10,Peru,NA,Moquegua,174863,5,0,782,10
2020-06-11,Peru,NA,Moquegua,174863,10,1,792,11
2020-06-12,Peru,NA,Moquegua,174863,9,0,801,11
2020-06-13,Peru,NA,Moquegua,174863,13,0,814,11
2020-06-14,Peru,NA,Moquegua,174863,3,1,817,12
2020-06-15,Peru,NA,Moquegua,174863,14,0,831,12
2020-06-16,Peru,NA,Moquegua,174863,4,0,835,12
2020-06-17,Peru,NA,Moquegua,174863,2,2,837,14
2020-06-18,Peru,NA,Moquegua,174863,5,1,842,15
2020-06-19,Peru,NA,Moquegua,174863,7,0,849,15
2020-06-20,Peru,NA,Moquegua,174863,11,1,860,16
2020-06-21,Peru,NA,Moquegua,174863,4,0,864,16
2020-06-22,Peru,NA,Moquegua,174863,4,0,868,16
2020-06-23,Peru,NA,Moquegua,174863,11,2,879,18
2020-06-24,Peru,NA,Moquegua,174863,22,3,901,21
2020-06-25,Peru,NA,Moquegua,174863,12,0,913,21
2020-06-26,Peru,NA,Moquegua,174863,15,0,928,21
2020-06-27,Peru,NA,Moquegua,174863,12,2,940,23
2020-06-28,Peru,NA,Moquegua,174863,6,0,946,23
2020-06-29,Peru,NA,Moquegua,174863,6,4,952,27
2020-06-30,Peru,NA,Moquegua,174863,53,2,1005,29
2020-07-01,Peru,NA,Moquegua,174863,35,2,1040,31
2020-07-02,Peru,NA,Moquegua,174863,21,0,1061,31
2020-07-03,Peru,NA,Moquegua,174863,38,2,1099,33
2020-07-04,Peru,NA,Moquegua,174863,52,3,1151,36
2020-07-05,Peru,NA,Moquegua,174863,10,1,1161,37
2020-07-06,Peru,NA,Moquegua,174863,39,3,1200,40
2020-07-07,Peru,NA,Moquegua,174863,40,2,1240,42
2020-07-08,Peru,NA,Moquegua,174863,33,4,1273,46
2020-07-09,Peru,NA,Moquegua,174863,24,2,1297,48
2020-07-10,Peru,NA,Moquegua,174863,79,2,1376,50
2020-07-11,Peru,NA,Moquegua,174863,57,3,1433,53
2020-07-12,Peru,NA,Moquegua,174863,25,1,1458,54
2020-07-13,Peru,NA,Moquegua,174863,21,4,1479,58
2020-07-14,Peru,NA,Moquegua,174863,91,8,1570,66
2020-07-15,Peru,NA,Moquegua,174863,49,5,1619,71
2020-07-16,Peru,NA,Moquegua,174863,86,5,1705,76
2020-07-17,Peru,NA,Moquegua,174863,124,2,1829,78
2020-07-18,Peru,NA,Moquegua,174863,76,5,1905,83
2020-07-19,Peru,NA,Moquegua,174863,57,12,1962,95
2020-07-20,Peru,NA,Moquegua,174863,52,11,2014,106
2020-07-21,Peru,NA,Moquegua,174863,120,5,2134,111
2020-07-22,Peru,NA,Moquegua,174863,129,4,2263,115
2020-07-23,Peru,NA,Moquegua,174863,87,2,2350,117
2020-07-24,Peru,NA,Moquegua,174863,89,2,2439,119
2020-07-25,Peru,NA,Moquegua,174863,130,0,2569,119
2020-07-26,Peru,NA,Moquegua,174863,25,1,2594,120
2020-07-27,Peru,NA,Moquegua,174863,144,2,2738,122
2020-07-28,Peru,NA,Moquegua,174863,57,1,2795,123
2020-07-29,Peru,NA,Moquegua,174863,91,2,2886,125
2020-07-30,Peru,NA,Moquegua,174863,203,2,3089,127
2020-07-31,Peru,NA,Moquegua,174863,130,3,3219,130
2020-08-01,Peru,NA,Moquegua,174863,98,7,3317,137
2020-08-02,Peru,NA,Moquegua,174863,49,1,3366,138
2020-08-03,Peru,NA,Moquegua,174863,180,0,3546,138
2020-08-04,Peru,NA,Moquegua,174863,243,8,3789,146
2020-08-05,Peru,NA,Moquegua,174863,255,1,4044,147
2020-08-06,Peru,NA,Moquegua,174863,359,2,4403,149
2020-08-07,Peru,NA,Moquegua,174863,310,8,4713,157
2020-08-08,Peru,NA,Moquegua,174863,88,3,4801,160
2020-08-09,Peru,NA,Moquegua,174863,63,0,4864,160
2020-08-10,Peru,NA,Moquegua,174863,208,6,5072,166
2020-08-11,Peru,NA,Moquegua,174863,521,3,5593,169
2020-08-12,Peru,NA,Moquegua,174863,212,4,5805,173
2020-08-13,Peru,NA,Moquegua,174863,286,3,6091,176
2020-08-14,Peru,NA,Moquegua,174863,253,3,6344,179
2020-08-15,Peru,NA,Moquegua,174863,275,5,6619,184
2020-08-16,Peru,NA,Moquegua,174863,56,2,6675,186
2020-08-17,Peru,NA,Moquegua,174863,299,5,6974,191
2020-08-18,Peru,NA,Moquegua,174863,178,2,7152,193
2020-08-19,Peru,NA,Moquegua,174863,331,3,7483,196
2020-08-20,Peru,NA,Moquegua,174863,213,1,7696,197
2020-08-21,Peru,NA,Moquegua,174863,195,3,7891,200
2020-08-22,Peru,NA,Moquegua,174863,87,8,7978,208
2020-08-23,Peru,NA,Moquegua,174863,75,4,8053,212
2020-08-24,Peru,NA,Moquegua,174863,198,2,8251,214
2020-08-25,Peru,NA,Moquegua,174863,236,6,8487,220
2020-08-26,Peru,NA,Moquegua,174863,196,1,8683,221
2020-08-27,Peru,NA,Moquegua,174863,127,2,8810,223
2020-08-28,Peru,NA,Moquegua,174863,219,2,9029,225
2020-08-29,Peru,NA,Moquegua,174863,67,2,9096,227
2020-08-30,Peru,NA,Moquegua,174863,15,2,9111,229
2020-08-31,Peru,NA,Moquegua,174863,173,0,9284,229
2020-09-01,Peru,NA,Moquegua,174863,91,3,9375,232
2020-09-02,Peru,NA,Moquegua,174863,153,1,9528,233
2020-09-03,Peru,NA,Moquegua,174863,42,2,9570,235
2020-09-04,Peru,NA,Moquegua,174863,211,2,9781,237
2020-09-05,Peru,NA,Moquegua,174863,28,1,9809,238
2020-09-06,Peru,NA,Moquegua,174863,11,3,9820,241
2020-09-07,Peru,NA,Moquegua,174863,90,0,9910,241
2020-09-08,Peru,NA,Moquegua,174863,153,0,10063,241
2020-09-09,Peru,NA,Moquegua,174863,118,0,10181,241
2020-09-10,Peru,NA,Moquegua,174863,155,2,10336,243
2020-09-11,Peru,NA,Moquegua,174863,409,1,10745,244
2020-09-12,Peru,NA,Moquegua,174863,197,2,10942,246
2020-09-13,Peru,NA,Moquegua,174863,35,1,10977,247
2020-09-14,Peru,NA,Moquegua,174863,212,2,11189,249
2020-09-15,Peru,NA,Moquegua,174863,199,3,11388,252
2020-09-16,Peru,NA,Moquegua,174863,240,0,11628,252
2020-09-17,Peru,NA,Moquegua,174863,226,1,11854,253
2020-09-18,Peru,NA,Moquegua,174863,210,2,12064,255
2020-09-19,Peru,NA,Moquegua,174863,335,2,12399,257
2020-09-20,Peru,NA,Moquegua,174863,14,0,12413,257
2020-09-21,Peru,NA,Moquegua,174863,149,1,12562,258
2020-09-22,Peru,NA,Moquegua,174863,89,1,12651,259
2020-04-10,Peru,NA,Pasco,254065,1,0,11,0
2020-04-11,Peru,NA,Pasco,254065,2,0,13,0
2020-04-14,Peru,NA,Pasco,254065,2,0,15,0
2020-04-15,Peru,NA,Pasco,254065,3,0,18,0
2020-04-16,Peru,NA,Pasco,254065,3,0,21,0
2020-04-17,Peru,NA,Pasco,254065,3,1,24,1
2020-04-18,Peru,NA,Pasco,254065,16,0,40,1
2020-04-19,Peru,NA,Pasco,254065,2,0,42,1
2020-04-20,Peru,NA,Pasco,254065,13,0,55,1
2020-04-21,Peru,NA,Pasco,254065,12,0,67,1
2020-04-22,Peru,NA,Pasco,254065,9,0,76,1
2020-04-23,Peru,NA,Pasco,254065,12,0,88,1
2020-04-24,Peru,NA,Pasco,254065,10,0,98,1
2020-04-25,Peru,NA,Pasco,254065,16,0,114,1
2020-04-26,Peru,NA,Pasco,254065,6,0,120,1
2020-04-27,Peru,NA,Pasco,254065,15,0,135,1
2020-04-28,Peru,NA,Pasco,254065,9,0,144,1
2020-04-29,Peru,NA,Pasco,254065,14,0,158,1
2020-04-30,Peru,NA,Pasco,254065,3,0,161,1
2020-05-01,Peru,NA,Pasco,254065,7,1,168,2
2020-05-02,Peru,NA,Pasco,254065,11,1,179,3
2020-05-03,Peru,NA,Pasco,254065,5,0,184,3
2020-05-04,Peru,NA,Pasco,254065,31,0,215,3
2020-05-05,Peru,NA,Pasco,254065,11,0,226,3
2020-05-06,Peru,NA,Pasco,254065,10,1,236,4
2020-05-07,Peru,NA,Pasco,254065,7,0,243,4
2020-05-08,Peru,NA,Pasco,254065,3,0,246,4
2020-05-09,Peru,NA,Pasco,254065,8,0,254,4
2020-05-10,Peru,NA,Pasco,254065,2,0,256,4
2020-05-11,Peru,NA,Pasco,254065,3,0,259,4
2020-05-12,Peru,NA,Pasco,254065,12,0,271,4
2020-05-13,Peru,NA,Pasco,254065,10,0,281,4
2020-05-14,Peru,NA,Pasco,254065,16,0,297,4
2020-05-15,Peru,NA,Pasco,254065,10,0,307,4
2020-05-16,Peru,NA,Pasco,254065,20,0,327,4
2020-05-17,Peru,NA,Pasco,254065,8,1,335,5
2020-05-18,Peru,NA,Pasco,254065,10,0,345,5
2020-05-19,Peru,NA,Pasco,254065,22,0,367,5
2020-05-20,Peru,NA,Pasco,254065,26,2,393,7
2020-05-21,Peru,NA,Pasco,254065,33,1,426,8
2020-05-22,Peru,NA,Pasco,254065,52,1,478,9
2020-05-23,Peru,NA,Pasco,254065,45,0,523,9
2020-05-24,Peru,NA,Pasco,254065,25,0,548,9
2020-05-25,Peru,NA,Pasco,254065,20,0,568,9
2020-05-26,Peru,NA,Pasco,254065,21,0,589,9
2020-05-27,Peru,NA,Pasco,254065,26,0,615,9
2020-05-28,Peru,NA,Pasco,254065,22,0,637,9
2020-05-29,Peru,NA,Pasco,254065,4,1,641,10
2020-05-30,Peru,NA,Pasco,254065,12,0,653,10
2020-05-31,Peru,NA,Pasco,254065,3,0,656,10
2020-06-01,Peru,NA,Pasco,254065,33,2,689,12
2020-06-02,Peru,NA,Pasco,254065,10,1,699,13
2020-06-03,Peru,NA,Pasco,254065,33,0,732,13
2020-06-04,Peru,NA,Pasco,254065,29,0,761,13
2020-06-05,Peru,NA,Pasco,254065,13,0,774,13
2020-06-06,Peru,NA,Pasco,254065,8,0,782,13
2020-06-07,Peru,NA,Pasco,254065,11,0,793,13
2020-06-08,Peru,NA,Pasco,254065,21,1,814,14
2020-06-09,Peru,NA,Pasco,254065,27,1,841,15
2020-06-10,Peru,NA,Pasco,254065,28,0,869,15
2020-06-11,Peru,NA,Pasco,254065,18,0,887,15
2020-06-12,Peru,NA,Pasco,254065,12,0,899,15
2020-06-13,Peru,NA,Pasco,254065,35,0,934,15
2020-06-14,Peru,NA,Pasco,254065,13,2,947,17
2020-06-15,Peru,NA,Pasco,254065,24,2,971,19
2020-06-16,Peru,NA,Pasco,254065,6,1,977,20
2020-06-17,Peru,NA,Pasco,254065,4,0,981,20
2020-06-18,Peru,NA,Pasco,254065,14,1,995,21
2020-06-19,Peru,NA,Pasco,254065,18,0,1013,21
2020-06-20,Peru,NA,Pasco,254065,10,3,1023,24
2020-06-21,Peru,NA,Pasco,254065,1,4,1024,28
2020-06-22,Peru,NA,Pasco,254065,7,0,1031,28
2020-06-23,Peru,NA,Pasco,254065,13,1,1044,29
2020-06-24,Peru,NA,Pasco,254065,11,0,1055,29
2020-06-25,Peru,NA,Pasco,254065,13,1,1068,30
2020-06-26,Peru,NA,Pasco,254065,18,0,1086,30
2020-06-27,Peru,NA,Pasco,254065,15,0,1101,30
2020-06-28,Peru,NA,Pasco,254065,8,0,1109,30
2020-06-29,Peru,NA,Pasco,254065,15,1,1124,31
2020-06-30,Peru,NA,Pasco,254065,13,3,1137,34
2020-07-01,Peru,NA,Pasco,254065,13,0,1150,34
2020-07-02,Peru,NA,Pasco,254065,22,0,1172,34
2020-07-03,Peru,NA,Pasco,254065,6,1,1178,35
2020-07-04,Peru,NA,Pasco,254065,19,0,1197,35
2020-07-05,Peru,NA,Pasco,254065,11,1,1208,36
2020-07-06,Peru,NA,Pasco,254065,24,0,1232,36
2020-07-07,Peru,NA,Pasco,254065,22,0,1254,36
2020-07-08,Peru,NA,Pasco,254065,27,0,1281,36
2020-07-09,Peru,NA,Pasco,254065,9,0,1290,36
2020-07-10,Peru,NA,Pasco,254065,72,0,1362,36
2020-07-11,Peru,NA,Pasco,254065,34,3,1396,39
2020-07-12,Peru,NA,Pasco,254065,20,1,1416,40
2020-07-13,Peru,NA,Pasco,254065,27,1,1443,41
2020-07-14,Peru,NA,Pasco,254065,16,2,1459,43
2020-07-15,Peru,NA,Pasco,254065,15,1,1474,44
2020-07-16,Peru,NA,Pasco,254065,14,1,1488,45
2020-07-17,Peru,NA,Pasco,254065,19,1,1507,46
2020-07-18,Peru,NA,Pasco,254065,35,2,1542,48
2020-07-19,Peru,NA,Pasco,254065,12,0,1554,48
2020-07-20,Peru,NA,Pasco,254065,18,1,1572,49
2020-07-21,Peru,NA,Pasco,254065,28,0,1600,49
2020-07-22,Peru,NA,Pasco,254065,31,0,1631,49
2020-07-23,Peru,NA,Pasco,254065,32,1,1663,50
2020-07-24,Peru,NA,Pasco,254065,33,0,1696,50
2020-07-25,Peru,NA,Pasco,254065,54,2,1750,52
2020-07-26,Peru,NA,Pasco,254065,31,1,1781,53
2020-07-27,Peru,NA,Pasco,254065,58,1,1839,54
2020-07-28,Peru,NA,Pasco,254065,23,0,1862,54
2020-07-29,Peru,NA,Pasco,254065,58,3,1920,57
2020-07-30,Peru,NA,Pasco,254065,95,2,2015,59
2020-07-31,Peru,NA,Pasco,254065,59,2,2074,61
2020-08-01,Peru,NA,Pasco,254065,36,1,2110,62
2020-08-02,Peru,NA,Pasco,254065,97,0,2207,62
2020-08-03,Peru,NA,Pasco,254065,79,0,2286,62
2020-08-04,Peru,NA,Pasco,254065,119,2,2405,64
2020-08-05,Peru,NA,Pasco,254065,68,0,2473,64
2020-08-06,Peru,NA,Pasco,254065,124,0,2597,64
2020-08-07,Peru,NA,Pasco,254065,69,1,2666,65
2020-08-08,Peru,NA,Pasco,254065,66,0,2732,65
2020-08-09,Peru,NA,Pasco,254065,60,1,2792,66
2020-08-10,Peru,NA,Pasco,254065,84,3,2876,69
2020-08-11,Peru,NA,Pasco,254065,87,1,2963,70
2020-08-12,Peru,NA,Pasco,254065,55,0,3018,70
2020-08-13,Peru,NA,Pasco,254065,55,1,3073,71
2020-08-14,Peru,NA,Pasco,254065,70,2,3143,73
2020-08-15,Peru,NA,Pasco,254065,40,2,3183,75
2020-08-16,Peru,NA,Pasco,254065,40,0,3223,75
2020-08-17,Peru,NA,Pasco,254065,60,0,3283,75
2020-08-18,Peru,NA,Pasco,254065,52,1,3335,76
2020-08-19,Peru,NA,Pasco,254065,58,0,3393,76
2020-08-20,Peru,NA,Pasco,254065,82,1,3475,77
2020-08-21,Peru,NA,Pasco,254065,59,1,3534,78
2020-08-22,Peru,NA,Pasco,254065,23,1,3557,79
2020-08-23,Peru,NA,Pasco,254065,4,2,3561,81
2020-08-24,Peru,NA,Pasco,254065,48,1,3609,82
2020-08-25,Peru,NA,Pasco,254065,100,0,3709,82
2020-08-26,Peru,NA,Pasco,254065,49,1,3758,83
2020-08-27,Peru,NA,Pasco,254065,81,2,3839,85
2020-08-28,Peru,NA,Pasco,254065,66,2,3905,87
2020-08-29,Peru,NA,Pasco,254065,72,1,3977,88
2020-08-30,Peru,NA,Pasco,254065,14,1,3991,89
2020-08-31,Peru,NA,Pasco,254065,56,0,4047,89
2020-09-01,Peru,NA,Pasco,254065,41,0,4088,89
2020-09-02,Peru,NA,Pasco,254065,66,0,4154,89
2020-09-03,Peru,NA,Pasco,254065,12,2,4166,91
2020-09-04,Peru,NA,Pasco,254065,109,0,4275,91
2020-09-05,Peru,NA,Pasco,254065,32,1,4307,92
2020-09-06,Peru,NA,Pasco,254065,7,0,4314,92
2020-09-07,Peru,NA,Pasco,254065,59,0,4373,92
2020-09-08,Peru,NA,Pasco,254065,47,0,4420,92
2020-09-09,Peru,NA,Pasco,254065,46,1,4466,93
2020-09-10,Peru,NA,Pasco,254065,18,1,4484,94
2020-09-11,Peru,NA,Pasco,254065,63,0,4547,94
2020-09-12,Peru,NA,Pasco,254065,28,2,4575,96
2020-09-13,Peru,NA,Pasco,254065,12,1,4587,97
2020-09-14,Peru,NA,Pasco,254065,61,0,4648,97
2020-09-15,Peru,NA,Pasco,254065,40,2,4688,99
2020-09-16,Peru,NA,Pasco,254065,40,0,4728,99
2020-09-17,Peru,NA,Pasco,254065,30,1,4758,100
2020-09-18,Peru,NA,Pasco,254065,63,1,4821,101
2020-09-19,Peru,NA,Pasco,254065,27,1,4848,102
2020-09-20,Peru,NA,Pasco,254065,16,0,4864,102
2020-09-21,Peru,NA,Pasco,254065,38,2,4902,104
2020-09-22,Peru,NA,Pasco,254065,3,1,4905,105
2020-03-20,Peru,NA,Piura,1856809,15,0,17,0
2020-03-21,Peru,NA,Piura,1856809,1,1,18,1
2020-03-25,Peru,NA,Piura,1856809,1,0,19,1
2020-03-28,Peru,NA,Piura,1856809,1,0,20,1
2020-03-29,Peru,NA,Piura,1856809,0,1,20,2
2020-03-31,Peru,NA,Piura,1856809,5,0,25,2
2020-04-01,Peru,NA,Piura,1856809,4,0,29,2
2020-04-02,Peru,NA,Piura,1856809,1,1,30,3
2020-04-03,Peru,NA,Piura,1856809,2,1,32,4
2020-04-04,Peru,NA,Piura,1856809,5,4,37,7
2020-04-05,Peru,NA,Piura,1856809,1,0,38,7
2020-04-06,Peru,NA,Piura,1856809,8,1,46,9
2020-04-07,Peru,NA,Piura,1856809,11,2,57,11
2020-04-08,Peru,NA,Piura,1856809,21,2,78,13
2020-04-09,Peru,NA,Piura,1856809,40,1,118,14
2020-04-10,Peru,NA,Piura,1856809,36,6,154,20
2020-04-11,Peru,NA,Piura,1856809,49,3,203,23
2020-04-12,Peru,NA,Piura,1856809,32,4,235,27
2020-04-13,Peru,NA,Piura,1856809,31,6,266,33
2020-04-14,Peru,NA,Piura,1856809,55,6,321,39
2020-04-15,Peru,NA,Piura,1856809,77,6,398,45
2020-04-16,Peru,NA,Piura,1856809,52,7,450,52
2020-04-17,Peru,NA,Piura,1856809,49,6,499,58
2020-04-18,Peru,NA,Piura,1856809,42,6,541,64
2020-04-19,Peru,NA,Piura,1856809,12,8,553,72
2020-04-20,Peru,NA,Piura,1856809,54,7,607,79
2020-04-21,Peru,NA,Piura,1856809,50,9,657,88
2020-04-22,Peru,NA,Piura,1856809,72,4,729,92
2020-04-23,Peru,NA,Piura,1856809,103,7,832,99
2020-04-24,Peru,NA,Piura,1856809,152,12,984,111
2020-04-25,Peru,NA,Piura,1856809,158,7,1142,118
2020-04-26,Peru,NA,Piura,1856809,80,13,1222,131
2020-04-27,Peru,NA,Piura,1856809,237,13,1459,144
2020-04-28,Peru,NA,Piura,1856809,143,14,1602,158
2020-04-29,Peru,NA,Piura,1856809,153,19,1755,177
2020-04-30,Peru,NA,Piura,1856809,180,15,1935,192
2020-05-01,Peru,NA,Piura,1856809,142,13,2077,205
2020-05-02,Peru,NA,Piura,1856809,202,18,2279,223
2020-05-03,Peru,NA,Piura,1856809,86,22,2365,245
2020-05-04,Peru,NA,Piura,1856809,223,16,2588,261
2020-05-05,Peru,NA,Piura,1856809,247,18,2835,279
2020-05-06,Peru,NA,Piura,1856809,213,26,3048,305
2020-05-07,Peru,NA,Piura,1856809,156,16,3204,321
2020-05-08,Peru,NA,Piura,1856809,145,28,3349,349
2020-05-09,Peru,NA,Piura,1856809,91,18,3440,367
2020-05-10,Peru,NA,Piura,1856809,38,26,3478,393
2020-05-11,Peru,NA,Piura,1856809,164,26,3642,419
2020-05-12,Peru,NA,Piura,1856809,135,12,3777,431
2020-05-13,Peru,NA,Piura,1856809,115,24,3892,455
2020-05-14,Peru,NA,Piura,1856809,135,18,4027,473
2020-05-15,Peru,NA,Piura,1856809,102,20,4129,493
2020-05-16,Peru,NA,Piura,1856809,58,14,4187,507
2020-05-17,Peru,NA,Piura,1856809,50,12,4237,519
2020-05-18,Peru,NA,Piura,1856809,203,19,4440,538
2020-05-19,Peru,NA,Piura,1856809,340,15,4780,553
2020-05-20,Peru,NA,Piura,1856809,467,20,5247,573
2020-05-21,Peru,NA,Piura,1856809,434,15,5681,588
2020-05-22,Peru,NA,Piura,1856809,481,17,6162,605
2020-05-23,Peru,NA,Piura,1856809,540,19,6702,624
2020-05-24,Peru,NA,Piura,1856809,199,23,6901,647
2020-05-25,Peru,NA,Piura,1856809,483,18,7384,665
2020-05-26,Peru,NA,Piura,1856809,419,14,7803,679
2020-05-27,Peru,NA,Piura,1856809,458,32,8261,711
2020-05-28,Peru,NA,Piura,1856809,375,19,8636,730
2020-05-29,Peru,NA,Piura,1856809,293,20,8929,750
2020-05-30,Peru,NA,Piura,1856809,216,29,9145,779
2020-05-31,Peru,NA,Piura,1856809,25,23,9170,802
2020-06-01,Peru,NA,Piura,1856809,505,21,9675,823
2020-06-02,Peru,NA,Piura,1856809,347,25,10022,848
2020-06-03,Peru,NA,Piura,1856809,276,28,10298,876
2020-06-04,Peru,NA,Piura,1856809,494,22,10792,898
2020-06-05,Peru,NA,Piura,1856809,470,24,11262,922
2020-06-06,Peru,NA,Piura,1856809,445,30,11707,952
2020-06-07,Peru,NA,Piura,1856809,74,29,11781,981
2020-06-08,Peru,NA,Piura,1856809,345,30,12126,1011
2020-06-09,Peru,NA,Piura,1856809,470,21,12596,1032
2020-06-10,Peru,NA,Piura,1856809,422,29,13018,1061
2020-06-11,Peru,NA,Piura,1856809,510,17,13528,1078
2020-06-12,Peru,NA,Piura,1856809,442,26,13970,1104
2020-06-13,Peru,NA,Piura,1856809,223,26,14193,1130
2020-06-14,Peru,NA,Piura,1856809,116,17,14309,1147
2020-06-15,Peru,NA,Piura,1856809,352,25,14661,1172
2020-06-16,Peru,NA,Piura,1856809,185,19,14846,1191
2020-06-17,Peru,NA,Piura,1856809,224,25,15070,1216
2020-06-18,Peru,NA,Piura,1856809,223,13,15293,1229
2020-06-19,Peru,NA,Piura,1856809,265,36,15558,1265
2020-06-20,Peru,NA,Piura,1856809,200,24,15758,1289
2020-06-21,Peru,NA,Piura,1856809,41,18,15799,1307
2020-06-22,Peru,NA,Piura,1856809,235,21,16034,1328
2020-06-23,Peru,NA,Piura,1856809,200,27,16234,1355
2020-06-24,Peru,NA,Piura,1856809,178,25,16412,1380
2020-06-25,Peru,NA,Piura,1856809,207,20,16619,1400
2020-06-26,Peru,NA,Piura,1856809,239,14,16858,1414
2020-06-27,Peru,NA,Piura,1856809,150,23,17008,1437
2020-06-28,Peru,NA,Piura,1856809,37,16,17045,1453
2020-06-29,Peru,NA,Piura,1856809,129,17,17174,1470
2020-06-30,Peru,NA,Piura,1856809,224,16,17398,1486
2020-07-01,Peru,NA,Piura,1856809,235,10,17633,1496
2020-07-02,Peru,NA,Piura,1856809,179,13,17812,1509
2020-07-03,Peru,NA,Piura,1856809,147,5,17959,1514
2020-07-04,Peru,NA,Piura,1856809,143,3,18102,1517
2020-07-05,Peru,NA,Piura,1856809,53,6,18155,1523
2020-07-06,Peru,NA,Piura,1856809,97,3,18252,1526
2020-07-07,Peru,NA,Piura,1856809,156,1,18408,1527
2020-07-08,Peru,NA,Piura,1856809,106,11,18514,1538
2020-07-09,Peru,NA,Piura,1856809,60,7,18574,1545
2020-07-10,Peru,NA,Piura,1856809,269,2,18843,1547
2020-07-11,Peru,NA,Piura,1856809,240,10,19083,1557
2020-07-12,Peru,NA,Piura,1856809,52,6,19135,1563
2020-07-13,Peru,NA,Piura,1856809,72,6,19207,1569
2020-07-14,Peru,NA,Piura,1856809,84,2,19291,1571
2020-07-15,Peru,NA,Piura,1856809,140,7,19431,1578
2020-07-16,Peru,NA,Piura,1856809,86,7,19517,1585
2020-07-17,Peru,NA,Piura,1856809,171,1,19688,1586
2020-07-18,Peru,NA,Piura,1856809,231,6,19919,1592
2020-07-19,Peru,NA,Piura,1856809,170,6,20089,1598
2020-07-20,Peru,NA,Piura,1856809,117,6,20206,1604
2020-07-21,Peru,NA,Piura,1856809,187,6,20393,1610
2020-07-22,Peru,NA,Piura,1856809,166,6,20559,1616
2020-07-23,Peru,NA,Piura,1856809,174,7,20733,1623
2020-07-24,Peru,NA,Piura,1856809,141,5,20874,1628
2020-07-25,Peru,NA,Piura,1856809,261,4,21135,1632
2020-07-26,Peru,NA,Piura,1856809,45,5,21180,1637
2020-07-27,Peru,NA,Piura,1856809,219,3,21399,1640
2020-07-28,Peru,NA,Piura,1856809,67,2,21466,1642
2020-07-29,Peru,NA,Piura,1856809,158,3,21624,1645
2020-07-30,Peru,NA,Piura,1856809,181,5,21805,1650
2020-07-31,Peru,NA,Piura,1856809,153,1,21958,1651
2020-08-01,Peru,NA,Piura,1856809,136,8,22094,1659
2020-08-02,Peru,NA,Piura,1856809,61,8,22155,1667
2020-08-03,Peru,NA,Piura,1856809,209,2,22364,1669
2020-08-04,Peru,NA,Piura,1856809,164,13,22528,1682
2020-08-05,Peru,NA,Piura,1856809,172,8,22700,1690
2020-08-06,Peru,NA,Piura,1856809,220,3,22920,1693
2020-08-07,Peru,NA,Piura,1856809,255,5,23175,1698
2020-08-08,Peru,NA,Piura,1856809,173,7,23348,1705
2020-08-09,Peru,NA,Piura,1856809,63,2,23411,1707
2020-08-10,Peru,NA,Piura,1856809,303,7,23714,1714
2020-08-11,Peru,NA,Piura,1856809,271,4,23985,1718
2020-08-12,Peru,NA,Piura,1856809,244,4,24229,1722
2020-08-13,Peru,NA,Piura,1856809,288,9,24517,1731
2020-08-14,Peru,NA,Piura,1856809,270,9,24787,1740
2020-08-15,Peru,NA,Piura,1856809,284,3,25071,1743
2020-08-16,Peru,NA,Piura,1856809,65,8,25136,1751
2020-08-17,Peru,NA,Piura,1856809,336,4,25472,1755
2020-08-18,Peru,NA,Piura,1856809,348,5,25820,1760
2020-08-19,Peru,NA,Piura,1856809,263,5,26083,1765
2020-08-20,Peru,NA,Piura,1856809,340,7,26423,1772
2020-08-21,Peru,NA,Piura,1856809,301,6,26724,1778
2020-08-22,Peru,NA,Piura,1856809,260,7,26984,1785
2020-08-23,Peru,NA,Piura,1856809,13,2,26997,1787
2020-08-24,Peru,NA,Piura,1856809,460,4,27457,1791
2020-08-25,Peru,NA,Piura,1856809,587,8,28044,1799
2020-08-26,Peru,NA,Piura,1856809,346,4,28390,1803
2020-08-27,Peru,NA,Piura,1856809,364,7,28754,1810
2020-08-28,Peru,NA,Piura,1856809,381,3,29135,1813
2020-08-29,Peru,NA,Piura,1856809,273,5,29408,1818
2020-08-30,Peru,NA,Piura,1856809,49,7,29457,1825
2020-08-31,Peru,NA,Piura,1856809,273,5,29730,1830
2020-09-01,Peru,NA,Piura,1856809,403,10,30133,1840
2020-09-02,Peru,NA,Piura,1856809,385,2,30518,1842
2020-09-03,Peru,NA,Piura,1856809,130,3,30648,1845
2020-09-04,Peru,NA,Piura,1856809,486,3,31134,1848
2020-09-05,Peru,NA,Piura,1856809,104,5,31238,1853
2020-09-06,Peru,NA,Piura,1856809,34,8,31272,1861
2020-09-07,Peru,NA,Piura,1856809,335,6,31607,1867
2020-09-08,Peru,NA,Piura,1856809,258,2,31865,1869
2020-09-09,Peru,NA,Piura,1856809,304,2,32169,1871
2020-09-10,Peru,NA,Piura,1856809,70,4,32239,1875
2020-09-11,Peru,NA,Piura,1856809,441,7,32680,1882
2020-09-12,Peru,NA,Piura,1856809,177,6,32857,1888
2020-09-13,Peru,NA,Piura,1856809,44,3,32901,1891
2020-09-14,Peru,NA,Piura,1856809,245,4,33146,1895
2020-09-15,Peru,NA,Piura,1856809,194,5,33340,1900
2020-09-16,Peru,NA,Piura,1856809,162,6,33502,1906
2020-09-17,Peru,NA,Piura,1856809,176,5,33678,1911
2020-09-18,Peru,NA,Piura,1856809,166,5,33844,1916
2020-09-19,Peru,NA,Piura,1856809,110,6,33954,1922
2020-09-20,Peru,NA,Piura,1856809,35,3,33989,1925
2020-09-21,Peru,NA,Piura,1856809,190,1,34179,1926
2020-09-22,Peru,NA,Piura,1856809,9,6,34188,1932
2020-04-16,Peru,NA,Puno,1172697,2,0,11,0
2020-04-17,Peru,NA,Puno,1172697,4,0,15,0
2020-04-18,Peru,NA,Puno,1172697,9,0,24,0
2020-04-20,Peru,NA,Puno,1172697,10,1,34,1
2020-04-21,Peru,NA,Puno,1172697,16,0,50,1
2020-04-22,Peru,NA,Puno,1172697,8,0,58,1
2020-04-23,Peru,NA,Puno,1172697,8,0,66,1
2020-04-24,Peru,NA,Puno,1172697,17,0,83,1
2020-04-25,Peru,NA,Puno,1172697,20,0,103,1
2020-04-26,Peru,NA,Puno,1172697,14,0,117,1
2020-04-27,Peru,NA,Puno,1172697,28,0,145,1
2020-04-28,Peru,NA,Puno,1172697,22,0,167,1
2020-04-29,Peru,NA,Puno,1172697,20,1,187,2
2020-04-30,Peru,NA,Puno,1172697,29,0,216,2
2020-05-01,Peru,NA,Puno,1172697,10,0,226,2
2020-05-02,Peru,NA,Puno,1172697,14,0,240,2
2020-05-03,Peru,NA,Puno,1172697,11,1,251,3
2020-05-04,Peru,NA,Puno,1172697,13,0,264,3
2020-05-05,Peru,NA,Puno,1172697,20,1,284,4
2020-05-06,Peru,NA,Puno,1172697,6,0,290,4
2020-05-07,Peru,NA,Puno,1172697,3,0,293,4
2020-05-08,Peru,NA,Puno,1172697,1,0,294,4
2020-05-09,Peru,NA,Puno,1172697,8,0,302,4
2020-05-10,Peru,NA,Puno,1172697,1,0,303,4
2020-05-11,Peru,NA,Puno,1172697,4,0,307,4
2020-05-12,Peru,NA,Puno,1172697,6,0,313,4
2020-05-13,Peru,NA,Puno,1172697,3,0,316,4
2020-05-14,Peru,NA,Puno,1172697,2,0,318,4
2020-05-15,Peru,NA,Puno,1172697,9,0,327,4
2020-05-16,Peru,NA,Puno,1172697,3,1,330,5
2020-05-18,Peru,NA,Puno,1172697,7,1,337,6
2020-05-19,Peru,NA,Puno,1172697,7,0,344,6
2020-05-20,Peru,NA,Puno,1172697,9,0,353,6
2020-05-21,Peru,NA,Puno,1172697,40,0,393,6
2020-05-22,Peru,NA,Puno,1172697,25,0,418,6
2020-05-23,Peru,NA,Puno,1172697,10,0,428,6
2020-05-24,Peru,NA,Puno,1172697,2,0,430,6
2020-05-25,Peru,NA,Puno,1172697,35,0,465,6
2020-05-26,Peru,NA,Puno,1172697,3,1,468,7
2020-05-27,Peru,NA,Puno,1172697,22,0,490,7
2020-05-28,Peru,NA,Puno,1172697,16,1,506,8
2020-05-29,Peru,NA,Puno,1172697,42,0,548,8
2020-05-30,Peru,NA,Puno,1172697,17,0,565,8
2020-05-31,Peru,NA,Puno,1172697,1,0,566,8
2020-06-01,Peru,NA,Puno,1172697,7,0,573,8
2020-06-02,Peru,NA,Puno,1172697,15,1,588,9
2020-06-03,Peru,NA,Puno,1172697,19,0,607,9
2020-06-04,Peru,NA,Puno,1172697,27,1,634,10
2020-06-05,Peru,NA,Puno,1172697,7,0,641,10
2020-06-06,Peru,NA,Puno,1172697,7,0,648,10
2020-06-07,Peru,NA,Puno,1172697,2,0,650,10
2020-06-08,Peru,NA,Puno,1172697,18,0,668,10
2020-06-09,Peru,NA,Puno,1172697,23,2,691,12
2020-06-10,Peru,NA,Puno,1172697,31,0,722,12
2020-06-11,Peru,NA,Puno,1172697,9,2,731,14
2020-06-12,Peru,NA,Puno,1172697,13,2,744,16
2020-06-13,Peru,NA,Puno,1172697,15,1,759,17
2020-06-14,Peru,NA,Puno,1172697,9,0,768,17
2020-06-15,Peru,NA,Puno,1172697,11,1,779,18
2020-06-16,Peru,NA,Puno,1172697,8,1,787,19
2020-06-17,Peru,NA,Puno,1172697,11,3,798,22
2020-06-18,Peru,NA,Puno,1172697,8,1,806,23
2020-06-19,Peru,NA,Puno,1172697,15,2,821,25
2020-06-20,Peru,NA,Puno,1172697,11,0,832,25
2020-06-21,Peru,NA,Puno,1172697,12,0,844,25
2020-06-22,Peru,NA,Puno,1172697,23,1,867,26
2020-06-23,Peru,NA,Puno,1172697,19,0,886,26
2020-06-24,Peru,NA,Puno,1172697,15,0,901,26
2020-06-25,Peru,NA,Puno,1172697,4,2,905,28
2020-06-26,Peru,NA,Puno,1172697,23,0,928,28
2020-06-27,Peru,NA,Puno,1172697,17,1,945,29
2020-06-28,Peru,NA,Puno,1172697,3,0,948,29
2020-06-29,Peru,NA,Puno,1172697,24,2,972,31
2020-06-30,Peru,NA,Puno,1172697,20,1,992,32
2020-07-01,Peru,NA,Puno,1172697,19,3,1011,35
2020-07-02,Peru,NA,Puno,1172697,20,2,1031,37
2020-07-03,Peru,NA,Puno,1172697,19,1,1050,38
2020-07-04,Peru,NA,Puno,1172697,20,0,1070,38
2020-07-05,Peru,NA,Puno,1172697,15,3,1085,41
2020-07-06,Peru,NA,Puno,1172697,23,1,1108,42
2020-07-07,Peru,NA,Puno,1172697,20,1,1128,43
2020-07-08,Peru,NA,Puno,1172697,6,2,1134,45
2020-07-09,Peru,NA,Puno,1172697,3,1,1137,46
2020-07-10,Peru,NA,Puno,1172697,21,0,1158,46
2020-07-11,Peru,NA,Puno,1172697,12,1,1170,47
2020-07-12,Peru,NA,Puno,1172697,15,1,1185,48
2020-07-13,Peru,NA,Puno,1172697,7,0,1192,48
2020-07-14,Peru,NA,Puno,1172697,9,0,1201,48
2020-07-15,Peru,NA,Puno,1172697,18,2,1219,50
2020-07-16,Peru,NA,Puno,1172697,74,2,1293,52
2020-07-17,Peru,NA,Puno,1172697,13,2,1306,54
2020-07-18,Peru,NA,Puno,1172697,40,5,1346,59
2020-07-19,Peru,NA,Puno,1172697,73,1,1419,60
2020-07-20,Peru,NA,Puno,1172697,44,1,1463,61
2020-07-21,Peru,NA,Puno,1172697,38,1,1501,62
2020-07-22,Peru,NA,Puno,1172697,74,1,1575,63
2020-07-23,Peru,NA,Puno,1172697,91,2,1666,65
2020-07-24,Peru,NA,Puno,1172697,118,3,1784,68
2020-07-25,Peru,NA,Puno,1172697,114,4,1898,72
2020-07-26,Peru,NA,Puno,1172697,60,6,1958,78
2020-07-27,Peru,NA,Puno,1172697,144,2,2102,80
2020-07-28,Peru,NA,Puno,1172697,59,2,2161,82
2020-07-29,Peru,NA,Puno,1172697,190,0,2351,82
2020-07-30,Peru,NA,Puno,1172697,115,1,2466,83
2020-07-31,Peru,NA,Puno,1172697,110,5,2576,88
2020-08-01,Peru,NA,Puno,1172697,85,4,2661,92
2020-08-02,Peru,NA,Puno,1172697,77,5,2738,97
2020-08-03,Peru,NA,Puno,1172697,148,1,2886,98
2020-08-04,Peru,NA,Puno,1172697,212,2,3098,100
2020-08-05,Peru,NA,Puno,1172697,150,4,3248,104
2020-08-06,Peru,NA,Puno,1172697,257,2,3505,106
2020-08-07,Peru,NA,Puno,1172697,215,6,3720,112
2020-08-08,Peru,NA,Puno,1172697,142,8,3862,120
2020-08-09,Peru,NA,Puno,1172697,95,3,3957,123
2020-08-10,Peru,NA,Puno,1172697,200,5,4157,128
2020-08-11,Peru,NA,Puno,1172697,226,4,4383,132
2020-08-12,Peru,NA,Puno,1172697,209,1,4592,133
2020-08-13,Peru,NA,Puno,1172697,218,5,4810,138
2020-08-14,Peru,NA,Puno,1172697,458,8,5268,146
2020-08-15,Peru,NA,Puno,1172697,858,6,6126,152
2020-08-16,Peru,NA,Puno,1172697,274,7,6400,159
2020-08-17,Peru,NA,Puno,1172697,284,6,6684,165
2020-08-18,Peru,NA,Puno,1172697,245,8,6929,173
2020-08-19,Peru,NA,Puno,1172697,201,10,7130,183
2020-08-20,Peru,NA,Puno,1172697,260,0,7390,183
2020-08-21,Peru,NA,Puno,1172697,169,6,7559,189
2020-08-22,Peru,NA,Puno,1172697,148,5,7707,194
2020-08-23,Peru,NA,Puno,1172697,25,9,7732,203
2020-08-24,Peru,NA,Puno,1172697,209,4,7941,207
2020-08-25,Peru,NA,Puno,1172697,374,4,8315,211
2020-08-26,Peru,NA,Puno,1172697,264,4,8579,215
2020-08-27,Peru,NA,Puno,1172697,220,8,8799,223
2020-08-28,Peru,NA,Puno,1172697,196,6,8995,229
2020-08-29,Peru,NA,Puno,1172697,162,2,9157,231
2020-08-30,Peru,NA,Puno,1172697,42,6,9199,237
2020-08-31,Peru,NA,Puno,1172697,145,2,9344,239
2020-09-01,Peru,NA,Puno,1172697,141,2,9485,241
2020-09-02,Peru,NA,Puno,1172697,200,2,9685,243
2020-09-03,Peru,NA,Puno,1172697,56,3,9741,246
2020-09-04,Peru,NA,Puno,1172697,405,4,10146,250
2020-09-05,Peru,NA,Puno,1172697,80,6,10226,256
2020-09-06,Peru,NA,Puno,1172697,44,3,10270,259
2020-09-07,Peru,NA,Puno,1172697,152,3,10422,262
2020-09-08,Peru,NA,Puno,1172697,151,2,10573,264
2020-09-09,Peru,NA,Puno,1172697,125,2,10698,266
2020-09-10,Peru,NA,Puno,1172697,51,1,10749,267
2020-09-11,Peru,NA,Puno,1172697,270,0,11019,267
2020-09-12,Peru,NA,Puno,1172697,136,0,11155,267
2020-09-13,Peru,NA,Puno,1172697,28,3,11183,270
2020-09-14,Peru,NA,Puno,1172697,145,1,11328,271
2020-09-15,Peru,NA,Puno,1172697,254,1,11582,272
2020-09-16,Peru,NA,Puno,1172697,151,5,11733,277
2020-09-17,Peru,NA,Puno,1172697,345,1,12078,278
2020-09-18,Peru,NA,Puno,1172697,309,1,12387,279
2020-09-19,Peru,NA,Puno,1172697,242,3,12629,282
2020-09-20,Peru,NA,Puno,1172697,50,1,12679,283
2020-09-21,Peru,NA,Puno,1172697,319,4,12998,287
2020-09-22,Peru,NA,Puno,1172697,17,2,13015,289
2020-04-07,Peru,NA,San Martin,813381,3,0,11,2
2020-04-08,Peru,NA,San Martin,813381,4,0,15,2
2020-04-09,Peru,NA,San Martin,813381,5,0,20,2
2020-04-11,Peru,NA,San Martin,813381,15,0,35,2
2020-04-14,Peru,NA,San Martin,813381,6,0,41,2
2020-04-15,Peru,NA,San Martin,813381,13,0,54,2
2020-04-16,Peru,NA,San Martin,813381,11,0,65,2
2020-04-17,Peru,NA,San Martin,813381,12,0,77,2
2020-04-18,Peru,NA,San Martin,813381,12,0,89,2
2020-04-19,Peru,NA,San Martin,813381,1,1,90,3
2020-04-20,Peru,NA,San Martin,813381,7,1,97,4
2020-04-21,Peru,NA,San Martin,813381,5,1,102,5
2020-04-22,Peru,NA,San Martin,813381,5,0,107,5
2020-04-23,Peru,NA,San Martin,813381,2,0,109,5
2020-04-24,Peru,NA,San Martin,813381,13,0,122,5
2020-04-25,Peru,NA,San Martin,813381,29,0,151,5
2020-04-26,Peru,NA,San Martin,813381,16,0,167,5
2020-04-27,Peru,NA,San Martin,813381,23,1,190,6
2020-04-28,Peru,NA,San Martin,813381,43,0,233,6
2020-04-29,Peru,NA,San Martin,813381,21,1,254,7
2020-04-30,Peru,NA,San Martin,813381,15,0,269,7
2020-05-01,Peru,NA,San Martin,813381,18,0,287,7
2020-05-02,Peru,NA,San Martin,813381,30,0,317,7
2020-05-03,Peru,NA,San Martin,813381,20,0,337,7
2020-05-04,Peru,NA,San Martin,813381,9,0,346,7
2020-05-05,Peru,NA,San Martin,813381,20,1,366,8
2020-05-06,Peru,NA,San Martin,813381,31,0,397,8
2020-05-07,Peru,NA,San Martin,813381,62,2,459,10
2020-05-08,Peru,NA,San Martin,813381,50,2,509,12
2020-05-09,Peru,NA,San Martin,813381,28,1,537,13
2020-05-10,Peru,NA,San Martin,813381,14,3,551,16
2020-05-11,Peru,NA,San Martin,813381,11,0,562,16
2020-05-12,Peru,NA,San Martin,813381,12,1,574,17
2020-05-13,Peru,NA,San Martin,813381,29,1,603,18
2020-05-14,Peru,NA,San Martin,813381,38,1,641,19
2020-05-15,Peru,NA,San Martin,813381,22,2,663,21
2020-05-16,Peru,NA,San Martin,813381,54,3,717,24
2020-05-17,Peru,NA,San Martin,813381,19,1,736,25
2020-05-18,Peru,NA,San Martin,813381,93,4,829,29
2020-05-19,Peru,NA,San Martin,813381,89,1,918,30
2020-05-20,Peru,NA,San Martin,813381,44,0,962,30
2020-05-21,Peru,NA,San Martin,813381,52,0,1014,30
2020-05-22,Peru,NA,San Martin,813381,27,2,1041,32
2020-05-23,Peru,NA,San Martin,813381,20,2,1061,34
2020-05-24,Peru,NA,San Martin,813381,15,3,1076,37
2020-05-25,Peru,NA,San Martin,813381,28,0,1104,37
2020-05-26,Peru,NA,San Martin,813381,63,3,1167,40
2020-05-27,Peru,NA,San Martin,813381,65,3,1232,43
2020-05-28,Peru,NA,San Martin,813381,66,2,1298,45
2020-05-29,Peru,NA,San Martin,813381,52,0,1350,45
2020-05-30,Peru,NA,San Martin,813381,63,3,1413,48
2020-05-31,Peru,NA,San Martin,813381,39,5,1452,53
2020-06-01,Peru,NA,San Martin,813381,97,7,1549,60
2020-06-02,Peru,NA,San Martin,813381,106,5,1655,65
2020-06-03,Peru,NA,San Martin,813381,67,10,1722,75
2020-06-04,Peru,NA,San Martin,813381,79,5,1801,80
2020-06-05,Peru,NA,San Martin,813381,71,10,1872,90
2020-06-06,Peru,NA,San Martin,813381,64,13,1936,103
2020-06-07,Peru,NA,San Martin,813381,55,3,1991,106
2020-06-08,Peru,NA,San Martin,813381,158,10,2149,116
2020-06-09,Peru,NA,San Martin,813381,106,7,2255,123
2020-06-10,Peru,NA,San Martin,813381,145,10,2400,133
2020-06-11,Peru,NA,San Martin,813381,165,11,2565,144
2020-06-12,Peru,NA,San Martin,813381,195,15,2760,159
2020-06-13,Peru,NA,San Martin,813381,123,18,2883,177
2020-06-14,Peru,NA,San Martin,813381,17,9,2900,186
2020-06-15,Peru,NA,San Martin,813381,51,17,2951,203
2020-06-16,Peru,NA,San Martin,813381,151,16,3102,219
2020-06-17,Peru,NA,San Martin,813381,83,20,3185,239
2020-06-18,Peru,NA,San Martin,813381,138,12,3323,251
2020-06-19,Peru,NA,San Martin,813381,135,12,3458,263
2020-06-20,Peru,NA,San Martin,813381,167,21,3625,284
2020-06-21,Peru,NA,San Martin,813381,17,9,3642,293
2020-06-22,Peru,NA,San Martin,813381,175,15,3817,308
2020-06-23,Peru,NA,San Martin,813381,169,11,3986,319
2020-06-24,Peru,NA,San Martin,813381,182,16,4168,335
2020-06-25,Peru,NA,San Martin,813381,240,16,4408,351
2020-06-26,Peru,NA,San Martin,813381,295,19,4703,370
2020-06-27,Peru,NA,San Martin,813381,207,16,4910,386
2020-06-28,Peru,NA,San Martin,813381,60,17,4970,403
2020-06-29,Peru,NA,San Martin,813381,211,17,5181,420
2020-06-30,Peru,NA,San Martin,813381,258,12,5439,432
2020-07-01,Peru,NA,San Martin,813381,189,9,5628,441
2020-07-02,Peru,NA,San Martin,813381,205,8,5833,449
2020-07-03,Peru,NA,San Martin,813381,159,5,5992,454
2020-07-04,Peru,NA,San Martin,813381,155,6,6147,460
2020-07-05,Peru,NA,San Martin,813381,100,8,6247,468
2020-07-06,Peru,NA,San Martin,813381,89,4,6336,472
2020-07-07,Peru,NA,San Martin,813381,63,9,6399,481
2020-07-08,Peru,NA,San Martin,813381,45,15,6444,496
2020-07-09,Peru,NA,San Martin,813381,81,5,6525,501
2020-07-10,Peru,NA,San Martin,813381,166,5,6691,506
2020-07-11,Peru,NA,San Martin,813381,92,7,6783,513
2020-07-12,Peru,NA,San Martin,813381,48,10,6831,523
2020-07-13,Peru,NA,San Martin,813381,44,5,6875,528
2020-07-14,Peru,NA,San Martin,813381,90,7,6965,535
2020-07-15,Peru,NA,San Martin,813381,85,2,7050,537
2020-07-16,Peru,NA,San Martin,813381,92,5,7142,542
2020-07-17,Peru,NA,San Martin,813381,84,3,7226,545
2020-07-18,Peru,NA,San Martin,813381,170,6,7396,551
2020-07-19,Peru,NA,San Martin,813381,36,5,7432,556
2020-07-20,Peru,NA,San Martin,813381,65,9,7497,565
2020-07-21,Peru,NA,San Martin,813381,133,7,7630,572
2020-07-22,Peru,NA,San Martin,813381,155,7,7785,579
2020-07-23,Peru,NA,San Martin,813381,212,7,7997,586
2020-07-24,Peru,NA,San Martin,813381,217,1,8214,587
2020-07-25,Peru,NA,San Martin,813381,227,0,8441,587
2020-07-26,Peru,NA,San Martin,813381,51,2,8492,589
2020-07-27,Peru,NA,San Martin,813381,220,1,8712,590
2020-07-28,Peru,NA,San Martin,813381,87,1,8799,591
2020-07-29,Peru,NA,San Martin,813381,165,3,8964,594
2020-07-30,Peru,NA,San Martin,813381,172,6,9136,600
2020-07-31,Peru,NA,San Martin,813381,204,3,9340,603
2020-08-01,Peru,NA,San Martin,813381,151,1,9491,604
2020-08-02,Peru,NA,San Martin,813381,54,3,9545,607
2020-08-03,Peru,NA,San Martin,813381,200,0,9745,607
2020-08-04,Peru,NA,San Martin,813381,228,1,9973,608
2020-08-05,Peru,NA,San Martin,813381,182,3,10155,611
2020-08-06,Peru,NA,San Martin,813381,271,2,10426,613
2020-08-07,Peru,NA,San Martin,813381,177,2,10603,615
2020-08-08,Peru,NA,San Martin,813381,164,1,10767,616
2020-08-09,Peru,NA,San Martin,813381,47,1,10814,617
2020-08-10,Peru,NA,San Martin,813381,209,2,11023,619
2020-08-11,Peru,NA,San Martin,813381,204,1,11227,620
2020-08-12,Peru,NA,San Martin,813381,205,4,11432,624
2020-08-13,Peru,NA,San Martin,813381,163,5,11595,629
2020-08-14,Peru,NA,San Martin,813381,157,3,11752,632
2020-08-15,Peru,NA,San Martin,813381,128,3,11880,635
2020-08-16,Peru,NA,San Martin,813381,49,2,11929,637
2020-08-17,Peru,NA,San Martin,813381,223,3,12152,640
2020-08-18,Peru,NA,San Martin,813381,180,2,12332,642
2020-08-19,Peru,NA,San Martin,813381,177,0,12509,642
2020-08-20,Peru,NA,San Martin,813381,192,3,12701,645
2020-08-21,Peru,NA,San Martin,813381,134,4,12835,649
2020-08-22,Peru,NA,San Martin,813381,121,1,12956,650
2020-08-23,Peru,NA,San Martin,813381,42,0,12998,650
2020-08-24,Peru,NA,San Martin,813381,209,2,13207,652
2020-08-25,Peru,NA,San Martin,813381,323,2,13530,654
2020-08-26,Peru,NA,San Martin,813381,167,2,13697,656
2020-08-27,Peru,NA,San Martin,813381,146,3,13843,659
2020-08-28,Peru,NA,San Martin,813381,228,0,14071,659
2020-08-29,Peru,NA,San Martin,813381,88,2,14159,661
2020-08-30,Peru,NA,San Martin,813381,35,0,14194,661
2020-08-31,Peru,NA,San Martin,813381,107,3,14301,664
2020-09-01,Peru,NA,San Martin,813381,134,0,14435,664
2020-09-02,Peru,NA,San Martin,813381,167,0,14602,664
2020-09-03,Peru,NA,San Martin,813381,110,1,14712,665
2020-09-04,Peru,NA,San Martin,813381,208,0,14920,665
2020-09-05,Peru,NA,San Martin,813381,93,4,15013,669
2020-09-06,Peru,NA,San Martin,813381,18,1,15031,670
2020-09-07,Peru,NA,San Martin,813381,117,1,15148,671
2020-09-08,Peru,NA,San Martin,813381,180,0,15328,671
2020-09-09,Peru,NA,San Martin,813381,137,1,15465,672
2020-09-10,Peru,NA,San Martin,813381,202,3,15667,675
2020-09-11,Peru,NA,San Martin,813381,232,2,15899,677
2020-09-12,Peru,NA,San Martin,813381,95,0,15994,677
2020-09-13,Peru,NA,San Martin,813381,33,4,16027,681
2020-09-14,Peru,NA,San Martin,813381,197,2,16224,683
2020-09-15,Peru,NA,San Martin,813381,108,1,16332,684
2020-09-16,Peru,NA,San Martin,813381,120,1,16452,685
2020-09-17,Peru,NA,San Martin,813381,129,1,16581,686
2020-09-18,Peru,NA,San Martin,813381,120,1,16701,687
2020-09-19,Peru,NA,San Martin,813381,99,1,16800,688
2020-09-20,Peru,NA,San Martin,813381,15,3,16815,691
2020-09-21,Peru,NA,San Martin,813381,115,2,16930,693
2020-09-22,Peru,NA,San Martin,813381,23,1,16953,694
2020-04-14,Peru,NA,Tacna,329332,3,0,12,0
2020-04-15,Peru,NA,Tacna,329332,2,0,14,0
2020-04-16,Peru,NA,Tacna,329332,7,0,21,0
2020-04-17,Peru,NA,Tacna,329332,9,0,30,0
2020-04-18,Peru,NA,Tacna,329332,8,0,38,0
2020-04-19,Peru,NA,Tacna,329332,4,0,42,0
2020-04-20,Peru,NA,Tacna,329332,7,0,49,0
2020-04-21,Peru,NA,Tacna,329332,6,0,55,0
2020-04-22,Peru,NA,Tacna,329332,8,0,63,0
2020-04-23,Peru,NA,Tacna,329332,14,1,77,1
2020-04-24,Peru,NA,Tacna,329332,8,0,85,1
2020-04-25,Peru,NA,Tacna,329332,7,0,92,1
2020-04-26,Peru,NA,Tacna,329332,4,0,96,1
2020-04-27,Peru,NA,Tacna,329332,5,0,101,1
2020-04-28,Peru,NA,Tacna,329332,22,0,123,1
2020-04-29,Peru,NA,Tacna,329332,23,0,146,1
2020-04-30,Peru,NA,Tacna,329332,16,0,162,1
2020-05-01,Peru,NA,Tacna,329332,6,0,168,1
2020-05-02,Peru,NA,Tacna,329332,6,1,174,2
2020-05-03,Peru,NA,Tacna,329332,7,0,181,2
2020-05-04,Peru,NA,Tacna,329332,8,0,189,2
2020-05-05,Peru,NA,Tacna,329332,10,1,199,3
2020-05-06,Peru,NA,Tacna,329332,7,0,206,3
2020-05-07,Peru,NA,Tacna,329332,3,0,209,3
2020-05-08,Peru,NA,Tacna,329332,6,0,215,3
2020-05-09,Peru,NA,Tacna,329332,9,0,224,3
2020-05-11,Peru,NA,Tacna,329332,4,0,228,3
2020-05-12,Peru,NA,Tacna,329332,4,0,232,3
2020-05-13,Peru,NA,Tacna,329332,7,0,239,3
2020-05-14,Peru,NA,Tacna,329332,10,0,249,3
2020-05-15,Peru,NA,Tacna,329332,15,0,264,3
2020-05-16,Peru,NA,Tacna,329332,11,0,275,3
2020-05-18,Peru,NA,Tacna,329332,22,3,297,6
2020-05-19,Peru,NA,Tacna,329332,14,0,311,6
2020-05-20,Peru,NA,Tacna,329332,13,0,324,6
2020-05-21,Peru,NA,Tacna,329332,44,0,368,6
2020-05-22,Peru,NA,Tacna,329332,35,0,403,6
2020-05-23,Peru,NA,Tacna,329332,52,0,455,6
2020-05-24,Peru,NA,Tacna,329332,2,2,457,8
2020-05-25,Peru,NA,Tacna,329332,43,1,500,9
2020-05-26,Peru,NA,Tacna,329332,14,0,514,9
2020-05-27,Peru,NA,Tacna,329332,11,0,525,9
2020-05-28,Peru,NA,Tacna,329332,34,0,559,9
2020-05-29,Peru,NA,Tacna,329332,11,0,570,9
2020-05-30,Peru,NA,Tacna,329332,22,1,592,10
2020-05-31,Peru,NA,Tacna,329332,3,1,595,11
2020-06-01,Peru,NA,Tacna,329332,14,0,609,11
2020-06-02,Peru,NA,Tacna,329332,15,1,624,12
2020-06-03,Peru,NA,Tacna,329332,14,0,638,12
2020-06-04,Peru,NA,Tacna,329332,15,0,653,12
2020-06-05,Peru,NA,Tacna,329332,22,0,675,12
2020-06-06,Peru,NA,Tacna,329332,16,1,691,13
2020-06-07,Peru,NA,Tacna,329332,3,0,694,13
2020-06-08,Peru,NA,Tacna,329332,13,2,707,15
2020-06-09,Peru,NA,Tacna,329332,16,0,723,15
2020-06-10,Peru,NA,Tacna,329332,8,0,731,15
2020-06-11,Peru,NA,Tacna,329332,20,0,751,15
2020-06-12,Peru,NA,Tacna,329332,15,0,766,15
2020-06-13,Peru,NA,Tacna,329332,9,0,775,15
2020-06-14,Peru,NA,Tacna,329332,2,1,777,16
2020-06-15,Peru,NA,Tacna,329332,27,1,804,17
2020-06-16,Peru,NA,Tacna,329332,13,2,817,19
2020-06-17,Peru,NA,Tacna,329332,22,0,839,19
2020-06-18,Peru,NA,Tacna,329332,9,0,848,19
2020-06-19,Peru,NA,Tacna,329332,23,1,871,20
2020-06-20,Peru,NA,Tacna,329332,23,0,894,20
2020-06-21,Peru,NA,Tacna,329332,1,0,895,20
2020-06-22,Peru,NA,Tacna,329332,11,0,906,20
2020-06-23,Peru,NA,Tacna,329332,13,2,919,22
2020-06-24,Peru,NA,Tacna,329332,18,0,937,22
2020-06-25,Peru,NA,Tacna,329332,28,1,965,23
2020-06-26,Peru,NA,Tacna,329332,32,0,997,23
2020-06-27,Peru,NA,Tacna,329332,18,1,1015,24
2020-06-28,Peru,NA,Tacna,329332,5,1,1020,25
2020-06-29,Peru,NA,Tacna,329332,19,0,1039,25
2020-06-30,Peru,NA,Tacna,329332,42,2,1081,27
2020-07-01,Peru,NA,Tacna,329332,22,0,1103,27
2020-07-02,Peru,NA,Tacna,329332,33,1,1136,28
2020-07-03,Peru,NA,Tacna,329332,27,0,1163,28
2020-07-04,Peru,NA,Tacna,329332,21,1,1184,29
2020-07-05,Peru,NA,Tacna,329332,3,0,1187,29
2020-07-06,Peru,NA,Tacna,329332,45,0,1232,29
2020-07-07,Peru,NA,Tacna,329332,47,1,1279,30
2020-07-08,Peru,NA,Tacna,329332,42,1,1321,31
2020-07-09,Peru,NA,Tacna,329332,76,2,1397,33
2020-07-10,Peru,NA,Tacna,329332,65,1,1462,34
2020-07-11,Peru,NA,Tacna,329332,70,3,1532,37
2020-07-12,Peru,NA,Tacna,329332,17,1,1549,38
2020-07-13,Peru,NA,Tacna,329332,56,7,1605,45
2020-07-14,Peru,NA,Tacna,329332,80,1,1685,46
2020-07-15,Peru,NA,Tacna,329332,61,1,1746,47
2020-07-16,Peru,NA,Tacna,329332,51,3,1797,50
2020-07-17,Peru,NA,Tacna,329332,93,1,1890,51
2020-07-18,Peru,NA,Tacna,329332,50,1,1940,52
2020-07-19,Peru,NA,Tacna,329332,38,1,1978,53
2020-07-20,Peru,NA,Tacna,329332,32,1,2010,54
2020-07-21,Peru,NA,Tacna,329332,88,0,2098,54
2020-07-22,Peru,NA,Tacna,329332,108,3,2206,57
2020-07-23,Peru,NA,Tacna,329332,65,2,2271,59
2020-07-24,Peru,NA,Tacna,329332,66,2,2337,61
2020-07-25,Peru,NA,Tacna,329332,95,0,2432,61
2020-07-26,Peru,NA,Tacna,329332,32,0,2464,61
2020-07-27,Peru,NA,Tacna,329332,137,1,2601,62
2020-07-28,Peru,NA,Tacna,329332,52,0,2653,62
2020-07-29,Peru,NA,Tacna,329332,100,3,2753,65
2020-07-30,Peru,NA,Tacna,329332,154,2,2907,67
2020-07-31,Peru,NA,Tacna,329332,114,1,3021,68
2020-08-01,Peru,NA,Tacna,329332,159,1,3180,69
2020-08-02,Peru,NA,Tacna,329332,56,0,3236,69
2020-08-03,Peru,NA,Tacna,329332,140,0,3376,69
2020-08-04,Peru,NA,Tacna,329332,186,1,3562,70
2020-08-05,Peru,NA,Tacna,329332,195,4,3757,74
2020-08-06,Peru,NA,Tacna,329332,201,1,3958,75
2020-08-07,Peru,NA,Tacna,329332,218,3,4176,78
2020-08-08,Peru,NA,Tacna,329332,172,5,4348,83
2020-08-09,Peru,NA,Tacna,329332,96,0,4444,83
2020-08-10,Peru,NA,Tacna,329332,127,6,4571,89
2020-08-11,Peru,NA,Tacna,329332,176,0,4747,89
2020-08-12,Peru,NA,Tacna,329332,258,2,5005,91
2020-08-13,Peru,NA,Tacna,329332,251,7,5256,98
2020-08-14,Peru,NA,Tacna,329332,277,2,5533,100
2020-08-15,Peru,NA,Tacna,329332,211,1,5744,101
2020-08-16,Peru,NA,Tacna,329332,57,3,5801,104
2020-08-17,Peru,NA,Tacna,329332,223,2,6024,106
2020-08-18,Peru,NA,Tacna,329332,174,4,6198,110
2020-08-19,Peru,NA,Tacna,329332,225,2,6423,112
2020-08-20,Peru,NA,Tacna,329332,402,2,6825,114
2020-08-21,Peru,NA,Tacna,329332,264,5,7089,119
2020-08-22,Peru,NA,Tacna,329332,259,3,7348,122
2020-08-23,Peru,NA,Tacna,329332,11,1,7359,123
2020-08-24,Peru,NA,Tacna,329332,291,3,7650,126
2020-08-25,Peru,NA,Tacna,329332,348,0,7998,126
2020-08-26,Peru,NA,Tacna,329332,197,2,8195,128
2020-08-27,Peru,NA,Tacna,329332,308,11,8503,139
2020-08-28,Peru,NA,Tacna,329332,24,2,8527,141
2020-08-29,Peru,NA,Tacna,329332,164,5,8691,146
2020-08-30,Peru,NA,Tacna,329332,26,1,8717,147
2020-08-31,Peru,NA,Tacna,329332,184,1,8901,148
2020-09-01,Peru,NA,Tacna,329332,107,3,9008,151
2020-09-02,Peru,NA,Tacna,329332,174,2,9182,153
2020-09-03,Peru,NA,Tacna,329332,52,4,9234,157
2020-09-04,Peru,NA,Tacna,329332,295,2,9529,159
2020-09-05,Peru,NA,Tacna,329332,103,4,9632,163
2020-09-06,Peru,NA,Tacna,329332,10,4,9642,167
2020-09-07,Peru,NA,Tacna,329332,281,2,9923,169
2020-09-08,Peru,NA,Tacna,329332,188,3,10111,172
2020-09-09,Peru,NA,Tacna,329332,132,2,10243,174
2020-09-10,Peru,NA,Tacna,329332,90,1,10333,175
2020-09-11,Peru,NA,Tacna,329332,263,4,10596,179
2020-09-12,Peru,NA,Tacna,329332,92,1,10688,180
2020-09-13,Peru,NA,Tacna,329332,15,1,10703,181
2020-09-14,Peru,NA,Tacna,329332,88,2,10791,183
2020-09-15,Peru,NA,Tacna,329332,93,4,10884,187
2020-09-16,Peru,NA,Tacna,329332,110,4,10994,191
2020-09-17,Peru,NA,Tacna,329332,131,3,11125,194
2020-09-18,Peru,NA,Tacna,329332,146,1,11271,195
2020-09-19,Peru,NA,Tacna,329332,38,5,11309,200
2020-09-20,Peru,NA,Tacna,329332,7,2,11316,202
2020-09-21,Peru,NA,Tacna,329332,62,3,11378,205
2020-09-22,Peru,NA,Tacna,329332,13,1,11391,206
2020-03-31,Peru,NA,Tumbes,224863,3,0,13,1
2020-04-01,Peru,NA,Tumbes,224863,2,1,15,2
2020-04-02,Peru,NA,Tumbes,224863,6,1,21,3
2020-04-03,Peru,NA,Tumbes,224863,6,1,27,4
2020-04-04,Peru,NA,Tumbes,224863,10,0,37,4
2020-04-06,Peru,NA,Tumbes,224863,5,2,42,6
2020-04-07,Peru,NA,Tumbes,224863,4,0,46,6
2020-04-08,Peru,NA,Tumbes,224863,22,0,68,6
2020-04-09,Peru,NA,Tumbes,224863,1,2,69,8
2020-04-10,Peru,NA,Tumbes,224863,3,0,72,8
2020-04-11,Peru,NA,Tumbes,224863,39,1,111,9
2020-04-12,Peru,NA,Tumbes,224863,6,1,117,10
2020-04-13,Peru,NA,Tumbes,224863,13,2,130,12
2020-04-14,Peru,NA,Tumbes,224863,22,0,152,12
2020-04-15,Peru,NA,Tumbes,224863,18,0,170,12
2020-04-16,Peru,NA,Tumbes,224863,12,0,182,12
2020-04-17,Peru,NA,Tumbes,224863,7,1,189,13
2020-04-18,Peru,NA,Tumbes,224863,6,1,195,14
2020-04-19,Peru,NA,Tumbes,224863,6,2,201,16
2020-04-20,Peru,NA,Tumbes,224863,17,1,218,17
2020-04-21,Peru,NA,Tumbes,224863,2,2,220,19
2020-04-22,Peru,NA,Tumbes,224863,7,3,227,22
2020-04-23,Peru,NA,Tumbes,224863,12,1,239,23
2020-04-24,Peru,NA,Tumbes,224863,20,3,259,26
2020-04-25,Peru,NA,Tumbes,224863,12,2,271,28
2020-04-26,Peru,NA,Tumbes,224863,9,1,280,29
2020-04-27,Peru,NA,Tumbes,224863,16,0,296,29
2020-04-28,Peru,NA,Tumbes,224863,14,0,310,29
2020-04-29,Peru,NA,Tumbes,224863,52,0,362,29
2020-04-30,Peru,NA,Tumbes,224863,30,0,392,29
2020-05-01,Peru,NA,Tumbes,224863,19,3,411,32
2020-05-02,Peru,NA,Tumbes,224863,44,2,455,34
2020-05-03,Peru,NA,Tumbes,224863,11,0,466,34
2020-05-04,Peru,NA,Tumbes,224863,26,2,492,36
2020-05-05,Peru,NA,Tumbes,224863,33,2,525,38
2020-05-06,Peru,NA,Tumbes,224863,14,4,539,42
2020-05-07,Peru,NA,Tumbes,224863,14,3,553,45
2020-05-08,Peru,NA,Tumbes,224863,12,2,565,47
2020-05-09,Peru,NA,Tumbes,224863,22,4,587,51
2020-05-10,Peru,NA,Tumbes,224863,2,1,589,52
2020-05-11,Peru,NA,Tumbes,224863,31,6,620,58
2020-05-12,Peru,NA,Tumbes,224863,29,3,649,61
2020-05-13,Peru,NA,Tumbes,224863,36,2,685,63
2020-05-14,Peru,NA,Tumbes,224863,23,3,708,66
2020-05-15,Peru,NA,Tumbes,224863,38,2,746,68
2020-05-16,Peru,NA,Tumbes,224863,38,1,784,69
2020-05-17,Peru,NA,Tumbes,224863,15,1,799,70
2020-05-18,Peru,NA,Tumbes,224863,24,3,823,73
2020-05-19,Peru,NA,Tumbes,224863,43,2,866,75
2020-05-20,Peru,NA,Tumbes,224863,31,5,897,80
2020-05-21,Peru,NA,Tumbes,224863,48,5,945,85
2020-05-22,Peru,NA,Tumbes,224863,45,5,990,90
2020-05-23,Peru,NA,Tumbes,224863,34,3,1024,93
2020-05-24,Peru,NA,Tumbes,224863,14,8,1038,101
2020-05-25,Peru,NA,Tumbes,224863,47,2,1085,103
2020-05-26,Peru,NA,Tumbes,224863,45,2,1130,105
2020-05-27,Peru,NA,Tumbes,224863,31,1,1161,106
2020-05-28,Peru,NA,Tumbes,224863,56,7,1217,113
2020-05-29,Peru,NA,Tumbes,224863,45,4,1262,117
2020-05-30,Peru,NA,Tumbes,224863,33,8,1295,125
2020-05-31,Peru,NA,Tumbes,224863,10,3,1305,128
2020-06-01,Peru,NA,Tumbes,224863,51,6,1356,134
2020-06-02,Peru,NA,Tumbes,224863,41,8,1397,142
2020-06-03,Peru,NA,Tumbes,224863,49,6,1446,148
2020-06-04,Peru,NA,Tumbes,224863,44,6,1490,154
2020-06-05,Peru,NA,Tumbes,224863,78,5,1568,159
2020-06-06,Peru,NA,Tumbes,224863,61,7,1629,166
2020-06-07,Peru,NA,Tumbes,224863,10,4,1639,170
2020-06-08,Peru,NA,Tumbes,224863,59,6,1698,176
2020-06-09,Peru,NA,Tumbes,224863,71,0,1769,176
2020-06-10,Peru,NA,Tumbes,224863,67,5,1836,181
2020-06-11,Peru,NA,Tumbes,224863,84,4,1920,185
2020-06-12,Peru,NA,Tumbes,224863,70,2,1990,187
2020-06-13,Peru,NA,Tumbes,224863,53,3,2043,190
2020-06-14,Peru,NA,Tumbes,224863,17,6,2060,196
2020-06-15,Peru,NA,Tumbes,224863,83,9,2143,205
2020-06-16,Peru,NA,Tumbes,224863,69,2,2212,207
2020-06-17,Peru,NA,Tumbes,224863,94,2,2306,209
2020-06-18,Peru,NA,Tumbes,224863,44,1,2350,210
2020-06-19,Peru,NA,Tumbes,224863,39,5,2389,215
2020-06-20,Peru,NA,Tumbes,224863,67,2,2456,217
2020-06-21,Peru,NA,Tumbes,224863,22,4,2478,221
2020-06-22,Peru,NA,Tumbes,224863,47,7,2525,228
2020-06-23,Peru,NA,Tumbes,224863,56,2,2581,230
2020-06-24,Peru,NA,Tumbes,224863,81,1,2662,231
2020-06-25,Peru,NA,Tumbes,224863,77,7,2739,238
2020-06-26,Peru,NA,Tumbes,224863,68,3,2807,241
2020-06-27,Peru,NA,Tumbes,224863,103,2,2910,243
2020-06-28,Peru,NA,Tumbes,224863,30,0,2940,243
2020-06-29,Peru,NA,Tumbes,224863,90,1,3030,244
2020-06-30,Peru,NA,Tumbes,224863,147,2,3177,246
2020-07-01,Peru,NA,Tumbes,224863,67,2,3244,248
2020-07-02,Peru,NA,Tumbes,224863,123,2,3367,250
2020-07-03,Peru,NA,Tumbes,224863,56,0,3423,250
2020-07-04,Peru,NA,Tumbes,224863,42,0,3465,250
2020-07-05,Peru,NA,Tumbes,224863,30,0,3495,250
2020-07-06,Peru,NA,Tumbes,224863,47,0,3542,250
2020-07-07,Peru,NA,Tumbes,224863,38,0,3580,250
2020-07-08,Peru,NA,Tumbes,224863,30,0,3610,250
2020-07-09,Peru,NA,Tumbes,224863,43,0,3653,250
2020-07-10,Peru,NA,Tumbes,224863,75,0,3728,250
2020-07-11,Peru,NA,Tumbes,224863,76,0,3804,250
2020-07-12,Peru,NA,Tumbes,224863,17,0,3821,250
2020-07-13,Peru,NA,Tumbes,224863,16,0,3837,250
2020-07-14,Peru,NA,Tumbes,224863,13,2,3850,252
2020-07-15,Peru,NA,Tumbes,224863,82,0,3932,252
2020-07-16,Peru,NA,Tumbes,224863,15,0,3947,252
2020-07-17,Peru,NA,Tumbes,224863,88,2,4035,254
2020-07-18,Peru,NA,Tumbes,224863,32,1,4067,255
2020-07-19,Peru,NA,Tumbes,224863,17,0,4084,255
2020-07-20,Peru,NA,Tumbes,224863,19,1,4103,256
2020-07-21,Peru,NA,Tumbes,224863,18,0,4121,256
2020-07-22,Peru,NA,Tumbes,224863,74,1,4195,257
2020-07-23,Peru,NA,Tumbes,224863,35,0,4230,257
2020-07-24,Peru,NA,Tumbes,224863,38,0,4268,257
2020-07-25,Peru,NA,Tumbes,224863,46,1,4314,258
2020-07-26,Peru,NA,Tumbes,224863,20,0,4334,258
2020-07-27,Peru,NA,Tumbes,224863,68,0,4402,258
2020-07-28,Peru,NA,Tumbes,224863,19,0,4421,258
2020-07-29,Peru,NA,Tumbes,224863,59,2,4480,260
2020-07-30,Peru,NA,Tumbes,224863,40,3,4520,263
2020-07-31,Peru,NA,Tumbes,224863,50,0,4570,263
2020-08-01,Peru,NA,Tumbes,224863,39,0,4609,263
2020-08-02,Peru,NA,Tumbes,224863,45,0,4654,263
2020-08-03,Peru,NA,Tumbes,224863,85,0,4739,263
2020-08-04,Peru,NA,Tumbes,224863,62,0,4801,263
2020-08-05,Peru,NA,Tumbes,224863,53,0,4854,263
2020-08-06,Peru,NA,Tumbes,224863,60,0,4914,263
2020-08-07,Peru,NA,Tumbes,224863,78,1,4992,264
2020-08-08,Peru,NA,Tumbes,224863,48,0,5040,264
2020-08-09,Peru,NA,Tumbes,224863,27,0,5067,264
2020-08-10,Peru,NA,Tumbes,224863,52,0,5119,264
2020-08-11,Peru,NA,Tumbes,224863,83,1,5202,265
2020-08-12,Peru,NA,Tumbes,224863,58,0,5260,265
2020-08-13,Peru,NA,Tumbes,224863,55,2,5315,267
2020-08-14,Peru,NA,Tumbes,224863,49,0,5364,267
2020-08-15,Peru,NA,Tumbes,224863,56,0,5420,267
2020-08-16,Peru,NA,Tumbes,224863,10,1,5430,268
2020-08-17,Peru,NA,Tumbes,224863,23,0,5453,268
2020-08-18,Peru,NA,Tumbes,224863,53,0,5506,268
2020-08-19,Peru,NA,Tumbes,224863,93,0,5599,268
2020-08-20,Peru,NA,Tumbes,224863,47,0,5646,268
2020-08-21,Peru,NA,Tumbes,224863,51,0,5697,268
2020-08-22,Peru,NA,Tumbes,224863,31,2,5728,270
2020-08-23,Peru,NA,Tumbes,224863,1,1,5729,271
2020-08-24,Peru,NA,Tumbes,224863,67,1,5796,272
2020-08-25,Peru,NA,Tumbes,224863,76,1,5872,273
2020-08-26,Peru,NA,Tumbes,224863,44,1,5916,274
2020-08-27,Peru,NA,Tumbes,224863,31,1,5947,275
2020-08-28,Peru,NA,Tumbes,224863,29,0,5976,275
2020-08-29,Peru,NA,Tumbes,224863,44,1,6020,276
2020-08-30,Peru,NA,Tumbes,224863,9,1,6029,277
2020-08-31,Peru,NA,Tumbes,224863,32,1,6061,278
2020-09-01,Peru,NA,Tumbes,224863,61,2,6122,280
2020-09-02,Peru,NA,Tumbes,224863,35,0,6157,280
2020-09-03,Peru,NA,Tumbes,224863,12,3,6169,283
2020-09-04,Peru,NA,Tumbes,224863,40,0,6209,283
2020-09-05,Peru,NA,Tumbes,224863,24,0,6233,283
2020-09-06,Peru,NA,Tumbes,224863,16,1,6249,284
2020-09-07,Peru,NA,Tumbes,224863,69,1,6318,285
2020-09-08,Peru,NA,Tumbes,224863,54,0,6372,285
2020-09-09,Peru,NA,Tumbes,224863,45,2,6417,287
2020-09-10,Peru,NA,Tumbes,224863,15,3,6432,290
2020-09-11,Peru,NA,Tumbes,224863,60,1,6492,291
2020-09-12,Peru,NA,Tumbes,224863,37,0,6529,291
2020-09-13,Peru,NA,Tumbes,224863,49,1,6578,292
2020-09-14,Peru,NA,Tumbes,224863,61,1,6639,293
2020-09-15,Peru,NA,Tumbes,224863,91,0,6730,293
2020-09-16,Peru,NA,Tumbes,224863,44,0,6774,293
2020-09-17,Peru,NA,Tumbes,224863,88,0,6862,293
2020-09-18,Peru,NA,Tumbes,224863,52,2,6914,295
2020-09-19,Peru,NA,Tumbes,224863,21,2,6935,297
2020-09-20,Peru,NA,Tumbes,224863,12,0,6947,297
2020-09-21,Peru,NA,Tumbes,224863,57,1,7004,298
2020-09-22,Peru,NA,Tumbes,224863,8,0,7012,298
2020-04-06,Peru,NA,Ucayali,496459,5,0,13,1
2020-04-07,Peru,NA,Ucayali,496459,1,0,14,1
2020-04-10,Peru,NA,Ucayali,496459,3,1,17,2
2020-04-11,Peru,NA,Ucayali,496459,1,0,18,2
2020-04-12,Peru,NA,Ucayali,496459,3,0,21,2
2020-04-13,Peru,NA,Ucayali,496459,11,0,32,2
2020-04-14,Peru,NA,Ucayali,496459,6,0,38,2
2020-04-15,Peru,NA,Ucayali,496459,22,2,60,4
2020-04-16,Peru,NA,Ucayali,496459,7,1,67,5
2020-04-17,Peru,NA,Ucayali,496459,15,0,82,5
2020-04-18,Peru,NA,Ucayali,496459,19,2,101,7
2020-04-19,Peru,NA,Ucayali,496459,22,4,123,11
2020-04-20,Peru,NA,Ucayali,496459,26,2,149,13
2020-04-21,Peru,NA,Ucayali,496459,23,3,172,16
2020-04-22,Peru,NA,Ucayali,496459,24,8,196,24
2020-04-23,Peru,NA,Ucayali,496459,15,3,211,27
2020-04-24,Peru,NA,Ucayali,496459,51,4,262,31
2020-04-25,Peru,NA,Ucayali,496459,21,7,283,38
2020-04-26,Peru,NA,Ucayali,496459,18,6,301,44
2020-04-27,Peru,NA,Ucayali,496459,109,1,410,45
2020-04-28,Peru,NA,Ucayali,496459,184,3,594,48
2020-04-29,Peru,NA,Ucayali,496459,87,2,681,50
2020-04-30,Peru,NA,Ucayali,496459,79,2,760,52
2020-05-01,Peru,NA,Ucayali,496459,76,8,836,60
2020-05-02,Peru,NA,Ucayali,496459,106,4,942,64
2020-05-03,Peru,NA,Ucayali,496459,94,3,1036,67
2020-05-04,Peru,NA,Ucayali,496459,91,2,1127,69
2020-05-05,Peru,NA,Ucayali,496459,59,6,1186,75
2020-05-06,Peru,NA,Ucayali,496459,81,3,1267,78
2020-05-07,Peru,NA,Ucayali,496459,12,3,1279,81
2020-05-08,Peru,NA,Ucayali,496459,101,4,1380,85
2020-05-09,Peru,NA,Ucayali,496459,190,3,1570,88
2020-05-10,Peru,NA,Ucayali,496459,47,2,1617,90
2020-05-11,Peru,NA,Ucayali,496459,47,7,1664,97
2020-05-12,Peru,NA,Ucayali,496459,84,3,1748,100
2020-05-13,Peru,NA,Ucayali,496459,109,1,1857,101
2020-05-14,Peru,NA,Ucayali,496459,111,3,1968,104
2020-05-15,Peru,NA,Ucayali,496459,104,2,2072,106
2020-05-16,Peru,NA,Ucayali,496459,407,4,2479,110
2020-05-17,Peru,NA,Ucayali,496459,57,3,2536,113
2020-05-18,Peru,NA,Ucayali,496459,354,4,2890,117
2020-05-19,Peru,NA,Ucayali,496459,142,3,3032,120
2020-05-20,Peru,NA,Ucayali,496459,317,2,3349,122
2020-05-21,Peru,NA,Ucayali,496459,170,4,3519,126
2020-05-22,Peru,NA,Ucayali,496459,192,5,3711,131
2020-05-23,Peru,NA,Ucayali,496459,125,6,3836,137
2020-05-24,Peru,NA,Ucayali,496459,36,1,3872,138
2020-05-25,Peru,NA,Ucayali,496459,77,1,3949,139
2020-05-26,Peru,NA,Ucayali,496459,197,4,4146,143
2020-05-27,Peru,NA,Ucayali,496459,176,5,4322,148
2020-05-28,Peru,NA,Ucayali,496459,209,2,4531,150
2020-05-29,Peru,NA,Ucayali,496459,172,3,4703,153
2020-05-30,Peru,NA,Ucayali,496459,207,3,4910,156
2020-05-31,Peru,NA,Ucayali,496459,50,1,4960,157
2020-06-01,Peru,NA,Ucayali,496459,114,4,5074,161
2020-06-02,Peru,NA,Ucayali,496459,39,4,5113,165
2020-06-03,Peru,NA,Ucayali,496459,58,1,5171,166
2020-06-04,Peru,NA,Ucayali,496459,61,4,5232,170
2020-06-05,Peru,NA,Ucayali,496459,153,3,5385,173
2020-06-06,Peru,NA,Ucayali,496459,172,4,5557,177
2020-06-07,Peru,NA,Ucayali,496459,50,1,5607,178
2020-06-08,Peru,NA,Ucayali,496459,198,4,5805,182
2020-06-09,Peru,NA,Ucayali,496459,209,3,6014,185
2020-06-10,Peru,NA,Ucayali,496459,117,4,6131,189
2020-06-11,Peru,NA,Ucayali,496459,183,3,6314,192
2020-06-12,Peru,NA,Ucayali,496459,150,1,6464,193
2020-06-13,Peru,NA,Ucayali,496459,239,7,6703,200
2020-06-14,Peru,NA,Ucayali,496459,30,2,6733,202
2020-06-15,Peru,NA,Ucayali,496459,44,2,6777,204
2020-06-16,Peru,NA,Ucayali,496459,45,4,6822,208
2020-06-17,Peru,NA,Ucayali,496459,53,8,6875,216
2020-06-18,Peru,NA,Ucayali,496459,49,2,6924,218
2020-06-19,Peru,NA,Ucayali,496459,132,4,7056,222
2020-06-20,Peru,NA,Ucayali,496459,65,2,7121,224
2020-06-21,Peru,NA,Ucayali,496459,131,2,7252,226
2020-06-22,Peru,NA,Ucayali,496459,73,2,7325,228
2020-06-23,Peru,NA,Ucayali,496459,53,3,7378,231
2020-06-24,Peru,NA,Ucayali,496459,22,0,7400,231
2020-06-25,Peru,NA,Ucayali,496459,97,1,7497,232
2020-06-26,Peru,NA,Ucayali,496459,110,0,7607,232
2020-06-27,Peru,NA,Ucayali,496459,102,3,7709,235
2020-06-28,Peru,NA,Ucayali,496459,23,3,7732,238
2020-06-29,Peru,NA,Ucayali,496459,42,0,7774,238
2020-06-30,Peru,NA,Ucayali,496459,107,3,7881,241
2020-07-01,Peru,NA,Ucayali,496459,145,1,8026,242
2020-07-02,Peru,NA,Ucayali,496459,48,1,8074,243
2020-07-03,Peru,NA,Ucayali,496459,139,0,8213,243
2020-07-04,Peru,NA,Ucayali,496459,57,0,8270,243
2020-07-05,Peru,NA,Ucayali,496459,48,3,8318,246
2020-07-06,Peru,NA,Ucayali,496459,101,0,8419,246
2020-07-07,Peru,NA,Ucayali,496459,103,1,8522,247
2020-07-08,Peru,NA,Ucayali,496459,56,1,8578,248
2020-07-09,Peru,NA,Ucayali,496459,48,0,8626,248
2020-07-10,Peru,NA,Ucayali,496459,163,1,8789,249
2020-07-11,Peru,NA,Ucayali,496459,113,0,8902,249
2020-07-12,Peru,NA,Ucayali,496459,36,4,8938,253
2020-07-13,Peru,NA,Ucayali,496459,24,3,8962,256
2020-07-14,Peru,NA,Ucayali,496459,71,0,9033,256
2020-07-15,Peru,NA,Ucayali,496459,92,3,9125,259
2020-07-16,Peru,NA,Ucayali,496459,68,2,9193,261
2020-07-17,Peru,NA,Ucayali,496459,52,1,9245,262
2020-07-18,Peru,NA,Ucayali,496459,111,1,9356,263
2020-07-19,Peru,NA,Ucayali,496459,57,1,9413,264
2020-07-20,Peru,NA,Ucayali,496459,35,0,9448,264
2020-07-21,Peru,NA,Ucayali,496459,41,2,9489,266
2020-07-22,Peru,NA,Ucayali,496459,42,0,9531,266
2020-07-23,Peru,NA,Ucayali,496459,49,0,9580,266
2020-07-24,Peru,NA,Ucayali,496459,76,2,9656,268
2020-07-25,Peru,NA,Ucayali,496459,73,0,9729,268
2020-07-26,Peru,NA,Ucayali,496459,39,1,9768,269
2020-07-27,Peru,NA,Ucayali,496459,122,2,9890,271
2020-07-28,Peru,NA,Ucayali,496459,41,0,9931,271
2020-07-29,Peru,NA,Ucayali,496459,148,2,10079,273
2020-07-30,Peru,NA,Ucayali,496459,97,0,10176,273
2020-07-31,Peru,NA,Ucayali,496459,121,0,10297,273
2020-08-01,Peru,NA,Ucayali,496459,108,2,10405,275
2020-08-02,Peru,NA,Ucayali,496459,28,1,10433,276
2020-08-03,Peru,NA,Ucayali,496459,96,0,10529,276
2020-08-04,Peru,NA,Ucayali,496459,136,0,10665,276
2020-08-05,Peru,NA,Ucayali,496459,122,2,10787,278
2020-08-06,Peru,NA,Ucayali,496459,129,0,10916,278
2020-08-07,Peru,NA,Ucayali,496459,98,1,11014,279
2020-08-08,Peru,NA,Ucayali,496459,160,0,11174,279
2020-08-09,Peru,NA,Ucayali,496459,26,0,11200,279
2020-08-10,Peru,NA,Ucayali,496459,181,1,11381,280
2020-08-11,Peru,NA,Ucayali,496459,134,0,11515,280
2020-08-12,Peru,NA,Ucayali,496459,172,0,11687,280
2020-08-13,Peru,NA,Ucayali,496459,215,1,11902,281
2020-08-14,Peru,NA,Ucayali,496459,144,0,12046,281
2020-08-15,Peru,NA,Ucayali,496459,91,0,12137,281
2020-08-16,Peru,NA,Ucayali,496459,33,3,12170,284
2020-08-17,Peru,NA,Ucayali,496459,155,1,12325,285
2020-08-18,Peru,NA,Ucayali,496459,234,0,12559,285
2020-08-19,Peru,NA,Ucayali,496459,198,1,12757,286
2020-08-20,Peru,NA,Ucayali,496459,215,1,12972,287
2020-08-21,Peru,NA,Ucayali,496459,63,1,13035,288
2020-08-22,Peru,NA,Ucayali,496459,112,0,13147,288
2020-08-23,Peru,NA,Ucayali,496459,28,1,13175,289
2020-08-24,Peru,NA,Ucayali,496459,142,0,13317,289
2020-08-25,Peru,NA,Ucayali,496459,227,3,13544,292
2020-08-26,Peru,NA,Ucayali,496459,216,0,13760,292
2020-08-27,Peru,NA,Ucayali,496459,123,0,13883,292
2020-08-28,Peru,NA,Ucayali,496459,130,1,14013,293
2020-08-29,Peru,NA,Ucayali,496459,123,4,14136,297
2020-08-30,Peru,NA,Ucayali,496459,46,0,14182,297
2020-08-31,Peru,NA,Ucayali,496459,78,3,14260,300
2020-09-01,Peru,NA,Ucayali,496459,93,1,14353,301
2020-09-02,Peru,NA,Ucayali,496459,86,0,14439,301
2020-09-03,Peru,NA,Ucayali,496459,47,0,14486,301
2020-09-04,Peru,NA,Ucayali,496459,113,1,14599,302
2020-09-05,Peru,NA,Ucayali,496459,71,0,14670,302
2020-09-06,Peru,NA,Ucayali,496459,31,2,14701,304
2020-09-07,Peru,NA,Ucayali,496459,90,1,14791,305
2020-09-08,Peru,NA,Ucayali,496459,85,0,14876,305
2020-09-09,Peru,NA,Ucayali,496459,81,0,14957,305
2020-09-10,Peru,NA,Ucayali,496459,46,0,15003,305
2020-09-11,Peru,NA,Ucayali,496459,123,0,15126,305
2020-09-12,Peru,NA,Ucayali,496459,43,1,15169,306
2020-09-13,Peru,NA,Ucayali,496459,21,0,15190,306
2020-09-14,Peru,NA,Ucayali,496459,90,1,15280,307
2020-09-15,Peru,NA,Ucayali,496459,82,0,15362,307
2020-09-16,Peru,NA,Ucayali,496459,69,1,15431,308
2020-09-17,Peru,NA,Ucayali,496459,119,1,15550,309
2020-09-18,Peru,NA,Ucayali,496459,46,2,15596,311
2020-09-19,Peru,NA,Ucayali,496459,29,0,15625,311
2020-09-20,Peru,NA,Ucayali,496459,30,1,15655,312
2020-09-21,Peru,NA,Ucayali,496459,69,2,15724,314
2020-09-22,Peru,NA,Ucayali,496459,34,0,15758,314
2020-03-28,Philippines,NA,Bicol Region,5796989,2,0,11,0
2020-03-30,Philippines,NA,Bicol Region,5796989,2,0,13,0
2020-03-31,Philippines,NA,Bicol Region,5796989,1,0,14,0
2020-04-02,Philippines,NA,Bicol Region,5796989,1,0,15,0
2020-04-03,Philippines,NA,Bicol Region,5796989,0,1,15,1
2020-04-05,Philippines,NA,Bicol Region,5796989,0,0,15,1
2020-04-06,Philippines,NA,Bicol Region,5796989,2,0,17,1
2020-04-07,Philippines,NA,Bicol Region,5796989,1,0,18,1
2020-04-08,Philippines,NA,Bicol Region,5796989,1,0,19,1
2020-04-10,Philippines,NA,Bicol Region,5796989,1,0,20,1
2020-04-13,Philippines,NA,Bicol Region,5796989,1,0,21,1
2020-04-14,Philippines,NA,Bicol Region,5796989,0,0,21,1
2020-04-15,Philippines,NA,Bicol Region,5796989,0,0,21,1
2020-04-17,Philippines,NA,Bicol Region,5796989,4,0,25,1
2020-04-19,Philippines,NA,Bicol Region,5796989,1,1,26,2
2020-04-20,Philippines,NA,Bicol Region,5796989,2,0,28,2
2020-04-21,Philippines,NA,Bicol Region,5796989,6,0,34,2
2020-04-22,Philippines,NA,Bicol Region,5796989,1,0,35,2
2020-04-23,Philippines,NA,Bicol Region,5796989,0,1,35,3
2020-04-24,Philippines,NA,Bicol Region,5796989,0,0,35,3
2020-04-26,Philippines,NA,Bicol Region,5796989,0,0,35,3
2020-04-27,Philippines,NA,Bicol Region,5796989,5,1,40,4
2020-04-28,Philippines,NA,Bicol Region,5796989,0,0,40,4
2020-04-29,Philippines,NA,Bicol Region,5796989,3,0,43,4
2020-04-30,Philippines,NA,Bicol Region,5796989,1,0,44,4
2020-05-01,Philippines,NA,Bicol Region,5796989,3,0,47,4
2020-05-04,Philippines,NA,Bicol Region,5796989,5,0,52,4
2020-05-05,Philippines,NA,Bicol Region,5796989,0,0,52,4
2020-05-06,Philippines,NA,Bicol Region,5796989,5,0,57,4
2020-05-07,Philippines,NA,Bicol Region,5796989,2,0,59,4
2020-05-08,Philippines,NA,Bicol Region,5796989,2,0,61,4
2020-05-09,Philippines,NA,Bicol Region,5796989,0,0,61,4
2020-05-11,Philippines,NA,Bicol Region,5796989,3,0,64,4
2020-05-12,Philippines,NA,Bicol Region,5796989,3,0,67,4
2020-05-13,Philippines,NA,Bicol Region,5796989,1,0,68,4
2020-05-14,Philippines,NA,Bicol Region,5796989,1,0,69,4
2020-05-15,Philippines,NA,Bicol Region,5796989,0,1,69,5
2020-05-16,Philippines,NA,Bicol Region,5796989,1,0,70,5
2020-05-19,Philippines,NA,Bicol Region,5796989,1,0,71,5
2020-05-21,Philippines,NA,Bicol Region,5796989,3,0,74,5
2020-05-22,Philippines,NA,Bicol Region,5796989,0,0,74,5
2020-05-23,Philippines,NA,Bicol Region,5796989,0,0,74,5
2020-05-25,Philippines,NA,Bicol Region,5796989,1,0,75,5
2020-05-26,Philippines,NA,Bicol Region,5796989,2,0,77,5
2020-05-28,Philippines,NA,Bicol Region,5796989,0,0,77,5
2020-05-29,Philippines,NA,Bicol Region,5796989,0,0,77,5
2020-05-30,Philippines,NA,Bicol Region,5796989,2,0,79,5
2020-05-31,Philippines,NA,Bicol Region,5796989,1,0,80,5
2020-06-01,Philippines,NA,Bicol Region,5796989,2,0,82,5
2020-06-02,Philippines,NA,Bicol Region,5796989,1,0,83,5
2020-06-03,Philippines,NA,Bicol Region,5796989,2,0,85,5
2020-06-04,Philippines,NA,Bicol Region,5796989,1,0,86,5
2020-06-06,Philippines,NA,Bicol Region,5796989,0,0,86,5
2020-06-08,Philippines,NA,Bicol Region,5796989,5,0,91,5
2020-06-09,Philippines,NA,Bicol Region,5796989,0,0,91,5
2020-06-10,Philippines,NA,Bicol Region,5796989,1,0,92,5
2020-06-12,Philippines,NA,Bicol Region,5796989,1,0,93,5
2020-06-14,Philippines,NA,Bicol Region,5796989,0,0,93,5
2020-06-15,Philippines,NA,Bicol Region,5796989,3,0,96,5
2020-06-16,Philippines,NA,Bicol Region,5796989,2,0,98,5
2020-06-17,Philippines,NA,Bicol Region,5796989,3,0,101,5
2020-06-18,Philippines,NA,Bicol Region,5796989,2,0,103,5
2020-06-19,Philippines,NA,Bicol Region,5796989,2,0,105,5
2020-06-20,Philippines,NA,Bicol Region,5796989,0,0,105,5
2020-06-22,Philippines,NA,Bicol Region,5796989,2,0,107,5
2020-06-23,Philippines,NA,Bicol Region,5796989,3,0,110,5
2020-06-24,Philippines,NA,Bicol Region,5796989,1,0,111,5
2020-06-25,Philippines,NA,Bicol Region,5796989,5,0,116,5
2020-06-26,Philippines,NA,Bicol Region,5796989,12,0,128,5
2020-06-27,Philippines,NA,Bicol Region,5796989,8,0,136,5
2020-06-28,Philippines,NA,Bicol Region,5796989,4,0,140,5
2020-06-29,Philippines,NA,Bicol Region,5796989,10,1,150,6
2020-06-30,Philippines,NA,Bicol Region,5796989,12,0,162,6
2020-07-01,Philippines,NA,Bicol Region,5796989,20,0,182,6
2020-07-02,Philippines,NA,Bicol Region,5796989,12,0,194,6
2020-07-03,Philippines,NA,Bicol Region,5796989,11,0,205,6
2020-07-04,Philippines,NA,Bicol Region,5796989,8,0,213,6
2020-07-05,Philippines,NA,Bicol Region,5796989,12,0,225,6
2020-07-06,Philippines,NA,Bicol Region,5796989,21,0,246,6
2020-07-07,Philippines,NA,Bicol Region,5796989,14,0,260,6
2020-07-08,Philippines,NA,Bicol Region,5796989,6,0,266,6
2020-07-09,Philippines,NA,Bicol Region,5796989,8,0,274,6
2020-07-10,Philippines,NA,Bicol Region,5796989,8,0,282,6
2020-07-11,Philippines,NA,Bicol Region,5796989,3,1,285,7
2020-07-12,Philippines,NA,Bicol Region,5796989,4,0,289,7
2020-07-13,Philippines,NA,Bicol Region,5796989,11,0,300,7
2020-07-14,Philippines,NA,Bicol Region,5796989,5,1,305,8
2020-07-15,Philippines,NA,Bicol Region,5796989,16,0,321,8
2020-07-16,Philippines,NA,Bicol Region,5796989,21,0,342,8
2020-07-17,Philippines,NA,Bicol Region,5796989,12,0,354,8
2020-07-18,Philippines,NA,Bicol Region,5796989,10,0,364,8
2020-07-19,Philippines,NA,Bicol Region,5796989,3,0,367,8
2020-07-20,Philippines,NA,Bicol Region,5796989,13,0,380,8
2020-07-21,Philippines,NA,Bicol Region,5796989,26,0,406,8
2020-07-22,Philippines,NA,Bicol Region,5796989,21,0,427,8
2020-07-23,Philippines,NA,Bicol Region,5796989,36,0,463,8
2020-07-24,Philippines,NA,Bicol Region,5796989,33,0,496,8
2020-07-25,Philippines,NA,Bicol Region,5796989,11,0,507,8
2020-07-26,Philippines,NA,Bicol Region,5796989,17,0,524,8
2020-07-27,Philippines,NA,Bicol Region,5796989,56,1,580,9
2020-07-28,Philippines,NA,Bicol Region,5796989,36,1,616,10
2020-07-29,Philippines,NA,Bicol Region,5796989,25,0,641,10
2020-07-30,Philippines,NA,Bicol Region,5796989,35,1,676,11
2020-07-31,Philippines,NA,Bicol Region,5796989,32,0,708,11
2020-08-01,Philippines,NA,Bicol Region,5796989,6,0,714,11
2020-08-02,Philippines,NA,Bicol Region,5796989,4,0,718,11
2020-08-03,Philippines,NA,Bicol Region,5796989,35,1,753,12
2020-08-04,Philippines,NA,Bicol Region,5796989,48,1,801,13
2020-08-05,Philippines,NA,Bicol Region,5796989,57,1,858,14
2020-08-06,Philippines,NA,Bicol Region,5796989,56,0,914,14
2020-08-07,Philippines,NA,Bicol Region,5796989,55,0,969,14
2020-08-08,Philippines,NA,Bicol Region,5796989,13,0,982,14
2020-08-09,Philippines,NA,Bicol Region,5796989,9,1,991,15
2020-08-10,Philippines,NA,Bicol Region,5796989,66,1,1057,16
2020-08-11,Philippines,NA,Bicol Region,5796989,46,2,1103,18
2020-08-12,Philippines,NA,Bicol Region,5796989,43,2,1146,20
2020-08-13,Philippines,NA,Bicol Region,5796989,23,0,1169,20
2020-08-14,Philippines,NA,Bicol Region,5796989,21,0,1190,20
2020-08-15,Philippines,NA,Bicol Region,5796989,16,0,1206,20
2020-08-16,Philippines,NA,Bicol Region,5796989,64,1,1270,21
2020-08-17,Philippines,NA,Bicol Region,5796989,46,0,1316,21
2020-08-18,Philippines,NA,Bicol Region,5796989,30,0,1346,21
2020-08-19,Philippines,NA,Bicol Region,5796989,46,1,1392,22
2020-08-20,Philippines,NA,Bicol Region,5796989,30,0,1422,22
2020-08-21,Philippines,NA,Bicol Region,5796989,25,0,1447,22
2020-08-22,Philippines,NA,Bicol Region,5796989,5,0,1452,22
2020-08-23,Philippines,NA,Bicol Region,5796989,3,0,1455,22
2020-08-24,Philippines,NA,Bicol Region,5796989,7,0,1462,22
2020-03-23,Philippines,NA,Cagayan Valley,3451410,7,0,15,1
2020-03-26,Philippines,NA,Cagayan Valley,3451410,3,0,18,1
2020-03-27,Philippines,NA,Cagayan Valley,3451410,2,0,20,1
2020-04-01,Philippines,NA,Cagayan Valley,3451410,0,0,20,1
2020-04-02,Philippines,NA,Cagayan Valley,3451410,2,0,22,1
2020-04-06,Philippines,NA,Cagayan Valley,3451410,2,0,24,1
2020-04-08,Philippines,NA,Cagayan Valley,3451410,2,0,26,1
2020-04-09,Philippines,NA,Cagayan Valley,3451410,0,0,26,1
2020-04-10,Philippines,NA,Cagayan Valley,3451410,1,0,27,1
2020-04-11,Philippines,NA,Cagayan Valley,3451410,0,0,27,1
2020-04-14,Philippines,NA,Cagayan Valley,3451410,0,0,27,1
2020-04-15,Philippines,NA,Cagayan Valley,3451410,0,0,27,1
2020-04-16,Philippines,NA,Cagayan Valley,3451410,0,0,27,1
2020-04-17,Philippines,NA,Cagayan Valley,3451410,0,0,27,1
2020-04-18,Philippines,NA,Cagayan Valley,3451410,0,0,27,1
2020-04-19,Philippines,NA,Cagayan Valley,3451410,0,0,27,1
2020-04-20,Philippines,NA,Cagayan Valley,3451410,0,0,27,1
2020-04-21,Philippines,NA,Cagayan Valley,3451410,0,0,27,1
2020-04-22,Philippines,NA,Cagayan Valley,3451410,3,0,30,1
2020-04-23,Philippines,NA,Cagayan Valley,3451410,1,0,31,1
2020-04-26,Philippines,NA,Cagayan Valley,3451410,1,0,32,1
2020-04-27,Philippines,NA,Cagayan Valley,3451410,1,0,33,1
2020-05-04,Philippines,NA,Cagayan Valley,3451410,0,0,33,1
2020-05-06,Philippines,NA,Cagayan Valley,3451410,0,0,33,1
2020-05-07,Philippines,NA,Cagayan Valley,3451410,0,0,33,1
2020-05-11,Philippines,NA,Cagayan Valley,3451410,0,0,33,1
2020-05-12,Philippines,NA,Cagayan Valley,3451410,0,0,33,1
2020-05-13,Philippines,NA,Cagayan Valley,3451410,0,0,33,1
2020-05-20,Philippines,NA,Cagayan Valley,3451410,1,0,34,1
2020-05-22,Philippines,NA,Cagayan Valley,3451410,1,0,35,1
2020-05-26,Philippines,NA,Cagayan Valley,3451410,0,0,35,1
2020-05-27,Philippines,NA,Cagayan Valley,3451410,1,0,36,1
2020-05-31,Philippines,NA,Cagayan Valley,3451410,1,0,37,1
2020-06-03,Philippines,NA,Cagayan Valley,3451410,2,0,39,1
2020-06-04,Philippines,NA,Cagayan Valley,3451410,1,0,40,1
2020-06-07,Philippines,NA,Cagayan Valley,3451410,2,0,42,1
2020-06-08,Philippines,NA,Cagayan Valley,3451410,5,0,47,1
2020-06-10,Philippines,NA,Cagayan Valley,3451410,4,0,51,1
2020-06-11,Philippines,NA,Cagayan Valley,3451410,2,0,53,1
2020-06-12,Philippines,NA,Cagayan Valley,3451410,1,0,54,1
2020-06-13,Philippines,NA,Cagayan Valley,3451410,1,0,55,1
2020-06-14,Philippines,NA,Cagayan Valley,3451410,1,0,56,1
2020-06-15,Philippines,NA,Cagayan Valley,3451410,2,0,58,1
2020-06-17,Philippines,NA,Cagayan Valley,3451410,2,0,60,1
2020-06-18,Philippines,NA,Cagayan Valley,3451410,1,0,61,1
2020-06-19,Philippines,NA,Cagayan Valley,3451410,3,0,64,1
2020-06-20,Philippines,NA,Cagayan Valley,3451410,3,0,67,1
2020-06-21,Philippines,NA,Cagayan Valley,3451410,2,0,69,1
2020-06-22,Philippines,NA,Cagayan Valley,3451410,7,0,76,1
2020-06-23,Philippines,NA,Cagayan Valley,3451410,2,0,78,1
2020-06-24,Philippines,NA,Cagayan Valley,3451410,4,0,82,1
2020-06-25,Philippines,NA,Cagayan Valley,3451410,1,0,83,1
2020-06-26,Philippines,NA,Cagayan Valley,3451410,3,0,86,1
2020-06-27,Philippines,NA,Cagayan Valley,3451410,2,0,88,1
2020-06-28,Philippines,NA,Cagayan Valley,3451410,7,0,95,1
2020-06-29,Philippines,NA,Cagayan Valley,3451410,9,0,104,1
2020-06-30,Philippines,NA,Cagayan Valley,3451410,3,0,107,1
2020-07-01,Philippines,NA,Cagayan Valley,3451410,5,0,112,1
2020-07-02,Philippines,NA,Cagayan Valley,3451410,8,0,120,1
2020-07-03,Philippines,NA,Cagayan Valley,3451410,5,0,125,1
2020-07-04,Philippines,NA,Cagayan Valley,3451410,10,0,135,1
2020-07-05,Philippines,NA,Cagayan Valley,3451410,3,0,138,1
2020-07-06,Philippines,NA,Cagayan Valley,3451410,7,0,145,1
2020-07-07,Philippines,NA,Cagayan Valley,3451410,3,0,148,1
2020-07-08,Philippines,NA,Cagayan Valley,3451410,7,0,155,1
2020-07-09,Philippines,NA,Cagayan Valley,3451410,10,0,165,1
2020-07-10,Philippines,NA,Cagayan Valley,3451410,5,0,170,1
2020-07-11,Philippines,NA,Cagayan Valley,3451410,6,0,176,1
2020-07-12,Philippines,NA,Cagayan Valley,3451410,4,1,180,2
2020-07-13,Philippines,NA,Cagayan Valley,3451410,12,0,192,2
2020-07-14,Philippines,NA,Cagayan Valley,3451410,10,0,202,2
2020-07-15,Philippines,NA,Cagayan Valley,3451410,10,0,212,2
2020-07-16,Philippines,NA,Cagayan Valley,3451410,7,0,219,2
2020-07-17,Philippines,NA,Cagayan Valley,3451410,12,0,231,2
2020-07-18,Philippines,NA,Cagayan Valley,3451410,12,0,243,2
2020-07-19,Philippines,NA,Cagayan Valley,3451410,2,0,245,2
2020-07-20,Philippines,NA,Cagayan Valley,3451410,7,0,252,2
2020-07-21,Philippines,NA,Cagayan Valley,3451410,10,0,262,2
2020-07-22,Philippines,NA,Cagayan Valley,3451410,22,0,284,2
2020-07-23,Philippines,NA,Cagayan Valley,3451410,6,1,290,3
2020-07-24,Philippines,NA,Cagayan Valley,3451410,3,0,293,3
2020-07-25,Philippines,NA,Cagayan Valley,3451410,9,0,302,3
2020-07-26,Philippines,NA,Cagayan Valley,3451410,2,0,304,3
2020-07-27,Philippines,NA,Cagayan Valley,3451410,10,0,314,3
2020-07-28,Philippines,NA,Cagayan Valley,3451410,11,0,325,3
2020-07-29,Philippines,NA,Cagayan Valley,3451410,8,0,333,3
2020-07-30,Philippines,NA,Cagayan Valley,3451410,18,0,351,3
2020-07-31,Philippines,NA,Cagayan Valley,3451410,18,0,369,3
2020-08-01,Philippines,NA,Cagayan Valley,3451410,8,0,377,3
2020-08-02,Philippines,NA,Cagayan Valley,3451410,5,0,382,3
2020-08-03,Philippines,NA,Cagayan Valley,3451410,33,0,415,3
2020-08-04,Philippines,NA,Cagayan Valley,3451410,42,0,457,3
2020-08-05,Philippines,NA,Cagayan Valley,3451410,39,0,496,3
2020-08-06,Philippines,NA,Cagayan Valley,3451410,16,0,512,3
2020-08-07,Philippines,NA,Cagayan Valley,3451410,18,0,530,3
2020-08-08,Philippines,NA,Cagayan Valley,3451410,1,0,531,3
2020-08-09,Philippines,NA,Cagayan Valley,3451410,3,0,534,3
2020-08-10,Philippines,NA,Cagayan Valley,3451410,20,0,554,3
2020-08-11,Philippines,NA,Cagayan Valley,3451410,14,0,568,3
2020-08-12,Philippines,NA,Cagayan Valley,3451410,19,0,587,3
2020-08-13,Philippines,NA,Cagayan Valley,3451410,16,0,603,3
2020-08-14,Philippines,NA,Cagayan Valley,3451410,11,1,614,4
2020-08-15,Philippines,NA,Cagayan Valley,3451410,7,0,621,4
2020-08-16,Philippines,NA,Cagayan Valley,3451410,5,0,626,4
2020-08-17,Philippines,NA,Cagayan Valley,3451410,18,0,644,4
2020-08-18,Philippines,NA,Cagayan Valley,3451410,8,0,652,4
2020-08-19,Philippines,NA,Cagayan Valley,3451410,13,0,665,4
2020-08-20,Philippines,NA,Cagayan Valley,3451410,18,0,683,4
2020-08-21,Philippines,NA,Cagayan Valley,3451410,12,0,695,4
2020-08-22,Philippines,NA,Cagayan Valley,3451410,13,0,708,4
2020-08-23,Philippines,NA,Cagayan Valley,3451410,10,0,718,4
2020-08-24,Philippines,NA,Cagayan Valley,3451410,3,0,721,4
2020-03-08,Philippines,NA,Calabarzon,14414774,36,0,40,0
2020-03-09,Philippines,NA,Calabarzon,14414774,1,0,41,0
2020-03-10,Philippines,NA,Calabarzon,14414774,3,0,44,0
2020-03-11,Philippines,NA,Calabarzon,14414774,5,1,49,1
2020-03-12,Philippines,NA,Calabarzon,14414774,7,1,56,2
2020-03-13,Philippines,NA,Calabarzon,14414774,8,1,64,3
2020-03-14,Philippines,NA,Calabarzon,14414774,17,1,81,4
2020-03-15,Philippines,NA,Calabarzon,14414774,9,1,90,5
2020-03-16,Philippines,NA,Calabarzon,14414774,9,1,99,6
2020-03-17,Philippines,NA,Calabarzon,14414774,15,2,114,8
2020-03-18,Philippines,NA,Calabarzon,14414774,22,0,136,8
2020-03-19,Philippines,NA,Calabarzon,14414774,24,0,160,8
2020-03-20,Philippines,NA,Calabarzon,14414774,18,2,178,10
2020-03-21,Philippines,NA,Calabarzon,14414774,12,1,190,11
2020-03-22,Philippines,NA,Calabarzon,14414774,14,1,204,12
2020-03-23,Philippines,NA,Calabarzon,14414774,22,6,226,18
2020-03-24,Philippines,NA,Calabarzon,14414774,20,2,246,20
2020-03-25,Philippines,NA,Calabarzon,14414774,14,4,260,24
2020-03-26,Philippines,NA,Calabarzon,14414774,39,3,299,27
2020-03-27,Philippines,NA,Calabarzon,14414774,36,3,335,30
2020-03-28,Philippines,NA,Calabarzon,14414774,26,3,361,33
2020-03-29,Philippines,NA,Calabarzon,14414774,18,4,379,37
2020-03-30,Philippines,NA,Calabarzon,14414774,28,6,407,43
2020-03-31,Philippines,NA,Calabarzon,14414774,28,4,435,47
2020-04-01,Philippines,NA,Calabarzon,14414774,38,4,473,51
2020-04-02,Philippines,NA,Calabarzon,14414774,84,4,557,55
2020-04-03,Philippines,NA,Calabarzon,14414774,29,4,586,59
2020-04-04,Philippines,NA,Calabarzon,14414774,30,8,616,67
2020-04-05,Philippines,NA,Calabarzon,14414774,18,8,634,75
2020-04-06,Philippines,NA,Calabarzon,14414774,44,2,678,77
2020-04-07,Philippines,NA,Calabarzon,14414774,69,3,747,80
2020-04-08,Philippines,NA,Calabarzon,14414774,104,2,851,82
2020-04-09,Philippines,NA,Calabarzon,14414774,39,4,890,86
2020-04-10,Philippines,NA,Calabarzon,14414774,43,3,933,89
2020-04-11,Philippines,NA,Calabarzon,14414774,52,3,985,92
2020-04-12,Philippines,NA,Calabarzon,14414774,47,4,1032,96
2020-04-13,Philippines,NA,Calabarzon,14414774,43,2,1075,98
2020-04-14,Philippines,NA,Calabarzon,14414774,24,0,1099,98
2020-04-15,Philippines,NA,Calabarzon,14414774,40,2,1139,100
2020-04-16,Philippines,NA,Calabarzon,14414774,32,2,1171,102
2020-04-17,Philippines,NA,Calabarzon,14414774,57,3,1228,105
2020-04-18,Philippines,NA,Calabarzon,14414774,8,2,1236,107
2020-04-19,Philippines,NA,Calabarzon,14414774,7,2,1243,109
2020-04-20,Philippines,NA,Calabarzon,14414774,15,2,1258,111
2020-04-21,Philippines,NA,Calabarzon,14414774,8,0,1266,111
2020-04-22,Philippines,NA,Calabarzon,14414774,24,2,1290,113
2020-04-23,Philippines,NA,Calabarzon,14414774,10,3,1300,116
2020-04-24,Philippines,NA,Calabarzon,14414774,15,0,1315,116
2020-04-25,Philippines,NA,Calabarzon,14414774,13,1,1328,117
2020-04-26,Philippines,NA,Calabarzon,14414774,7,1,1335,118
2020-04-27,Philippines,NA,Calabarzon,14414774,17,1,1352,119
2020-04-28,Philippines,NA,Calabarzon,14414774,10,2,1362,121
2020-04-29,Philippines,NA,Calabarzon,14414774,26,0,1388,121
2020-04-30,Philippines,NA,Calabarzon,14414774,11,1,1399,122
2020-05-01,Philippines,NA,Calabarzon,14414774,16,0,1415,122
2020-05-02,Philippines,NA,Calabarzon,14414774,7,0,1422,122
2020-05-03,Philippines,NA,Calabarzon,14414774,10,2,1432,124
2020-05-04,Philippines,NA,Calabarzon,14414774,7,2,1439,126
2020-05-05,Philippines,NA,Calabarzon,14414774,11,0,1450,126
2020-05-06,Philippines,NA,Calabarzon,14414774,15,2,1465,128
2020-05-07,Philippines,NA,Calabarzon,14414774,17,0,1482,128
2020-05-08,Philippines,NA,Calabarzon,14414774,28,1,1510,129
2020-05-09,Philippines,NA,Calabarzon,14414774,10,2,1520,131
2020-05-10,Philippines,NA,Calabarzon,14414774,5,0,1525,131
2020-05-11,Philippines,NA,Calabarzon,14414774,23,2,1548,133
2020-05-12,Philippines,NA,Calabarzon,14414774,21,1,1569,134
2020-05-13,Philippines,NA,Calabarzon,14414774,18,1,1587,135
2020-05-14,Philippines,NA,Calabarzon,14414774,15,1,1602,136
2020-05-15,Philippines,NA,Calabarzon,14414774,16,1,1618,137
2020-05-16,Philippines,NA,Calabarzon,14414774,5,1,1623,138
2020-05-17,Philippines,NA,Calabarzon,14414774,15,2,1638,140
2020-05-18,Philippines,NA,Calabarzon,14414774,25,0,1663,140
2020-05-19,Philippines,NA,Calabarzon,14414774,30,4,1693,144
2020-05-20,Philippines,NA,Calabarzon,14414774,38,0,1731,144
2020-05-21,Philippines,NA,Calabarzon,14414774,31,0,1762,144
2020-05-22,Philippines,NA,Calabarzon,14414774,26,2,1788,146
2020-05-23,Philippines,NA,Calabarzon,14414774,15,2,1803,148
2020-05-24,Philippines,NA,Calabarzon,14414774,9,1,1812,149
2020-05-25,Philippines,NA,Calabarzon,14414774,14,0,1826,149
2020-05-26,Philippines,NA,Calabarzon,14414774,23,2,1849,151
2020-05-27,Philippines,NA,Calabarzon,14414774,24,0,1873,151
2020-05-28,Philippines,NA,Calabarzon,14414774,29,0,1902,151
2020-05-29,Philippines,NA,Calabarzon,14414774,21,1,1923,152
2020-05-30,Philippines,NA,Calabarzon,14414774,7,0,1930,152
2020-05-31,Philippines,NA,Calabarzon,14414774,8,1,1938,153
2020-06-01,Philippines,NA,Calabarzon,14414774,27,1,1965,154
2020-06-02,Philippines,NA,Calabarzon,14414774,22,0,1987,154
2020-06-03,Philippines,NA,Calabarzon,14414774,32,0,2019,154
2020-06-04,Philippines,NA,Calabarzon,14414774,50,2,2069,156
2020-06-05,Philippines,NA,Calabarzon,14414774,44,2,2113,158
2020-06-06,Philippines,NA,Calabarzon,14414774,18,0,2131,158
2020-06-07,Philippines,NA,Calabarzon,14414774,10,0,2141,158
2020-06-08,Philippines,NA,Calabarzon,14414774,54,1,2195,159
2020-06-09,Philippines,NA,Calabarzon,14414774,39,0,2234,159
2020-06-10,Philippines,NA,Calabarzon,14414774,34,1,2268,160
2020-06-11,Philippines,NA,Calabarzon,14414774,59,0,2327,160
2020-06-12,Philippines,NA,Calabarzon,14414774,18,0,2345,160
2020-06-13,Philippines,NA,Calabarzon,14414774,25,1,2370,161
2020-06-14,Philippines,NA,Calabarzon,14414774,26,1,2396,162
2020-06-15,Philippines,NA,Calabarzon,14414774,50,0,2446,162
2020-06-16,Philippines,NA,Calabarzon,14414774,63,1,2509,163
2020-06-17,Philippines,NA,Calabarzon,14414774,66,1,2575,164
2020-06-18,Philippines,NA,Calabarzon,14414774,65,0,2640,164
2020-06-19,Philippines,NA,Calabarzon,14414774,62,1,2702,165
2020-06-20,Philippines,NA,Calabarzon,14414774,51,1,2753,166
2020-06-21,Philippines,NA,Calabarzon,14414774,42,0,2795,166
2020-06-22,Philippines,NA,Calabarzon,14414774,94,0,2889,166
2020-06-23,Philippines,NA,Calabarzon,14414774,118,0,3007,166
2020-06-24,Philippines,NA,Calabarzon,14414774,88,1,3095,167
2020-06-25,Philippines,NA,Calabarzon,14414774,167,0,3262,167
2020-06-26,Philippines,NA,Calabarzon,14414774,126,0,3388,167
2020-06-27,Philippines,NA,Calabarzon,14414774,49,0,3437,167
2020-06-28,Philippines,NA,Calabarzon,14414774,47,0,3484,167
2020-06-29,Philippines,NA,Calabarzon,14414774,177,1,3661,168
2020-06-30,Philippines,NA,Calabarzon,14414774,155,0,3816,168
2020-07-01,Philippines,NA,Calabarzon,14414774,177,0,3993,168
2020-07-02,Philippines,NA,Calabarzon,14414774,128,0,4121,168
2020-07-03,Philippines,NA,Calabarzon,14414774,239,0,4360,168
2020-07-04,Philippines,NA,Calabarzon,14414774,145,0,4505,168
2020-07-05,Philippines,NA,Calabarzon,14414774,73,0,4578,168
2020-07-06,Philippines,NA,Calabarzon,14414774,200,1,4778,169
2020-07-07,Philippines,NA,Calabarzon,14414774,231,0,5009,169
2020-07-08,Philippines,NA,Calabarzon,14414774,201,1,5210,170
2020-07-09,Philippines,NA,Calabarzon,14414774,229,1,5439,171
2020-07-10,Philippines,NA,Calabarzon,14414774,277,0,5716,171
2020-07-11,Philippines,NA,Calabarzon,14414774,203,1,5919,172
2020-07-12,Philippines,NA,Calabarzon,14414774,116,0,6035,172
2020-07-13,Philippines,NA,Calabarzon,14414774,237,0,6272,172
2020-07-14,Philippines,NA,Calabarzon,14414774,233,2,6505,174
2020-07-15,Philippines,NA,Calabarzon,14414774,257,3,6762,177
2020-07-16,Philippines,NA,Calabarzon,14414774,496,0,7258,177
2020-07-17,Philippines,NA,Calabarzon,14414774,625,2,7883,179
2020-07-18,Philippines,NA,Calabarzon,14414774,263,1,8146,180
2020-07-19,Philippines,NA,Calabarzon,14414774,165,1,8311,181
2020-07-20,Philippines,NA,Calabarzon,14414774,828,3,9139,184
2020-07-21,Philippines,NA,Calabarzon,14414774,640,3,9779,187
2020-07-22,Philippines,NA,Calabarzon,14414774,680,1,10459,188
2020-07-23,Philippines,NA,Calabarzon,14414774,1067,4,11526,192
2020-07-24,Philippines,NA,Calabarzon,14414774,826,1,12352,193
2020-07-25,Philippines,NA,Calabarzon,14414774,656,1,13008,194
2020-07-26,Philippines,NA,Calabarzon,14414774,236,2,13244,196
2020-07-27,Philippines,NA,Calabarzon,14414774,848,2,14092,198
2020-07-28,Philippines,NA,Calabarzon,14414774,834,2,14926,200
2020-07-29,Philippines,NA,Calabarzon,14414774,712,7,15638,207
2020-07-30,Philippines,NA,Calabarzon,14414774,620,2,16258,209
2020-07-31,Philippines,NA,Calabarzon,14414774,487,4,16745,213
2020-08-01,Philippines,NA,Calabarzon,14414774,368,4,17113,217
2020-08-02,Philippines,NA,Calabarzon,14414774,210,3,17323,220
2020-08-03,Philippines,NA,Calabarzon,14414774,725,0,18048,220
2020-08-04,Philippines,NA,Calabarzon,14414774,716,4,18764,224
2020-08-05,Philippines,NA,Calabarzon,14414774,637,4,19401,228
2020-08-06,Philippines,NA,Calabarzon,14414774,713,1,20114,229
2020-08-07,Philippines,NA,Calabarzon,14414774,635,4,20749,233
2020-08-08,Philippines,NA,Calabarzon,14414774,413,4,21162,237
2020-08-09,Philippines,NA,Calabarzon,14414774,287,3,21449,240
2020-08-10,Philippines,NA,Calabarzon,14414774,850,5,22299,245
2020-08-11,Philippines,NA,Calabarzon,14414774,809,9,23108,254
2020-08-12,Philippines,NA,Calabarzon,14414774,755,3,23863,257
2020-08-13,Philippines,NA,Calabarzon,14414774,734,4,24597,261
2020-08-14,Philippines,NA,Calabarzon,14414774,829,7,25426,268
2020-08-15,Philippines,NA,Calabarzon,14414774,335,2,25761,270
2020-08-16,Philippines,NA,Calabarzon,14414774,269,1,26030,271
2020-08-17,Philippines,NA,Calabarzon,14414774,799,1,26829,272
2020-08-18,Philippines,NA,Calabarzon,14414774,685,2,27514,274
2020-08-19,Philippines,NA,Calabarzon,14414774,667,2,28181,276
2020-08-20,Philippines,NA,Calabarzon,14414774,677,1,28858,277
2020-08-21,Philippines,NA,Calabarzon,14414774,468,1,29326,278
2020-08-22,Philippines,NA,Calabarzon,14414774,247,1,29573,279
2020-08-23,Philippines,NA,Calabarzon,14414774,73,0,29646,279
2020-08-24,Philippines,NA,Calabarzon,14414774,77,0,29723,279
2020-08-25,Philippines,NA,Calabarzon,14414774,12,0,29735,279
2020-03-10,Philippines,NA,Central Luzon,11218177,2,0,11,0
2020-03-11,Philippines,NA,Central Luzon,11218177,2,0,13,0
2020-03-12,Philippines,NA,Central Luzon,11218177,2,0,15,0
2020-03-13,Philippines,NA,Central Luzon,11218177,1,1,16,1
2020-03-14,Philippines,NA,Central Luzon,11218177,4,0,20,1
2020-03-15,Philippines,NA,Central Luzon,11218177,5,1,25,2
2020-03-16,Philippines,NA,Central Luzon,11218177,9,0,34,2
2020-03-17,Philippines,NA,Central Luzon,11218177,3,0,37,2
2020-03-18,Philippines,NA,Central Luzon,11218177,4,0,41,2
2020-03-19,Philippines,NA,Central Luzon,11218177,7,0,48,2
2020-03-20,Philippines,NA,Central Luzon,11218177,4,2,52,4
2020-03-21,Philippines,NA,Central Luzon,11218177,9,0,61,4
2020-03-22,Philippines,NA,Central Luzon,11218177,7,0,68,4
2020-03-23,Philippines,NA,Central Luzon,11218177,10,1,78,5
2020-03-24,Philippines,NA,Central Luzon,11218177,12,3,90,8
2020-03-25,Philippines,NA,Central Luzon,11218177,17,4,107,12
2020-03-26,Philippines,NA,Central Luzon,11218177,15,3,122,15
2020-03-27,Philippines,NA,Central Luzon,11218177,14,2,136,17
2020-03-28,Philippines,NA,Central Luzon,11218177,6,2,142,19
2020-03-29,Philippines,NA,Central Luzon,11218177,6,2,148,21
2020-03-30,Philippines,NA,Central Luzon,11218177,9,0,157,21
2020-03-31,Philippines,NA,Central Luzon,11218177,17,1,174,22
2020-04-01,Philippines,NA,Central Luzon,11218177,10,2,184,24
2020-04-02,Philippines,NA,Central Luzon,11218177,13,2,197,26
2020-04-03,Philippines,NA,Central Luzon,11218177,9,0,206,26
2020-04-04,Philippines,NA,Central Luzon,11218177,9,2,215,28
2020-04-05,Philippines,NA,Central Luzon,11218177,3,1,218,29
2020-04-06,Philippines,NA,Central Luzon,11218177,10,0,228,29
2020-04-07,Philippines,NA,Central Luzon,11218177,13,0,241,29
2020-04-08,Philippines,NA,Central Luzon,11218177,33,4,274,33
2020-04-09,Philippines,NA,Central Luzon,11218177,12,1,286,34
2020-04-10,Philippines,NA,Central Luzon,11218177,39,3,325,37
2020-04-11,Philippines,NA,Central Luzon,11218177,17,0,342,37
2020-04-12,Philippines,NA,Central Luzon,11218177,15,0,357,37
2020-04-13,Philippines,NA,Central Luzon,11218177,9,2,366,39
2020-04-14,Philippines,NA,Central Luzon,11218177,8,0,374,39
2020-04-15,Philippines,NA,Central Luzon,11218177,9,0,383,39
2020-04-16,Philippines,NA,Central Luzon,11218177,8,0,391,39
2020-04-17,Philippines,NA,Central Luzon,11218177,8,0,399,39
2020-04-18,Philippines,NA,Central Luzon,11218177,9,1,408,40
2020-04-19,Philippines,NA,Central Luzon,11218177,13,0,421,40
2020-04-20,Philippines,NA,Central Luzon,11218177,20,2,441,42
2020-04-21,Philippines,NA,Central Luzon,11218177,10,2,451,44
2020-04-22,Philippines,NA,Central Luzon,11218177,14,1,465,45
2020-04-23,Philippines,NA,Central Luzon,11218177,7,1,472,46
2020-04-24,Philippines,NA,Central Luzon,11218177,15,0,487,46
2020-04-25,Philippines,NA,Central Luzon,11218177,14,1,501,47
2020-04-26,Philippines,NA,Central Luzon,11218177,5,0,506,47
2020-04-27,Philippines,NA,Central Luzon,11218177,9,0,515,47
2020-04-28,Philippines,NA,Central Luzon,11218177,5,0,520,47
2020-04-29,Philippines,NA,Central Luzon,11218177,10,1,530,48
2020-04-30,Philippines,NA,Central Luzon,11218177,5,0,535,48
2020-05-01,Philippines,NA,Central Luzon,11218177,5,1,540,49
2020-05-02,Philippines,NA,Central Luzon,11218177,2,0,542,49
2020-05-03,Philippines,NA,Central Luzon,11218177,1,0,543,49
2020-05-04,Philippines,NA,Central Luzon,11218177,1,1,544,50
2020-05-05,Philippines,NA,Central Luzon,11218177,10,0,554,50
2020-05-06,Philippines,NA,Central Luzon,11218177,4,1,558,51
2020-05-07,Philippines,NA,Central Luzon,11218177,8,0,566,51
2020-05-08,Philippines,NA,Central Luzon,11218177,4,2,570,53
2020-05-09,Philippines,NA,Central Luzon,11218177,3,0,573,53
2020-05-10,Philippines,NA,Central Luzon,11218177,2,1,575,54
2020-05-11,Philippines,NA,Central Luzon,11218177,4,0,579,54
2020-05-12,Philippines,NA,Central Luzon,11218177,4,0,583,54
2020-05-13,Philippines,NA,Central Luzon,11218177,8,0,591,54
2020-05-14,Philippines,NA,Central Luzon,11218177,4,0,595,54
2020-05-15,Philippines,NA,Central Luzon,11218177,8,0,603,54
2020-05-16,Philippines,NA,Central Luzon,11218177,1,0,604,54
2020-05-17,Philippines,NA,Central Luzon,11218177,1,1,605,55
2020-05-18,Philippines,NA,Central Luzon,11218177,6,0,611,55
2020-05-19,Philippines,NA,Central Luzon,11218177,14,0,625,55
2020-05-20,Philippines,NA,Central Luzon,11218177,9,0,634,55
2020-05-21,Philippines,NA,Central Luzon,11218177,4,0,638,55
2020-05-22,Philippines,NA,Central Luzon,11218177,15,0,653,55
2020-05-23,Philippines,NA,Central Luzon,11218177,2,1,655,56
2020-05-24,Philippines,NA,Central Luzon,11218177,1,0,656,56
2020-05-25,Philippines,NA,Central Luzon,11218177,12,2,668,58
2020-05-26,Philippines,NA,Central Luzon,11218177,10,0,678,58
2020-05-27,Philippines,NA,Central Luzon,11218177,8,1,686,59
2020-05-28,Philippines,NA,Central Luzon,11218177,7,0,693,59
2020-05-29,Philippines,NA,Central Luzon,11218177,4,0,697,59
2020-05-30,Philippines,NA,Central Luzon,11218177,3,1,700,60
2020-05-31,Philippines,NA,Central Luzon,11218177,3,0,703,60
2020-06-01,Philippines,NA,Central Luzon,11218177,14,0,717,60
2020-06-02,Philippines,NA,Central Luzon,11218177,10,0,727,60
2020-06-03,Philippines,NA,Central Luzon,11218177,9,0,736,60
2020-06-04,Philippines,NA,Central Luzon,11218177,15,0,751,60
2020-06-05,Philippines,NA,Central Luzon,11218177,11,0,762,60
2020-06-06,Philippines,NA,Central Luzon,11218177,3,0,765,60
2020-06-07,Philippines,NA,Central Luzon,11218177,2,0,767,60
2020-06-08,Philippines,NA,Central Luzon,11218177,19,0,786,60
2020-06-09,Philippines,NA,Central Luzon,11218177,11,0,797,60
2020-06-10,Philippines,NA,Central Luzon,11218177,7,0,804,60
2020-06-11,Philippines,NA,Central Luzon,11218177,10,0,814,60
2020-06-12,Philippines,NA,Central Luzon,11218177,7,0,821,60
2020-06-13,Philippines,NA,Central Luzon,11218177,2,0,823,60
2020-06-14,Philippines,NA,Central Luzon,11218177,3,1,826,61
2020-06-15,Philippines,NA,Central Luzon,11218177,17,2,843,63
2020-06-16,Philippines,NA,Central Luzon,11218177,7,0,850,63
2020-06-17,Philippines,NA,Central Luzon,11218177,17,0,867,63
2020-06-18,Philippines,NA,Central Luzon,11218177,23,0,890,63
2020-06-19,Philippines,NA,Central Luzon,11218177,16,1,906,64
2020-06-20,Philippines,NA,Central Luzon,11218177,8,0,914,64
2020-06-21,Philippines,NA,Central Luzon,11218177,9,0,923,64
2020-06-22,Philippines,NA,Central Luzon,11218177,33,0,956,64
2020-06-23,Philippines,NA,Central Luzon,11218177,22,0,978,64
2020-06-24,Philippines,NA,Central Luzon,11218177,26,0,1004,64
2020-06-25,Philippines,NA,Central Luzon,11218177,28,0,1032,64
2020-06-26,Philippines,NA,Central Luzon,11218177,28,0,1060,64
2020-06-27,Philippines,NA,Central Luzon,11218177,28,2,1088,66
2020-06-28,Philippines,NA,Central Luzon,11218177,7,0,1095,66
2020-06-29,Philippines,NA,Central Luzon,11218177,41,0,1136,66
2020-06-30,Philippines,NA,Central Luzon,11218177,60,0,1196,66
2020-07-01,Philippines,NA,Central Luzon,11218177,48,0,1244,66
2020-07-02,Philippines,NA,Central Luzon,11218177,48,0,1292,66
2020-07-03,Philippines,NA,Central Luzon,11218177,50,0,1342,66
2020-07-04,Philippines,NA,Central Luzon,11218177,39,0,1381,66
2020-07-05,Philippines,NA,Central Luzon,11218177,13,0,1394,66
2020-07-06,Philippines,NA,Central Luzon,11218177,57,0,1451,66
2020-07-07,Philippines,NA,Central Luzon,11218177,52,0,1503,66
2020-07-08,Philippines,NA,Central Luzon,11218177,57,0,1560,66
2020-07-09,Philippines,NA,Central Luzon,11218177,56,0,1616,66
2020-07-10,Philippines,NA,Central Luzon,11218177,58,0,1674,66
2020-07-11,Philippines,NA,Central Luzon,11218177,38,1,1712,67
2020-07-12,Philippines,NA,Central Luzon,11218177,18,0,1730,67
2020-07-13,Philippines,NA,Central Luzon,11218177,71,1,1801,68
2020-07-14,Philippines,NA,Central Luzon,11218177,96,1,1897,69
2020-07-15,Philippines,NA,Central Luzon,11218177,74,1,1971,70
2020-07-16,Philippines,NA,Central Luzon,11218177,85,0,2056,70
2020-07-17,Philippines,NA,Central Luzon,11218177,88,0,2144,70
2020-07-18,Philippines,NA,Central Luzon,11218177,93,0,2237,70
2020-07-19,Philippines,NA,Central Luzon,11218177,29,0,2266,70
2020-07-20,Philippines,NA,Central Luzon,11218177,101,0,2367,70
2020-07-21,Philippines,NA,Central Luzon,11218177,114,1,2481,71
2020-07-22,Philippines,NA,Central Luzon,11218177,100,0,2581,71
2020-07-23,Philippines,NA,Central Luzon,11218177,146,0,2727,71
2020-07-24,Philippines,NA,Central Luzon,11218177,90,0,2817,71
2020-07-25,Philippines,NA,Central Luzon,11218177,108,0,2925,71
2020-07-26,Philippines,NA,Central Luzon,11218177,37,1,2962,72
2020-07-27,Philippines,NA,Central Luzon,11218177,226,1,3188,73
2020-07-28,Philippines,NA,Central Luzon,11218177,138,0,3326,73
2020-07-29,Philippines,NA,Central Luzon,11218177,126,1,3452,74
2020-07-30,Philippines,NA,Central Luzon,11218177,152,2,3604,76
2020-07-31,Philippines,NA,Central Luzon,11218177,118,1,3722,77
2020-08-01,Philippines,NA,Central Luzon,11218177,69,0,3791,77
2020-08-02,Philippines,NA,Central Luzon,11218177,30,0,3821,77
2020-08-03,Philippines,NA,Central Luzon,11218177,171,0,3992,77
2020-08-04,Philippines,NA,Central Luzon,11218177,147,3,4139,80
2020-08-05,Philippines,NA,Central Luzon,11218177,173,0,4312,80
2020-08-06,Philippines,NA,Central Luzon,11218177,211,0,4523,80
2020-08-07,Philippines,NA,Central Luzon,11218177,159,1,4682,81
2020-08-08,Philippines,NA,Central Luzon,11218177,106,0,4788,81
2020-08-09,Philippines,NA,Central Luzon,11218177,62,0,4850,81
2020-08-10,Philippines,NA,Central Luzon,11218177,235,3,5085,84
2020-08-11,Philippines,NA,Central Luzon,11218177,183,0,5268,84
2020-08-12,Philippines,NA,Central Luzon,11218177,216,2,5484,86
2020-08-13,Philippines,NA,Central Luzon,11218177,162,4,5646,90
2020-08-14,Philippines,NA,Central Luzon,11218177,247,1,5893,91
2020-08-15,Philippines,NA,Central Luzon,11218177,130,1,6023,92
2020-08-16,Philippines,NA,Central Luzon,11218177,62,0,6085,92
2020-08-17,Philippines,NA,Central Luzon,11218177,283,1,6368,93
2020-08-18,Philippines,NA,Central Luzon,11218177,197,1,6565,94
2020-08-19,Philippines,NA,Central Luzon,11218177,170,2,6735,96
2020-08-20,Philippines,NA,Central Luzon,11218177,271,0,7006,96
2020-08-21,Philippines,NA,Central Luzon,11218177,150,0,7156,96
2020-08-22,Philippines,NA,Central Luzon,11218177,169,0,7325,96
2020-08-23,Philippines,NA,Central Luzon,11218177,21,0,7346,96
2020-08-24,Philippines,NA,Central Luzon,11218177,31,0,7377,96
2020-08-25,Philippines,NA,Central Luzon,11218177,23,0,7400,96
2020-03-13,Philippines,NA,Central Visayas,7396898,1,0,11,1
2020-03-18,Philippines,NA,Central Visayas,7396898,2,0,13,1
2020-03-19,Philippines,NA,Central Visayas,7396898,5,0,18,1
2020-03-20,Philippines,NA,Central Visayas,7396898,5,0,23,1
2020-03-21,Philippines,NA,Central Visayas,7396898,1,0,24,1
2020-03-22,Philippines,NA,Central Visayas,7396898,5,0,29,1
2020-03-23,Philippines,NA,Central Visayas,7396898,3,0,32,1
2020-03-24,Philippines,NA,Central Visayas,7396898,3,1,35,2
2020-03-25,Philippines,NA,Central Visayas,7396898,6,0,41,2
2020-03-26,Philippines,NA,Central Visayas,7396898,4,0,45,2
2020-03-27,Philippines,NA,Central Visayas,7396898,2,2,47,4
2020-03-28,Philippines,NA,Central Visayas,7396898,0,1,47,5
2020-03-29,Philippines,NA,Central Visayas,7396898,1,0,48,5
2020-04-01,Philippines,NA,Central Visayas,7396898,1,0,49,5
2020-04-02,Philippines,NA,Central Visayas,7396898,1,1,50,6
2020-04-03,Philippines,NA,Central Visayas,7396898,1,1,51,7
2020-04-04,Philippines,NA,Central Visayas,7396898,2,0,53,7
2020-04-05,Philippines,NA,Central Visayas,7396898,0,2,53,9
2020-04-06,Philippines,NA,Central Visayas,7396898,3,1,56,10
2020-04-07,Philippines,NA,Central Visayas,7396898,2,0,58,10
2020-04-08,Philippines,NA,Central Visayas,7396898,2,1,60,11
2020-04-09,Philippines,NA,Central Visayas,7396898,1,0,61,11
2020-04-11,Philippines,NA,Central Visayas,7396898,0,0,61,11
2020-04-12,Philippines,NA,Central Visayas,7396898,2,0,63,11
2020-04-13,Philippines,NA,Central Visayas,7396898,24,0,87,11
2020-04-14,Philippines,NA,Central Visayas,7396898,24,0,111,11
2020-04-15,Philippines,NA,Central Visayas,7396898,68,0,179,11
2020-04-16,Philippines,NA,Central Visayas,7396898,4,0,183,11
2020-04-17,Philippines,NA,Central Visayas,7396898,3,0,186,11
2020-04-18,Philippines,NA,Central Visayas,7396898,3,1,189,12
2020-04-19,Philippines,NA,Central Visayas,7396898,5,0,194,12
2020-04-20,Philippines,NA,Central Visayas,7396898,135,1,329,13
2020-04-21,Philippines,NA,Central Visayas,7396898,4,0,333,13
2020-04-22,Philippines,NA,Central Visayas,7396898,69,0,402,13
2020-04-23,Philippines,NA,Central Visayas,7396898,42,0,444,13
2020-04-24,Philippines,NA,Central Visayas,7396898,75,0,519,13
2020-04-25,Philippines,NA,Central Visayas,7396898,28,2,547,15
2020-04-26,Philippines,NA,Central Visayas,7396898,2,0,549,15
2020-04-27,Philippines,NA,Central Visayas,7396898,89,0,638,15
2020-04-28,Philippines,NA,Central Visayas,7396898,152,1,790,16
2020-04-29,Philippines,NA,Central Visayas,7396898,92,2,882,18
2020-04-30,Philippines,NA,Central Visayas,7396898,431,2,1313,20
2020-05-01,Philippines,NA,Central Visayas,7396898,69,1,1382,21
2020-05-02,Philippines,NA,Central Visayas,7396898,12,1,1394,22
2020-05-03,Philippines,NA,Central Visayas,7396898,4,1,1398,23
2020-05-04,Philippines,NA,Central Visayas,7396898,121,0,1519,23
2020-05-05,Philippines,NA,Central Visayas,7396898,37,3,1556,26
2020-05-06,Philippines,NA,Central Visayas,7396898,75,0,1631,26
2020-05-07,Philippines,NA,Central Visayas,7396898,166,1,1797,27
2020-05-08,Philippines,NA,Central Visayas,7396898,54,1,1851,28
2020-05-09,Philippines,NA,Central Visayas,7396898,12,2,1863,30
2020-05-10,Philippines,NA,Central Visayas,7396898,9,1,1872,31
2020-05-11,Philippines,NA,Central Visayas,7396898,42,2,1914,33
2020-05-12,Philippines,NA,Central Visayas,7396898,34,2,1948,35
2020-05-13,Philippines,NA,Central Visayas,7396898,79,5,2027,40
2020-05-14,Philippines,NA,Central Visayas,7396898,99,3,2126,43
2020-05-15,Philippines,NA,Central Visayas,7396898,61,2,2187,45
2020-05-16,Philippines,NA,Central Visayas,7396898,19,2,2206,47
2020-05-17,Philippines,NA,Central Visayas,7396898,18,2,2224,49
2020-05-18,Philippines,NA,Central Visayas,7396898,12,2,2236,51
2020-05-19,Philippines,NA,Central Visayas,7396898,58,6,2294,57
2020-05-20,Philippines,NA,Central Visayas,7396898,104,2,2398,59
2020-05-21,Philippines,NA,Central Visayas,7396898,66,5,2464,64
2020-05-22,Philippines,NA,Central Visayas,7396898,47,4,2511,68
2020-05-23,Philippines,NA,Central Visayas,7396898,31,3,2542,71
2020-05-24,Philippines,NA,Central Visayas,7396898,41,1,2583,72
2020-05-25,Philippines,NA,Central Visayas,7396898,40,5,2623,77
2020-05-26,Philippines,NA,Central Visayas,7396898,88,1,2711,78
2020-05-27,Philippines,NA,Central Visayas,7396898,117,6,2828,84
2020-05-28,Philippines,NA,Central Visayas,7396898,95,4,2923,88
2020-05-29,Philippines,NA,Central Visayas,7396898,125,8,3048,96
2020-05-30,Philippines,NA,Central Visayas,7396898,36,3,3084,99
2020-05-31,Philippines,NA,Central Visayas,7396898,43,4,3127,103
2020-06-01,Philippines,NA,Central Visayas,7396898,79,10,3206,113
2020-06-02,Philippines,NA,Central Visayas,7396898,88,5,3294,118
2020-06-03,Philippines,NA,Central Visayas,7396898,139,9,3433,127
2020-06-04,Philippines,NA,Central Visayas,7396898,182,8,3615,135
2020-06-05,Philippines,NA,Central Visayas,7396898,257,10,3872,145
2020-06-06,Philippines,NA,Central Visayas,7396898,76,8,3948,153
2020-06-07,Philippines,NA,Central Visayas,7396898,92,13,4040,166
2020-06-08,Philippines,NA,Central Visayas,7396898,229,11,4269,177
2020-06-09,Philippines,NA,Central Visayas,7396898,266,11,4535,188
2020-06-10,Philippines,NA,Central Visayas,7396898,226,12,4761,200
2020-06-11,Philippines,NA,Central Visayas,7396898,204,21,4965,221
2020-06-12,Philippines,NA,Central Visayas,7396898,161,5,5126,226
2020-06-13,Philippines,NA,Central Visayas,7396898,97,13,5223,239
2020-06-14,Philippines,NA,Central Visayas,7396898,76,25,5299,264
2020-06-15,Philippines,NA,Central Visayas,7396898,142,11,5441,275
2020-06-16,Philippines,NA,Central Visayas,7396898,175,18,5616,293
2020-06-17,Philippines,NA,Central Visayas,7396898,334,13,5950,306
2020-06-18,Philippines,NA,Central Visayas,7396898,176,8,6126,314
2020-06-19,Philippines,NA,Central Visayas,7396898,161,18,6287,332
2020-06-20,Philippines,NA,Central Visayas,7396898,175,15,6462,347
2020-06-21,Philippines,NA,Central Visayas,7396898,131,18,6593,365
2020-06-22,Philippines,NA,Central Visayas,7396898,217,19,6810,384
2020-06-23,Philippines,NA,Central Visayas,7396898,213,19,7023,403
2020-06-24,Philippines,NA,Central Visayas,7396898,258,19,7281,422
2020-06-25,Philippines,NA,Central Visayas,7396898,319,22,7600,444
2020-06-26,Philippines,NA,Central Visayas,7396898,357,22,7957,466
2020-06-27,Philippines,NA,Central Visayas,7396898,177,20,8134,486
2020-06-28,Philippines,NA,Central Visayas,7396898,146,18,8280,504
2020-06-29,Philippines,NA,Central Visayas,7396898,453,25,8733,529
2020-06-30,Philippines,NA,Central Visayas,7396898,409,20,9142,549
2020-07-01,Philippines,NA,Central Visayas,7396898,431,22,9573,571
2020-07-02,Philippines,NA,Central Visayas,7396898,339,18,9912,589
2020-07-03,Philippines,NA,Central Visayas,7396898,354,19,10266,608
2020-07-04,Philippines,NA,Central Visayas,7396898,304,17,10570,625
2020-07-05,Philippines,NA,Central Visayas,7396898,123,24,10693,649
2020-07-06,Philippines,NA,Central Visayas,7396898,350,16,11043,665
2020-07-07,Philippines,NA,Central Visayas,7396898,343,14,11386,679
2020-07-08,Philippines,NA,Central Visayas,7396898,261,20,11647,699
2020-07-09,Philippines,NA,Central Visayas,7396898,264,17,11911,716
2020-07-10,Philippines,NA,Central Visayas,7396898,398,17,12309,733
2020-07-11,Philippines,NA,Central Visayas,7396898,202,9,12511,742
2020-07-12,Philippines,NA,Central Visayas,7396898,125,12,12636,754
2020-07-13,Philippines,NA,Central Visayas,7396898,287,19,12923,773
2020-07-14,Philippines,NA,Central Visayas,7396898,271,14,13194,787
2020-07-15,Philippines,NA,Central Visayas,7396898,341,10,13535,797
2020-07-16,Philippines,NA,Central Visayas,7396898,164,9,13699,806
2020-07-17,Philippines,NA,Central Visayas,7396898,250,7,13949,813
2020-07-18,Philippines,NA,Central Visayas,7396898,151,7,14100,820
2020-07-19,Philippines,NA,Central Visayas,7396898,75,15,14175,835
2020-07-20,Philippines,NA,Central Visayas,7396898,298,14,14473,849
2020-07-21,Philippines,NA,Central Visayas,7396898,302,11,14775,860
2020-07-22,Philippines,NA,Central Visayas,7396898,214,13,14989,873
2020-07-23,Philippines,NA,Central Visayas,7396898,151,13,15140,886
2020-07-24,Philippines,NA,Central Visayas,7396898,219,5,15359,891
2020-07-25,Philippines,NA,Central Visayas,7396898,110,8,15469,899
2020-07-26,Philippines,NA,Central Visayas,7396898,56,5,15525,904
2020-07-27,Philippines,NA,Central Visayas,7396898,217,5,15742,909
2020-07-28,Philippines,NA,Central Visayas,7396898,243,10,15985,919
2020-07-29,Philippines,NA,Central Visayas,7396898,192,5,16177,924
2020-07-30,Philippines,NA,Central Visayas,7396898,208,10,16385,934
2020-07-31,Philippines,NA,Central Visayas,7396898,79,4,16464,938
2020-08-01,Philippines,NA,Central Visayas,7396898,104,4,16568,942
2020-08-02,Philippines,NA,Central Visayas,7396898,92,10,16660,952
2020-08-03,Philippines,NA,Central Visayas,7396898,190,3,16850,955
2020-08-04,Philippines,NA,Central Visayas,7396898,114,2,16964,957
2020-08-05,Philippines,NA,Central Visayas,7396898,154,2,17118,959
2020-08-06,Philippines,NA,Central Visayas,7396898,80,4,17198,963
2020-08-07,Philippines,NA,Central Visayas,7396898,96,4,17294,967
2020-08-08,Philippines,NA,Central Visayas,7396898,47,3,17341,970
2020-08-09,Philippines,NA,Central Visayas,7396898,27,1,17368,971
2020-08-10,Philippines,NA,Central Visayas,7396898,159,2,17527,973
2020-08-11,Philippines,NA,Central Visayas,7396898,132,0,17659,973
2020-08-12,Philippines,NA,Central Visayas,7396898,101,2,17760,975
2020-08-13,Philippines,NA,Central Visayas,7396898,67,4,17827,979
2020-08-14,Philippines,NA,Central Visayas,7396898,106,1,17933,980
2020-08-15,Philippines,NA,Central Visayas,7396898,65,2,17998,982
2020-08-16,Philippines,NA,Central Visayas,7396898,30,3,18028,985
2020-08-17,Philippines,NA,Central Visayas,7396898,108,1,18136,986
2020-08-18,Philippines,NA,Central Visayas,7396898,109,0,18245,986
2020-08-19,Philippines,NA,Central Visayas,7396898,144,2,18389,988
2020-08-20,Philippines,NA,Central Visayas,7396898,83,1,18472,989
2020-08-21,Philippines,NA,Central Visayas,7396898,36,1,18508,990
2020-08-22,Philippines,NA,Central Visayas,7396898,46,1,18554,991
2020-08-23,Philippines,NA,Central Visayas,7396898,11,0,18565,991
2020-08-24,Philippines,NA,Central Visayas,7396898,67,0,18632,991
2020-08-25,Philippines,NA,Central Visayas,7396898,1,0,18633,991
2020-03-26,Philippines,NA,Cordillera Administrative Region,1722006,1,0,11,1
2020-03-27,Philippines,NA,Cordillera Administrative Region,1722006,1,0,12,1
2020-03-28,Philippines,NA,Cordillera Administrative Region,1722006,1,0,13,1
2020-03-29,Philippines,NA,Cordillera Administrative Region,1722006,1,0,14,1
2020-03-30,Philippines,NA,Cordillera Administrative Region,1722006,1,0,15,1
2020-04-03,Philippines,NA,Cordillera Administrative Region,1722006,1,0,16,1
2020-04-04,Philippines,NA,Cordillera Administrative Region,1722006,1,0,17,1
2020-04-07,Philippines,NA,Cordillera Administrative Region,1722006,2,0,19,1
2020-04-08,Philippines,NA,Cordillera Administrative Region,1722006,3,0,22,1
2020-04-09,Philippines,NA,Cordillera Administrative Region,1722006,1,0,23,1
2020-04-12,Philippines,NA,Cordillera Administrative Region,1722006,0,0,23,1
2020-04-13,Philippines,NA,Cordillera Administrative Region,1722006,1,0,24,1
2020-04-14,Philippines,NA,Cordillera Administrative Region,1722006,1,0,25,1
2020-04-16,Philippines,NA,Cordillera Administrative Region,1722006,0,0,25,1
2020-04-20,Philippines,NA,Cordillera Administrative Region,1722006,1,0,26,1
2020-04-22,Philippines,NA,Cordillera Administrative Region,1722006,3,0,29,1
2020-04-23,Philippines,NA,Cordillera Administrative Region,1722006,1,0,30,1
2020-04-24,Philippines,NA,Cordillera Administrative Region,1722006,10,0,40,1
2020-04-25,Philippines,NA,Cordillera Administrative Region,1722006,4,0,44,1
2020-04-27,Philippines,NA,Cordillera Administrative Region,1722006,0,0,44,1
2020-05-02,Philippines,NA,Cordillera Administrative Region,1722006,0,0,44,1
2020-05-03,Philippines,NA,Cordillera Administrative Region,1722006,1,0,45,1
2020-05-04,Philippines,NA,Cordillera Administrative Region,1722006,1,0,46,1
2020-05-06,Philippines,NA,Cordillera Administrative Region,1722006,0,0,46,1
2020-05-07,Philippines,NA,Cordillera Administrative Region,1722006,0,0,46,1
2020-05-08,Philippines,NA,Cordillera Administrative Region,1722006,0,0,46,1
2020-05-09,Philippines,NA,Cordillera Administrative Region,1722006,0,0,46,1
2020-05-11,Philippines,NA,Cordillera Administrative Region,1722006,0,0,46,1
2020-05-12,Philippines,NA,Cordillera Administrative Region,1722006,0,0,46,1
2020-05-14,Philippines,NA,Cordillera Administrative Region,1722006,0,0,46,1
2020-05-15,Philippines,NA,Cordillera Administrative Region,1722006,1,0,47,1
2020-05-16,Philippines,NA,Cordillera Administrative Region,1722006,1,0,48,1
2020-05-20,Philippines,NA,Cordillera Administrative Region,1722006,0,0,48,1
2020-05-21,Philippines,NA,Cordillera Administrative Region,1722006,1,0,49,1
2020-05-28,Philippines,NA,Cordillera Administrative Region,1722006,0,0,49,1
2020-05-29,Philippines,NA,Cordillera Administrative Region,1722006,3,0,52,1
2020-06-01,Philippines,NA,Cordillera Administrative Region,1722006,2,0,54,1
2020-06-02,Philippines,NA,Cordillera Administrative Region,1722006,2,0,56,1
2020-06-04,Philippines,NA,Cordillera Administrative Region,1722006,1,0,57,1
2020-06-07,Philippines,NA,Cordillera Administrative Region,1722006,1,0,58,1
2020-06-08,Philippines,NA,Cordillera Administrative Region,1722006,14,0,72,1
2020-06-09,Philippines,NA,Cordillera Administrative Region,1722006,6,0,78,1
2020-06-10,Philippines,NA,Cordillera Administrative Region,1722006,4,0,82,1
2020-06-11,Philippines,NA,Cordillera Administrative Region,1722006,8,0,90,1
2020-06-12,Philippines,NA,Cordillera Administrative Region,1722006,1,0,91,1
2020-06-13,Philippines,NA,Cordillera Administrative Region,1722006,6,0,97,1
2020-06-15,Philippines,NA,Cordillera Administrative Region,1722006,5,0,102,1
2020-06-16,Philippines,NA,Cordillera Administrative Region,1722006,1,1,103,2
2020-06-17,Philippines,NA,Cordillera Administrative Region,1722006,1,0,104,2
2020-06-22,Philippines,NA,Cordillera Administrative Region,1722006,1,0,105,2
2020-06-23,Philippines,NA,Cordillera Administrative Region,1722006,1,0,106,2
2020-06-24,Philippines,NA,Cordillera Administrative Region,1722006,2,0,108,2
2020-06-25,Philippines,NA,Cordillera Administrative Region,1722006,0,0,108,2
2020-06-26,Philippines,NA,Cordillera Administrative Region,1722006,0,0,108,2
2020-06-27,Philippines,NA,Cordillera Administrative Region,1722006,1,0,109,2
2020-06-28,Philippines,NA,Cordillera Administrative Region,1722006,2,0,111,2
2020-06-29,Philippines,NA,Cordillera Administrative Region,1722006,2,0,113,2
2020-06-30,Philippines,NA,Cordillera Administrative Region,1722006,0,0,113,2
2020-07-01,Philippines,NA,Cordillera Administrative Region,1722006,0,0,113,2
2020-07-02,Philippines,NA,Cordillera Administrative Region,1722006,3,0,116,2
2020-07-03,Philippines,NA,Cordillera Administrative Region,1722006,1,0,117,2
2020-07-04,Philippines,NA,Cordillera Administrative Region,1722006,3,0,120,2
2020-07-05,Philippines,NA,Cordillera Administrative Region,1722006,1,0,121,2
2020-07-06,Philippines,NA,Cordillera Administrative Region,1722006,1,0,122,2
2020-07-07,Philippines,NA,Cordillera Administrative Region,1722006,1,0,123,2
2020-07-08,Philippines,NA,Cordillera Administrative Region,1722006,10,0,133,2
2020-07-09,Philippines,NA,Cordillera Administrative Region,1722006,5,0,138,2
2020-07-10,Philippines,NA,Cordillera Administrative Region,1722006,2,0,140,2
2020-07-11,Philippines,NA,Cordillera Administrative Region,1722006,3,0,143,2
2020-07-13,Philippines,NA,Cordillera Administrative Region,1722006,2,0,145,2
2020-07-14,Philippines,NA,Cordillera Administrative Region,1722006,1,0,146,2
2020-07-15,Philippines,NA,Cordillera Administrative Region,1722006,3,0,149,2
2020-07-16,Philippines,NA,Cordillera Administrative Region,1722006,3,0,152,2
2020-07-17,Philippines,NA,Cordillera Administrative Region,1722006,12,0,164,2
2020-07-18,Philippines,NA,Cordillera Administrative Region,1722006,6,0,170,2
2020-07-19,Philippines,NA,Cordillera Administrative Region,1722006,2,0,172,2
2020-07-20,Philippines,NA,Cordillera Administrative Region,1722006,10,0,182,2
2020-07-21,Philippines,NA,Cordillera Administrative Region,1722006,7,0,189,2
2020-07-22,Philippines,NA,Cordillera Administrative Region,1722006,33,0,222,2
2020-07-23,Philippines,NA,Cordillera Administrative Region,1722006,28,0,250,2
2020-07-24,Philippines,NA,Cordillera Administrative Region,1722006,14,0,264,2
2020-07-25,Philippines,NA,Cordillera Administrative Region,1722006,2,0,266,2
2020-07-27,Philippines,NA,Cordillera Administrative Region,1722006,5,0,271,2
2020-07-28,Philippines,NA,Cordillera Administrative Region,1722006,16,0,287,2
2020-07-29,Philippines,NA,Cordillera Administrative Region,1722006,27,0,314,2
2020-07-30,Philippines,NA,Cordillera Administrative Region,1722006,16,1,330,3
2020-07-31,Philippines,NA,Cordillera Administrative Region,1722006,11,1,341,4
2020-08-01,Philippines,NA,Cordillera Administrative Region,1722006,9,0,350,4
2020-08-02,Philippines,NA,Cordillera Administrative Region,1722006,3,0,353,4
2020-08-03,Philippines,NA,Cordillera Administrative Region,1722006,14,0,367,4
2020-08-04,Philippines,NA,Cordillera Administrative Region,1722006,19,0,386,4
2020-08-05,Philippines,NA,Cordillera Administrative Region,1722006,12,1,398,5
2020-08-06,Philippines,NA,Cordillera Administrative Region,1722006,23,0,421,5
2020-08-07,Philippines,NA,Cordillera Administrative Region,1722006,37,1,458,6
2020-08-08,Philippines,NA,Cordillera Administrative Region,1722006,18,1,476,7
2020-08-09,Philippines,NA,Cordillera Administrative Region,1722006,1,0,477,7
2020-08-10,Philippines,NA,Cordillera Administrative Region,1722006,21,0,498,7
2020-08-11,Philippines,NA,Cordillera Administrative Region,1722006,13,0,511,7
2020-08-12,Philippines,NA,Cordillera Administrative Region,1722006,59,0,570,7
2020-08-13,Philippines,NA,Cordillera Administrative Region,1722006,10,0,580,7
2020-08-14,Philippines,NA,Cordillera Administrative Region,1722006,14,1,594,8
2020-08-15,Philippines,NA,Cordillera Administrative Region,1722006,4,1,598,9
2020-08-16,Philippines,NA,Cordillera Administrative Region,1722006,10,0,608,9
2020-08-17,Philippines,NA,Cordillera Administrative Region,1722006,28,0,636,9
2020-08-18,Philippines,NA,Cordillera Administrative Region,1722006,11,0,647,9
2020-08-19,Philippines,NA,Cordillera Administrative Region,1722006,19,0,666,9
2020-08-20,Philippines,NA,Cordillera Administrative Region,1722006,21,0,687,9
2020-08-21,Philippines,NA,Cordillera Administrative Region,1722006,34,0,721,9
2020-08-22,Philippines,NA,Cordillera Administrative Region,1722006,21,0,742,9
2020-08-23,Philippines,NA,Cordillera Administrative Region,1722006,2,0,744,9
2020-08-24,Philippines,NA,Cordillera Administrative Region,1722006,7,0,751,9
2020-03-16,Philippines,NA,Davao Region,65463,3,0,12,0
2020-03-17,Philippines,NA,Davao Region,65463,1,0,13,0
2020-03-18,Philippines,NA,Davao Region,65463,2,0,15,0
2020-03-19,Philippines,NA,Davao Region,65463,3,0,18,0
2020-03-20,Philippines,NA,Davao Region,65463,1,1,19,1
2020-03-21,Philippines,NA,Davao Region,65463,3,0,22,1
2020-03-22,Philippines,NA,Davao Region,65463,3,0,25,1
2020-03-23,Philippines,NA,Davao Region,65463,8,2,33,3
2020-03-24,Philippines,NA,Davao Region,65463,11,0,44,3
2020-03-25,Philippines,NA,Davao Region,65463,6,0,50,3
2020-03-26,Philippines,NA,Davao Region,65463,5,1,55,4
2020-03-27,Philippines,NA,Davao Region,65463,5,0,60,4
2020-03-28,Philippines,NA,Davao Region,65463,6,0,66,4
2020-03-29,Philippines,NA,Davao Region,65463,0,1,66,5
2020-03-30,Philippines,NA,Davao Region,65463,4,1,70,6
2020-03-31,Philippines,NA,Davao Region,65463,3,2,73,8
2020-04-01,Philippines,NA,Davao Region,65463,6,1,79,9
2020-04-02,Philippines,NA,Davao Region,65463,1,0,80,9
2020-04-03,Philippines,NA,Davao Region,65463,1,0,81,9
2020-04-04,Philippines,NA,Davao Region,65463,1,1,82,10
2020-04-05,Philippines,NA,Davao Region,65463,1,0,83,10
2020-04-06,Philippines,NA,Davao Region,65463,1,0,84,10
2020-04-07,Philippines,NA,Davao Region,65463,2,1,86,11
2020-04-08,Philippines,NA,Davao Region,65463,2,0,88,11
2020-04-09,Philippines,NA,Davao Region,65463,2,0,90,11
2020-04-10,Philippines,NA,Davao Region,65463,3,2,93,13
2020-04-11,Philippines,NA,Davao Region,65463,4,0,97,13
2020-04-12,Philippines,NA,Davao Region,65463,1,0,98,13
2020-04-13,Philippines,NA,Davao Region,65463,4,0,102,13
2020-04-14,Philippines,NA,Davao Region,65463,2,1,104,14
2020-04-15,Philippines,NA,Davao Region,65463,6,0,110,14
2020-04-16,Philippines,NA,Davao Region,65463,1,0,111,14
2020-04-17,Philippines,NA,Davao Region,65463,3,0,114,14
2020-04-18,Philippines,NA,Davao Region,65463,1,0,115,14
2020-04-20,Philippines,NA,Davao Region,65463,0,0,115,14
2020-04-21,Philippines,NA,Davao Region,65463,0,0,115,14
2020-04-22,Philippines,NA,Davao Region,65463,6,1,121,15
2020-04-23,Philippines,NA,Davao Region,65463,4,0,125,15
2020-04-24,Philippines,NA,Davao Region,65463,4,0,129,15
2020-04-25,Philippines,NA,Davao Region,65463,0,0,129,15
2020-04-26,Philippines,NA,Davao Region,65463,0,1,129,16
2020-04-27,Philippines,NA,Davao Region,65463,4,1,133,17
2020-04-28,Philippines,NA,Davao Region,65463,3,1,136,18
2020-04-29,Philippines,NA,Davao Region,65463,1,0,137,18
2020-04-30,Philippines,NA,Davao Region,65463,6,0,143,18
2020-05-02,Philippines,NA,Davao Region,65463,11,0,154,18
2020-05-03,Philippines,NA,Davao Region,65463,2,0,156,18
2020-05-04,Philippines,NA,Davao Region,65463,13,1,169,19
2020-05-05,Philippines,NA,Davao Region,65463,1,0,170,19
2020-05-06,Philippines,NA,Davao Region,65463,8,0,178,19
2020-05-07,Philippines,NA,Davao Region,65463,1,0,179,19
2020-05-08,Philippines,NA,Davao Region,65463,2,0,181,19
2020-05-09,Philippines,NA,Davao Region,65463,0,1,181,20
2020-05-10,Philippines,NA,Davao Region,65463,0,0,181,20
2020-05-11,Philippines,NA,Davao Region,65463,2,1,183,21
2020-05-12,Philippines,NA,Davao Region,65463,6,0,189,21
2020-05-13,Philippines,NA,Davao Region,65463,5,1,194,22
2020-05-14,Philippines,NA,Davao Region,65463,2,1,196,23
2020-05-15,Philippines,NA,Davao Region,65463,21,0,217,23
2020-05-16,Philippines,NA,Davao Region,65463,5,0,222,23
2020-05-17,Philippines,NA,Davao Region,65463,1,0,223,23
2020-05-18,Philippines,NA,Davao Region,65463,2,0,225,23
2020-05-19,Philippines,NA,Davao Region,65463,7,0,232,23
2020-05-20,Philippines,NA,Davao Region,65463,8,0,240,23
2020-05-21,Philippines,NA,Davao Region,65463,3,0,243,23
2020-05-22,Philippines,NA,Davao Region,65463,17,0,260,23
2020-05-23,Philippines,NA,Davao Region,65463,4,0,264,23
2020-05-24,Philippines,NA,Davao Region,65463,5,0,269,23
2020-05-25,Philippines,NA,Davao Region,65463,5,0,274,23
2020-05-26,Philippines,NA,Davao Region,65463,14,3,288,26
2020-05-27,Philippines,NA,Davao Region,65463,29,0,317,26
2020-05-28,Philippines,NA,Davao Region,65463,15,1,332,27
2020-05-29,Philippines,NA,Davao Region,65463,6,1,338,28
2020-05-30,Philippines,NA,Davao Region,65463,5,0,343,28
2020-05-31,Philippines,NA,Davao Region,65463,0,0,343,28
2020-06-01,Philippines,NA,Davao Region,65463,3,0,346,28
2020-06-02,Philippines,NA,Davao Region,65463,5,0,351,28
2020-06-03,Philippines,NA,Davao Region,65463,4,0,355,28
2020-06-04,Philippines,NA,Davao Region,65463,2,0,357,28
2020-06-05,Philippines,NA,Davao Region,65463,1,1,358,29
2020-06-06,Philippines,NA,Davao Region,65463,1,0,359,29
2020-06-07,Philippines,NA,Davao Region,65463,1,0,360,29
2020-06-08,Philippines,NA,Davao Region,65463,6,0,366,29
2020-06-09,Philippines,NA,Davao Region,65463,34,0,400,29
2020-06-10,Philippines,NA,Davao Region,65463,5,0,405,29
2020-06-11,Philippines,NA,Davao Region,65463,18,0,423,29
2020-06-12,Philippines,NA,Davao Region,65463,0,0,423,29
2020-06-13,Philippines,NA,Davao Region,65463,1,0,424,29
2020-06-14,Philippines,NA,Davao Region,65463,1,0,425,29
2020-06-15,Philippines,NA,Davao Region,65463,5,0,430,29
2020-06-16,Philippines,NA,Davao Region,65463,5,0,435,29
2020-06-17,Philippines,NA,Davao Region,65463,8,0,443,29
2020-06-18,Philippines,NA,Davao Region,65463,14,0,457,29
2020-06-19,Philippines,NA,Davao Region,65463,1,0,458,29
2020-06-20,Philippines,NA,Davao Region,65463,3,0,461,29
2020-06-21,Philippines,NA,Davao Region,65463,0,0,461,29
2020-06-22,Philippines,NA,Davao Region,65463,16,0,477,29
2020-06-23,Philippines,NA,Davao Region,65463,6,0,483,29
2020-06-24,Philippines,NA,Davao Region,65463,11,0,494,29
2020-06-25,Philippines,NA,Davao Region,65463,11,0,505,29
2020-06-26,Philippines,NA,Davao Region,65463,16,0,521,29
2020-06-27,Philippines,NA,Davao Region,65463,6,0,527,29
2020-06-28,Philippines,NA,Davao Region,65463,2,2,529,31
2020-06-29,Philippines,NA,Davao Region,65463,29,0,558,31
2020-06-30,Philippines,NA,Davao Region,65463,16,0,574,31
2020-07-01,Philippines,NA,Davao Region,65463,10,0,584,31
2020-07-02,Philippines,NA,Davao Region,65463,14,0,598,31
2020-07-03,Philippines,NA,Davao Region,65463,15,0,613,31
2020-07-04,Philippines,NA,Davao Region,65463,4,0,617,31
2020-07-05,Philippines,NA,Davao Region,65463,12,0,629,31
2020-07-06,Philippines,NA,Davao Region,65463,36,0,665,31
2020-07-07,Philippines,NA,Davao Region,65463,41,0,706,31
2020-07-08,Philippines,NA,Davao Region,65463,12,0,718,31
2020-07-09,Philippines,NA,Davao Region,65463,15,0,733,31
2020-07-10,Philippines,NA,Davao Region,65463,46,1,779,32
2020-07-11,Philippines,NA,Davao Region,65463,16,1,795,33
2020-07-12,Philippines,NA,Davao Region,65463,29,3,824,36
2020-07-13,Philippines,NA,Davao Region,65463,22,2,846,38
2020-07-14,Philippines,NA,Davao Region,65463,33,1,879,39
2020-07-15,Philippines,NA,Davao Region,65463,45,2,924,41
2020-07-16,Philippines,NA,Davao Region,65463,24,0,948,41
2020-07-17,Philippines,NA,Davao Region,65463,24,0,972,41
2020-07-18,Philippines,NA,Davao Region,65463,11,0,983,41
2020-07-19,Philippines,NA,Davao Region,65463,7,0,990,41
2020-07-20,Philippines,NA,Davao Region,65463,38,0,1028,41
2020-07-21,Philippines,NA,Davao Region,65463,46,0,1074,41
2020-07-22,Philippines,NA,Davao Region,65463,39,1,1113,42
2020-07-23,Philippines,NA,Davao Region,65463,27,1,1140,43
2020-07-24,Philippines,NA,Davao Region,65463,51,0,1191,43
2020-07-25,Philippines,NA,Davao Region,65463,19,0,1210,43
2020-07-26,Philippines,NA,Davao Region,65463,5,1,1215,44
2020-07-27,Philippines,NA,Davao Region,65463,68,1,1283,45
2020-07-28,Philippines,NA,Davao Region,65463,37,0,1320,45
2020-07-29,Philippines,NA,Davao Region,65463,46,1,1366,46
2020-07-30,Philippines,NA,Davao Region,65463,38,1,1404,47
2020-07-31,Philippines,NA,Davao Region,65463,14,1,1418,48
2020-08-01,Philippines,NA,Davao Region,65463,7,0,1425,48
2020-08-02,Philippines,NA,Davao Region,65463,10,4,1435,52
2020-08-03,Philippines,NA,Davao Region,65463,36,0,1471,52
2020-08-04,Philippines,NA,Davao Region,65463,45,0,1516,52
2020-08-05,Philippines,NA,Davao Region,65463,31,0,1547,52
2020-08-06,Philippines,NA,Davao Region,65463,38,0,1585,52
2020-08-07,Philippines,NA,Davao Region,65463,67,0,1652,52
2020-08-08,Philippines,NA,Davao Region,65463,24,0,1676,52
2020-08-09,Philippines,NA,Davao Region,65463,9,0,1685,52
2020-08-10,Philippines,NA,Davao Region,65463,51,0,1736,52
2020-08-11,Philippines,NA,Davao Region,65463,35,0,1771,52
2020-08-12,Philippines,NA,Davao Region,65463,40,0,1811,52
2020-08-13,Philippines,NA,Davao Region,65463,22,1,1833,53
2020-08-14,Philippines,NA,Davao Region,65463,62,1,1895,54
2020-08-15,Philippines,NA,Davao Region,65463,8,1,1903,55
2020-08-16,Philippines,NA,Davao Region,65463,5,0,1908,55
2020-08-17,Philippines,NA,Davao Region,65463,30,0,1938,55
2020-08-18,Philippines,NA,Davao Region,65463,21,1,1959,56
2020-08-19,Philippines,NA,Davao Region,65463,28,0,1987,56
2020-08-20,Philippines,NA,Davao Region,65463,25,0,2012,56
2020-08-21,Philippines,NA,Davao Region,65463,13,0,2025,56
2020-08-22,Philippines,NA,Davao Region,65463,6,1,2031,57
2020-08-23,Philippines,NA,Davao Region,65463,5,0,2036,57
2020-08-24,Philippines,NA,Davao Region,65463,6,0,2042,57
2020-08-25,Philippines,NA,Davao Region,65463,2,0,2044,57
2020-04-21,Philippines,NA,Eastern Visayas,4440150,6,0,14,0
2020-04-27,Philippines,NA,Eastern Visayas,4440150,1,0,15,0
2020-04-28,Philippines,NA,Eastern Visayas,4440150,1,0,16,0
2020-04-29,Philippines,NA,Eastern Visayas,4440150,2,0,18,0
2020-04-30,Philippines,NA,Eastern Visayas,4440150,4,0,22,0
2020-05-04,Philippines,NA,Eastern Visayas,4440150,0,0,22,0
2020-05-10,Philippines,NA,Eastern Visayas,4440150,0,0,22,0
2020-05-11,Philippines,NA,Eastern Visayas,4440150,6,0,28,0
2020-05-12,Philippines,NA,Eastern Visayas,4440150,1,0,29,0
2020-05-15,Philippines,NA,Eastern Visayas,4440150,1,0,30,0
2020-05-16,Philippines,NA,Eastern Visayas,4440150,0,0,30,0
2020-05-17,Philippines,NA,Eastern Visayas,4440150,0,0,30,0
2020-05-19,Philippines,NA,Eastern Visayas,4440150,1,0,31,0
2020-05-21,Philippines,NA,Eastern Visayas,4440150,2,0,33,0
2020-05-25,Philippines,NA,Eastern Visayas,4440150,1,0,34,0
2020-05-26,Philippines,NA,Eastern Visayas,4440150,5,0,39,0
2020-05-28,Philippines,NA,Eastern Visayas,4440150,2,0,41,0
2020-05-29,Philippines,NA,Eastern Visayas,4440150,2,0,43,0
2020-05-30,Philippines,NA,Eastern Visayas,4440150,0,0,43,0
2020-05-31,Philippines,NA,Eastern Visayas,4440150,1,0,44,0
2020-06-02,Philippines,NA,Eastern Visayas,4440150,1,0,45,0
2020-06-03,Philippines,NA,Eastern Visayas,4440150,1,0,46,0
2020-06-04,Philippines,NA,Eastern Visayas,4440150,2,0,48,0
2020-06-05,Philippines,NA,Eastern Visayas,4440150,1,0,49,0
2020-06-07,Philippines,NA,Eastern Visayas,4440150,17,0,66,0
2020-06-08,Philippines,NA,Eastern Visayas,4440150,7,0,73,0
2020-06-09,Philippines,NA,Eastern Visayas,4440150,12,0,85,0
2020-06-10,Philippines,NA,Eastern Visayas,4440150,38,0,123,0
2020-06-11,Philippines,NA,Eastern Visayas,4440150,46,0,169,0
2020-06-12,Philippines,NA,Eastern Visayas,4440150,15,0,184,0
2020-06-13,Philippines,NA,Eastern Visayas,4440150,11,0,195,0
2020-06-14,Philippines,NA,Eastern Visayas,4440150,19,1,214,1
2020-06-15,Philippines,NA,Eastern Visayas,4440150,90,0,304,1
2020-06-16,Philippines,NA,Eastern Visayas,4440150,28,0,332,1
2020-06-17,Philippines,NA,Eastern Visayas,4440150,33,0,365,1
2020-06-18,Philippines,NA,Eastern Visayas,4440150,75,0,440,1
2020-06-19,Philippines,NA,Eastern Visayas,4440150,9,0,449,1
2020-06-20,Philippines,NA,Eastern Visayas,4440150,9,0,458,1
2020-06-22,Philippines,NA,Eastern Visayas,4440150,3,0,461,1
2020-06-23,Philippines,NA,Eastern Visayas,4440150,1,0,462,1
2020-06-24,Philippines,NA,Eastern Visayas,4440150,31,1,493,2
2020-06-25,Philippines,NA,Eastern Visayas,4440150,34,0,527,2
2020-06-26,Philippines,NA,Eastern Visayas,4440150,5,0,532,2
2020-06-27,Philippines,NA,Eastern Visayas,4440150,0,0,532,2
2020-06-28,Philippines,NA,Eastern Visayas,4440150,4,0,536,2
2020-06-29,Philippines,NA,Eastern Visayas,4440150,25,0,561,2
2020-06-30,Philippines,NA,Eastern Visayas,4440150,14,0,575,2
2020-07-01,Philippines,NA,Eastern Visayas,4440150,12,0,587,2
2020-07-02,Philippines,NA,Eastern Visayas,4440150,7,0,594,2
2020-07-03,Philippines,NA,Eastern Visayas,4440150,0,0,594,2
2020-07-04,Philippines,NA,Eastern Visayas,4440150,3,0,597,2
2020-07-05,Philippines,NA,Eastern Visayas,4440150,1,0,598,2
2020-07-06,Philippines,NA,Eastern Visayas,4440150,2,0,600,2
2020-07-07,Philippines,NA,Eastern Visayas,4440150,5,0,605,2
2020-07-08,Philippines,NA,Eastern Visayas,4440150,3,0,608,2
2020-07-09,Philippines,NA,Eastern Visayas,4440150,2,0,610,2
2020-07-10,Philippines,NA,Eastern Visayas,4440150,3,0,613,2
2020-07-11,Philippines,NA,Eastern Visayas,4440150,3,0,616,2
2020-07-12,Philippines,NA,Eastern Visayas,4440150,1,0,617,2
2020-07-13,Philippines,NA,Eastern Visayas,4440150,6,0,623,2
2020-07-14,Philippines,NA,Eastern Visayas,4440150,10,0,633,2
2020-07-15,Philippines,NA,Eastern Visayas,4440150,6,0,639,2
2020-07-16,Philippines,NA,Eastern Visayas,4440150,6,0,645,2
2020-07-17,Philippines,NA,Eastern Visayas,4440150,5,0,650,2
2020-07-18,Philippines,NA,Eastern Visayas,4440150,2,0,652,2
2020-07-19,Philippines,NA,Eastern Visayas,4440150,4,0,656,2
2020-07-20,Philippines,NA,Eastern Visayas,4440150,49,0,705,2
2020-07-21,Philippines,NA,Eastern Visayas,4440150,29,0,734,2
2020-07-22,Philippines,NA,Eastern Visayas,4440150,19,0,753,2
2020-07-23,Philippines,NA,Eastern Visayas,4440150,26,0,779,2
2020-07-24,Philippines,NA,Eastern Visayas,4440150,12,0,791,2
2020-07-25,Philippines,NA,Eastern Visayas,4440150,6,0,797,2
2020-07-26,Philippines,NA,Eastern Visayas,4440150,22,0,819,2
2020-07-27,Philippines,NA,Eastern Visayas,4440150,38,0,857,2
2020-07-28,Philippines,NA,Eastern Visayas,4440150,45,0,902,2
2020-07-29,Philippines,NA,Eastern Visayas,4440150,54,0,956,2
2020-07-30,Philippines,NA,Eastern Visayas,4440150,16,0,972,2
2020-07-31,Philippines,NA,Eastern Visayas,4440150,15,0,987,2
2020-08-01,Philippines,NA,Eastern Visayas,4440150,3,0,990,2
2020-08-02,Philippines,NA,Eastern Visayas,4440150,20,0,1010,2
2020-08-03,Philippines,NA,Eastern Visayas,4440150,73,0,1083,2
2020-08-04,Philippines,NA,Eastern Visayas,4440150,73,1,1156,3
2020-08-05,Philippines,NA,Eastern Visayas,4440150,67,0,1223,3
2020-08-06,Philippines,NA,Eastern Visayas,4440150,89,0,1312,3
2020-08-07,Philippines,NA,Eastern Visayas,4440150,31,1,1343,4
2020-08-08,Philippines,NA,Eastern Visayas,4440150,18,0,1361,4
2020-08-09,Philippines,NA,Eastern Visayas,4440150,25,0,1386,4
2020-08-10,Philippines,NA,Eastern Visayas,4440150,70,1,1456,5
2020-08-11,Philippines,NA,Eastern Visayas,4440150,54,0,1510,5
2020-08-12,Philippines,NA,Eastern Visayas,4440150,59,1,1569,6
2020-08-13,Philippines,NA,Eastern Visayas,4440150,55,0,1624,6
2020-08-14,Philippines,NA,Eastern Visayas,4440150,27,0,1651,6
2020-08-15,Philippines,NA,Eastern Visayas,4440150,20,1,1671,7
2020-08-16,Philippines,NA,Eastern Visayas,4440150,93,1,1764,8
2020-08-17,Philippines,NA,Eastern Visayas,4440150,135,0,1899,8
2020-08-18,Philippines,NA,Eastern Visayas,4440150,35,0,1934,8
2020-08-19,Philippines,NA,Eastern Visayas,4440150,129,0,2063,8
2020-08-20,Philippines,NA,Eastern Visayas,4440150,103,0,2166,8
2020-08-21,Philippines,NA,Eastern Visayas,4440150,151,0,2317,8
2020-08-22,Philippines,NA,Eastern Visayas,4440150,15,0,2332,8
2020-08-23,Philippines,NA,Eastern Visayas,4440150,42,0,2374,8
2020-08-24,Philippines,NA,Eastern Visayas,4440150,57,0,2431,8
2020-03-16,Philippines,NA,Ilocos Region,5026128,5,0,14,0
2020-03-18,Philippines,NA,Ilocos Region,5026128,1,1,15,1
2020-03-20,Philippines,NA,Ilocos Region,5026128,0,1,15,2
2020-03-21,Philippines,NA,Ilocos Region,5026128,1,0,16,2
2020-03-22,Philippines,NA,Ilocos Region,5026128,3,0,19,2
2020-03-23,Philippines,NA,Ilocos Region,5026128,1,0,20,2
2020-03-24,Philippines,NA,Ilocos Region,5026128,3,2,23,4
2020-03-25,Philippines,NA,Ilocos Region,5026128,2,0,25,4
2020-03-26,Philippines,NA,Ilocos Region,5026128,6,2,31,6
2020-03-27,Philippines,NA,Ilocos Region,5026128,7,1,38,7
2020-03-28,Philippines,NA,Ilocos Region,5026128,1,2,39,7
2020-03-29,Philippines,NA,Ilocos Region,5026128,1,0,40,8
2020-03-30,Philippines,NA,Ilocos Region,5026128,1,1,41,8
2020-03-31,Philippines,NA,Ilocos Region,5026128,3,0,44,8
2020-04-01,Philippines,NA,Ilocos Region,5026128,2,2,46,9
2020-04-04,Philippines,NA,Ilocos Region,5026128,1,0,47,9
2020-04-05,Philippines,NA,Ilocos Region,5026128,1,0,48,9
2020-04-06,Philippines,NA,Ilocos Region,5026128,2,0,50,10
2020-04-07,Philippines,NA,Ilocos Region,5026128,1,0,51,10
2020-04-08,Philippines,NA,Ilocos Region,5026128,2,0,53,10
2020-04-09,Philippines,NA,Ilocos Region,5026128,1,0,54,10
2020-04-10,Philippines,NA,Ilocos Region,5026128,0,0,54,10
2020-04-12,Philippines,NA,Ilocos Region,5026128,1,0,55,11
2020-04-13,Philippines,NA,Ilocos Region,5026128,1,0,56,11
2020-04-14,Philippines,NA,Ilocos Region,5026128,0,0,56,11
2020-04-15,Philippines,NA,Ilocos Region,5026128,0,0,56,11
2020-04-16,Philippines,NA,Ilocos Region,5026128,1,0,57,11
2020-04-18,Philippines,NA,Ilocos Region,5026128,1,0,58,11
2020-04-19,Philippines,NA,Ilocos Region,5026128,0,0,58,11
2020-04-20,Philippines,NA,Ilocos Region,5026128,6,1,64,12
2020-04-21,Philippines,NA,Ilocos Region,5026128,1,0,65,13
2020-04-22,Philippines,NA,Ilocos Region,5026128,0,0,65,13
2020-04-24,Philippines,NA,Ilocos Region,5026128,2,0,67,13
2020-04-25,Philippines,NA,Ilocos Region,5026128,2,0,69,13
2020-04-27,Philippines,NA,Ilocos Region,5026128,0,0,69,13
2020-04-28,Philippines,NA,Ilocos Region,5026128,0,0,69,13
2020-05-01,Philippines,NA,Ilocos Region,5026128,0,0,69,13
2020-05-06,Philippines,NA,Ilocos Region,5026128,1,0,70,13
2020-05-07,Philippines,NA,Ilocos Region,5026128,1,0,71,13
2020-05-09,Philippines,NA,Ilocos Region,5026128,0,0,71,13
2020-05-12,Philippines,NA,Ilocos Region,5026128,0,0,71,13
2020-05-13,Philippines,NA,Ilocos Region,5026128,2,0,73,13
2020-05-15,Philippines,NA,Ilocos Region,5026128,0,0,73,13
2020-05-17,Philippines,NA,Ilocos Region,5026128,1,0,74,13
2020-05-18,Philippines,NA,Ilocos Region,5026128,1,0,75,13
2020-05-20,Philippines,NA,Ilocos Region,5026128,0,0,75,13
2020-05-21,Philippines,NA,Ilocos Region,5026128,1,0,76,13
2020-05-27,Philippines,NA,Ilocos Region,5026128,8,0,84,13
2020-05-28,Philippines,NA,Ilocos Region,5026128,5,0,89,13
2020-05-29,Philippines,NA,Ilocos Region,5026128,0,0,89,13
2020-05-30,Philippines,NA,Ilocos Region,5026128,4,0,93,13
2020-05-31,Philippines,NA,Ilocos Region,5026128,0,0,93,13
2020-06-01,Philippines,NA,Ilocos Region,5026128,1,0,94,13
2020-06-02,Philippines,NA,Ilocos Region,5026128,5,0,99,13
2020-06-03,Philippines,NA,Ilocos Region,5026128,9,0,108,13
2020-06-04,Philippines,NA,Ilocos Region,5026128,1,0,109,13
2020-06-05,Philippines,NA,Ilocos Region,5026128,1,0,110,13
2020-06-07,Philippines,NA,Ilocos Region,5026128,1,0,111,13
2020-06-08,Philippines,NA,Ilocos Region,5026128,3,0,114,13
2020-06-09,Philippines,NA,Ilocos Region,5026128,1,0,115,13
2020-06-11,Philippines,NA,Ilocos Region,5026128,4,0,119,13
2020-06-12,Philippines,NA,Ilocos Region,5026128,0,0,119,13
2020-06-15,Philippines,NA,Ilocos Region,5026128,0,0,119,13
2020-06-16,Philippines,NA,Ilocos Region,5026128,4,0,123,13
2020-06-17,Philippines,NA,Ilocos Region,5026128,2,0,125,13
2020-06-18,Philippines,NA,Ilocos Region,5026128,2,0,127,13
2020-06-19,Philippines,NA,Ilocos Region,5026128,2,0,129,13
2020-06-20,Philippines,NA,Ilocos Region,5026128,4,0,133,13
2020-06-21,Philippines,NA,Ilocos Region,5026128,1,0,134,13
2020-06-22,Philippines,NA,Ilocos Region,5026128,7,0,141,13
2020-06-23,Philippines,NA,Ilocos Region,5026128,3,0,144,13
2020-06-24,Philippines,NA,Ilocos Region,5026128,5,0,149,13
2020-06-25,Philippines,NA,Ilocos Region,5026128,5,0,154,13
2020-06-26,Philippines,NA,Ilocos Region,5026128,3,0,157,13
2020-06-27,Philippines,NA,Ilocos Region,5026128,3,0,160,13
2020-06-29,Philippines,NA,Ilocos Region,5026128,8,1,168,14
2020-06-30,Philippines,NA,Ilocos Region,5026128,2,0,170,14
2020-07-01,Philippines,NA,Ilocos Region,5026128,4,0,174,14
2020-07-02,Philippines,NA,Ilocos Region,5026128,10,0,184,14
2020-07-03,Philippines,NA,Ilocos Region,5026128,3,0,187,14
2020-07-04,Philippines,NA,Ilocos Region,5026128,4,0,191,14
2020-07-05,Philippines,NA,Ilocos Region,5026128,0,0,191,14
2020-07-07,Philippines,NA,Ilocos Region,5026128,6,0,197,14
2020-07-08,Philippines,NA,Ilocos Region,5026128,4,0,201,14
2020-07-09,Philippines,NA,Ilocos Region,5026128,6,0,207,14
2020-07-10,Philippines,NA,Ilocos Region,5026128,1,0,208,14
2020-07-11,Philippines,NA,Ilocos Region,5026128,6,0,214,14
2020-07-12,Philippines,NA,Ilocos Region,5026128,6,1,220,15
2020-07-13,Philippines,NA,Ilocos Region,5026128,1,0,221,15
2020-07-14,Philippines,NA,Ilocos Region,5026128,34,0,255,15
2020-07-15,Philippines,NA,Ilocos Region,5026128,6,0,261,15
2020-07-16,Philippines,NA,Ilocos Region,5026128,16,0,277,15
2020-07-17,Philippines,NA,Ilocos Region,5026128,23,0,300,15
2020-07-18,Philippines,NA,Ilocos Region,5026128,25,1,325,16
2020-07-19,Philippines,NA,Ilocos Region,5026128,4,1,329,17
2020-07-20,Philippines,NA,Ilocos Region,5026128,13,0,342,17
2020-07-21,Philippines,NA,Ilocos Region,5026128,19,1,361,18
2020-07-22,Philippines,NA,Ilocos Region,5026128,39,0,400,18
2020-07-23,Philippines,NA,Ilocos Region,5026128,17,0,417,18
2020-07-24,Philippines,NA,Ilocos Region,5026128,20,0,437,18
2020-07-25,Philippines,NA,Ilocos Region,5026128,21,0,458,18
2020-07-26,Philippines,NA,Ilocos Region,5026128,9,0,467,18
2020-07-27,Philippines,NA,Ilocos Region,5026128,36,1,503,19
2020-07-28,Philippines,NA,Ilocos Region,5026128,27,0,530,19
2020-07-29,Philippines,NA,Ilocos Region,5026128,21,0,551,19
2020-07-30,Philippines,NA,Ilocos Region,5026128,20,1,571,20
2020-07-31,Philippines,NA,Ilocos Region,5026128,9,1,580,21
2020-08-01,Philippines,NA,Ilocos Region,5026128,16,0,596,21
2020-08-02,Philippines,NA,Ilocos Region,5026128,19,0,615,21
2020-08-03,Philippines,NA,Ilocos Region,5026128,33,0,648,21
2020-08-04,Philippines,NA,Ilocos Region,5026128,22,0,670,21
2020-08-05,Philippines,NA,Ilocos Region,5026128,33,0,703,21
2020-08-06,Philippines,NA,Ilocos Region,5026128,22,1,725,22
2020-08-07,Philippines,NA,Ilocos Region,5026128,26,0,751,22
2020-08-08,Philippines,NA,Ilocos Region,5026128,3,0,754,22
2020-08-09,Philippines,NA,Ilocos Region,5026128,42,0,796,22
2020-08-10,Philippines,NA,Ilocos Region,5026128,37,0,833,22
2020-08-11,Philippines,NA,Ilocos Region,5026128,16,0,849,22
2020-08-12,Philippines,NA,Ilocos Region,5026128,26,1,875,23
2020-08-13,Philippines,NA,Ilocos Region,5026128,19,0,894,23
2020-08-14,Philippines,NA,Ilocos Region,5026128,24,0,918,23
2020-08-15,Philippines,NA,Ilocos Region,5026128,5,0,923,23
2020-08-16,Philippines,NA,Ilocos Region,5026128,6,1,929,24
2020-08-17,Philippines,NA,Ilocos Region,5026128,26,1,955,25
2020-08-18,Philippines,NA,Ilocos Region,5026128,16,0,971,25
2020-08-19,Philippines,NA,Ilocos Region,5026128,21,1,992,26
2020-08-20,Philippines,NA,Ilocos Region,5026128,16,0,1008,26
2020-08-21,Philippines,NA,Ilocos Region,5026128,20,0,1028,26
2020-08-22,Philippines,NA,Ilocos Region,5026128,6,0,1034,26
2020-08-23,Philippines,NA,Ilocos Region,5026128,7,0,1041,26
2020-08-24,Philippines,NA,Ilocos Region,5026128,6,0,1047,26
2020-03-05,Philippines,NA,Metro Manila,12877253,6,0,12,0
2020-03-06,Philippines,NA,Metro Manila,12877253,23,0,35,0
2020-03-07,Philippines,NA,Metro Manila,12877253,108,0,143,0
2020-03-08,Philippines,NA,Metro Manila,12877253,362,0,505,0
2020-03-09,Philippines,NA,Metro Manila,12877253,20,0,525,0
2020-03-10,Philippines,NA,Metro Manila,12877253,40,0,565,0
2020-03-11,Philippines,NA,Metro Manila,12877253,80,2,645,2
2020-03-12,Philippines,NA,Metro Manila,12877253,136,4,781,6
2020-03-13,Philippines,NA,Metro Manila,12877253,120,4,901,10
2020-03-14,Philippines,NA,Metro Manila,12877253,192,2,1093,12
2020-03-15,Philippines,NA,Metro Manila,12877253,204,6,1297,18
2020-03-16,Philippines,NA,Metro Manila,12877253,184,8,1481,26
2020-03-17,Philippines,NA,Metro Manila,12877253,204,14,1685,40
2020-03-18,Philippines,NA,Metro Manila,12877253,218,20,1903,60
2020-03-19,Philippines,NA,Metro Manila,12877253,203,22,2106,82
2020-03-20,Philippines,NA,Metro Manila,12877253,207,16,2313,98
2020-03-21,Philippines,NA,Metro Manila,12877253,236,22,2549,120
2020-03-22,Philippines,NA,Metro Manila,12877253,190,46,2739,166
2020-03-23,Philippines,NA,Metro Manila,12877253,296,52,3035,218
2020-03-24,Philippines,NA,Metro Manila,12877253,266,32,3301,250
2020-03-25,Philippines,NA,Metro Manila,12877253,296,26,3597,276
2020-03-26,Philippines,NA,Metro Manila,12877253,240,56,3837,332
2020-03-27,Philippines,NA,Metro Manila,12877253,314,62,4151,394
2020-03-28,Philippines,NA,Metro Manila,12877253,287,52,4438,446
2020-03-29,Philippines,NA,Metro Manila,12877253,238,42,4676,488
2020-03-30,Philippines,NA,Metro Manila,12877253,247,60,4923,548
2020-03-31,Philippines,NA,Metro Manila,12877253,329,40,5252,588
2020-04-01,Philippines,NA,Metro Manila,12877253,337,49,5589,637
2020-04-02,Philippines,NA,Metro Manila,12877253,425,41,6014,678
2020-04-03,Philippines,NA,Metro Manila,12877253,221,28,6235,706
2020-04-04,Philippines,NA,Metro Manila,12877253,272,36,6507,742
2020-04-05,Philippines,NA,Metro Manila,12877253,207,30,6714,772
2020-04-06,Philippines,NA,Metro Manila,12877253,359,37,7073,809
2020-04-07,Philippines,NA,Metro Manila,12877253,413,24,7486,833
2020-04-08,Philippines,NA,Metro Manila,12877253,483,32,7969,865
2020-04-09,Philippines,NA,Metro Manila,12877253,443,18,8412,883
2020-04-10,Philippines,NA,Metro Manila,12877253,392,25,8804,908
2020-04-11,Philippines,NA,Metro Manila,12877253,392,40,9196,948
2020-04-12,Philippines,NA,Metro Manila,12877253,300,30,9496,978
2020-04-13,Philippines,NA,Metro Manila,12877253,287,45,9783,1023
2020-04-14,Philippines,NA,Metro Manila,12877253,249,22,10032,1045
2020-04-15,Philippines,NA,Metro Manila,12877253,280,32,10312,1077
2020-04-16,Philippines,NA,Metro Manila,12877253,296,8,10608,1085
2020-04-17,Philippines,NA,Metro Manila,12877253,268,14,10876,1099
2020-04-18,Philippines,NA,Metro Manila,12877253,189,26,11065,1125
2020-04-19,Philippines,NA,Metro Manila,12877253,106,16,11171,1141
2020-04-20,Philippines,NA,Metro Manila,12877253,261,24,11432,1165
2020-04-21,Philippines,NA,Metro Manila,12877253,243,20,11675,1185
2020-04-22,Philippines,NA,Metro Manila,12877253,259,18,11934,1203
2020-04-23,Philippines,NA,Metro Manila,12877253,190,32,12124,1235
2020-04-24,Philippines,NA,Metro Manila,12877253,236,14,12360,1249
2020-04-25,Philippines,NA,Metro Manila,12877253,267,12,12627,1261
2020-04-26,Philippines,NA,Metro Manila,12877253,168,9,12795,1270
2020-04-27,Philippines,NA,Metro Manila,12877253,260,27,13055,1297
2020-04-28,Philippines,NA,Metro Manila,12877253,287,2,13342,1299
2020-04-29,Philippines,NA,Metro Manila,12877253,295,10,13637,1309
2020-04-30,Philippines,NA,Metro Manila,12877253,303,14,13940,1323
2020-05-01,Philippines,NA,Metro Manila,12877253,218,6,14158,1329
2020-05-02,Philippines,NA,Metro Manila,12877253,123,20,14281,1349
2020-05-03,Philippines,NA,Metro Manila,12877253,119,8,14400,1357
2020-05-04,Philippines,NA,Metro Manila,12877253,296,11,14696,1368
2020-05-05,Philippines,NA,Metro Manila,12877253,354,12,15050,1380
2020-05-06,Philippines,NA,Metro Manila,12877253,348,18,15398,1398
2020-05-07,Philippines,NA,Metro Manila,12877253,274,10,15672,1408
2020-05-08,Philippines,NA,Metro Manila,12877253,534,16,16206,1424
2020-05-09,Philippines,NA,Metro Manila,12877253,164,17,16370,1441
2020-05-10,Philippines,NA,Metro Manila,12877253,168,8,16538,1449
2020-05-11,Philippines,NA,Metro Manila,12877253,348,21,16886,1470
2020-05-12,Philippines,NA,Metro Manila,12877253,323,8,17209,1478
2020-05-13,Philippines,NA,Metro Manila,12877253,248,9,17457,1487
2020-05-14,Philippines,NA,Metro Manila,12877253,399,18,17856,1505
2020-05-15,Philippines,NA,Metro Manila,12877253,371,12,18227,1517
2020-05-16,Philippines,NA,Metro Manila,12877253,211,12,18438,1529
2020-05-17,Philippines,NA,Metro Manila,12877253,163,4,18601,1533
2020-05-18,Philippines,NA,Metro Manila,12877253,438,2,19039,1535
2020-05-19,Philippines,NA,Metro Manila,12877253,503,17,19542,1552
2020-05-20,Philippines,NA,Metro Manila,12877253,479,8,20021,1560
2020-05-21,Philippines,NA,Metro Manila,12877253,431,6,20452,1566
2020-05-22,Philippines,NA,Metro Manila,12877253,469,22,20921,1588
2020-05-23,Philippines,NA,Metro Manila,12877253,286,10,21207,1598
2020-05-24,Philippines,NA,Metro Manila,12877253,119,4,21326,1602
2020-05-25,Philippines,NA,Metro Manila,12877253,234,8,21560,1610
2020-05-26,Philippines,NA,Metro Manila,12877253,404,8,21964,1618
2020-05-27,Philippines,NA,Metro Manila,12877253,469,4,22433,1622
2020-05-28,Philippines,NA,Metro Manila,12877253,462,6,22895,1628
2020-05-29,Philippines,NA,Metro Manila,12877253,330,8,23225,1636
2020-05-30,Philippines,NA,Metro Manila,12877253,209,4,23434,1640
2020-05-31,Philippines,NA,Metro Manila,12877253,126,2,23560,1642
2020-06-01,Philippines,NA,Metro Manila,12877253,397,6,23957,1648
2020-06-02,Philippines,NA,Metro Manila,12877253,410,9,24367,1657
2020-06-03,Philippines,NA,Metro Manila,12877253,471,6,24838,1663
2020-06-04,Philippines,NA,Metro Manila,12877253,482,6,25320,1669
2020-06-05,Philippines,NA,Metro Manila,12877253,374,12,25694,1681
2020-06-06,Philippines,NA,Metro Manila,12877253,216,4,25910,1685
2020-06-07,Philippines,NA,Metro Manila,12877253,160,6,26070,1691
2020-06-08,Philippines,NA,Metro Manila,12877253,764,12,26834,1703
2020-06-09,Philippines,NA,Metro Manila,12877253,511,8,27345,1711
2020-06-10,Philippines,NA,Metro Manila,12877253,473,15,27818,1726
2020-06-11,Philippines,NA,Metro Manila,12877253,672,4,28490,1730
2020-06-12,Philippines,NA,Metro Manila,12877253,280,6,28770,1736
2020-06-13,Philippines,NA,Metro Manila,12877253,278,14,29048,1750
2020-06-14,Philippines,NA,Metro Manila,12877253,270,15,29318,1765
2020-06-15,Philippines,NA,Metro Manila,12877253,734,8,30052,1773
2020-06-16,Philippines,NA,Metro Manila,12877253,569,12,30621,1785
2020-06-17,Philippines,NA,Metro Manila,12877253,636,18,31257,1803
2020-06-18,Philippines,NA,Metro Manila,12877253,722,6,31979,1809
2020-06-19,Philippines,NA,Metro Manila,12877253,771,4,32750,1813
2020-06-20,Philippines,NA,Metro Manila,12877253,727,12,33477,1825
2020-06-21,Philippines,NA,Metro Manila,12877253,318,10,33795,1835
2020-06-22,Philippines,NA,Metro Manila,12877253,946,16,34741,1851
2020-06-23,Philippines,NA,Metro Manila,12877253,928,14,35669,1865
2020-06-24,Philippines,NA,Metro Manila,12877253,1056,9,36725,1874
2020-06-25,Philippines,NA,Metro Manila,12877253,1462,10,38187,1884
2020-06-26,Philippines,NA,Metro Manila,12877253,966,7,39153,1891
2020-06-27,Philippines,NA,Metro Manila,12877253,727,12,39880,1903
2020-06-28,Philippines,NA,Metro Manila,12877253,543,7,40423,1910
2020-06-29,Philippines,NA,Metro Manila,12877253,1890,8,42313,1918
2020-06-30,Philippines,NA,Metro Manila,12877253,1960,15,44273,1933
2020-07-01,Philippines,NA,Metro Manila,12877253,1960,13,46233,1946
2020-07-02,Philippines,NA,Metro Manila,12877253,1845,11,48078,1957
2020-07-03,Philippines,NA,Metro Manila,12877253,1931,12,50009,1969
2020-07-04,Philippines,NA,Metro Manila,12877253,1190,14,51199,1983
2020-07-05,Philippines,NA,Metro Manila,12877253,933,10,52132,1993
2020-07-06,Philippines,NA,Metro Manila,12877253,2321,6,54453,1999
2020-07-07,Philippines,NA,Metro Manila,12877253,2336,14,56789,2013
2020-07-08,Philippines,NA,Metro Manila,12877253,2346,6,59135,2019
2020-07-09,Philippines,NA,Metro Manila,12877253,3192,2,62327,2021
2020-07-10,Philippines,NA,Metro Manila,12877253,2473,8,64800,2029
2020-07-11,Philippines,NA,Metro Manila,12877253,2016,12,66816,2041
2020-07-12,Philippines,NA,Metro Manila,12877253,1265,14,68081,2055
2020-07-13,Philippines,NA,Metro Manila,12877253,2745,12,70826,2067
2020-07-14,Philippines,NA,Metro Manila,12877253,2520,16,73346,2083
2020-07-15,Philippines,NA,Metro Manila,12877253,3351,12,76697,2095
2020-07-16,Philippines,NA,Metro Manila,12877253,3557,20,80254,2115
2020-07-17,Philippines,NA,Metro Manila,12877253,4003,25,84257,2140
2020-07-18,Philippines,NA,Metro Manila,12877253,2328,39,86585,2179
2020-07-19,Philippines,NA,Metro Manila,12877253,1208,12,87793,2191
2020-07-20,Philippines,NA,Metro Manila,12877253,3473,8,91266,2199
2020-07-21,Philippines,NA,Metro Manila,12877253,4032,15,95298,2214
2020-07-22,Philippines,NA,Metro Manila,12877253,4391,29,99689,2243
2020-07-23,Philippines,NA,Metro Manila,12877253,4273,25,103962,2268
2020-07-24,Philippines,NA,Metro Manila,12877253,4336,33,108298,2301
2020-07-25,Philippines,NA,Metro Manila,12877253,2489,15,110787,2316
2020-07-26,Philippines,NA,Metro Manila,12877253,1478,14,112265,2330
2020-07-27,Philippines,NA,Metro Manila,12877253,5041,31,117306,2361
2020-07-28,Philippines,NA,Metro Manila,12877253,4189,34,121495,2395
2020-07-29,Philippines,NA,Metro Manila,12877253,3763,28,125258,2423
2020-07-30,Philippines,NA,Metro Manila,12877253,4023,29,129281,2452
2020-07-31,Philippines,NA,Metro Manila,12877253,3063,22,132344,2474
2020-08-01,Philippines,NA,Metro Manila,12877253,1924,34,134268,2508
2020-08-02,Philippines,NA,Metro Manila,12877253,1270,28,135538,2536
2020-08-03,Philippines,NA,Metro Manila,12877253,4251,22,139789,2558
2020-08-04,Philippines,NA,Metro Manila,12877253,4617,32,144406,2590
2020-08-05,Philippines,NA,Metro Manila,12877253,4016,34,148422,2624
2020-08-06,Philippines,NA,Metro Manila,12877253,4855,44,153277,2668
2020-08-07,Philippines,NA,Metro Manila,12877253,4693,34,157970,2702
2020-08-08,Philippines,NA,Metro Manila,12877253,2750,16,160720,2718
2020-08-09,Philippines,NA,Metro Manila,12877253,1660,30,162380,2748
2020-08-10,Philippines,NA,Metro Manila,12877253,4946,26,167326,2774
2020-08-11,Philippines,NA,Metro Manila,12877253,5161,46,172487,2820
2020-08-12,Philippines,NA,Metro Manila,12877253,4864,36,177351,2856
2020-08-13,Philippines,NA,Metro Manila,12877253,4060,32,181411,2888
2020-08-14,Philippines,NA,Metro Manila,12877253,4093,24,185504,2912
2020-08-15,Philippines,NA,Metro Manila,12877253,1910,24,187414,2936
2020-08-16,Philippines,NA,Metro Manila,12877253,1188,24,188602,2960
2020-08-17,Philippines,NA,Metro Manila,12877253,4475,18,193077,2978
2020-08-18,Philippines,NA,Metro Manila,12877253,4010,14,197087,2992
2020-08-19,Philippines,NA,Metro Manila,12877253,3760,14,200847,3006
2020-08-20,Philippines,NA,Metro Manila,12877253,3442,14,204289,3020
2020-08-21,Philippines,NA,Metro Manila,12877253,2652,2,206941,3022
2020-08-22,Philippines,NA,Metro Manila,12877253,1442,6,208383,3028
2020-08-23,Philippines,NA,Metro Manila,12877253,448,0,208831,3028
2020-08-24,Philippines,NA,Metro Manila,12877253,314,8,209145,3036
2020-08-25,Philippines,NA,Metro Manila,12877253,30,0,209175,3036
2020-03-24,Philippines,NA,Mimaropa,2963360,3,0,12,1
2020-04-02,Philippines,NA,Mimaropa,2963360,1,0,13,1
2020-04-05,Philippines,NA,Mimaropa,2963360,1,0,14,1
2020-04-06,Philippines,NA,Mimaropa,2963360,2,0,16,1
2020-04-07,Philippines,NA,Mimaropa,2963360,1,1,17,2
2020-04-08,Philippines,NA,Mimaropa,2963360,2,0,19,2
2020-04-09,Philippines,NA,Mimaropa,2963360,1,0,20,2
2020-04-10,Philippines,NA,Mimaropa,2963360,1,0,21,2
2020-04-11,Philippines,NA,Mimaropa,2963360,0,0,21,2
2020-04-12,Philippines,NA,Mimaropa,2963360,0,0,21,2
2020-04-13,Philippines,NA,Mimaropa,2963360,1,0,22,2
2020-04-14,Philippines,NA,Mimaropa,2963360,3,0,25,2
2020-04-15,Philippines,NA,Mimaropa,2963360,1,0,26,2
2020-04-16,Philippines,NA,Mimaropa,2963360,1,0,27,2
2020-04-18,Philippines,NA,Mimaropa,2963360,1,0,28,2
2020-04-19,Philippines,NA,Mimaropa,2963360,1,0,29,2
2020-04-20,Philippines,NA,Mimaropa,2963360,1,0,30,2
2020-04-21,Philippines,NA,Mimaropa,2963360,0,1,30,3
2020-04-23,Philippines,NA,Mimaropa,2963360,0,0,30,3
2020-04-24,Philippines,NA,Mimaropa,2963360,1,0,31,3
2020-04-26,Philippines,NA,Mimaropa,2963360,0,0,31,3
2020-04-29,Philippines,NA,Mimaropa,2963360,1,0,32,3
2020-04-30,Philippines,NA,Mimaropa,2963360,4,0,36,3
2020-05-02,Philippines,NA,Mimaropa,2963360,1,0,37,3
2020-05-04,Philippines,NA,Mimaropa,2963360,0,0,37,3
2020-05-05,Philippines,NA,Mimaropa,2963360,2,0,39,3
2020-05-06,Philippines,NA,Mimaropa,2963360,0,1,39,4
2020-05-07,Philippines,NA,Mimaropa,2963360,0,0,39,4
2020-05-10,Philippines,NA,Mimaropa,2963360,1,0,40,4
2020-05-11,Philippines,NA,Mimaropa,2963360,0,0,40,4
2020-05-12,Philippines,NA,Mimaropa,2963360,1,0,41,4
2020-05-13,Philippines,NA,Mimaropa,2963360,0,0,41,4
2020-05-14,Philippines,NA,Mimaropa,2963360,1,0,42,4
2020-05-15,Philippines,NA,Mimaropa,2963360,1,0,43,4
2020-05-16,Philippines,NA,Mimaropa,2963360,1,0,44,4
2020-05-19,Philippines,NA,Mimaropa,2963360,2,0,46,4
2020-05-20,Philippines,NA,Mimaropa,2963360,1,0,47,4
2020-05-21,Philippines,NA,Mimaropa,2963360,3,0,50,4
2020-05-24,Philippines,NA,Mimaropa,2963360,14,0,64,4
2020-05-25,Philippines,NA,Mimaropa,2963360,6,0,70,4
2020-05-27,Philippines,NA,Mimaropa,2963360,2,0,72,4
2020-05-28,Philippines,NA,Mimaropa,2963360,3,0,75,4
2020-05-29,Philippines,NA,Mimaropa,2963360,1,0,76,4
2020-06-01,Philippines,NA,Mimaropa,2963360,2,0,78,4
2020-06-04,Philippines,NA,Mimaropa,2963360,1,0,79,4
2020-06-06,Philippines,NA,Mimaropa,2963360,2,0,81,4
2020-06-07,Philippines,NA,Mimaropa,2963360,1,0,82,4
2020-06-08,Philippines,NA,Mimaropa,2963360,0,0,82,4
2020-06-09,Philippines,NA,Mimaropa,2963360,1,0,83,4
2020-06-12,Philippines,NA,Mimaropa,2963360,0,0,83,4
2020-06-13,Philippines,NA,Mimaropa,2963360,0,0,83,4
2020-06-14,Philippines,NA,Mimaropa,2963360,2,0,85,4
2020-06-15,Philippines,NA,Mimaropa,2963360,4,0,89,4
2020-06-16,Philippines,NA,Mimaropa,2963360,2,0,91,4
2020-06-17,Philippines,NA,Mimaropa,2963360,6,0,97,4
2020-06-18,Philippines,NA,Mimaropa,2963360,1,0,98,4
2020-06-19,Philippines,NA,Mimaropa,2963360,1,0,99,4
2020-06-20,Philippines,NA,Mimaropa,2963360,3,1,102,5
2020-06-22,Philippines,NA,Mimaropa,2963360,6,0,108,5
2020-06-23,Philippines,NA,Mimaropa,2963360,8,0,116,5
2020-06-24,Philippines,NA,Mimaropa,2963360,2,0,118,5
2020-06-25,Philippines,NA,Mimaropa,2963360,2,0,120,5
2020-06-26,Philippines,NA,Mimaropa,2963360,3,0,123,5
2020-06-27,Philippines,NA,Mimaropa,2963360,2,0,125,5
2020-06-28,Philippines,NA,Mimaropa,2963360,2,0,127,5
2020-06-29,Philippines,NA,Mimaropa,2963360,8,0,135,5
2020-06-30,Philippines,NA,Mimaropa,2963360,3,0,138,5
2020-07-01,Philippines,NA,Mimaropa,2963360,3,0,141,5
2020-07-02,Philippines,NA,Mimaropa,2963360,4,0,145,5
2020-07-03,Philippines,NA,Mimaropa,2963360,3,0,148,5
2020-07-04,Philippines,NA,Mimaropa,2963360,4,0,152,5
2020-07-05,Philippines,NA,Mimaropa,2963360,2,0,154,5
2020-07-06,Philippines,NA,Mimaropa,2963360,4,0,158,5
2020-07-07,Philippines,NA,Mimaropa,2963360,3,0,161,5
2020-07-08,Philippines,NA,Mimaropa,2963360,7,0,168,5
2020-07-09,Philippines,NA,Mimaropa,2963360,3,0,171,5
2020-07-10,Philippines,NA,Mimaropa,2963360,2,0,173,5
2020-07-12,Philippines,NA,Mimaropa,2963360,5,0,178,5
2020-07-13,Philippines,NA,Mimaropa,2963360,4,0,182,5
2020-07-14,Philippines,NA,Mimaropa,2963360,8,0,190,5
2020-07-15,Philippines,NA,Mimaropa,2963360,4,0,194,5
2020-07-16,Philippines,NA,Mimaropa,2963360,6,0,200,5
2020-07-17,Philippines,NA,Mimaropa,2963360,20,0,220,5
2020-07-18,Philippines,NA,Mimaropa,2963360,8,0,228,5
2020-07-19,Philippines,NA,Mimaropa,2963360,0,0,228,5
2020-07-20,Philippines,NA,Mimaropa,2963360,5,1,233,6
2020-07-21,Philippines,NA,Mimaropa,2963360,5,0,238,6
2020-07-22,Philippines,NA,Mimaropa,2963360,19,0,257,6
2020-07-23,Philippines,NA,Mimaropa,2963360,6,0,263,6
2020-07-24,Philippines,NA,Mimaropa,2963360,7,0,270,6
2020-07-25,Philippines,NA,Mimaropa,2963360,2,0,272,6
2020-07-26,Philippines,NA,Mimaropa,2963360,8,0,280,6
2020-07-27,Philippines,NA,Mimaropa,2963360,12,0,292,6
2020-07-28,Philippines,NA,Mimaropa,2963360,20,0,312,6
2020-07-29,Philippines,NA,Mimaropa,2963360,9,0,321,6
2020-07-30,Philippines,NA,Mimaropa,2963360,15,0,336,6
2020-07-31,Philippines,NA,Mimaropa,2963360,2,0,338,6
2020-08-01,Philippines,NA,Mimaropa,2963360,17,0,355,6
2020-08-02,Philippines,NA,Mimaropa,2963360,4,0,359,6
2020-08-03,Philippines,NA,Mimaropa,2963360,26,0,385,6
2020-08-04,Philippines,NA,Mimaropa,2963360,12,0,397,6
2020-08-05,Philippines,NA,Mimaropa,2963360,25,0,422,6
2020-08-06,Philippines,NA,Mimaropa,2963360,18,0,440,6
2020-08-07,Philippines,NA,Mimaropa,2963360,15,0,455,6
2020-08-08,Philippines,NA,Mimaropa,2963360,6,0,461,6
2020-08-09,Philippines,NA,Mimaropa,2963360,43,0,504,6
2020-08-10,Philippines,NA,Mimaropa,2963360,14,0,518,6
2020-08-11,Philippines,NA,Mimaropa,2963360,14,0,532,6
2020-08-12,Philippines,NA,Mimaropa,2963360,10,0,542,6
2020-08-13,Philippines,NA,Mimaropa,2963360,11,0,553,6
2020-08-14,Philippines,NA,Mimaropa,2963360,8,0,561,6
2020-08-15,Philippines,NA,Mimaropa,2963360,17,0,578,6
2020-08-16,Philippines,NA,Mimaropa,2963360,3,0,581,6
2020-08-17,Philippines,NA,Mimaropa,2963360,20,0,601,6
2020-08-18,Philippines,NA,Mimaropa,2963360,22,1,623,7
2020-08-19,Philippines,NA,Mimaropa,2963360,21,0,644,7
2020-08-20,Philippines,NA,Mimaropa,2963360,4,0,648,7
2020-08-21,Philippines,NA,Mimaropa,2963360,5,0,653,7
2020-08-22,Philippines,NA,Mimaropa,2963360,3,0,656,7
2020-08-23,Philippines,NA,Mimaropa,2963360,1,0,657,7
2020-04-28,Philippines,NA,Northern Mindanao,4689302,1,0,11,2
2020-04-29,Philippines,NA,Northern Mindanao,4689302,1,0,12,2
2020-04-30,Philippines,NA,Northern Mindanao,4689302,2,0,14,2
2020-05-01,Philippines,NA,Northern Mindanao,4689302,1,0,15,3
2020-05-03,Philippines,NA,Northern Mindanao,4689302,1,0,16,3
2020-05-05,Philippines,NA,Northern Mindanao,4689302,0,1,16,3
2020-05-06,Philippines,NA,Northern Mindanao,4689302,0,1,16,3
2020-05-08,Philippines,NA,Northern Mindanao,4689302,1,0,17,3
2020-05-09,Philippines,NA,Northern Mindanao,4689302,0,0,17,3
2020-05-15,Philippines,NA,Northern Mindanao,4689302,2,1,19,3
2020-05-18,Philippines,NA,Northern Mindanao,4689302,0,0,19,3
2020-05-21,Philippines,NA,Northern Mindanao,4689302,2,0,21,4
2020-05-23,Philippines,NA,Northern Mindanao,4689302,1,0,22,4
2020-05-24,Philippines,NA,Northern Mindanao,4689302,1,0,23,4
2020-05-25,Philippines,NA,Northern Mindanao,4689302,3,0,26,5
2020-05-29,Philippines,NA,Northern Mindanao,4689302,1,0,27,5
2020-05-30,Philippines,NA,Northern Mindanao,4689302,1,0,28,5
2020-06-01,Philippines,NA,Northern Mindanao,4689302,1,0,29,5
2020-06-03,Philippines,NA,Northern Mindanao,4689302,1,0,30,6
2020-06-04,Philippines,NA,Northern Mindanao,4689302,3,0,33,6
2020-06-05,Philippines,NA,Northern Mindanao,4689302,3,0,36,7
2020-06-07,Philippines,NA,Northern Mindanao,4689302,1,1,37,7
2020-06-08,Philippines,NA,Northern Mindanao,4689302,2,0,39,7
2020-06-09,Philippines,NA,Northern Mindanao,4689302,5,0,44,8
2020-06-10,Philippines,NA,Northern Mindanao,4689302,2,0,46,9
2020-06-11,Philippines,NA,Northern Mindanao,4689302,3,0,49,9
2020-06-12,Philippines,NA,Northern Mindanao,4689302,6,0,55,10
2020-06-13,Philippines,NA,Northern Mindanao,4689302,5,0,60,10
2020-06-14,Philippines,NA,Northern Mindanao,4689302,4,0,64,10
2020-06-15,Philippines,NA,Northern Mindanao,4689302,4,0,68,10
2020-06-16,Philippines,NA,Northern Mindanao,4689302,3,0,71,10
2020-06-17,Philippines,NA,Northern Mindanao,4689302,6,0,77,10
2020-06-18,Philippines,NA,Northern Mindanao,4689302,1,0,78,10
2020-06-19,Philippines,NA,Northern Mindanao,4689302,6,0,84,10
2020-06-20,Philippines,NA,Northern Mindanao,4689302,7,0,91,10
2020-06-21,Philippines,NA,Northern Mindanao,4689302,13,0,104,10
2020-06-22,Philippines,NA,Northern Mindanao,4689302,3,0,107,10
2020-06-23,Philippines,NA,Northern Mindanao,4689302,9,0,116,10
2020-06-24,Philippines,NA,Northern Mindanao,4689302,13,0,129,10
2020-06-25,Philippines,NA,Northern Mindanao,4689302,9,0,138,10
2020-06-26,Philippines,NA,Northern Mindanao,4689302,12,0,150,10
2020-06-27,Philippines,NA,Northern Mindanao,4689302,5,0,155,10
2020-06-28,Philippines,NA,Northern Mindanao,4689302,16,0,171,10
2020-06-29,Philippines,NA,Northern Mindanao,4689302,14,0,185,10
2020-06-30,Philippines,NA,Northern Mindanao,4689302,32,0,217,10
2020-07-01,Philippines,NA,Northern Mindanao,4689302,16,0,233,10
2020-07-02,Philippines,NA,Northern Mindanao,4689302,25,0,258,10
2020-07-03,Philippines,NA,Northern Mindanao,4689302,16,0,274,10
2020-07-04,Philippines,NA,Northern Mindanao,4689302,7,0,281,10
2020-07-05,Philippines,NA,Northern Mindanao,4689302,12,0,293,10
2020-07-06,Philippines,NA,Northern Mindanao,4689302,19,0,312,10
2020-07-07,Philippines,NA,Northern Mindanao,4689302,11,0,323,10
2020-07-08,Philippines,NA,Northern Mindanao,4689302,15,0,338,10
2020-07-09,Philippines,NA,Northern Mindanao,4689302,17,0,355,10
2020-07-10,Philippines,NA,Northern Mindanao,4689302,23,0,378,10
2020-07-11,Philippines,NA,Northern Mindanao,4689302,9,1,387,11
2020-07-12,Philippines,NA,Northern Mindanao,4689302,14,0,401,11
2020-07-13,Philippines,NA,Northern Mindanao,4689302,13,0,414,11
2020-07-14,Philippines,NA,Northern Mindanao,4689302,20,1,434,12
2020-07-15,Philippines,NA,Northern Mindanao,4689302,10,0,444,12
2020-07-16,Philippines,NA,Northern Mindanao,4689302,17,0,461,12
2020-07-17,Philippines,NA,Northern Mindanao,4689302,19,0,480,12
2020-07-18,Philippines,NA,Northern Mindanao,4689302,7,0,487,12
2020-07-19,Philippines,NA,Northern Mindanao,4689302,3,0,490,12
2020-07-20,Philippines,NA,Northern Mindanao,4689302,10,0,500,12
2020-07-21,Philippines,NA,Northern Mindanao,4689302,14,0,514,12
2020-07-22,Philippines,NA,Northern Mindanao,4689302,15,0,529,12
2020-07-23,Philippines,NA,Northern Mindanao,4689302,15,0,544,12
2020-07-24,Philippines,NA,Northern Mindanao,4689302,11,0,555,12
2020-07-25,Philippines,NA,Northern Mindanao,4689302,12,0,567,12
2020-07-26,Philippines,NA,Northern Mindanao,4689302,9,0,576,12
2020-07-27,Philippines,NA,Northern Mindanao,4689302,30,0,606,12
2020-07-28,Philippines,NA,Northern Mindanao,4689302,16,0,622,12
2020-07-29,Philippines,NA,Northern Mindanao,4689302,29,0,651,12
2020-07-30,Philippines,NA,Northern Mindanao,4689302,15,0,666,12
2020-07-31,Philippines,NA,Northern Mindanao,4689302,36,0,702,12
2020-08-01,Philippines,NA,Northern Mindanao,4689302,23,0,725,12
2020-08-02,Philippines,NA,Northern Mindanao,4689302,12,0,737,12
2020-08-03,Philippines,NA,Northern Mindanao,4689302,20,0,757,12
2020-08-04,Philippines,NA,Northern Mindanao,4689302,19,1,776,13
2020-08-05,Philippines,NA,Northern Mindanao,4689302,31,0,807,13
2020-08-06,Philippines,NA,Northern Mindanao,4689302,27,0,834,13
2020-08-07,Philippines,NA,Northern Mindanao,4689302,42,0,876,13
2020-08-08,Philippines,NA,Northern Mindanao,4689302,26,0,902,13
2020-08-09,Philippines,NA,Northern Mindanao,4689302,8,0,910,13
2020-08-10,Philippines,NA,Northern Mindanao,4689302,40,0,950,13
2020-08-11,Philippines,NA,Northern Mindanao,4689302,37,1,987,14
2020-08-12,Philippines,NA,Northern Mindanao,4689302,30,0,1017,14
2020-08-13,Philippines,NA,Northern Mindanao,4689302,35,1,1052,15
2020-08-14,Philippines,NA,Northern Mindanao,4689302,56,0,1108,15
2020-08-15,Philippines,NA,Northern Mindanao,4689302,38,1,1146,16
2020-08-16,Philippines,NA,Northern Mindanao,4689302,26,0,1172,16
2020-08-17,Philippines,NA,Northern Mindanao,4689302,23,0,1195,16
2020-08-18,Philippines,NA,Northern Mindanao,4689302,26,0,1221,16
2020-08-19,Philippines,NA,Northern Mindanao,4689302,29,0,1250,16
2020-08-20,Philippines,NA,Northern Mindanao,4689302,45,1,1295,17
2020-08-21,Philippines,NA,Northern Mindanao,4689302,29,0,1324,17
2020-08-22,Philippines,NA,Northern Mindanao,4689302,18,0,1342,17
2020-08-23,Philippines,NA,Northern Mindanao,4689302,21,0,1363,17
2020-08-24,Philippines,NA,Northern Mindanao,4689302,6,0,1369,17
2020-03-27,Philippines,NA,Soccsksargen,4245838,1,0,11,1
2020-03-28,Philippines,NA,Soccsksargen,4245838,1,0,12,1
2020-03-29,Philippines,NA,Soccsksargen,4245838,1,0,13,1
2020-03-31,Philippines,NA,Soccsksargen,4245838,1,0,14,1
2020-04-09,Philippines,NA,Soccsksargen,4245838,0,0,14,1
2020-04-12,Philippines,NA,Soccsksargen,4245838,0,0,14,1
2020-04-13,Philippines,NA,Soccsksargen,4245838,0,0,14,1
2020-04-15,Philippines,NA,Soccsksargen,4245838,0,0,14,1
2020-04-16,Philippines,NA,Soccsksargen,4245838,0,0,14,1
2020-04-22,Philippines,NA,Soccsksargen,4245838,0,0,14,1
2020-04-23,Philippines,NA,Soccsksargen,4245838,0,0,14,1
2020-04-29,Philippines,NA,Soccsksargen,4245838,1,0,15,1
2020-05-03,Philippines,NA,Soccsksargen,4245838,1,0,16,1
2020-05-05,Philippines,NA,Soccsksargen,4245838,1,0,17,1
2020-05-07,Philippines,NA,Soccsksargen,4245838,1,0,18,1
2020-05-12,Philippines,NA,Soccsksargen,4245838,2,0,20,1
2020-05-13,Philippines,NA,Soccsksargen,4245838,1,0,21,1
2020-05-14,Philippines,NA,Soccsksargen,4245838,2,0,23,1
2020-05-16,Philippines,NA,Soccsksargen,4245838,1,0,24,1
2020-05-22,Philippines,NA,Soccsksargen,4245838,0,0,24,1
2020-05-29,Philippines,NA,Soccsksargen,4245838,1,0,25,1
2020-05-30,Philippines,NA,Soccsksargen,4245838,0,0,25,1
2020-05-31,Philippines,NA,Soccsksargen,4245838,0,0,25,1
2020-06-01,Philippines,NA,Soccsksargen,4245838,1,0,26,1
2020-06-03,Philippines,NA,Soccsksargen,4245838,0,0,26,1
2020-06-05,Philippines,NA,Soccsksargen,4245838,1,0,27,1
2020-06-06,Philippines,NA,Soccsksargen,4245838,1,0,28,1
2020-06-08,Philippines,NA,Soccsksargen,4245838,3,0,31,1
2020-06-09,Philippines,NA,Soccsksargen,4245838,1,0,32,1
2020-06-10,Philippines,NA,Soccsksargen,4245838,2,0,34,1
2020-06-11,Philippines,NA,Soccsksargen,4245838,1,0,35,1
2020-06-12,Philippines,NA,Soccsksargen,4245838,1,0,36,1
2020-06-13,Philippines,NA,Soccsksargen,4245838,1,0,37,1
2020-06-14,Philippines,NA,Soccsksargen,4245838,1,0,38,1
2020-06-15,Philippines,NA,Soccsksargen,4245838,2,0,40,1
2020-06-17,Philippines,NA,Soccsksargen,4245838,3,0,43,1
2020-06-18,Philippines,NA,Soccsksargen,4245838,3,0,46,1
2020-06-19,Philippines,NA,Soccsksargen,4245838,1,0,47,1
2020-06-20,Philippines,NA,Soccsksargen,4245838,0,0,47,1
2020-06-22,Philippines,NA,Soccsksargen,4245838,5,0,52,1
2020-06-23,Philippines,NA,Soccsksargen,4245838,1,0,53,1
2020-06-24,Philippines,NA,Soccsksargen,4245838,2,0,55,1
2020-06-25,Philippines,NA,Soccsksargen,4245838,1,0,56,1
2020-06-26,Philippines,NA,Soccsksargen,4245838,4,0,60,1
2020-06-27,Philippines,NA,Soccsksargen,4245838,3,0,63,1
2020-06-29,Philippines,NA,Soccsksargen,4245838,11,0,74,1
2020-06-30,Philippines,NA,Soccsksargen,4245838,0,1,74,2
2020-07-01,Philippines,NA,Soccsksargen,4245838,1,0,75,2
2020-07-02,Philippines,NA,Soccsksargen,4245838,2,0,77,2
2020-07-03,Philippines,NA,Soccsksargen,4245838,1,0,78,2
2020-07-04,Philippines,NA,Soccsksargen,4245838,3,0,81,2
2020-07-05,Philippines,NA,Soccsksargen,4245838,3,0,84,2
2020-07-06,Philippines,NA,Soccsksargen,4245838,3,0,87,2
2020-07-07,Philippines,NA,Soccsksargen,4245838,11,0,98,2
2020-07-08,Philippines,NA,Soccsksargen,4245838,6,0,104,2
2020-07-09,Philippines,NA,Soccsksargen,4245838,20,0,124,2
2020-07-10,Philippines,NA,Soccsksargen,4245838,11,0,135,2
2020-07-11,Philippines,NA,Soccsksargen,4245838,11,0,146,2
2020-07-12,Philippines,NA,Soccsksargen,4245838,8,0,154,2
2020-07-13,Philippines,NA,Soccsksargen,4245838,10,0,164,2
2020-07-14,Philippines,NA,Soccsksargen,4245838,23,0,187,2
2020-07-15,Philippines,NA,Soccsksargen,4245838,28,0,215,2
2020-07-16,Philippines,NA,Soccsksargen,4245838,9,0,224,2
2020-07-17,Philippines,NA,Soccsksargen,4245838,17,0,241,2
2020-07-18,Philippines,NA,Soccsksargen,4245838,1,0,242,2
2020-07-19,Philippines,NA,Soccsksargen,4245838,10,0,252,2
2020-07-20,Philippines,NA,Soccsksargen,4245838,15,0,267,2
2020-07-21,Philippines,NA,Soccsksargen,4245838,20,0,287,2
2020-07-22,Philippines,NA,Soccsksargen,4245838,14,0,301,2
2020-07-23,Philippines,NA,Soccsksargen,4245838,8,0,309,2
2020-07-24,Philippines,NA,Soccsksargen,4245838,6,1,315,3
2020-07-25,Philippines,NA,Soccsksargen,4245838,10,0,325,3
2020-07-26,Philippines,NA,Soccsksargen,4245838,2,0,327,3
2020-07-27,Philippines,NA,Soccsksargen,4245838,12,0,339,3
2020-07-28,Philippines,NA,Soccsksargen,4245838,22,0,361,3
2020-07-29,Philippines,NA,Soccsksargen,4245838,22,0,383,3
2020-07-30,Philippines,NA,Soccsksargen,4245838,11,0,394,3
2020-07-31,Philippines,NA,Soccsksargen,4245838,5,0,399,3
2020-08-01,Philippines,NA,Soccsksargen,4245838,3,0,402,3
2020-08-02,Philippines,NA,Soccsksargen,4245838,0,0,402,3
2020-08-03,Philippines,NA,Soccsksargen,4245838,8,0,410,3
2020-08-04,Philippines,NA,Soccsksargen,4245838,11,0,421,3
2020-08-05,Philippines,NA,Soccsksargen,4245838,11,0,432,3
2020-08-06,Philippines,NA,Soccsksargen,4245838,4,0,436,3
2020-08-07,Philippines,NA,Soccsksargen,4245838,7,0,443,3
2020-08-08,Philippines,NA,Soccsksargen,4245838,3,0,446,3
2020-08-09,Philippines,NA,Soccsksargen,4245838,3,0,449,3
2020-08-10,Philippines,NA,Soccsksargen,4245838,12,0,461,3
2020-08-11,Philippines,NA,Soccsksargen,4245838,10,0,471,3
2020-08-12,Philippines,NA,Soccsksargen,4245838,12,0,483,3
2020-08-13,Philippines,NA,Soccsksargen,4245838,11,1,494,4
2020-08-14,Philippines,NA,Soccsksargen,4245838,9,0,503,4
2020-08-15,Philippines,NA,Soccsksargen,4245838,12,0,515,4
2020-08-16,Philippines,NA,Soccsksargen,4245838,1,0,516,4
2020-08-17,Philippines,NA,Soccsksargen,4245838,11,0,527,4
2020-08-18,Philippines,NA,Soccsksargen,4245838,12,0,539,4
2020-08-19,Philippines,NA,Soccsksargen,4245838,9,0,548,4
2020-08-20,Philippines,NA,Soccsksargen,4245838,9,0,557,4
2020-08-21,Philippines,NA,Soccsksargen,4245838,11,0,568,4
2020-08-22,Philippines,NA,Soccsksargen,4245838,5,0,573,4
2020-08-23,Philippines,NA,Soccsksargen,4245838,1,0,574,4
2020-08-24,Philippines,NA,Soccsksargen,4245838,6,0,580,4
2020-03-18,Philippines,NA,Western Visayas,7536383,4,0,12,0
2020-03-20,Philippines,NA,Western Visayas,7536383,3,0,15,0
2020-03-21,Philippines,NA,Western Visayas,7536383,3,1,18,1
2020-03-23,Philippines,NA,Western Visayas,7536383,2,0,20,1
2020-03-24,Philippines,NA,Western Visayas,7536383,2,0,22,1
2020-03-26,Philippines,NA,Western Visayas,7536383,2,0,24,1
2020-03-27,Philippines,NA,Western Visayas,7536383,2,0,26,1
2020-03-28,Philippines,NA,Western Visayas,7536383,1,0,27,1
2020-03-29,Philippines,NA,Western Visayas,7536383,1,2,28,3
2020-03-30,Philippines,NA,Western Visayas,7536383,5,1,33,4
2020-03-31,Philippines,NA,Western Visayas,7536383,2,1,35,5
2020-04-01,Philippines,NA,Western Visayas,7536383,2,0,37,5
2020-04-02,Philippines,NA,Western Visayas,7536383,1,0,38,5
2020-04-03,Philippines,NA,Western Visayas,7536383,0,0,38,5
2020-04-04,Philippines,NA,Western Visayas,7536383,1,1,39,6
2020-04-05,Philippines,NA,Western Visayas,7536383,2,0,41,6
2020-04-08,Philippines,NA,Western Visayas,7536383,6,1,47,7
2020-04-09,Philippines,NA,Western Visayas,7536383,1,1,48,8
2020-04-10,Philippines,NA,Western Visayas,7536383,3,0,51,8
2020-04-12,Philippines,NA,Western Visayas,7536383,3,0,54,8
2020-04-13,Philippines,NA,Western Visayas,7536383,1,0,55,8
2020-04-14,Philippines,NA,Western Visayas,7536383,0,0,55,8
2020-04-16,Philippines,NA,Western Visayas,7536383,0,0,55,8
2020-04-17,Philippines,NA,Western Visayas,7536383,2,0,57,8
2020-04-19,Philippines,NA,Western Visayas,7536383,0,0,57,8
2020-04-20,Philippines,NA,Western Visayas,7536383,1,0,58,8
2020-04-21,Philippines,NA,Western Visayas,7536383,2,0,60,8
2020-04-22,Philippines,NA,Western Visayas,7536383,1,0,61,8
2020-04-23,Philippines,NA,Western Visayas,7536383,3,0,64,8
2020-04-24,Philippines,NA,Western Visayas,7536383,0,1,64,9
2020-04-27,Philippines,NA,Western Visayas,7536383,1,0,65,9
2020-04-30,Philippines,NA,Western Visayas,7536383,4,0,69,9
2020-05-01,Philippines,NA,Western Visayas,7536383,1,0,70,9
2020-05-03,Philippines,NA,Western Visayas,7536383,1,1,71,10
2020-05-04,Philippines,NA,Western Visayas,7536383,0,0,71,10
2020-05-05,Philippines,NA,Western Visayas,7536383,1,0,72,10
2020-05-06,Philippines,NA,Western Visayas,7536383,1,0,73,10
2020-05-07,Philippines,NA,Western Visayas,7536383,0,0,73,10
2020-05-08,Philippines,NA,Western Visayas,7536383,1,0,74,10
2020-05-09,Philippines,NA,Western Visayas,7536383,0,0,74,10
2020-05-12,Philippines,NA,Western Visayas,7536383,1,0,75,10
2020-05-13,Philippines,NA,Western Visayas,7536383,1,0,76,10
2020-05-14,Philippines,NA,Western Visayas,7536383,0,0,76,10
2020-05-15,Philippines,NA,Western Visayas,7536383,1,0,77,10
2020-05-16,Philippines,NA,Western Visayas,7536383,0,0,77,10
2020-05-18,Philippines,NA,Western Visayas,7536383,1,0,78,10
2020-05-20,Philippines,NA,Western Visayas,7536383,2,0,80,10
2020-05-21,Philippines,NA,Western Visayas,7536383,0,0,80,10
2020-05-22,Philippines,NA,Western Visayas,7536383,2,0,82,10
2020-05-23,Philippines,NA,Western Visayas,7536383,1,0,83,10
2020-05-27,Philippines,NA,Western Visayas,7536383,1,0,84,10
2020-05-29,Philippines,NA,Western Visayas,7536383,1,0,85,10
2020-05-31,Philippines,NA,Western Visayas,7536383,1,0,86,10
2020-06-01,Philippines,NA,Western Visayas,7536383,2,0,88,10
2020-06-02,Philippines,NA,Western Visayas,7536383,2,0,90,10
2020-06-03,Philippines,NA,Western Visayas,7536383,1,0,91,10
2020-06-05,Philippines,NA,Western Visayas,7536383,3,0,94,10
2020-06-06,Philippines,NA,Western Visayas,7536383,3,0,97,10
2020-06-08,Philippines,NA,Western Visayas,7536383,9,0,106,10
2020-06-09,Philippines,NA,Western Visayas,7536383,2,0,108,10
2020-06-10,Philippines,NA,Western Visayas,7536383,1,0,109,10
2020-06-11,Philippines,NA,Western Visayas,7536383,3,0,112,10
2020-06-12,Philippines,NA,Western Visayas,7536383,3,0,115,10
2020-06-13,Philippines,NA,Western Visayas,7536383,2,0,117,10
2020-06-15,Philippines,NA,Western Visayas,7536383,5,0,122,10
2020-06-16,Philippines,NA,Western Visayas,7536383,17,0,139,10
2020-06-17,Philippines,NA,Western Visayas,7536383,15,0,154,10
2020-06-18,Philippines,NA,Western Visayas,7536383,33,0,187,10
2020-06-19,Philippines,NA,Western Visayas,7536383,9,0,196,10
2020-06-20,Philippines,NA,Western Visayas,7536383,4,0,200,10
2020-06-21,Philippines,NA,Western Visayas,7536383,16,0,216,10
2020-06-22,Philippines,NA,Western Visayas,7536383,20,0,236,10
2020-06-23,Philippines,NA,Western Visayas,7536383,40,0,276,10
2020-06-24,Philippines,NA,Western Visayas,7536383,15,0,291,10
2020-06-25,Philippines,NA,Western Visayas,7536383,26,0,317,10
2020-06-26,Philippines,NA,Western Visayas,7536383,23,0,340,10
2020-06-27,Philippines,NA,Western Visayas,7536383,31,0,371,10
2020-06-28,Philippines,NA,Western Visayas,7536383,23,0,394,10
2020-06-29,Philippines,NA,Western Visayas,7536383,125,0,519,10
2020-06-30,Philippines,NA,Western Visayas,7536383,38,0,557,10
2020-07-01,Philippines,NA,Western Visayas,7536383,23,0,580,10
2020-07-02,Philippines,NA,Western Visayas,7536383,39,0,619,10
2020-07-03,Philippines,NA,Western Visayas,7536383,22,0,641,10
2020-07-04,Philippines,NA,Western Visayas,7536383,12,0,653,10
2020-07-05,Philippines,NA,Western Visayas,7536383,7,0,660,10
2020-07-06,Philippines,NA,Western Visayas,7536383,15,0,675,10
2020-07-07,Philippines,NA,Western Visayas,7536383,18,2,693,12
2020-07-08,Philippines,NA,Western Visayas,7536383,18,0,711,12
2020-07-09,Philippines,NA,Western Visayas,7536383,23,0,734,12
2020-07-10,Philippines,NA,Western Visayas,7536383,21,0,755,12
2020-07-11,Philippines,NA,Western Visayas,7536383,13,0,768,12
2020-07-12,Philippines,NA,Western Visayas,7536383,7,0,775,12
2020-07-13,Philippines,NA,Western Visayas,7536383,6,0,781,12
2020-07-14,Philippines,NA,Western Visayas,7536383,24,0,805,12
2020-07-15,Philippines,NA,Western Visayas,7536383,25,1,830,13
2020-07-16,Philippines,NA,Western Visayas,7536383,15,0,845,13
2020-07-17,Philippines,NA,Western Visayas,7536383,74,1,919,14
2020-07-18,Philippines,NA,Western Visayas,7536383,27,0,946,14
2020-07-19,Philippines,NA,Western Visayas,7536383,22,1,968,15
2020-07-20,Philippines,NA,Western Visayas,7536383,45,0,1013,15
2020-07-21,Philippines,NA,Western Visayas,7536383,90,0,1103,15
2020-07-22,Philippines,NA,Western Visayas,7536383,50,0,1153,15
2020-07-23,Philippines,NA,Western Visayas,7536383,55,0,1208,15
2020-07-24,Philippines,NA,Western Visayas,7536383,43,0,1251,15
2020-07-25,Philippines,NA,Western Visayas,7536383,63,0,1314,15
2020-07-26,Philippines,NA,Western Visayas,7536383,29,0,1343,15
2020-07-27,Philippines,NA,Western Visayas,7536383,84,1,1427,16
2020-07-28,Philippines,NA,Western Visayas,7536383,134,1,1561,17
2020-07-29,Philippines,NA,Western Visayas,7536383,37,1,1598,18
2020-07-30,Philippines,NA,Western Visayas,7536383,72,1,1670,19
2020-07-31,Philippines,NA,Western Visayas,7536383,47,1,1717,20
2020-08-01,Philippines,NA,Western Visayas,7536383,61,0,1778,20
2020-08-02,Philippines,NA,Western Visayas,7536383,34,1,1812,21
2020-08-03,Philippines,NA,Western Visayas,7536383,148,1,1960,22
2020-08-04,Philippines,NA,Western Visayas,7536383,100,2,2060,24
2020-08-05,Philippines,NA,Western Visayas,7536383,84,2,2144,26
2020-08-06,Philippines,NA,Western Visayas,7536383,239,2,2383,28
2020-08-07,Philippines,NA,Western Visayas,7536383,221,2,2604,30
2020-08-08,Philippines,NA,Western Visayas,7536383,157,2,2761,32
2020-08-09,Philippines,NA,Western Visayas,7536383,56,2,2817,34
2020-08-10,Philippines,NA,Western Visayas,7536383,226,3,3043,37
2020-08-11,Philippines,NA,Western Visayas,7536383,164,1,3207,38
2020-08-12,Philippines,NA,Western Visayas,7536383,74,1,3281,39
2020-08-13,Philippines,NA,Western Visayas,7536383,142,2,3423,41
2020-08-14,Philippines,NA,Western Visayas,7536383,201,3,3624,44
2020-08-15,Philippines,NA,Western Visayas,7536383,101,2,3725,46
2020-08-16,Philippines,NA,Western Visayas,7536383,65,2,3790,48
2020-08-17,Philippines,NA,Western Visayas,7536383,186,0,3976,48
2020-08-18,Philippines,NA,Western Visayas,7536383,176,1,4152,49
2020-08-19,Philippines,NA,Western Visayas,7536383,165,1,4317,50
2020-08-20,Philippines,NA,Western Visayas,7536383,158,1,4475,51
2020-08-21,Philippines,NA,Western Visayas,7536383,113,0,4588,51
2020-08-22,Philippines,NA,Western Visayas,7536383,56,0,4644,51
2020-08-23,Philippines,NA,Western Visayas,7536383,31,0,4675,51
2020-08-24,Philippines,NA,Western Visayas,7536383,24,0,4699,51
2020-08-25,Philippines,NA,Western Visayas,7536383,9,0,4708,51
2020-04-04,Philippines,NA,Zamboanga Peninsula,3629783,1,0,11,0
2020-04-06,Philippines,NA,Zamboanga Peninsula,3629783,0,0,11,0
2020-04-07,Philippines,NA,Zamboanga Peninsula,3629783,1,0,12,0
2020-04-12,Philippines,NA,Zamboanga Peninsula,3629783,0,0,12,0
2020-04-14,Philippines,NA,Zamboanga Peninsula,3629783,0,0,12,0
2020-04-17,Philippines,NA,Zamboanga Peninsula,3629783,1,0,13,0
2020-04-18,Philippines,NA,Zamboanga Peninsula,3629783,1,0,14,0
2020-04-19,Philippines,NA,Zamboanga Peninsula,3629783,0,1,14,1
2020-04-20,Philippines,NA,Zamboanga Peninsula,3629783,1,0,15,1
2020-04-21,Philippines,NA,Zamboanga Peninsula,3629783,0,1,15,2
2020-04-25,Philippines,NA,Zamboanga Peninsula,3629783,0,1,15,3
2020-04-26,Philippines,NA,Zamboanga Peninsula,3629783,1,0,16,3
2020-04-27,Philippines,NA,Zamboanga Peninsula,3629783,25,0,41,3
2020-04-29,Philippines,NA,Zamboanga Peninsula,3629783,21,0,62,3
2020-04-30,Philippines,NA,Zamboanga Peninsula,3629783,2,1,64,4
2020-05-01,Philippines,NA,Zamboanga Peninsula,3629783,0,0,64,4
2020-05-05,Philippines,NA,Zamboanga Peninsula,3629783,7,0,71,4
2020-05-08,Philippines,NA,Zamboanga Peninsula,3629783,34,0,105,4
2020-05-09,Philippines,NA,Zamboanga Peninsula,3629783,1,0,106,4
2020-05-11,Philippines,NA,Zamboanga Peninsula,3629783,23,0,129,4
2020-05-12,Philippines,NA,Zamboanga Peninsula,3629783,2,0,131,4
2020-05-13,Philippines,NA,Zamboanga Peninsula,3629783,16,0,147,4
2020-05-17,Philippines,NA,Zamboanga Peninsula,3629783,0,0,147,4
2020-05-20,Philippines,NA,Zamboanga Peninsula,3629783,2,0,149,4
2020-05-22,Philippines,NA,Zamboanga Peninsula,3629783,7,0,156,4
2020-05-23,Philippines,NA,Zamboanga Peninsula,3629783,1,0,157,4
2020-05-25,Philippines,NA,Zamboanga Peninsula,3629783,1,1,158,5
2020-05-28,Philippines,NA,Zamboanga Peninsula,3629783,0,0,158,5
2020-05-29,Philippines,NA,Zamboanga Peninsula,3629783,4,0,162,5
2020-05-30,Philippines,NA,Zamboanga Peninsula,3629783,1,0,163,5
2020-06-02,Philippines,NA,Zamboanga Peninsula,3629783,0,0,163,5
2020-06-04,Philippines,NA,Zamboanga Peninsula,3629783,1,0,164,5
2020-06-05,Philippines,NA,Zamboanga Peninsula,3629783,24,0,188,5
2020-06-08,Philippines,NA,Zamboanga Peninsula,3629783,1,0,189,5
2020-06-09,Philippines,NA,Zamboanga Peninsula,3629783,1,0,190,5
2020-06-10,Philippines,NA,Zamboanga Peninsula,3629783,2,0,192,5
2020-06-12,Philippines,NA,Zamboanga Peninsula,3629783,1,0,193,5
2020-06-13,Philippines,NA,Zamboanga Peninsula,3629783,0,1,193,6
2020-06-14,Philippines,NA,Zamboanga Peninsula,3629783,4,0,197,6
2020-06-15,Philippines,NA,Zamboanga Peninsula,3629783,3,0,200,6
2020-06-16,Philippines,NA,Zamboanga Peninsula,3629783,2,0,202,6
2020-06-17,Philippines,NA,Zamboanga Peninsula,3629783,6,0,208,6
2020-06-18,Philippines,NA,Zamboanga Peninsula,3629783,1,0,209,6
2020-06-19,Philippines,NA,Zamboanga Peninsula,3629783,4,0,213,6
2020-06-20,Philippines,NA,Zamboanga Peninsula,3629783,2,0,215,6
2020-06-21,Philippines,NA,Zamboanga Peninsula,3629783,1,0,216,6
2020-06-22,Philippines,NA,Zamboanga Peninsula,3629783,9,0,225,6
2020-06-23,Philippines,NA,Zamboanga Peninsula,3629783,11,0,236,6
2020-06-24,Philippines,NA,Zamboanga Peninsula,3629783,17,0,253,6
2020-06-25,Philippines,NA,Zamboanga Peninsula,3629783,8,0,261,6
2020-06-26,Philippines,NA,Zamboanga Peninsula,3629783,1,0,262,6
2020-06-27,Philippines,NA,Zamboanga Peninsula,3629783,3,1,265,7
2020-06-28,Philippines,NA,Zamboanga Peninsula,3629783,1,0,266,7
2020-06-29,Philippines,NA,Zamboanga Peninsula,3629783,8,0,274,7
2020-06-30,Philippines,NA,Zamboanga Peninsula,3629783,33,0,307,7
2020-07-01,Philippines,NA,Zamboanga Peninsula,3629783,12,0,319,7
2020-07-02,Philippines,NA,Zamboanga Peninsula,3629783,10,0,329,7
2020-07-03,Philippines,NA,Zamboanga Peninsula,3629783,11,1,340,8
2020-07-04,Philippines,NA,Zamboanga Peninsula,3629783,25,1,365,9
2020-07-05,Philippines,NA,Zamboanga Peninsula,3629783,19,0,384,9
2020-07-06,Philippines,NA,Zamboanga Peninsula,3629783,10,1,394,10
2020-07-07,Philippines,NA,Zamboanga Peninsula,3629783,23,1,417,11
2020-07-08,Philippines,NA,Zamboanga Peninsula,3629783,22,0,439,11
2020-07-09,Philippines,NA,Zamboanga Peninsula,3629783,15,0,454,11
2020-07-10,Philippines,NA,Zamboanga Peninsula,3629783,36,0,490,11
2020-07-11,Philippines,NA,Zamboanga Peninsula,3629783,13,1,503,12
2020-07-12,Philippines,NA,Zamboanga Peninsula,3629783,11,0,514,12
2020-07-13,Philippines,NA,Zamboanga Peninsula,3629783,18,0,532,12
2020-07-14,Philippines,NA,Zamboanga Peninsula,3629783,20,0,552,12
2020-07-15,Philippines,NA,Zamboanga Peninsula,3629783,5,0,557,12
2020-07-16,Philippines,NA,Zamboanga Peninsula,3629783,15,0,572,12
2020-07-17,Philippines,NA,Zamboanga Peninsula,3629783,25,1,597,13
2020-07-18,Philippines,NA,Zamboanga Peninsula,3629783,16,0,613,13
2020-07-19,Philippines,NA,Zamboanga Peninsula,3629783,42,0,655,13
2020-07-20,Philippines,NA,Zamboanga Peninsula,3629783,27,0,682,13
2020-07-21,Philippines,NA,Zamboanga Peninsula,3629783,16,0,698,13
2020-07-22,Philippines,NA,Zamboanga Peninsula,3629783,11,1,709,14
2020-07-23,Philippines,NA,Zamboanga Peninsula,3629783,9,1,718,15
2020-07-24,Philippines,NA,Zamboanga Peninsula,3629783,10,0,728,15
2020-07-25,Philippines,NA,Zamboanga Peninsula,3629783,9,0,737,15
2020-07-26,Philippines,NA,Zamboanga Peninsula,3629783,8,1,745,16
2020-07-27,Philippines,NA,Zamboanga Peninsula,3629783,22,0,767,16
2020-07-28,Philippines,NA,Zamboanga Peninsula,3629783,15,0,782,16
2020-07-29,Philippines,NA,Zamboanga Peninsula,3629783,12,1,794,17
2020-07-30,Philippines,NA,Zamboanga Peninsula,3629783,26,2,820,19
2020-07-31,Philippines,NA,Zamboanga Peninsula,3629783,16,0,836,19
2020-08-01,Philippines,NA,Zamboanga Peninsula,3629783,29,0,865,19
2020-08-02,Philippines,NA,Zamboanga Peninsula,3629783,13,1,878,20
2020-08-03,Philippines,NA,Zamboanga Peninsula,3629783,52,0,930,20
2020-08-04,Philippines,NA,Zamboanga Peninsula,3629783,17,1,947,21
2020-08-05,Philippines,NA,Zamboanga Peninsula,3629783,22,2,969,23
2020-08-06,Philippines,NA,Zamboanga Peninsula,3629783,41,1,1010,24
2020-08-07,Philippines,NA,Zamboanga Peninsula,3629783,30,4,1040,28
2020-08-08,Philippines,NA,Zamboanga Peninsula,3629783,20,0,1060,28
2020-08-09,Philippines,NA,Zamboanga Peninsula,3629783,12,1,1072,29
2020-08-10,Philippines,NA,Zamboanga Peninsula,3629783,48,0,1120,29
2020-08-11,Philippines,NA,Zamboanga Peninsula,3629783,26,2,1146,31
2020-08-12,Philippines,NA,Zamboanga Peninsula,3629783,37,0,1183,31
2020-08-13,Philippines,NA,Zamboanga Peninsula,3629783,21,0,1204,31
2020-08-14,Philippines,NA,Zamboanga Peninsula,3629783,28,2,1232,33
2020-08-15,Philippines,NA,Zamboanga Peninsula,3629783,34,2,1266,35
2020-08-16,Philippines,NA,Zamboanga Peninsula,3629783,16,1,1282,36
2020-08-17,Philippines,NA,Zamboanga Peninsula,3629783,17,1,1299,37
2020-08-18,Philippines,NA,Zamboanga Peninsula,3629783,19,3,1318,40
2020-08-19,Philippines,NA,Zamboanga Peninsula,3629783,19,0,1337,40
2020-08-20,Philippines,NA,Zamboanga Peninsula,3629783,32,1,1369,41
2020-08-21,Philippines,NA,Zamboanga Peninsula,3629783,27,2,1396,43
2020-08-22,Philippines,NA,Zamboanga Peninsula,3629783,11,0,1407,43
2020-08-23,Philippines,NA,Zamboanga Peninsula,3629783,11,1,1418,44
2020-08-24,Philippines,NA,Zamboanga Peninsula,3629783,9,0,1427,44
2020-04-06,Russia,NA,Adygea,453376,6,0,13,0
2020-04-10,Russia,NA,Adygea,453376,7,0,20,0
2020-04-14,Russia,NA,Adygea,453376,7,0,27,0
2020-04-16,Russia,NA,Adygea,453376,16,0,43,0
2020-04-17,Russia,NA,Adygea,453376,36,0,79,0
2020-04-18,Russia,NA,Adygea,453376,5,0,84,0
2020-04-19,Russia,NA,Adygea,453376,7,0,91,0
2020-04-20,Russia,NA,Adygea,453376,9,0,100,0
2020-04-21,Russia,NA,Adygea,453376,8,0,108,0
2020-04-22,Russia,NA,Adygea,453376,5,0,113,0
2020-04-23,Russia,NA,Adygea,453376,1,0,114,0
2020-04-24,Russia,NA,Adygea,453376,3,0,117,0
2020-04-25,Russia,NA,Adygea,453376,2,0,119,0
2020-04-26,Russia,NA,Adygea,453376,15,0,134,0
2020-04-27,Russia,NA,Adygea,453376,8,0,142,0
2020-04-28,Russia,NA,Adygea,453376,8,0,150,0
2020-04-29,Russia,NA,Adygea,453376,4,0,154,0
2020-04-30,Russia,NA,Adygea,453376,9,0,163,0
2020-05-01,Russia,NA,Adygea,453376,2,0,165,0
2020-05-02,Russia,NA,Adygea,453376,3,0,168,0
2020-05-03,Russia,NA,Adygea,453376,10,0,178,0
2020-05-04,Russia,NA,Adygea,453376,7,0,185,0
2020-05-05,Russia,NA,Adygea,453376,5,0,190,0
2020-05-06,Russia,NA,Adygea,453376,12,0,202,0
2020-05-07,Russia,NA,Adygea,453376,4,0,206,0
2020-05-08,Russia,NA,Adygea,453376,6,0,212,0
2020-05-09,Russia,NA,Adygea,453376,8,0,220,0
2020-05-10,Russia,NA,Adygea,453376,4,0,224,0
2020-05-11,Russia,NA,Adygea,453376,17,0,241,0
2020-05-12,Russia,NA,Adygea,453376,11,0,252,0
2020-05-13,Russia,NA,Adygea,453376,19,0,271,0
2020-05-14,Russia,NA,Adygea,453376,5,0,276,0
2020-05-15,Russia,NA,Adygea,453376,31,0,307,0
2020-05-16,Russia,NA,Adygea,453376,40,0,347,0
2020-05-17,Russia,NA,Adygea,453376,51,0,398,0
2020-05-18,Russia,NA,Adygea,453376,32,0,430,0
2020-05-19,Russia,NA,Adygea,453376,31,0,461,0
2020-05-20,Russia,NA,Adygea,453376,64,0,525,0
2020-05-21,Russia,NA,Adygea,453376,36,0,561,0
2020-05-22,Russia,NA,Adygea,453376,30,0,591,0
2020-05-23,Russia,NA,Adygea,453376,31,0,622,0
2020-05-24,Russia,NA,Adygea,453376,49,0,671,0
2020-05-25,Russia,NA,Adygea,453376,25,0,696,0
2020-05-26,Russia,NA,Adygea,453376,25,0,721,0
2020-05-27,Russia,NA,Adygea,453376,38,0,759,0
2020-05-28,Russia,NA,Adygea,453376,24,0,783,0
2020-05-29,Russia,NA,Adygea,453376,11,0,794,0
2020-05-30,Russia,NA,Adygea,453376,19,0,813,0
2020-05-31,Russia,NA,Adygea,453376,41,0,854,0
2020-06-01,Russia,NA,Adygea,453376,20,0,874,0
2020-06-02,Russia,NA,Adygea,453376,16,0,890,0
2020-06-03,Russia,NA,Adygea,453376,14,0,904,0
2020-06-04,Russia,NA,Adygea,453376,33,0,937,0
2020-06-05,Russia,NA,Adygea,453376,25,0,962,0
2020-06-06,Russia,NA,Adygea,453376,33,0,995,0
2020-06-07,Russia,NA,Adygea,453376,30,0,1025,0
2020-06-08,Russia,NA,Adygea,453376,44,0,1069,0
2020-06-09,Russia,NA,Adygea,453376,46,0,1115,0
2020-06-10,Russia,NA,Adygea,453376,43,0,1158,0
2020-06-11,Russia,NA,Adygea,453376,55,0,1213,0
2020-06-12,Russia,NA,Adygea,453376,38,0,1251,0
2020-06-13,Russia,NA,Adygea,453376,27,0,1278,0
2020-06-14,Russia,NA,Adygea,453376,33,0,1311,0
2020-06-15,Russia,NA,Adygea,453376,29,0,1340,0
2020-06-16,Russia,NA,Adygea,453376,49,0,1389,0
2020-06-17,Russia,NA,Adygea,453376,26,0,1415,0
2020-06-18,Russia,NA,Adygea,453376,31,0,1446,0
2020-06-19,Russia,NA,Adygea,453376,38,0,1484,0
2020-06-20,Russia,NA,Adygea,453376,27,0,1511,0
2020-06-21,Russia,NA,Adygea,453376,30,0,1541,0
2020-06-22,Russia,NA,Adygea,453376,28,0,1569,0
2020-06-23,Russia,NA,Adygea,453376,38,0,1607,0
2020-06-24,Russia,NA,Adygea,453376,40,0,1647,0
2020-06-25,Russia,NA,Adygea,453376,35,0,1682,0
2020-06-26,Russia,NA,Adygea,453376,30,0,1712,0
2020-06-27,Russia,NA,Adygea,453376,34,0,1746,0
2020-06-28,Russia,NA,Adygea,453376,49,0,1795,0
2020-06-29,Russia,NA,Adygea,453376,52,0,1847,0
2020-06-30,Russia,NA,Adygea,453376,51,0,1898,0
2020-07-01,Russia,NA,Adygea,453376,37,0,1935,0
2020-07-02,Russia,NA,Adygea,453376,46,0,1981,0
2020-07-03,Russia,NA,Adygea,453376,58,0,2039,0
2020-07-04,Russia,NA,Adygea,453376,29,0,2068,0
2020-07-05,Russia,NA,Adygea,453376,26,0,2094,0
2020-07-06,Russia,NA,Adygea,453376,27,0,2121,0
2020-07-07,Russia,NA,Adygea,453376,24,0,2145,0
2020-07-08,Russia,NA,Adygea,453376,22,0,2167,0
2020-07-09,Russia,NA,Adygea,453376,20,0,2187,0
2020-07-10,Russia,NA,Adygea,453376,18,0,2205,0
2020-07-11,Russia,NA,Adygea,453376,19,0,2224,0
2020-07-12,Russia,NA,Adygea,453376,18,0,2242,0
2020-07-13,Russia,NA,Adygea,453376,16,0,2258,0
2020-07-14,Russia,NA,Adygea,453376,17,0,2275,0
2020-07-15,Russia,NA,Adygea,453376,16,0,2291,0
2020-07-16,Russia,NA,Adygea,453376,17,0,2308,0
2020-07-17,Russia,NA,Adygea,453376,18,0,2326,0
2020-07-18,Russia,NA,Adygea,453376,18,0,2344,0
2020-07-19,Russia,NA,Adygea,453376,20,0,2364,0
2020-07-20,Russia,NA,Adygea,453376,20,0,2384,0
2020-07-21,Russia,NA,Adygea,453376,27,0,2411,0
2020-07-22,Russia,NA,Adygea,453376,25,0,2436,0
2020-07-23,Russia,NA,Adygea,453376,34,0,2470,0
2020-07-24,Russia,NA,Adygea,453376,26,0,2496,0
2020-07-25,Russia,NA,Adygea,453376,34,0,2530,0
2020-07-26,Russia,NA,Adygea,453376,38,0,2568,0
2020-07-27,Russia,NA,Adygea,453376,36,0,2604,0
2020-07-28,Russia,NA,Adygea,453376,38,0,2642,0
2020-07-29,Russia,NA,Adygea,453376,37,0,2679,0
2020-07-30,Russia,NA,Adygea,453376,35,0,2714,0
2020-07-31,Russia,NA,Adygea,453376,33,0,2747,0
2020-08-01,Russia,NA,Adygea,453376,28,0,2775,0
2020-08-02,Russia,NA,Adygea,453376,28,0,2803,0
2020-08-26,Russia,NA,Adygea,453376,0,0,3291,26
2020-08-27,Russia,NA,Adygea,453376,17,0,3308,26
2020-08-28,Russia,NA,Adygea,453376,19,1,3327,27
2020-08-29,Russia,NA,Adygea,453376,19,0,3346,27
2020-08-30,Russia,NA,Adygea,453376,18,0,3364,27
2020-08-31,Russia,NA,Adygea,453376,22,0,3386,27
2020-09-01,Russia,NA,Adygea,453376,14,0,3400,27
2020-09-02,Russia,NA,Adygea,453376,20,0,3420,27
2020-09-03,Russia,NA,Adygea,453376,20,0,3440,27
2020-09-04,Russia,NA,Adygea,453376,21,1,3461,28
2020-09-05,Russia,NA,Adygea,453376,19,1,3480,29
2020-09-06,Russia,NA,Adygea,453376,20,0,3500,29
2020-09-07,Russia,NA,Adygea,453376,22,1,3522,30
2020-09-08,Russia,NA,Adygea,453376,24,0,3546,30
2020-09-09,Russia,NA,Adygea,453376,21,0,3567,30
2020-09-10,Russia,NA,Adygea,453376,20,0,3587,30
2020-09-11,Russia,NA,Adygea,453376,22,0,3609,30
2020-09-12,Russia,NA,Adygea,453376,21,0,3630,30
2020-09-13,Russia,NA,Adygea,453376,20,0,3650,30
2020-09-14,Russia,NA,Adygea,453376,19,0,3669,30
2020-09-15,Russia,NA,Adygea,453376,20,0,3689,30
2020-09-16,Russia,NA,Adygea,453376,21,0,3710,30
2020-09-17,Russia,NA,Adygea,453376,20,0,3730,30
2020-09-18,Russia,NA,Adygea,453376,23,1,3753,31
2020-09-19,Russia,NA,Adygea,453376,22,0,3775,31
2020-09-20,Russia,NA,Adygea,453376,24,0,3799,31
2020-09-21,Russia,NA,Adygea,453376,25,0,3824,31
2020-09-22,Russia,NA,Adygea,453376,23,0,3847,31
2020-09-23,Russia,NA,Adygea,453376,26,0,3873,31
2020-04-06,Russia,NA,Altai Krai,2350080,5,0,12,0
2020-04-08,Russia,NA,Altai Krai,2350080,6,0,18,0
2020-04-09,Russia,NA,Altai Krai,2350080,3,0,21,0
2020-04-11,Russia,NA,Altai Krai,2350080,8,0,29,0
2020-04-13,Russia,NA,Altai Krai,2350080,2,0,31,0
2020-04-14,Russia,NA,Altai Krai,2350080,5,0,36,0
2020-04-15,Russia,NA,Altai Krai,2350080,3,0,39,0
2020-04-16,Russia,NA,Altai Krai,2350080,9,0,48,0
2020-04-17,Russia,NA,Altai Krai,2350080,5,0,53,0
2020-04-18,Russia,NA,Altai Krai,2350080,10,0,63,0
2020-04-19,Russia,NA,Altai Krai,2350080,9,0,72,0
2020-04-20,Russia,NA,Altai Krai,2350080,12,0,84,0
2020-04-21,Russia,NA,Altai Krai,2350080,43,0,127,0
2020-04-22,Russia,NA,Altai Krai,2350080,9,0,136,0
2020-04-23,Russia,NA,Altai Krai,2350080,8,0,144,0
2020-04-24,Russia,NA,Altai Krai,2350080,8,0,152,0
2020-04-25,Russia,NA,Altai Krai,2350080,63,0,215,0
2020-04-26,Russia,NA,Altai Krai,2350080,68,0,283,0
2020-04-27,Russia,NA,Altai Krai,2350080,27,0,310,0
2020-04-28,Russia,NA,Altai Krai,2350080,14,0,324,0
2020-04-29,Russia,NA,Altai Krai,2350080,24,0,348,0
2020-04-30,Russia,NA,Altai Krai,2350080,34,0,382,0
2020-05-01,Russia,NA,Altai Krai,2350080,41,0,423,0
2020-05-02,Russia,NA,Altai Krai,2350080,28,0,451,0
2020-05-03,Russia,NA,Altai Krai,2350080,47,0,498,0
2020-05-04,Russia,NA,Altai Krai,2350080,36,0,534,0
2020-05-05,Russia,NA,Altai Krai,2350080,21,0,555,0
2020-05-06,Russia,NA,Altai Krai,2350080,33,0,588,0
2020-05-07,Russia,NA,Altai Krai,2350080,17,0,605,0
2020-05-08,Russia,NA,Altai Krai,2350080,16,0,621,0
2020-05-09,Russia,NA,Altai Krai,2350080,20,0,641,0
2020-05-10,Russia,NA,Altai Krai,2350080,28,0,669,0
2020-05-11,Russia,NA,Altai Krai,2350080,38,0,707,0
2020-05-12,Russia,NA,Altai Krai,2350080,20,0,727,0
2020-05-13,Russia,NA,Altai Krai,2350080,43,0,770,0
2020-05-14,Russia,NA,Altai Krai,2350080,39,0,809,0
2020-05-15,Russia,NA,Altai Krai,2350080,38,0,847,0
2020-05-16,Russia,NA,Altai Krai,2350080,38,0,885,0
2020-05-17,Russia,NA,Altai Krai,2350080,40,0,925,0
2020-05-18,Russia,NA,Altai Krai,2350080,45,0,970,0
2020-05-19,Russia,NA,Altai Krai,2350080,44,0,1014,0
2020-05-20,Russia,NA,Altai Krai,2350080,40,0,1054,0
2020-05-21,Russia,NA,Altai Krai,2350080,57,0,1111,0
2020-05-22,Russia,NA,Altai Krai,2350080,74,0,1185,0
2020-05-23,Russia,NA,Altai Krai,2350080,69,0,1254,0
2020-05-24,Russia,NA,Altai Krai,2350080,71,0,1325,0
2020-05-25,Russia,NA,Altai Krai,2350080,81,0,1406,0
2020-05-26,Russia,NA,Altai Krai,2350080,79,0,1485,0
2020-05-27,Russia,NA,Altai Krai,2350080,69,0,1554,0
2020-05-28,Russia,NA,Altai Krai,2350080,79,0,1633,0
2020-05-29,Russia,NA,Altai Krai,2350080,75,0,1708,0
2020-05-30,Russia,NA,Altai Krai,2350080,71,0,1779,0
2020-05-31,Russia,NA,Altai Krai,2350080,69,0,1848,0
2020-06-01,Russia,NA,Altai Krai,2350080,67,0,1915,0
2020-06-02,Russia,NA,Altai Krai,2350080,70,0,1985,0
2020-06-03,Russia,NA,Altai Krai,2350080,81,0,2066,0
2020-06-04,Russia,NA,Altai Krai,2350080,69,0,2135,0
2020-06-05,Russia,NA,Altai Krai,2350080,57,0,2192,0
2020-06-06,Russia,NA,Altai Krai,2350080,63,0,2255,0
2020-06-07,Russia,NA,Altai Krai,2350080,64,0,2319,0
2020-06-08,Russia,NA,Altai Krai,2350080,71,0,2390,0
2020-06-09,Russia,NA,Altai Krai,2350080,68,0,2458,0
2020-06-10,Russia,NA,Altai Krai,2350080,66,0,2524,0
2020-06-11,Russia,NA,Altai Krai,2350080,69,0,2593,0
2020-06-12,Russia,NA,Altai Krai,2350080,66,0,2659,0
2020-06-13,Russia,NA,Altai Krai,2350080,67,0,2726,0
2020-06-14,Russia,NA,Altai Krai,2350080,69,0,2795,0
2020-06-15,Russia,NA,Altai Krai,2350080,72,0,2867,0
2020-06-16,Russia,NA,Altai Krai,2350080,72,0,2939,0
2020-06-17,Russia,NA,Altai Krai,2350080,71,0,3010,0
2020-06-18,Russia,NA,Altai Krai,2350080,68,0,3078,0
2020-06-19,Russia,NA,Altai Krai,2350080,75,0,3153,0
2020-06-20,Russia,NA,Altai Krai,2350080,73,0,3226,0
2020-06-21,Russia,NA,Altai Krai,2350080,72,0,3298,0
2020-06-22,Russia,NA,Altai Krai,2350080,73,0,3371,0
2020-06-23,Russia,NA,Altai Krai,2350080,74,0,3445,0
2020-06-24,Russia,NA,Altai Krai,2350080,77,0,3522,0
2020-06-25,Russia,NA,Altai Krai,2350080,78,0,3600,0
2020-06-26,Russia,NA,Altai Krai,2350080,76,0,3676,0
2020-06-27,Russia,NA,Altai Krai,2350080,77,0,3753,0
2020-06-28,Russia,NA,Altai Krai,2350080,78,0,3831,0
2020-06-29,Russia,NA,Altai Krai,2350080,78,0,3909,0
2020-06-30,Russia,NA,Altai Krai,2350080,76,0,3985,0
2020-07-01,Russia,NA,Altai Krai,2350080,74,0,4059,0
2020-07-02,Russia,NA,Altai Krai,2350080,75,0,4134,0
2020-07-03,Russia,NA,Altai Krai,2350080,73,0,4207,0
2020-07-04,Russia,NA,Altai Krai,2350080,92,0,4299,0
2020-07-05,Russia,NA,Altai Krai,2350080,115,0,4414,0
2020-07-06,Russia,NA,Altai Krai,2350080,124,0,4538,0
2020-07-07,Russia,NA,Altai Krai,2350080,171,0,4709,0
2020-07-08,Russia,NA,Altai Krai,2350080,188,0,4897,0
2020-07-09,Russia,NA,Altai Krai,2350080,224,0,5121,0
2020-07-10,Russia,NA,Altai Krai,2350080,240,0,5361,0
2020-07-11,Russia,NA,Altai Krai,2350080,228,0,5589,0
2020-07-12,Russia,NA,Altai Krai,2350080,232,0,5821,0
2020-07-13,Russia,NA,Altai Krai,2350080,235,0,6056,0
2020-07-14,Russia,NA,Altai Krai,2350080,238,0,6294,0
2020-07-15,Russia,NA,Altai Krai,2350080,246,0,6540,0
2020-07-16,Russia,NA,Altai Krai,2350080,215,0,6755,0
2020-07-17,Russia,NA,Altai Krai,2350080,228,0,6983,0
2020-07-18,Russia,NA,Altai Krai,2350080,201,0,7184,0
2020-07-19,Russia,NA,Altai Krai,2350080,198,0,7382,0
2020-07-20,Russia,NA,Altai Krai,2350080,191,0,7573,0
2020-07-21,Russia,NA,Altai Krai,2350080,185,0,7758,0
2020-07-22,Russia,NA,Altai Krai,2350080,183,0,7941,0
2020-07-23,Russia,NA,Altai Krai,2350080,166,0,8107,0
2020-07-24,Russia,NA,Altai Krai,2350080,146,0,8253,0
2020-07-25,Russia,NA,Altai Krai,2350080,138,0,8391,0
2020-07-26,Russia,NA,Altai Krai,2350080,140,0,8531,0
2020-07-27,Russia,NA,Altai Krai,2350080,134,0,8665,0
2020-07-28,Russia,NA,Altai Krai,2350080,121,0,8786,0
2020-07-29,Russia,NA,Altai Krai,2350080,107,0,8893,0
2020-07-30,Russia,NA,Altai Krai,2350080,105,0,8998,0
2020-07-31,Russia,NA,Altai Krai,2350080,111,0,9109,0
2020-08-01,Russia,NA,Altai Krai,2350080,108,0,9217,0
2020-08-02,Russia,NA,Altai Krai,2350080,109,0,9326,0
2020-08-26,Russia,NA,Altai Krai,2350080,0,0,11387,112
2020-08-27,Russia,NA,Altai Krai,2350080,69,0,11456,112
2020-08-28,Russia,NA,Altai Krai,2350080,67,2,11523,114
2020-08-29,Russia,NA,Altai Krai,2350080,68,2,11591,116
2020-08-30,Russia,NA,Altai Krai,2350080,64,1,11655,117
2020-08-31,Russia,NA,Altai Krai,2350080,65,2,11720,119
2020-09-01,Russia,NA,Altai Krai,2350080,61,0,11781,119
2020-09-02,Russia,NA,Altai Krai,2350080,63,0,11844,119
2020-09-03,Russia,NA,Altai Krai,2350080,64,1,11908,120
2020-09-04,Russia,NA,Altai Krai,2350080,62,2,11970,122
2020-09-05,Russia,NA,Altai Krai,2350080,63,1,12033,123
2020-09-06,Russia,NA,Altai Krai,2350080,61,4,12094,127
2020-09-07,Russia,NA,Altai Krai,2350080,62,0,12156,127
2020-09-08,Russia,NA,Altai Krai,2350080,60,4,12216,131
2020-09-09,Russia,NA,Altai Krai,2350080,64,5,12280,136
2020-09-10,Russia,NA,Altai Krai,2350080,62,3,12342,139
2020-09-11,Russia,NA,Altai Krai,2350080,63,0,12405,139
2020-09-12,Russia,NA,Altai Krai,2350080,61,2,12466,141
2020-09-13,Russia,NA,Altai Krai,2350080,62,2,12528,143
2020-09-14,Russia,NA,Altai Krai,2350080,60,0,12588,143
2020-09-15,Russia,NA,Altai Krai,2350080,63,9,12651,152
2020-09-16,Russia,NA,Altai Krai,2350080,65,2,12716,154
2020-09-17,Russia,NA,Altai Krai,2350080,64,5,12780,159
2020-09-18,Russia,NA,Altai Krai,2350080,66,2,12846,161
2020-09-19,Russia,NA,Altai Krai,2350080,68,3,12914,164
2020-09-20,Russia,NA,Altai Krai,2350080,73,5,12987,169
2020-09-21,Russia,NA,Altai Krai,2350080,73,4,13060,173
2020-09-22,Russia,NA,Altai Krai,2350080,78,2,13138,175
2020-09-23,Russia,NA,Altai Krai,2350080,79,4,13217,179
2020-04-25,Russia,NA,Altai Republic,215263,5,0,14,0
2020-04-26,Russia,NA,Altai Republic,215263,1,0,15,0
2020-04-27,Russia,NA,Altai Republic,215263,12,0,27,0
2020-04-29,Russia,NA,Altai Republic,215263,3,0,30,0
2020-04-30,Russia,NA,Altai Republic,215263,2,0,32,0
2020-05-01,Russia,NA,Altai Republic,215263,1,0,33,0
2020-05-02,Russia,NA,Altai Republic,215263,2,0,35,0
2020-05-03,Russia,NA,Altai Republic,215263,1,0,36,0
2020-05-05,Russia,NA,Altai Republic,215263,1,0,37,0
2020-05-06,Russia,NA,Altai Republic,215263,1,0,38,0
2020-05-07,Russia,NA,Altai Republic,215263,2,0,40,0
2020-05-08,Russia,NA,Altai Republic,215263,1,0,41,0
2020-05-09,Russia,NA,Altai Republic,215263,10,0,51,0
2020-05-10,Russia,NA,Altai Republic,215263,1,0,52,0
2020-05-11,Russia,NA,Altai Republic,215263,2,0,54,0
2020-05-12,Russia,NA,Altai Republic,215263,2,0,56,0
2020-05-13,Russia,NA,Altai Republic,215263,4,0,60,0
2020-05-14,Russia,NA,Altai Republic,215263,3,0,63,0
2020-05-15,Russia,NA,Altai Republic,215263,2,0,65,0
2020-05-16,Russia,NA,Altai Republic,215263,4,0,69,0
2020-05-17,Russia,NA,Altai Republic,215263,6,0,75,0
2020-05-18,Russia,NA,Altai Republic,215263,3,0,78,0
2020-05-19,Russia,NA,Altai Republic,215263,3,0,81,0
2020-05-20,Russia,NA,Altai Republic,215263,1,0,82,0
2020-05-21,Russia,NA,Altai Republic,215263,6,0,88,0
2020-05-22,Russia,NA,Altai Republic,215263,4,0,92,0
2020-05-24,Russia,NA,Altai Republic,215263,3,0,95,0
2020-05-25,Russia,NA,Altai Republic,215263,7,0,102,0
2020-05-26,Russia,NA,Altai Republic,215263,2,0,104,0
2020-05-27,Russia,NA,Altai Republic,215263,1,0,105,0
2020-05-28,Russia,NA,Altai Republic,215263,4,0,109,0
2020-05-29,Russia,NA,Altai Republic,215263,1,0,110,0
2020-05-30,Russia,NA,Altai Republic,215263,6,0,116,0
2020-05-31,Russia,NA,Altai Republic,215263,6,0,122,0
2020-06-01,Russia,NA,Altai Republic,215263,10,0,132,0
2020-06-02,Russia,NA,Altai Republic,215263,1,0,133,0
2020-06-03,Russia,NA,Altai Republic,215263,5,0,138,0
2020-06-04,Russia,NA,Altai Republic,215263,16,0,154,0
2020-06-05,Russia,NA,Altai Republic,215263,2,0,156,0
2020-06-06,Russia,NA,Altai Republic,215263,7,0,163,0
2020-06-07,Russia,NA,Altai Republic,215263,9,0,172,0
2020-06-08,Russia,NA,Altai Republic,215263,8,0,180,0
2020-06-09,Russia,NA,Altai Republic,215263,10,0,190,0
2020-06-10,Russia,NA,Altai Republic,215263,14,0,204,0
2020-06-11,Russia,NA,Altai Republic,215263,8,0,212,0
2020-06-12,Russia,NA,Altai Republic,215263,8,0,220,0
2020-06-13,Russia,NA,Altai Republic,215263,23,0,243,0
2020-06-14,Russia,NA,Altai Republic,215263,13,0,256,0
2020-06-15,Russia,NA,Altai Republic,215263,19,0,275,0
2020-06-16,Russia,NA,Altai Republic,215263,4,0,279,0
2020-06-17,Russia,NA,Altai Republic,215263,21,0,300,0
2020-06-18,Russia,NA,Altai Republic,215263,34,0,334,0
2020-06-19,Russia,NA,Altai Republic,215263,2,0,336,0
2020-06-20,Russia,NA,Altai Republic,215263,60,0,396,0
2020-06-21,Russia,NA,Altai Republic,215263,25,0,421,0
2020-06-22,Russia,NA,Altai Republic,215263,15,0,436,0
2020-06-23,Russia,NA,Altai Republic,215263,30,0,466,0
2020-06-24,Russia,NA,Altai Republic,215263,17,0,483,0
2020-06-25,Russia,NA,Altai Republic,215263,28,0,511,0
2020-06-26,Russia,NA,Altai Republic,215263,11,0,522,0
2020-06-27,Russia,NA,Altai Republic,215263,39,0,561,0
2020-06-28,Russia,NA,Altai Republic,215263,36,0,597,0
2020-06-29,Russia,NA,Altai Republic,215263,20,0,617,0
2020-06-30,Russia,NA,Altai Republic,215263,33,0,650,0
2020-07-01,Russia,NA,Altai Republic,215263,31,0,681,0
2020-07-02,Russia,NA,Altai Republic,215263,64,0,745,0
2020-07-03,Russia,NA,Altai Republic,215263,32,0,777,0
2020-07-04,Russia,NA,Altai Republic,215263,31,0,808,0
2020-07-05,Russia,NA,Altai Republic,215263,41,0,849,0
2020-07-06,Russia,NA,Altai Republic,215263,20,0,869,0
2020-07-07,Russia,NA,Altai Republic,215263,22,0,891,0
2020-07-08,Russia,NA,Altai Republic,215263,45,0,936,0
2020-07-09,Russia,NA,Altai Republic,215263,26,0,962,0
2020-07-10,Russia,NA,Altai Republic,215263,31,0,993,0
2020-07-11,Russia,NA,Altai Republic,215263,43,0,1036,0
2020-07-12,Russia,NA,Altai Republic,215263,17,0,1053,0
2020-07-13,Russia,NA,Altai Republic,215263,46,0,1099,0
2020-07-14,Russia,NA,Altai Republic,215263,12,0,1111,0
2020-07-15,Russia,NA,Altai Republic,215263,28,0,1139,0
2020-07-16,Russia,NA,Altai Republic,215263,15,0,1154,0
2020-07-17,Russia,NA,Altai Republic,215263,43,0,1197,0
2020-07-18,Russia,NA,Altai Republic,215263,20,0,1217,0
2020-07-19,Russia,NA,Altai Republic,215263,22,0,1239,0
2020-07-20,Russia,NA,Altai Republic,215263,37,0,1276,0
2020-07-21,Russia,NA,Altai Republic,215263,28,0,1304,0
2020-07-22,Russia,NA,Altai Republic,215263,27,0,1331,0
2020-07-23,Russia,NA,Altai Republic,215263,20,0,1351,0
2020-07-24,Russia,NA,Altai Republic,215263,36,0,1387,0
2020-07-25,Russia,NA,Altai Republic,215263,32,0,1419,0
2020-07-26,Russia,NA,Altai Republic,215263,18,0,1437,0
2020-07-27,Russia,NA,Altai Republic,215263,25,0,1462,0
2020-07-28,Russia,NA,Altai Republic,215263,14,0,1476,0
2020-07-29,Russia,NA,Altai Republic,215263,22,0,1498,0
2020-07-30,Russia,NA,Altai Republic,215263,31,0,1529,0
2020-07-31,Russia,NA,Altai Republic,215263,22,0,1551,0
2020-08-01,Russia,NA,Altai Republic,215263,28,0,1579,0
2020-08-02,Russia,NA,Altai Republic,215263,27,0,1606,0
2020-04-17,Russia,NA,Amur Oblast,798424,2,0,11,0
2020-04-18,Russia,NA,Amur Oblast,798424,3,0,14,0
2020-04-19,Russia,NA,Amur Oblast,798424,2,0,16,0
2020-04-20,Russia,NA,Amur Oblast,798424,4,0,20,0
2020-04-22,Russia,NA,Amur Oblast,798424,3,0,23,0
2020-04-23,Russia,NA,Amur Oblast,798424,2,0,25,0
2020-04-24,Russia,NA,Amur Oblast,798424,3,0,28,0
2020-04-25,Russia,NA,Amur Oblast,798424,5,0,33,0
2020-04-26,Russia,NA,Amur Oblast,798424,3,0,36,0
2020-04-27,Russia,NA,Amur Oblast,798424,4,0,40,0
2020-04-28,Russia,NA,Amur Oblast,798424,1,0,41,0
2020-04-29,Russia,NA,Amur Oblast,798424,5,0,46,0
2020-04-30,Russia,NA,Amur Oblast,798424,10,0,56,0
2020-05-01,Russia,NA,Amur Oblast,798424,11,0,67,0
2020-05-02,Russia,NA,Amur Oblast,798424,5,0,72,0
2020-05-03,Russia,NA,Amur Oblast,798424,7,0,79,0
2020-05-04,Russia,NA,Amur Oblast,798424,5,0,84,0
2020-05-05,Russia,NA,Amur Oblast,798424,14,0,98,0
2020-05-06,Russia,NA,Amur Oblast,798424,8,0,106,0
2020-05-07,Russia,NA,Amur Oblast,798424,6,0,112,0
2020-05-08,Russia,NA,Amur Oblast,798424,11,0,123,0
2020-05-09,Russia,NA,Amur Oblast,798424,12,0,135,0
2020-05-10,Russia,NA,Amur Oblast,798424,5,0,140,0
2020-05-11,Russia,NA,Amur Oblast,798424,12,0,152,0
2020-05-12,Russia,NA,Amur Oblast,798424,17,0,169,0
2020-05-13,Russia,NA,Amur Oblast,798424,13,0,182,0
2020-05-14,Russia,NA,Amur Oblast,798424,12,0,194,0
2020-05-15,Russia,NA,Amur Oblast,798424,10,0,204,0
2020-05-16,Russia,NA,Amur Oblast,798424,8,0,212,0
2020-05-17,Russia,NA,Amur Oblast,798424,10,0,222,0
2020-05-18,Russia,NA,Amur Oblast,798424,16,0,238,0
2020-05-19,Russia,NA,Amur Oblast,798424,9,0,247,0
2020-05-20,Russia,NA,Amur Oblast,798424,30,0,277,0
2020-05-21,Russia,NA,Amur Oblast,798424,17,0,294,0
2020-05-22,Russia,NA,Amur Oblast,798424,23,0,317,0
2020-05-23,Russia,NA,Amur Oblast,798424,23,0,340,0
2020-05-24,Russia,NA,Amur Oblast,798424,15,0,355,0
2020-05-25,Russia,NA,Amur Oblast,798424,30,0,385,0
2020-05-26,Russia,NA,Amur Oblast,798424,16,0,401,0
2020-05-27,Russia,NA,Amur Oblast,798424,13,0,414,0
2020-05-28,Russia,NA,Amur Oblast,798424,19,0,433,0
2020-05-29,Russia,NA,Amur Oblast,798424,28,0,461,0
2020-05-30,Russia,NA,Amur Oblast,798424,25,0,486,0
2020-05-31,Russia,NA,Amur Oblast,798424,20,0,506,0
2020-06-01,Russia,NA,Amur Oblast,798424,22,0,528,0
2020-06-02,Russia,NA,Amur Oblast,798424,18,0,546,0
2020-06-03,Russia,NA,Amur Oblast,798424,20,0,566,0
2020-06-04,Russia,NA,Amur Oblast,798424,22,0,588,0
2020-06-05,Russia,NA,Amur Oblast,798424,27,0,615,0
2020-06-06,Russia,NA,Amur Oblast,798424,42,0,657,0
2020-06-07,Russia,NA,Amur Oblast,798424,45,0,702,0
2020-06-08,Russia,NA,Amur Oblast,798424,46,0,748,0
2020-06-09,Russia,NA,Amur Oblast,798424,48,0,796,0
2020-06-10,Russia,NA,Amur Oblast,798424,39,0,835,0
2020-06-11,Russia,NA,Amur Oblast,798424,38,0,873,0
2020-06-12,Russia,NA,Amur Oblast,798424,41,0,914,0
2020-06-13,Russia,NA,Amur Oblast,798424,59,0,973,0
2020-06-14,Russia,NA,Amur Oblast,798424,45,0,1018,0
2020-06-15,Russia,NA,Amur Oblast,798424,44,0,1062,0
2020-06-16,Russia,NA,Amur Oblast,798424,38,0,1100,0
2020-06-17,Russia,NA,Amur Oblast,798424,38,0,1138,0
2020-06-18,Russia,NA,Amur Oblast,798424,43,0,1181,0
2020-06-19,Russia,NA,Amur Oblast,798424,49,0,1230,0
2020-06-20,Russia,NA,Amur Oblast,798424,53,0,1283,0
2020-06-21,Russia,NA,Amur Oblast,798424,57,0,1340,0
2020-06-22,Russia,NA,Amur Oblast,798424,59,0,1399,0
2020-06-23,Russia,NA,Amur Oblast,798424,45,0,1444,0
2020-06-24,Russia,NA,Amur Oblast,798424,46,0,1490,0
2020-06-25,Russia,NA,Amur Oblast,798424,38,0,1528,0
2020-06-26,Russia,NA,Amur Oblast,798424,44,0,1572,0
2020-06-27,Russia,NA,Amur Oblast,798424,38,0,1610,0
2020-06-28,Russia,NA,Amur Oblast,798424,41,0,1651,0
2020-06-29,Russia,NA,Amur Oblast,798424,31,0,1682,0
2020-06-30,Russia,NA,Amur Oblast,798424,25,0,1707,0
2020-07-01,Russia,NA,Amur Oblast,798424,27,0,1734,0
2020-07-02,Russia,NA,Amur Oblast,798424,31,0,1765,0
2020-07-03,Russia,NA,Amur Oblast,798424,30,0,1795,0
2020-07-04,Russia,NA,Amur Oblast,798424,31,0,1826,0
2020-07-05,Russia,NA,Amur Oblast,798424,34,0,1860,0
2020-07-06,Russia,NA,Amur Oblast,798424,29,0,1889,0
2020-07-07,Russia,NA,Amur Oblast,798424,28,0,1917,0
2020-07-08,Russia,NA,Amur Oblast,798424,27,0,1944,0
2020-07-09,Russia,NA,Amur Oblast,798424,31,0,1975,0
2020-07-10,Russia,NA,Amur Oblast,798424,44,0,2019,0
2020-07-11,Russia,NA,Amur Oblast,798424,38,0,2057,0
2020-07-12,Russia,NA,Amur Oblast,798424,40,0,2097,0
2020-07-13,Russia,NA,Amur Oblast,798424,46,0,2143,0
2020-07-14,Russia,NA,Amur Oblast,798424,42,0,2185,0
2020-07-15,Russia,NA,Amur Oblast,798424,42,0,2227,0
2020-07-16,Russia,NA,Amur Oblast,798424,44,0,2271,0
2020-07-17,Russia,NA,Amur Oblast,798424,43,0,2314,0
2020-07-18,Russia,NA,Amur Oblast,798424,40,0,2354,0
2020-07-19,Russia,NA,Amur Oblast,798424,39,0,2393,0
2020-07-20,Russia,NA,Amur Oblast,798424,30,0,2423,0
2020-07-21,Russia,NA,Amur Oblast,798424,28,0,2451,0
2020-07-22,Russia,NA,Amur Oblast,798424,27,0,2478,0
2020-07-23,Russia,NA,Amur Oblast,798424,28,0,2506,0
2020-07-24,Russia,NA,Amur Oblast,798424,28,0,2534,0
2020-07-25,Russia,NA,Amur Oblast,798424,32,0,2566,0
2020-07-26,Russia,NA,Amur Oblast,798424,34,0,2600,0
2020-07-27,Russia,NA,Amur Oblast,798424,32,0,2632,0
2020-07-28,Russia,NA,Amur Oblast,798424,28,0,2660,0
2020-07-29,Russia,NA,Amur Oblast,798424,29,0,2689,0
2020-07-30,Russia,NA,Amur Oblast,798424,35,0,2724,0
2020-07-31,Russia,NA,Amur Oblast,798424,28,0,2752,0
2020-08-01,Russia,NA,Amur Oblast,798424,24,0,2776,0
2020-08-02,Russia,NA,Amur Oblast,798424,25,0,2801,0
2020-08-26,Russia,NA,Amur Oblast,798424,0,0,3250,47
2020-08-27,Russia,NA,Amur Oblast,798424,24,0,3274,47
2020-08-28,Russia,NA,Amur Oblast,798424,25,0,3299,47
2020-08-29,Russia,NA,Amur Oblast,798424,27,0,3326,47
2020-08-30,Russia,NA,Amur Oblast,798424,29,0,3355,47
2020-08-31,Russia,NA,Amur Oblast,798424,31,0,3386,47
2020-09-01,Russia,NA,Amur Oblast,798424,32,0,3418,47
2020-09-02,Russia,NA,Amur Oblast,798424,31,0,3449,47
2020-09-03,Russia,NA,Amur Oblast,798424,30,0,3479,47
2020-09-04,Russia,NA,Amur Oblast,798424,29,0,3508,47
2020-09-05,Russia,NA,Amur Oblast,798424,29,0,3537,47
2020-09-06,Russia,NA,Amur Oblast,798424,35,0,3572,47
2020-09-07,Russia,NA,Amur Oblast,798424,36,0,3608,47
2020-09-08,Russia,NA,Amur Oblast,798424,33,0,3641,47
2020-09-09,Russia,NA,Amur Oblast,798424,30,2,3671,49
2020-09-10,Russia,NA,Amur Oblast,798424,29,1,3700,50
2020-09-11,Russia,NA,Amur Oblast,798424,31,0,3731,50
2020-09-12,Russia,NA,Amur Oblast,798424,30,0,3761,50
2020-09-13,Russia,NA,Amur Oblast,798424,28,0,3789,50
2020-09-14,Russia,NA,Amur Oblast,798424,27,0,3816,50
2020-09-15,Russia,NA,Amur Oblast,798424,26,0,3842,50
2020-09-16,Russia,NA,Amur Oblast,798424,25,0,3867,50
2020-09-17,Russia,NA,Amur Oblast,798424,28,0,3895,50
2020-09-18,Russia,NA,Amur Oblast,798424,33,0,3928,50
2020-09-19,Russia,NA,Amur Oblast,798424,31,0,3959,50
2020-09-20,Russia,NA,Amur Oblast,798424,30,0,3989,50
2020-09-21,Russia,NA,Amur Oblast,798424,32,0,4021,50
2020-09-22,Russia,NA,Amur Oblast,798424,29,0,4050,50
2020-09-23,Russia,NA,Amur Oblast,798424,28,0,4078,50
2020-04-06,Russia,NA,Arkhangelsk Oblast,1155028,6,0,14,0
2020-04-09,Russia,NA,Arkhangelsk Oblast,1155028,10,0,24,0
2020-04-13,Russia,NA,Arkhangelsk Oblast,1155028,7,0,31,0
2020-04-14,Russia,NA,Arkhangelsk Oblast,1155028,1,0,32,0
2020-04-16,Russia,NA,Arkhangelsk Oblast,1155028,1,0,33,0
2020-04-17,Russia,NA,Arkhangelsk Oblast,1155028,1,0,34,0
2020-04-18,Russia,NA,Arkhangelsk Oblast,1155028,5,0,39,0
2020-04-19,Russia,NA,Arkhangelsk Oblast,1155028,68,0,107,0
2020-04-20,Russia,NA,Arkhangelsk Oblast,1155028,7,0,114,0
2020-04-21,Russia,NA,Arkhangelsk Oblast,1155028,4,0,118,0
2020-04-22,Russia,NA,Arkhangelsk Oblast,1155028,2,0,120,0
2020-04-23,Russia,NA,Arkhangelsk Oblast,1155028,3,0,123,0
2020-04-24,Russia,NA,Arkhangelsk Oblast,1155028,14,0,137,0
2020-04-25,Russia,NA,Arkhangelsk Oblast,1155028,10,0,147,0
2020-04-26,Russia,NA,Arkhangelsk Oblast,1155028,20,0,167,0
2020-04-27,Russia,NA,Arkhangelsk Oblast,1155028,8,0,175,0
2020-04-28,Russia,NA,Arkhangelsk Oblast,1155028,6,0,181,0
2020-04-29,Russia,NA,Arkhangelsk Oblast,1155028,4,0,185,0
2020-04-30,Russia,NA,Arkhangelsk Oblast,1155028,13,0,198,0
2020-05-01,Russia,NA,Arkhangelsk Oblast,1155028,15,0,213,0
2020-05-02,Russia,NA,Arkhangelsk Oblast,1155028,25,0,238,0
2020-05-03,Russia,NA,Arkhangelsk Oblast,1155028,22,0,260,0
2020-05-04,Russia,NA,Arkhangelsk Oblast,1155028,39,0,299,0
2020-05-05,Russia,NA,Arkhangelsk Oblast,1155028,6,0,305,0
2020-05-06,Russia,NA,Arkhangelsk Oblast,1155028,24,0,329,0
2020-05-07,Russia,NA,Arkhangelsk Oblast,1155028,25,0,354,0
2020-05-08,Russia,NA,Arkhangelsk Oblast,1155028,18,0,372,0
2020-05-09,Russia,NA,Arkhangelsk Oblast,1155028,28,0,400,0
2020-05-10,Russia,NA,Arkhangelsk Oblast,1155028,25,0,425,0
2020-05-11,Russia,NA,Arkhangelsk Oblast,1155028,32,0,457,0
2020-05-12,Russia,NA,Arkhangelsk Oblast,1155028,37,0,494,0
2020-05-13,Russia,NA,Arkhangelsk Oblast,1155028,19,0,513,0
2020-05-14,Russia,NA,Arkhangelsk Oblast,1155028,41,0,554,0
2020-05-15,Russia,NA,Arkhangelsk Oblast,1155028,32,0,586,0
2020-05-16,Russia,NA,Arkhangelsk Oblast,1155028,52,0,638,0
2020-05-17,Russia,NA,Arkhangelsk Oblast,1155028,50,0,688,0
2020-05-18,Russia,NA,Arkhangelsk Oblast,1155028,32,0,720,0
2020-05-19,Russia,NA,Arkhangelsk Oblast,1155028,72,0,792,0
2020-05-20,Russia,NA,Arkhangelsk Oblast,1155028,25,0,817,0
2020-05-21,Russia,NA,Arkhangelsk Oblast,1155028,41,0,858,0
2020-05-22,Russia,NA,Arkhangelsk Oblast,1155028,30,0,888,0
2020-05-23,Russia,NA,Arkhangelsk Oblast,1155028,37,0,925,0
2020-05-24,Russia,NA,Arkhangelsk Oblast,1155028,95,0,1020,0
2020-05-25,Russia,NA,Arkhangelsk Oblast,1155028,126,0,1146,0
2020-05-26,Russia,NA,Arkhangelsk Oblast,1155028,169,0,1315,0
2020-05-27,Russia,NA,Arkhangelsk Oblast,1155028,95,0,1410,0
2020-05-28,Russia,NA,Arkhangelsk Oblast,1155028,127,0,1537,0
2020-05-29,Russia,NA,Arkhangelsk Oblast,1155028,101,0,1638,0
2020-05-30,Russia,NA,Arkhangelsk Oblast,1155028,158,0,1796,0
2020-05-31,Russia,NA,Arkhangelsk Oblast,1155028,137,0,1933,0
2020-06-01,Russia,NA,Arkhangelsk Oblast,1155028,135,0,2068,0
2020-06-02,Russia,NA,Arkhangelsk Oblast,1155028,56,0,2124,0
2020-06-03,Russia,NA,Arkhangelsk Oblast,1155028,239,0,2363,0
2020-06-04,Russia,NA,Arkhangelsk Oblast,1155028,133,0,2496,0
2020-06-05,Russia,NA,Arkhangelsk Oblast,1155028,125,0,2621,0
2020-06-06,Russia,NA,Arkhangelsk Oblast,1155028,125,0,2746,0
2020-06-07,Russia,NA,Arkhangelsk Oblast,1155028,122,0,2868,0
2020-06-08,Russia,NA,Arkhangelsk Oblast,1155028,121,0,2989,0
2020-06-09,Russia,NA,Arkhangelsk Oblast,1155028,96,0,3085,0
2020-06-10,Russia,NA,Arkhangelsk Oblast,1155028,132,0,3217,0
2020-06-11,Russia,NA,Arkhangelsk Oblast,1155028,145,0,3362,0
2020-06-12,Russia,NA,Arkhangelsk Oblast,1155028,112,0,3474,0
2020-06-13,Russia,NA,Arkhangelsk Oblast,1155028,113,0,3587,0
2020-06-14,Russia,NA,Arkhangelsk Oblast,1155028,109,0,3696,0
2020-06-15,Russia,NA,Arkhangelsk Oblast,1155028,107,0,3803,0
2020-06-16,Russia,NA,Arkhangelsk Oblast,1155028,109,0,3912,0
2020-06-17,Russia,NA,Arkhangelsk Oblast,1155028,123,0,4035,0
2020-06-18,Russia,NA,Arkhangelsk Oblast,1155028,121,0,4156,0
2020-06-19,Russia,NA,Arkhangelsk Oblast,1155028,118,0,4274,0
2020-06-20,Russia,NA,Arkhangelsk Oblast,1155028,121,0,4395,0
2020-06-21,Russia,NA,Arkhangelsk Oblast,1155028,129,0,4524,0
2020-06-22,Russia,NA,Arkhangelsk Oblast,1155028,107,0,4631,0
2020-06-23,Russia,NA,Arkhangelsk Oblast,1155028,124,0,4755,0
2020-06-24,Russia,NA,Arkhangelsk Oblast,1155028,120,0,4875,0
2020-06-25,Russia,NA,Arkhangelsk Oblast,1155028,117,0,4992,0
2020-06-26,Russia,NA,Arkhangelsk Oblast,1155028,115,0,5107,0
2020-06-27,Russia,NA,Arkhangelsk Oblast,1155028,118,0,5225,0
2020-06-28,Russia,NA,Arkhangelsk Oblast,1155028,114,0,5339,0
2020-06-29,Russia,NA,Arkhangelsk Oblast,1155028,115,0,5454,0
2020-06-30,Russia,NA,Arkhangelsk Oblast,1155028,102,0,5556,0
2020-07-01,Russia,NA,Arkhangelsk Oblast,1155028,118,0,5674,0
2020-07-02,Russia,NA,Arkhangelsk Oblast,1155028,116,0,5790,0
2020-07-03,Russia,NA,Arkhangelsk Oblast,1155028,119,0,5909,0
2020-07-04,Russia,NA,Arkhangelsk Oblast,1155028,117,0,6026,0
2020-07-05,Russia,NA,Arkhangelsk Oblast,1155028,170,0,6196,0
2020-07-06,Russia,NA,Arkhangelsk Oblast,1155028,104,0,6300,0
2020-07-07,Russia,NA,Arkhangelsk Oblast,1155028,119,0,6419,0
2020-07-08,Russia,NA,Arkhangelsk Oblast,1155028,115,0,6534,0
2020-07-09,Russia,NA,Arkhangelsk Oblast,1155028,113,0,6647,0
2020-07-10,Russia,NA,Arkhangelsk Oblast,1155028,112,0,6759,0
2020-07-11,Russia,NA,Arkhangelsk Oblast,1155028,114,0,6873,0
2020-07-12,Russia,NA,Arkhangelsk Oblast,1155028,115,0,6988,0
2020-07-13,Russia,NA,Arkhangelsk Oblast,1155028,134,0,7122,0
2020-07-14,Russia,NA,Arkhangelsk Oblast,1155028,129,0,7251,0
2020-07-15,Russia,NA,Arkhangelsk Oblast,1155028,119,0,7370,0
2020-07-16,Russia,NA,Arkhangelsk Oblast,1155028,122,0,7492,0
2020-07-17,Russia,NA,Arkhangelsk Oblast,1155028,116,0,7608,0
2020-07-18,Russia,NA,Arkhangelsk Oblast,1155028,104,0,7712,0
2020-07-19,Russia,NA,Arkhangelsk Oblast,1155028,107,0,7819,0
2020-07-20,Russia,NA,Arkhangelsk Oblast,1155028,89,0,7908,0
2020-07-21,Russia,NA,Arkhangelsk Oblast,1155028,81,0,7989,0
2020-07-22,Russia,NA,Arkhangelsk Oblast,1155028,92,0,8081,0
2020-07-23,Russia,NA,Arkhangelsk Oblast,1155028,76,0,8157,0
2020-07-24,Russia,NA,Arkhangelsk Oblast,1155028,68,0,8225,0
2020-07-25,Russia,NA,Arkhangelsk Oblast,1155028,66,0,8291,0
2020-07-26,Russia,NA,Arkhangelsk Oblast,1155028,74,0,8365,0
2020-07-27,Russia,NA,Arkhangelsk Oblast,1155028,69,0,8434,0
2020-07-28,Russia,NA,Arkhangelsk Oblast,1155028,63,0,8497,0
2020-07-29,Russia,NA,Arkhangelsk Oblast,1155028,68,0,8565,0
2020-07-30,Russia,NA,Arkhangelsk Oblast,1155028,76,0,8641,0
2020-07-31,Russia,NA,Arkhangelsk Oblast,1155028,69,0,8710,0
2020-08-01,Russia,NA,Arkhangelsk Oblast,1155028,57,0,8767,0
2020-08-02,Russia,NA,Arkhangelsk Oblast,1155028,75,0,8842,0
2020-08-26,Russia,NA,Arkhangelsk Oblast,1155028,0,0,10442,245
2020-08-27,Russia,NA,Arkhangelsk Oblast,1155028,73,3,10515,248
2020-08-28,Russia,NA,Arkhangelsk Oblast,1155028,87,1,10602,249
2020-08-29,Russia,NA,Arkhangelsk Oblast,1155028,100,2,10702,251
2020-08-30,Russia,NA,Arkhangelsk Oblast,1155028,81,0,10783,251
2020-08-31,Russia,NA,Arkhangelsk Oblast,1155028,42,0,10825,251
2020-09-01,Russia,NA,Arkhangelsk Oblast,1155028,63,1,10888,252
2020-09-02,Russia,NA,Arkhangelsk Oblast,1155028,49,0,10937,252
2020-09-03,Russia,NA,Arkhangelsk Oblast,1155028,48,0,10985,252
2020-09-04,Russia,NA,Arkhangelsk Oblast,1155028,74,0,11059,252
2020-09-05,Russia,NA,Arkhangelsk Oblast,1155028,72,2,11131,254
2020-09-06,Russia,NA,Arkhangelsk Oblast,1155028,60,1,11191,255
2020-09-07,Russia,NA,Arkhangelsk Oblast,1155028,78,0,11269,255
2020-09-08,Russia,NA,Arkhangelsk Oblast,1155028,68,0,11337,255
2020-09-09,Russia,NA,Arkhangelsk Oblast,1155028,69,0,11406,255
2020-09-10,Russia,NA,Arkhangelsk Oblast,1155028,85,1,11491,256
2020-09-11,Russia,NA,Arkhangelsk Oblast,1155028,83,0,11574,256
2020-09-12,Russia,NA,Arkhangelsk Oblast,1155028,83,0,11657,256
2020-09-13,Russia,NA,Arkhangelsk Oblast,1155028,96,0,11753,256
2020-09-14,Russia,NA,Arkhangelsk Oblast,1155028,91,0,11844,256
2020-09-15,Russia,NA,Arkhangelsk Oblast,1155028,88,0,11932,256
2020-09-16,Russia,NA,Arkhangelsk Oblast,1155028,75,1,12007,257
2020-09-17,Russia,NA,Arkhangelsk Oblast,1155028,83,0,12090,257
2020-09-18,Russia,NA,Arkhangelsk Oblast,1155028,103,0,12193,257
2020-09-19,Russia,NA,Arkhangelsk Oblast,1155028,97,0,12290,257
2020-09-20,Russia,NA,Arkhangelsk Oblast,1155028,94,0,12384,257
2020-09-21,Russia,NA,Arkhangelsk Oblast,1155028,97,0,12481,257
2020-09-22,Russia,NA,Arkhangelsk Oblast,1155028,81,1,12562,258
2020-09-23,Russia,NA,Arkhangelsk Oblast,1155028,91,0,12653,258
2020-04-09,Russia,NA,Astrakhan Oblast,1017514,16,0,21,0
2020-04-12,Russia,NA,Astrakhan Oblast,1017514,8,0,29,0
2020-04-13,Russia,NA,Astrakhan Oblast,1017514,1,0,30,0
2020-04-15,Russia,NA,Astrakhan Oblast,1017514,17,0,47,0
2020-04-16,Russia,NA,Astrakhan Oblast,1017514,13,0,60,0
2020-04-17,Russia,NA,Astrakhan Oblast,1017514,4,0,64,0
2020-04-18,Russia,NA,Astrakhan Oblast,1017514,35,0,99,0
2020-04-19,Russia,NA,Astrakhan Oblast,1017514,24,0,123,0
2020-04-20,Russia,NA,Astrakhan Oblast,1017514,13,0,136,0
2020-04-21,Russia,NA,Astrakhan Oblast,1017514,1,0,137,0
2020-04-22,Russia,NA,Astrakhan Oblast,1017514,11,0,148,0
2020-04-23,Russia,NA,Astrakhan Oblast,1017514,17,0,165,0
2020-04-24,Russia,NA,Astrakhan Oblast,1017514,21,0,186,0
2020-04-25,Russia,NA,Astrakhan Oblast,1017514,25,0,211,0
2020-04-26,Russia,NA,Astrakhan Oblast,1017514,66,0,277,0
2020-04-27,Russia,NA,Astrakhan Oblast,1017514,21,0,298,0
2020-04-28,Russia,NA,Astrakhan Oblast,1017514,8,0,306,0
2020-04-29,Russia,NA,Astrakhan Oblast,1017514,44,0,350,0
2020-04-30,Russia,NA,Astrakhan Oblast,1017514,15,0,365,0
2020-05-01,Russia,NA,Astrakhan Oblast,1017514,19,0,384,0
2020-05-02,Russia,NA,Astrakhan Oblast,1017514,27,0,411,0
2020-05-03,Russia,NA,Astrakhan Oblast,1017514,76,0,487,0
2020-05-04,Russia,NA,Astrakhan Oblast,1017514,17,0,504,0
2020-05-05,Russia,NA,Astrakhan Oblast,1017514,31,0,535,0
2020-05-06,Russia,NA,Astrakhan Oblast,1017514,29,0,564,0
2020-05-07,Russia,NA,Astrakhan Oblast,1017514,25,0,589,0
2020-05-08,Russia,NA,Astrakhan Oblast,1017514,40,0,629,0
2020-05-09,Russia,NA,Astrakhan Oblast,1017514,44,0,673,0
2020-05-10,Russia,NA,Astrakhan Oblast,1017514,58,0,731,0
2020-05-11,Russia,NA,Astrakhan Oblast,1017514,33,0,764,0
2020-05-12,Russia,NA,Astrakhan Oblast,1017514,42,0,806,0
2020-05-13,Russia,NA,Astrakhan Oblast,1017514,44,0,850,0
2020-05-14,Russia,NA,Astrakhan Oblast,1017514,45,0,895,0
2020-05-15,Russia,NA,Astrakhan Oblast,1017514,50,0,945,0
2020-05-16,Russia,NA,Astrakhan Oblast,1017514,39,0,984,0
2020-05-17,Russia,NA,Astrakhan Oblast,1017514,45,0,1029,0
2020-05-18,Russia,NA,Astrakhan Oblast,1017514,36,0,1065,0
2020-05-19,Russia,NA,Astrakhan Oblast,1017514,34,0,1099,0
2020-05-20,Russia,NA,Astrakhan Oblast,1017514,55,0,1154,0
2020-05-21,Russia,NA,Astrakhan Oblast,1017514,48,0,1202,0
2020-05-22,Russia,NA,Astrakhan Oblast,1017514,45,0,1247,0
2020-05-23,Russia,NA,Astrakhan Oblast,1017514,51,0,1298,0
2020-05-24,Russia,NA,Astrakhan Oblast,1017514,50,0,1348,0
2020-05-25,Russia,NA,Astrakhan Oblast,1017514,153,0,1501,0
2020-05-26,Russia,NA,Astrakhan Oblast,1017514,57,0,1558,0
2020-05-27,Russia,NA,Astrakhan Oblast,1017514,38,0,1596,0
2020-05-28,Russia,NA,Astrakhan Oblast,1017514,18,0,1614,0
2020-05-29,Russia,NA,Astrakhan Oblast,1017514,40,0,1654,0
2020-05-30,Russia,NA,Astrakhan Oblast,1017514,39,0,1693,0
2020-05-31,Russia,NA,Astrakhan Oblast,1017514,59,0,1752,0
2020-06-01,Russia,NA,Astrakhan Oblast,1017514,131,0,1883,0
2020-06-02,Russia,NA,Astrakhan Oblast,1017514,54,0,1937,0
2020-06-03,Russia,NA,Astrakhan Oblast,1017514,67,0,2004,0
2020-06-04,Russia,NA,Astrakhan Oblast,1017514,93,0,2097,0
2020-06-05,Russia,NA,Astrakhan Oblast,1017514,75,0,2172,0
2020-06-06,Russia,NA,Astrakhan Oblast,1017514,61,0,2233,0
2020-06-07,Russia,NA,Astrakhan Oblast,1017514,60,0,2293,0
2020-06-08,Russia,NA,Astrakhan Oblast,1017514,44,0,2337,0
2020-06-09,Russia,NA,Astrakhan Oblast,1017514,83,0,2420,0
2020-06-10,Russia,NA,Astrakhan Oblast,1017514,81,0,2501,0
2020-06-11,Russia,NA,Astrakhan Oblast,1017514,85,0,2586,0
2020-06-12,Russia,NA,Astrakhan Oblast,1017514,44,0,2630,0
2020-06-13,Russia,NA,Astrakhan Oblast,1017514,44,0,2674,0
2020-06-14,Russia,NA,Astrakhan Oblast,1017514,59,0,2733,0
2020-06-15,Russia,NA,Astrakhan Oblast,1017514,61,0,2794,0
2020-06-16,Russia,NA,Astrakhan Oblast,1017514,68,0,2862,0
2020-06-17,Russia,NA,Astrakhan Oblast,1017514,65,0,2927,0
2020-06-18,Russia,NA,Astrakhan Oblast,1017514,60,0,2987,0
2020-06-19,Russia,NA,Astrakhan Oblast,1017514,59,0,3046,0
2020-06-20,Russia,NA,Astrakhan Oblast,1017514,57,0,3103,0
2020-06-21,Russia,NA,Astrakhan Oblast,1017514,55,0,3158,0
2020-06-22,Russia,NA,Astrakhan Oblast,1017514,48,0,3206,0
2020-06-23,Russia,NA,Astrakhan Oblast,1017514,36,0,3242,0
2020-06-24,Russia,NA,Astrakhan Oblast,1017514,33,0,3275,0
2020-06-25,Russia,NA,Astrakhan Oblast,1017514,32,0,3307,0
2020-06-26,Russia,NA,Astrakhan Oblast,1017514,40,0,3347,0
2020-06-27,Russia,NA,Astrakhan Oblast,1017514,35,0,3382,0
2020-06-28,Russia,NA,Astrakhan Oblast,1017514,37,0,3419,0
2020-06-29,Russia,NA,Astrakhan Oblast,1017514,29,0,3448,0
2020-06-30,Russia,NA,Astrakhan Oblast,1017514,31,0,3479,0
2020-07-01,Russia,NA,Astrakhan Oblast,1017514,34,0,3513,0
2020-07-02,Russia,NA,Astrakhan Oblast,1017514,35,0,3548,0
2020-07-03,Russia,NA,Astrakhan Oblast,1017514,29,0,3577,0
2020-07-04,Russia,NA,Astrakhan Oblast,1017514,40,0,3617,0
2020-07-05,Russia,NA,Astrakhan Oblast,1017514,39,0,3656,0
2020-07-06,Russia,NA,Astrakhan Oblast,1017514,42,0,3698,0
2020-07-07,Russia,NA,Astrakhan Oblast,1017514,40,0,3738,0
2020-07-08,Russia,NA,Astrakhan Oblast,1017514,35,0,3773,0
2020-07-09,Russia,NA,Astrakhan Oblast,1017514,33,0,3806,0
2020-07-10,Russia,NA,Astrakhan Oblast,1017514,36,0,3842,0
2020-07-11,Russia,NA,Astrakhan Oblast,1017514,31,0,3873,0
2020-07-12,Russia,NA,Astrakhan Oblast,1017514,37,0,3910,0
2020-07-13,Russia,NA,Astrakhan Oblast,1017514,33,0,3943,0
2020-07-14,Russia,NA,Astrakhan Oblast,1017514,34,0,3977,0
2020-07-15,Russia,NA,Astrakhan Oblast,1017514,36,0,4013,0
2020-07-16,Russia,NA,Astrakhan Oblast,1017514,32,0,4045,0
2020-07-17,Russia,NA,Astrakhan Oblast,1017514,41,0,4086,0
2020-07-18,Russia,NA,Astrakhan Oblast,1017514,58,0,4144,0
2020-07-19,Russia,NA,Astrakhan Oblast,1017514,32,0,4176,0
2020-07-20,Russia,NA,Astrakhan Oblast,1017514,37,0,4213,0
2020-07-21,Russia,NA,Astrakhan Oblast,1017514,32,0,4245,0
2020-07-22,Russia,NA,Astrakhan Oblast,1017514,35,0,4280,0
2020-07-23,Russia,NA,Astrakhan Oblast,1017514,31,0,4311,0
2020-07-24,Russia,NA,Astrakhan Oblast,1017514,30,0,4341,0
2020-07-25,Russia,NA,Astrakhan Oblast,1017514,30,0,4371,0
2020-07-26,Russia,NA,Astrakhan Oblast,1017514,34,0,4405,0
2020-07-27,Russia,NA,Astrakhan Oblast,1017514,32,0,4437,0
2020-07-28,Russia,NA,Astrakhan Oblast,1017514,36,0,4473,0
2020-07-29,Russia,NA,Astrakhan Oblast,1017514,30,0,4503,0
2020-07-30,Russia,NA,Astrakhan Oblast,1017514,35,0,4538,0
2020-07-31,Russia,NA,Astrakhan Oblast,1017514,31,0,4569,0
2020-08-01,Russia,NA,Astrakhan Oblast,1017514,51,0,4620,0
2020-08-02,Russia,NA,Astrakhan Oblast,1017514,37,0,4657,0
2020-08-26,Russia,NA,Astrakhan Oblast,1017514,0,0,5508,68
2020-08-27,Russia,NA,Astrakhan Oblast,1017514,43,1,5551,69
2020-08-28,Russia,NA,Astrakhan Oblast,1017514,40,1,5591,70
2020-08-29,Russia,NA,Astrakhan Oblast,1017514,37,2,5628,72
2020-08-30,Russia,NA,Astrakhan Oblast,1017514,30,0,5658,72
2020-08-31,Russia,NA,Astrakhan Oblast,1017514,35,1,5693,73
2020-09-01,Russia,NA,Astrakhan Oblast,1017514,37,1,5730,74
2020-09-02,Russia,NA,Astrakhan Oblast,1017514,41,1,5771,75
2020-09-03,Russia,NA,Astrakhan Oblast,1017514,38,0,5809,75
2020-09-04,Russia,NA,Astrakhan Oblast,1017514,35,2,5844,77
2020-09-05,Russia,NA,Astrakhan Oblast,1017514,50,2,5894,79
2020-09-06,Russia,NA,Astrakhan Oblast,1017514,41,0,5935,79
2020-09-07,Russia,NA,Astrakhan Oblast,1017514,43,1,5978,80
2020-09-08,Russia,NA,Astrakhan Oblast,1017514,48,1,6026,81
2020-09-09,Russia,NA,Astrakhan Oblast,1017514,50,1,6076,82
2020-09-10,Russia,NA,Astrakhan Oblast,1017514,39,2,6115,84
2020-09-11,Russia,NA,Astrakhan Oblast,1017514,53,1,6168,85
2020-09-12,Russia,NA,Astrakhan Oblast,1017514,50,2,6218,87
2020-09-13,Russia,NA,Astrakhan Oblast,1017514,45,0,6263,87
2020-09-14,Russia,NA,Astrakhan Oblast,1017514,42,1,6305,88
2020-09-15,Russia,NA,Astrakhan Oblast,1017514,51,1,6356,89
2020-09-16,Russia,NA,Astrakhan Oblast,1017514,53,1,6409,90
2020-09-17,Russia,NA,Astrakhan Oblast,1017514,48,1,6457,91
2020-09-18,Russia,NA,Astrakhan Oblast,1017514,47,1,6504,92
2020-09-19,Russia,NA,Astrakhan Oblast,1017514,46,2,6550,94
2020-09-20,Russia,NA,Astrakhan Oblast,1017514,54,0,6604,94
2020-09-21,Russia,NA,Astrakhan Oblast,1017514,49,1,6653,95
2020-09-22,Russia,NA,Astrakhan Oblast,1017514,45,1,6698,96
2020-09-23,Russia,NA,Astrakhan Oblast,1017514,51,2,6749,98
2020-04-07,Russia,NA,Bashkortostan,4063293,2,0,12,0
2020-04-08,Russia,NA,Bashkortostan,4063293,4,0,16,0
2020-04-09,Russia,NA,Bashkortostan,4063293,6,0,22,0
2020-04-10,Russia,NA,Bashkortostan,4063293,18,0,40,0
2020-04-11,Russia,NA,Bashkortostan,4063293,25,0,65,0
2020-04-12,Russia,NA,Bashkortostan,4063293,19,0,84,0
2020-04-13,Russia,NA,Bashkortostan,4063293,23,0,107,0
2020-04-14,Russia,NA,Bashkortostan,4063293,22,0,129,0
2020-04-15,Russia,NA,Bashkortostan,4063293,20,0,149,0
2020-04-16,Russia,NA,Bashkortostan,4063293,42,0,191,0
2020-04-17,Russia,NA,Bashkortostan,4063293,22,0,213,0
2020-04-18,Russia,NA,Bashkortostan,4063293,39,0,252,0
2020-04-20,Russia,NA,Bashkortostan,4063293,45,0,297,0
2020-04-21,Russia,NA,Bashkortostan,4063293,74,0,371,0
2020-04-22,Russia,NA,Bashkortostan,4063293,25,0,396,0
2020-04-23,Russia,NA,Bashkortostan,4063293,26,0,422,0
2020-04-24,Russia,NA,Bashkortostan,4063293,33,0,455,0
2020-04-25,Russia,NA,Bashkortostan,4063293,35,0,490,0
2020-04-26,Russia,NA,Bashkortostan,4063293,37,0,527,0
2020-04-27,Russia,NA,Bashkortostan,4063293,43,0,570,0
2020-04-28,Russia,NA,Bashkortostan,4063293,61,0,631,0
2020-04-29,Russia,NA,Bashkortostan,4063293,60,0,691,0
2020-04-30,Russia,NA,Bashkortostan,4063293,75,0,766,0
2020-05-01,Russia,NA,Bashkortostan,4063293,77,0,843,0
2020-05-02,Russia,NA,Bashkortostan,4063293,92,0,935,0
2020-05-03,Russia,NA,Bashkortostan,4063293,87,0,1022,0
2020-05-04,Russia,NA,Bashkortostan,4063293,80,0,1102,0
2020-05-05,Russia,NA,Bashkortostan,4063293,34,0,1136,0
2020-05-06,Russia,NA,Bashkortostan,4063293,24,0,1160,0
2020-05-07,Russia,NA,Bashkortostan,4063293,83,0,1243,0
2020-05-08,Russia,NA,Bashkortostan,4063293,89,0,1332,0
2020-05-09,Russia,NA,Bashkortostan,4063293,84,0,1416,0
2020-05-10,Russia,NA,Bashkortostan,4063293,75,0,1491,0
2020-05-11,Russia,NA,Bashkortostan,4063293,76,0,1567,0
2020-05-12,Russia,NA,Bashkortostan,4063293,80,0,1647,0
2020-05-13,Russia,NA,Bashkortostan,4063293,49,0,1696,0
2020-05-14,Russia,NA,Bashkortostan,4063293,88,0,1784,0
2020-05-15,Russia,NA,Bashkortostan,4063293,90,0,1874,0
2020-05-16,Russia,NA,Bashkortostan,4063293,89,0,1963,0
2020-05-17,Russia,NA,Bashkortostan,4063293,98,0,2061,0
2020-05-18,Russia,NA,Bashkortostan,4063293,94,0,2155,0
2020-05-19,Russia,NA,Bashkortostan,4063293,92,0,2247,0
2020-05-20,Russia,NA,Bashkortostan,4063293,88,0,2335,0
2020-05-21,Russia,NA,Bashkortostan,4063293,89,0,2424,0
2020-05-22,Russia,NA,Bashkortostan,4063293,90,0,2514,0
2020-05-23,Russia,NA,Bashkortostan,4063293,88,0,2602,0
2020-05-24,Russia,NA,Bashkortostan,4063293,81,0,2683,0
2020-05-25,Russia,NA,Bashkortostan,4063293,89,0,2772,0
2020-05-26,Russia,NA,Bashkortostan,4063293,79,0,2851,0
2020-05-27,Russia,NA,Bashkortostan,4063293,91,0,2942,0
2020-05-28,Russia,NA,Bashkortostan,4063293,79,0,3021,0
2020-05-29,Russia,NA,Bashkortostan,4063293,84,0,3105,0
2020-05-30,Russia,NA,Bashkortostan,4063293,80,0,3185,0
2020-05-31,Russia,NA,Bashkortostan,4063293,75,0,3260,0
2020-06-01,Russia,NA,Bashkortostan,4063293,77,0,3337,0
2020-06-02,Russia,NA,Bashkortostan,4063293,72,0,3409,0
2020-06-03,Russia,NA,Bashkortostan,4063293,92,0,3501,0
2020-06-04,Russia,NA,Bashkortostan,4063293,107,0,3608,0
2020-06-05,Russia,NA,Bashkortostan,4063293,119,0,3727,0
2020-06-06,Russia,NA,Bashkortostan,4063293,105,0,3832,0
2020-06-07,Russia,NA,Bashkortostan,4063293,96,0,3928,0
2020-06-08,Russia,NA,Bashkortostan,4063293,89,0,4017,0
2020-06-09,Russia,NA,Bashkortostan,4063293,96,0,4113,0
2020-06-10,Russia,NA,Bashkortostan,4063293,81,0,4194,0
2020-06-11,Russia,NA,Bashkortostan,4063293,79,0,4273,0
2020-06-12,Russia,NA,Bashkortostan,4063293,75,0,4348,0
2020-06-13,Russia,NA,Bashkortostan,4063293,70,0,4418,0
2020-06-14,Russia,NA,Bashkortostan,4063293,68,0,4486,0
2020-06-15,Russia,NA,Bashkortostan,4063293,61,0,4547,0
2020-06-16,Russia,NA,Bashkortostan,4063293,64,0,4611,0
2020-06-17,Russia,NA,Bashkortostan,4063293,59,0,4670,0
2020-06-18,Russia,NA,Bashkortostan,4063293,60,0,4730,0
2020-06-19,Russia,NA,Bashkortostan,4063293,62,0,4792,0
2020-06-20,Russia,NA,Bashkortostan,4063293,58,0,4850,0
2020-06-21,Russia,NA,Bashkortostan,4063293,56,0,4906,0
2020-06-22,Russia,NA,Bashkortostan,4063293,53,0,4959,0
2020-06-23,Russia,NA,Bashkortostan,4063293,52,0,5011,0
2020-06-24,Russia,NA,Bashkortostan,4063293,57,0,5068,0
2020-06-25,Russia,NA,Bashkortostan,4063293,53,0,5121,0
2020-06-26,Russia,NA,Bashkortostan,4063293,50,0,5171,0
2020-06-27,Russia,NA,Bashkortostan,4063293,49,0,5220,0
2020-06-28,Russia,NA,Bashkortostan,4063293,47,0,5267,0
2020-06-29,Russia,NA,Bashkortostan,4063293,48,0,5315,0
2020-06-30,Russia,NA,Bashkortostan,4063293,46,0,5361,0
2020-07-01,Russia,NA,Bashkortostan,4063293,44,0,5405,0
2020-07-02,Russia,NA,Bashkortostan,4063293,45,0,5450,0
2020-07-03,Russia,NA,Bashkortostan,4063293,47,0,5497,0
2020-07-04,Russia,NA,Bashkortostan,4063293,46,0,5543,0
2020-07-05,Russia,NA,Bashkortostan,4063293,48,0,5591,0
2020-07-06,Russia,NA,Bashkortostan,4063293,47,0,5638,0
2020-07-07,Russia,NA,Bashkortostan,4063293,48,0,5686,0
2020-07-08,Russia,NA,Bashkortostan,4063293,45,0,5731,0
2020-07-09,Russia,NA,Bashkortostan,4063293,47,0,5778,0
2020-07-10,Russia,NA,Bashkortostan,4063293,48,0,5826,0
2020-07-11,Russia,NA,Bashkortostan,4063293,49,0,5875,0
2020-07-12,Russia,NA,Bashkortostan,4063293,46,0,5921,0
2020-07-13,Russia,NA,Bashkortostan,4063293,46,0,5967,0
2020-07-14,Russia,NA,Bashkortostan,4063293,47,0,6014,0
2020-07-15,Russia,NA,Bashkortostan,4063293,63,0,6077,0
2020-07-16,Russia,NA,Bashkortostan,4063293,57,0,6134,0
2020-07-17,Russia,NA,Bashkortostan,4063293,60,0,6194,0
2020-07-18,Russia,NA,Bashkortostan,4063293,55,0,6249,0
2020-07-19,Russia,NA,Bashkortostan,4063293,58,0,6307,0
2020-07-20,Russia,NA,Bashkortostan,4063293,41,0,6348,0
2020-07-21,Russia,NA,Bashkortostan,4063293,38,0,6386,0
2020-07-22,Russia,NA,Bashkortostan,4063293,40,0,6426,0
2020-07-23,Russia,NA,Bashkortostan,4063293,37,0,6463,0
2020-07-24,Russia,NA,Bashkortostan,4063293,37,0,6500,0
2020-07-25,Russia,NA,Bashkortostan,4063293,36,0,6536,0
2020-07-26,Russia,NA,Bashkortostan,4063293,35,0,6571,0
2020-07-27,Russia,NA,Bashkortostan,4063293,36,0,6607,0
2020-07-28,Russia,NA,Bashkortostan,4063293,33,0,6640,0
2020-07-29,Russia,NA,Bashkortostan,4063293,35,0,6675,0
2020-07-30,Russia,NA,Bashkortostan,4063293,36,0,6711,0
2020-07-31,Russia,NA,Bashkortostan,4063293,34,0,6745,0
2020-08-01,Russia,NA,Bashkortostan,4063293,35,0,6780,0
2020-08-02,Russia,NA,Bashkortostan,4063293,35,0,6815,0
2020-08-26,Russia,NA,Bashkortostan,4063293,0,0,7634,28
2020-08-27,Russia,NA,Bashkortostan,4063293,33,0,7667,28
2020-08-28,Russia,NA,Bashkortostan,4063293,31,0,7698,28
2020-08-29,Russia,NA,Bashkortostan,4063293,33,1,7731,29
2020-08-30,Russia,NA,Bashkortostan,4063293,32,0,7763,29
2020-08-31,Russia,NA,Bashkortostan,4063293,32,0,7795,29
2020-09-01,Russia,NA,Bashkortostan,4063293,30,0,7825,29
2020-09-02,Russia,NA,Bashkortostan,4063293,31,0,7856,29
2020-09-03,Russia,NA,Bashkortostan,4063293,32,0,7888,29
2020-09-04,Russia,NA,Bashkortostan,4063293,30,0,7918,29
2020-09-05,Russia,NA,Bashkortostan,4063293,31,0,7949,29
2020-09-06,Russia,NA,Bashkortostan,4063293,32,0,7981,29
2020-09-07,Russia,NA,Bashkortostan,4063293,30,0,8011,29
2020-09-08,Russia,NA,Bashkortostan,4063293,31,0,8042,29
2020-09-09,Russia,NA,Bashkortostan,4063293,30,0,8072,29
2020-09-10,Russia,NA,Bashkortostan,4063293,29,1,8101,30
2020-09-11,Russia,NA,Bashkortostan,4063293,30,0,8131,30
2020-09-12,Russia,NA,Bashkortostan,4063293,30,0,8161,30
2020-09-13,Russia,NA,Bashkortostan,4063293,32,1,8193,31
2020-09-14,Russia,NA,Bashkortostan,4063293,30,0,8223,31
2020-09-15,Russia,NA,Bashkortostan,4063293,31,0,8254,31
2020-09-16,Russia,NA,Bashkortostan,4063293,32,0,8286,31
2020-09-17,Russia,NA,Bashkortostan,4063293,31,0,8317,31
2020-09-18,Russia,NA,Bashkortostan,4063293,33,0,8350,31
2020-09-19,Russia,NA,Bashkortostan,4063293,34,2,8384,33
2020-09-20,Russia,NA,Bashkortostan,4063293,33,0,8417,33
2020-09-21,Russia,NA,Bashkortostan,4063293,35,0,8452,33
2020-09-22,Russia,NA,Bashkortostan,4063293,35,3,8487,36
2020-09-23,Russia,NA,Bashkortostan,4063293,34,0,8521,36
2020-04-06,Russia,NA,Belgorod Oblast,1549876,4,0,11,0
2020-04-07,Russia,NA,Belgorod Oblast,1549876,3,0,14,0
2020-04-08,Russia,NA,Belgorod Oblast,1549876,4,0,18,0
2020-04-10,Russia,NA,Belgorod Oblast,1549876,8,0,26,0
2020-04-12,Russia,NA,Belgorod Oblast,1549876,5,0,31,0
2020-04-14,Russia,NA,Belgorod Oblast,1549876,10,0,41,0
2020-04-15,Russia,NA,Belgorod Oblast,1549876,4,0,45,0
2020-04-16,Russia,NA,Belgorod Oblast,1549876,13,0,58,0
2020-04-17,Russia,NA,Belgorod Oblast,1549876,12,0,70,0
2020-04-18,Russia,NA,Belgorod Oblast,1549876,11,0,81,0
2020-04-19,Russia,NA,Belgorod Oblast,1549876,9,0,90,0
2020-04-20,Russia,NA,Belgorod Oblast,1549876,22,0,112,0
2020-04-21,Russia,NA,Belgorod Oblast,1549876,10,0,122,0
2020-04-22,Russia,NA,Belgorod Oblast,1549876,22,0,144,0
2020-04-23,Russia,NA,Belgorod Oblast,1549876,32,0,176,0
2020-04-24,Russia,NA,Belgorod Oblast,1549876,26,0,202,0
2020-04-25,Russia,NA,Belgorod Oblast,1549876,19,0,221,0
2020-04-26,Russia,NA,Belgorod Oblast,1549876,21,0,242,0
2020-04-27,Russia,NA,Belgorod Oblast,1549876,27,0,269,0
2020-04-28,Russia,NA,Belgorod Oblast,1549876,30,0,299,0
2020-04-29,Russia,NA,Belgorod Oblast,1549876,28,0,327,0
2020-04-30,Russia,NA,Belgorod Oblast,1549876,28,0,355,0
2020-05-01,Russia,NA,Belgorod Oblast,1549876,28,0,383,0
2020-05-02,Russia,NA,Belgorod Oblast,1549876,36,0,419,0
2020-05-03,Russia,NA,Belgorod Oblast,1549876,35,0,454,0
2020-05-04,Russia,NA,Belgorod Oblast,1549876,31,0,485,0
2020-05-05,Russia,NA,Belgorod Oblast,1549876,39,0,524,0
2020-05-06,Russia,NA,Belgorod Oblast,1549876,16,0,540,0
2020-05-07,Russia,NA,Belgorod Oblast,1549876,34,0,574,0
2020-05-08,Russia,NA,Belgorod Oblast,1549876,39,0,613,0
2020-05-09,Russia,NA,Belgorod Oblast,1549876,46,0,659,0
2020-05-10,Russia,NA,Belgorod Oblast,1549876,48,0,707,0
2020-05-11,Russia,NA,Belgorod Oblast,1549876,91,0,798,0
2020-05-12,Russia,NA,Belgorod Oblast,1549876,54,0,852,0
2020-05-13,Russia,NA,Belgorod Oblast,1549876,90,0,942,0
2020-05-14,Russia,NA,Belgorod Oblast,1549876,52,0,994,0
2020-05-15,Russia,NA,Belgorod Oblast,1549876,79,0,1073,0
2020-05-16,Russia,NA,Belgorod Oblast,1549876,76,0,1149,0
2020-05-17,Russia,NA,Belgorod Oblast,1549876,73,0,1222,0
2020-05-18,Russia,NA,Belgorod Oblast,1549876,70,0,1292,0
2020-05-19,Russia,NA,Belgorod Oblast,1549876,69,0,1361,0
2020-05-20,Russia,NA,Belgorod Oblast,1549876,67,0,1428,0
2020-05-21,Russia,NA,Belgorod Oblast,1549876,71,0,1499,0
2020-05-22,Russia,NA,Belgorod Oblast,1549876,82,0,1581,0
2020-05-23,Russia,NA,Belgorod Oblast,1549876,73,0,1654,0
2020-05-24,Russia,NA,Belgorod Oblast,1549876,82,0,1736,0
2020-05-25,Russia,NA,Belgorod Oblast,1549876,89,0,1825,0
2020-05-26,Russia,NA,Belgorod Oblast,1549876,76,0,1901,0
2020-05-27,Russia,NA,Belgorod Oblast,1549876,79,0,1980,0
2020-05-28,Russia,NA,Belgorod Oblast,1549876,79,0,2059,0
2020-05-29,Russia,NA,Belgorod Oblast,1549876,81,0,2140,0
2020-05-30,Russia,NA,Belgorod Oblast,1549876,83,0,2223,0
2020-05-31,Russia,NA,Belgorod Oblast,1549876,87,0,2310,0
2020-06-01,Russia,NA,Belgorod Oblast,1549876,82,0,2392,0
2020-06-02,Russia,NA,Belgorod Oblast,1549876,79,0,2471,0
2020-06-03,Russia,NA,Belgorod Oblast,1549876,77,0,2548,0
2020-06-04,Russia,NA,Belgorod Oblast,1549876,76,0,2624,0
2020-06-05,Russia,NA,Belgorod Oblast,1549876,71,0,2695,0
2020-06-06,Russia,NA,Belgorod Oblast,1549876,74,0,2769,0
2020-06-07,Russia,NA,Belgorod Oblast,1549876,71,0,2840,0
2020-06-08,Russia,NA,Belgorod Oblast,1549876,73,0,2913,0
2020-06-09,Russia,NA,Belgorod Oblast,1549876,75,0,2988,0
2020-06-10,Russia,NA,Belgorod Oblast,1549876,73,0,3061,0
2020-06-11,Russia,NA,Belgorod Oblast,1549876,76,0,3137,0
2020-06-12,Russia,NA,Belgorod Oblast,1549876,70,0,3207,0
2020-06-13,Russia,NA,Belgorod Oblast,1549876,77,0,3284,0
2020-06-14,Russia,NA,Belgorod Oblast,1549876,80,0,3364,0
2020-06-15,Russia,NA,Belgorod Oblast,1549876,78,0,3442,0
2020-06-16,Russia,NA,Belgorod Oblast,1549876,72,0,3514,0
2020-06-17,Russia,NA,Belgorod Oblast,1549876,78,0,3592,0
2020-06-18,Russia,NA,Belgorod Oblast,1549876,74,0,3666,0
2020-06-19,Russia,NA,Belgorod Oblast,1549876,81,0,3747,0
2020-06-20,Russia,NA,Belgorod Oblast,1549876,73,0,3820,0
2020-06-21,Russia,NA,Belgorod Oblast,1549876,76,0,3896,0
2020-06-22,Russia,NA,Belgorod Oblast,1549876,80,0,3976,0
2020-06-23,Russia,NA,Belgorod Oblast,1549876,72,0,4048,0
2020-06-24,Russia,NA,Belgorod Oblast,1549876,72,0,4120,0
2020-06-25,Russia,NA,Belgorod Oblast,1549876,69,0,4189,0
2020-06-26,Russia,NA,Belgorod Oblast,1549876,72,0,4261,0
2020-06-27,Russia,NA,Belgorod Oblast,1549876,70,0,4331,0
2020-06-28,Russia,NA,Belgorod Oblast,1549876,68,0,4399,0
2020-06-29,Russia,NA,Belgorod Oblast,1549876,65,0,4464,0
2020-06-30,Russia,NA,Belgorod Oblast,1549876,60,0,4524,0
2020-07-01,Russia,NA,Belgorod Oblast,1549876,59,0,4583,0
2020-07-02,Russia,NA,Belgorod Oblast,1549876,54,0,4637,0
2020-07-03,Russia,NA,Belgorod Oblast,1549876,60,0,4697,0
2020-07-04,Russia,NA,Belgorod Oblast,1549876,52,0,4749,0
2020-07-05,Russia,NA,Belgorod Oblast,1549876,57,0,4806,0
2020-07-06,Russia,NA,Belgorod Oblast,1549876,51,0,4857,0
2020-07-07,Russia,NA,Belgorod Oblast,1549876,49,0,4906,0
2020-07-08,Russia,NA,Belgorod Oblast,1549876,44,0,4950,0
2020-07-09,Russia,NA,Belgorod Oblast,1549876,48,0,4998,0
2020-07-10,Russia,NA,Belgorod Oblast,1549876,40,0,5038,0
2020-07-11,Russia,NA,Belgorod Oblast,1549876,47,0,5085,0
2020-07-12,Russia,NA,Belgorod Oblast,1549876,43,0,5128,0
2020-07-13,Russia,NA,Belgorod Oblast,1549876,48,0,5176,0
2020-07-14,Russia,NA,Belgorod Oblast,1549876,51,0,5227,0
2020-07-15,Russia,NA,Belgorod Oblast,1549876,44,0,5271,0
2020-07-16,Russia,NA,Belgorod Oblast,1549876,48,0,5319,0
2020-07-17,Russia,NA,Belgorod Oblast,1549876,41,0,5360,0
2020-07-18,Russia,NA,Belgorod Oblast,1549876,38,0,5398,0
2020-07-19,Russia,NA,Belgorod Oblast,1549876,43,0,5441,0
2020-07-20,Russia,NA,Belgorod Oblast,1549876,45,0,5486,0
2020-07-21,Russia,NA,Belgorod Oblast,1549876,41,0,5527,0
2020-07-22,Russia,NA,Belgorod Oblast,1549876,44,0,5571,0
2020-07-23,Russia,NA,Belgorod Oblast,1549876,46,0,5617,0
2020-07-24,Russia,NA,Belgorod Oblast,1549876,39,0,5656,0
2020-07-25,Russia,NA,Belgorod Oblast,1549876,47,0,5703,0
2020-07-26,Russia,NA,Belgorod Oblast,1549876,42,0,5745,0
2020-07-27,Russia,NA,Belgorod Oblast,1549876,39,0,5784,0
2020-07-28,Russia,NA,Belgorod Oblast,1549876,45,0,5829,0
2020-07-29,Russia,NA,Belgorod Oblast,1549876,42,0,5871,0
2020-07-30,Russia,NA,Belgorod Oblast,1549876,39,0,5910,0
2020-07-31,Russia,NA,Belgorod Oblast,1549876,42,0,5952,0
2020-08-01,Russia,NA,Belgorod Oblast,1549876,46,0,5998,0
2020-08-02,Russia,NA,Belgorod Oblast,1549876,44,0,6042,0
2020-08-26,Russia,NA,Belgorod Oblast,1549876,0,0,7157,51
2020-08-27,Russia,NA,Belgorod Oblast,1549876,38,0,7195,51
2020-08-28,Russia,NA,Belgorod Oblast,1549876,44,0,7239,51
2020-08-29,Russia,NA,Belgorod Oblast,1549876,40,2,7279,53
2020-08-30,Russia,NA,Belgorod Oblast,1549876,41,0,7320,53
2020-08-31,Russia,NA,Belgorod Oblast,1549876,45,0,7365,53
2020-09-01,Russia,NA,Belgorod Oblast,1549876,40,0,7405,53
2020-09-02,Russia,NA,Belgorod Oblast,1549876,44,0,7449,53
2020-09-03,Russia,NA,Belgorod Oblast,1549876,42,1,7491,54
2020-09-04,Russia,NA,Belgorod Oblast,1549876,40,0,7531,54
2020-09-05,Russia,NA,Belgorod Oblast,1549876,38,0,7569,54
2020-09-06,Russia,NA,Belgorod Oblast,1549876,41,0,7610,54
2020-09-07,Russia,NA,Belgorod Oblast,1549876,44,0,7654,54
2020-09-08,Russia,NA,Belgorod Oblast,1549876,45,0,7699,54
2020-09-09,Russia,NA,Belgorod Oblast,1549876,43,1,7742,55
2020-09-10,Russia,NA,Belgorod Oblast,1549876,44,0,7786,55
2020-09-11,Russia,NA,Belgorod Oblast,1549876,46,0,7832,55
2020-09-12,Russia,NA,Belgorod Oblast,1549876,42,0,7874,55
2020-09-13,Russia,NA,Belgorod Oblast,1549876,45,0,7919,55
2020-09-14,Russia,NA,Belgorod Oblast,1549876,43,0,7962,55
2020-09-15,Russia,NA,Belgorod Oblast,1549876,46,0,8008,55
2020-09-16,Russia,NA,Belgorod Oblast,1549876,48,2,8056,57
2020-09-17,Russia,NA,Belgorod Oblast,1549876,47,0,8103,57
2020-09-18,Russia,NA,Belgorod Oblast,1549876,49,0,8152,57
2020-09-19,Russia,NA,Belgorod Oblast,1549876,56,0,8208,57
2020-09-20,Russia,NA,Belgorod Oblast,1549876,52,0,8260,57
2020-09-21,Russia,NA,Belgorod Oblast,1549876,51,0,8311,57
2020-09-22,Russia,NA,Belgorod Oblast,1549876,54,0,8365,57
2020-09-23,Russia,NA,Belgorod Oblast,1549876,57,0,8422,57
2020-04-04,Russia,NA,Bryansk Oblast,1210982,12,0,19,0
2020-04-06,Russia,NA,Bryansk Oblast,1210982,5,0,24,0
2020-04-07,Russia,NA,Bryansk Oblast,1210982,32,0,56,0
2020-04-08,Russia,NA,Bryansk Oblast,1210982,1,0,57,0
2020-04-09,Russia,NA,Bryansk Oblast,1210982,40,0,97,0
2020-04-11,Russia,NA,Bryansk Oblast,1210982,26,0,123,0
2020-04-12,Russia,NA,Bryansk Oblast,1210982,18,0,141,0
2020-04-13,Russia,NA,Bryansk Oblast,1210982,1,0,142,0
2020-04-15,Russia,NA,Bryansk Oblast,1210982,22,0,164,0
2020-04-16,Russia,NA,Bryansk Oblast,1210982,37,0,201,0
2020-04-17,Russia,NA,Bryansk Oblast,1210982,27,0,228,0
2020-04-18,Russia,NA,Bryansk Oblast,1210982,28,0,256,0
2020-04-19,Russia,NA,Bryansk Oblast,1210982,23,0,279,0
2020-04-20,Russia,NA,Bryansk Oblast,1210982,42,0,321,0
2020-04-21,Russia,NA,Bryansk Oblast,1210982,29,0,350,0
2020-04-22,Russia,NA,Bryansk Oblast,1210982,49,0,399,0
2020-04-23,Russia,NA,Bryansk Oblast,1210982,60,0,459,0
2020-04-24,Russia,NA,Bryansk Oblast,1210982,35,0,494,0
2020-04-25,Russia,NA,Bryansk Oblast,1210982,27,0,521,0
2020-04-26,Russia,NA,Bryansk Oblast,1210982,78,0,599,0
2020-04-27,Russia,NA,Bryansk Oblast,1210982,43,0,642,0
2020-04-28,Russia,NA,Bryansk Oblast,1210982,26,0,668,0
2020-04-29,Russia,NA,Bryansk Oblast,1210982,115,0,783,0
2020-04-30,Russia,NA,Bryansk Oblast,1210982,118,0,901,0
2020-05-01,Russia,NA,Bryansk Oblast,1210982,88,0,989,0
2020-05-02,Russia,NA,Bryansk Oblast,1210982,73,0,1062,0
2020-05-03,Russia,NA,Bryansk Oblast,1210982,86,0,1148,0
2020-05-04,Russia,NA,Bryansk Oblast,1210982,102,0,1250,0
2020-05-05,Russia,NA,Bryansk Oblast,1210982,37,0,1287,0
2020-05-06,Russia,NA,Bryansk Oblast,1210982,80,0,1367,0
2020-05-07,Russia,NA,Bryansk Oblast,1210982,75,0,1442,0
2020-05-08,Russia,NA,Bryansk Oblast,1210982,72,0,1514,0
2020-05-09,Russia,NA,Bryansk Oblast,1210982,23,0,1537,0
2020-05-10,Russia,NA,Bryansk Oblast,1210982,68,0,1605,0
2020-05-11,Russia,NA,Bryansk Oblast,1210982,73,0,1678,0
2020-05-12,Russia,NA,Bryansk Oblast,1210982,75,0,1753,0
2020-05-13,Russia,NA,Bryansk Oblast,1210982,73,0,1826,0
2020-05-14,Russia,NA,Bryansk Oblast,1210982,82,0,1908,0
2020-05-15,Russia,NA,Bryansk Oblast,1210982,87,0,1995,0
2020-05-16,Russia,NA,Bryansk Oblast,1210982,85,0,2080,0
2020-05-17,Russia,NA,Bryansk Oblast,1210982,98,0,2178,0
2020-05-18,Russia,NA,Bryansk Oblast,1210982,115,0,2293,0
2020-05-19,Russia,NA,Bryansk Oblast,1210982,112,0,2405,0
2020-05-20,Russia,NA,Bryansk Oblast,1210982,110,0,2515,0
2020-05-21,Russia,NA,Bryansk Oblast,1210982,117,0,2632,0
2020-05-22,Russia,NA,Bryansk Oblast,1210982,105,0,2737,0
2020-05-23,Russia,NA,Bryansk Oblast,1210982,103,0,2840,0
2020-05-24,Russia,NA,Bryansk Oblast,1210982,111,0,2951,0
2020-05-25,Russia,NA,Bryansk Oblast,1210982,106,0,3057,0
2020-05-26,Russia,NA,Bryansk Oblast,1210982,99,0,3156,0
2020-05-27,Russia,NA,Bryansk Oblast,1210982,98,0,3254,0
2020-05-28,Russia,NA,Bryansk Oblast,1210982,109,0,3363,0
2020-05-29,Russia,NA,Bryansk Oblast,1210982,110,0,3473,0
2020-05-30,Russia,NA,Bryansk Oblast,1210982,105,0,3578,0
2020-05-31,Russia,NA,Bryansk Oblast,1210982,107,0,3685,0
2020-06-01,Russia,NA,Bryansk Oblast,1210982,102,0,3787,0
2020-06-02,Russia,NA,Bryansk Oblast,1210982,98,0,3885,0
2020-06-03,Russia,NA,Bryansk Oblast,1210982,97,0,3982,0
2020-06-04,Russia,NA,Bryansk Oblast,1210982,96,0,4078,0
2020-06-05,Russia,NA,Bryansk Oblast,1210982,96,0,4174,0
2020-06-06,Russia,NA,Bryansk Oblast,1210982,95,0,4269,0
2020-06-07,Russia,NA,Bryansk Oblast,1210982,95,0,4364,0
2020-06-08,Russia,NA,Bryansk Oblast,1210982,94,0,4458,0
2020-06-09,Russia,NA,Bryansk Oblast,1210982,93,0,4551,0
2020-06-10,Russia,NA,Bryansk Oblast,1210982,90,0,4641,0
2020-06-11,Russia,NA,Bryansk Oblast,1210982,91,0,4732,0
2020-06-12,Russia,NA,Bryansk Oblast,1210982,93,0,4825,0
2020-06-13,Russia,NA,Bryansk Oblast,1210982,95,0,4920,0
2020-06-14,Russia,NA,Bryansk Oblast,1210982,91,0,5011,0
2020-06-15,Russia,NA,Bryansk Oblast,1210982,87,0,5098,0
2020-06-16,Russia,NA,Bryansk Oblast,1210982,85,0,5183,0
2020-06-17,Russia,NA,Bryansk Oblast,1210982,87,0,5270,0
2020-06-18,Russia,NA,Bryansk Oblast,1210982,75,0,5345,0
2020-06-19,Russia,NA,Bryansk Oblast,1210982,76,0,5421,0
2020-06-20,Russia,NA,Bryansk Oblast,1210982,77,0,5498,0
2020-06-21,Russia,NA,Bryansk Oblast,1210982,81,0,5579,0
2020-06-22,Russia,NA,Bryansk Oblast,1210982,76,0,5655,0
2020-06-23,Russia,NA,Bryansk Oblast,1210982,74,0,5729,0
2020-06-24,Russia,NA,Bryansk Oblast,1210982,72,0,5801,0
2020-06-25,Russia,NA,Bryansk Oblast,1210982,69,0,5870,0
2020-06-26,Russia,NA,Bryansk Oblast,1210982,71,0,5941,0
2020-06-27,Russia,NA,Bryansk Oblast,1210982,70,0,6011,0
2020-06-28,Russia,NA,Bryansk Oblast,1210982,68,0,6079,0
2020-06-29,Russia,NA,Bryansk Oblast,1210982,68,0,6147,0
2020-06-30,Russia,NA,Bryansk Oblast,1210982,65,0,6212,0
2020-07-01,Russia,NA,Bryansk Oblast,1210982,59,0,6271,0
2020-07-02,Russia,NA,Bryansk Oblast,1210982,54,0,6325,0
2020-07-03,Russia,NA,Bryansk Oblast,1210982,53,0,6378,0
2020-07-04,Russia,NA,Bryansk Oblast,1210982,51,0,6429,0
2020-07-05,Russia,NA,Bryansk Oblast,1210982,50,0,6479,0
2020-07-06,Russia,NA,Bryansk Oblast,1210982,43,0,6522,0
2020-07-07,Russia,NA,Bryansk Oblast,1210982,41,0,6563,0
2020-07-08,Russia,NA,Bryansk Oblast,1210982,40,0,6603,0
2020-07-09,Russia,NA,Bryansk Oblast,1210982,40,0,6643,0
2020-07-10,Russia,NA,Bryansk Oblast,1210982,36,0,6679,0
2020-07-11,Russia,NA,Bryansk Oblast,1210982,46,0,6725,0
2020-07-12,Russia,NA,Bryansk Oblast,1210982,45,0,6770,0
2020-07-13,Russia,NA,Bryansk Oblast,1210982,47,0,6817,0
2020-07-14,Russia,NA,Bryansk Oblast,1210982,45,0,6862,0
2020-07-15,Russia,NA,Bryansk Oblast,1210982,44,0,6906,0
2020-07-16,Russia,NA,Bryansk Oblast,1210982,41,0,6947,0
2020-07-17,Russia,NA,Bryansk Oblast,1210982,31,0,6978,0
2020-07-18,Russia,NA,Bryansk Oblast,1210982,30,0,7008,0
2020-07-19,Russia,NA,Bryansk Oblast,1210982,30,0,7038,0
2020-07-20,Russia,NA,Bryansk Oblast,1210982,30,0,7068,0
2020-07-21,Russia,NA,Bryansk Oblast,1210982,23,0,7091,0
2020-07-22,Russia,NA,Bryansk Oblast,1210982,25,0,7116,0
2020-07-23,Russia,NA,Bryansk Oblast,1210982,25,0,7141,0
2020-07-24,Russia,NA,Bryansk Oblast,1210982,23,0,7164,0
2020-07-25,Russia,NA,Bryansk Oblast,1210982,30,0,7194,0
2020-07-26,Russia,NA,Bryansk Oblast,1210982,27,0,7221,0
2020-07-27,Russia,NA,Bryansk Oblast,1210982,24,0,7245,0
2020-07-28,Russia,NA,Bryansk Oblast,1210982,27,0,7272,0
2020-07-29,Russia,NA,Bryansk Oblast,1210982,33,0,7305,0
2020-07-30,Russia,NA,Bryansk Oblast,1210982,35,0,7340,0
2020-07-31,Russia,NA,Bryansk Oblast,1210982,30,0,7370,0
2020-08-01,Russia,NA,Bryansk Oblast,1210982,30,0,7400,0
2020-08-02,Russia,NA,Bryansk Oblast,1210982,30,0,7430,0
2020-08-26,Russia,NA,Bryansk Oblast,1210982,0,0,8073,35
2020-08-27,Russia,NA,Bryansk Oblast,1210982,24,0,8097,35
2020-08-28,Russia,NA,Bryansk Oblast,1210982,28,0,8125,35
2020-08-29,Russia,NA,Bryansk Oblast,1210982,34,0,8159,35
2020-08-30,Russia,NA,Bryansk Oblast,1210982,35,0,8194,35
2020-08-31,Russia,NA,Bryansk Oblast,1210982,33,0,8227,35
2020-09-01,Russia,NA,Bryansk Oblast,1210982,25,0,8252,35
2020-09-02,Russia,NA,Bryansk Oblast,1210982,26,0,8278,35
2020-09-03,Russia,NA,Bryansk Oblast,1210982,27,0,8305,35
2020-09-04,Russia,NA,Bryansk Oblast,1210982,32,0,8337,35
2020-09-05,Russia,NA,Bryansk Oblast,1210982,33,0,8370,35
2020-09-06,Russia,NA,Bryansk Oblast,1210982,35,0,8405,35
2020-09-07,Russia,NA,Bryansk Oblast,1210982,32,0,8437,35
2020-09-08,Russia,NA,Bryansk Oblast,1210982,28,0,8465,35
2020-09-09,Russia,NA,Bryansk Oblast,1210982,32,0,8497,35
2020-09-10,Russia,NA,Bryansk Oblast,1210982,36,0,8533,35
2020-09-11,Russia,NA,Bryansk Oblast,1210982,38,0,8571,35
2020-09-12,Russia,NA,Bryansk Oblast,1210982,35,0,8606,35
2020-09-13,Russia,NA,Bryansk Oblast,1210982,39,0,8645,35
2020-09-14,Russia,NA,Bryansk Oblast,1210982,42,0,8687,35
2020-09-15,Russia,NA,Bryansk Oblast,1210982,46,0,8733,35
2020-09-16,Russia,NA,Bryansk Oblast,1210982,49,0,8782,35
2020-09-17,Russia,NA,Bryansk Oblast,1210982,48,0,8830,35
2020-09-18,Russia,NA,Bryansk Oblast,1210982,48,2,8878,37
2020-09-19,Russia,NA,Bryansk Oblast,1210982,49,0,8927,37
2020-09-20,Russia,NA,Bryansk Oblast,1210982,51,0,8978,37
2020-09-21,Russia,NA,Bryansk Oblast,1210982,52,0,9030,37
2020-09-22,Russia,NA,Bryansk Oblast,1210982,48,0,9078,37
2020-09-23,Russia,NA,Bryansk Oblast,1210982,39,0,9117,37
2020-03-30,Russia,NA,Buryatia,984511,5,0,13,0
2020-03-31,Russia,NA,Buryatia,984511,6,0,19,0
2020-04-01,Russia,NA,Buryatia,984511,6,0,25,0
2020-04-02,Russia,NA,Buryatia,984511,5,0,30,0
2020-04-03,Russia,NA,Buryatia,984511,1,0,31,0
2020-04-04,Russia,NA,Buryatia,984511,4,0,35,0
2020-04-06,Russia,NA,Buryatia,984511,8,0,43,0
2020-04-08,Russia,NA,Buryatia,984511,7,0,50,0
2020-04-09,Russia,NA,Buryatia,984511,4,0,54,0
2020-04-10,Russia,NA,Buryatia,984511,6,0,60,0
2020-04-11,Russia,NA,Buryatia,984511,1,0,61,0
2020-04-12,Russia,NA,Buryatia,984511,12,0,73,0
2020-04-13,Russia,NA,Buryatia,984511,4,0,77,0
2020-04-14,Russia,NA,Buryatia,984511,9,0,86,0
2020-04-15,Russia,NA,Buryatia,984511,6,0,92,0
2020-04-16,Russia,NA,Buryatia,984511,8,0,100,0
2020-04-17,Russia,NA,Buryatia,984511,3,0,103,0
2020-04-18,Russia,NA,Buryatia,984511,9,0,112,0
2020-04-19,Russia,NA,Buryatia,984511,3,0,115,0
2020-04-21,Russia,NA,Buryatia,984511,10,0,125,0
2020-04-22,Russia,NA,Buryatia,984511,28,0,153,0
2020-04-23,Russia,NA,Buryatia,984511,10,0,163,0
2020-04-24,Russia,NA,Buryatia,984511,4,0,167,0
2020-04-25,Russia,NA,Buryatia,984511,13,0,180,0
2020-04-26,Russia,NA,Buryatia,984511,6,0,186,0
2020-04-27,Russia,NA,Buryatia,984511,23,0,209,0
2020-04-28,Russia,NA,Buryatia,984511,18,0,227,0
2020-04-29,Russia,NA,Buryatia,984511,18,0,245,0
2020-04-30,Russia,NA,Buryatia,984511,26,0,271,0
2020-05-01,Russia,NA,Buryatia,984511,26,0,297,0
2020-05-02,Russia,NA,Buryatia,984511,28,0,325,0
2020-05-03,Russia,NA,Buryatia,984511,30,0,355,0
2020-05-04,Russia,NA,Buryatia,984511,18,0,373,0
2020-05-05,Russia,NA,Buryatia,984511,34,0,407,0
2020-05-06,Russia,NA,Buryatia,984511,43,0,450,0
2020-05-07,Russia,NA,Buryatia,984511,49,0,499,0
2020-05-08,Russia,NA,Buryatia,984511,19,0,518,0
2020-05-09,Russia,NA,Buryatia,984511,30,0,548,0
2020-05-10,Russia,NA,Buryatia,984511,22,0,570,0
2020-05-11,Russia,NA,Buryatia,984511,50,0,620,0
2020-05-12,Russia,NA,Buryatia,984511,39,0,659,0
2020-05-13,Russia,NA,Buryatia,984511,28,0,687,0
2020-05-14,Russia,NA,Buryatia,984511,49,0,736,0
2020-05-15,Russia,NA,Buryatia,984511,88,0,824,0
2020-05-16,Russia,NA,Buryatia,984511,41,0,865,0
2020-05-17,Russia,NA,Buryatia,984511,27,0,892,0
2020-05-18,Russia,NA,Buryatia,984511,56,0,948,0
2020-05-19,Russia,NA,Buryatia,984511,25,0,973,0
2020-05-20,Russia,NA,Buryatia,984511,42,0,1015,0
2020-05-21,Russia,NA,Buryatia,984511,27,0,1042,0
2020-05-22,Russia,NA,Buryatia,984511,48,0,1090,0
2020-05-23,Russia,NA,Buryatia,984511,34,0,1124,0
2020-05-24,Russia,NA,Buryatia,984511,19,0,1143,0
2020-05-25,Russia,NA,Buryatia,984511,66,0,1209,0
2020-05-26,Russia,NA,Buryatia,984511,45,0,1254,0
2020-05-27,Russia,NA,Buryatia,984511,59,0,1313,0
2020-05-28,Russia,NA,Buryatia,984511,51,0,1364,0
2020-05-29,Russia,NA,Buryatia,984511,47,0,1411,0
2020-05-30,Russia,NA,Buryatia,984511,27,0,1438,0
2020-05-31,Russia,NA,Buryatia,984511,29,0,1467,0
2020-06-01,Russia,NA,Buryatia,984511,46,0,1513,0
2020-06-02,Russia,NA,Buryatia,984511,50,0,1563,0
2020-06-03,Russia,NA,Buryatia,984511,24,0,1587,0
2020-06-04,Russia,NA,Buryatia,984511,46,0,1633,0
2020-06-05,Russia,NA,Buryatia,984511,48,0,1681,0
2020-06-06,Russia,NA,Buryatia,984511,52,0,1733,0
2020-06-07,Russia,NA,Buryatia,984511,52,0,1785,0
2020-06-08,Russia,NA,Buryatia,984511,48,0,1833,0
2020-06-09,Russia,NA,Buryatia,984511,44,0,1877,0
2020-06-10,Russia,NA,Buryatia,984511,79,0,1956,0
2020-06-11,Russia,NA,Buryatia,984511,64,0,2020,0
2020-06-12,Russia,NA,Buryatia,984511,90,0,2110,0
2020-06-13,Russia,NA,Buryatia,984511,43,0,2153,0
2020-06-14,Russia,NA,Buryatia,984511,50,0,2203,0
2020-06-15,Russia,NA,Buryatia,984511,49,0,2252,0
2020-06-16,Russia,NA,Buryatia,984511,51,0,2303,0
2020-06-17,Russia,NA,Buryatia,984511,38,0,2341,0
2020-06-18,Russia,NA,Buryatia,984511,51,0,2392,0
2020-06-19,Russia,NA,Buryatia,984511,54,0,2446,0
2020-06-20,Russia,NA,Buryatia,984511,55,0,2501,0
2020-06-21,Russia,NA,Buryatia,984511,48,0,2549,0
2020-06-22,Russia,NA,Buryatia,984511,42,0,2591,0
2020-06-23,Russia,NA,Buryatia,984511,43,0,2634,0
2020-06-24,Russia,NA,Buryatia,984511,48,0,2682,0
2020-06-25,Russia,NA,Buryatia,984511,49,0,2731,0
2020-06-26,Russia,NA,Buryatia,984511,44,0,2775,0
2020-06-27,Russia,NA,Buryatia,984511,56,0,2831,0
2020-06-28,Russia,NA,Buryatia,984511,26,0,2857,0
2020-06-29,Russia,NA,Buryatia,984511,29,0,2886,0
2020-06-30,Russia,NA,Buryatia,984511,38,0,2924,0
2020-07-01,Russia,NA,Buryatia,984511,33,0,2957,0
2020-07-02,Russia,NA,Buryatia,984511,34,0,2991,0
2020-07-03,Russia,NA,Buryatia,984511,43,0,3034,0
2020-07-04,Russia,NA,Buryatia,984511,37,0,3071,0
2020-07-05,Russia,NA,Buryatia,984511,29,0,3100,0
2020-07-06,Russia,NA,Buryatia,984511,41,0,3141,0
2020-07-07,Russia,NA,Buryatia,984511,34,0,3175,0
2020-07-08,Russia,NA,Buryatia,984511,44,0,3219,0
2020-07-09,Russia,NA,Buryatia,984511,38,0,3257,0
2020-07-10,Russia,NA,Buryatia,984511,41,0,3298,0
2020-07-11,Russia,NA,Buryatia,984511,43,0,3341,0
2020-07-12,Russia,NA,Buryatia,984511,37,0,3378,0
2020-07-13,Russia,NA,Buryatia,984511,36,0,3414,0
2020-07-14,Russia,NA,Buryatia,984511,35,0,3449,0
2020-07-15,Russia,NA,Buryatia,984511,32,0,3481,0
2020-07-16,Russia,NA,Buryatia,984511,41,0,3522,0
2020-07-17,Russia,NA,Buryatia,984511,44,0,3566,0
2020-07-18,Russia,NA,Buryatia,984511,42,0,3608,0
2020-07-19,Russia,NA,Buryatia,984511,43,0,3651,0
2020-07-20,Russia,NA,Buryatia,984511,41,0,3692,0
2020-07-21,Russia,NA,Buryatia,984511,37,0,3729,0
2020-07-22,Russia,NA,Buryatia,984511,38,0,3767,0
2020-07-23,Russia,NA,Buryatia,984511,19,0,3786,0
2020-07-24,Russia,NA,Buryatia,984511,38,0,3824,0
2020-07-25,Russia,NA,Buryatia,984511,40,0,3864,0
2020-07-26,Russia,NA,Buryatia,984511,38,0,3902,0
2020-07-27,Russia,NA,Buryatia,984511,32,0,3934,0
2020-07-28,Russia,NA,Buryatia,984511,35,0,3969,0
2020-07-29,Russia,NA,Buryatia,984511,38,0,4007,0
2020-07-30,Russia,NA,Buryatia,984511,39,0,4046,0
2020-07-31,Russia,NA,Buryatia,984511,35,0,4081,0
2020-08-01,Russia,NA,Buryatia,984511,42,0,4123,0
2020-08-02,Russia,NA,Buryatia,984511,36,0,4159,0
2020-08-26,Russia,NA,Buryatia,984511,0,0,5001,46
2020-08-27,Russia,NA,Buryatia,984511,41,0,5042,46
2020-08-28,Russia,NA,Buryatia,984511,45,0,5087,46
2020-08-29,Russia,NA,Buryatia,984511,49,0,5136,46
2020-08-30,Russia,NA,Buryatia,984511,54,1,5190,47
2020-08-31,Russia,NA,Buryatia,984511,53,0,5243,47
2020-09-01,Russia,NA,Buryatia,984511,48,3,5291,50
2020-09-02,Russia,NA,Buryatia,984511,40,3,5331,53
2020-09-03,Russia,NA,Buryatia,984511,49,1,5380,54
2020-09-04,Russia,NA,Buryatia,984511,47,1,5427,55
2020-09-05,Russia,NA,Buryatia,984511,54,0,5481,55
2020-09-06,Russia,NA,Buryatia,984511,50,0,5531,55
2020-09-07,Russia,NA,Buryatia,984511,51,0,5582,55
2020-09-08,Russia,NA,Buryatia,984511,50,0,5632,55
2020-09-09,Russia,NA,Buryatia,984511,34,5,5666,60
2020-09-10,Russia,NA,Buryatia,984511,39,0,5705,60
2020-09-11,Russia,NA,Buryatia,984511,43,0,5748,60
2020-09-12,Russia,NA,Buryatia,984511,48,0,5796,60
2020-09-13,Russia,NA,Buryatia,984511,48,1,5844,61
2020-09-14,Russia,NA,Buryatia,984511,45,0,5889,61
2020-09-15,Russia,NA,Buryatia,984511,48,0,5937,61
2020-09-16,Russia,NA,Buryatia,984511,47,1,5984,62
2020-09-17,Russia,NA,Buryatia,984511,44,0,6028,62
2020-09-18,Russia,NA,Buryatia,984511,60,0,6088,62
2020-09-19,Russia,NA,Buryatia,984511,64,0,6152,62
2020-09-20,Russia,NA,Buryatia,984511,67,1,6219,63
2020-09-21,Russia,NA,Buryatia,984511,67,0,6286,63
2020-09-22,Russia,NA,Buryatia,984511,66,2,6352,65
2020-09-23,Russia,NA,Buryatia,984511,65,0,6417,65
2020-04-03,Russia,NA,Chechnya,1436981,2,0,12,0
2020-04-04,Russia,NA,Chechnya,1436981,3,0,15,0
2020-04-06,Russia,NA,Chechnya,1436981,1,0,16,0
2020-04-07,Russia,NA,Chechnya,1436981,1,0,17,0
2020-04-08,Russia,NA,Chechnya,1436981,5,0,22,0
2020-04-11,Russia,NA,Chechnya,1436981,8,0,30,0
2020-04-12,Russia,NA,Chechnya,1436981,17,0,47,0
2020-04-13,Russia,NA,Chechnya,1436981,2,0,49,0
2020-04-14,Russia,NA,Chechnya,1436981,15,0,64,0
2020-04-15,Russia,NA,Chechnya,1436981,41,0,105,0
2020-04-16,Russia,NA,Chechnya,1436981,3,0,108,0
2020-04-17,Russia,NA,Chechnya,1436981,7,0,115,0
2020-04-18,Russia,NA,Chechnya,1436981,60,0,175,0
2020-04-19,Russia,NA,Chechnya,1436981,44,0,219,0
2020-04-20,Russia,NA,Chechnya,1436981,45,0,264,0
2020-04-21,Russia,NA,Chechnya,1436981,39,0,303,0
2020-04-22,Russia,NA,Chechnya,1436981,20,0,323,0
2020-04-23,Russia,NA,Chechnya,1436981,24,0,347,0
2020-04-24,Russia,NA,Chechnya,1436981,18,0,365,0
2020-04-25,Russia,NA,Chechnya,1436981,22,0,387,0
2020-04-26,Russia,NA,Chechnya,1436981,22,0,409,0
2020-04-27,Russia,NA,Chechnya,1436981,20,0,429,0
2020-04-28,Russia,NA,Chechnya,1436981,18,0,447,0
2020-04-29,Russia,NA,Chechnya,1436981,18,0,465,0
2020-04-30,Russia,NA,Chechnya,1436981,20,0,485,0
2020-05-01,Russia,NA,Chechnya,1436981,19,0,504,0
2020-05-02,Russia,NA,Chechnya,1436981,21,0,525,0
2020-05-03,Russia,NA,Chechnya,1436981,28,0,553,0
2020-05-04,Russia,NA,Chechnya,1436981,30,0,583,0
2020-05-05,Russia,NA,Chechnya,1436981,32,0,615,0
2020-05-06,Russia,NA,Chechnya,1436981,30,0,645,0
2020-05-07,Russia,NA,Chechnya,1436981,29,0,674,0
2020-05-08,Russia,NA,Chechnya,1436981,31,0,705,0
2020-05-09,Russia,NA,Chechnya,1436981,28,0,733,0
2020-05-10,Russia,NA,Chechnya,1436981,26,0,759,0
2020-05-11,Russia,NA,Chechnya,1436981,28,0,787,0
2020-05-12,Russia,NA,Chechnya,1436981,26,0,813,0
2020-05-13,Russia,NA,Chechnya,1436981,28,0,841,0
2020-05-14,Russia,NA,Chechnya,1436981,24,0,865,0
2020-05-15,Russia,NA,Chechnya,1436981,26,0,891,0
2020-05-16,Russia,NA,Chechnya,1436981,27,0,918,0
2020-05-17,Russia,NA,Chechnya,1436981,25,0,943,0
2020-05-18,Russia,NA,Chechnya,1436981,23,0,966,0
2020-05-19,Russia,NA,Chechnya,1436981,20,0,986,0
2020-05-20,Russia,NA,Chechnya,1436981,19,0,1005,0
2020-05-21,Russia,NA,Chechnya,1436981,21,0,1026,0
2020-05-22,Russia,NA,Chechnya,1436981,20,0,1046,0
2020-05-23,Russia,NA,Chechnya,1436981,20,0,1066,0
2020-05-24,Russia,NA,Chechnya,1436981,24,0,1090,0
2020-05-25,Russia,NA,Chechnya,1436981,22,0,1112,0
2020-05-26,Russia,NA,Chechnya,1436981,21,0,1133,0
2020-05-27,Russia,NA,Chechnya,1436981,19,0,1152,0
2020-05-28,Russia,NA,Chechnya,1436981,22,0,1174,0
2020-05-29,Russia,NA,Chechnya,1436981,18,0,1192,0
2020-05-30,Russia,NA,Chechnya,1436981,17,0,1209,0
2020-05-31,Russia,NA,Chechnya,1436981,18,0,1227,0
2020-06-01,Russia,NA,Chechnya,1436981,20,0,1247,0
2020-06-02,Russia,NA,Chechnya,1436981,17,0,1264,0
2020-06-03,Russia,NA,Chechnya,1436981,14,0,1278,0
2020-06-04,Russia,NA,Chechnya,1436981,13,0,1291,0
2020-06-05,Russia,NA,Chechnya,1436981,15,0,1306,0
2020-06-06,Russia,NA,Chechnya,1436981,20,0,1326,0
2020-06-07,Russia,NA,Chechnya,1436981,19,0,1345,0
2020-06-08,Russia,NA,Chechnya,1436981,20,0,1365,0
2020-06-09,Russia,NA,Chechnya,1436981,19,0,1384,0
2020-06-10,Russia,NA,Chechnya,1436981,16,0,1400,0
2020-06-11,Russia,NA,Chechnya,1436981,20,0,1420,0
2020-06-12,Russia,NA,Chechnya,1436981,21,0,1441,0
2020-06-13,Russia,NA,Chechnya,1436981,23,0,1464,0
2020-06-14,Russia,NA,Chechnya,1436981,17,0,1481,0
2020-06-15,Russia,NA,Chechnya,1436981,15,0,1496,0
2020-06-16,Russia,NA,Chechnya,1436981,17,0,1513,0
2020-06-17,Russia,NA,Chechnya,1436981,16,0,1529,0
2020-06-18,Russia,NA,Chechnya,1436981,14,0,1543,0
2020-06-19,Russia,NA,Chechnya,1436981,17,0,1560,0
2020-06-20,Russia,NA,Chechnya,1436981,19,0,1579,0
2020-06-21,Russia,NA,Chechnya,1436981,21,0,1600,0
2020-06-22,Russia,NA,Chechnya,1436981,19,0,1619,0
2020-06-23,Russia,NA,Chechnya,1436981,15,0,1634,0
2020-06-24,Russia,NA,Chechnya,1436981,11,0,1645,0
2020-06-25,Russia,NA,Chechnya,1436981,9,0,1654,0
2020-06-26,Russia,NA,Chechnya,1436981,10,0,1664,0
2020-06-27,Russia,NA,Chechnya,1436981,13,0,1677,0
2020-06-28,Russia,NA,Chechnya,1436981,17,0,1694,0
2020-06-29,Russia,NA,Chechnya,1436981,14,0,1708,0
2020-06-30,Russia,NA,Chechnya,1436981,5,0,1713,0
2020-07-01,Russia,NA,Chechnya,1436981,10,0,1723,0
2020-07-02,Russia,NA,Chechnya,1436981,13,0,1736,0
2020-07-03,Russia,NA,Chechnya,1436981,12,0,1748,0
2020-07-04,Russia,NA,Chechnya,1436981,9,0,1757,0
2020-07-05,Russia,NA,Chechnya,1436981,15,0,1772,0
2020-07-06,Russia,NA,Chechnya,1436981,14,0,1786,0
2020-07-07,Russia,NA,Chechnya,1436981,9,0,1795,0
2020-07-08,Russia,NA,Chechnya,1436981,6,0,1801,0
2020-07-09,Russia,NA,Chechnya,1436981,8,0,1809,0
2020-07-10,Russia,NA,Chechnya,1436981,5,0,1814,0
2020-07-11,Russia,NA,Chechnya,1436981,7,0,1821,0
2020-07-12,Russia,NA,Chechnya,1436981,11,0,1832,0
2020-07-13,Russia,NA,Chechnya,1436981,10,0,1842,0
2020-07-14,Russia,NA,Chechnya,1436981,9,0,1851,0
2020-07-15,Russia,NA,Chechnya,1436981,12,0,1863,0
2020-07-16,Russia,NA,Chechnya,1436981,15,0,1878,0
2020-07-17,Russia,NA,Chechnya,1436981,17,0,1895,0
2020-07-18,Russia,NA,Chechnya,1436981,13,0,1908,0
2020-07-19,Russia,NA,Chechnya,1436981,11,0,1919,0
2020-07-20,Russia,NA,Chechnya,1436981,8,0,1927,0
2020-07-21,Russia,NA,Chechnya,1436981,10,0,1937,0
2020-07-22,Russia,NA,Chechnya,1436981,12,0,1949,0
2020-07-23,Russia,NA,Chechnya,1436981,9,0,1958,0
2020-07-24,Russia,NA,Chechnya,1436981,13,0,1971,0
2020-07-25,Russia,NA,Chechnya,1436981,14,0,1985,0
2020-07-26,Russia,NA,Chechnya,1436981,15,0,2000,0
2020-07-27,Russia,NA,Chechnya,1436981,10,0,2010,0
2020-07-28,Russia,NA,Chechnya,1436981,8,0,2018,0
2020-07-29,Russia,NA,Chechnya,1436981,12,0,2030,0
2020-07-30,Russia,NA,Chechnya,1436981,16,0,2046,0
2020-07-31,Russia,NA,Chechnya,1436981,14,0,2060,0
2020-08-01,Russia,NA,Chechnya,1436981,12,0,2072,0
2020-08-02,Russia,NA,Chechnya,1436981,10,0,2082,0
2020-08-26,Russia,NA,Chechnya,1436981,0,0,2245,38
2020-08-27,Russia,NA,Chechnya,1436981,4,0,2249,38
2020-08-28,Russia,NA,Chechnya,1436981,4,0,2253,38
2020-08-29,Russia,NA,Chechnya,1436981,5,0,2258,38
2020-08-30,Russia,NA,Chechnya,1436981,7,0,2265,38
2020-08-31,Russia,NA,Chechnya,1436981,5,0,2270,38
2020-09-01,Russia,NA,Chechnya,1436981,4,0,2274,38
2020-09-02,Russia,NA,Chechnya,1436981,6,0,2280,38
2020-09-03,Russia,NA,Chechnya,1436981,6,0,2286,38
2020-09-04,Russia,NA,Chechnya,1436981,4,1,2290,39
2020-09-05,Russia,NA,Chechnya,1436981,6,0,2296,39
2020-09-06,Russia,NA,Chechnya,1436981,7,0,2303,39
2020-09-07,Russia,NA,Chechnya,1436981,4,1,2307,40
2020-09-08,Russia,NA,Chechnya,1436981,7,0,2314,40
2020-09-09,Russia,NA,Chechnya,1436981,8,0,2322,40
2020-09-10,Russia,NA,Chechnya,1436981,5,0,2327,40
2020-09-11,Russia,NA,Chechnya,1436981,6,0,2333,40
2020-09-12,Russia,NA,Chechnya,1436981,4,0,2337,40
2020-09-13,Russia,NA,Chechnya,1436981,4,0,2341,40
2020-09-14,Russia,NA,Chechnya,1436981,6,0,2347,40
2020-09-15,Russia,NA,Chechnya,1436981,5,0,2352,40
2020-09-16,Russia,NA,Chechnya,1436981,4,0,2356,40
2020-09-17,Russia,NA,Chechnya,1436981,5,0,2361,40
2020-09-18,Russia,NA,Chechnya,1436981,7,0,2368,40
2020-09-19,Russia,NA,Chechnya,1436981,6,0,2374,40
2020-09-20,Russia,NA,Chechnya,1436981,4,0,2378,40
2020-09-21,Russia,NA,Chechnya,1436981,6,0,2384,40
2020-09-22,Russia,NA,Chechnya,1436981,4,0,2388,40
2020-09-23,Russia,NA,Chechnya,1436981,5,0,2393,40
2020-03-29,Russia,NA,Chelyabinsk Oblast,3500361,3,0,12,0
2020-03-30,Russia,NA,Chelyabinsk Oblast,3500361,2,0,14,0
2020-04-01,Russia,NA,Chelyabinsk Oblast,3500361,7,0,21,0
2020-04-03,Russia,NA,Chelyabinsk Oblast,3500361,2,0,23,0
2020-04-04,Russia,NA,Chelyabinsk Oblast,3500361,3,0,26,0
2020-04-05,Russia,NA,Chelyabinsk Oblast,3500361,1,0,27,0
2020-04-06,Russia,NA,Chelyabinsk Oblast,3500361,4,0,31,0
2020-04-07,Russia,NA,Chelyabinsk Oblast,3500361,1,0,32,0
2020-04-09,Russia,NA,Chelyabinsk Oblast,3500361,2,0,34,0
2020-04-11,Russia,NA,Chelyabinsk Oblast,3500361,6,0,40,0
2020-04-13,Russia,NA,Chelyabinsk Oblast,3500361,3,0,43,0
2020-04-14,Russia,NA,Chelyabinsk Oblast,3500361,5,0,48,0
2020-04-15,Russia,NA,Chelyabinsk Oblast,3500361,3,0,51,0
2020-04-16,Russia,NA,Chelyabinsk Oblast,3500361,2,0,53,0
2020-04-17,Russia,NA,Chelyabinsk Oblast,3500361,4,0,57,0
2020-04-18,Russia,NA,Chelyabinsk Oblast,3500361,4,0,61,0
2020-04-19,Russia,NA,Chelyabinsk Oblast,3500361,7,0,68,0
2020-04-20,Russia,NA,Chelyabinsk Oblast,3500361,10,0,78,0
2020-04-21,Russia,NA,Chelyabinsk Oblast,3500361,14,0,92,0
2020-04-22,Russia,NA,Chelyabinsk Oblast,3500361,10,0,102,0
2020-04-23,Russia,NA,Chelyabinsk Oblast,3500361,9,0,111,0
2020-04-24,Russia,NA,Chelyabinsk Oblast,3500361,57,0,168,0
2020-04-25,Russia,NA,Chelyabinsk Oblast,3500361,72,0,240,0
2020-04-26,Russia,NA,Chelyabinsk Oblast,3500361,62,0,302,0
2020-04-27,Russia,NA,Chelyabinsk Oblast,3500361,58,0,360,0
2020-04-28,Russia,NA,Chelyabinsk Oblast,3500361,48,0,408,0
2020-04-29,Russia,NA,Chelyabinsk Oblast,3500361,19,0,427,0
2020-04-30,Russia,NA,Chelyabinsk Oblast,3500361,67,0,494,0
2020-05-01,Russia,NA,Chelyabinsk Oblast,3500361,44,0,538,0
2020-05-02,Russia,NA,Chelyabinsk Oblast,3500361,30,0,568,0
2020-05-03,Russia,NA,Chelyabinsk Oblast,3500361,63,0,631,0
2020-05-04,Russia,NA,Chelyabinsk Oblast,3500361,51,0,682,0
2020-05-05,Russia,NA,Chelyabinsk Oblast,3500361,86,0,768,0
2020-05-06,Russia,NA,Chelyabinsk Oblast,3500361,44,0,812,0
2020-05-07,Russia,NA,Chelyabinsk Oblast,3500361,27,0,839,0
2020-05-08,Russia,NA,Chelyabinsk Oblast,3500361,42,0,881,0
2020-05-09,Russia,NA,Chelyabinsk Oblast,3500361,70,0,951,0
2020-05-10,Russia,NA,Chelyabinsk Oblast,3500361,90,0,1041,0
2020-05-11,Russia,NA,Chelyabinsk Oblast,3500361,77,0,1118,0
2020-05-12,Russia,NA,Chelyabinsk Oblast,3500361,94,0,1212,0
2020-05-13,Russia,NA,Chelyabinsk Oblast,3500361,51,0,1263,0
2020-05-14,Russia,NA,Chelyabinsk Oblast,3500361,44,0,1307,0
2020-05-15,Russia,NA,Chelyabinsk Oblast,3500361,100,0,1407,0
2020-05-16,Russia,NA,Chelyabinsk Oblast,3500361,69,0,1476,0
2020-05-17,Russia,NA,Chelyabinsk Oblast,3500361,98,0,1574,0
2020-05-18,Russia,NA,Chelyabinsk Oblast,3500361,85,0,1659,0
2020-05-19,Russia,NA,Chelyabinsk Oblast,3500361,96,0,1755,0
2020-05-20,Russia,NA,Chelyabinsk Oblast,3500361,74,0,1829,0
2020-05-21,Russia,NA,Chelyabinsk Oblast,3500361,84,0,1913,0
2020-05-22,Russia,NA,Chelyabinsk Oblast,3500361,80,0,1993,0
2020-05-23,Russia,NA,Chelyabinsk Oblast,3500361,80,0,2073,0
2020-05-24,Russia,NA,Chelyabinsk Oblast,3500361,62,0,2135,0
2020-05-25,Russia,NA,Chelyabinsk Oblast,3500361,45,0,2180,0
2020-05-26,Russia,NA,Chelyabinsk Oblast,3500361,36,0,2216,0
2020-05-27,Russia,NA,Chelyabinsk Oblast,3500361,70,0,2286,0
2020-05-28,Russia,NA,Chelyabinsk Oblast,3500361,82,0,2368,0
2020-05-29,Russia,NA,Chelyabinsk Oblast,3500361,141,0,2509,0
2020-05-30,Russia,NA,Chelyabinsk Oblast,3500361,150,0,2659,0
2020-05-31,Russia,NA,Chelyabinsk Oblast,3500361,136,0,2795,0
2020-06-01,Russia,NA,Chelyabinsk Oblast,3500361,134,0,2929,0
2020-06-02,Russia,NA,Chelyabinsk Oblast,3500361,113,0,3042,0
2020-06-03,Russia,NA,Chelyabinsk Oblast,3500361,108,0,3150,0
2020-06-04,Russia,NA,Chelyabinsk Oblast,3500361,113,0,3263,0
2020-06-05,Russia,NA,Chelyabinsk Oblast,3500361,108,0,3371,0
2020-06-06,Russia,NA,Chelyabinsk Oblast,3500361,128,0,3499,0
2020-06-07,Russia,NA,Chelyabinsk Oblast,3500361,115,0,3614,0
2020-06-08,Russia,NA,Chelyabinsk Oblast,3500361,123,0,3737,0
2020-06-09,Russia,NA,Chelyabinsk Oblast,3500361,143,0,3880,0
2020-06-10,Russia,NA,Chelyabinsk Oblast,3500361,135,0,4015,0
2020-06-11,Russia,NA,Chelyabinsk Oblast,3500361,115,0,4130,0
2020-06-12,Russia,NA,Chelyabinsk Oblast,3500361,91,0,4221,0
2020-06-13,Russia,NA,Chelyabinsk Oblast,3500361,120,0,4341,0
2020-06-14,Russia,NA,Chelyabinsk Oblast,3500361,141,0,4482,0
2020-06-15,Russia,NA,Chelyabinsk Oblast,3500361,169,0,4651,0
2020-06-16,Russia,NA,Chelyabinsk Oblast,3500361,171,0,4822,0
2020-06-17,Russia,NA,Chelyabinsk Oblast,3500361,136,0,4958,0
2020-06-18,Russia,NA,Chelyabinsk Oblast,3500361,167,0,5125,0
2020-06-19,Russia,NA,Chelyabinsk Oblast,3500361,166,0,5291,0
2020-06-20,Russia,NA,Chelyabinsk Oblast,3500361,176,0,5467,0
2020-06-21,Russia,NA,Chelyabinsk Oblast,3500361,182,0,5649,0
2020-06-22,Russia,NA,Chelyabinsk Oblast,3500361,176,0,5825,0
2020-06-23,Russia,NA,Chelyabinsk Oblast,3500361,258,0,6083,0
2020-06-24,Russia,NA,Chelyabinsk Oblast,3500361,185,0,6268,0
2020-06-25,Russia,NA,Chelyabinsk Oblast,3500361,174,0,6442,0
2020-06-26,Russia,NA,Chelyabinsk Oblast,3500361,160,0,6602,0
2020-06-27,Russia,NA,Chelyabinsk Oblast,3500361,158,0,6760,0
2020-06-28,Russia,NA,Chelyabinsk Oblast,3500361,152,0,6912,0
2020-06-29,Russia,NA,Chelyabinsk Oblast,3500361,146,0,7058,0
2020-06-30,Russia,NA,Chelyabinsk Oblast,3500361,144,0,7202,0
2020-07-01,Russia,NA,Chelyabinsk Oblast,3500361,137,0,7339,0
2020-07-02,Russia,NA,Chelyabinsk Oblast,3500361,134,0,7473,0
2020-07-03,Russia,NA,Chelyabinsk Oblast,3500361,129,0,7602,0
2020-07-04,Russia,NA,Chelyabinsk Oblast,3500361,128,0,7730,0
2020-07-05,Russia,NA,Chelyabinsk Oblast,3500361,131,0,7861,0
2020-07-06,Russia,NA,Chelyabinsk Oblast,3500361,128,0,7989,0
2020-07-07,Russia,NA,Chelyabinsk Oblast,3500361,138,0,8127,0
2020-07-08,Russia,NA,Chelyabinsk Oblast,3500361,135,0,8262,0
2020-07-09,Russia,NA,Chelyabinsk Oblast,3500361,129,0,8391,0
2020-07-10,Russia,NA,Chelyabinsk Oblast,3500361,129,0,8520,0
2020-07-11,Russia,NA,Chelyabinsk Oblast,3500361,129,0,8649,0
2020-07-12,Russia,NA,Chelyabinsk Oblast,3500361,119,0,8768,0
2020-07-13,Russia,NA,Chelyabinsk Oblast,3500361,132,0,8900,0
2020-07-14,Russia,NA,Chelyabinsk Oblast,3500361,132,0,9032,0
2020-07-15,Russia,NA,Chelyabinsk Oblast,3500361,132,0,9164,0
2020-07-16,Russia,NA,Chelyabinsk Oblast,3500361,125,0,9289,0
2020-07-17,Russia,NA,Chelyabinsk Oblast,3500361,131,0,9420,0
2020-07-18,Russia,NA,Chelyabinsk Oblast,3500361,132,0,9552,0
2020-07-19,Russia,NA,Chelyabinsk Oblast,3500361,130,0,9682,0
2020-07-20,Russia,NA,Chelyabinsk Oblast,3500361,134,0,9816,0
2020-07-21,Russia,NA,Chelyabinsk Oblast,3500361,130,0,9946,0
2020-07-22,Russia,NA,Chelyabinsk Oblast,3500361,132,0,10078,0
2020-07-23,Russia,NA,Chelyabinsk Oblast,3500361,130,0,10208,0
2020-07-24,Russia,NA,Chelyabinsk Oblast,3500361,121,0,10329,0
2020-07-25,Russia,NA,Chelyabinsk Oblast,3500361,124,0,10453,0
2020-07-26,Russia,NA,Chelyabinsk Oblast,3500361,131,0,10584,0
2020-07-27,Russia,NA,Chelyabinsk Oblast,3500361,128,0,10712,0
2020-07-28,Russia,NA,Chelyabinsk Oblast,3500361,124,0,10836,0
2020-07-29,Russia,NA,Chelyabinsk Oblast,3500361,125,0,10961,0
2020-07-30,Russia,NA,Chelyabinsk Oblast,3500361,119,0,11080,0
2020-07-31,Russia,NA,Chelyabinsk Oblast,3500361,117,0,11197,0
2020-08-01,Russia,NA,Chelyabinsk Oblast,3500361,110,0,11307,0
2020-08-02,Russia,NA,Chelyabinsk Oblast,3500361,109,0,11416,0
2020-08-26,Russia,NA,Chelyabinsk Oblast,3500361,0,0,13351,103
2020-08-27,Russia,NA,Chelyabinsk Oblast,3500361,69,1,13420,104
2020-08-28,Russia,NA,Chelyabinsk Oblast,3500361,68,0,13488,104
2020-08-29,Russia,NA,Chelyabinsk Oblast,3500361,70,0,13558,104
2020-08-30,Russia,NA,Chelyabinsk Oblast,3500361,62,0,13620,104
2020-08-31,Russia,NA,Chelyabinsk Oblast,3500361,62,0,13682,104
2020-09-01,Russia,NA,Chelyabinsk Oblast,3500361,71,0,13753,104
2020-09-02,Russia,NA,Chelyabinsk Oblast,3500361,73,1,13826,105
2020-09-03,Russia,NA,Chelyabinsk Oblast,3500361,51,3,13877,108
2020-09-04,Russia,NA,Chelyabinsk Oblast,3500361,57,0,13934,108
2020-09-05,Russia,NA,Chelyabinsk Oblast,3500361,66,0,14000,108
2020-09-06,Russia,NA,Chelyabinsk Oblast,3500361,63,0,14063,108
2020-09-07,Russia,NA,Chelyabinsk Oblast,3500361,59,0,14122,108
2020-09-08,Russia,NA,Chelyabinsk Oblast,3500361,65,0,14187,108
2020-09-09,Russia,NA,Chelyabinsk Oblast,3500361,62,1,14249,109
2020-09-10,Russia,NA,Chelyabinsk Oblast,3500361,69,0,14318,109
2020-09-11,Russia,NA,Chelyabinsk Oblast,3500361,66,2,14384,111
2020-09-12,Russia,NA,Chelyabinsk Oblast,3500361,69,0,14453,111
2020-09-13,Russia,NA,Chelyabinsk Oblast,3500361,61,0,14514,111
2020-09-14,Russia,NA,Chelyabinsk Oblast,3500361,67,0,14581,111
2020-09-15,Russia,NA,Chelyabinsk Oblast,3500361,71,0,14652,111
2020-09-16,Russia,NA,Chelyabinsk Oblast,3500361,72,3,14724,114
2020-09-17,Russia,NA,Chelyabinsk Oblast,3500361,72,5,14796,119
2020-09-18,Russia,NA,Chelyabinsk Oblast,3500361,61,0,14857,119
2020-09-19,Russia,NA,Chelyabinsk Oblast,3500361,71,3,14928,122
2020-09-20,Russia,NA,Chelyabinsk Oblast,3500361,69,0,14997,122
2020-09-21,Russia,NA,Chelyabinsk Oblast,3500361,68,0,15065,122
2020-09-22,Russia,NA,Chelyabinsk Oblast,3500361,77,0,15142,122
2020-09-23,Russia,NA,Chelyabinsk Oblast,3500361,78,0,15220,122
2020-04-08,Russia,NA,Chuvashia,1231117,9,0,15,0
2020-04-09,Russia,NA,Chuvashia,1231117,2,0,17,0
2020-04-10,Russia,NA,Chuvashia,1231117,15,0,32,0
2020-04-11,Russia,NA,Chuvashia,1231117,7,0,39,0
2020-04-12,Russia,NA,Chuvashia,1231117,11,0,50,0
2020-04-13,Russia,NA,Chuvashia,1231117,15,0,65,0
2020-04-15,Russia,NA,Chuvashia,1231117,13,0,78,0
2020-04-16,Russia,NA,Chuvashia,1231117,47,0,125,0
2020-04-17,Russia,NA,Chuvashia,1231117,12,0,137,0
2020-04-18,Russia,NA,Chuvashia,1231117,27,0,164,0
2020-04-19,Russia,NA,Chuvashia,1231117,29,0,193,0
2020-04-20,Russia,NA,Chuvashia,1231117,32,0,225,0
2020-04-21,Russia,NA,Chuvashia,1231117,10,0,235,0
2020-04-22,Russia,NA,Chuvashia,1231117,27,0,262,0
2020-04-23,Russia,NA,Chuvashia,1231117,43,0,305,0
2020-04-24,Russia,NA,Chuvashia,1231117,43,0,348,0
2020-04-25,Russia,NA,Chuvashia,1231117,35,0,383,0
2020-04-26,Russia,NA,Chuvashia,1231117,38,0,421,0
2020-04-27,Russia,NA,Chuvashia,1231117,42,0,463,0
2020-04-29,Russia,NA,Chuvashia,1231117,37,0,500,0
2020-04-30,Russia,NA,Chuvashia,1231117,47,0,547,0
2020-05-01,Russia,NA,Chuvashia,1231117,41,0,588,0
2020-05-02,Russia,NA,Chuvashia,1231117,49,0,637,0
2020-05-03,Russia,NA,Chuvashia,1231117,55,0,692,0
2020-05-04,Russia,NA,Chuvashia,1231117,64,0,756,0
2020-05-05,Russia,NA,Chuvashia,1231117,49,0,805,0
2020-05-06,Russia,NA,Chuvashia,1231117,48,0,853,0
2020-05-07,Russia,NA,Chuvashia,1231117,58,0,911,0
2020-05-08,Russia,NA,Chuvashia,1231117,68,0,979,0
2020-05-09,Russia,NA,Chuvashia,1231117,63,0,1042,0
2020-05-10,Russia,NA,Chuvashia,1231117,63,0,1105,0
2020-05-11,Russia,NA,Chuvashia,1231117,76,0,1181,0
2020-05-12,Russia,NA,Chuvashia,1231117,62,0,1243,0
2020-05-13,Russia,NA,Chuvashia,1231117,78,0,1321,0
2020-05-14,Russia,NA,Chuvashia,1231117,79,0,1400,0
2020-05-15,Russia,NA,Chuvashia,1231117,83,0,1483,0
2020-05-16,Russia,NA,Chuvashia,1231117,81,0,1564,0
2020-05-17,Russia,NA,Chuvashia,1231117,97,0,1661,0
2020-05-18,Russia,NA,Chuvashia,1231117,87,0,1748,0
2020-05-19,Russia,NA,Chuvashia,1231117,76,0,1824,0
2020-05-20,Russia,NA,Chuvashia,1231117,73,0,1897,0
2020-05-21,Russia,NA,Chuvashia,1231117,78,0,1975,0
2020-05-22,Russia,NA,Chuvashia,1231117,90,0,2065,0
2020-05-23,Russia,NA,Chuvashia,1231117,91,0,2156,0
2020-05-24,Russia,NA,Chuvashia,1231117,95,0,2251,0
2020-05-25,Russia,NA,Chuvashia,1231117,97,0,2348,0
2020-05-26,Russia,NA,Chuvashia,1231117,85,0,2433,0
2020-05-27,Russia,NA,Chuvashia,1231117,73,0,2506,0
2020-05-28,Russia,NA,Chuvashia,1231117,81,0,2587,0
2020-05-29,Russia,NA,Chuvashia,1231117,83,0,2670,0
2020-05-30,Russia,NA,Chuvashia,1231117,89,0,2759,0
2020-05-31,Russia,NA,Chuvashia,1231117,87,0,2846,0
2020-06-01,Russia,NA,Chuvashia,1231117,88,0,2934,0
2020-06-02,Russia,NA,Chuvashia,1231117,88,0,3022,0
2020-06-03,Russia,NA,Chuvashia,1231117,87,0,3109,0
2020-06-04,Russia,NA,Chuvashia,1231117,83,0,3192,0
2020-06-05,Russia,NA,Chuvashia,1231117,80,0,3272,0
2020-06-06,Russia,NA,Chuvashia,1231117,84,0,3356,0
2020-06-07,Russia,NA,Chuvashia,1231117,80,0,3436,0
2020-06-08,Russia,NA,Chuvashia,1231117,86,0,3522,0
2020-06-09,Russia,NA,Chuvashia,1231117,85,0,3607,0
2020-06-10,Russia,NA,Chuvashia,1231117,79,0,3686,0
2020-06-11,Russia,NA,Chuvashia,1231117,77,0,3763,0
2020-06-12,Russia,NA,Chuvashia,1231117,76,0,3839,0
2020-06-13,Russia,NA,Chuvashia,1231117,78,0,3917,0
2020-06-14,Russia,NA,Chuvashia,1231117,77,0,3994,0
2020-06-15,Russia,NA,Chuvashia,1231117,79,0,4073,0
2020-06-16,Russia,NA,Chuvashia,1231117,74,0,4147,0
2020-06-17,Russia,NA,Chuvashia,1231117,73,0,4220,0
2020-06-18,Russia,NA,Chuvashia,1231117,72,0,4292,0
2020-06-19,Russia,NA,Chuvashia,1231117,70,0,4362,0
2020-06-20,Russia,NA,Chuvashia,1231117,71,0,4433,0
2020-06-21,Russia,NA,Chuvashia,1231117,69,0,4502,0
2020-06-22,Russia,NA,Chuvashia,1231117,71,0,4573,0
2020-06-23,Russia,NA,Chuvashia,1231117,66,0,4639,0
2020-06-24,Russia,NA,Chuvashia,1231117,62,0,4701,0
2020-06-25,Russia,NA,Chuvashia,1231117,62,0,4763,0
2020-06-26,Russia,NA,Chuvashia,1231117,58,0,4821,0
2020-06-27,Russia,NA,Chuvashia,1231117,55,0,4876,0
2020-06-28,Russia,NA,Chuvashia,1231117,58,0,4934,0
2020-06-29,Russia,NA,Chuvashia,1231117,52,0,4986,0
2020-06-30,Russia,NA,Chuvashia,1231117,51,0,5037,0
2020-07-01,Russia,NA,Chuvashia,1231117,58,0,5095,0
2020-07-02,Russia,NA,Chuvashia,1231117,60,0,5155,0
2020-07-03,Russia,NA,Chuvashia,1231117,59,0,5214,0
2020-07-04,Russia,NA,Chuvashia,1231117,62,0,5276,0
2020-07-05,Russia,NA,Chuvashia,1231117,71,0,5347,0
2020-07-06,Russia,NA,Chuvashia,1231117,68,0,5415,0
2020-07-07,Russia,NA,Chuvashia,1231117,67,0,5482,0
2020-07-08,Russia,NA,Chuvashia,1231117,69,0,5551,0
2020-07-09,Russia,NA,Chuvashia,1231117,67,0,5618,0
2020-07-10,Russia,NA,Chuvashia,1231117,61,0,5679,0
2020-07-11,Russia,NA,Chuvashia,1231117,57,0,5736,0
2020-07-12,Russia,NA,Chuvashia,1231117,55,0,5791,0
2020-07-13,Russia,NA,Chuvashia,1231117,56,0,5847,0
2020-07-14,Russia,NA,Chuvashia,1231117,54,0,5901,0
2020-07-15,Russia,NA,Chuvashia,1231117,58,0,5959,0
2020-07-16,Russia,NA,Chuvashia,1231117,57,0,6016,0
2020-07-17,Russia,NA,Chuvashia,1231117,55,0,6071,0
2020-07-18,Russia,NA,Chuvashia,1231117,54,0,6125,0
2020-07-19,Russia,NA,Chuvashia,1231117,52,0,6177,0
2020-07-20,Russia,NA,Chuvashia,1231117,48,0,6225,0
2020-07-21,Russia,NA,Chuvashia,1231117,46,0,6271,0
2020-07-22,Russia,NA,Chuvashia,1231117,42,0,6313,0
2020-07-23,Russia,NA,Chuvashia,1231117,46,0,6359,0
2020-07-24,Russia,NA,Chuvashia,1231117,42,0,6401,0
2020-07-25,Russia,NA,Chuvashia,1231117,44,0,6445,0
2020-07-26,Russia,NA,Chuvashia,1231117,45,0,6490,0
2020-07-27,Russia,NA,Chuvashia,1231117,38,0,6528,0
2020-07-28,Russia,NA,Chuvashia,1231117,42,0,6570,0
2020-07-29,Russia,NA,Chuvashia,1231117,44,0,6614,0
2020-07-30,Russia,NA,Chuvashia,1231117,41,0,6655,0
2020-07-31,Russia,NA,Chuvashia,1231117,40,0,6695,0
2020-08-01,Russia,NA,Chuvashia,1231117,40,0,6735,0
2020-08-02,Russia,NA,Chuvashia,1231117,37,0,6772,0
2020-08-26,Russia,NA,Chuvashia,1231117,0,0,7619,68
2020-08-27,Russia,NA,Chuvashia,1231117,32,0,7651,68
2020-08-28,Russia,NA,Chuvashia,1231117,31,2,7682,70
2020-08-29,Russia,NA,Chuvashia,1231117,31,0,7713,70
2020-08-30,Russia,NA,Chuvashia,1231117,30,0,7743,70
2020-08-31,Russia,NA,Chuvashia,1231117,31,0,7774,70
2020-09-01,Russia,NA,Chuvashia,1231117,29,0,7803,70
2020-09-02,Russia,NA,Chuvashia,1231117,33,1,7836,71
2020-09-03,Russia,NA,Chuvashia,1231117,29,0,7865,71
2020-09-04,Russia,NA,Chuvashia,1231117,30,1,7895,72
2020-09-05,Russia,NA,Chuvashia,1231117,28,1,7923,73
2020-09-06,Russia,NA,Chuvashia,1231117,30,0,7953,73
2020-09-07,Russia,NA,Chuvashia,1231117,30,0,7983,73
2020-09-08,Russia,NA,Chuvashia,1231117,31,1,8014,74
2020-09-09,Russia,NA,Chuvashia,1231117,29,1,8043,75
2020-09-10,Russia,NA,Chuvashia,1231117,27,1,8070,76
2020-09-11,Russia,NA,Chuvashia,1231117,26,0,8096,76
2020-09-12,Russia,NA,Chuvashia,1231117,25,1,8121,77
2020-09-13,Russia,NA,Chuvashia,1231117,24,2,8145,79
2020-09-14,Russia,NA,Chuvashia,1231117,24,2,8169,81
2020-09-15,Russia,NA,Chuvashia,1231117,25,0,8194,81
2020-09-16,Russia,NA,Chuvashia,1231117,27,2,8221,83
2020-09-17,Russia,NA,Chuvashia,1231117,27,0,8248,83
2020-09-18,Russia,NA,Chuvashia,1231117,26,2,8274,85
2020-09-19,Russia,NA,Chuvashia,1231117,27,0,8301,85
2020-09-20,Russia,NA,Chuvashia,1231117,26,0,8327,85
2020-09-21,Russia,NA,Chuvashia,1231117,25,0,8352,85
2020-09-22,Russia,NA,Chuvashia,1231117,28,4,8380,89
2020-09-23,Russia,NA,Chuvashia,1231117,27,0,8407,89
2020-03-31,Russia,NA,Dagestan,3063885,9,0,13,0
2020-04-01,Russia,NA,Dagestan,3063885,2,0,15,0
2020-04-02,Russia,NA,Dagestan,3063885,10,0,25,0
2020-04-06,Russia,NA,Dagestan,3063885,5,0,30,0
2020-04-07,Russia,NA,Dagestan,3063885,13,0,43,0
2020-04-08,Russia,NA,Dagestan,3063885,1,0,44,0
2020-04-09,Russia,NA,Dagestan,3063885,13,0,57,0
2020-04-10,Russia,NA,Dagestan,3063885,1,0,58,0
2020-04-11,Russia,NA,Dagestan,3063885,26,0,84,0
2020-04-14,Russia,NA,Dagestan,3063885,16,0,100,0
2020-04-15,Russia,NA,Dagestan,3063885,5,0,105,0
2020-04-16,Russia,NA,Dagestan,3063885,49,0,154,0
2020-04-17,Russia,NA,Dagestan,3063885,59,0,213,0
2020-04-18,Russia,NA,Dagestan,3063885,44,0,257,0
2020-04-19,Russia,NA,Dagestan,3063885,35,0,292,0
2020-04-20,Russia,NA,Dagestan,3063885,39,0,331,0
2020-04-21,Russia,NA,Dagestan,3063885,40,0,371,0
2020-04-22,Russia,NA,Dagestan,3063885,46,0,417,0
2020-04-23,Russia,NA,Dagestan,3063885,37,0,454,0
2020-04-24,Russia,NA,Dagestan,3063885,113,0,567,0
2020-04-25,Russia,NA,Dagestan,3063885,157,0,724,0
2020-04-26,Russia,NA,Dagestan,3063885,103,0,827,0
2020-04-27,Russia,NA,Dagestan,3063885,167,0,994,0
2020-04-28,Russia,NA,Dagestan,3063885,153,0,1147,0
2020-04-29,Russia,NA,Dagestan,3063885,84,0,1231,0
2020-04-30,Russia,NA,Dagestan,3063885,158,0,1389,0
2020-05-01,Russia,NA,Dagestan,3063885,164,0,1553,0
2020-05-02,Russia,NA,Dagestan,3063885,109,0,1662,0
2020-05-03,Russia,NA,Dagestan,3063885,136,0,1798,0
2020-05-04,Russia,NA,Dagestan,3063885,160,0,1958,0
2020-05-05,Russia,NA,Dagestan,3063885,128,0,2086,0
2020-05-06,Russia,NA,Dagestan,3063885,181,0,2267,0
2020-05-07,Russia,NA,Dagestan,3063885,105,0,2372,0
2020-05-08,Russia,NA,Dagestan,3063885,96,0,2468,0
2020-05-09,Russia,NA,Dagestan,3063885,92,0,2560,0
2020-05-10,Russia,NA,Dagestan,3063885,93,0,2653,0
2020-05-11,Russia,NA,Dagestan,3063885,119,0,2772,0
2020-05-12,Russia,NA,Dagestan,3063885,116,0,2888,0
2020-05-13,Russia,NA,Dagestan,3063885,109,0,2997,0
2020-05-14,Russia,NA,Dagestan,3063885,98,0,3095,0
2020-05-15,Russia,NA,Dagestan,3063885,97,0,3192,0
2020-05-16,Russia,NA,Dagestan,3063885,88,0,3280,0
2020-05-17,Russia,NA,Dagestan,3063885,91,0,3371,0
2020-05-18,Russia,NA,Dagestan,3063885,89,0,3460,0
2020-05-19,Russia,NA,Dagestan,3063885,93,0,3553,0
2020-05-20,Russia,NA,Dagestan,3063885,90,0,3643,0
2020-05-21,Russia,NA,Dagestan,3063885,103,0,3746,0
2020-05-22,Russia,NA,Dagestan,3063885,109,0,3855,0
2020-05-23,Russia,NA,Dagestan,3063885,127,0,3982,0
2020-05-24,Russia,NA,Dagestan,3063885,113,0,4095,0
2020-05-25,Russia,NA,Dagestan,3063885,110,0,4205,0
2020-05-26,Russia,NA,Dagestan,3063885,89,0,4294,0
2020-05-27,Russia,NA,Dagestan,3063885,161,0,4455,0
2020-05-28,Russia,NA,Dagestan,3063885,124,0,4579,0
2020-05-29,Russia,NA,Dagestan,3063885,125,0,4704,0
2020-05-30,Russia,NA,Dagestan,3063885,126,0,4830,0
2020-05-31,Russia,NA,Dagestan,3063885,125,0,4955,0
2020-06-01,Russia,NA,Dagestan,3063885,141,0,5096,0
2020-06-02,Russia,NA,Dagestan,3063885,132,0,5228,0
2020-06-03,Russia,NA,Dagestan,3063885,113,0,5341,0
2020-06-04,Russia,NA,Dagestan,3063885,122,0,5463,0
2020-06-05,Russia,NA,Dagestan,3063885,124,0,5587,0
2020-06-06,Russia,NA,Dagestan,3063885,156,0,5743,0
2020-06-07,Russia,NA,Dagestan,3063885,115,0,5858,0
2020-06-08,Russia,NA,Dagestan,3063885,112,0,5970,0
2020-06-09,Russia,NA,Dagestan,3063885,107,0,6077,0
2020-06-10,Russia,NA,Dagestan,3063885,98,0,6175,0
2020-06-11,Russia,NA,Dagestan,3063885,97,0,6272,0
2020-06-12,Russia,NA,Dagestan,3063885,95,0,6367,0
2020-06-13,Russia,NA,Dagestan,3063885,96,0,6463,0
2020-06-14,Russia,NA,Dagestan,3063885,94,0,6557,0
2020-06-15,Russia,NA,Dagestan,3063885,95,0,6652,0
2020-06-16,Russia,NA,Dagestan,3063885,93,0,6745,0
2020-06-17,Russia,NA,Dagestan,3063885,92,0,6837,0
2020-06-18,Russia,NA,Dagestan,3063885,90,0,6927,0
2020-06-19,Russia,NA,Dagestan,3063885,88,0,7015,0
2020-06-20,Russia,NA,Dagestan,3063885,88,0,7103,0
2020-06-21,Russia,NA,Dagestan,3063885,85,0,7188,0
2020-06-22,Russia,NA,Dagestan,3063885,79,0,7267,0
2020-06-23,Russia,NA,Dagestan,3063885,73,0,7340,0
2020-06-24,Russia,NA,Dagestan,3063885,75,0,7415,0
2020-06-25,Russia,NA,Dagestan,3063885,73,0,7488,0
2020-06-26,Russia,NA,Dagestan,3063885,73,0,7561,0
2020-06-27,Russia,NA,Dagestan,3063885,75,0,7636,0
2020-06-28,Russia,NA,Dagestan,3063885,71,0,7707,0
2020-06-29,Russia,NA,Dagestan,3063885,68,0,7775,0
2020-06-30,Russia,NA,Dagestan,3063885,65,0,7840,0
2020-07-01,Russia,NA,Dagestan,3063885,65,0,7905,0
2020-07-02,Russia,NA,Dagestan,3063885,63,0,7968,0
2020-07-03,Russia,NA,Dagestan,3063885,57,0,8025,0
2020-07-04,Russia,NA,Dagestan,3063885,55,0,8080,0
2020-07-05,Russia,NA,Dagestan,3063885,52,0,8132,0
2020-07-06,Russia,NA,Dagestan,3063885,52,0,8184,0
2020-07-07,Russia,NA,Dagestan,3063885,48,0,8232,0
2020-07-08,Russia,NA,Dagestan,3063885,48,0,8280,0
2020-07-09,Russia,NA,Dagestan,3063885,47,0,8327,0
2020-07-10,Russia,NA,Dagestan,3063885,47,0,8374,0
2020-07-11,Russia,NA,Dagestan,3063885,48,0,8422,0
2020-07-12,Russia,NA,Dagestan,3063885,46,0,8468,0
2020-07-13,Russia,NA,Dagestan,3063885,46,0,8514,0
2020-07-14,Russia,NA,Dagestan,3063885,46,0,8560,0
2020-07-15,Russia,NA,Dagestan,3063885,42,0,8602,0
2020-07-16,Russia,NA,Dagestan,3063885,45,0,8647,0
2020-07-17,Russia,NA,Dagestan,3063885,44,0,8691,0
2020-07-18,Russia,NA,Dagestan,3063885,44,0,8735,0
2020-07-19,Russia,NA,Dagestan,3063885,43,0,8778,0
2020-07-20,Russia,NA,Dagestan,3063885,41,0,8819,0
2020-07-21,Russia,NA,Dagestan,3063885,41,0,8860,0
2020-07-22,Russia,NA,Dagestan,3063885,41,0,8901,0
2020-07-23,Russia,NA,Dagestan,3063885,40,0,8941,0
2020-07-24,Russia,NA,Dagestan,3063885,40,0,8981,0
2020-07-25,Russia,NA,Dagestan,3063885,40,0,9021,0
2020-07-26,Russia,NA,Dagestan,3063885,41,0,9062,0
2020-07-27,Russia,NA,Dagestan,3063885,41,0,9103,0
2020-07-28,Russia,NA,Dagestan,3063885,40,0,9143,0
2020-07-29,Russia,NA,Dagestan,3063885,40,0,9183,0
2020-07-30,Russia,NA,Dagestan,3063885,40,0,9223,0
2020-07-31,Russia,NA,Dagestan,3063885,43,0,9266,0
2020-08-01,Russia,NA,Dagestan,3063885,42,0,9308,0
2020-08-02,Russia,NA,Dagestan,3063885,42,0,9350,0
2020-08-26,Russia,NA,Dagestan,3063885,0,0,10651,487
2020-08-27,Russia,NA,Dagestan,3063885,65,2,10716,489
2020-08-28,Russia,NA,Dagestan,3063885,72,5,10788,494
2020-08-29,Russia,NA,Dagestan,3063885,70,1,10858,495
2020-08-30,Russia,NA,Dagestan,3063885,70,0,10928,495
2020-08-31,Russia,NA,Dagestan,3063885,71,2,10999,497
2020-09-01,Russia,NA,Dagestan,3063885,74,2,11073,499
2020-09-02,Russia,NA,Dagestan,3063885,72,3,11145,502
2020-09-03,Russia,NA,Dagestan,3063885,74,3,11219,505
2020-09-04,Russia,NA,Dagestan,3063885,73,1,11292,506
2020-09-05,Russia,NA,Dagestan,3063885,75,1,11367,507
2020-09-06,Russia,NA,Dagestan,3063885,75,0,11442,507
2020-09-07,Russia,NA,Dagestan,3063885,78,3,11520,510
2020-09-08,Russia,NA,Dagestan,3063885,78,2,11598,512
2020-09-09,Russia,NA,Dagestan,3063885,80,2,11678,514
2020-09-10,Russia,NA,Dagestan,3063885,82,1,11760,515
2020-09-11,Russia,NA,Dagestan,3063885,82,2,11842,517
2020-09-12,Russia,NA,Dagestan,3063885,83,4,11925,521
2020-09-13,Russia,NA,Dagestan,3063885,83,2,12008,523
2020-09-14,Russia,NA,Dagestan,3063885,84,1,12092,524
2020-09-15,Russia,NA,Dagestan,3063885,83,4,12175,528
2020-09-16,Russia,NA,Dagestan,3063885,85,1,12260,529
2020-09-17,Russia,NA,Dagestan,3063885,85,4,12345,533
2020-09-18,Russia,NA,Dagestan,3063885,84,5,12429,538
2020-09-19,Russia,NA,Dagestan,3063885,85,5,12514,543
2020-09-20,Russia,NA,Dagestan,3063885,86,4,12600,547
2020-09-21,Russia,NA,Dagestan,3063885,85,5,12685,552
2020-09-22,Russia,NA,Dagestan,3063885,83,5,12768,557
2020-09-23,Russia,NA,Dagestan,3063885,83,7,12851,564
2020-04-08,Russia,NA,Ingushetia,488043,18,0,25,0
2020-04-10,Russia,NA,Ingushetia,488043,4,0,29,0
2020-04-13,Russia,NA,Ingushetia,488043,5,0,34,0
2020-04-15,Russia,NA,Ingushetia,488043,56,0,90,0
2020-04-16,Russia,NA,Ingushetia,488043,63,0,153,0
2020-04-17,Russia,NA,Ingushetia,488043,38,0,191,0
2020-04-18,Russia,NA,Ingushetia,488043,36,0,227,0
2020-04-19,Russia,NA,Ingushetia,488043,42,0,269,0
2020-04-20,Russia,NA,Ingushetia,488043,39,0,308,0
2020-04-21,Russia,NA,Ingushetia,488043,46,0,354,0
2020-04-22,Russia,NA,Ingushetia,488043,43,0,397,0
2020-04-23,Russia,NA,Ingushetia,488043,39,0,436,0
2020-04-24,Russia,NA,Ingushetia,488043,38,0,474,0
2020-04-25,Russia,NA,Ingushetia,488043,41,0,515,0
2020-04-26,Russia,NA,Ingushetia,488043,37,0,552,0
2020-04-27,Russia,NA,Ingushetia,488043,38,0,590,0
2020-04-28,Russia,NA,Ingushetia,488043,43,0,633,0
2020-04-29,Russia,NA,Ingushetia,488043,46,0,679,0
2020-04-30,Russia,NA,Ingushetia,488043,43,0,722,0
2020-05-01,Russia,NA,Ingushetia,488043,47,0,769,0
2020-05-02,Russia,NA,Ingushetia,488043,45,0,814,0
2020-05-03,Russia,NA,Ingushetia,488043,51,0,865,0
2020-05-04,Russia,NA,Ingushetia,488043,53,0,918,0
2020-05-05,Russia,NA,Ingushetia,488043,48,0,966,0
2020-05-06,Russia,NA,Ingushetia,488043,52,0,1018,0
2020-05-07,Russia,NA,Ingushetia,488043,49,0,1067,0
2020-05-08,Russia,NA,Ingushetia,488043,41,0,1108,0
2020-05-09,Russia,NA,Ingushetia,488043,44,0,1152,0
2020-05-10,Russia,NA,Ingushetia,488043,47,0,1199,0
2020-05-11,Russia,NA,Ingushetia,488043,46,0,1245,0
2020-05-12,Russia,NA,Ingushetia,488043,45,0,1290,0
2020-05-13,Russia,NA,Ingushetia,488043,43,0,1333,0
2020-05-14,Russia,NA,Ingushetia,488043,39,0,1372,0
2020-05-15,Russia,NA,Ingushetia,488043,35,0,1407,0
2020-05-16,Russia,NA,Ingushetia,488043,36,0,1443,0
2020-05-17,Russia,NA,Ingushetia,488043,37,0,1480,0
2020-05-18,Russia,NA,Ingushetia,488043,35,0,1515,0
2020-05-19,Russia,NA,Ingushetia,488043,46,0,1561,0
2020-05-20,Russia,NA,Ingushetia,488043,44,0,1605,0
2020-05-21,Russia,NA,Ingushetia,488043,43,0,1648,0
2020-05-22,Russia,NA,Ingushetia,488043,44,0,1692,0
2020-05-23,Russia,NA,Ingushetia,488043,42,0,1734,0
2020-05-24,Russia,NA,Ingushetia,488043,44,0,1778,0
2020-05-25,Russia,NA,Ingushetia,488043,45,0,1823,0
2020-05-26,Russia,NA,Ingushetia,488043,43,0,1866,0
2020-05-27,Russia,NA,Ingushetia,488043,40,0,1906,0
2020-05-28,Russia,NA,Ingushetia,488043,49,0,1955,0
2020-05-29,Russia,NA,Ingushetia,488043,45,0,2000,0
2020-05-30,Russia,NA,Ingushetia,488043,44,0,2044,0
2020-05-31,Russia,NA,Ingushetia,488043,39,0,2083,0
2020-06-01,Russia,NA,Ingushetia,488043,44,0,2127,0
2020-06-02,Russia,NA,Ingushetia,488043,37,0,2164,0
2020-06-03,Russia,NA,Ingushetia,488043,33,0,2197,0
2020-06-04,Russia,NA,Ingushetia,488043,31,0,2228,0
2020-06-05,Russia,NA,Ingushetia,488043,40,0,2268,0
2020-06-06,Russia,NA,Ingushetia,488043,39,0,2307,0
2020-06-07,Russia,NA,Ingushetia,488043,35,0,2342,0
2020-06-08,Russia,NA,Ingushetia,488043,26,0,2368,0
2020-06-09,Russia,NA,Ingushetia,488043,31,0,2399,0
2020-06-10,Russia,NA,Ingushetia,488043,39,0,2438,0
2020-06-11,Russia,NA,Ingushetia,488043,36,0,2474,0
2020-06-12,Russia,NA,Ingushetia,488043,36,0,2510,0
2020-06-13,Russia,NA,Ingushetia,488043,40,0,2550,0
2020-06-14,Russia,NA,Ingushetia,488043,37,0,2587,0
2020-06-15,Russia,NA,Ingushetia,488043,36,0,2623,0
2020-06-16,Russia,NA,Ingushetia,488043,34,0,2657,0
2020-06-17,Russia,NA,Ingushetia,488043,36,0,2693,0
2020-06-18,Russia,NA,Ingushetia,488043,32,0,2725,0
2020-06-19,Russia,NA,Ingushetia,488043,30,0,2755,0
2020-06-20,Russia,NA,Ingushetia,488043,27,0,2782,0
2020-06-21,Russia,NA,Ingushetia,488043,24,0,2806,0
2020-06-22,Russia,NA,Ingushetia,488043,22,0,2828,0
2020-06-23,Russia,NA,Ingushetia,488043,32,0,2860,0
2020-06-24,Russia,NA,Ingushetia,488043,29,0,2889,0
2020-06-25,Russia,NA,Ingushetia,488043,27,0,2916,0
2020-06-26,Russia,NA,Ingushetia,488043,30,0,2946,0
2020-06-27,Russia,NA,Ingushetia,488043,32,0,2978,0
2020-06-28,Russia,NA,Ingushetia,488043,17,0,2995,0
2020-06-29,Russia,NA,Ingushetia,488043,25,0,3020,0
2020-06-30,Russia,NA,Ingushetia,488043,27,0,3047,0
2020-07-01,Russia,NA,Ingushetia,488043,22,0,3069,0
2020-07-02,Russia,NA,Ingushetia,488043,19,0,3088,0
2020-07-03,Russia,NA,Ingushetia,488043,24,0,3112,0
2020-07-04,Russia,NA,Ingushetia,488043,26,0,3138,0
2020-07-05,Russia,NA,Ingushetia,488043,16,0,3154,0
2020-07-06,Russia,NA,Ingushetia,488043,15,0,3169,0
2020-07-07,Russia,NA,Ingushetia,488043,16,0,3185,0
2020-07-08,Russia,NA,Ingushetia,488043,20,0,3205,0
2020-07-09,Russia,NA,Ingushetia,488043,23,0,3228,0
2020-07-10,Russia,NA,Ingushetia,488043,25,0,3253,0
2020-07-11,Russia,NA,Ingushetia,488043,27,0,3280,0
2020-07-12,Russia,NA,Ingushetia,488043,22,0,3302,0
2020-07-13,Russia,NA,Ingushetia,488043,16,0,3318,0
2020-07-14,Russia,NA,Ingushetia,488043,10,0,3328,0
2020-07-15,Russia,NA,Ingushetia,488043,16,0,3344,0
2020-07-16,Russia,NA,Ingushetia,488043,22,0,3366,0
2020-07-17,Russia,NA,Ingushetia,488043,27,0,3393,0
2020-07-18,Russia,NA,Ingushetia,488043,26,0,3419,0
2020-07-19,Russia,NA,Ingushetia,488043,19,0,3438,0
2020-07-20,Russia,NA,Ingushetia,488043,10,0,3448,0
2020-07-21,Russia,NA,Ingushetia,488043,11,0,3459,0
2020-07-22,Russia,NA,Ingushetia,488043,22,0,3481,0
2020-07-23,Russia,NA,Ingushetia,488043,21,0,3502,0
2020-07-24,Russia,NA,Ingushetia,488043,27,0,3529,0
2020-07-25,Russia,NA,Ingushetia,488043,20,0,3549,0
2020-07-26,Russia,NA,Ingushetia,488043,29,0,3578,0
2020-07-27,Russia,NA,Ingushetia,488043,27,0,3605,0
2020-07-28,Russia,NA,Ingushetia,488043,15,0,3620,0
2020-07-29,Russia,NA,Ingushetia,488043,24,0,3644,0
2020-07-30,Russia,NA,Ingushetia,488043,21,0,3665,0
2020-07-31,Russia,NA,Ingushetia,488043,23,0,3688,0
2020-08-01,Russia,NA,Ingushetia,488043,21,0,3709,0
2020-08-02,Russia,NA,Ingushetia,488043,20,0,3729,0
2020-08-26,Russia,NA,Ingushetia,488043,0,0,4256,76
2020-08-27,Russia,NA,Ingushetia,488043,21,0,4277,76
2020-08-28,Russia,NA,Ingushetia,488043,29,0,4306,76
2020-08-29,Russia,NA,Ingushetia,488043,32,0,4338,76
2020-08-30,Russia,NA,Ingushetia,488043,30,0,4368,76
2020-08-31,Russia,NA,Ingushetia,488043,29,0,4397,76
2020-09-01,Russia,NA,Ingushetia,488043,27,0,4424,76
2020-09-02,Russia,NA,Ingushetia,488043,30,0,4454,76
2020-09-03,Russia,NA,Ingushetia,488043,23,0,4477,76
2020-09-04,Russia,NA,Ingushetia,488043,33,0,4510,76
2020-09-05,Russia,NA,Ingushetia,488043,37,0,4547,76
2020-09-06,Russia,NA,Ingushetia,488043,39,1,4586,77
2020-09-07,Russia,NA,Ingushetia,488043,36,0,4622,77
2020-09-08,Russia,NA,Ingushetia,488043,41,0,4663,77
2020-09-09,Russia,NA,Ingushetia,488043,39,0,4702,77
2020-09-10,Russia,NA,Ingushetia,488043,34,0,4736,77
2020-09-11,Russia,NA,Ingushetia,488043,37,0,4773,77
2020-09-12,Russia,NA,Ingushetia,488043,41,0,4814,77
2020-09-13,Russia,NA,Ingushetia,488043,45,0,4859,77
2020-09-14,Russia,NA,Ingushetia,488043,42,0,4901,77
2020-09-15,Russia,NA,Ingushetia,488043,48,0,4949,77
2020-09-16,Russia,NA,Ingushetia,488043,46,1,4995,78
2020-09-17,Russia,NA,Ingushetia,488043,49,0,5044,78
2020-09-18,Russia,NA,Ingushetia,488043,45,0,5089,78
2020-09-19,Russia,NA,Ingushetia,488043,47,0,5136,78
2020-09-20,Russia,NA,Ingushetia,488043,49,1,5185,79
2020-09-21,Russia,NA,Ingushetia,488043,46,0,5231,79
2020-09-22,Russia,NA,Ingushetia,488043,48,1,5279,80
2020-09-23,Russia,NA,Ingushetia,488043,49,2,5328,82
2020-04-06,Russia,NA,Irkutsk Oblast,2404195,3,0,11,0
2020-04-07,Russia,NA,Irkutsk Oblast,2404195,3,0,14,0
2020-04-09,Russia,NA,Irkutsk Oblast,2404195,3,0,17,0
2020-04-10,Russia,NA,Irkutsk Oblast,2404195,4,0,21,0
2020-04-11,Russia,NA,Irkutsk Oblast,2404195,2,0,23,0
2020-04-12,Russia,NA,Irkutsk Oblast,2404195,5,0,28,0
2020-04-13,Russia,NA,Irkutsk Oblast,2404195,7,0,35,0
2020-04-14,Russia,NA,Irkutsk Oblast,2404195,4,0,39,0
2020-04-16,Russia,NA,Irkutsk Oblast,2404195,6,0,45,0
2020-04-17,Russia,NA,Irkutsk Oblast,2404195,2,0,47,0
2020-04-18,Russia,NA,Irkutsk Oblast,2404195,7,0,54,0
2020-04-19,Russia,NA,Irkutsk Oblast,2404195,1,0,55,0
2020-04-20,Russia,NA,Irkutsk Oblast,2404195,10,0,65,0
2020-04-21,Russia,NA,Irkutsk Oblast,2404195,3,0,68,0
2020-04-22,Russia,NA,Irkutsk Oblast,2404195,7,0,75,0
2020-04-24,Russia,NA,Irkutsk Oblast,2404195,5,0,80,0
2020-04-25,Russia,NA,Irkutsk Oblast,2404195,5,0,85,0
2020-04-26,Russia,NA,Irkutsk Oblast,2404195,2,0,87,0
2020-04-28,Russia,NA,Irkutsk Oblast,2404195,8,0,95,0
2020-04-29,Russia,NA,Irkutsk Oblast,2404195,6,0,101,0
2020-04-30,Russia,NA,Irkutsk Oblast,2404195,4,0,105,0
2020-05-01,Russia,NA,Irkutsk Oblast,2404195,18,0,123,0
2020-05-02,Russia,NA,Irkutsk Oblast,2404195,7,0,130,0
2020-05-03,Russia,NA,Irkutsk Oblast,2404195,20,0,150,0
2020-05-04,Russia,NA,Irkutsk Oblast,2404195,27,0,177,0
2020-05-05,Russia,NA,Irkutsk Oblast,2404195,23,0,200,0
2020-05-06,Russia,NA,Irkutsk Oblast,2404195,31,0,231,0
2020-05-07,Russia,NA,Irkutsk Oblast,2404195,6,0,237,0
2020-05-08,Russia,NA,Irkutsk Oblast,2404195,18,0,255,0
2020-05-09,Russia,NA,Irkutsk Oblast,2404195,16,0,271,0
2020-05-10,Russia,NA,Irkutsk Oblast,2404195,18,0,289,0
2020-05-11,Russia,NA,Irkutsk Oblast,2404195,24,0,313,0
2020-05-12,Russia,NA,Irkutsk Oblast,2404195,20,0,333,0
2020-05-13,Russia,NA,Irkutsk Oblast,2404195,20,0,353,0
2020-05-14,Russia,NA,Irkutsk Oblast,2404195,26,0,379,0
2020-05-15,Russia,NA,Irkutsk Oblast,2404195,95,0,474,0
2020-05-16,Russia,NA,Irkutsk Oblast,2404195,25,0,499,0
2020-05-17,Russia,NA,Irkutsk Oblast,2404195,27,0,526,0
2020-05-18,Russia,NA,Irkutsk Oblast,2404195,75,0,601,0
2020-05-19,Russia,NA,Irkutsk Oblast,2404195,97,0,698,0
2020-05-20,Russia,NA,Irkutsk Oblast,2404195,48,0,746,0
2020-05-21,Russia,NA,Irkutsk Oblast,2404195,34,0,780,0
2020-05-22,Russia,NA,Irkutsk Oblast,2404195,83,0,863,0
2020-05-23,Russia,NA,Irkutsk Oblast,2404195,95,0,958,0
2020-05-24,Russia,NA,Irkutsk Oblast,2404195,120,0,1078,0
2020-05-25,Russia,NA,Irkutsk Oblast,2404195,116,0,1194,0
2020-05-26,Russia,NA,Irkutsk Oblast,2404195,112,0,1306,0
2020-05-27,Russia,NA,Irkutsk Oblast,2404195,70,0,1376,0
2020-05-28,Russia,NA,Irkutsk Oblast,2404195,62,0,1438,0
2020-05-29,Russia,NA,Irkutsk Oblast,2404195,60,0,1498,0
2020-05-30,Russia,NA,Irkutsk Oblast,2404195,162,0,1660,0
2020-05-31,Russia,NA,Irkutsk Oblast,2404195,90,0,1750,0
2020-06-01,Russia,NA,Irkutsk Oblast,2404195,229,0,1979,0
2020-06-02,Russia,NA,Irkutsk Oblast,2404195,210,0,2189,0
2020-06-03,Russia,NA,Irkutsk Oblast,2404195,120,0,2309,0
2020-06-04,Russia,NA,Irkutsk Oblast,2404195,138,0,2447,0
2020-06-05,Russia,NA,Irkutsk Oblast,2404195,95,0,2542,0
2020-06-06,Russia,NA,Irkutsk Oblast,2404195,71,0,2613,0
2020-06-07,Russia,NA,Irkutsk Oblast,2404195,179,0,2792,0
2020-06-08,Russia,NA,Irkutsk Oblast,2404195,85,0,2877,0
2020-06-09,Russia,NA,Irkutsk Oblast,2404195,206,0,3083,0
2020-06-10,Russia,NA,Irkutsk Oblast,2404195,182,0,3265,0
2020-06-11,Russia,NA,Irkutsk Oblast,2404195,240,0,3505,0
2020-06-12,Russia,NA,Irkutsk Oblast,2404195,151,0,3656,0
2020-06-13,Russia,NA,Irkutsk Oblast,2404195,163,0,3819,0
2020-06-14,Russia,NA,Irkutsk Oblast,2404195,209,0,4028,0
2020-06-15,Russia,NA,Irkutsk Oblast,2404195,127,0,4155,0
2020-06-16,Russia,NA,Irkutsk Oblast,2404195,319,0,4474,0
2020-06-17,Russia,NA,Irkutsk Oblast,2404195,179,0,4653,0
2020-06-18,Russia,NA,Irkutsk Oblast,2404195,133,0,4786,0
2020-06-19,Russia,NA,Irkutsk Oblast,2404195,164,0,4950,0
2020-06-20,Russia,NA,Irkutsk Oblast,2404195,193,0,5143,0
2020-06-21,Russia,NA,Irkutsk Oblast,2404195,191,0,5334,0
2020-06-22,Russia,NA,Irkutsk Oblast,2404195,194,0,5528,0
2020-06-23,Russia,NA,Irkutsk Oblast,2404195,198,0,5726,0
2020-06-24,Russia,NA,Irkutsk Oblast,2404195,193,0,5919,0
2020-06-25,Russia,NA,Irkutsk Oblast,2404195,209,0,6128,0
2020-06-26,Russia,NA,Irkutsk Oblast,2404195,210,0,6338,0
2020-06-27,Russia,NA,Irkutsk Oblast,2404195,237,0,6575,0
2020-06-28,Russia,NA,Irkutsk Oblast,2404195,232,0,6807,0
2020-06-29,Russia,NA,Irkutsk Oblast,2404195,236,0,7043,0
2020-06-30,Russia,NA,Irkutsk Oblast,2404195,242,0,7285,0
2020-07-01,Russia,NA,Irkutsk Oblast,2404195,248,0,7533,0
2020-07-02,Russia,NA,Irkutsk Oblast,2404195,243,0,7776,0
2020-07-03,Russia,NA,Irkutsk Oblast,2404195,249,0,8025,0
2020-07-04,Russia,NA,Irkutsk Oblast,2404195,235,0,8260,0
2020-07-05,Russia,NA,Irkutsk Oblast,2404195,241,0,8501,0
2020-07-06,Russia,NA,Irkutsk Oblast,2404195,239,0,8740,0
2020-07-07,Russia,NA,Irkutsk Oblast,2404195,245,0,8985,0
2020-07-08,Russia,NA,Irkutsk Oblast,2404195,240,0,9225,0
2020-07-09,Russia,NA,Irkutsk Oblast,2404195,243,0,9468,0
2020-07-10,Russia,NA,Irkutsk Oblast,2404195,211,0,9679,0
2020-07-11,Russia,NA,Irkutsk Oblast,2404195,206,0,9885,0
2020-07-12,Russia,NA,Irkutsk Oblast,2404195,209,0,10094,0
2020-07-13,Russia,NA,Irkutsk Oblast,2404195,203,0,10297,0
2020-07-14,Russia,NA,Irkutsk Oblast,2404195,198,0,10495,0
2020-07-15,Russia,NA,Irkutsk Oblast,2404195,190,0,10685,0
2020-07-16,Russia,NA,Irkutsk Oblast,2404195,196,0,10881,0
2020-07-17,Russia,NA,Irkutsk Oblast,2404195,193,0,11074,0
2020-07-18,Russia,NA,Irkutsk Oblast,2404195,188,0,11262,0
2020-07-19,Russia,NA,Irkutsk Oblast,2404195,185,0,11447,0
2020-07-20,Russia,NA,Irkutsk Oblast,2404195,178,0,11625,0
2020-07-21,Russia,NA,Irkutsk Oblast,2404195,181,0,11806,0
2020-07-22,Russia,NA,Irkutsk Oblast,2404195,170,0,11976,0
2020-07-23,Russia,NA,Irkutsk Oblast,2404195,176,0,12152,0
2020-07-24,Russia,NA,Irkutsk Oblast,2404195,171,0,12323,0
2020-07-25,Russia,NA,Irkutsk Oblast,2404195,164,0,12487,0
2020-07-26,Russia,NA,Irkutsk Oblast,2404195,161,0,12648,0
2020-07-27,Russia,NA,Irkutsk Oblast,2404195,165,0,12813,0
2020-07-28,Russia,NA,Irkutsk Oblast,2404195,162,0,12975,0
2020-07-29,Russia,NA,Irkutsk Oblast,2404195,159,0,13134,0
2020-07-30,Russia,NA,Irkutsk Oblast,2404195,148,0,13282,0
2020-07-31,Russia,NA,Irkutsk Oblast,2404195,140,0,13422,0
2020-08-01,Russia,NA,Irkutsk Oblast,2404195,146,0,13568,0
2020-08-02,Russia,NA,Irkutsk Oblast,2404195,143,0,13711,0
2020-08-26,Russia,NA,Irkutsk Oblast,2404195,0,0,16434,245
2020-08-27,Russia,NA,Irkutsk Oblast,2404195,76,3,16510,248
2020-08-28,Russia,NA,Irkutsk Oblast,2404195,73,0,16583,248
2020-08-29,Russia,NA,Irkutsk Oblast,2404195,77,0,16660,248
2020-08-30,Russia,NA,Irkutsk Oblast,2404195,72,0,16732,248
2020-08-31,Russia,NA,Irkutsk Oblast,2404195,78,0,16810,248
2020-09-01,Russia,NA,Irkutsk Oblast,2404195,76,2,16886,250
2020-09-02,Russia,NA,Irkutsk Oblast,2404195,72,1,16958,251
2020-09-03,Russia,NA,Irkutsk Oblast,2404195,75,1,17033,252
2020-09-04,Russia,NA,Irkutsk Oblast,2404195,70,2,17103,254
2020-09-05,Russia,NA,Irkutsk Oblast,2404195,81,0,17184,254
2020-09-06,Russia,NA,Irkutsk Oblast,2404195,69,0,17253,254
2020-09-07,Russia,NA,Irkutsk Oblast,2404195,75,0,17328,254
2020-09-08,Russia,NA,Irkutsk Oblast,2404195,67,0,17395,254
2020-09-09,Russia,NA,Irkutsk Oblast,2404195,71,5,17466,259
2020-09-10,Russia,NA,Irkutsk Oblast,2404195,76,1,17542,260
2020-09-11,Russia,NA,Irkutsk Oblast,2404195,73,1,17615,261
2020-09-12,Russia,NA,Irkutsk Oblast,2404195,76,1,17691,262
2020-09-13,Russia,NA,Irkutsk Oblast,2404195,69,0,17760,262
2020-09-14,Russia,NA,Irkutsk Oblast,2404195,72,0,17832,262
2020-09-15,Russia,NA,Irkutsk Oblast,2404195,73,2,17905,264
2020-09-16,Russia,NA,Irkutsk Oblast,2404195,76,2,17981,266
2020-09-17,Russia,NA,Irkutsk Oblast,2404195,77,3,18058,269
2020-09-18,Russia,NA,Irkutsk Oblast,2404195,81,4,18139,273
2020-09-19,Russia,NA,Irkutsk Oblast,2404195,72,1,18211,274
2020-09-20,Russia,NA,Irkutsk Oblast,2404195,78,0,18289,274
2020-09-21,Russia,NA,Irkutsk Oblast,2404195,69,3,18358,277
2020-09-22,Russia,NA,Irkutsk Oblast,2404195,75,0,18433,277
2020-09-23,Russia,NA,Irkutsk Oblast,2404195,73,1,18506,278
2020-04-01,Russia,NA,Ivanovo Oblast,1014646,2,0,11,0
2020-04-03,Russia,NA,Ivanovo Oblast,1014646,2,0,13,0
2020-04-04,Russia,NA,Ivanovo Oblast,1014646,10,0,23,0
2020-04-06,Russia,NA,Ivanovo Oblast,1014646,10,0,33,0
2020-04-07,Russia,NA,Ivanovo Oblast,1014646,14,0,47,0
2020-04-09,Russia,NA,Ivanovo Oblast,1014646,13,0,60,0
2020-04-11,Russia,NA,Ivanovo Oblast,1014646,2,0,62,0
2020-04-12,Russia,NA,Ivanovo Oblast,1014646,18,0,80,0
2020-04-13,Russia,NA,Ivanovo Oblast,1014646,6,0,86,0
2020-04-14,Russia,NA,Ivanovo Oblast,1014646,10,0,96,0
2020-04-15,Russia,NA,Ivanovo Oblast,1014646,25,0,121,0
2020-04-16,Russia,NA,Ivanovo Oblast,1014646,15,0,136,0
2020-04-17,Russia,NA,Ivanovo Oblast,1014646,13,0,149,0
2020-04-18,Russia,NA,Ivanovo Oblast,1014646,15,0,164,0
2020-04-19,Russia,NA,Ivanovo Oblast,1014646,19,0,183,0
2020-04-20,Russia,NA,Ivanovo Oblast,1014646,20,0,203,0
2020-04-21,Russia,NA,Ivanovo Oblast,1014646,10,0,213,0
2020-04-22,Russia,NA,Ivanovo Oblast,1014646,12,0,225,0
2020-04-23,Russia,NA,Ivanovo Oblast,1014646,14,0,239,0
2020-04-24,Russia,NA,Ivanovo Oblast,1014646,8,0,247,0
2020-04-25,Russia,NA,Ivanovo Oblast,1014646,16,0,263,0
2020-04-26,Russia,NA,Ivanovo Oblast,1014646,11,0,274,0
2020-04-27,Russia,NA,Ivanovo Oblast,1014646,8,0,282,0
2020-04-28,Russia,NA,Ivanovo Oblast,1014646,14,0,296,0
2020-04-29,Russia,NA,Ivanovo Oblast,1014646,31,0,327,0
2020-04-30,Russia,NA,Ivanovo Oblast,1014646,32,0,359,0
2020-05-01,Russia,NA,Ivanovo Oblast,1014646,44,0,403,0
2020-05-02,Russia,NA,Ivanovo Oblast,1014646,31,0,434,0
2020-05-03,Russia,NA,Ivanovo Oblast,1014646,22,0,456,0
2020-05-04,Russia,NA,Ivanovo Oblast,1014646,29,0,485,0
2020-05-05,Russia,NA,Ivanovo Oblast,1014646,32,0,517,0
2020-05-06,Russia,NA,Ivanovo Oblast,1014646,20,0,537,0
2020-05-07,Russia,NA,Ivanovo Oblast,1014646,58,0,595,0
2020-05-08,Russia,NA,Ivanovo Oblast,1014646,58,0,653,0
2020-05-09,Russia,NA,Ivanovo Oblast,1014646,26,0,679,0
2020-05-10,Russia,NA,Ivanovo Oblast,1014646,79,0,758,0
2020-05-11,Russia,NA,Ivanovo Oblast,1014646,85,0,843,0
2020-05-12,Russia,NA,Ivanovo Oblast,1014646,68,0,911,0
2020-05-13,Russia,NA,Ivanovo Oblast,1014646,10,0,921,0
2020-05-14,Russia,NA,Ivanovo Oblast,1014646,102,0,1023,0
2020-05-15,Russia,NA,Ivanovo Oblast,1014646,101,0,1124,0
2020-05-16,Russia,NA,Ivanovo Oblast,1014646,68,0,1192,0
2020-05-17,Russia,NA,Ivanovo Oblast,1014646,53,0,1245,0
2020-05-18,Russia,NA,Ivanovo Oblast,1014646,46,0,1291,0
2020-05-19,Russia,NA,Ivanovo Oblast,1014646,22,0,1313,0
2020-05-20,Russia,NA,Ivanovo Oblast,1014646,47,0,1360,0
2020-05-21,Russia,NA,Ivanovo Oblast,1014646,55,0,1415,0
2020-05-22,Russia,NA,Ivanovo Oblast,1014646,48,0,1463,0
2020-05-23,Russia,NA,Ivanovo Oblast,1014646,42,0,1505,0
2020-05-24,Russia,NA,Ivanovo Oblast,1014646,61,0,1566,0
2020-05-25,Russia,NA,Ivanovo Oblast,1014646,36,0,1602,0
2020-05-26,Russia,NA,Ivanovo Oblast,1014646,37,0,1639,0
2020-05-27,Russia,NA,Ivanovo Oblast,1014646,47,0,1686,0
2020-05-28,Russia,NA,Ivanovo Oblast,1014646,59,0,1745,0
2020-05-29,Russia,NA,Ivanovo Oblast,1014646,68,0,1813,0
2020-05-30,Russia,NA,Ivanovo Oblast,1014646,87,0,1900,0
2020-05-31,Russia,NA,Ivanovo Oblast,1014646,77,0,1977,0
2020-06-01,Russia,NA,Ivanovo Oblast,1014646,80,0,2057,0
2020-06-02,Russia,NA,Ivanovo Oblast,1014646,83,0,2140,0
2020-06-03,Russia,NA,Ivanovo Oblast,1014646,65,0,2205,0
2020-06-04,Russia,NA,Ivanovo Oblast,1014646,117,0,2322,0
2020-06-05,Russia,NA,Ivanovo Oblast,1014646,125,0,2447,0
2020-06-06,Russia,NA,Ivanovo Oblast,1014646,130,0,2577,0
2020-06-07,Russia,NA,Ivanovo Oblast,1014646,128,0,2705,0
2020-06-08,Russia,NA,Ivanovo Oblast,1014646,117,0,2822,0
2020-06-09,Russia,NA,Ivanovo Oblast,1014646,108,0,2930,0
2020-06-10,Russia,NA,Ivanovo Oblast,1014646,101,0,3031,0
2020-06-11,Russia,NA,Ivanovo Oblast,1014646,99,0,3130,0
2020-06-12,Russia,NA,Ivanovo Oblast,1014646,98,0,3228,0
2020-06-13,Russia,NA,Ivanovo Oblast,1014646,95,0,3323,0
2020-06-14,Russia,NA,Ivanovo Oblast,1014646,94,0,3417,0
2020-06-15,Russia,NA,Ivanovo Oblast,1014646,91,0,3508,0
2020-06-16,Russia,NA,Ivanovo Oblast,1014646,91,0,3599,0
2020-06-17,Russia,NA,Ivanovo Oblast,1014646,86,0,3685,0
2020-06-18,Russia,NA,Ivanovo Oblast,1014646,83,0,3768,0
2020-06-19,Russia,NA,Ivanovo Oblast,1014646,85,0,3853,0
2020-06-20,Russia,NA,Ivanovo Oblast,1014646,81,0,3934,0
2020-06-21,Russia,NA,Ivanovo Oblast,1014646,83,0,4017,0
2020-06-22,Russia,NA,Ivanovo Oblast,1014646,81,0,4098,0
2020-06-23,Russia,NA,Ivanovo Oblast,1014646,78,0,4176,0
2020-06-24,Russia,NA,Ivanovo Oblast,1014646,77,0,4253,0
2020-06-25,Russia,NA,Ivanovo Oblast,1014646,77,0,4330,0
2020-06-26,Russia,NA,Ivanovo Oblast,1014646,75,0,4405,0
2020-06-27,Russia,NA,Ivanovo Oblast,1014646,74,0,4479,0
2020-06-28,Russia,NA,Ivanovo Oblast,1014646,71,0,4550,0
2020-06-29,Russia,NA,Ivanovo Oblast,1014646,71,0,4621,0
2020-06-30,Russia,NA,Ivanovo Oblast,1014646,70,0,4691,0
2020-07-01,Russia,NA,Ivanovo Oblast,1014646,70,0,4761,0
2020-07-02,Russia,NA,Ivanovo Oblast,1014646,68,0,4829,0
2020-07-03,Russia,NA,Ivanovo Oblast,1014646,69,0,4898,0
2020-07-04,Russia,NA,Ivanovo Oblast,1014646,67,0,4965,0
2020-07-05,Russia,NA,Ivanovo Oblast,1014646,69,0,5034,0
2020-07-06,Russia,NA,Ivanovo Oblast,1014646,68,0,5102,0
2020-07-07,Russia,NA,Ivanovo Oblast,1014646,66,0,5168,0
2020-07-08,Russia,NA,Ivanovo Oblast,1014646,64,0,5232,0
2020-07-09,Russia,NA,Ivanovo Oblast,1014646,72,0,5304,0
2020-07-10,Russia,NA,Ivanovo Oblast,1014646,67,0,5371,0
2020-07-11,Russia,NA,Ivanovo Oblast,1014646,65,0,5436,0
2020-07-12,Russia,NA,Ivanovo Oblast,1014646,65,0,5501,0
2020-07-13,Russia,NA,Ivanovo Oblast,1014646,64,0,5565,0
2020-07-14,Russia,NA,Ivanovo Oblast,1014646,64,0,5629,0
2020-07-15,Russia,NA,Ivanovo Oblast,1014646,62,0,5691,0
2020-07-16,Russia,NA,Ivanovo Oblast,1014646,61,0,5752,0
2020-07-17,Russia,NA,Ivanovo Oblast,1014646,61,0,5813,0
2020-07-18,Russia,NA,Ivanovo Oblast,1014646,63,0,5876,0
2020-07-19,Russia,NA,Ivanovo Oblast,1014646,62,0,5938,0
2020-07-20,Russia,NA,Ivanovo Oblast,1014646,60,0,5998,0
2020-07-21,Russia,NA,Ivanovo Oblast,1014646,61,0,6059,0
2020-07-22,Russia,NA,Ivanovo Oblast,1014646,57,0,6116,0
2020-07-23,Russia,NA,Ivanovo Oblast,1014646,56,0,6172,0
2020-07-24,Russia,NA,Ivanovo Oblast,1014646,50,0,6222,0
2020-07-25,Russia,NA,Ivanovo Oblast,1014646,43,0,6265,0
2020-07-26,Russia,NA,Ivanovo Oblast,1014646,38,0,6303,0
2020-07-27,Russia,NA,Ivanovo Oblast,1014646,27,0,6330,0
2020-07-28,Russia,NA,Ivanovo Oblast,1014646,22,0,6352,0
2020-07-29,Russia,NA,Ivanovo Oblast,1014646,25,0,6377,0
2020-07-30,Russia,NA,Ivanovo Oblast,1014646,24,0,6401,0
2020-07-31,Russia,NA,Ivanovo Oblast,1014646,25,0,6426,0
2020-08-01,Russia,NA,Ivanovo Oblast,1014646,26,0,6452,0
2020-08-02,Russia,NA,Ivanovo Oblast,1014646,27,0,6479,0
2020-08-26,Russia,NA,Ivanovo Oblast,1014646,0,0,7210,115
2020-08-27,Russia,NA,Ivanovo Oblast,1014646,38,2,7248,117
2020-08-28,Russia,NA,Ivanovo Oblast,1014646,37,0,7285,117
2020-08-29,Russia,NA,Ivanovo Oblast,1014646,36,1,7321,118
2020-08-30,Russia,NA,Ivanovo Oblast,1014646,39,0,7360,118
2020-08-31,Russia,NA,Ivanovo Oblast,1014646,37,0,7397,118
2020-09-01,Russia,NA,Ivanovo Oblast,1014646,36,1,7433,119
2020-09-02,Russia,NA,Ivanovo Oblast,1014646,38,0,7471,119
2020-09-03,Russia,NA,Ivanovo Oblast,1014646,38,0,7509,119
2020-09-04,Russia,NA,Ivanovo Oblast,1014646,40,1,7549,120
2020-09-05,Russia,NA,Ivanovo Oblast,1014646,42,1,7591,121
2020-09-06,Russia,NA,Ivanovo Oblast,1014646,43,0,7634,121
2020-09-07,Russia,NA,Ivanovo Oblast,1014646,41,1,7675,122
2020-09-08,Russia,NA,Ivanovo Oblast,1014646,40,0,7715,122
2020-09-09,Russia,NA,Ivanovo Oblast,1014646,42,1,7757,123
2020-09-10,Russia,NA,Ivanovo Oblast,1014646,43,0,7800,123
2020-09-11,Russia,NA,Ivanovo Oblast,1014646,42,0,7842,123
2020-09-12,Russia,NA,Ivanovo Oblast,1014646,41,2,7883,125
2020-09-13,Russia,NA,Ivanovo Oblast,1014646,42,0,7925,125
2020-09-14,Russia,NA,Ivanovo Oblast,1014646,43,0,7968,125
2020-09-15,Russia,NA,Ivanovo Oblast,1014646,41,1,8009,126
2020-09-16,Russia,NA,Ivanovo Oblast,1014646,43,0,8052,126
2020-09-17,Russia,NA,Ivanovo Oblast,1014646,44,2,8096,128
2020-09-18,Russia,NA,Ivanovo Oblast,1014646,42,1,8138,129
2020-09-19,Russia,NA,Ivanovo Oblast,1014646,46,1,8184,130
2020-09-20,Russia,NA,Ivanovo Oblast,1014646,44,0,8228,130
2020-09-21,Russia,NA,Ivanovo Oblast,1014646,43,0,8271,130
2020-09-22,Russia,NA,Ivanovo Oblast,1014646,44,0,8315,130
2020-09-23,Russia,NA,Ivanovo Oblast,1014646,45,2,8360,132
2020-04-17,Russia,NA,Jewish Avtonomnyy Okrug,158381,6,0,16,0
2020-04-18,Russia,NA,Jewish Avtonomnyy Okrug,158381,3,0,19,0
2020-04-19,Russia,NA,Jewish Avtonomnyy Okrug,158381,1,0,20,0
2020-04-20,Russia,NA,Jewish Avtonomnyy Okrug,158381,2,0,22,0
2020-04-21,Russia,NA,Jewish Avtonomnyy Okrug,158381,21,0,43,0
2020-04-22,Russia,NA,Jewish Avtonomnyy Okrug,158381,9,0,52,0
2020-04-23,Russia,NA,Jewish Avtonomnyy Okrug,158381,14,0,66,0
2020-04-24,Russia,NA,Jewish Avtonomnyy Okrug,158381,14,0,80,0
2020-04-25,Russia,NA,Jewish Avtonomnyy Okrug,158381,6,0,86,0
2020-04-27,Russia,NA,Jewish Avtonomnyy Okrug,158381,15,0,101,0
2020-04-28,Russia,NA,Jewish Avtonomnyy Okrug,158381,12,0,113,0
2020-04-29,Russia,NA,Jewish Avtonomnyy Okrug,158381,5,0,118,0
2020-04-30,Russia,NA,Jewish Avtonomnyy Okrug,158381,6,0,124,0
2020-05-01,Russia,NA,Jewish Avtonomnyy Okrug,158381,7,0,131,0
2020-05-02,Russia,NA,Jewish Avtonomnyy Okrug,158381,3,0,134,0
2020-05-03,Russia,NA,Jewish Avtonomnyy Okrug,158381,9,0,143,0
2020-05-04,Russia,NA,Jewish Avtonomnyy Okrug,158381,2,0,145,0
2020-05-05,Russia,NA,Jewish Avtonomnyy Okrug,158381,3,0,148,0
2020-05-06,Russia,NA,Jewish Avtonomnyy Okrug,158381,5,0,153,0
2020-05-07,Russia,NA,Jewish Avtonomnyy Okrug,158381,6,0,159,0
2020-05-08,Russia,NA,Jewish Avtonomnyy Okrug,158381,11,0,170,0
2020-05-09,Russia,NA,Jewish Avtonomnyy Okrug,158381,5,0,175,0
2020-05-10,Russia,NA,Jewish Avtonomnyy Okrug,158381,4,0,179,0
2020-05-11,Russia,NA,Jewish Avtonomnyy Okrug,158381,6,0,185,0
2020-05-12,Russia,NA,Jewish Avtonomnyy Okrug,158381,3,0,188,0
2020-05-13,Russia,NA,Jewish Avtonomnyy Okrug,158381,24,0,212,0
2020-05-14,Russia,NA,Jewish Avtonomnyy Okrug,158381,6,0,218,0
2020-05-15,Russia,NA,Jewish Avtonomnyy Okrug,158381,4,0,222,0
2020-05-16,Russia,NA,Jewish Avtonomnyy Okrug,158381,3,0,225,0
2020-05-17,Russia,NA,Jewish Avtonomnyy Okrug,158381,5,0,230,0
2020-05-19,Russia,NA,Jewish Avtonomnyy Okrug,158381,6,0,236,0
2020-05-20,Russia,NA,Jewish Avtonomnyy Okrug,158381,10,0,246,0
2020-05-21,Russia,NA,Jewish Avtonomnyy Okrug,158381,15,0,261,0
2020-05-22,Russia,NA,Jewish Avtonomnyy Okrug,158381,1,0,262,0
2020-05-23,Russia,NA,Jewish Avtonomnyy Okrug,158381,1,0,263,0
2020-05-24,Russia,NA,Jewish Avtonomnyy Okrug,158381,3,0,266,0
2020-05-25,Russia,NA,Jewish Avtonomnyy Okrug,158381,1,0,267,0
2020-05-26,Russia,NA,Jewish Avtonomnyy Okrug,158381,5,0,272,0
2020-05-27,Russia,NA,Jewish Avtonomnyy Okrug,158381,2,0,274,0
2020-05-28,Russia,NA,Jewish Avtonomnyy Okrug,158381,7,0,281,0
2020-05-29,Russia,NA,Jewish Avtonomnyy Okrug,158381,7,0,288,0
2020-05-30,Russia,NA,Jewish Avtonomnyy Okrug,158381,11,0,299,0
2020-05-31,Russia,NA,Jewish Avtonomnyy Okrug,158381,10,0,309,0
2020-06-01,Russia,NA,Jewish Avtonomnyy Okrug,158381,5,0,314,0
2020-06-03,Russia,NA,Jewish Avtonomnyy Okrug,158381,3,0,317,0
2020-06-04,Russia,NA,Jewish Avtonomnyy Okrug,158381,6,0,323,0
2020-06-05,Russia,NA,Jewish Avtonomnyy Okrug,158381,6,0,329,0
2020-06-06,Russia,NA,Jewish Avtonomnyy Okrug,158381,7,0,336,0
2020-06-07,Russia,NA,Jewish Avtonomnyy Okrug,158381,7,0,343,0
2020-06-08,Russia,NA,Jewish Avtonomnyy Okrug,158381,4,0,347,0
2020-06-09,Russia,NA,Jewish Avtonomnyy Okrug,158381,3,0,350,0
2020-06-10,Russia,NA,Jewish Avtonomnyy Okrug,158381,6,0,356,0
2020-06-11,Russia,NA,Jewish Avtonomnyy Okrug,158381,7,0,363,0
2020-06-12,Russia,NA,Jewish Avtonomnyy Okrug,158381,4,0,367,0
2020-06-13,Russia,NA,Jewish Avtonomnyy Okrug,158381,4,0,371,0
2020-06-14,Russia,NA,Jewish Avtonomnyy Okrug,158381,3,0,374,0
2020-06-16,Russia,NA,Jewish Avtonomnyy Okrug,158381,4,0,378,0
2020-06-17,Russia,NA,Jewish Avtonomnyy Okrug,158381,4,0,382,0
2020-06-18,Russia,NA,Jewish Avtonomnyy Okrug,158381,4,0,386,0
2020-06-19,Russia,NA,Jewish Avtonomnyy Okrug,158381,4,0,390,0
2020-06-20,Russia,NA,Jewish Avtonomnyy Okrug,158381,4,0,394,0
2020-06-21,Russia,NA,Jewish Avtonomnyy Okrug,158381,3,0,397,0
2020-06-22,Russia,NA,Jewish Avtonomnyy Okrug,158381,2,0,399,0
2020-06-23,Russia,NA,Jewish Avtonomnyy Okrug,158381,1,0,400,0
2020-06-24,Russia,NA,Jewish Avtonomnyy Okrug,158381,4,0,404,0
2020-06-25,Russia,NA,Jewish Avtonomnyy Okrug,158381,4,0,408,0
2020-06-26,Russia,NA,Jewish Avtonomnyy Okrug,158381,5,0,413,0
2020-06-27,Russia,NA,Jewish Avtonomnyy Okrug,158381,4,0,417,0
2020-06-28,Russia,NA,Jewish Avtonomnyy Okrug,158381,4,0,421,0
2020-06-29,Russia,NA,Jewish Avtonomnyy Okrug,158381,3,0,424,0
2020-06-30,Russia,NA,Jewish Avtonomnyy Okrug,158381,2,0,426,0
2020-07-01,Russia,NA,Jewish Avtonomnyy Okrug,158381,2,0,428,0
2020-07-02,Russia,NA,Jewish Avtonomnyy Okrug,158381,2,0,430,0
2020-07-03,Russia,NA,Jewish Avtonomnyy Okrug,158381,3,0,433,0
2020-07-04,Russia,NA,Jewish Avtonomnyy Okrug,158381,2,0,435,0
2020-07-05,Russia,NA,Jewish Avtonomnyy Okrug,158381,3,0,438,0
2020-07-06,Russia,NA,Jewish Avtonomnyy Okrug,158381,3,0,441,0
2020-07-07,Russia,NA,Jewish Avtonomnyy Okrug,158381,5,0,446,0
2020-07-08,Russia,NA,Jewish Avtonomnyy Okrug,158381,6,0,452,0
2020-07-09,Russia,NA,Jewish Avtonomnyy Okrug,158381,5,0,457,0
2020-07-10,Russia,NA,Jewish Avtonomnyy Okrug,158381,5,0,462,0
2020-07-11,Russia,NA,Jewish Avtonomnyy Okrug,158381,7,0,469,0
2020-07-12,Russia,NA,Jewish Avtonomnyy Okrug,158381,7,0,476,0
2020-07-13,Russia,NA,Jewish Avtonomnyy Okrug,158381,6,0,482,0
2020-07-14,Russia,NA,Jewish Avtonomnyy Okrug,158381,5,0,487,0
2020-07-15,Russia,NA,Jewish Avtonomnyy Okrug,158381,4,0,491,0
2020-07-16,Russia,NA,Jewish Avtonomnyy Okrug,158381,4,0,495,0
2020-07-17,Russia,NA,Jewish Avtonomnyy Okrug,158381,4,0,499,0
2020-07-18,Russia,NA,Jewish Avtonomnyy Okrug,158381,4,0,503,0
2020-07-19,Russia,NA,Jewish Avtonomnyy Okrug,158381,3,0,506,0
2020-07-20,Russia,NA,Jewish Avtonomnyy Okrug,158381,1,0,507,0
2020-07-21,Russia,NA,Jewish Avtonomnyy Okrug,158381,2,0,509,0
2020-07-22,Russia,NA,Jewish Avtonomnyy Okrug,158381,2,0,511,0
2020-07-23,Russia,NA,Jewish Avtonomnyy Okrug,158381,1,0,512,0
2020-07-24,Russia,NA,Jewish Avtonomnyy Okrug,158381,2,0,514,0
2020-07-25,Russia,NA,Jewish Avtonomnyy Okrug,158381,3,0,517,0
2020-07-26,Russia,NA,Jewish Avtonomnyy Okrug,158381,3,0,520,0
2020-07-27,Russia,NA,Jewish Avtonomnyy Okrug,158381,3,0,523,0
2020-07-28,Russia,NA,Jewish Avtonomnyy Okrug,158381,2,0,525,0
2020-07-29,Russia,NA,Jewish Avtonomnyy Okrug,158381,4,0,529,0
2020-07-30,Russia,NA,Jewish Avtonomnyy Okrug,158381,3,0,532,0
2020-07-31,Russia,NA,Jewish Avtonomnyy Okrug,158381,2,0,534,0
2020-08-01,Russia,NA,Jewish Avtonomnyy Okrug,158381,3,0,537,0
2020-08-02,Russia,NA,Jewish Avtonomnyy Okrug,158381,1,0,538,0
2020-08-26,Russia,NA,Jewish Avtonomnyy Okrug,158381,0,0,602,9
2020-08-27,Russia,NA,Jewish Avtonomnyy Okrug,158381,3,0,605,9
2020-08-28,Russia,NA,Jewish Avtonomnyy Okrug,158381,4,0,609,9
2020-08-29,Russia,NA,Jewish Avtonomnyy Okrug,158381,6,0,615,9
2020-08-30,Russia,NA,Jewish Avtonomnyy Okrug,158381,5,0,620,9
2020-08-31,Russia,NA,Jewish Avtonomnyy Okrug,158381,6,0,626,9
2020-09-01,Russia,NA,Jewish Avtonomnyy Okrug,158381,6,0,632,9
2020-09-02,Russia,NA,Jewish Avtonomnyy Okrug,158381,7,0,639,9
2020-09-03,Russia,NA,Jewish Avtonomnyy Okrug,158381,7,0,646,9
2020-09-04,Russia,NA,Jewish Avtonomnyy Okrug,158381,9,0,655,9
2020-09-05,Russia,NA,Jewish Avtonomnyy Okrug,158381,8,0,663,9
2020-09-06,Russia,NA,Jewish Avtonomnyy Okrug,158381,7,0,670,9
2020-09-07,Russia,NA,Jewish Avtonomnyy Okrug,158381,7,0,677,9
2020-09-08,Russia,NA,Jewish Avtonomnyy Okrug,158381,8,0,685,9
2020-09-09,Russia,NA,Jewish Avtonomnyy Okrug,158381,8,0,693,9
2020-09-10,Russia,NA,Jewish Avtonomnyy Okrug,158381,7,0,700,9
2020-09-11,Russia,NA,Jewish Avtonomnyy Okrug,158381,5,0,705,9
2020-09-12,Russia,NA,Jewish Avtonomnyy Okrug,158381,7,0,712,9
2020-09-13,Russia,NA,Jewish Avtonomnyy Okrug,158381,6,0,718,9
2020-09-14,Russia,NA,Jewish Avtonomnyy Okrug,158381,7,1,725,10
2020-09-15,Russia,NA,Jewish Avtonomnyy Okrug,158381,8,0,733,10
2020-09-16,Russia,NA,Jewish Avtonomnyy Okrug,158381,9,0,742,10
2020-09-17,Russia,NA,Jewish Avtonomnyy Okrug,158381,9,0,751,10
2020-09-18,Russia,NA,Jewish Avtonomnyy Okrug,158381,9,0,760,10
2020-09-19,Russia,NA,Jewish Avtonomnyy Okrug,158381,12,0,772,10
2020-09-20,Russia,NA,Jewish Avtonomnyy Okrug,158381,10,0,782,10
2020-09-21,Russia,NA,Jewish Avtonomnyy Okrug,158381,11,0,793,10
2020-09-22,Russia,NA,Jewish Avtonomnyy Okrug,158381,15,0,808,10
2020-09-23,Russia,NA,Jewish Avtonomnyy Okrug,158381,15,0,823,10
2020-04-07,Russia,NA,Kabardino-Balkaria,865828,5,0,13,0
2020-04-08,Russia,NA,Kabardino-Balkaria,865828,2,0,15,0
2020-04-10,Russia,NA,Kabardino-Balkaria,865828,4,0,19,0
2020-04-11,Russia,NA,Kabardino-Balkaria,865828,3,0,22,0
2020-04-12,Russia,NA,Kabardino-Balkaria,865828,5,0,27,0
2020-04-13,Russia,NA,Kabardino-Balkaria,865828,15,0,42,0
2020-04-16,Russia,NA,Kabardino-Balkaria,865828,19,0,61,0
2020-04-17,Russia,NA,Kabardino-Balkaria,865828,23,0,84,0
2020-04-18,Russia,NA,Kabardino-Balkaria,865828,22,0,106,0
2020-04-19,Russia,NA,Kabardino-Balkaria,865828,22,0,128,0
2020-04-20,Russia,NA,Kabardino-Balkaria,865828,16,0,144,0
2020-04-21,Russia,NA,Kabardino-Balkaria,865828,18,0,162,0
2020-04-22,Russia,NA,Kabardino-Balkaria,865828,23,0,185,0
2020-04-23,Russia,NA,Kabardino-Balkaria,865828,25,0,210,0
2020-04-24,Russia,NA,Kabardino-Balkaria,865828,25,0,235,0
2020-04-25,Russia,NA,Kabardino-Balkaria,865828,29,0,264,0
2020-04-26,Russia,NA,Kabardino-Balkaria,865828,28,0,292,0
2020-04-27,Russia,NA,Kabardino-Balkaria,865828,29,0,321,0
2020-04-28,Russia,NA,Kabardino-Balkaria,865828,38,0,359,0
2020-04-29,Russia,NA,Kabardino-Balkaria,865828,45,0,404,0
2020-04-30,Russia,NA,Kabardino-Balkaria,865828,44,0,448,0
2020-05-01,Russia,NA,Kabardino-Balkaria,865828,43,0,491,0
2020-05-02,Russia,NA,Kabardino-Balkaria,865828,45,0,536,0
2020-05-03,Russia,NA,Kabardino-Balkaria,865828,90,0,626,0
2020-05-04,Russia,NA,Kabardino-Balkaria,865828,105,0,731,0
2020-05-05,Russia,NA,Kabardino-Balkaria,865828,81,0,812,0
2020-05-06,Russia,NA,Kabardino-Balkaria,865828,105,0,917,0
2020-05-07,Russia,NA,Kabardino-Balkaria,865828,83,0,1000,0
2020-05-08,Russia,NA,Kabardino-Balkaria,865828,81,0,1081,0
2020-05-09,Russia,NA,Kabardino-Balkaria,865828,79,0,1160,0
2020-05-10,Russia,NA,Kabardino-Balkaria,865828,77,0,1237,0
2020-05-11,Russia,NA,Kabardino-Balkaria,865828,80,0,1317,0
2020-05-12,Russia,NA,Kabardino-Balkaria,865828,76,0,1393,0
2020-05-13,Russia,NA,Kabardino-Balkaria,865828,74,0,1467,0
2020-05-14,Russia,NA,Kabardino-Balkaria,865828,73,0,1540,0
2020-05-15,Russia,NA,Kabardino-Balkaria,865828,71,0,1611,0
2020-05-16,Russia,NA,Kabardino-Balkaria,865828,71,0,1682,0
2020-05-17,Russia,NA,Kabardino-Balkaria,865828,69,0,1751,0
2020-05-18,Russia,NA,Kabardino-Balkaria,865828,65,0,1816,0
2020-05-19,Russia,NA,Kabardino-Balkaria,865828,62,0,1878,0
2020-05-20,Russia,NA,Kabardino-Balkaria,865828,66,0,1944,0
2020-05-21,Russia,NA,Kabardino-Balkaria,865828,68,0,2012,0
2020-05-22,Russia,NA,Kabardino-Balkaria,865828,71,0,2083,0
2020-05-23,Russia,NA,Kabardino-Balkaria,865828,80,0,2163,0
2020-05-24,Russia,NA,Kabardino-Balkaria,865828,80,0,2243,0
2020-05-25,Russia,NA,Kabardino-Balkaria,865828,83,0,2326,0
2020-05-26,Russia,NA,Kabardino-Balkaria,865828,88,0,2414,0
2020-05-27,Russia,NA,Kabardino-Balkaria,865828,87,0,2501,0
2020-05-28,Russia,NA,Kabardino-Balkaria,865828,83,0,2584,0
2020-05-29,Russia,NA,Kabardino-Balkaria,865828,81,0,2665,0
2020-05-30,Russia,NA,Kabardino-Balkaria,865828,77,0,2742,0
2020-05-31,Russia,NA,Kabardino-Balkaria,865828,77,0,2819,0
2020-06-01,Russia,NA,Kabardino-Balkaria,865828,76,0,2895,0
2020-06-02,Russia,NA,Kabardino-Balkaria,865828,75,0,2970,0
2020-06-03,Russia,NA,Kabardino-Balkaria,865828,74,0,3044,0
2020-06-04,Russia,NA,Kabardino-Balkaria,865828,74,0,3118,0
2020-06-05,Russia,NA,Kabardino-Balkaria,865828,73,0,3191,0
2020-06-06,Russia,NA,Kabardino-Balkaria,865828,73,0,3264,0
2020-06-07,Russia,NA,Kabardino-Balkaria,865828,76,0,3340,0
2020-06-08,Russia,NA,Kabardino-Balkaria,865828,76,0,3416,0
2020-06-09,Russia,NA,Kabardino-Balkaria,865828,75,0,3491,0
2020-06-10,Russia,NA,Kabardino-Balkaria,865828,77,0,3568,0
2020-06-11,Russia,NA,Kabardino-Balkaria,865828,79,0,3647,0
2020-06-12,Russia,NA,Kabardino-Balkaria,865828,79,0,3726,0
2020-06-13,Russia,NA,Kabardino-Balkaria,865828,81,0,3807,0
2020-06-14,Russia,NA,Kabardino-Balkaria,865828,80,0,3887,0
2020-06-15,Russia,NA,Kabardino-Balkaria,865828,80,0,3967,0
2020-06-16,Russia,NA,Kabardino-Balkaria,865828,80,0,4047,0
2020-06-17,Russia,NA,Kabardino-Balkaria,865828,77,0,4124,0
2020-06-18,Russia,NA,Kabardino-Balkaria,865828,77,0,4201,0
2020-06-19,Russia,NA,Kabardino-Balkaria,865828,76,0,4277,0
2020-06-20,Russia,NA,Kabardino-Balkaria,865828,76,0,4353,0
2020-06-21,Russia,NA,Kabardino-Balkaria,865828,75,0,4428,0
2020-06-22,Russia,NA,Kabardino-Balkaria,865828,75,0,4503,0
2020-06-23,Russia,NA,Kabardino-Balkaria,865828,74,0,4577,0
2020-06-24,Russia,NA,Kabardino-Balkaria,865828,71,0,4648,0
2020-06-25,Russia,NA,Kabardino-Balkaria,865828,70,0,4718,0
2020-06-26,Russia,NA,Kabardino-Balkaria,865828,65,0,4783,0
2020-06-27,Russia,NA,Kabardino-Balkaria,865828,60,0,4843,0
2020-06-28,Russia,NA,Kabardino-Balkaria,865828,54,0,4897,0
2020-06-29,Russia,NA,Kabardino-Balkaria,865828,53,0,4950,0
2020-06-30,Russia,NA,Kabardino-Balkaria,865828,52,0,5002,0
2020-07-01,Russia,NA,Kabardino-Balkaria,865828,51,0,5053,0
2020-07-02,Russia,NA,Kabardino-Balkaria,865828,48,0,5101,0
2020-07-03,Russia,NA,Kabardino-Balkaria,865828,48,0,5149,0
2020-07-04,Russia,NA,Kabardino-Balkaria,865828,47,0,5196,0
2020-07-05,Russia,NA,Kabardino-Balkaria,865828,47,0,5243,0
2020-07-06,Russia,NA,Kabardino-Balkaria,865828,46,0,5289,0
2020-07-07,Russia,NA,Kabardino-Balkaria,865828,46,0,5335,0
2020-07-08,Russia,NA,Kabardino-Balkaria,865828,45,0,5380,0
2020-07-09,Russia,NA,Kabardino-Balkaria,865828,45,0,5425,0
2020-07-10,Russia,NA,Kabardino-Balkaria,865828,44,0,5469,0
2020-07-11,Russia,NA,Kabardino-Balkaria,865828,43,0,5512,0
2020-07-12,Russia,NA,Kabardino-Balkaria,865828,42,0,5554,0
2020-07-13,Russia,NA,Kabardino-Balkaria,865828,42,0,5596,0
2020-07-14,Russia,NA,Kabardino-Balkaria,865828,41,0,5637,0
2020-07-15,Russia,NA,Kabardino-Balkaria,865828,41,0,5678,0
2020-07-16,Russia,NA,Kabardino-Balkaria,865828,40,0,5718,0
2020-07-17,Russia,NA,Kabardino-Balkaria,865828,25,0,5743,0
2020-07-18,Russia,NA,Kabardino-Balkaria,865828,20,0,5763,0
2020-07-19,Russia,NA,Kabardino-Balkaria,865828,20,0,5783,0
2020-07-20,Russia,NA,Kabardino-Balkaria,865828,16,0,5799,0
2020-07-21,Russia,NA,Kabardino-Balkaria,865828,16,0,5815,0
2020-07-22,Russia,NA,Kabardino-Balkaria,865828,16,0,5831,0
2020-07-23,Russia,NA,Kabardino-Balkaria,865828,16,0,5847,0
2020-07-24,Russia,NA,Kabardino-Balkaria,865828,15,0,5862,0
2020-07-25,Russia,NA,Kabardino-Balkaria,865828,15,0,5877,0
2020-07-26,Russia,NA,Kabardino-Balkaria,865828,15,0,5892,0
2020-07-27,Russia,NA,Kabardino-Balkaria,865828,16,0,5908,0
2020-07-28,Russia,NA,Kabardino-Balkaria,865828,15,0,5923,0
2020-07-29,Russia,NA,Kabardino-Balkaria,865828,15,0,5938,0
2020-07-30,Russia,NA,Kabardino-Balkaria,865828,16,0,5954,0
2020-07-31,Russia,NA,Kabardino-Balkaria,865828,15,0,5969,0
2020-08-01,Russia,NA,Kabardino-Balkaria,865828,16,0,5985,0
2020-08-02,Russia,NA,Kabardino-Balkaria,865828,15,0,6000,0
2020-08-26,Russia,NA,Kabardino-Balkaria,865828,0,0,6397,77
2020-08-27,Russia,NA,Kabardino-Balkaria,865828,20,0,6417,77
2020-08-28,Russia,NA,Kabardino-Balkaria,865828,22,0,6439,77
2020-08-29,Russia,NA,Kabardino-Balkaria,865828,24,0,6463,77
2020-08-30,Russia,NA,Kabardino-Balkaria,865828,25,0,6488,77
2020-08-31,Russia,NA,Kabardino-Balkaria,865828,26,1,6514,78
2020-09-01,Russia,NA,Kabardino-Balkaria,865828,28,1,6542,79
2020-09-02,Russia,NA,Kabardino-Balkaria,865828,28,0,6570,79
2020-09-03,Russia,NA,Kabardino-Balkaria,865828,29,0,6599,79
2020-09-04,Russia,NA,Kabardino-Balkaria,865828,30,0,6629,79
2020-09-05,Russia,NA,Kabardino-Balkaria,865828,30,0,6659,79
2020-09-06,Russia,NA,Kabardino-Balkaria,865828,32,0,6691,79
2020-09-07,Russia,NA,Kabardino-Balkaria,865828,33,0,6724,79
2020-09-08,Russia,NA,Kabardino-Balkaria,865828,33,0,6757,79
2020-09-09,Russia,NA,Kabardino-Balkaria,865828,35,0,6792,79
2020-09-10,Russia,NA,Kabardino-Balkaria,865828,35,1,6827,80
2020-09-11,Russia,NA,Kabardino-Balkaria,865828,37,1,6864,81
2020-09-12,Russia,NA,Kabardino-Balkaria,865828,37,0,6901,81
2020-09-13,Russia,NA,Kabardino-Balkaria,865828,40,1,6941,82
2020-09-14,Russia,NA,Kabardino-Balkaria,865828,40,0,6981,82
2020-09-15,Russia,NA,Kabardino-Balkaria,865828,42,1,7023,83
2020-09-16,Russia,NA,Kabardino-Balkaria,865828,42,1,7065,84
2020-09-17,Russia,NA,Kabardino-Balkaria,865828,41,0,7106,84
2020-09-18,Russia,NA,Kabardino-Balkaria,865828,43,1,7149,85
2020-09-19,Russia,NA,Kabardino-Balkaria,865828,42,1,7191,86
2020-09-20,Russia,NA,Kabardino-Balkaria,865828,43,1,7234,87
2020-09-21,Russia,NA,Kabardino-Balkaria,865828,42,1,7276,88
2020-09-22,Russia,NA,Kabardino-Balkaria,865828,43,1,7319,89
2020-09-23,Russia,NA,Kabardino-Balkaria,865828,41,1,7360,90
2020-03-28,Russia,NA,Kaliningrad Oblast,994599,3,0,11,0
2020-03-30,Russia,NA,Kaliningrad Oblast,994599,1,0,12,0
2020-04-02,Russia,NA,Kaliningrad Oblast,994599,7,0,19,0
2020-04-07,Russia,NA,Kaliningrad Oblast,994599,29,0,48,0
2020-04-08,Russia,NA,Kaliningrad Oblast,994599,1,0,49,0
2020-04-09,Russia,NA,Kaliningrad Oblast,994599,3,0,52,0
2020-04-10,Russia,NA,Kaliningrad Oblast,994599,10,0,62,0
2020-04-11,Russia,NA,Kaliningrad Oblast,994599,3,0,65,0
2020-04-12,Russia,NA,Kaliningrad Oblast,994599,5,0,70,0
2020-04-13,Russia,NA,Kaliningrad Oblast,994599,4,0,74,0
2020-04-14,Russia,NA,Kaliningrad Oblast,994599,5,0,79,0
2020-04-15,Russia,NA,Kaliningrad Oblast,994599,5,0,84,0
2020-04-16,Russia,NA,Kaliningrad Oblast,994599,8,0,92,0
2020-04-17,Russia,NA,Kaliningrad Oblast,994599,12,0,104,0
2020-04-18,Russia,NA,Kaliningrad Oblast,994599,11,0,115,0
2020-04-19,Russia,NA,Kaliningrad Oblast,994599,11,0,126,0
2020-04-20,Russia,NA,Kaliningrad Oblast,994599,12,0,138,0
2020-04-21,Russia,NA,Kaliningrad Oblast,994599,6,0,144,0
2020-04-22,Russia,NA,Kaliningrad Oblast,994599,19,0,163,0
2020-04-23,Russia,NA,Kaliningrad Oblast,994599,8,0,171,0
2020-04-24,Russia,NA,Kaliningrad Oblast,994599,18,0,189,0
2020-04-25,Russia,NA,Kaliningrad Oblast,994599,21,0,210,0
2020-04-26,Russia,NA,Kaliningrad Oblast,994599,26,0,236,0
2020-04-27,Russia,NA,Kaliningrad Oblast,994599,28,0,264,0
2020-04-28,Russia,NA,Kaliningrad Oblast,994599,39,0,303,0
2020-04-29,Russia,NA,Kaliningrad Oblast,994599,23,0,326,0
2020-04-30,Russia,NA,Kaliningrad Oblast,994599,32,0,358,0
2020-05-01,Russia,NA,Kaliningrad Oblast,994599,37,0,395,0
2020-05-02,Russia,NA,Kaliningrad Oblast,994599,43,0,438,0
2020-05-03,Russia,NA,Kaliningrad Oblast,994599,41,0,479,0
2020-05-04,Russia,NA,Kaliningrad Oblast,994599,45,0,524,0
2020-05-05,Russia,NA,Kaliningrad Oblast,994599,42,0,566,0
2020-05-06,Russia,NA,Kaliningrad Oblast,994599,17,0,583,0
2020-05-07,Russia,NA,Kaliningrad Oblast,994599,16,0,599,0
2020-05-08,Russia,NA,Kaliningrad Oblast,994599,38,0,637,0
2020-05-09,Russia,NA,Kaliningrad Oblast,994599,34,0,671,0
2020-05-10,Russia,NA,Kaliningrad Oblast,994599,42,0,713,0
2020-05-11,Russia,NA,Kaliningrad Oblast,994599,40,0,753,0
2020-05-12,Russia,NA,Kaliningrad Oblast,994599,19,0,772,0
2020-05-13,Russia,NA,Kaliningrad Oblast,994599,40,0,812,0
2020-05-14,Russia,NA,Kaliningrad Oblast,994599,36,0,848,0
2020-05-15,Russia,NA,Kaliningrad Oblast,994599,33,0,881,0
2020-05-16,Russia,NA,Kaliningrad Oblast,994599,35,0,916,0
2020-05-17,Russia,NA,Kaliningrad Oblast,994599,36,0,952,0
2020-05-18,Russia,NA,Kaliningrad Oblast,994599,26,0,978,0
2020-05-19,Russia,NA,Kaliningrad Oblast,994599,32,0,1010,0
2020-05-20,Russia,NA,Kaliningrad Oblast,994599,32,0,1042,0
2020-05-21,Russia,NA,Kaliningrad Oblast,994599,34,0,1076,0
2020-05-22,Russia,NA,Kaliningrad Oblast,994599,41,0,1117,0
2020-05-23,Russia,NA,Kaliningrad Oblast,994599,41,0,1158,0
2020-05-24,Russia,NA,Kaliningrad Oblast,994599,43,0,1201,0
2020-05-25,Russia,NA,Kaliningrad Oblast,994599,43,0,1244,0
2020-05-26,Russia,NA,Kaliningrad Oblast,994599,50,0,1294,0
2020-05-27,Russia,NA,Kaliningrad Oblast,994599,44,0,1338,0
2020-05-28,Russia,NA,Kaliningrad Oblast,994599,38,0,1376,0
2020-05-29,Russia,NA,Kaliningrad Oblast,994599,33,0,1409,0
2020-05-30,Russia,NA,Kaliningrad Oblast,994599,51,0,1460,0
2020-05-31,Russia,NA,Kaliningrad Oblast,994599,48,0,1508,0
2020-06-01,Russia,NA,Kaliningrad Oblast,994599,45,0,1553,0
2020-06-02,Russia,NA,Kaliningrad Oblast,994599,54,0,1607,0
2020-06-03,Russia,NA,Kaliningrad Oblast,994599,35,0,1642,0
2020-06-04,Russia,NA,Kaliningrad Oblast,994599,23,0,1665,0
2020-06-05,Russia,NA,Kaliningrad Oblast,994599,35,0,1700,0
2020-06-06,Russia,NA,Kaliningrad Oblast,994599,36,0,1736,0
2020-06-07,Russia,NA,Kaliningrad Oblast,994599,40,0,1776,0
2020-06-08,Russia,NA,Kaliningrad Oblast,994599,37,0,1813,0
2020-06-09,Russia,NA,Kaliningrad Oblast,994599,45,0,1858,0
2020-06-10,Russia,NA,Kaliningrad Oblast,994599,46,0,1904,0
2020-06-11,Russia,NA,Kaliningrad Oblast,994599,42,0,1946,0
2020-06-12,Russia,NA,Kaliningrad Oblast,994599,38,0,1984,0
2020-06-13,Russia,NA,Kaliningrad Oblast,994599,43,0,2027,0
2020-06-14,Russia,NA,Kaliningrad Oblast,994599,45,0,2072,0
2020-06-15,Russia,NA,Kaliningrad Oblast,994599,40,0,2112,0
2020-06-16,Russia,NA,Kaliningrad Oblast,994599,12,0,2124,0
2020-06-17,Russia,NA,Kaliningrad Oblast,994599,37,0,2161,0
2020-06-18,Russia,NA,Kaliningrad Oblast,994599,34,0,2195,0
2020-06-19,Russia,NA,Kaliningrad Oblast,994599,32,0,2227,0
2020-06-20,Russia,NA,Kaliningrad Oblast,994599,35,0,2262,0
2020-06-21,Russia,NA,Kaliningrad Oblast,994599,30,0,2292,0
2020-06-22,Russia,NA,Kaliningrad Oblast,994599,29,0,2321,0
2020-06-23,Russia,NA,Kaliningrad Oblast,994599,27,0,2348,0
2020-06-24,Russia,NA,Kaliningrad Oblast,994599,8,0,2356,0
2020-06-25,Russia,NA,Kaliningrad Oblast,994599,17,0,2373,0
2020-06-26,Russia,NA,Kaliningrad Oblast,994599,19,0,2392,0
2020-06-27,Russia,NA,Kaliningrad Oblast,994599,19,0,2411,0
2020-06-28,Russia,NA,Kaliningrad Oblast,994599,15,0,2426,0
2020-06-29,Russia,NA,Kaliningrad Oblast,994599,10,0,2436,0
2020-06-30,Russia,NA,Kaliningrad Oblast,994599,10,0,2446,0
2020-07-01,Russia,NA,Kaliningrad Oblast,994599,9,0,2455,0
2020-07-02,Russia,NA,Kaliningrad Oblast,994599,17,0,2472,0
2020-07-03,Russia,NA,Kaliningrad Oblast,994599,15,0,2487,0
2020-07-04,Russia,NA,Kaliningrad Oblast,994599,18,0,2505,0
2020-07-05,Russia,NA,Kaliningrad Oblast,994599,16,0,2521,0
2020-07-06,Russia,NA,Kaliningrad Oblast,994599,18,0,2539,0
2020-07-07,Russia,NA,Kaliningrad Oblast,994599,14,0,2553,0
2020-07-08,Russia,NA,Kaliningrad Oblast,994599,11,0,2564,0
2020-07-09,Russia,NA,Kaliningrad Oblast,994599,14,0,2578,0
2020-07-10,Russia,NA,Kaliningrad Oblast,994599,13,0,2591,0
2020-07-11,Russia,NA,Kaliningrad Oblast,994599,14,0,2605,0
2020-07-12,Russia,NA,Kaliningrad Oblast,994599,10,0,2615,0
2020-07-13,Russia,NA,Kaliningrad Oblast,994599,12,0,2627,0
2020-07-14,Russia,NA,Kaliningrad Oblast,994599,9,0,2636,0
2020-07-15,Russia,NA,Kaliningrad Oblast,994599,12,0,2648,0
2020-07-16,Russia,NA,Kaliningrad Oblast,994599,14,0,2662,0
2020-07-17,Russia,NA,Kaliningrad Oblast,994599,14,0,2676,0
2020-07-18,Russia,NA,Kaliningrad Oblast,994599,15,0,2691,0
2020-07-19,Russia,NA,Kaliningrad Oblast,994599,14,0,2705,0
2020-07-20,Russia,NA,Kaliningrad Oblast,994599,13,0,2718,0
2020-07-21,Russia,NA,Kaliningrad Oblast,994599,11,0,2729,0
2020-07-22,Russia,NA,Kaliningrad Oblast,994599,7,0,2736,0
2020-07-23,Russia,NA,Kaliningrad Oblast,994599,10,0,2746,0
2020-07-24,Russia,NA,Kaliningrad Oblast,994599,13,0,2759,0
2020-07-25,Russia,NA,Kaliningrad Oblast,994599,16,0,2775,0
2020-07-26,Russia,NA,Kaliningrad Oblast,994599,15,0,2790,0
2020-07-27,Russia,NA,Kaliningrad Oblast,994599,15,0,2805,0
2020-07-28,Russia,NA,Kaliningrad Oblast,994599,16,0,2821,0
2020-07-29,Russia,NA,Kaliningrad Oblast,994599,14,0,2835,0
2020-07-30,Russia,NA,Kaliningrad Oblast,994599,19,0,2854,0
2020-07-31,Russia,NA,Kaliningrad Oblast,994599,21,0,2875,0
2020-08-01,Russia,NA,Kaliningrad Oblast,994599,23,0,2898,0
2020-08-02,Russia,NA,Kaliningrad Oblast,994599,19,0,2917,0
2020-08-26,Russia,NA,Kaliningrad Oblast,994599,0,0,3330,58
2020-08-27,Russia,NA,Kaliningrad Oblast,994599,18,0,3348,58
2020-08-28,Russia,NA,Kaliningrad Oblast,994599,21,0,3369,58
2020-08-29,Russia,NA,Kaliningrad Oblast,994599,24,0,3393,58
2020-08-30,Russia,NA,Kaliningrad Oblast,994599,22,0,3415,58
2020-08-31,Russia,NA,Kaliningrad Oblast,994599,15,0,3430,58
2020-09-01,Russia,NA,Kaliningrad Oblast,994599,16,0,3446,58
2020-09-02,Russia,NA,Kaliningrad Oblast,994599,17,0,3463,58
2020-09-03,Russia,NA,Kaliningrad Oblast,994599,20,0,3483,58
2020-09-04,Russia,NA,Kaliningrad Oblast,994599,19,0,3502,58
2020-09-05,Russia,NA,Kaliningrad Oblast,994599,21,0,3523,58
2020-09-06,Russia,NA,Kaliningrad Oblast,994599,20,0,3543,58
2020-09-07,Russia,NA,Kaliningrad Oblast,994599,25,0,3568,58
2020-09-08,Russia,NA,Kaliningrad Oblast,994599,28,0,3596,58
2020-09-09,Russia,NA,Kaliningrad Oblast,994599,30,0,3626,58
2020-09-10,Russia,NA,Kaliningrad Oblast,994599,29,0,3655,58
2020-09-11,Russia,NA,Kaliningrad Oblast,994599,30,0,3685,58
2020-09-12,Russia,NA,Kaliningrad Oblast,994599,27,0,3712,58
2020-09-13,Russia,NA,Kaliningrad Oblast,994599,32,0,3744,58
2020-09-14,Russia,NA,Kaliningrad Oblast,994599,31,0,3775,58
2020-09-15,Russia,NA,Kaliningrad Oblast,994599,35,3,3810,61
2020-09-16,Russia,NA,Kaliningrad Oblast,994599,32,3,3842,64
2020-09-17,Russia,NA,Kaliningrad Oblast,994599,33,1,3875,65
2020-09-18,Russia,NA,Kaliningrad Oblast,994599,31,2,3906,67
2020-09-19,Russia,NA,Kaliningrad Oblast,994599,35,0,3941,67
2020-09-20,Russia,NA,Kaliningrad Oblast,994599,34,0,3975,67
2020-09-21,Russia,NA,Kaliningrad Oblast,994599,32,1,4007,68
2020-09-22,Russia,NA,Kaliningrad Oblast,994599,34,4,4041,72
2020-09-23,Russia,NA,Kaliningrad Oblast,994599,38,1,4079,73
2020-04-07,Russia,NA,Kalmykia,275413,4,0,11,0
2020-04-08,Russia,NA,Kalmykia,275413,4,0,15,0
2020-04-09,Russia,NA,Kalmykia,275413,8,0,23,0
2020-04-11,Russia,NA,Kalmykia,275413,9,0,32,0
2020-04-15,Russia,NA,Kalmykia,275413,3,0,35,0
2020-04-16,Russia,NA,Kalmykia,275413,1,0,36,0
2020-04-17,Russia,NA,Kalmykia,275413,17,0,53,0
2020-04-18,Russia,NA,Kalmykia,275413,14,0,67,0
2020-04-19,Russia,NA,Kalmykia,275413,7,0,74,0
2020-04-20,Russia,NA,Kalmykia,275413,3,0,77,0
2020-04-22,Russia,NA,Kalmykia,275413,11,0,88,0
2020-04-23,Russia,NA,Kalmykia,275413,6,0,94,0
2020-04-24,Russia,NA,Kalmykia,275413,10,0,104,0
2020-04-25,Russia,NA,Kalmykia,275413,18,0,122,0
2020-04-26,Russia,NA,Kalmykia,275413,24,0,146,0
2020-04-27,Russia,NA,Kalmykia,275413,12,0,158,0
2020-04-28,Russia,NA,Kalmykia,275413,9,0,167,0
2020-04-29,Russia,NA,Kalmykia,275413,16,0,183,0
2020-04-30,Russia,NA,Kalmykia,275413,9,0,192,0
2020-05-01,Russia,NA,Kalmykia,275413,39,0,231,0
2020-05-02,Russia,NA,Kalmykia,275413,23,0,254,0
2020-05-03,Russia,NA,Kalmykia,275413,29,0,283,0
2020-05-04,Russia,NA,Kalmykia,275413,38,0,321,0
2020-05-05,Russia,NA,Kalmykia,275413,1,0,322,0
2020-05-06,Russia,NA,Kalmykia,275413,29,0,351,0
2020-05-07,Russia,NA,Kalmykia,275413,28,0,379,0
2020-05-08,Russia,NA,Kalmykia,275413,26,0,405,0
2020-05-09,Russia,NA,Kalmykia,275413,50,0,455,0
2020-05-10,Russia,NA,Kalmykia,275413,18,0,473,0
2020-05-11,Russia,NA,Kalmykia,275413,21,0,494,0
2020-05-12,Russia,NA,Kalmykia,275413,3,0,497,0
2020-05-13,Russia,NA,Kalmykia,275413,35,0,532,0
2020-05-14,Russia,NA,Kalmykia,275413,35,0,567,0
2020-05-15,Russia,NA,Kalmykia,275413,51,0,618,0
2020-05-16,Russia,NA,Kalmykia,275413,37,0,655,0
2020-05-17,Russia,NA,Kalmykia,275413,38,0,693,0
2020-05-18,Russia,NA,Kalmykia,275413,28,0,721,0
2020-05-20,Russia,NA,Kalmykia,275413,23,0,744,0
2020-05-21,Russia,NA,Kalmykia,275413,32,0,776,0
2020-05-22,Russia,NA,Kalmykia,275413,34,0,810,0
2020-05-23,Russia,NA,Kalmykia,275413,46,0,856,0
2020-05-24,Russia,NA,Kalmykia,275413,23,0,879,0
2020-05-25,Russia,NA,Kalmykia,275413,24,0,903,0
2020-05-27,Russia,NA,Kalmykia,275413,41,0,944,0
2020-05-28,Russia,NA,Kalmykia,275413,29,0,973,0
2020-05-29,Russia,NA,Kalmykia,275413,26,0,999,0
2020-05-30,Russia,NA,Kalmykia,275413,20,0,1019,0
2020-05-31,Russia,NA,Kalmykia,275413,35,0,1054,0
2020-06-01,Russia,NA,Kalmykia,275413,20,0,1074,0
2020-06-02,Russia,NA,Kalmykia,275413,11,0,1085,0
2020-06-03,Russia,NA,Kalmykia,275413,23,0,1108,0
2020-06-04,Russia,NA,Kalmykia,275413,19,0,1127,0
2020-06-05,Russia,NA,Kalmykia,275413,9,0,1136,0
2020-06-06,Russia,NA,Kalmykia,275413,13,0,1149,0
2020-06-07,Russia,NA,Kalmykia,275413,19,0,1168,0
2020-06-08,Russia,NA,Kalmykia,275413,11,0,1179,0
2020-06-09,Russia,NA,Kalmykia,275413,1,0,1180,0
2020-06-10,Russia,NA,Kalmykia,275413,23,0,1203,0
2020-06-11,Russia,NA,Kalmykia,275413,12,0,1215,0
2020-06-12,Russia,NA,Kalmykia,275413,18,0,1233,0
2020-06-13,Russia,NA,Kalmykia,275413,14,0,1247,0
2020-06-14,Russia,NA,Kalmykia,275413,16,0,1263,0
2020-06-15,Russia,NA,Kalmykia,275413,9,0,1272,0
2020-06-17,Russia,NA,Kalmykia,275413,16,0,1288,0
2020-06-18,Russia,NA,Kalmykia,275413,4,0,1292,0
2020-06-19,Russia,NA,Kalmykia,275413,8,0,1300,0
2020-06-20,Russia,NA,Kalmykia,275413,14,0,1314,0
2020-06-21,Russia,NA,Kalmykia,275413,13,0,1327,0
2020-06-22,Russia,NA,Kalmykia,275413,12,0,1339,0
2020-06-23,Russia,NA,Kalmykia,275413,1,0,1340,0
2020-06-24,Russia,NA,Kalmykia,275413,22,0,1362,0
2020-06-25,Russia,NA,Kalmykia,275413,30,0,1392,0
2020-06-26,Russia,NA,Kalmykia,275413,18,0,1410,0
2020-06-27,Russia,NA,Kalmykia,275413,32,0,1442,0
2020-06-28,Russia,NA,Kalmykia,275413,20,0,1462,0
2020-06-29,Russia,NA,Kalmykia,275413,19,0,1481,0
2020-06-30,Russia,NA,Kalmykia,275413,2,0,1483,0
2020-07-01,Russia,NA,Kalmykia,275413,40,0,1523,0
2020-07-02,Russia,NA,Kalmykia,275413,194,0,1717,0
2020-07-03,Russia,NA,Kalmykia,275413,122,0,1839,0
2020-07-04,Russia,NA,Kalmykia,275413,39,0,1878,0
2020-07-05,Russia,NA,Kalmykia,275413,37,0,1915,0
2020-07-06,Russia,NA,Kalmykia,275413,32,0,1947,0
2020-07-08,Russia,NA,Kalmykia,275413,40,0,1987,0
2020-07-09,Russia,NA,Kalmykia,275413,41,0,2028,0
2020-07-10,Russia,NA,Kalmykia,275413,45,0,2073,0
2020-07-11,Russia,NA,Kalmykia,275413,34,0,2107,0
2020-07-12,Russia,NA,Kalmykia,275413,42,0,2149,0
2020-07-13,Russia,NA,Kalmykia,275413,33,0,2182,0
2020-07-15,Russia,NA,Kalmykia,275413,38,0,2220,0
2020-07-16,Russia,NA,Kalmykia,275413,55,0,2275,0
2020-07-17,Russia,NA,Kalmykia,275413,40,0,2315,0
2020-07-18,Russia,NA,Kalmykia,275413,31,0,2346,0
2020-07-19,Russia,NA,Kalmykia,275413,17,0,2363,0
2020-07-20,Russia,NA,Kalmykia,275413,8,0,2371,0
2020-07-22,Russia,NA,Kalmykia,275413,34,0,2405,0
2020-07-23,Russia,NA,Kalmykia,275413,5,0,2410,0
2020-07-24,Russia,NA,Kalmykia,275413,29,0,2439,0
2020-07-25,Russia,NA,Kalmykia,275413,37,0,2476,0
2020-07-26,Russia,NA,Kalmykia,275413,19,0,2495,0
2020-07-27,Russia,NA,Kalmykia,275413,15,0,2510,0
2020-07-28,Russia,NA,Kalmykia,275413,2,0,2512,0
2020-07-29,Russia,NA,Kalmykia,275413,49,0,2561,0
2020-07-30,Russia,NA,Kalmykia,275413,28,0,2589,0
2020-07-31,Russia,NA,Kalmykia,275413,32,0,2621,0
2020-08-01,Russia,NA,Kalmykia,275413,19,0,2640,0
2020-08-02,Russia,NA,Kalmykia,275413,19,0,2659,0
2020-08-26,Russia,NA,Kalmykia,275413,0,0,3856,50
2020-08-27,Russia,NA,Kalmykia,275413,57,2,3913,52
2020-08-28,Russia,NA,Kalmykia,275413,68,3,3981,55
2020-08-29,Russia,NA,Kalmykia,275413,73,1,4054,56
2020-08-30,Russia,NA,Kalmykia,275413,83,0,4137,56
2020-08-31,Russia,NA,Kalmykia,275413,132,0,4269,56
2020-09-01,Russia,NA,Kalmykia,275413,57,0,4326,56
2020-09-02,Russia,NA,Kalmykia,275413,85,0,4411,56
2020-09-03,Russia,NA,Kalmykia,275413,79,0,4490,56
2020-09-04,Russia,NA,Kalmykia,275413,83,0,4573,56
2020-09-05,Russia,NA,Kalmykia,275413,82,0,4655,56
2020-09-06,Russia,NA,Kalmykia,275413,85,0,4740,56
2020-09-07,Russia,NA,Kalmykia,275413,83,0,4823,56
2020-09-08,Russia,NA,Kalmykia,275413,59,3,4882,59
2020-09-09,Russia,NA,Kalmykia,275413,84,2,4966,61
2020-09-10,Russia,NA,Kalmykia,275413,90,1,5056,62
2020-09-11,Russia,NA,Kalmykia,275413,103,3,5159,65
2020-09-12,Russia,NA,Kalmykia,275413,88,0,5247,65
2020-09-13,Russia,NA,Kalmykia,275413,68,0,5315,65
2020-09-14,Russia,NA,Kalmykia,275413,63,0,5378,65
2020-09-15,Russia,NA,Kalmykia,275413,73,0,5451,65
2020-09-16,Russia,NA,Kalmykia,275413,37,0,5488,65
2020-09-17,Russia,NA,Kalmykia,275413,63,0,5551,65
2020-09-18,Russia,NA,Kalmykia,275413,61,0,5612,65
2020-09-19,Russia,NA,Kalmykia,275413,69,0,5681,65
2020-09-20,Russia,NA,Kalmykia,275413,69,0,5750,65
2020-09-21,Russia,NA,Kalmykia,275413,73,0,5823,65
2020-09-22,Russia,NA,Kalmykia,275413,62,2,5885,67
2020-09-23,Russia,NA,Kalmykia,275413,69,2,5954,69
2020-04-07,Russia,NA,Kaluga Oblast,1012156,4,0,11,0
2020-04-10,Russia,NA,Kaluga Oblast,1012156,7,0,18,0
2020-04-11,Russia,NA,Kaluga Oblast,1012156,6,0,24,0
2020-04-13,Russia,NA,Kaluga Oblast,1012156,10,0,34,0
2020-04-14,Russia,NA,Kaluga Oblast,1012156,15,0,49,0
2020-04-15,Russia,NA,Kaluga Oblast,1012156,25,0,74,0
2020-04-16,Russia,NA,Kaluga Oblast,1012156,28,0,102,0
2020-04-17,Russia,NA,Kaluga Oblast,1012156,20,0,122,0
2020-04-18,Russia,NA,Kaluga Oblast,1012156,29,0,151,0
2020-04-19,Russia,NA,Kaluga Oblast,1012156,37,0,188,0
2020-04-20,Russia,NA,Kaluga Oblast,1012156,40,0,228,0
2020-04-21,Russia,NA,Kaluga Oblast,1012156,30,0,258,0
2020-04-22,Russia,NA,Kaluga Oblast,1012156,72,0,330,0
2020-04-23,Russia,NA,Kaluga Oblast,1012156,53,0,383,0
2020-04-24,Russia,NA,Kaluga Oblast,1012156,61,0,444,0
2020-04-25,Russia,NA,Kaluga Oblast,1012156,69,0,513,0
2020-04-26,Russia,NA,Kaluga Oblast,1012156,70,0,583,0
2020-04-27,Russia,NA,Kaluga Oblast,1012156,56,0,639,0
2020-04-28,Russia,NA,Kaluga Oblast,1012156,67,0,706,0
2020-04-29,Russia,NA,Kaluga Oblast,1012156,66,0,772,0
2020-04-30,Russia,NA,Kaluga Oblast,1012156,113,0,885,0
2020-05-01,Russia,NA,Kaluga Oblast,1012156,121,0,1006,0
2020-05-02,Russia,NA,Kaluga Oblast,1012156,59,0,1065,0
2020-05-03,Russia,NA,Kaluga Oblast,1012156,71,0,1136,0
2020-05-04,Russia,NA,Kaluga Oblast,1012156,81,0,1217,0
2020-05-05,Russia,NA,Kaluga Oblast,1012156,92,0,1309,0
2020-05-06,Russia,NA,Kaluga Oblast,1012156,98,0,1407,0
2020-05-07,Russia,NA,Kaluga Oblast,1012156,79,0,1486,0
2020-05-08,Russia,NA,Kaluga Oblast,1012156,78,0,1564,0
2020-05-09,Russia,NA,Kaluga Oblast,1012156,77,0,1641,0
2020-05-10,Russia,NA,Kaluga Oblast,1012156,89,0,1730,0
2020-05-11,Russia,NA,Kaluga Oblast,1012156,98,0,1828,0
2020-05-12,Russia,NA,Kaluga Oblast,1012156,96,0,1924,0
2020-05-13,Russia,NA,Kaluga Oblast,1012156,94,0,2018,0
2020-05-14,Russia,NA,Kaluga Oblast,1012156,97,0,2115,0
2020-05-15,Russia,NA,Kaluga Oblast,1012156,98,0,2213,0
2020-05-16,Russia,NA,Kaluga Oblast,1012156,99,0,2312,0
2020-05-17,Russia,NA,Kaluga Oblast,1012156,97,0,2409,0
2020-05-18,Russia,NA,Kaluga Oblast,1012156,109,0,2518,0
2020-05-19,Russia,NA,Kaluga Oblast,1012156,114,0,2632,0
2020-05-20,Russia,NA,Kaluga Oblast,1012156,118,0,2750,0
2020-05-21,Russia,NA,Kaluga Oblast,1012156,121,0,2871,0
2020-05-22,Russia,NA,Kaluga Oblast,1012156,127,0,2998,0
2020-05-23,Russia,NA,Kaluga Oblast,1012156,125,0,3123,0
2020-05-24,Russia,NA,Kaluga Oblast,1012156,123,0,3246,0
2020-05-25,Russia,NA,Kaluga Oblast,1012156,108,0,3354,0
2020-05-26,Russia,NA,Kaluga Oblast,1012156,105,0,3459,0
2020-05-27,Russia,NA,Kaluga Oblast,1012156,101,0,3560,0
2020-05-28,Russia,NA,Kaluga Oblast,1012156,93,0,3653,0
2020-05-29,Russia,NA,Kaluga Oblast,1012156,91,0,3744,0
2020-05-30,Russia,NA,Kaluga Oblast,1012156,90,0,3834,0
2020-05-31,Russia,NA,Kaluga Oblast,1012156,89,0,3923,0
2020-06-01,Russia,NA,Kaluga Oblast,1012156,86,0,4009,0
2020-06-02,Russia,NA,Kaluga Oblast,1012156,83,0,4092,0
2020-06-03,Russia,NA,Kaluga Oblast,1012156,87,0,4179,0
2020-06-04,Russia,NA,Kaluga Oblast,1012156,91,0,4270,0
2020-06-05,Russia,NA,Kaluga Oblast,1012156,87,0,4357,0
2020-06-06,Russia,NA,Kaluga Oblast,1012156,74,0,4431,0
2020-06-07,Russia,NA,Kaluga Oblast,1012156,80,0,4511,0
2020-06-08,Russia,NA,Kaluga Oblast,1012156,89,0,4600,0
2020-06-09,Russia,NA,Kaluga Oblast,1012156,91,0,4691,0
2020-06-10,Russia,NA,Kaluga Oblast,1012156,70,0,4761,0
2020-06-11,Russia,NA,Kaluga Oblast,1012156,68,0,4829,0
2020-06-12,Russia,NA,Kaluga Oblast,1012156,94,0,4923,0
2020-06-13,Russia,NA,Kaluga Oblast,1012156,88,0,5011,0
2020-06-14,Russia,NA,Kaluga Oblast,1012156,80,0,5091,0
2020-06-15,Russia,NA,Kaluga Oblast,1012156,78,0,5169,0
2020-06-16,Russia,NA,Kaluga Oblast,1012156,77,0,5246,0
2020-06-17,Russia,NA,Kaluga Oblast,1012156,75,0,5321,0
2020-06-18,Russia,NA,Kaluga Oblast,1012156,78,0,5399,0
2020-06-19,Russia,NA,Kaluga Oblast,1012156,63,0,5462,0
2020-06-20,Russia,NA,Kaluga Oblast,1012156,60,0,5522,0
2020-06-21,Russia,NA,Kaluga Oblast,1012156,58,0,5580,0
2020-06-22,Russia,NA,Kaluga Oblast,1012156,60,0,5640,0
2020-06-23,Russia,NA,Kaluga Oblast,1012156,54,0,5694,0
2020-06-24,Russia,NA,Kaluga Oblast,1012156,50,0,5744,0
2020-06-25,Russia,NA,Kaluga Oblast,1012156,44,0,5788,0
2020-06-26,Russia,NA,Kaluga Oblast,1012156,46,0,5834,0
2020-06-27,Russia,NA,Kaluga Oblast,1012156,46,0,5880,0
2020-06-28,Russia,NA,Kaluga Oblast,1012156,45,0,5925,0
2020-06-29,Russia,NA,Kaluga Oblast,1012156,48,0,5973,0
2020-06-30,Russia,NA,Kaluga Oblast,1012156,45,0,6018,0
2020-07-01,Russia,NA,Kaluga Oblast,1012156,48,0,6066,0
2020-07-02,Russia,NA,Kaluga Oblast,1012156,51,0,6117,0
2020-07-03,Russia,NA,Kaluga Oblast,1012156,53,0,6170,0
2020-07-04,Russia,NA,Kaluga Oblast,1012156,52,0,6222,0
2020-07-05,Russia,NA,Kaluga Oblast,1012156,50,0,6272,0
2020-07-06,Russia,NA,Kaluga Oblast,1012156,49,0,6321,0
2020-07-07,Russia,NA,Kaluga Oblast,1012156,47,0,6368,0
2020-07-08,Russia,NA,Kaluga Oblast,1012156,45,0,6413,0
2020-07-09,Russia,NA,Kaluga Oblast,1012156,45,0,6458,0
2020-07-10,Russia,NA,Kaluga Oblast,1012156,51,0,6509,0
2020-07-11,Russia,NA,Kaluga Oblast,1012156,50,0,6559,0
2020-07-12,Russia,NA,Kaluga Oblast,1012156,49,0,6608,0
2020-07-13,Russia,NA,Kaluga Oblast,1012156,48,0,6656,0
2020-07-14,Russia,NA,Kaluga Oblast,1012156,41,0,6697,0
2020-07-15,Russia,NA,Kaluga Oblast,1012156,45,0,6742,0
2020-07-16,Russia,NA,Kaluga Oblast,1012156,39,0,6781,0
2020-07-17,Russia,NA,Kaluga Oblast,1012156,37,0,6818,0
2020-07-18,Russia,NA,Kaluga Oblast,1012156,36,0,6854,0
2020-07-19,Russia,NA,Kaluga Oblast,1012156,35,0,6889,0
2020-07-20,Russia,NA,Kaluga Oblast,1012156,34,0,6923,0
2020-07-21,Russia,NA,Kaluga Oblast,1012156,34,0,6957,0
2020-07-22,Russia,NA,Kaluga Oblast,1012156,30,0,6987,0
2020-07-23,Russia,NA,Kaluga Oblast,1012156,33,0,7020,0
2020-07-24,Russia,NA,Kaluga Oblast,1012156,24,0,7044,0
2020-07-25,Russia,NA,Kaluga Oblast,1012156,23,0,7067,0
2020-07-26,Russia,NA,Kaluga Oblast,1012156,23,0,7090,0
2020-07-27,Russia,NA,Kaluga Oblast,1012156,21,0,7111,0
2020-07-28,Russia,NA,Kaluga Oblast,1012156,22,0,7133,0
2020-07-29,Russia,NA,Kaluga Oblast,1012156,22,0,7155,0
2020-07-30,Russia,NA,Kaluga Oblast,1012156,24,0,7179,0
2020-07-31,Russia,NA,Kaluga Oblast,1012156,25,0,7204,0
2020-08-01,Russia,NA,Kaluga Oblast,1012156,28,0,7232,0
2020-08-02,Russia,NA,Kaluga Oblast,1012156,28,0,7260,0
2020-08-26,Russia,NA,Kaluga Oblast,1012156,0,0,7910,64
2020-08-27,Russia,NA,Kaluga Oblast,1012156,26,3,7936,67
2020-08-28,Russia,NA,Kaluga Oblast,1012156,28,0,7964,67
2020-08-29,Russia,NA,Kaluga Oblast,1012156,29,0,7993,67
2020-08-30,Russia,NA,Kaluga Oblast,1012156,30,0,8023,67
2020-08-31,Russia,NA,Kaluga Oblast,1012156,32,0,8055,67
2020-09-01,Russia,NA,Kaluga Oblast,1012156,24,0,8079,67
2020-09-02,Russia,NA,Kaluga Oblast,1012156,29,2,8108,69
2020-09-03,Russia,NA,Kaluga Oblast,1012156,26,0,8134,69
2020-09-04,Russia,NA,Kaluga Oblast,1012156,32,0,8166,69
2020-09-05,Russia,NA,Kaluga Oblast,1012156,29,0,8195,69
2020-09-06,Russia,NA,Kaluga Oblast,1012156,27,2,8222,71
2020-09-07,Russia,NA,Kaluga Oblast,1012156,29,0,8251,71
2020-09-08,Russia,NA,Kaluga Oblast,1012156,22,0,8273,71
2020-09-09,Russia,NA,Kaluga Oblast,1012156,27,0,8300,71
2020-09-10,Russia,NA,Kaluga Oblast,1012156,29,0,8329,71
2020-09-11,Russia,NA,Kaluga Oblast,1012156,32,0,8361,71
2020-09-12,Russia,NA,Kaluga Oblast,1012156,35,0,8396,71
2020-09-13,Russia,NA,Kaluga Oblast,1012156,37,0,8433,71
2020-09-14,Russia,NA,Kaluga Oblast,1012156,39,0,8472,71
2020-09-15,Russia,NA,Kaluga Oblast,1012156,30,0,8502,71
2020-09-16,Russia,NA,Kaluga Oblast,1012156,32,0,8534,71
2020-09-17,Russia,NA,Kaluga Oblast,1012156,40,0,8574,71
2020-09-18,Russia,NA,Kaluga Oblast,1012156,48,0,8622,71
2020-09-19,Russia,NA,Kaluga Oblast,1012156,50,1,8672,72
2020-09-20,Russia,NA,Kaluga Oblast,1012156,42,0,8714,72
2020-09-21,Russia,NA,Kaluga Oblast,1012156,45,0,8759,72
2020-09-22,Russia,NA,Kaluga Oblast,1012156,24,2,8783,74
2020-09-23,Russia,NA,Kaluga Oblast,1012156,40,0,8823,74
2020-04-16,Russia,NA,Kamchatka Krai,315557,11,0,21,0
2020-04-17,Russia,NA,Kamchatka Krai,315557,8,0,29,0
2020-04-19,Russia,NA,Kamchatka Krai,315557,5,0,34,0
2020-04-20,Russia,NA,Kamchatka Krai,315557,7,0,41,0
2020-04-21,Russia,NA,Kamchatka Krai,315557,7,0,48,0
2020-04-22,Russia,NA,Kamchatka Krai,315557,15,0,63,0
2020-04-23,Russia,NA,Kamchatka Krai,315557,15,0,78,0
2020-04-24,Russia,NA,Kamchatka Krai,315557,6,0,84,0
2020-04-25,Russia,NA,Kamchatka Krai,315557,3,0,87,0
2020-04-26,Russia,NA,Kamchatka Krai,315557,23,0,110,0
2020-04-27,Russia,NA,Kamchatka Krai,315557,85,0,195,0
2020-04-28,Russia,NA,Kamchatka Krai,315557,8,0,203,0
2020-04-29,Russia,NA,Kamchatka Krai,315557,38,0,241,0
2020-04-30,Russia,NA,Kamchatka Krai,315557,24,0,265,0
2020-05-01,Russia,NA,Kamchatka Krai,315557,16,0,281,0
2020-05-02,Russia,NA,Kamchatka Krai,315557,5,0,286,0
2020-05-03,Russia,NA,Kamchatka Krai,315557,25,0,311,0
2020-05-04,Russia,NA,Kamchatka Krai,315557,28,0,339,0
2020-05-05,Russia,NA,Kamchatka Krai,315557,8,0,347,0
2020-05-06,Russia,NA,Kamchatka Krai,315557,1,0,348,0
2020-05-07,Russia,NA,Kamchatka Krai,315557,2,0,350,0
2020-05-08,Russia,NA,Kamchatka Krai,315557,3,0,353,0
2020-05-09,Russia,NA,Kamchatka Krai,315557,10,0,363,0
2020-05-10,Russia,NA,Kamchatka Krai,315557,13,0,376,0
2020-05-11,Russia,NA,Kamchatka Krai,315557,8,0,384,0
2020-05-12,Russia,NA,Kamchatka Krai,315557,14,0,398,0
2020-05-13,Russia,NA,Kamchatka Krai,315557,20,0,418,0
2020-05-14,Russia,NA,Kamchatka Krai,315557,11,0,429,0
2020-05-15,Russia,NA,Kamchatka Krai,315557,14,0,443,0
2020-05-16,Russia,NA,Kamchatka Krai,315557,18,0,461,0
2020-05-17,Russia,NA,Kamchatka Krai,315557,16,0,477,0
2020-05-18,Russia,NA,Kamchatka Krai,315557,18,0,495,0
2020-05-19,Russia,NA,Kamchatka Krai,315557,20,0,515,0
2020-05-20,Russia,NA,Kamchatka Krai,315557,21,0,536,0
2020-05-21,Russia,NA,Kamchatka Krai,315557,18,0,554,0
2020-05-22,Russia,NA,Kamchatka Krai,315557,18,0,572,0
2020-05-23,Russia,NA,Kamchatka Krai,315557,23,0,595,0
2020-05-24,Russia,NA,Kamchatka Krai,315557,32,0,627,0
2020-05-25,Russia,NA,Kamchatka Krai,315557,31,0,658,0
2020-05-26,Russia,NA,Kamchatka Krai,315557,20,0,678,0
2020-05-27,Russia,NA,Kamchatka Krai,315557,22,0,700,0
2020-05-28,Russia,NA,Kamchatka Krai,315557,25,0,725,0
2020-05-29,Russia,NA,Kamchatka Krai,315557,34,0,759,0
2020-05-30,Russia,NA,Kamchatka Krai,315557,46,0,805,0
2020-05-31,Russia,NA,Kamchatka Krai,315557,44,0,849,0
2020-06-01,Russia,NA,Kamchatka Krai,315557,32,0,881,0
2020-06-02,Russia,NA,Kamchatka Krai,315557,35,0,916,0
2020-06-03,Russia,NA,Kamchatka Krai,315557,33,0,949,0
2020-06-04,Russia,NA,Kamchatka Krai,315557,35,0,984,0
2020-06-05,Russia,NA,Kamchatka Krai,315557,49,0,1033,0
2020-06-06,Russia,NA,Kamchatka Krai,315557,52,0,1085,0
2020-06-07,Russia,NA,Kamchatka Krai,315557,40,0,1125,0
2020-06-08,Russia,NA,Kamchatka Krai,315557,43,0,1168,0
2020-06-09,Russia,NA,Kamchatka Krai,315557,46,0,1214,0
2020-06-10,Russia,NA,Kamchatka Krai,315557,41,0,1255,0
2020-06-11,Russia,NA,Kamchatka Krai,315557,51,0,1306,0
2020-06-12,Russia,NA,Kamchatka Krai,315557,54,0,1360,0
2020-06-13,Russia,NA,Kamchatka Krai,315557,49,0,1409,0
2020-06-14,Russia,NA,Kamchatka Krai,315557,45,0,1454,0
2020-06-15,Russia,NA,Kamchatka Krai,315557,42,0,1496,0
2020-06-16,Russia,NA,Kamchatka Krai,315557,40,0,1536,0
2020-06-17,Russia,NA,Kamchatka Krai,315557,39,0,1575,0
2020-06-18,Russia,NA,Kamchatka Krai,315557,42,0,1617,0
2020-06-19,Russia,NA,Kamchatka Krai,315557,45,0,1662,0
2020-06-20,Russia,NA,Kamchatka Krai,315557,52,0,1714,0
2020-06-21,Russia,NA,Kamchatka Krai,315557,41,0,1755,0
2020-06-22,Russia,NA,Kamchatka Krai,315557,38,0,1793,0
2020-06-23,Russia,NA,Kamchatka Krai,315557,41,0,1834,0
2020-06-24,Russia,NA,Kamchatka Krai,315557,93,0,1927,0
2020-06-25,Russia,NA,Kamchatka Krai,315557,42,0,1969,0
2020-06-26,Russia,NA,Kamchatka Krai,315557,39,0,2008,0
2020-06-27,Russia,NA,Kamchatka Krai,315557,44,0,2052,0
2020-06-28,Russia,NA,Kamchatka Krai,315557,41,0,2093,0
2020-06-29,Russia,NA,Kamchatka Krai,315557,52,0,2145,0
2020-06-30,Russia,NA,Kamchatka Krai,315557,45,0,2190,0
2020-07-01,Russia,NA,Kamchatka Krai,315557,55,0,2245,0
2020-07-02,Russia,NA,Kamchatka Krai,315557,48,0,2293,0
2020-07-03,Russia,NA,Kamchatka Krai,315557,41,0,2334,0
2020-07-04,Russia,NA,Kamchatka Krai,315557,46,0,2380,0
2020-07-05,Russia,NA,Kamchatka Krai,315557,42,0,2422,0
2020-07-06,Russia,NA,Kamchatka Krai,315557,47,0,2469,0
2020-07-07,Russia,NA,Kamchatka Krai,315557,45,0,2514,0
2020-07-08,Russia,NA,Kamchatka Krai,315557,46,0,2560,0
2020-07-09,Russia,NA,Kamchatka Krai,315557,42,0,2602,0
2020-07-10,Russia,NA,Kamchatka Krai,315557,38,0,2640,0
2020-07-11,Russia,NA,Kamchatka Krai,315557,36,0,2676,0
2020-07-12,Russia,NA,Kamchatka Krai,315557,37,0,2713,0
2020-07-13,Russia,NA,Kamchatka Krai,315557,44,0,2757,0
2020-07-14,Russia,NA,Kamchatka Krai,315557,41,0,2798,0
2020-07-15,Russia,NA,Kamchatka Krai,315557,42,0,2840,0
2020-07-16,Russia,NA,Kamchatka Krai,315557,36,0,2876,0
2020-07-17,Russia,NA,Kamchatka Krai,315557,34,0,2910,0
2020-07-18,Russia,NA,Kamchatka Krai,315557,35,0,2945,0
2020-07-19,Russia,NA,Kamchatka Krai,315557,37,0,2982,0
2020-07-20,Russia,NA,Kamchatka Krai,315557,35,0,3017,0
2020-07-21,Russia,NA,Kamchatka Krai,315557,34,0,3051,0
2020-07-22,Russia,NA,Kamchatka Krai,315557,35,0,3086,0
2020-07-23,Russia,NA,Kamchatka Krai,315557,36,0,3122,0
2020-07-24,Russia,NA,Kamchatka Krai,315557,38,0,3160,0
2020-07-25,Russia,NA,Kamchatka Krai,315557,41,0,3201,0
2020-07-26,Russia,NA,Kamchatka Krai,315557,39,0,3240,0
2020-07-27,Russia,NA,Kamchatka Krai,315557,30,0,3270,0
2020-07-28,Russia,NA,Kamchatka Krai,315557,19,0,3289,0
2020-07-29,Russia,NA,Kamchatka Krai,315557,25,0,3314,0
2020-07-30,Russia,NA,Kamchatka Krai,315557,22,0,3336,0
2020-07-31,Russia,NA,Kamchatka Krai,315557,26,0,3362,0
2020-08-01,Russia,NA,Kamchatka Krai,315557,16,0,3378,0
2020-08-02,Russia,NA,Kamchatka Krai,315557,23,0,3401,0
2020-08-26,Russia,NA,Kamchatka Krai,315557,0,0,3791,42
2020-08-27,Russia,NA,Kamchatka Krai,315557,12,0,3803,42
2020-08-28,Russia,NA,Kamchatka Krai,315557,13,0,3816,42
2020-08-29,Russia,NA,Kamchatka Krai,315557,12,0,3828,42
2020-08-30,Russia,NA,Kamchatka Krai,315557,13,0,3841,42
2020-08-31,Russia,NA,Kamchatka Krai,315557,11,0,3852,42
2020-09-01,Russia,NA,Kamchatka Krai,315557,12,0,3864,42
2020-09-02,Russia,NA,Kamchatka Krai,315557,13,0,3877,42
2020-09-03,Russia,NA,Kamchatka Krai,315557,24,0,3901,42
2020-09-04,Russia,NA,Kamchatka Krai,315557,14,0,3915,42
2020-09-05,Russia,NA,Kamchatka Krai,315557,14,0,3929,42
2020-09-06,Russia,NA,Kamchatka Krai,315557,13,0,3942,42
2020-09-07,Russia,NA,Kamchatka Krai,315557,13,0,3955,42
2020-09-08,Russia,NA,Kamchatka Krai,315557,12,0,3967,42
2020-09-09,Russia,NA,Kamchatka Krai,315557,14,0,3981,42
2020-09-10,Russia,NA,Kamchatka Krai,315557,15,1,3996,43
2020-09-11,Russia,NA,Kamchatka Krai,315557,30,6,4026,49
2020-09-12,Russia,NA,Kamchatka Krai,315557,27,5,4053,54
2020-09-13,Russia,NA,Kamchatka Krai,315557,25,3,4078,57
2020-09-14,Russia,NA,Kamchatka Krai,315557,21,3,4099,60
2020-09-15,Russia,NA,Kamchatka Krai,315557,23,4,4122,64
2020-09-16,Russia,NA,Kamchatka Krai,315557,23,3,4145,67
2020-09-17,Russia,NA,Kamchatka Krai,315557,28,0,4173,67
2020-09-18,Russia,NA,Kamchatka Krai,315557,25,0,4198,67
2020-09-19,Russia,NA,Kamchatka Krai,315557,26,0,4224,67
2020-09-20,Russia,NA,Kamchatka Krai,315557,20,0,4244,67
2020-09-21,Russia,NA,Kamchatka Krai,315557,22,0,4266,67
2020-09-22,Russia,NA,Kamchatka Krai,315557,25,0,4291,67
2020-09-23,Russia,NA,Kamchatka Krai,315557,25,0,4316,67
2020-04-08,Russia,NA,Karachay-Cherkessia,466305,10,0,13,0
2020-04-09,Russia,NA,Karachay-Cherkessia,466305,1,0,14,0
2020-04-10,Russia,NA,Karachay-Cherkessia,466305,3,0,17,0
2020-04-12,Russia,NA,Karachay-Cherkessia,466305,2,0,19,0
2020-04-13,Russia,NA,Karachay-Cherkessia,466305,2,0,21,0
2020-04-15,Russia,NA,Karachay-Cherkessia,466305,7,0,28,0
2020-04-16,Russia,NA,Karachay-Cherkessia,466305,7,0,35,0
2020-04-17,Russia,NA,Karachay-Cherkessia,466305,19,0,54,0
2020-04-18,Russia,NA,Karachay-Cherkessia,466305,1,0,55,0
2020-04-19,Russia,NA,Karachay-Cherkessia,466305,17,0,72,0
2020-04-20,Russia,NA,Karachay-Cherkessia,466305,20,0,92,0
2020-04-21,Russia,NA,Karachay-Cherkessia,466305,19,0,111,0
2020-04-22,Russia,NA,Karachay-Cherkessia,466305,39,0,150,0
2020-04-23,Russia,NA,Karachay-Cherkessia,466305,24,0,174,0
2020-04-24,Russia,NA,Karachay-Cherkessia,466305,25,0,199,0
2020-04-25,Russia,NA,Karachay-Cherkessia,466305,46,0,245,0
2020-04-26,Russia,NA,Karachay-Cherkessia,466305,42,0,287,0
2020-04-27,Russia,NA,Karachay-Cherkessia,466305,19,0,306,0
2020-04-28,Russia,NA,Karachay-Cherkessia,466305,13,0,319,0
2020-04-29,Russia,NA,Karachay-Cherkessia,466305,16,0,335,0
2020-04-30,Russia,NA,Karachay-Cherkessia,466305,22,0,357,0
2020-05-01,Russia,NA,Karachay-Cherkessia,466305,46,0,403,0
2020-05-02,Russia,NA,Karachay-Cherkessia,466305,14,0,417,0
2020-05-03,Russia,NA,Karachay-Cherkessia,466305,18,0,435,0
2020-05-04,Russia,NA,Karachay-Cherkessia,466305,11,0,446,0
2020-05-05,Russia,NA,Karachay-Cherkessia,466305,12,0,458,0
2020-05-06,Russia,NA,Karachay-Cherkessia,466305,4,0,462,0
2020-05-07,Russia,NA,Karachay-Cherkessia,466305,6,0,468,0
2020-05-08,Russia,NA,Karachay-Cherkessia,466305,15,0,483,0
2020-05-09,Russia,NA,Karachay-Cherkessia,466305,31,0,514,0
2020-05-10,Russia,NA,Karachay-Cherkessia,466305,18,0,532,0
2020-05-11,Russia,NA,Karachay-Cherkessia,466305,12,0,544,0
2020-05-12,Russia,NA,Karachay-Cherkessia,466305,10,0,554,0
2020-05-13,Russia,NA,Karachay-Cherkessia,466305,12,0,566,0
2020-05-14,Russia,NA,Karachay-Cherkessia,466305,27,0,593,0
2020-05-15,Russia,NA,Karachay-Cherkessia,466305,26,0,619,0
2020-05-16,Russia,NA,Karachay-Cherkessia,466305,18,0,637,0
2020-05-17,Russia,NA,Karachay-Cherkessia,466305,19,0,656,0
2020-05-18,Russia,NA,Karachay-Cherkessia,466305,15,0,671,0
2020-05-19,Russia,NA,Karachay-Cherkessia,466305,11,0,682,0
2020-05-20,Russia,NA,Karachay-Cherkessia,466305,12,0,694,0
2020-05-21,Russia,NA,Karachay-Cherkessia,466305,12,0,706,0
2020-05-22,Russia,NA,Karachay-Cherkessia,466305,11,0,717,0
2020-05-23,Russia,NA,Karachay-Cherkessia,466305,20,0,737,0
2020-05-24,Russia,NA,Karachay-Cherkessia,466305,25,0,762,0
2020-05-25,Russia,NA,Karachay-Cherkessia,466305,26,0,788,0
2020-05-26,Russia,NA,Karachay-Cherkessia,466305,31,0,819,0
2020-05-27,Russia,NA,Karachay-Cherkessia,466305,39,0,858,0
2020-05-28,Russia,NA,Karachay-Cherkessia,466305,42,0,900,0
2020-05-29,Russia,NA,Karachay-Cherkessia,466305,56,0,956,0
2020-05-30,Russia,NA,Karachay-Cherkessia,466305,54,0,1010,0
2020-05-31,Russia,NA,Karachay-Cherkessia,466305,62,0,1072,0
2020-06-01,Russia,NA,Karachay-Cherkessia,466305,70,0,1142,0
2020-06-02,Russia,NA,Karachay-Cherkessia,466305,67,0,1209,0
2020-06-03,Russia,NA,Karachay-Cherkessia,466305,72,0,1281,0
2020-06-04,Russia,NA,Karachay-Cherkessia,466305,78,0,1359,0
2020-06-05,Russia,NA,Karachay-Cherkessia,466305,76,0,1435,0
2020-06-06,Russia,NA,Karachay-Cherkessia,466305,75,0,1510,0
2020-06-07,Russia,NA,Karachay-Cherkessia,466305,75,0,1585,0
2020-06-08,Russia,NA,Karachay-Cherkessia,466305,74,0,1659,0
2020-06-09,Russia,NA,Karachay-Cherkessia,466305,75,0,1734,0
2020-06-10,Russia,NA,Karachay-Cherkessia,466305,78,0,1812,0
2020-06-11,Russia,NA,Karachay-Cherkessia,466305,82,0,1894,0
2020-06-12,Russia,NA,Karachay-Cherkessia,466305,80,0,1974,0
2020-06-13,Russia,NA,Karachay-Cherkessia,466305,89,0,2063,0
2020-06-14,Russia,NA,Karachay-Cherkessia,466305,98,0,2161,0
2020-06-15,Russia,NA,Karachay-Cherkessia,466305,99,0,2260,0
2020-06-16,Russia,NA,Karachay-Cherkessia,466305,94,0,2354,0
2020-06-17,Russia,NA,Karachay-Cherkessia,466305,97,0,2451,0
2020-06-18,Russia,NA,Karachay-Cherkessia,466305,99,0,2550,0
2020-06-19,Russia,NA,Karachay-Cherkessia,466305,94,0,2644,0
2020-06-20,Russia,NA,Karachay-Cherkessia,466305,91,0,2735,0
2020-06-21,Russia,NA,Karachay-Cherkessia,466305,85,0,2820,0
2020-06-22,Russia,NA,Karachay-Cherkessia,466305,87,0,2907,0
2020-06-23,Russia,NA,Karachay-Cherkessia,466305,81,0,2988,0
2020-06-24,Russia,NA,Karachay-Cherkessia,466305,84,0,3072,0
2020-06-25,Russia,NA,Karachay-Cherkessia,466305,82,0,3154,0
2020-06-26,Russia,NA,Karachay-Cherkessia,466305,72,0,3226,0
2020-06-27,Russia,NA,Karachay-Cherkessia,466305,84,0,3310,0
2020-06-28,Russia,NA,Karachay-Cherkessia,466305,74,0,3384,0
2020-06-29,Russia,NA,Karachay-Cherkessia,466305,69,0,3453,0
2020-06-30,Russia,NA,Karachay-Cherkessia,466305,72,0,3525,0
2020-07-01,Russia,NA,Karachay-Cherkessia,466305,79,0,3604,0
2020-07-02,Russia,NA,Karachay-Cherkessia,466305,69,0,3673,0
2020-07-03,Russia,NA,Karachay-Cherkessia,466305,62,0,3735,0
2020-07-04,Russia,NA,Karachay-Cherkessia,466305,44,0,3779,0
2020-07-05,Russia,NA,Karachay-Cherkessia,466305,43,0,3822,0
2020-07-06,Russia,NA,Karachay-Cherkessia,466305,33,0,3855,0
2020-07-07,Russia,NA,Karachay-Cherkessia,466305,32,0,3887,0
2020-07-08,Russia,NA,Karachay-Cherkessia,466305,37,0,3924,0
2020-07-09,Russia,NA,Karachay-Cherkessia,466305,38,0,3962,0
2020-07-10,Russia,NA,Karachay-Cherkessia,466305,31,0,3993,0
2020-07-11,Russia,NA,Karachay-Cherkessia,466305,29,0,4022,0
2020-07-12,Russia,NA,Karachay-Cherkessia,466305,27,0,4049,0
2020-07-13,Russia,NA,Karachay-Cherkessia,466305,21,0,4070,0
2020-07-14,Russia,NA,Karachay-Cherkessia,466305,19,0,4089,0
2020-07-15,Russia,NA,Karachay-Cherkessia,466305,25,0,4114,0
2020-07-16,Russia,NA,Karachay-Cherkessia,466305,25,0,4139,0
2020-07-17,Russia,NA,Karachay-Cherkessia,466305,28,0,4167,0
2020-07-18,Russia,NA,Karachay-Cherkessia,466305,23,0,4190,0
2020-07-19,Russia,NA,Karachay-Cherkessia,466305,27,0,4217,0
2020-07-20,Russia,NA,Karachay-Cherkessia,466305,22,0,4239,0
2020-07-21,Russia,NA,Karachay-Cherkessia,466305,25,0,4264,0
2020-07-22,Russia,NA,Karachay-Cherkessia,466305,24,0,4288,0
2020-07-23,Russia,NA,Karachay-Cherkessia,466305,27,0,4315,0
2020-07-24,Russia,NA,Karachay-Cherkessia,466305,23,0,4338,0
2020-07-25,Russia,NA,Karachay-Cherkessia,466305,21,0,4359,0
2020-07-26,Russia,NA,Karachay-Cherkessia,466305,24,0,4383,0
2020-07-27,Russia,NA,Karachay-Cherkessia,466305,19,0,4402,0
2020-07-28,Russia,NA,Karachay-Cherkessia,466305,18,0,4420,0
2020-07-29,Russia,NA,Karachay-Cherkessia,466305,8,0,4428,0
2020-07-30,Russia,NA,Karachay-Cherkessia,466305,10,0,4438,0
2020-07-31,Russia,NA,Karachay-Cherkessia,466305,9,0,4447,0
2020-08-01,Russia,NA,Karachay-Cherkessia,466305,11,0,4458,0
2020-08-02,Russia,NA,Karachay-Cherkessia,466305,12,0,4470,0
2020-08-26,Russia,NA,Karachay-Cherkessia,466305,0,0,4898,26
2020-08-27,Russia,NA,Karachay-Cherkessia,466305,39,0,4937,26
2020-08-28,Russia,NA,Karachay-Cherkessia,466305,39,0,4976,26
2020-08-29,Russia,NA,Karachay-Cherkessia,466305,45,0,5021,26
2020-08-30,Russia,NA,Karachay-Cherkessia,466305,45,0,5066,26
2020-08-31,Russia,NA,Karachay-Cherkessia,466305,49,0,5115,26
2020-09-01,Russia,NA,Karachay-Cherkessia,466305,48,0,5163,26
2020-09-02,Russia,NA,Karachay-Cherkessia,466305,53,0,5216,26
2020-09-03,Russia,NA,Karachay-Cherkessia,466305,56,0,5272,26
2020-09-04,Russia,NA,Karachay-Cherkessia,466305,63,2,5335,28
2020-09-05,Russia,NA,Karachay-Cherkessia,466305,64,0,5399,28
2020-09-06,Russia,NA,Karachay-Cherkessia,466305,59,0,5458,28
2020-09-07,Russia,NA,Karachay-Cherkessia,466305,65,0,5523,28
2020-09-08,Russia,NA,Karachay-Cherkessia,466305,63,0,5586,28
2020-09-09,Russia,NA,Karachay-Cherkessia,466305,65,0,5651,28
2020-09-10,Russia,NA,Karachay-Cherkessia,466305,64,0,5715,28
2020-09-11,Russia,NA,Karachay-Cherkessia,466305,62,0,5777,28
2020-09-12,Russia,NA,Karachay-Cherkessia,466305,63,0,5840,28
2020-09-13,Russia,NA,Karachay-Cherkessia,466305,59,0,5899,28
2020-09-14,Russia,NA,Karachay-Cherkessia,466305,63,0,5962,28
2020-09-15,Russia,NA,Karachay-Cherkessia,466305,65,0,6027,28
2020-09-16,Russia,NA,Karachay-Cherkessia,466305,66,0,6093,28
2020-09-17,Russia,NA,Karachay-Cherkessia,466305,65,0,6158,28
2020-09-18,Russia,NA,Karachay-Cherkessia,466305,63,0,6221,28
2020-09-19,Russia,NA,Karachay-Cherkessia,466305,64,0,6285,28
2020-09-20,Russia,NA,Karachay-Cherkessia,466305,66,0,6351,28
2020-09-21,Russia,NA,Karachay-Cherkessia,466305,65,0,6416,28
2020-09-22,Russia,NA,Karachay-Cherkessia,466305,66,0,6482,28
2020-09-23,Russia,NA,Karachay-Cherkessia,466305,64,0,6546,28
2020-04-10,Russia,NA,Kemerovo Oblast,2694877,4,0,11,0
2020-04-11,Russia,NA,Kemerovo Oblast,2694877,1,0,12,0
2020-04-13,Russia,NA,Kemerovo Oblast,2694877,2,0,14,0
2020-04-15,Russia,NA,Kemerovo Oblast,2694877,1,0,15,0
2020-04-16,Russia,NA,Kemerovo Oblast,2694877,3,0,18,0
2020-04-17,Russia,NA,Kemerovo Oblast,2694877,4,0,22,0
2020-04-18,Russia,NA,Kemerovo Oblast,2694877,4,0,26,0
2020-04-19,Russia,NA,Kemerovo Oblast,2694877,9,0,35,0
2020-04-20,Russia,NA,Kemerovo Oblast,2694877,6,0,41,0
2020-04-21,Russia,NA,Kemerovo Oblast,2694877,6,0,47,0
2020-04-22,Russia,NA,Kemerovo Oblast,2694877,9,0,56,0
2020-04-23,Russia,NA,Kemerovo Oblast,2694877,11,0,67,0
2020-04-24,Russia,NA,Kemerovo Oblast,2694877,9,0,76,0
2020-04-25,Russia,NA,Kemerovo Oblast,2694877,6,0,82,0
2020-04-26,Russia,NA,Kemerovo Oblast,2694877,21,0,103,0
2020-04-27,Russia,NA,Kemerovo Oblast,2694877,4,0,107,0
2020-04-28,Russia,NA,Kemerovo Oblast,2694877,4,0,111,0
2020-04-29,Russia,NA,Kemerovo Oblast,2694877,3,0,114,0
2020-04-30,Russia,NA,Kemerovo Oblast,2694877,12,0,126,0
2020-05-01,Russia,NA,Kemerovo Oblast,2694877,2,0,128,0
2020-05-02,Russia,NA,Kemerovo Oblast,2694877,14,0,142,0
2020-05-03,Russia,NA,Kemerovo Oblast,2694877,11,0,153,0
2020-05-04,Russia,NA,Kemerovo Oblast,2694877,13,0,166,0
2020-05-06,Russia,NA,Kemerovo Oblast,2694877,14,0,180,0
2020-05-07,Russia,NA,Kemerovo Oblast,2694877,18,0,198,0
2020-05-08,Russia,NA,Kemerovo Oblast,2694877,6,0,204,0
2020-05-09,Russia,NA,Kemerovo Oblast,2694877,10,0,214,0
2020-05-10,Russia,NA,Kemerovo Oblast,2694877,19,0,233,0
2020-05-11,Russia,NA,Kemerovo Oblast,2694877,18,0,251,0
2020-05-12,Russia,NA,Kemerovo Oblast,2694877,9,0,260,0
2020-05-13,Russia,NA,Kemerovo Oblast,2694877,9,0,269,0
2020-05-14,Russia,NA,Kemerovo Oblast,2694877,13,0,282,0
2020-05-15,Russia,NA,Kemerovo Oblast,2694877,14,0,296,0
2020-05-16,Russia,NA,Kemerovo Oblast,2694877,11,0,307,0
2020-05-17,Russia,NA,Kemerovo Oblast,2694877,14,0,321,0
2020-05-18,Russia,NA,Kemerovo Oblast,2694877,7,0,328,0
2020-05-19,Russia,NA,Kemerovo Oblast,2694877,5,0,333,0
2020-05-20,Russia,NA,Kemerovo Oblast,2694877,9,0,342,0
2020-05-21,Russia,NA,Kemerovo Oblast,2694877,23,0,365,0
2020-05-22,Russia,NA,Kemerovo Oblast,2694877,12,0,377,0
2020-05-23,Russia,NA,Kemerovo Oblast,2694877,14,0,391,0
2020-05-24,Russia,NA,Kemerovo Oblast,2694877,15,0,406,0
2020-05-25,Russia,NA,Kemerovo Oblast,2694877,12,0,418,0
2020-05-26,Russia,NA,Kemerovo Oblast,2694877,13,0,431,0
2020-05-27,Russia,NA,Kemerovo Oblast,2694877,13,0,444,0
2020-05-28,Russia,NA,Kemerovo Oblast,2694877,18,0,462,0
2020-05-29,Russia,NA,Kemerovo Oblast,2694877,20,0,482,0
2020-05-30,Russia,NA,Kemerovo Oblast,2694877,13,0,495,0
2020-05-31,Russia,NA,Kemerovo Oblast,2694877,25,0,520,0
2020-06-01,Russia,NA,Kemerovo Oblast,2694877,25,0,545,0
2020-06-02,Russia,NA,Kemerovo Oblast,2694877,44,0,589,0
2020-06-03,Russia,NA,Kemerovo Oblast,2694877,27,0,616,0
2020-06-04,Russia,NA,Kemerovo Oblast,2694877,22,0,638,0
2020-06-05,Russia,NA,Kemerovo Oblast,2694877,28,0,666,0
2020-06-06,Russia,NA,Kemerovo Oblast,2694877,19,0,685,0
2020-06-07,Russia,NA,Kemerovo Oblast,2694877,36,0,721,0
2020-06-08,Russia,NA,Kemerovo Oblast,2694877,31,0,752,0
2020-06-09,Russia,NA,Kemerovo Oblast,2694877,34,0,786,0
2020-06-10,Russia,NA,Kemerovo Oblast,2694877,48,0,834,0
2020-06-11,Russia,NA,Kemerovo Oblast,2694877,34,0,868,0
2020-06-12,Russia,NA,Kemerovo Oblast,2694877,61,0,929,0
2020-06-13,Russia,NA,Kemerovo Oblast,2694877,68,0,997,0
2020-06-14,Russia,NA,Kemerovo Oblast,2694877,22,0,1019,0
2020-06-15,Russia,NA,Kemerovo Oblast,2694877,23,0,1042,0
2020-06-16,Russia,NA,Kemerovo Oblast,2694877,20,0,1062,0
2020-06-17,Russia,NA,Kemerovo Oblast,2694877,17,0,1079,0
2020-06-18,Russia,NA,Kemerovo Oblast,2694877,20,0,1099,0
2020-06-19,Russia,NA,Kemerovo Oblast,2694877,58,0,1157,0
2020-06-20,Russia,NA,Kemerovo Oblast,2694877,61,0,1218,0
2020-06-21,Russia,NA,Kemerovo Oblast,2694877,59,0,1277,0
2020-06-22,Russia,NA,Kemerovo Oblast,2694877,75,0,1352,0
2020-06-23,Russia,NA,Kemerovo Oblast,2694877,44,0,1396,0
2020-06-24,Russia,NA,Kemerovo Oblast,2694877,28,0,1424,0
2020-06-25,Russia,NA,Kemerovo Oblast,2694877,30,0,1454,0
2020-06-26,Russia,NA,Kemerovo Oblast,2694877,34,0,1488,0
2020-06-27,Russia,NA,Kemerovo Oblast,2694877,44,0,1532,0
2020-06-28,Russia,NA,Kemerovo Oblast,2694877,47,0,1579,0
2020-06-29,Russia,NA,Kemerovo Oblast,2694877,43,0,1622,0
2020-06-30,Russia,NA,Kemerovo Oblast,2694877,40,0,1662,0
2020-07-01,Russia,NA,Kemerovo Oblast,2694877,41,0,1703,0
2020-07-02,Russia,NA,Kemerovo Oblast,2694877,41,0,1744,0
2020-07-03,Russia,NA,Kemerovo Oblast,2694877,62,0,1806,0
2020-07-04,Russia,NA,Kemerovo Oblast,2694877,67,0,1873,0
2020-07-05,Russia,NA,Kemerovo Oblast,2694877,71,0,1944,0
2020-07-06,Russia,NA,Kemerovo Oblast,2694877,74,0,2018,0
2020-07-07,Russia,NA,Kemerovo Oblast,2694877,67,0,2085,0
2020-07-08,Russia,NA,Kemerovo Oblast,2694877,49,0,2134,0
2020-07-09,Russia,NA,Kemerovo Oblast,2694877,69,0,2203,0
2020-07-10,Russia,NA,Kemerovo Oblast,2694877,77,0,2280,0
2020-07-11,Russia,NA,Kemerovo Oblast,2694877,74,0,2354,0
2020-07-12,Russia,NA,Kemerovo Oblast,2694877,52,0,2406,0
2020-07-13,Russia,NA,Kemerovo Oblast,2694877,51,0,2457,0
2020-07-14,Russia,NA,Kemerovo Oblast,2694877,50,0,2507,0
2020-07-15,Russia,NA,Kemerovo Oblast,2694877,46,0,2553,0
2020-07-16,Russia,NA,Kemerovo Oblast,2694877,49,0,2602,0
2020-07-17,Russia,NA,Kemerovo Oblast,2694877,48,0,2650,0
2020-07-18,Russia,NA,Kemerovo Oblast,2694877,45,0,2695,0
2020-07-19,Russia,NA,Kemerovo Oblast,2694877,45,0,2740,0
2020-07-20,Russia,NA,Kemerovo Oblast,2694877,56,0,2796,0
2020-07-21,Russia,NA,Kemerovo Oblast,2694877,61,0,2857,0
2020-07-22,Russia,NA,Kemerovo Oblast,2694877,62,0,2919,0
2020-07-23,Russia,NA,Kemerovo Oblast,2694877,64,0,2983,0
2020-07-24,Russia,NA,Kemerovo Oblast,2694877,67,0,3050,0
2020-07-25,Russia,NA,Kemerovo Oblast,2694877,68,0,3118,0
2020-07-26,Russia,NA,Kemerovo Oblast,2694877,75,0,3193,0
2020-07-27,Russia,NA,Kemerovo Oblast,2694877,67,0,3260,0
2020-07-28,Russia,NA,Kemerovo Oblast,2694877,69,0,3329,0
2020-07-29,Russia,NA,Kemerovo Oblast,2694877,79,0,3408,0
2020-07-30,Russia,NA,Kemerovo Oblast,2694877,73,0,3481,0
2020-07-31,Russia,NA,Kemerovo Oblast,2694877,74,0,3555,0
2020-08-01,Russia,NA,Kemerovo Oblast,2694877,72,0,3627,0
2020-08-02,Russia,NA,Kemerovo Oblast,2694877,75,0,3702,0
2020-08-26,Russia,NA,Kemerovo Oblast,2694877,0,0,5962,30
2020-08-27,Russia,NA,Kemerovo Oblast,2694877,98,5,6060,35
2020-08-28,Russia,NA,Kemerovo Oblast,2694877,96,6,6156,41
2020-08-29,Russia,NA,Kemerovo Oblast,2694877,93,3,6249,44
2020-08-30,Russia,NA,Kemerovo Oblast,2694877,96,0,6345,44
2020-08-31,Russia,NA,Kemerovo Oblast,2694877,92,0,6437,44
2020-09-01,Russia,NA,Kemerovo Oblast,2694877,90,1,6527,45
2020-09-02,Russia,NA,Kemerovo Oblast,2694877,88,0,6615,45
2020-09-03,Russia,NA,Kemerovo Oblast,2694877,86,0,6701,45
2020-09-04,Russia,NA,Kemerovo Oblast,2694877,90,2,6791,47
2020-09-05,Russia,NA,Kemerovo Oblast,2694877,89,1,6880,48
2020-09-06,Russia,NA,Kemerovo Oblast,2694877,85,0,6965,48
2020-09-07,Russia,NA,Kemerovo Oblast,2694877,83,0,7048,48
2020-09-08,Russia,NA,Kemerovo Oblast,2694877,85,1,7133,49
2020-09-09,Russia,NA,Kemerovo Oblast,2694877,84,0,7217,49
2020-09-10,Russia,NA,Kemerovo Oblast,2694877,87,0,7304,49
2020-09-11,Russia,NA,Kemerovo Oblast,2694877,95,0,7399,49
2020-09-12,Russia,NA,Kemerovo Oblast,2694877,93,1,7492,50
2020-09-13,Russia,NA,Kemerovo Oblast,2694877,97,0,7589,50
2020-09-14,Russia,NA,Kemerovo Oblast,2694877,105,0,7694,50
2020-09-15,Russia,NA,Kemerovo Oblast,2694877,115,5,7809,55
2020-09-16,Russia,NA,Kemerovo Oblast,2694877,126,0,7935,55
2020-09-17,Russia,NA,Kemerovo Oblast,2694877,125,1,8060,56
2020-09-18,Russia,NA,Kemerovo Oblast,2694877,128,11,8188,67
2020-09-19,Russia,NA,Kemerovo Oblast,2694877,135,0,8323,67
2020-09-20,Russia,NA,Kemerovo Oblast,2694877,127,0,8450,67
2020-09-21,Russia,NA,Kemerovo Oblast,2694877,130,0,8580,67
2020-09-22,Russia,NA,Kemerovo Oblast,2694877,124,1,8704,68
2020-09-23,Russia,NA,Kemerovo Oblast,2694877,125,7,8829,75
2020-04-05,Russia,NA,Khabarovsk Krai,1328302,1,0,11,0
2020-04-07,Russia,NA,Khabarovsk Krai,1328302,5,0,16,0
2020-04-08,Russia,NA,Khabarovsk Krai,1328302,8,0,24,0
2020-04-10,Russia,NA,Khabarovsk Krai,1328302,4,0,28,0
2020-04-11,Russia,NA,Khabarovsk Krai,1328302,1,0,29,0
2020-04-12,Russia,NA,Khabarovsk Krai,1328302,11,0,40,0
2020-04-13,Russia,NA,Khabarovsk Krai,1328302,14,0,54,0
2020-04-15,Russia,NA,Khabarovsk Krai,1328302,23,0,77,0
2020-04-16,Russia,NA,Khabarovsk Krai,1328302,14,0,91,0
2020-04-17,Russia,NA,Khabarovsk Krai,1328302,18,0,109,0
2020-04-18,Russia,NA,Khabarovsk Krai,1328302,38,0,147,0
2020-04-19,Russia,NA,Khabarovsk Krai,1328302,38,0,185,0
2020-04-20,Russia,NA,Khabarovsk Krai,1328302,30,0,215,0
2020-04-21,Russia,NA,Khabarovsk Krai,1328302,28,0,243,0
2020-04-22,Russia,NA,Khabarovsk Krai,1328302,29,0,272,0
2020-04-23,Russia,NA,Khabarovsk Krai,1328302,38,0,310,0
2020-04-24,Russia,NA,Khabarovsk Krai,1328302,41,0,351,0
2020-04-25,Russia,NA,Khabarovsk Krai,1328302,28,0,379,0
2020-04-26,Russia,NA,Khabarovsk Krai,1328302,27,0,406,0
2020-04-27,Russia,NA,Khabarovsk Krai,1328302,33,0,439,0
2020-04-28,Russia,NA,Khabarovsk Krai,1328302,28,0,467,0
2020-04-29,Russia,NA,Khabarovsk Krai,1328302,31,0,498,0
2020-04-30,Russia,NA,Khabarovsk Krai,1328302,38,0,536,0
2020-05-01,Russia,NA,Khabarovsk Krai,1328302,30,0,566,0
2020-05-02,Russia,NA,Khabarovsk Krai,1328302,29,0,595,0
2020-05-03,Russia,NA,Khabarovsk Krai,1328302,34,0,629,0
2020-05-04,Russia,NA,Khabarovsk Krai,1328302,39,0,668,0
2020-05-05,Russia,NA,Khabarovsk Krai,1328302,31,0,699,0
2020-05-06,Russia,NA,Khabarovsk Krai,1328302,39,0,738,0
2020-05-07,Russia,NA,Khabarovsk Krai,1328302,43,0,781,0
2020-05-08,Russia,NA,Khabarovsk Krai,1328302,40,0,821,0
2020-05-09,Russia,NA,Khabarovsk Krai,1328302,41,0,862,0
2020-05-10,Russia,NA,Khabarovsk Krai,1328302,34,0,896,0
2020-05-11,Russia,NA,Khabarovsk Krai,1328302,39,0,935,0
2020-05-12,Russia,NA,Khabarovsk Krai,1328302,42,0,977,0
2020-05-13,Russia,NA,Khabarovsk Krai,1328302,46,0,1023,0
2020-05-14,Russia,NA,Khabarovsk Krai,1328302,51,0,1074,0
2020-05-15,Russia,NA,Khabarovsk Krai,1328302,52,0,1126,0
2020-05-16,Russia,NA,Khabarovsk Krai,1328302,50,0,1176,0
2020-05-17,Russia,NA,Khabarovsk Krai,1328302,47,0,1223,0
2020-05-18,Russia,NA,Khabarovsk Krai,1328302,50,0,1273,0
2020-05-19,Russia,NA,Khabarovsk Krai,1328302,52,0,1325,0
2020-05-20,Russia,NA,Khabarovsk Krai,1328302,55,0,1380,0
2020-05-21,Russia,NA,Khabarovsk Krai,1328302,64,0,1444,0
2020-05-22,Russia,NA,Khabarovsk Krai,1328302,65,0,1509,0
2020-05-23,Russia,NA,Khabarovsk Krai,1328302,63,0,1572,0
2020-05-24,Russia,NA,Khabarovsk Krai,1328302,61,0,1633,0
2020-05-25,Russia,NA,Khabarovsk Krai,1328302,65,0,1698,0
2020-05-26,Russia,NA,Khabarovsk Krai,1328302,62,0,1760,0
2020-05-27,Russia,NA,Khabarovsk Krai,1328302,67,0,1827,0
2020-05-28,Russia,NA,Khabarovsk Krai,1328302,63,0,1890,0
2020-05-29,Russia,NA,Khabarovsk Krai,1328302,69,0,1959,0
2020-05-30,Russia,NA,Khabarovsk Krai,1328302,59,0,2018,0
2020-05-31,Russia,NA,Khabarovsk Krai,1328302,63,0,2081,0
2020-06-01,Russia,NA,Khabarovsk Krai,1328302,61,0,2142,0
2020-06-02,Russia,NA,Khabarovsk Krai,1328302,67,0,2209,0
2020-06-03,Russia,NA,Khabarovsk Krai,1328302,64,0,2273,0
2020-06-04,Russia,NA,Khabarovsk Krai,1328302,60,0,2333,0
2020-06-05,Russia,NA,Khabarovsk Krai,1328302,65,0,2398,0
2020-06-06,Russia,NA,Khabarovsk Krai,1328302,70,0,2468,0
2020-06-07,Russia,NA,Khabarovsk Krai,1328302,69,0,2537,0
2020-06-08,Russia,NA,Khabarovsk Krai,1328302,59,0,2596,0
2020-06-09,Russia,NA,Khabarovsk Krai,1328302,65,0,2661,0
2020-06-10,Russia,NA,Khabarovsk Krai,1328302,72,0,2733,0
2020-06-11,Russia,NA,Khabarovsk Krai,1328302,71,0,2804,0
2020-06-12,Russia,NA,Khabarovsk Krai,1328302,65,0,2869,0
2020-06-13,Russia,NA,Khabarovsk Krai,1328302,69,0,2938,0
2020-06-14,Russia,NA,Khabarovsk Krai,1328302,71,0,3009,0
2020-06-15,Russia,NA,Khabarovsk Krai,1328302,74,0,3083,0
2020-06-16,Russia,NA,Khabarovsk Krai,1328302,70,0,3153,0
2020-06-17,Russia,NA,Khabarovsk Krai,1328302,73,0,3226,0
2020-06-18,Russia,NA,Khabarovsk Krai,1328302,68,0,3294,0
2020-06-19,Russia,NA,Khabarovsk Krai,1328302,78,0,3372,0
2020-06-20,Russia,NA,Khabarovsk Krai,1328302,75,0,3447,0
2020-06-21,Russia,NA,Khabarovsk Krai,1328302,77,0,3524,0
2020-06-22,Russia,NA,Khabarovsk Krai,1328302,66,0,3590,0
2020-06-23,Russia,NA,Khabarovsk Krai,1328302,79,0,3669,0
2020-06-24,Russia,NA,Khabarovsk Krai,1328302,83,0,3752,0
2020-06-25,Russia,NA,Khabarovsk Krai,1328302,72,0,3824,0
2020-06-26,Russia,NA,Khabarovsk Krai,1328302,75,0,3899,0
2020-06-27,Russia,NA,Khabarovsk Krai,1328302,79,0,3978,0
2020-06-28,Russia,NA,Khabarovsk Krai,1328302,85,0,4063,0
2020-06-29,Russia,NA,Khabarovsk Krai,1328302,77,0,4140,0
2020-06-30,Russia,NA,Khabarovsk Krai,1328302,81,0,4221,0
2020-07-01,Russia,NA,Khabarovsk Krai,1328302,79,0,4300,0
2020-07-02,Russia,NA,Khabarovsk Krai,1328302,86,0,4386,0
2020-07-03,Russia,NA,Khabarovsk Krai,1328302,95,0,4481,0
2020-07-04,Russia,NA,Khabarovsk Krai,1328302,74,0,4555,0
2020-07-05,Russia,NA,Khabarovsk Krai,1328302,89,0,4644,0
2020-07-06,Russia,NA,Khabarovsk Krai,1328302,82,0,4726,0
2020-07-07,Russia,NA,Khabarovsk Krai,1328302,94,0,4820,0
2020-07-08,Russia,NA,Khabarovsk Krai,1328302,98,0,4918,0
2020-07-09,Russia,NA,Khabarovsk Krai,1328302,96,0,5014,0
2020-07-10,Russia,NA,Khabarovsk Krai,1328302,100,0,5114,0
2020-07-11,Russia,NA,Khabarovsk Krai,1328302,103,0,5217,0
2020-07-12,Russia,NA,Khabarovsk Krai,1328302,94,0,5311,0
2020-07-13,Russia,NA,Khabarovsk Krai,1328302,121,0,5432,0
2020-07-14,Russia,NA,Khabarovsk Krai,1328302,107,0,5539,0
2020-07-15,Russia,NA,Khabarovsk Krai,1328302,98,0,5637,0
2020-07-16,Russia,NA,Khabarovsk Krai,1328302,117,0,5754,0
2020-07-17,Russia,NA,Khabarovsk Krai,1328302,119,0,5873,0
2020-07-18,Russia,NA,Khabarovsk Krai,1328302,113,0,5986,0
2020-07-19,Russia,NA,Khabarovsk Krai,1328302,102,0,6088,0
2020-07-20,Russia,NA,Khabarovsk Krai,1328302,120,0,6208,0
2020-07-21,Russia,NA,Khabarovsk Krai,1328302,126,0,6334,0
2020-07-22,Russia,NA,Khabarovsk Krai,1328302,123,0,6457,0
2020-07-23,Russia,NA,Khabarovsk Krai,1328302,127,0,6584,0
2020-07-24,Russia,NA,Khabarovsk Krai,1328302,130,0,6714,0
2020-07-25,Russia,NA,Khabarovsk Krai,1328302,137,0,6851,0
2020-07-26,Russia,NA,Khabarovsk Krai,1328302,122,0,6973,0
2020-07-27,Russia,NA,Khabarovsk Krai,1328302,118,0,7091,0
2020-07-28,Russia,NA,Khabarovsk Krai,1328302,101,0,7192,0
2020-07-29,Russia,NA,Khabarovsk Krai,1328302,120,0,7312,0
2020-07-30,Russia,NA,Khabarovsk Krai,1328302,116,0,7428,0
2020-07-31,Russia,NA,Khabarovsk Krai,1328302,112,0,7540,0
2020-08-01,Russia,NA,Khabarovsk Krai,1328302,110,0,7650,0
2020-08-02,Russia,NA,Khabarovsk Krai,1328302,109,0,7759,0
2020-08-26,Russia,NA,Khabarovsk Krai,1328302,0,0,9795,85
2020-08-27,Russia,NA,Khabarovsk Krai,1328302,65,1,9860,86
2020-08-28,Russia,NA,Khabarovsk Krai,1328302,50,1,9910,87
2020-08-29,Russia,NA,Khabarovsk Krai,1328302,62,0,9972,87
2020-08-30,Russia,NA,Khabarovsk Krai,1328302,61,2,10033,89
2020-08-31,Russia,NA,Khabarovsk Krai,1328302,68,1,10101,90
2020-09-01,Russia,NA,Khabarovsk Krai,1328302,49,1,10150,91
2020-09-02,Russia,NA,Khabarovsk Krai,1328302,86,1,10236,92
2020-09-03,Russia,NA,Khabarovsk Krai,1328302,73,1,10309,93
2020-09-04,Russia,NA,Khabarovsk Krai,1328302,60,0,10369,93
2020-09-05,Russia,NA,Khabarovsk Krai,1328302,50,0,10419,93
2020-09-06,Russia,NA,Khabarovsk Krai,1328302,53,0,10472,93
2020-09-07,Russia,NA,Khabarovsk Krai,1328302,47,0,10519,93
2020-09-08,Russia,NA,Khabarovsk Krai,1328302,57,1,10576,94
2020-09-09,Russia,NA,Khabarovsk Krai,1328302,62,0,10638,94
2020-09-10,Russia,NA,Khabarovsk Krai,1328302,67,1,10705,95
2020-09-11,Russia,NA,Khabarovsk Krai,1328302,77,0,10782,95
2020-09-12,Russia,NA,Khabarovsk Krai,1328302,72,0,10854,95
2020-09-13,Russia,NA,Khabarovsk Krai,1328302,69,0,10923,95
2020-09-14,Russia,NA,Khabarovsk Krai,1328302,70,1,10993,96
2020-09-15,Russia,NA,Khabarovsk Krai,1328302,66,1,11059,97
2020-09-16,Russia,NA,Khabarovsk Krai,1328302,67,2,11126,99
2020-09-17,Russia,NA,Khabarovsk Krai,1328302,61,2,11187,101
2020-09-18,Russia,NA,Khabarovsk Krai,1328302,68,0,11255,101
2020-09-19,Russia,NA,Khabarovsk Krai,1328302,70,0,11325,101
2020-09-20,Russia,NA,Khabarovsk Krai,1328302,67,0,11392,101
2020-09-21,Russia,NA,Khabarovsk Krai,1328302,66,0,11458,101
2020-09-22,Russia,NA,Khabarovsk Krai,1328302,61,1,11519,102
2020-09-23,Russia,NA,Khabarovsk Krai,1328302,72,0,11591,102
2020-04-11,Russia,NA,Khakassia,537513,3,0,12,0
2020-04-14,Russia,NA,Khakassia,537513,8,0,20,0
2020-04-15,Russia,NA,Khakassia,537513,6,0,26,0
2020-04-16,Russia,NA,Khakassia,537513,1,0,27,0
2020-04-17,Russia,NA,Khakassia,537513,11,0,38,0
2020-04-18,Russia,NA,Khakassia,537513,8,0,46,0
2020-04-19,Russia,NA,Khakassia,537513,22,0,68,0
2020-04-20,Russia,NA,Khakassia,537513,8,0,76,0
2020-04-21,Russia,NA,Khakassia,537513,8,0,84,0
2020-04-22,Russia,NA,Khakassia,537513,3,0,87,0
2020-04-23,Russia,NA,Khakassia,537513,12,0,99,0
2020-04-24,Russia,NA,Khakassia,537513,3,0,102,0
2020-04-25,Russia,NA,Khakassia,537513,49,0,151,0
2020-04-26,Russia,NA,Khakassia,537513,25,0,176,0
2020-04-27,Russia,NA,Khakassia,537513,8,0,184,0
2020-04-28,Russia,NA,Khakassia,537513,22,0,206,0
2020-04-29,Russia,NA,Khakassia,537513,22,0,228,0
2020-04-30,Russia,NA,Khakassia,537513,4,0,232,0
2020-05-01,Russia,NA,Khakassia,537513,25,0,257,0
2020-05-02,Russia,NA,Khakassia,537513,9,0,266,0
2020-05-03,Russia,NA,Khakassia,537513,6,0,272,0
2020-05-04,Russia,NA,Khakassia,537513,30,0,302,0
2020-05-05,Russia,NA,Khakassia,537513,16,0,318,0
2020-05-06,Russia,NA,Khakassia,537513,22,0,340,0
2020-05-07,Russia,NA,Khakassia,537513,12,0,352,0
2020-05-08,Russia,NA,Khakassia,537513,15,0,367,0
2020-05-09,Russia,NA,Khakassia,537513,36,0,403,0
2020-05-10,Russia,NA,Khakassia,537513,22,0,425,0
2020-05-11,Russia,NA,Khakassia,537513,41,0,466,0
2020-05-12,Russia,NA,Khakassia,537513,37,0,503,0
2020-05-13,Russia,NA,Khakassia,537513,21,0,524,0
2020-05-14,Russia,NA,Khakassia,537513,8,0,532,0
2020-05-15,Russia,NA,Khakassia,537513,25,0,557,0
2020-05-16,Russia,NA,Khakassia,537513,38,0,595,0
2020-05-17,Russia,NA,Khakassia,537513,23,0,618,0
2020-05-18,Russia,NA,Khakassia,537513,24,0,642,0
2020-05-19,Russia,NA,Khakassia,537513,25,0,667,0
2020-05-20,Russia,NA,Khakassia,537513,28,0,695,0
2020-05-21,Russia,NA,Khakassia,537513,29,0,724,0
2020-05-22,Russia,NA,Khakassia,537513,23,0,747,0
2020-05-23,Russia,NA,Khakassia,537513,31,0,778,0
2020-05-24,Russia,NA,Khakassia,537513,11,0,789,0
2020-05-25,Russia,NA,Khakassia,537513,24,0,813,0
2020-05-26,Russia,NA,Khakassia,537513,23,0,836,0
2020-05-27,Russia,NA,Khakassia,537513,20,0,856,0
2020-05-28,Russia,NA,Khakassia,537513,22,0,878,0
2020-05-29,Russia,NA,Khakassia,537513,32,0,910,0
2020-05-30,Russia,NA,Khakassia,537513,30,0,940,0
2020-05-31,Russia,NA,Khakassia,537513,24,0,964,0
2020-06-01,Russia,NA,Khakassia,537513,21,0,985,0
2020-06-02,Russia,NA,Khakassia,537513,35,0,1020,0
2020-06-03,Russia,NA,Khakassia,537513,32,0,1052,0
2020-06-04,Russia,NA,Khakassia,537513,25,0,1077,0
2020-06-05,Russia,NA,Khakassia,537513,25,0,1102,0
2020-06-06,Russia,NA,Khakassia,537513,9,0,1111,0
2020-06-07,Russia,NA,Khakassia,537513,17,0,1128,0
2020-06-08,Russia,NA,Khakassia,537513,13,0,1141,0
2020-06-09,Russia,NA,Khakassia,537513,24,0,1165,0
2020-06-10,Russia,NA,Khakassia,537513,26,0,1191,0
2020-06-11,Russia,NA,Khakassia,537513,38,0,1229,0
2020-06-12,Russia,NA,Khakassia,537513,37,0,1266,0
2020-06-13,Russia,NA,Khakassia,537513,33,0,1299,0
2020-06-14,Russia,NA,Khakassia,537513,33,0,1332,0
2020-06-15,Russia,NA,Khakassia,537513,24,0,1356,0
2020-06-16,Russia,NA,Khakassia,537513,25,0,1381,0
2020-06-17,Russia,NA,Khakassia,537513,28,0,1409,0
2020-06-18,Russia,NA,Khakassia,537513,35,0,1444,0
2020-06-19,Russia,NA,Khakassia,537513,46,0,1490,0
2020-06-20,Russia,NA,Khakassia,537513,47,0,1537,0
2020-06-21,Russia,NA,Khakassia,537513,46,0,1583,0
2020-06-22,Russia,NA,Khakassia,537513,29,0,1612,0
2020-06-23,Russia,NA,Khakassia,537513,19,0,1631,0
2020-06-24,Russia,NA,Khakassia,537513,30,0,1661,0
2020-06-25,Russia,NA,Khakassia,537513,35,0,1696,0
2020-06-26,Russia,NA,Khakassia,537513,39,0,1735,0
2020-06-27,Russia,NA,Khakassia,537513,36,0,1771,0
2020-06-28,Russia,NA,Khakassia,537513,41,0,1812,0
2020-06-29,Russia,NA,Khakassia,537513,32,0,1844,0
2020-06-30,Russia,NA,Khakassia,537513,28,0,1872,0
2020-07-01,Russia,NA,Khakassia,537513,32,0,1904,0
2020-07-02,Russia,NA,Khakassia,537513,31,0,1935,0
2020-07-03,Russia,NA,Khakassia,537513,38,0,1973,0
2020-07-04,Russia,NA,Khakassia,537513,40,0,2013,0
2020-07-05,Russia,NA,Khakassia,537513,42,0,2055,0
2020-07-06,Russia,NA,Khakassia,537513,28,0,2083,0
2020-07-07,Russia,NA,Khakassia,537513,26,0,2109,0
2020-07-08,Russia,NA,Khakassia,537513,33,0,2142,0
2020-07-09,Russia,NA,Khakassia,537513,45,0,2187,0
2020-07-10,Russia,NA,Khakassia,537513,49,0,2236,0
2020-07-11,Russia,NA,Khakassia,537513,49,0,2285,0
2020-07-12,Russia,NA,Khakassia,537513,44,0,2329,0
2020-07-13,Russia,NA,Khakassia,537513,45,0,2374,0
2020-07-14,Russia,NA,Khakassia,537513,41,0,2415,0
2020-07-15,Russia,NA,Khakassia,537513,35,0,2450,0
2020-07-16,Russia,NA,Khakassia,537513,34,0,2484,0
2020-07-17,Russia,NA,Khakassia,537513,36,0,2520,0
2020-07-18,Russia,NA,Khakassia,537513,38,0,2558,0
2020-07-19,Russia,NA,Khakassia,537513,37,0,2595,0
2020-07-20,Russia,NA,Khakassia,537513,33,0,2628,0
2020-07-21,Russia,NA,Khakassia,537513,21,0,2649,0
2020-07-22,Russia,NA,Khakassia,537513,19,0,2668,0
2020-07-23,Russia,NA,Khakassia,537513,21,0,2689,0
2020-07-24,Russia,NA,Khakassia,537513,20,0,2709,0
2020-07-25,Russia,NA,Khakassia,537513,21,0,2730,0
2020-07-26,Russia,NA,Khakassia,537513,19,0,2749,0
2020-07-27,Russia,NA,Khakassia,537513,20,0,2769,0
2020-07-28,Russia,NA,Khakassia,537513,17,0,2786,0
2020-07-29,Russia,NA,Khakassia,537513,16,0,2802,0
2020-07-30,Russia,NA,Khakassia,537513,16,0,2818,0
2020-07-31,Russia,NA,Khakassia,537513,18,0,2836,0
2020-08-01,Russia,NA,Khakassia,537513,19,0,2855,0
2020-08-02,Russia,NA,Khakassia,537513,21,0,2876,0
2020-08-26,Russia,NA,Khakassia,537513,0,0,3326,39
2020-08-27,Russia,NA,Khakassia,537513,19,2,3345,41
2020-08-28,Russia,NA,Khakassia,537513,17,1,3362,42
2020-08-29,Russia,NA,Khakassia,537513,17,0,3379,42
2020-08-30,Russia,NA,Khakassia,537513,17,0,3396,42
2020-08-31,Russia,NA,Khakassia,537513,19,0,3415,42
2020-09-01,Russia,NA,Khakassia,537513,19,1,3434,43
2020-09-02,Russia,NA,Khakassia,537513,21,2,3455,45
2020-09-03,Russia,NA,Khakassia,537513,23,0,3478,45
2020-09-04,Russia,NA,Khakassia,537513,25,0,3503,45
2020-09-05,Russia,NA,Khakassia,537513,26,2,3529,47
2020-09-06,Russia,NA,Khakassia,537513,27,0,3556,47
2020-09-07,Russia,NA,Khakassia,537513,27,0,3583,47
2020-09-08,Russia,NA,Khakassia,537513,28,0,3611,47
2020-09-09,Russia,NA,Khakassia,537513,30,0,3641,47
2020-09-10,Russia,NA,Khakassia,537513,33,0,3674,47
2020-09-11,Russia,NA,Khakassia,537513,34,0,3708,47
2020-09-12,Russia,NA,Khakassia,537513,33,0,3741,47
2020-09-13,Russia,NA,Khakassia,537513,33,0,3774,47
2020-09-14,Russia,NA,Khakassia,537513,32,0,3806,47
2020-09-15,Russia,NA,Khakassia,537513,29,0,3835,47
2020-09-16,Russia,NA,Khakassia,537513,30,0,3865,47
2020-09-17,Russia,NA,Khakassia,537513,31,0,3896,47
2020-09-18,Russia,NA,Khakassia,537513,32,0,3928,47
2020-09-19,Russia,NA,Khakassia,537513,35,0,3963,47
2020-09-20,Russia,NA,Khakassia,537513,36,0,3999,47
2020-09-21,Russia,NA,Khakassia,537513,35,0,4034,47
2020-09-22,Russia,NA,Khakassia,537513,34,1,4068,48
2020-09-23,Russia,NA,Khakassia,537513,36,0,4104,48
2020-04-03,Russia,NA,Khanty-Mansi Avtonomnyy Okrug,1625501,8,0,16,0
2020-04-05,Russia,NA,Khanty-Mansi Avtonomnyy Okrug,1625501,3,0,19,0
2020-04-07,Russia,NA,Khanty-Mansi Avtonomnyy Okrug,1625501,19,0,38,0
2020-04-08,Russia,NA,Khanty-Mansi Avtonomnyy Okrug,1625501,3,0,41,0
2020-04-14,Russia,NA,Khanty-Mansi Avtonomnyy Okrug,1625501,15,0,56,0
2020-04-15,Russia,NA,Khanty-Mansi Avtonomnyy Okrug,1625501,15,0,71,0
2020-04-16,Russia,NA,Khanty-Mansi Avtonomnyy Okrug,1625501,39,0,110,0
2020-04-17,Russia,NA,Khanty-Mansi Avtonomnyy Okrug,1625501,18,0,128,0
2020-04-18,Russia,NA,Khanty-Mansi Avtonomnyy Okrug,1625501,33,0,161,0
2020-04-19,Russia,NA,Khanty-Mansi Avtonomnyy Okrug,1625501,14,0,175,0
2020-04-20,Russia,NA,Khanty-Mansi Avtonomnyy Okrug,1625501,13,0,188,0
2020-04-21,Russia,NA,Khanty-Mansi Avtonomnyy Okrug,1625501,9,0,197,0
2020-04-22,Russia,NA,Khanty-Mansi Avtonomnyy Okrug,1625501,6,0,203,0
2020-04-23,Russia,NA,Khanty-Mansi Avtonomnyy Okrug,1625501,12,0,215,0
2020-04-24,Russia,NA,Khanty-Mansi Avtonomnyy Okrug,1625501,2,0,217,0
2020-04-25,Russia,NA,Khanty-Mansi Avtonomnyy Okrug,1625501,16,0,233,0
2020-04-26,Russia,NA,Khanty-Mansi Avtonomnyy Okrug,1625501,41,0,274,0
2020-04-27,Russia,NA,Khanty-Mansi Avtonomnyy Okrug,1625501,23,0,297,0
2020-04-28,Russia,NA,Khanty-Mansi Avtonomnyy Okrug,1625501,41,0,338,0
2020-04-29,Russia,NA,Khanty-Mansi Avtonomnyy Okrug,1625501,28,0,366,0
2020-04-30,Russia,NA,Khanty-Mansi Avtonomnyy Okrug,1625501,21,0,387,0
2020-05-01,Russia,NA,Khanty-Mansi Avtonomnyy Okrug,1625501,18,0,405,0
2020-05-02,Russia,NA,Khanty-Mansi Avtonomnyy Okrug,1625501,9,0,414,0
2020-05-03,Russia,NA,Khanty-Mansi Avtonomnyy Okrug,1625501,35,0,449,0
2020-05-04,Russia,NA,Khanty-Mansi Avtonomnyy Okrug,1625501,18,0,467,0
2020-05-05,Russia,NA,Khanty-Mansi Avtonomnyy Okrug,1625501,41,0,508,0
2020-05-06,Russia,NA,Khanty-Mansi Avtonomnyy Okrug,1625501,29,0,537,0
2020-05-07,Russia,NA,Khanty-Mansi Avtonomnyy Okrug,1625501,14,0,551,0
2020-05-08,Russia,NA,Khanty-Mansi Avtonomnyy Okrug,1625501,32,0,583,0
2020-05-09,Russia,NA,Khanty-Mansi Avtonomnyy Okrug,1625501,43,0,626,0
2020-05-10,Russia,NA,Khanty-Mansi Avtonomnyy Okrug,1625501,67,0,693,0
2020-05-11,Russia,NA,Khanty-Mansi Avtonomnyy Okrug,1625501,84,0,777,0
2020-05-12,Russia,NA,Khanty-Mansi Avtonomnyy Okrug,1625501,45,0,822,0
2020-05-13,Russia,NA,Khanty-Mansi Avtonomnyy Okrug,1625501,43,0,865,0
2020-05-14,Russia,NA,Khanty-Mansi Avtonomnyy Okrug,1625501,61,0,926,0
2020-05-15,Russia,NA,Khanty-Mansi Avtonomnyy Okrug,1625501,39,0,965,0
2020-05-16,Russia,NA,Khanty-Mansi Avtonomnyy Okrug,1625501,83,0,1048,0
2020-05-17,Russia,NA,Khanty-Mansi Avtonomnyy Okrug,1625501,118,0,1166,0
2020-05-18,Russia,NA,Khanty-Mansi Avtonomnyy Okrug,1625501,86,0,1252,0
2020-05-19,Russia,NA,Khanty-Mansi Avtonomnyy Okrug,1625501,56,0,1308,0
2020-05-20,Russia,NA,Khanty-Mansi Avtonomnyy Okrug,1625501,63,0,1371,0
2020-05-21,Russia,NA,Khanty-Mansi Avtonomnyy Okrug,1625501,59,0,1430,0
2020-05-22,Russia,NA,Khanty-Mansi Avtonomnyy Okrug,1625501,80,0,1510,0
2020-05-23,Russia,NA,Khanty-Mansi Avtonomnyy Okrug,1625501,58,0,1568,0
2020-05-24,Russia,NA,Khanty-Mansi Avtonomnyy Okrug,1625501,102,0,1670,0
2020-05-25,Russia,NA,Khanty-Mansi Avtonomnyy Okrug,1625501,85,0,1755,0
2020-05-26,Russia,NA,Khanty-Mansi Avtonomnyy Okrug,1625501,94,0,1849,0
2020-05-27,Russia,NA,Khanty-Mansi Avtonomnyy Okrug,1625501,75,0,1924,0
2020-05-28,Russia,NA,Khanty-Mansi Avtonomnyy Okrug,1625501,104,0,2028,0
2020-05-29,Russia,NA,Khanty-Mansi Avtonomnyy Okrug,1625501,105,0,2133,0
2020-05-30,Russia,NA,Khanty-Mansi Avtonomnyy Okrug,1625501,167,0,2300,0
2020-05-31,Russia,NA,Khanty-Mansi Avtonomnyy Okrug,1625501,136,0,2436,0
2020-06-01,Russia,NA,Khanty-Mansi Avtonomnyy Okrug,1625501,151,0,2587,0
2020-06-02,Russia,NA,Khanty-Mansi Avtonomnyy Okrug,1625501,149,0,2736,0
2020-06-03,Russia,NA,Khanty-Mansi Avtonomnyy Okrug,1625501,111,0,2847,0
2020-06-04,Russia,NA,Khanty-Mansi Avtonomnyy Okrug,1625501,140,0,2987,0
2020-06-05,Russia,NA,Khanty-Mansi Avtonomnyy Okrug,1625501,117,0,3104,0
2020-06-06,Russia,NA,Khanty-Mansi Avtonomnyy Okrug,1625501,127,0,3231,0
2020-06-07,Russia,NA,Khanty-Mansi Avtonomnyy Okrug,1625501,115,0,3346,0
2020-06-08,Russia,NA,Khanty-Mansi Avtonomnyy Okrug,1625501,129,0,3475,0
2020-06-09,Russia,NA,Khanty-Mansi Avtonomnyy Okrug,1625501,149,0,3624,0
2020-06-10,Russia,NA,Khanty-Mansi Avtonomnyy Okrug,1625501,197,0,3821,0
2020-06-11,Russia,NA,Khanty-Mansi Avtonomnyy Okrug,1625501,186,0,4007,0
2020-06-12,Russia,NA,Khanty-Mansi Avtonomnyy Okrug,1625501,150,0,4157,0
2020-06-13,Russia,NA,Khanty-Mansi Avtonomnyy Okrug,1625501,183,0,4340,0
2020-06-14,Russia,NA,Khanty-Mansi Avtonomnyy Okrug,1625501,229,0,4569,0
2020-06-15,Russia,NA,Khanty-Mansi Avtonomnyy Okrug,1625501,184,0,4753,0
2020-06-16,Russia,NA,Khanty-Mansi Avtonomnyy Okrug,1625501,220,0,4973,0
2020-06-17,Russia,NA,Khanty-Mansi Avtonomnyy Okrug,1625501,237,0,5210,0
2020-06-18,Russia,NA,Khanty-Mansi Avtonomnyy Okrug,1625501,243,0,5453,0
2020-06-19,Russia,NA,Khanty-Mansi Avtonomnyy Okrug,1625501,259,0,5712,0
2020-06-20,Russia,NA,Khanty-Mansi Avtonomnyy Okrug,1625501,280,0,5992,0
2020-06-21,Russia,NA,Khanty-Mansi Avtonomnyy Okrug,1625501,294,0,6286,0
2020-06-22,Russia,NA,Khanty-Mansi Avtonomnyy Okrug,1625501,295,0,6581,0
2020-06-23,Russia,NA,Khanty-Mansi Avtonomnyy Okrug,1625501,319,0,6900,0
2020-06-24,Russia,NA,Khanty-Mansi Avtonomnyy Okrug,1625501,323,0,7223,0
2020-06-25,Russia,NA,Khanty-Mansi Avtonomnyy Okrug,1625501,319,0,7542,0
2020-06-26,Russia,NA,Khanty-Mansi Avtonomnyy Okrug,1625501,295,0,7837,0
2020-06-27,Russia,NA,Khanty-Mansi Avtonomnyy Okrug,1625501,280,0,8117,0
2020-06-28,Russia,NA,Khanty-Mansi Avtonomnyy Okrug,1625501,285,0,8402,0
2020-06-29,Russia,NA,Khanty-Mansi Avtonomnyy Okrug,1625501,277,0,8679,0
2020-06-30,Russia,NA,Khanty-Mansi Avtonomnyy Okrug,1625501,279,0,8958,0
2020-07-01,Russia,NA,Khanty-Mansi Avtonomnyy Okrug,1625501,261,0,9219,0
2020-07-02,Russia,NA,Khanty-Mansi Avtonomnyy Okrug,1625501,266,0,9485,0
2020-07-03,Russia,NA,Khanty-Mansi Avtonomnyy Okrug,1625501,271,0,9756,0
2020-07-04,Russia,NA,Khanty-Mansi Avtonomnyy Okrug,1625501,273,0,10029,0
2020-07-05,Russia,NA,Khanty-Mansi Avtonomnyy Okrug,1625501,272,0,10301,0
2020-07-06,Russia,NA,Khanty-Mansi Avtonomnyy Okrug,1625501,289,0,10590,0
2020-07-07,Russia,NA,Khanty-Mansi Avtonomnyy Okrug,1625501,283,0,10873,0
2020-07-08,Russia,NA,Khanty-Mansi Avtonomnyy Okrug,1625501,268,0,11141,0
2020-07-09,Russia,NA,Khanty-Mansi Avtonomnyy Okrug,1625501,265,0,11406,0
2020-07-10,Russia,NA,Khanty-Mansi Avtonomnyy Okrug,1625501,263,0,11669,0
2020-07-11,Russia,NA,Khanty-Mansi Avtonomnyy Okrug,1625501,268,0,11937,0
2020-07-12,Russia,NA,Khanty-Mansi Avtonomnyy Okrug,1625501,267,0,12204,0
2020-07-13,Russia,NA,Khanty-Mansi Avtonomnyy Okrug,1625501,270,0,12474,0
2020-07-14,Russia,NA,Khanty-Mansi Avtonomnyy Okrug,1625501,268,0,12742,0
2020-07-15,Russia,NA,Khanty-Mansi Avtonomnyy Okrug,1625501,251,0,12993,0
2020-07-16,Russia,NA,Khanty-Mansi Avtonomnyy Okrug,1625501,252,0,13245,0
2020-07-17,Russia,NA,Khanty-Mansi Avtonomnyy Okrug,1625501,249,0,13494,0
2020-07-18,Russia,NA,Khanty-Mansi Avtonomnyy Okrug,1625501,247,0,13741,0
2020-07-19,Russia,NA,Khanty-Mansi Avtonomnyy Okrug,1625501,237,0,13978,0
2020-07-20,Russia,NA,Khanty-Mansi Avtonomnyy Okrug,1625501,236,0,14214,0
2020-07-21,Russia,NA,Khanty-Mansi Avtonomnyy Okrug,1625501,228,0,14442,0
2020-07-22,Russia,NA,Khanty-Mansi Avtonomnyy Okrug,1625501,221,0,14663,0
2020-07-23,Russia,NA,Khanty-Mansi Avtonomnyy Okrug,1625501,198,0,14861,0
2020-07-24,Russia,NA,Khanty-Mansi Avtonomnyy Okrug,1625501,196,0,15057,0
2020-07-25,Russia,NA,Khanty-Mansi Avtonomnyy Okrug,1625501,193,0,15250,0
2020-07-26,Russia,NA,Khanty-Mansi Avtonomnyy Okrug,1625501,192,0,15442,0
2020-07-27,Russia,NA,Khanty-Mansi Avtonomnyy Okrug,1625501,188,0,15630,0
2020-07-28,Russia,NA,Khanty-Mansi Avtonomnyy Okrug,1625501,187,0,15817,0
2020-07-29,Russia,NA,Khanty-Mansi Avtonomnyy Okrug,1625501,173,0,15990,0
2020-07-30,Russia,NA,Khanty-Mansi Avtonomnyy Okrug,1625501,172,0,16162,0
2020-07-31,Russia,NA,Khanty-Mansi Avtonomnyy Okrug,1625501,171,0,16333,0
2020-08-01,Russia,NA,Khanty-Mansi Avtonomnyy Okrug,1625501,170,0,16503,0
2020-08-02,Russia,NA,Khanty-Mansi Avtonomnyy Okrug,1625501,168,0,16671,0
2020-08-26,Russia,NA,Khanty-Mansi Avtonomnyy Okrug,1625501,0,0,19285,161
2020-08-27,Russia,NA,Khanty-Mansi Avtonomnyy Okrug,1625501,65,1,19350,162
2020-08-28,Russia,NA,Khanty-Mansi Avtonomnyy Okrug,1625501,64,1,19414,163
2020-08-29,Russia,NA,Khanty-Mansi Avtonomnyy Okrug,1625501,64,1,19478,164
2020-08-30,Russia,NA,Khanty-Mansi Avtonomnyy Okrug,1625501,65,1,19543,165
2020-08-31,Russia,NA,Khanty-Mansi Avtonomnyy Okrug,1625501,66,1,19609,166
2020-09-01,Russia,NA,Khanty-Mansi Avtonomnyy Okrug,1625501,67,1,19676,167
2020-09-02,Russia,NA,Khanty-Mansi Avtonomnyy Okrug,1625501,68,2,19744,169
2020-09-03,Russia,NA,Khanty-Mansi Avtonomnyy Okrug,1625501,72,1,19816,170
2020-09-04,Russia,NA,Khanty-Mansi Avtonomnyy Okrug,1625501,75,2,19891,172
2020-09-05,Russia,NA,Khanty-Mansi Avtonomnyy Okrug,1625501,76,2,19967,174
2020-09-06,Russia,NA,Khanty-Mansi Avtonomnyy Okrug,1625501,78,0,20045,174
2020-09-07,Russia,NA,Khanty-Mansi Avtonomnyy Okrug,1625501,76,1,20121,175
2020-09-08,Russia,NA,Khanty-Mansi Avtonomnyy Okrug,1625501,72,0,20193,175
2020-09-09,Russia,NA,Khanty-Mansi Avtonomnyy Okrug,1625501,77,1,20270,176
2020-09-10,Russia,NA,Khanty-Mansi Avtonomnyy Okrug,1625501,80,0,20350,176
2020-09-11,Russia,NA,Khanty-Mansi Avtonomnyy Okrug,1625501,80,1,20430,177
2020-09-12,Russia,NA,Khanty-Mansi Avtonomnyy Okrug,1625501,75,0,20505,177
2020-09-13,Russia,NA,Khanty-Mansi Avtonomnyy Okrug,1625501,78,0,20583,177
2020-09-14,Russia,NA,Khanty-Mansi Avtonomnyy Okrug,1625501,82,0,20665,177
2020-09-15,Russia,NA,Khanty-Mansi Avtonomnyy Okrug,1625501,83,1,20748,178
2020-09-16,Russia,NA,Khanty-Mansi Avtonomnyy Okrug,1625501,83,1,20831,179
2020-09-17,Russia,NA,Khanty-Mansi Avtonomnyy Okrug,1625501,76,0,20907,179
2020-09-18,Russia,NA,Khanty-Mansi Avtonomnyy Okrug,1625501,81,0,20988,179
2020-09-19,Russia,NA,Khanty-Mansi Avtonomnyy Okrug,1625501,89,0,21077,179
2020-09-20,Russia,NA,Khanty-Mansi Avtonomnyy Okrug,1625501,98,0,21175,179
2020-09-21,Russia,NA,Khanty-Mansi Avtonomnyy Okrug,1625501,98,2,21273,181
2020-09-22,Russia,NA,Khanty-Mansi Avtonomnyy Okrug,1625501,118,0,21391,181
2020-09-23,Russia,NA,Khanty-Mansi Avtonomnyy Okrug,1625501,125,1,21516,182
2020-03-30,Russia,NA,Kirov Oblast,1283238,3,0,12,0
2020-04-03,Russia,NA,Kirov Oblast,1283238,3,0,15,0
2020-04-04,Russia,NA,Kirov Oblast,1283238,3,0,18,0
2020-04-07,Russia,NA,Kirov Oblast,1283238,2,0,20,0
2020-04-09,Russia,NA,Kirov Oblast,1283238,8,0,28,0
2020-04-10,Russia,NA,Kirov Oblast,1283238,1,0,29,0
2020-04-11,Russia,NA,Kirov Oblast,1283238,6,0,35,0
2020-04-12,Russia,NA,Kirov Oblast,1283238,1,0,36,0
2020-04-13,Russia,NA,Kirov Oblast,1283238,15,0,51,0
2020-04-15,Russia,NA,Kirov Oblast,1283238,13,0,64,0
2020-04-16,Russia,NA,Kirov Oblast,1283238,9,0,73,0
2020-04-17,Russia,NA,Kirov Oblast,1283238,18,0,91,0
2020-04-18,Russia,NA,Kirov Oblast,1283238,20,0,111,0
2020-04-19,Russia,NA,Kirov Oblast,1283238,39,0,150,0
2020-04-20,Russia,NA,Kirov Oblast,1283238,19,0,169,0
2020-04-21,Russia,NA,Kirov Oblast,1283238,19,0,188,0
2020-04-22,Russia,NA,Kirov Oblast,1283238,28,0,216,0
2020-04-23,Russia,NA,Kirov Oblast,1283238,24,0,240,0
2020-04-24,Russia,NA,Kirov Oblast,1283238,36,0,276,0
2020-04-25,Russia,NA,Kirov Oblast,1283238,40,0,316,0
2020-04-26,Russia,NA,Kirov Oblast,1283238,46,0,362,0
2020-04-27,Russia,NA,Kirov Oblast,1283238,26,0,388,0
2020-04-28,Russia,NA,Kirov Oblast,1283238,35,0,423,0
2020-04-29,Russia,NA,Kirov Oblast,1283238,43,0,466,0
2020-04-30,Russia,NA,Kirov Oblast,1283238,27,0,493,0
2020-05-01,Russia,NA,Kirov Oblast,1283238,18,0,511,0
2020-05-02,Russia,NA,Kirov Oblast,1283238,32,0,543,0
2020-05-03,Russia,NA,Kirov Oblast,1283238,42,0,585,0
2020-05-04,Russia,NA,Kirov Oblast,1283238,33,0,618,0
2020-05-05,Russia,NA,Kirov Oblast,1283238,26,0,644,0
2020-05-06,Russia,NA,Kirov Oblast,1283238,17,0,661,0
2020-05-07,Russia,NA,Kirov Oblast,1283238,25,0,686,0
2020-05-08,Russia,NA,Kirov Oblast,1283238,32,0,718,0
2020-05-09,Russia,NA,Kirov Oblast,1283238,43,0,761,0
2020-05-10,Russia,NA,Kirov Oblast,1283238,46,0,807,0
2020-05-11,Russia,NA,Kirov Oblast,1283238,28,0,835,0
2020-05-12,Russia,NA,Kirov Oblast,1283238,41,0,876,0
2020-05-13,Russia,NA,Kirov Oblast,1283238,20,0,896,0
2020-05-14,Russia,NA,Kirov Oblast,1283238,15,0,911,0
2020-05-15,Russia,NA,Kirov Oblast,1283238,21,0,932,0
2020-05-16,Russia,NA,Kirov Oblast,1283238,35,0,967,0
2020-05-17,Russia,NA,Kirov Oblast,1283238,34,0,1001,0
2020-05-18,Russia,NA,Kirov Oblast,1283238,7,0,1008,0
2020-05-19,Russia,NA,Kirov Oblast,1283238,12,0,1020,0
2020-05-20,Russia,NA,Kirov Oblast,1283238,44,0,1064,0
2020-05-21,Russia,NA,Kirov Oblast,1283238,27,0,1091,0
2020-05-22,Russia,NA,Kirov Oblast,1283238,70,0,1161,0
2020-05-23,Russia,NA,Kirov Oblast,1283238,30,0,1191,0
2020-05-24,Russia,NA,Kirov Oblast,1283238,68,0,1259,0
2020-05-25,Russia,NA,Kirov Oblast,1283238,64,0,1323,0
2020-05-26,Russia,NA,Kirov Oblast,1283238,47,0,1370,0
2020-05-27,Russia,NA,Kirov Oblast,1283238,68,0,1438,0
2020-05-28,Russia,NA,Kirov Oblast,1283238,57,0,1495,0
2020-05-29,Russia,NA,Kirov Oblast,1283238,56,0,1551,0
2020-05-30,Russia,NA,Kirov Oblast,1283238,78,0,1629,0
2020-05-31,Russia,NA,Kirov Oblast,1283238,54,0,1683,0
2020-06-01,Russia,NA,Kirov Oblast,1283238,68,0,1751,0
2020-06-02,Russia,NA,Kirov Oblast,1283238,77,0,1828,0
2020-06-03,Russia,NA,Kirov Oblast,1283238,76,0,1904,0
2020-06-04,Russia,NA,Kirov Oblast,1283238,63,0,1967,0
2020-06-05,Russia,NA,Kirov Oblast,1283238,75,0,2042,0
2020-06-06,Russia,NA,Kirov Oblast,1283238,79,0,2121,0
2020-06-07,Russia,NA,Kirov Oblast,1283238,61,0,2182,0
2020-06-08,Russia,NA,Kirov Oblast,1283238,78,0,2260,0
2020-06-09,Russia,NA,Kirov Oblast,1283238,40,0,2300,0
2020-06-10,Russia,NA,Kirov Oblast,1283238,60,0,2360,0
2020-06-11,Russia,NA,Kirov Oblast,1283238,61,0,2421,0
2020-06-12,Russia,NA,Kirov Oblast,1283238,58,0,2479,0
2020-06-13,Russia,NA,Kirov Oblast,1283238,29,0,2508,0
2020-06-14,Russia,NA,Kirov Oblast,1283238,39,0,2547,0
2020-06-15,Russia,NA,Kirov Oblast,1283238,53,0,2600,0
2020-06-16,Russia,NA,Kirov Oblast,1283238,48,0,2648,0
2020-06-17,Russia,NA,Kirov Oblast,1283238,45,0,2693,0
2020-06-18,Russia,NA,Kirov Oblast,1283238,41,0,2734,0
2020-06-19,Russia,NA,Kirov Oblast,1283238,43,0,2777,0
2020-06-20,Russia,NA,Kirov Oblast,1283238,43,0,2820,0
2020-06-21,Russia,NA,Kirov Oblast,1283238,49,0,2869,0
2020-06-22,Russia,NA,Kirov Oblast,1283238,47,0,2916,0
2020-06-23,Russia,NA,Kirov Oblast,1283238,36,0,2952,0
2020-06-24,Russia,NA,Kirov Oblast,1283238,34,0,2986,0
2020-06-25,Russia,NA,Kirov Oblast,1283238,40,0,3026,0
2020-06-26,Russia,NA,Kirov Oblast,1283238,50,0,3076,0
2020-06-27,Russia,NA,Kirov Oblast,1283238,41,0,3117,0
2020-06-28,Russia,NA,Kirov Oblast,1283238,31,0,3148,0
2020-06-29,Russia,NA,Kirov Oblast,1283238,31,0,3179,0
2020-06-30,Russia,NA,Kirov Oblast,1283238,35,0,3214,0
2020-07-01,Russia,NA,Kirov Oblast,1283238,32,0,3246,0
2020-07-02,Russia,NA,Kirov Oblast,1283238,30,0,3276,0
2020-07-03,Russia,NA,Kirov Oblast,1283238,45,0,3321,0
2020-07-04,Russia,NA,Kirov Oblast,1283238,33,0,3354,0
2020-07-05,Russia,NA,Kirov Oblast,1283238,50,0,3404,0
2020-07-06,Russia,NA,Kirov Oblast,1283238,55,0,3459,0
2020-07-07,Russia,NA,Kirov Oblast,1283238,53,0,3512,0
2020-07-08,Russia,NA,Kirov Oblast,1283238,45,0,3557,0
2020-07-09,Russia,NA,Kirov Oblast,1283238,57,0,3614,0
2020-07-10,Russia,NA,Kirov Oblast,1283238,55,0,3669,0
2020-07-11,Russia,NA,Kirov Oblast,1283238,58,0,3727,0
2020-07-12,Russia,NA,Kirov Oblast,1283238,52,0,3779,0
2020-07-13,Russia,NA,Kirov Oblast,1283238,54,0,3833,0
2020-07-14,Russia,NA,Kirov Oblast,1283238,44,0,3877,0
2020-07-15,Russia,NA,Kirov Oblast,1283238,56,0,3933,0
2020-07-16,Russia,NA,Kirov Oblast,1283238,57,0,3990,0
2020-07-17,Russia,NA,Kirov Oblast,1283238,56,0,4046,0
2020-07-18,Russia,NA,Kirov Oblast,1283238,45,0,4091,0
2020-07-19,Russia,NA,Kirov Oblast,1283238,51,0,4142,0
2020-07-20,Russia,NA,Kirov Oblast,1283238,56,0,4198,0
2020-07-21,Russia,NA,Kirov Oblast,1283238,58,0,4256,0
2020-07-22,Russia,NA,Kirov Oblast,1283238,46,0,4302,0
2020-07-23,Russia,NA,Kirov Oblast,1283238,47,0,4349,0
2020-07-24,Russia,NA,Kirov Oblast,1283238,55,0,4404,0
2020-07-25,Russia,NA,Kirov Oblast,1283238,58,0,4462,0
2020-07-26,Russia,NA,Kirov Oblast,1283238,49,0,4511,0
2020-07-27,Russia,NA,Kirov Oblast,1283238,59,0,4570,0
2020-07-28,Russia,NA,Kirov Oblast,1283238,47,0,4617,0
2020-07-29,Russia,NA,Kirov Oblast,1283238,48,0,4665,0
2020-07-30,Russia,NA,Kirov Oblast,1283238,58,0,4723,0
2020-07-31,Russia,NA,Kirov Oblast,1283238,66,0,4789,0
2020-08-01,Russia,NA,Kirov Oblast,1283238,50,0,4839,0
2020-08-02,Russia,NA,Kirov Oblast,1283238,49,0,4888,0
2020-08-26,Russia,NA,Kirov Oblast,1283238,0,0,6235,96
2020-08-27,Russia,NA,Kirov Oblast,1283238,63,1,6298,97
2020-08-28,Russia,NA,Kirov Oblast,1283238,63,1,6361,98
2020-08-29,Russia,NA,Kirov Oblast,1283238,65,0,6426,98
2020-08-30,Russia,NA,Kirov Oblast,1283238,64,0,6490,98
2020-08-31,Russia,NA,Kirov Oblast,1283238,65,0,6555,98
2020-09-01,Russia,NA,Kirov Oblast,1283238,64,0,6619,98
2020-09-02,Russia,NA,Kirov Oblast,1283238,64,0,6683,98
2020-09-03,Russia,NA,Kirov Oblast,1283238,65,0,6748,98
2020-09-04,Russia,NA,Kirov Oblast,1283238,64,0,6812,98
2020-09-05,Russia,NA,Kirov Oblast,1283238,65,0,6877,98
2020-09-06,Russia,NA,Kirov Oblast,1283238,63,0,6940,98
2020-09-07,Russia,NA,Kirov Oblast,1283238,62,0,7002,98
2020-09-08,Russia,NA,Kirov Oblast,1283238,63,2,7065,100
2020-09-09,Russia,NA,Kirov Oblast,1283238,60,0,7125,100
2020-09-10,Russia,NA,Kirov Oblast,1283238,65,2,7190,102
2020-09-11,Russia,NA,Kirov Oblast,1283238,65,2,7255,104
2020-09-12,Russia,NA,Kirov Oblast,1283238,66,2,7321,106
2020-09-13,Russia,NA,Kirov Oblast,1283238,62,2,7383,108
2020-09-14,Russia,NA,Kirov Oblast,1283238,66,2,7449,110
2020-09-15,Russia,NA,Kirov Oblast,1283238,63,2,7512,112
2020-09-16,Russia,NA,Kirov Oblast,1283238,60,2,7572,114
2020-09-17,Russia,NA,Kirov Oblast,1283238,62,2,7634,116
2020-09-18,Russia,NA,Kirov Oblast,1283238,67,2,7701,118
2020-09-19,Russia,NA,Kirov Oblast,1283238,68,2,7769,120
2020-09-20,Russia,NA,Kirov Oblast,1283238,70,1,7839,121
2020-09-21,Russia,NA,Kirov Oblast,1283238,68,1,7907,122
2020-09-22,Russia,NA,Kirov Oblast,1283238,67,1,7974,123
2020-09-23,Russia,NA,Kirov Oblast,1283238,66,1,8040,124
2020-03-30,Russia,NA,Komi Republic,840873,15,0,22,0
2020-04-01,Russia,NA,Komi Republic,840873,32,0,54,0
2020-04-02,Russia,NA,Komi Republic,840873,2,0,56,0
2020-04-04,Russia,NA,Komi Republic,840873,3,0,59,0
2020-04-06,Russia,NA,Komi Republic,840873,31,0,90,0
2020-04-07,Russia,NA,Komi Republic,840873,11,0,101,0
2020-04-08,Russia,NA,Komi Republic,840873,18,0,119,0
2020-04-09,Russia,NA,Komi Republic,840873,31,0,150,0
2020-04-10,Russia,NA,Komi Republic,840873,58,0,208,0
2020-04-14,Russia,NA,Komi Republic,840873,97,0,305,0
2020-04-15,Russia,NA,Komi Republic,840873,97,0,402,0
2020-04-16,Russia,NA,Komi Republic,840873,39,0,441,0
2020-04-17,Russia,NA,Komi Republic,840873,14,0,455,0
2020-04-18,Russia,NA,Komi Republic,840873,19,0,474,0
2020-04-19,Russia,NA,Komi Republic,840873,7,0,481,0
2020-04-20,Russia,NA,Komi Republic,840873,10,0,491,0
2020-04-21,Russia,NA,Komi Republic,840873,16,0,507,0
2020-04-22,Russia,NA,Komi Republic,840873,20,0,527,0
2020-04-23,Russia,NA,Komi Republic,840873,15,0,542,0
2020-04-24,Russia,NA,Komi Republic,840873,11,0,553,0
2020-04-25,Russia,NA,Komi Republic,840873,8,0,561,0
2020-04-26,Russia,NA,Komi Republic,840873,17,0,578,0
2020-04-27,Russia,NA,Komi Republic,840873,12,0,590,0
2020-04-28,Russia,NA,Komi Republic,840873,7,0,597,0
2020-04-29,Russia,NA,Komi Republic,840873,14,0,611,0
2020-04-30,Russia,NA,Komi Republic,840873,10,0,621,0
2020-05-01,Russia,NA,Komi Republic,840873,28,0,649,0
2020-05-02,Russia,NA,Komi Republic,840873,7,0,656,0
2020-05-03,Russia,NA,Komi Republic,840873,20,0,676,0
2020-05-04,Russia,NA,Komi Republic,840873,6,0,682,0
2020-05-05,Russia,NA,Komi Republic,840873,16,0,698,0
2020-05-06,Russia,NA,Komi Republic,840873,28,0,726,0
2020-05-07,Russia,NA,Komi Republic,840873,56,0,782,0
2020-05-08,Russia,NA,Komi Republic,840873,11,0,793,0
2020-05-09,Russia,NA,Komi Republic,840873,10,0,803,0
2020-05-10,Russia,NA,Komi Republic,840873,20,0,823,0
2020-05-11,Russia,NA,Komi Republic,840873,21,0,844,0
2020-05-12,Russia,NA,Komi Republic,840873,3,0,847,0
2020-05-13,Russia,NA,Komi Republic,840873,12,0,859,0
2020-05-14,Russia,NA,Komi Republic,840873,8,0,867,0
2020-05-15,Russia,NA,Komi Republic,840873,15,0,882,0
2020-05-16,Russia,NA,Komi Republic,840873,29,0,911,0
2020-05-17,Russia,NA,Komi Republic,840873,20,0,931,0
2020-05-18,Russia,NA,Komi Republic,840873,37,0,968,0
2020-05-19,Russia,NA,Komi Republic,840873,39,0,1007,0
2020-05-20,Russia,NA,Komi Republic,840873,12,0,1019,0
2020-05-21,Russia,NA,Komi Republic,840873,13,0,1032,0
2020-05-22,Russia,NA,Komi Republic,840873,35,0,1067,0
2020-05-23,Russia,NA,Komi Republic,840873,38,0,1105,0
2020-05-24,Russia,NA,Komi Republic,840873,24,0,1129,0
2020-05-25,Russia,NA,Komi Republic,840873,6,0,1135,0
2020-05-26,Russia,NA,Komi Republic,840873,9,0,1144,0
2020-05-27,Russia,NA,Komi Republic,840873,44,0,1188,0
2020-05-28,Russia,NA,Komi Republic,840873,50,0,1238,0
2020-05-29,Russia,NA,Komi Republic,840873,24,0,1262,0
2020-05-30,Russia,NA,Komi Republic,840873,31,0,1293,0
2020-05-31,Russia,NA,Komi Republic,840873,29,0,1322,0
2020-06-01,Russia,NA,Komi Republic,840873,30,0,1352,0
2020-06-02,Russia,NA,Komi Republic,840873,41,0,1393,0
2020-06-03,Russia,NA,Komi Republic,840873,33,0,1426,0
2020-06-04,Russia,NA,Komi Republic,840873,29,0,1455,0
2020-06-05,Russia,NA,Komi Republic,840873,25,0,1480,0
2020-06-06,Russia,NA,Komi Republic,840873,38,0,1518,0
2020-06-07,Russia,NA,Komi Republic,840873,46,0,1564,0
2020-06-08,Russia,NA,Komi Republic,840873,36,0,1600,0
2020-06-09,Russia,NA,Komi Republic,840873,26,0,1626,0
2020-06-10,Russia,NA,Komi Republic,840873,67,0,1693,0
2020-06-11,Russia,NA,Komi Republic,840873,111,0,1804,0
2020-06-12,Russia,NA,Komi Republic,840873,125,0,1929,0
2020-06-13,Russia,NA,Komi Republic,840873,156,0,2085,0
2020-06-14,Russia,NA,Komi Republic,840873,181,0,2266,0
2020-06-15,Russia,NA,Komi Republic,840873,86,0,2352,0
2020-06-16,Russia,NA,Komi Republic,840873,85,0,2437,0
2020-06-17,Russia,NA,Komi Republic,840873,54,0,2491,0
2020-06-18,Russia,NA,Komi Republic,840873,82,0,2573,0
2020-06-19,Russia,NA,Komi Republic,840873,114,0,2687,0
2020-06-20,Russia,NA,Komi Republic,840873,57,0,2744,0
2020-06-21,Russia,NA,Komi Republic,840873,61,0,2805,0
2020-06-22,Russia,NA,Komi Republic,840873,59,0,2864,0
2020-06-23,Russia,NA,Komi Republic,840873,62,0,2926,0
2020-06-24,Russia,NA,Komi Republic,840873,60,0,2986,0
2020-06-25,Russia,NA,Komi Republic,840873,64,0,3050,0
2020-06-26,Russia,NA,Komi Republic,840873,58,0,3108,0
2020-06-27,Russia,NA,Komi Republic,840873,65,0,3173,0
2020-06-28,Russia,NA,Komi Republic,840873,114,0,3287,0
2020-06-29,Russia,NA,Komi Republic,840873,69,0,3356,0
2020-06-30,Russia,NA,Komi Republic,840873,53,0,3409,0
2020-07-01,Russia,NA,Komi Republic,840873,54,0,3463,0
2020-07-02,Russia,NA,Komi Republic,840873,50,0,3513,0
2020-07-03,Russia,NA,Komi Republic,840873,64,0,3577,0
2020-07-04,Russia,NA,Komi Republic,840873,63,0,3640,0
2020-07-05,Russia,NA,Komi Republic,840873,55,0,3695,0
2020-07-06,Russia,NA,Komi Republic,840873,67,0,3762,0
2020-07-07,Russia,NA,Komi Republic,840873,104,0,3866,0
2020-07-08,Russia,NA,Komi Republic,840873,83,0,3949,0
2020-07-09,Russia,NA,Komi Republic,840873,79,0,4028,0
2020-07-10,Russia,NA,Komi Republic,840873,79,0,4107,0
2020-07-11,Russia,NA,Komi Republic,840873,72,0,4179,0
2020-07-12,Russia,NA,Komi Republic,840873,70,0,4249,0
2020-07-13,Russia,NA,Komi Republic,840873,59,0,4308,0
2020-07-14,Russia,NA,Komi Republic,840873,58,0,4366,0
2020-07-15,Russia,NA,Komi Republic,840873,50,0,4416,0
2020-07-16,Russia,NA,Komi Republic,840873,53,0,4469,0
2020-07-17,Russia,NA,Komi Republic,840873,73,0,4542,0
2020-07-18,Russia,NA,Komi Republic,840873,68,0,4610,0
2020-07-19,Russia,NA,Komi Republic,840873,70,0,4680,0
2020-07-20,Russia,NA,Komi Republic,840873,81,0,4761,0
2020-07-21,Russia,NA,Komi Republic,840873,58,0,4819,0
2020-07-22,Russia,NA,Komi Republic,840873,47,0,4866,0
2020-07-23,Russia,NA,Komi Republic,840873,45,0,4911,0
2020-07-24,Russia,NA,Komi Republic,840873,53,0,4964,0
2020-07-25,Russia,NA,Komi Republic,840873,70,0,5034,0
2020-07-26,Russia,NA,Komi Republic,840873,66,0,5100,0
2020-07-27,Russia,NA,Komi Republic,840873,44,0,5144,0
2020-07-28,Russia,NA,Komi Republic,840873,41,0,5185,0
2020-07-29,Russia,NA,Komi Republic,840873,36,0,5221,0
2020-07-30,Russia,NA,Komi Republic,840873,38,0,5259,0
2020-07-31,Russia,NA,Komi Republic,840873,44,0,5303,0
2020-08-01,Russia,NA,Komi Republic,840873,48,0,5351,0
2020-08-02,Russia,NA,Komi Republic,840873,45,0,5396,0
2020-08-26,Russia,NA,Komi Republic,840873,0,0,6429,83
2020-08-27,Russia,NA,Komi Republic,840873,24,0,6453,83
2020-08-28,Russia,NA,Komi Republic,840873,27,1,6480,84
2020-08-29,Russia,NA,Komi Republic,840873,24,1,6504,85
2020-08-30,Russia,NA,Komi Republic,840873,29,0,6533,85
2020-08-31,Russia,NA,Komi Republic,840873,30,0,6563,85
2020-09-01,Russia,NA,Komi Republic,840873,29,0,6592,85
2020-09-02,Russia,NA,Komi Republic,840873,28,0,6620,85
2020-09-03,Russia,NA,Komi Republic,840873,24,0,6644,85
2020-09-04,Russia,NA,Komi Republic,840873,35,0,6679,85
2020-09-05,Russia,NA,Komi Republic,840873,37,0,6716,85
2020-09-06,Russia,NA,Komi Republic,840873,38,0,6754,85
2020-09-07,Russia,NA,Komi Republic,840873,33,0,6787,85
2020-09-08,Russia,NA,Komi Republic,840873,29,1,6816,86
2020-09-09,Russia,NA,Komi Republic,840873,36,2,6852,88
2020-09-10,Russia,NA,Komi Republic,840873,46,1,6898,89
2020-09-11,Russia,NA,Komi Republic,840873,44,1,6942,90
2020-09-12,Russia,NA,Komi Republic,840873,61,1,7003,91
2020-09-13,Russia,NA,Komi Republic,840873,58,0,7061,91
2020-09-14,Russia,NA,Komi Republic,840873,53,0,7114,91
2020-09-15,Russia,NA,Komi Republic,840873,51,0,7165,91
2020-09-16,Russia,NA,Komi Republic,840873,58,1,7223,92
2020-09-17,Russia,NA,Komi Republic,840873,69,1,7292,93
2020-09-18,Russia,NA,Komi Republic,840873,67,3,7359,96
2020-09-19,Russia,NA,Komi Republic,840873,73,1,7432,97
2020-09-20,Russia,NA,Komi Republic,840873,75,0,7507,97
2020-09-21,Russia,NA,Komi Republic,840873,76,0,7583,97
2020-09-22,Russia,NA,Komi Republic,840873,79,4,7662,101
2020-09-23,Russia,NA,Komi Republic,840873,78,3,7740,104
2020-04-09,Russia,NA,Kostroma Oblast,643324,3,0,12,0
2020-04-10,Russia,NA,Kostroma Oblast,643324,3,0,15,0
2020-04-12,Russia,NA,Kostroma Oblast,643324,4,0,19,0
2020-04-15,Russia,NA,Kostroma Oblast,643324,9,0,28,0
2020-04-16,Russia,NA,Kostroma Oblast,643324,11,0,39,0
2020-04-17,Russia,NA,Kostroma Oblast,643324,9,0,48,0
2020-04-18,Russia,NA,Kostroma Oblast,643324,6,0,54,0
2020-04-19,Russia,NA,Kostroma Oblast,643324,13,0,67,0
2020-04-20,Russia,NA,Kostroma Oblast,643324,4,0,71,0
2020-04-21,Russia,NA,Kostroma Oblast,643324,11,0,82,0
2020-04-22,Russia,NA,Kostroma Oblast,643324,7,0,89,0
2020-04-23,Russia,NA,Kostroma Oblast,643324,16,0,105,0
2020-04-24,Russia,NA,Kostroma Oblast,643324,16,0,121,0
2020-04-25,Russia,NA,Kostroma Oblast,643324,17,0,138,0
2020-04-26,Russia,NA,Kostroma Oblast,643324,11,0,149,0
2020-04-27,Russia,NA,Kostroma Oblast,643324,10,0,159,0
2020-04-28,Russia,NA,Kostroma Oblast,643324,22,0,181,0
2020-04-29,Russia,NA,Kostroma Oblast,643324,13,0,194,0
2020-04-30,Russia,NA,Kostroma Oblast,643324,18,0,212,0
2020-05-01,Russia,NA,Kostroma Oblast,643324,16,0,228,0
2020-05-02,Russia,NA,Kostroma Oblast,643324,14,0,242,0
2020-05-03,Russia,NA,Kostroma Oblast,643324,12,0,254,0
2020-05-04,Russia,NA,Kostroma Oblast,643324,13,0,267,0
2020-05-05,Russia,NA,Kostroma Oblast,643324,12,0,279,0
2020-05-06,Russia,NA,Kostroma Oblast,643324,15,0,294,0
2020-05-07,Russia,NA,Kostroma Oblast,643324,18,0,312,0
2020-05-08,Russia,NA,Kostroma Oblast,643324,22,0,334,0
2020-05-09,Russia,NA,Kostroma Oblast,643324,10,0,344,0
2020-05-10,Russia,NA,Kostroma Oblast,643324,14,0,358,0
2020-05-11,Russia,NA,Kostroma Oblast,643324,15,0,373,0
2020-05-12,Russia,NA,Kostroma Oblast,643324,12,0,385,0
2020-05-13,Russia,NA,Kostroma Oblast,643324,18,0,403,0
2020-05-14,Russia,NA,Kostroma Oblast,643324,31,0,434,0
2020-05-15,Russia,NA,Kostroma Oblast,643324,19,0,453,0
2020-05-16,Russia,NA,Kostroma Oblast,643324,8,0,461,0
2020-05-17,Russia,NA,Kostroma Oblast,643324,17,0,478,0
2020-05-18,Russia,NA,Kostroma Oblast,643324,10,0,488,0
2020-05-19,Russia,NA,Kostroma Oblast,643324,13,0,501,0
2020-05-20,Russia,NA,Kostroma Oblast,643324,16,0,517,0
2020-05-21,Russia,NA,Kostroma Oblast,643324,11,0,528,0
2020-05-22,Russia,NA,Kostroma Oblast,643324,13,0,541,0
2020-05-23,Russia,NA,Kostroma Oblast,643324,20,0,561,0
2020-05-24,Russia,NA,Kostroma Oblast,643324,7,0,568,0
2020-05-25,Russia,NA,Kostroma Oblast,643324,13,0,581,0
2020-05-26,Russia,NA,Kostroma Oblast,643324,21,0,602,0
2020-05-27,Russia,NA,Kostroma Oblast,643324,16,0,618,0
2020-05-28,Russia,NA,Kostroma Oblast,643324,39,0,657,0
2020-05-29,Russia,NA,Kostroma Oblast,643324,35,0,692,0
2020-05-30,Russia,NA,Kostroma Oblast,643324,28,0,720,0
2020-05-31,Russia,NA,Kostroma Oblast,643324,39,0,759,0
2020-06-01,Russia,NA,Kostroma Oblast,643324,14,0,773,0
2020-06-02,Russia,NA,Kostroma Oblast,643324,32,0,805,0
2020-06-03,Russia,NA,Kostroma Oblast,643324,21,0,826,0
2020-06-04,Russia,NA,Kostroma Oblast,643324,17,0,843,0
2020-06-05,Russia,NA,Kostroma Oblast,643324,20,0,863,0
2020-06-06,Russia,NA,Kostroma Oblast,643324,26,0,889,0
2020-06-07,Russia,NA,Kostroma Oblast,643324,13,0,902,0
2020-06-08,Russia,NA,Kostroma Oblast,643324,25,0,927,0
2020-06-09,Russia,NA,Kostroma Oblast,643324,27,0,954,0
2020-06-10,Russia,NA,Kostroma Oblast,643324,24,0,978,0
2020-06-11,Russia,NA,Kostroma Oblast,643324,51,0,1029,0
2020-06-12,Russia,NA,Kostroma Oblast,643324,38,0,1067,0
2020-06-13,Russia,NA,Kostroma Oblast,643324,43,0,1110,0
2020-06-14,Russia,NA,Kostroma Oblast,643324,27,0,1137,0
2020-06-15,Russia,NA,Kostroma Oblast,643324,25,0,1162,0
2020-06-16,Russia,NA,Kostroma Oblast,643324,14,0,1176,0
2020-06-17,Russia,NA,Kostroma Oblast,643324,39,0,1215,0
2020-06-18,Russia,NA,Kostroma Oblast,643324,32,0,1247,0
2020-06-19,Russia,NA,Kostroma Oblast,643324,16,0,1263,0
2020-06-20,Russia,NA,Kostroma Oblast,643324,36,0,1299,0
2020-06-21,Russia,NA,Kostroma Oblast,643324,33,0,1332,0
2020-06-22,Russia,NA,Kostroma Oblast,643324,29,0,1361,0
2020-06-23,Russia,NA,Kostroma Oblast,643324,26,0,1387,0
2020-06-24,Russia,NA,Kostroma Oblast,643324,25,0,1412,0
2020-06-25,Russia,NA,Kostroma Oblast,643324,31,0,1443,0
2020-06-26,Russia,NA,Kostroma Oblast,643324,28,0,1471,0
2020-06-27,Russia,NA,Kostroma Oblast,643324,24,0,1495,0
2020-06-28,Russia,NA,Kostroma Oblast,643324,37,0,1532,0
2020-06-29,Russia,NA,Kostroma Oblast,643324,34,0,1566,0
2020-06-30,Russia,NA,Kostroma Oblast,643324,18,0,1584,0
2020-07-01,Russia,NA,Kostroma Oblast,643324,8,0,1592,0
2020-07-02,Russia,NA,Kostroma Oblast,643324,21,0,1613,0
2020-07-03,Russia,NA,Kostroma Oblast,643324,20,0,1633,0
2020-07-04,Russia,NA,Kostroma Oblast,643324,22,0,1655,0
2020-07-05,Russia,NA,Kostroma Oblast,643324,22,0,1677,0
2020-07-06,Russia,NA,Kostroma Oblast,643324,20,0,1697,0
2020-07-07,Russia,NA,Kostroma Oblast,643324,34,0,1731,0
2020-07-08,Russia,NA,Kostroma Oblast,643324,22,0,1753,0
2020-07-09,Russia,NA,Kostroma Oblast,643324,26,0,1779,0
2020-07-10,Russia,NA,Kostroma Oblast,643324,36,0,1815,0
2020-07-11,Russia,NA,Kostroma Oblast,643324,11,0,1826,0
2020-07-12,Russia,NA,Kostroma Oblast,643324,19,0,1845,0
2020-07-13,Russia,NA,Kostroma Oblast,643324,11,0,1856,0
2020-07-14,Russia,NA,Kostroma Oblast,643324,8,0,1864,0
2020-07-15,Russia,NA,Kostroma Oblast,643324,23,0,1887,0
2020-07-16,Russia,NA,Kostroma Oblast,643324,16,0,1903,0
2020-07-17,Russia,NA,Kostroma Oblast,643324,20,0,1923,0
2020-07-18,Russia,NA,Kostroma Oblast,643324,24,0,1947,0
2020-07-19,Russia,NA,Kostroma Oblast,643324,17,0,1964,0
2020-07-20,Russia,NA,Kostroma Oblast,643324,32,0,1996,0
2020-07-21,Russia,NA,Kostroma Oblast,643324,10,0,2006,0
2020-07-22,Russia,NA,Kostroma Oblast,643324,11,0,2017,0
2020-07-23,Russia,NA,Kostroma Oblast,643324,12,0,2029,0
2020-07-24,Russia,NA,Kostroma Oblast,643324,12,0,2041,0
2020-07-25,Russia,NA,Kostroma Oblast,643324,34,0,2075,0
2020-07-26,Russia,NA,Kostroma Oblast,643324,45,0,2120,0
2020-07-27,Russia,NA,Kostroma Oblast,643324,18,0,2138,0
2020-07-28,Russia,NA,Kostroma Oblast,643324,17,0,2155,0
2020-07-29,Russia,NA,Kostroma Oblast,643324,12,0,2167,0
2020-07-30,Russia,NA,Kostroma Oblast,643324,9,0,2176,0
2020-07-31,Russia,NA,Kostroma Oblast,643324,31,0,2207,0
2020-08-01,Russia,NA,Kostroma Oblast,643324,28,0,2235,0
2020-08-02,Russia,NA,Kostroma Oblast,643324,27,0,2262,0
2020-08-26,Russia,NA,Kostroma Oblast,643324,0,0,3355,39
2020-08-27,Russia,NA,Kostroma Oblast,643324,38,1,3393,40
2020-08-28,Russia,NA,Kostroma Oblast,643324,36,0,3429,40
2020-08-29,Russia,NA,Kostroma Oblast,643324,38,0,3467,40
2020-08-30,Russia,NA,Kostroma Oblast,643324,43,0,3510,40
2020-08-31,Russia,NA,Kostroma Oblast,643324,36,0,3546,40
2020-09-01,Russia,NA,Kostroma Oblast,643324,32,0,3578,40
2020-09-02,Russia,NA,Kostroma Oblast,643324,23,1,3601,41
2020-09-03,Russia,NA,Kostroma Oblast,643324,24,0,3625,41
2020-09-04,Russia,NA,Kostroma Oblast,643324,34,0,3659,41
2020-09-05,Russia,NA,Kostroma Oblast,643324,37,0,3696,41
2020-09-06,Russia,NA,Kostroma Oblast,643324,46,0,3742,41
2020-09-07,Russia,NA,Kostroma Oblast,643324,44,0,3786,41
2020-09-08,Russia,NA,Kostroma Oblast,643324,31,3,3817,44
2020-09-09,Russia,NA,Kostroma Oblast,643324,46,0,3863,44
2020-09-10,Russia,NA,Kostroma Oblast,643324,48,3,3911,47
2020-09-11,Russia,NA,Kostroma Oblast,643324,41,2,3952,49
2020-09-12,Russia,NA,Kostroma Oblast,643324,47,1,3999,50
2020-09-13,Russia,NA,Kostroma Oblast,643324,47,0,4046,50
2020-09-14,Russia,NA,Kostroma Oblast,643324,53,0,4099,50
2020-09-15,Russia,NA,Kostroma Oblast,643324,16,3,4115,53
2020-09-16,Russia,NA,Kostroma Oblast,643324,41,0,4156,53
2020-09-17,Russia,NA,Kostroma Oblast,643324,47,5,4203,58
2020-09-18,Russia,NA,Kostroma Oblast,643324,32,0,4235,58
2020-09-19,Russia,NA,Kostroma Oblast,643324,42,0,4277,58
2020-09-20,Russia,NA,Kostroma Oblast,643324,34,0,4311,58
2020-09-21,Russia,NA,Kostroma Oblast,643324,37,0,4348,58
2020-09-22,Russia,NA,Kostroma Oblast,643324,31,0,4379,58
2020-09-23,Russia,NA,Kostroma Oblast,643324,38,1,4417,59
2020-03-28,Russia,NA,Krasnodar Krai,5514250,8,0,17,0
2020-04-01,Russia,NA,Krasnodar Krai,5514250,5,0,22,0
2020-04-03,Russia,NA,Krasnodar Krai,5514250,17,0,39,0
2020-04-06,Russia,NA,Krasnodar Krai,5514250,11,0,50,0
2020-04-07,Russia,NA,Krasnodar Krai,5514250,11,0,61,0
2020-04-08,Russia,NA,Krasnodar Krai,5514250,24,0,85,0
2020-04-09,Russia,NA,Krasnodar Krai,5514250,20,0,105,0
2020-04-10,Russia,NA,Krasnodar Krai,5514250,20,0,125,0
2020-04-11,Russia,NA,Krasnodar Krai,5514250,13,0,138,0
2020-04-12,Russia,NA,Krasnodar Krai,5514250,31,0,169,0
2020-04-13,Russia,NA,Krasnodar Krai,5514250,41,0,210,0
2020-04-14,Russia,NA,Krasnodar Krai,5514250,5,0,215,0
2020-04-15,Russia,NA,Krasnodar Krai,5514250,24,0,239,0
2020-04-16,Russia,NA,Krasnodar Krai,5514250,21,0,260,0
2020-04-17,Russia,NA,Krasnodar Krai,5514250,30,0,290,0
2020-04-18,Russia,NA,Krasnodar Krai,5514250,45,0,335,0
2020-04-19,Russia,NA,Krasnodar Krai,5514250,48,0,383,0
2020-04-20,Russia,NA,Krasnodar Krai,5514250,34,0,417,0
2020-04-21,Russia,NA,Krasnodar Krai,5514250,44,0,461,0
2020-04-22,Russia,NA,Krasnodar Krai,5514250,20,0,481,0
2020-04-23,Russia,NA,Krasnodar Krai,5514250,58,0,539,0
2020-04-24,Russia,NA,Krasnodar Krai,5514250,84,0,623,0
2020-04-25,Russia,NA,Krasnodar Krai,5514250,84,0,707,0
2020-04-26,Russia,NA,Krasnodar Krai,5514250,73,0,780,0
2020-04-27,Russia,NA,Krasnodar Krai,5514250,57,0,837,0
2020-04-28,Russia,NA,Krasnodar Krai,5514250,51,0,888,0
2020-04-29,Russia,NA,Krasnodar Krai,5514250,63,0,951,0
2020-04-30,Russia,NA,Krasnodar Krai,5514250,66,0,1017,0
2020-05-01,Russia,NA,Krasnodar Krai,5514250,66,0,1083,0
2020-05-02,Russia,NA,Krasnodar Krai,5514250,79,0,1162,0
2020-05-03,Russia,NA,Krasnodar Krai,5514250,82,0,1244,0
2020-05-04,Russia,NA,Krasnodar Krai,5514250,96,0,1340,0
2020-05-05,Russia,NA,Krasnodar Krai,5514250,97,0,1437,0
2020-05-06,Russia,NA,Krasnodar Krai,5514250,97,0,1534,0
2020-05-07,Russia,NA,Krasnodar Krai,5514250,99,0,1633,0
2020-05-08,Russia,NA,Krasnodar Krai,5514250,99,0,1732,0
2020-05-09,Russia,NA,Krasnodar Krai,5514250,98,0,1830,0
2020-05-10,Russia,NA,Krasnodar Krai,5514250,99,0,1929,0
2020-05-11,Russia,NA,Krasnodar Krai,5514250,98,0,2027,0
2020-05-12,Russia,NA,Krasnodar Krai,5514250,99,0,2126,0
2020-05-13,Russia,NA,Krasnodar Krai,5514250,96,0,2222,0
2020-05-14,Russia,NA,Krasnodar Krai,5514250,97,0,2319,0
2020-05-15,Russia,NA,Krasnodar Krai,5514250,99,0,2418,0
2020-05-16,Russia,NA,Krasnodar Krai,5514250,92,0,2510,0
2020-05-17,Russia,NA,Krasnodar Krai,5514250,95,0,2605,0
2020-05-18,Russia,NA,Krasnodar Krai,5514250,94,0,2699,0
2020-05-19,Russia,NA,Krasnodar Krai,5514250,93,0,2792,0
2020-05-20,Russia,NA,Krasnodar Krai,5514250,91,0,2883,0
2020-05-21,Russia,NA,Krasnodar Krai,5514250,91,0,2974,0
2020-05-22,Russia,NA,Krasnodar Krai,5514250,92,0,3066,0
2020-05-23,Russia,NA,Krasnodar Krai,5514250,89,0,3155,0
2020-05-24,Russia,NA,Krasnodar Krai,5514250,92,0,3247,0
2020-05-25,Russia,NA,Krasnodar Krai,5514250,90,0,3337,0
2020-05-26,Russia,NA,Krasnodar Krai,5514250,89,0,3426,0
2020-05-27,Russia,NA,Krasnodar Krai,5514250,80,0,3506,0
2020-05-28,Russia,NA,Krasnodar Krai,5514250,76,0,3582,0
2020-05-29,Russia,NA,Krasnodar Krai,5514250,80,0,3662,0
2020-05-30,Russia,NA,Krasnodar Krai,5514250,82,0,3744,0
2020-05-31,Russia,NA,Krasnodar Krai,5514250,80,0,3824,0
2020-06-01,Russia,NA,Krasnodar Krai,5514250,84,0,3908,0
2020-06-02,Russia,NA,Krasnodar Krai,5514250,79,0,3987,0
2020-06-03,Russia,NA,Krasnodar Krai,5514250,81,0,4068,0
2020-06-04,Russia,NA,Krasnodar Krai,5514250,80,0,4148,0
2020-06-05,Russia,NA,Krasnodar Krai,5514250,83,0,4231,0
2020-06-06,Russia,NA,Krasnodar Krai,5514250,81,0,4312,0
2020-06-07,Russia,NA,Krasnodar Krai,5514250,87,0,4399,0
2020-06-08,Russia,NA,Krasnodar Krai,5514250,86,0,4485,0
2020-06-09,Russia,NA,Krasnodar Krai,5514250,89,0,4574,0
2020-06-10,Russia,NA,Krasnodar Krai,5514250,81,0,4655,0
2020-06-11,Russia,NA,Krasnodar Krai,5514250,80,0,4735,0
2020-06-12,Russia,NA,Krasnodar Krai,5514250,80,0,4815,0
2020-06-13,Russia,NA,Krasnodar Krai,5514250,78,0,4893,0
2020-06-14,Russia,NA,Krasnodar Krai,5514250,77,0,4970,0
2020-06-15,Russia,NA,Krasnodar Krai,5514250,72,0,5042,0
2020-06-16,Russia,NA,Krasnodar Krai,5514250,70,0,5112,0
2020-06-17,Russia,NA,Krasnodar Krai,5514250,71,0,5183,0
2020-06-18,Russia,NA,Krasnodar Krai,5514250,69,0,5252,0
2020-06-19,Russia,NA,Krasnodar Krai,5514250,64,0,5316,0
2020-06-20,Russia,NA,Krasnodar Krai,5514250,60,0,5376,0
2020-06-21,Russia,NA,Krasnodar Krai,5514250,64,0,5440,0
2020-06-22,Russia,NA,Krasnodar Krai,5514250,61,0,5501,0
2020-06-23,Russia,NA,Krasnodar Krai,5514250,60,0,5561,0
2020-06-24,Russia,NA,Krasnodar Krai,5514250,63,0,5624,0
2020-06-25,Russia,NA,Krasnodar Krai,5514250,59,0,5683,0
2020-06-26,Russia,NA,Krasnodar Krai,5514250,60,0,5743,0
2020-06-27,Russia,NA,Krasnodar Krai,5514250,58,0,5801,0
2020-06-28,Russia,NA,Krasnodar Krai,5514250,59,0,5860,0
2020-06-29,Russia,NA,Krasnodar Krai,5514250,62,0,5922,0
2020-06-30,Russia,NA,Krasnodar Krai,5514250,60,0,5982,0
2020-07-01,Russia,NA,Krasnodar Krai,5514250,61,0,6043,0
2020-07-02,Russia,NA,Krasnodar Krai,5514250,59,0,6102,0
2020-07-03,Russia,NA,Krasnodar Krai,5514250,57,0,6159,0
2020-07-04,Russia,NA,Krasnodar Krai,5514250,59,0,6218,0
2020-07-05,Russia,NA,Krasnodar Krai,5514250,62,0,6280,0
2020-07-06,Russia,NA,Krasnodar Krai,5514250,60,0,6340,0
2020-07-07,Russia,NA,Krasnodar Krai,5514250,59,0,6399,0
2020-07-08,Russia,NA,Krasnodar Krai,5514250,61,0,6460,0
2020-07-09,Russia,NA,Krasnodar Krai,5514250,63,0,6523,0
2020-07-10,Russia,NA,Krasnodar Krai,5514250,66,0,6589,0
2020-07-11,Russia,NA,Krasnodar Krai,5514250,65,0,6654,0
2020-07-12,Russia,NA,Krasnodar Krai,5514250,67,0,6721,0
2020-07-13,Russia,NA,Krasnodar Krai,5514250,64,0,6785,0
2020-07-14,Russia,NA,Krasnodar Krai,5514250,62,0,6847,0
2020-07-15,Russia,NA,Krasnodar Krai,5514250,65,0,6912,0
2020-07-16,Russia,NA,Krasnodar Krai,5514250,67,0,6979,0
2020-07-17,Russia,NA,Krasnodar Krai,5514250,66,0,7045,0
2020-07-18,Russia,NA,Krasnodar Krai,5514250,70,0,7115,0
2020-07-19,Russia,NA,Krasnodar Krai,5514250,75,0,7190,0
2020-07-20,Russia,NA,Krasnodar Krai,5514250,72,0,7262,0
2020-07-21,Russia,NA,Krasnodar Krai,5514250,78,0,7340,0
2020-07-22,Russia,NA,Krasnodar Krai,5514250,83,0,7423,0
2020-07-23,Russia,NA,Krasnodar Krai,5514250,85,0,7508,0
2020-07-24,Russia,NA,Krasnodar Krai,5514250,90,0,7598,0
2020-07-25,Russia,NA,Krasnodar Krai,5514250,92,0,7690,0
2020-07-26,Russia,NA,Krasnodar Krai,5514250,94,0,7784,0
2020-07-27,Russia,NA,Krasnodar Krai,5514250,96,0,7880,0
2020-07-28,Russia,NA,Krasnodar Krai,5514250,95,0,7975,0
2020-07-29,Russia,NA,Krasnodar Krai,5514250,97,0,8072,0
2020-07-30,Russia,NA,Krasnodar Krai,5514250,98,0,8170,0
2020-07-31,Russia,NA,Krasnodar Krai,5514250,96,0,8266,0
2020-08-01,Russia,NA,Krasnodar Krai,5514250,99,0,8365,0
2020-08-02,Russia,NA,Krasnodar Krai,5514250,107,0,8472,0
2020-08-26,Russia,NA,Krasnodar Krai,5514250,0,0,10771,169
2020-08-27,Russia,NA,Krasnodar Krai,5514250,86,3,10857,172
2020-08-28,Russia,NA,Krasnodar Krai,5514250,84,2,10941,174
2020-08-29,Russia,NA,Krasnodar Krai,5514250,90,2,11031,176
2020-08-30,Russia,NA,Krasnodar Krai,5514250,90,1,11121,177
2020-08-31,Russia,NA,Krasnodar Krai,5514250,87,5,11208,182
2020-09-01,Russia,NA,Krasnodar Krai,5514250,86,3,11294,185
2020-09-02,Russia,NA,Krasnodar Krai,5514250,88,2,11382,187
2020-09-03,Russia,NA,Krasnodar Krai,5514250,90,0,11472,187
2020-09-04,Russia,NA,Krasnodar Krai,5514250,92,2,11564,189
2020-09-05,Russia,NA,Krasnodar Krai,5514250,90,2,11654,191
2020-09-06,Russia,NA,Krasnodar Krai,5514250,93,2,11747,193
2020-09-07,Russia,NA,Krasnodar Krai,5514250,91,1,11838,194
2020-09-08,Russia,NA,Krasnodar Krai,5514250,92,2,11930,196
2020-09-09,Russia,NA,Krasnodar Krai,5514250,90,6,12020,202
2020-09-10,Russia,NA,Krasnodar Krai,5514250,87,3,12107,205
2020-09-11,Russia,NA,Krasnodar Krai,5514250,88,4,12195,209
2020-09-12,Russia,NA,Krasnodar Krai,5514250,90,6,12285,215
2020-09-13,Russia,NA,Krasnodar Krai,5514250,92,5,12377,220
2020-09-14,Russia,NA,Krasnodar Krai,5514250,92,4,12469,224
2020-09-15,Russia,NA,Krasnodar Krai,5514250,94,4,12563,228
2020-09-16,Russia,NA,Krasnodar Krai,5514250,95,1,12658,229
2020-09-17,Russia,NA,Krasnodar Krai,5514250,93,2,12751,231
2020-09-18,Russia,NA,Krasnodar Krai,5514250,92,4,12843,235
2020-09-19,Russia,NA,Krasnodar Krai,5514250,94,6,12937,241
2020-09-20,Russia,NA,Krasnodar Krai,5514250,94,3,13031,244
2020-09-21,Russia,NA,Krasnodar Krai,5514250,92,2,13123,246
2020-09-22,Russia,NA,Krasnodar Krai,5514250,96,5,13219,251
2020-09-23,Russia,NA,Krasnodar Krai,5514250,94,5,13313,256
2020-03-28,Russia,NA,Krasnoyarsk Krai,2876497,4,0,12,0
2020-03-30,Russia,NA,Krasnoyarsk Krai,2876497,2,0,14,0
2020-04-01,Russia,NA,Krasnoyarsk Krai,2876497,6,0,20,0
2020-04-02,Russia,NA,Krasnoyarsk Krai,2876497,5,0,25,0
2020-04-05,Russia,NA,Krasnoyarsk Krai,2876497,4,0,29,0
2020-04-06,Russia,NA,Krasnoyarsk Krai,2876497,3,0,32,0
2020-04-08,Russia,NA,Krasnoyarsk Krai,2876497,7,0,39,0
2020-04-11,Russia,NA,Krasnoyarsk Krai,2876497,21,0,60,0
2020-04-12,Russia,NA,Krasnoyarsk Krai,2876497,25,0,85,0
2020-04-13,Russia,NA,Krasnoyarsk Krai,2876497,25,0,110,0
2020-04-14,Russia,NA,Krasnoyarsk Krai,2876497,21,0,131,0
2020-04-15,Russia,NA,Krasnoyarsk Krai,2876497,11,0,142,0
2020-04-16,Russia,NA,Krasnoyarsk Krai,2876497,60,0,202,0
2020-04-17,Russia,NA,Krasnoyarsk Krai,2876497,29,0,231,0
2020-04-18,Russia,NA,Krasnoyarsk Krai,2876497,45,0,276,0
2020-04-19,Russia,NA,Krasnoyarsk Krai,2876497,24,0,300,0
2020-04-20,Russia,NA,Krasnoyarsk Krai,2876497,6,0,306,0
2020-04-21,Russia,NA,Krasnoyarsk Krai,2876497,64,0,370,0
2020-04-22,Russia,NA,Krasnoyarsk Krai,2876497,22,0,392,0
2020-04-23,Russia,NA,Krasnoyarsk Krai,2876497,35,0,427,0
2020-04-24,Russia,NA,Krasnoyarsk Krai,2876497,22,0,449,0
2020-04-25,Russia,NA,Krasnoyarsk Krai,2876497,18,0,467,0
2020-04-26,Russia,NA,Krasnoyarsk Krai,2876497,41,0,508,0
2020-04-27,Russia,NA,Krasnoyarsk Krai,2876497,19,0,527,0
2020-04-28,Russia,NA,Krasnoyarsk Krai,2876497,47,0,574,0
2020-04-29,Russia,NA,Krasnoyarsk Krai,2876497,35,0,609,0
2020-04-30,Russia,NA,Krasnoyarsk Krai,2876497,57,0,666,0
2020-05-01,Russia,NA,Krasnoyarsk Krai,2876497,48,0,714,0
2020-05-02,Russia,NA,Krasnoyarsk Krai,2876497,50,0,764,0
2020-05-03,Russia,NA,Krasnoyarsk Krai,2876497,17,0,781,0
2020-05-04,Russia,NA,Krasnoyarsk Krai,2876497,42,0,823,0
2020-05-05,Russia,NA,Krasnoyarsk Krai,2876497,45,0,868,0
2020-05-06,Russia,NA,Krasnoyarsk Krai,2876497,42,0,910,0
2020-05-07,Russia,NA,Krasnoyarsk Krai,2876497,23,0,933,0
2020-05-08,Russia,NA,Krasnoyarsk Krai,2876497,31,0,964,0
2020-05-09,Russia,NA,Krasnoyarsk Krai,2876497,106,0,1070,0
2020-05-10,Russia,NA,Krasnoyarsk Krai,2876497,73,0,1143,0
2020-05-11,Russia,NA,Krasnoyarsk Krai,2876497,58,0,1201,0
2020-05-12,Russia,NA,Krasnoyarsk Krai,2876497,227,0,1428,0
2020-05-13,Russia,NA,Krasnoyarsk Krai,2876497,93,0,1521,0
2020-05-14,Russia,NA,Krasnoyarsk Krai,2876497,21,0,1542,0
2020-05-15,Russia,NA,Krasnoyarsk Krai,2876497,48,0,1590,0
2020-05-16,Russia,NA,Krasnoyarsk Krai,2876497,61,0,1651,0
2020-05-17,Russia,NA,Krasnoyarsk Krai,2876497,114,0,1765,0
2020-05-18,Russia,NA,Krasnoyarsk Krai,2876497,107,0,1872,0
2020-05-19,Russia,NA,Krasnoyarsk Krai,2876497,69,0,1941,0
2020-05-20,Russia,NA,Krasnoyarsk Krai,2876497,504,0,2445,0
2020-05-21,Russia,NA,Krasnoyarsk Krai,2876497,376,0,2821,0
2020-05-22,Russia,NA,Krasnoyarsk Krai,2876497,150,0,2971,0
2020-05-23,Russia,NA,Krasnoyarsk Krai,2876497,148,0,3119,0
2020-05-24,Russia,NA,Krasnoyarsk Krai,2876497,146,0,3265,0
2020-05-25,Russia,NA,Krasnoyarsk Krai,2876497,145,0,3410,0
2020-05-26,Russia,NA,Krasnoyarsk Krai,2876497,148,0,3558,0
2020-05-27,Russia,NA,Krasnoyarsk Krai,2876497,142,0,3700,0
2020-05-28,Russia,NA,Krasnoyarsk Krai,2876497,147,0,3847,0
2020-05-29,Russia,NA,Krasnoyarsk Krai,2876497,138,0,3985,0
2020-05-30,Russia,NA,Krasnoyarsk Krai,2876497,136,0,4121,0
2020-05-31,Russia,NA,Krasnoyarsk Krai,2876497,128,0,4249,0
2020-06-01,Russia,NA,Krasnoyarsk Krai,2876497,131,0,4380,0
2020-06-02,Russia,NA,Krasnoyarsk Krai,2876497,150,0,4530,0
2020-06-03,Russia,NA,Krasnoyarsk Krai,2876497,124,0,4654,0
2020-06-04,Russia,NA,Krasnoyarsk Krai,2876497,141,0,4795,0
2020-06-05,Russia,NA,Krasnoyarsk Krai,2876497,173,0,4968,0
2020-06-06,Russia,NA,Krasnoyarsk Krai,2876497,168,0,5136,0
2020-06-07,Russia,NA,Krasnoyarsk Krai,2876497,165,0,5301,0
2020-06-08,Russia,NA,Krasnoyarsk Krai,2876497,159,0,5460,0
2020-06-09,Russia,NA,Krasnoyarsk Krai,2876497,157,0,5617,0
2020-06-10,Russia,NA,Krasnoyarsk Krai,2876497,174,0,5791,0
2020-06-11,Russia,NA,Krasnoyarsk Krai,2876497,190,0,5981,0
2020-06-12,Russia,NA,Krasnoyarsk Krai,2876497,178,0,6159,0
2020-06-13,Russia,NA,Krasnoyarsk Krai,2876497,169,0,6328,0
2020-06-14,Russia,NA,Krasnoyarsk Krai,2876497,166,0,6494,0
2020-06-15,Russia,NA,Krasnoyarsk Krai,2876497,161,0,6655,0
2020-06-16,Russia,NA,Krasnoyarsk Krai,2876497,158,0,6813,0
2020-06-17,Russia,NA,Krasnoyarsk Krai,2876497,160,0,6973,0
2020-06-18,Russia,NA,Krasnoyarsk Krai,2876497,156,0,7129,0
2020-06-19,Russia,NA,Krasnoyarsk Krai,2876497,151,0,7280,0
2020-06-20,Russia,NA,Krasnoyarsk Krai,2876497,152,0,7432,0
2020-06-21,Russia,NA,Krasnoyarsk Krai,2876497,148,0,7580,0
2020-06-22,Russia,NA,Krasnoyarsk Krai,2876497,146,0,7726,0
2020-06-23,Russia,NA,Krasnoyarsk Krai,2876497,149,0,7875,0
2020-06-24,Russia,NA,Krasnoyarsk Krai,2876497,154,0,8029,0
2020-06-25,Russia,NA,Krasnoyarsk Krai,2876497,153,0,8182,0
2020-06-26,Russia,NA,Krasnoyarsk Krai,2876497,149,0,8331,0
2020-06-27,Russia,NA,Krasnoyarsk Krai,2876497,145,0,8476,0
2020-06-28,Russia,NA,Krasnoyarsk Krai,2876497,143,0,8619,0
2020-06-29,Russia,NA,Krasnoyarsk Krai,2876497,141,0,8760,0
2020-06-30,Russia,NA,Krasnoyarsk Krai,2876497,144,0,8904,0
2020-07-01,Russia,NA,Krasnoyarsk Krai,2876497,140,0,9044,0
2020-07-02,Russia,NA,Krasnoyarsk Krai,2876497,137,0,9181,0
2020-07-03,Russia,NA,Krasnoyarsk Krai,2876497,135,0,9316,0
2020-07-04,Russia,NA,Krasnoyarsk Krai,2876497,136,0,9452,0
2020-07-05,Russia,NA,Krasnoyarsk Krai,2876497,133,0,9585,0
2020-07-06,Russia,NA,Krasnoyarsk Krai,2876497,131,0,9716,0
2020-07-07,Russia,NA,Krasnoyarsk Krai,2876497,132,0,9848,0
2020-07-08,Russia,NA,Krasnoyarsk Krai,2876497,130,0,9978,0
2020-07-09,Russia,NA,Krasnoyarsk Krai,2876497,128,0,10106,0
2020-07-10,Russia,NA,Krasnoyarsk Krai,2876497,129,0,10235,0
2020-07-11,Russia,NA,Krasnoyarsk Krai,2876497,134,0,10369,0
2020-07-12,Russia,NA,Krasnoyarsk Krai,2876497,131,0,10500,0
2020-07-13,Russia,NA,Krasnoyarsk Krai,2876497,128,0,10628,0
2020-07-14,Russia,NA,Krasnoyarsk Krai,2876497,128,0,10756,0
2020-07-15,Russia,NA,Krasnoyarsk Krai,2876497,133,0,10889,0
2020-07-16,Russia,NA,Krasnoyarsk Krai,2876497,131,0,11020,0
2020-07-17,Russia,NA,Krasnoyarsk Krai,2876497,129,0,11149,0
2020-07-18,Russia,NA,Krasnoyarsk Krai,2876497,127,0,11276,0
2020-07-19,Russia,NA,Krasnoyarsk Krai,2876497,127,0,11403,0
2020-07-20,Russia,NA,Krasnoyarsk Krai,2876497,125,0,11528,0
2020-07-21,Russia,NA,Krasnoyarsk Krai,2876497,127,0,11655,0
2020-07-22,Russia,NA,Krasnoyarsk Krai,2876497,135,0,11790,0
2020-07-23,Russia,NA,Krasnoyarsk Krai,2876497,133,0,11923,0
2020-07-24,Russia,NA,Krasnoyarsk Krai,2876497,134,0,12057,0
2020-07-25,Russia,NA,Krasnoyarsk Krai,2876497,187,0,12244,0
2020-07-26,Russia,NA,Krasnoyarsk Krai,2876497,175,0,12419,0
2020-07-27,Russia,NA,Krasnoyarsk Krai,2876497,162,0,12581,0
2020-07-28,Russia,NA,Krasnoyarsk Krai,2876497,153,0,12734,0
2020-07-29,Russia,NA,Krasnoyarsk Krai,2876497,125,0,12859,0
2020-07-30,Russia,NA,Krasnoyarsk Krai,2876497,141,0,13000,0
2020-07-31,Russia,NA,Krasnoyarsk Krai,2876497,145,0,13145,0
2020-08-01,Russia,NA,Krasnoyarsk Krai,2876497,143,0,13288,0
2020-08-02,Russia,NA,Krasnoyarsk Krai,2876497,134,0,13422,0
2020-08-26,Russia,NA,Krasnoyarsk Krai,2876497,0,0,16316,442
2020-08-27,Russia,NA,Krasnoyarsk Krai,2876497,112,8,16428,450
2020-08-28,Russia,NA,Krasnoyarsk Krai,2876497,111,8,16539,458
2020-08-29,Russia,NA,Krasnoyarsk Krai,2876497,110,6,16649,464
2020-08-30,Russia,NA,Krasnoyarsk Krai,2876497,111,6,16760,470
2020-08-31,Russia,NA,Krasnoyarsk Krai,2876497,110,7,16870,477
2020-09-01,Russia,NA,Krasnoyarsk Krai,2876497,109,4,16979,481
2020-09-02,Russia,NA,Krasnoyarsk Krai,2876497,110,5,17089,486
2020-09-03,Russia,NA,Krasnoyarsk Krai,2876497,108,6,17197,492
2020-09-04,Russia,NA,Krasnoyarsk Krai,2876497,107,6,17304,498
2020-09-05,Russia,NA,Krasnoyarsk Krai,2876497,109,3,17413,501
2020-09-06,Russia,NA,Krasnoyarsk Krai,2876497,107,2,17520,503
2020-09-07,Russia,NA,Krasnoyarsk Krai,2876497,106,3,17626,506
2020-09-08,Russia,NA,Krasnoyarsk Krai,2876497,103,4,17729,510
2020-09-09,Russia,NA,Krasnoyarsk Krai,2876497,105,3,17834,513
2020-09-10,Russia,NA,Krasnoyarsk Krai,2876497,102,3,17936,516
2020-09-11,Russia,NA,Krasnoyarsk Krai,2876497,102,2,18038,518
2020-09-12,Russia,NA,Krasnoyarsk Krai,2876497,101,2,18139,520
2020-09-13,Russia,NA,Krasnoyarsk Krai,2876497,103,1,18242,521
2020-09-14,Russia,NA,Krasnoyarsk Krai,2876497,102,0,18344,521
2020-09-15,Russia,NA,Krasnoyarsk Krai,2876497,101,2,18445,523
2020-09-16,Russia,NA,Krasnoyarsk Krai,2876497,102,2,18547,525
2020-09-17,Russia,NA,Krasnoyarsk Krai,2876497,101,0,18648,525
2020-09-18,Russia,NA,Krasnoyarsk Krai,2876497,103,1,18751,526
2020-09-19,Russia,NA,Krasnoyarsk Krai,2876497,101,4,18852,530
2020-09-20,Russia,NA,Krasnoyarsk Krai,2876497,102,2,18954,532
2020-09-21,Russia,NA,Krasnoyarsk Krai,2876497,101,2,19055,534
2020-09-22,Russia,NA,Krasnoyarsk Krai,2876497,102,3,19157,537
2020-09-23,Russia,NA,Krasnoyarsk Krai,2876497,103,3,19260,540
2020-04-16,Russia,NA,Kurgan Oblast,845537,1,0,11,0
2020-04-17,Russia,NA,Kurgan Oblast,845537,1,0,12,0
2020-04-18,Russia,NA,Kurgan Oblast,845537,1,0,13,0
2020-04-21,Russia,NA,Kurgan Oblast,845537,2,0,15,0
2020-04-23,Russia,NA,Kurgan Oblast,845537,5,0,20,0
2020-04-24,Russia,NA,Kurgan Oblast,845537,2,0,22,0
2020-04-25,Russia,NA,Kurgan Oblast,845537,5,0,27,0
2020-04-26,Russia,NA,Kurgan Oblast,845537,2,0,29,0
2020-04-27,Russia,NA,Kurgan Oblast,845537,2,0,31,0
2020-04-28,Russia,NA,Kurgan Oblast,845537,2,0,33,0
2020-04-29,Russia,NA,Kurgan Oblast,845537,6,0,39,0
2020-04-30,Russia,NA,Kurgan Oblast,845537,1,0,40,0
2020-05-01,Russia,NA,Kurgan Oblast,845537,5,0,45,0
2020-05-02,Russia,NA,Kurgan Oblast,845537,4,0,49,0
2020-05-03,Russia,NA,Kurgan Oblast,845537,2,0,51,0
2020-05-04,Russia,NA,Kurgan Oblast,845537,1,0,52,0
2020-05-05,Russia,NA,Kurgan Oblast,845537,3,0,55,0
2020-05-06,Russia,NA,Kurgan Oblast,845537,1,0,56,0
2020-05-07,Russia,NA,Kurgan Oblast,845537,5,0,61,0
2020-05-08,Russia,NA,Kurgan Oblast,845537,4,0,65,0
2020-05-09,Russia,NA,Kurgan Oblast,845537,6,0,71,0
2020-05-10,Russia,NA,Kurgan Oblast,845537,2,0,73,0
2020-05-11,Russia,NA,Kurgan Oblast,845537,6,0,79,0
2020-05-12,Russia,NA,Kurgan Oblast,845537,5,0,84,0
2020-05-13,Russia,NA,Kurgan Oblast,845537,2,0,86,0
2020-05-14,Russia,NA,Kurgan Oblast,845537,9,0,95,0
2020-05-15,Russia,NA,Kurgan Oblast,845537,8,0,103,0
2020-05-16,Russia,NA,Kurgan Oblast,845537,6,0,109,0
2020-05-17,Russia,NA,Kurgan Oblast,845537,2,0,111,0
2020-05-18,Russia,NA,Kurgan Oblast,845537,8,0,119,0
2020-05-19,Russia,NA,Kurgan Oblast,845537,11,0,130,0
2020-05-20,Russia,NA,Kurgan Oblast,845537,3,0,133,0
2020-05-21,Russia,NA,Kurgan Oblast,845537,17,0,150,0
2020-05-22,Russia,NA,Kurgan Oblast,845537,19,0,169,0
2020-05-23,Russia,NA,Kurgan Oblast,845537,8,0,177,0
2020-05-24,Russia,NA,Kurgan Oblast,845537,2,0,179,0
2020-05-25,Russia,NA,Kurgan Oblast,845537,4,0,183,0
2020-05-26,Russia,NA,Kurgan Oblast,845537,6,0,189,0
2020-05-27,Russia,NA,Kurgan Oblast,845537,3,0,192,0
2020-05-28,Russia,NA,Kurgan Oblast,845537,7,0,199,0
2020-05-29,Russia,NA,Kurgan Oblast,845537,3,0,202,0
2020-05-30,Russia,NA,Kurgan Oblast,845537,16,0,218,0
2020-05-31,Russia,NA,Kurgan Oblast,845537,13,0,231,0
2020-06-01,Russia,NA,Kurgan Oblast,845537,14,0,245,0
2020-06-02,Russia,NA,Kurgan Oblast,845537,7,0,252,0
2020-06-03,Russia,NA,Kurgan Oblast,845537,3,0,255,0
2020-06-04,Russia,NA,Kurgan Oblast,845537,4,0,259,0
2020-06-05,Russia,NA,Kurgan Oblast,845537,9,0,268,0
2020-06-06,Russia,NA,Kurgan Oblast,845537,12,0,280,0
2020-06-07,Russia,NA,Kurgan Oblast,845537,8,0,288,0
2020-06-08,Russia,NA,Kurgan Oblast,845537,18,0,306,0
2020-06-09,Russia,NA,Kurgan Oblast,845537,8,0,314,0
2020-06-10,Russia,NA,Kurgan Oblast,845537,16,0,330,0
2020-06-11,Russia,NA,Kurgan Oblast,845537,14,0,344,0
2020-06-12,Russia,NA,Kurgan Oblast,845537,11,0,355,0
2020-06-13,Russia,NA,Kurgan Oblast,845537,14,0,369,0
2020-06-14,Russia,NA,Kurgan Oblast,845537,15,0,384,0
2020-06-15,Russia,NA,Kurgan Oblast,845537,20,0,404,0
2020-06-16,Russia,NA,Kurgan Oblast,845537,9,0,413,0
2020-06-17,Russia,NA,Kurgan Oblast,845537,9,0,422,0
2020-06-18,Russia,NA,Kurgan Oblast,845537,19,0,441,0
2020-06-19,Russia,NA,Kurgan Oblast,845537,32,0,473,0
2020-06-20,Russia,NA,Kurgan Oblast,845537,28,0,501,0
2020-06-21,Russia,NA,Kurgan Oblast,845537,27,0,528,0
2020-06-22,Russia,NA,Kurgan Oblast,845537,43,0,571,0
2020-06-23,Russia,NA,Kurgan Oblast,845537,20,0,591,0
2020-06-24,Russia,NA,Kurgan Oblast,845537,34,0,625,0
2020-06-25,Russia,NA,Kurgan Oblast,845537,35,0,660,0
2020-06-26,Russia,NA,Kurgan Oblast,845537,19,0,679,0
2020-06-27,Russia,NA,Kurgan Oblast,845537,21,0,700,0
2020-06-28,Russia,NA,Kurgan Oblast,845537,39,0,739,0
2020-06-29,Russia,NA,Kurgan Oblast,845537,14,0,753,0
2020-06-30,Russia,NA,Kurgan Oblast,845537,33,0,786,0
2020-07-01,Russia,NA,Kurgan Oblast,845537,8,0,794,0
2020-07-02,Russia,NA,Kurgan Oblast,845537,40,0,834,0
2020-07-03,Russia,NA,Kurgan Oblast,845537,30,0,864,0
2020-07-04,Russia,NA,Kurgan Oblast,845537,41,0,905,0
2020-07-05,Russia,NA,Kurgan Oblast,845537,42,0,947,0
2020-07-06,Russia,NA,Kurgan Oblast,845537,53,0,1000,0
2020-07-07,Russia,NA,Kurgan Oblast,845537,58,0,1058,0
2020-07-08,Russia,NA,Kurgan Oblast,845537,61,0,1119,0
2020-07-09,Russia,NA,Kurgan Oblast,845537,61,0,1180,0
2020-07-10,Russia,NA,Kurgan Oblast,845537,60,0,1240,0
2020-07-11,Russia,NA,Kurgan Oblast,845537,63,0,1303,0
2020-07-12,Russia,NA,Kurgan Oblast,845537,65,0,1368,0
2020-07-13,Russia,NA,Kurgan Oblast,845537,64,0,1432,0
2020-07-14,Russia,NA,Kurgan Oblast,845537,58,0,1490,0
2020-07-15,Russia,NA,Kurgan Oblast,845537,56,0,1546,0
2020-07-16,Russia,NA,Kurgan Oblast,845537,55,0,1601,0
2020-07-17,Russia,NA,Kurgan Oblast,845537,52,0,1653,0
2020-07-18,Russia,NA,Kurgan Oblast,845537,50,0,1703,0
2020-07-19,Russia,NA,Kurgan Oblast,845537,49,0,1752,0
2020-07-20,Russia,NA,Kurgan Oblast,845537,51,0,1803,0
2020-07-21,Russia,NA,Kurgan Oblast,845537,47,0,1850,0
2020-07-22,Russia,NA,Kurgan Oblast,845537,44,0,1894,0
2020-07-23,Russia,NA,Kurgan Oblast,845537,42,0,1936,0
2020-07-24,Russia,NA,Kurgan Oblast,845537,43,0,1979,0
2020-07-25,Russia,NA,Kurgan Oblast,845537,38,0,2017,0
2020-07-26,Russia,NA,Kurgan Oblast,845537,38,0,2055,0
2020-07-27,Russia,NA,Kurgan Oblast,845537,36,0,2091,0
2020-07-28,Russia,NA,Kurgan Oblast,845537,35,0,2126,0
2020-07-29,Russia,NA,Kurgan Oblast,845537,37,0,2163,0
2020-07-30,Russia,NA,Kurgan Oblast,845537,36,0,2199,0
2020-07-31,Russia,NA,Kurgan Oblast,845537,35,0,2234,0
2020-08-01,Russia,NA,Kurgan Oblast,845537,33,0,2267,0
2020-08-02,Russia,NA,Kurgan Oblast,845537,36,0,2303,0
2020-08-26,Russia,NA,Kurgan Oblast,845537,0,0,2870,17
2020-08-27,Russia,NA,Kurgan Oblast,845537,21,0,2891,17
2020-08-28,Russia,NA,Kurgan Oblast,845537,23,0,2914,17
2020-08-29,Russia,NA,Kurgan Oblast,845537,20,0,2934,17
2020-08-30,Russia,NA,Kurgan Oblast,845537,23,0,2957,17
2020-08-31,Russia,NA,Kurgan Oblast,845537,24,0,2981,17
2020-09-01,Russia,NA,Kurgan Oblast,845537,22,0,3003,17
2020-09-02,Russia,NA,Kurgan Oblast,845537,24,0,3027,17
2020-09-03,Russia,NA,Kurgan Oblast,845537,23,1,3050,18
2020-09-04,Russia,NA,Kurgan Oblast,845537,21,1,3071,19
2020-09-05,Russia,NA,Kurgan Oblast,845537,25,0,3096,19
2020-09-06,Russia,NA,Kurgan Oblast,845537,25,0,3121,19
2020-09-07,Russia,NA,Kurgan Oblast,845537,24,0,3145,19
2020-09-08,Russia,NA,Kurgan Oblast,845537,27,1,3172,20
2020-09-09,Russia,NA,Kurgan Oblast,845537,26,1,3198,21
2020-09-10,Russia,NA,Kurgan Oblast,845537,26,0,3224,21
2020-09-11,Russia,NA,Kurgan Oblast,845537,29,0,3253,21
2020-09-12,Russia,NA,Kurgan Oblast,845537,29,1,3282,22
2020-09-13,Russia,NA,Kurgan Oblast,845537,28,0,3310,22
2020-09-14,Russia,NA,Kurgan Oblast,845537,26,0,3336,22
2020-09-15,Russia,NA,Kurgan Oblast,845537,25,1,3361,23
2020-09-16,Russia,NA,Kurgan Oblast,845537,28,1,3389,24
2020-09-17,Russia,NA,Kurgan Oblast,845537,30,0,3419,24
2020-09-18,Russia,NA,Kurgan Oblast,845537,28,1,3447,25
2020-09-19,Russia,NA,Kurgan Oblast,845537,25,1,3472,26
2020-09-20,Russia,NA,Kurgan Oblast,845537,27,0,3499,26
2020-09-21,Russia,NA,Kurgan Oblast,845537,26,0,3525,26
2020-09-22,Russia,NA,Kurgan Oblast,845537,28,1,3553,27
2020-09-23,Russia,NA,Kurgan Oblast,845537,30,1,3583,28
2020-04-09,Russia,NA,Kursk Oblast,1115237,10,0,20,0
2020-04-10,Russia,NA,Kursk Oblast,1115237,1,0,21,0
2020-04-11,Russia,NA,Kursk Oblast,1115237,21,0,42,0
2020-04-12,Russia,NA,Kursk Oblast,1115237,1,0,43,0
2020-04-13,Russia,NA,Kursk Oblast,1115237,15,0,58,0
2020-04-15,Russia,NA,Kursk Oblast,1115237,31,0,89,0
2020-04-16,Russia,NA,Kursk Oblast,1115237,31,0,120,0
2020-04-17,Russia,NA,Kursk Oblast,1115237,25,0,145,0
2020-04-18,Russia,NA,Kursk Oblast,1115237,25,0,170,0
2020-04-19,Russia,NA,Kursk Oblast,1115237,26,0,196,0
2020-04-20,Russia,NA,Kursk Oblast,1115237,24,0,220,0
2020-04-21,Russia,NA,Kursk Oblast,1115237,22,0,242,0
2020-04-22,Russia,NA,Kursk Oblast,1115237,34,0,276,0
2020-04-23,Russia,NA,Kursk Oblast,1115237,32,0,308,0
2020-04-24,Russia,NA,Kursk Oblast,1115237,37,0,345,0
2020-04-25,Russia,NA,Kursk Oblast,1115237,44,0,389,0
2020-04-26,Russia,NA,Kursk Oblast,1115237,67,0,456,0
2020-04-27,Russia,NA,Kursk Oblast,1115237,69,0,525,0
2020-04-28,Russia,NA,Kursk Oblast,1115237,65,0,590,0
2020-04-29,Russia,NA,Kursk Oblast,1115237,68,0,658,0
2020-04-30,Russia,NA,Kursk Oblast,1115237,68,0,726,0
2020-05-01,Russia,NA,Kursk Oblast,1115237,66,0,792,0
2020-05-02,Russia,NA,Kursk Oblast,1115237,69,0,861,0
2020-05-03,Russia,NA,Kursk Oblast,1115237,67,0,928,0
2020-05-04,Russia,NA,Kursk Oblast,1115237,69,0,997,0
2020-05-05,Russia,NA,Kursk Oblast,1115237,65,0,1062,0
2020-05-06,Russia,NA,Kursk Oblast,1115237,67,0,1129,0
2020-05-07,Russia,NA,Kursk Oblast,1115237,68,0,1197,0
2020-05-08,Russia,NA,Kursk Oblast,1115237,71,0,1268,0
2020-05-09,Russia,NA,Kursk Oblast,1115237,71,0,1339,0
2020-05-10,Russia,NA,Kursk Oblast,1115237,71,0,1410,0
2020-05-11,Russia,NA,Kursk Oblast,1115237,74,0,1484,0
2020-05-12,Russia,NA,Kursk Oblast,1115237,70,0,1554,0
2020-05-13,Russia,NA,Kursk Oblast,1115237,67,0,1621,0
2020-05-14,Russia,NA,Kursk Oblast,1115237,76,0,1697,0
2020-05-15,Russia,NA,Kursk Oblast,1115237,80,0,1777,0
2020-05-16,Russia,NA,Kursk Oblast,1115237,78,0,1855,0
2020-05-17,Russia,NA,Kursk Oblast,1115237,81,0,1936,0
2020-05-18,Russia,NA,Kursk Oblast,1115237,79,0,2015,0
2020-05-19,Russia,NA,Kursk Oblast,1115237,80,0,2095,0
2020-05-20,Russia,NA,Kursk Oblast,1115237,82,0,2177,0
2020-05-21,Russia,NA,Kursk Oblast,1115237,81,0,2258,0
2020-05-22,Russia,NA,Kursk Oblast,1115237,81,0,2339,0
2020-05-23,Russia,NA,Kursk Oblast,1115237,83,0,2422,0
2020-05-24,Russia,NA,Kursk Oblast,1115237,85,0,2507,0
2020-05-25,Russia,NA,Kursk Oblast,1115237,74,0,2581,0
2020-05-26,Russia,NA,Kursk Oblast,1115237,67,0,2648,0
2020-05-27,Russia,NA,Kursk Oblast,1115237,71,0,2719,0
2020-05-28,Russia,NA,Kursk Oblast,1115237,68,0,2787,0
2020-05-29,Russia,NA,Kursk Oblast,1115237,64,0,2851,0
2020-05-30,Russia,NA,Kursk Oblast,1115237,71,0,2922,0
2020-05-31,Russia,NA,Kursk Oblast,1115237,78,0,3000,0
2020-06-01,Russia,NA,Kursk Oblast,1115237,63,0,3063,0
2020-06-02,Russia,NA,Kursk Oblast,1115237,60,0,3123,0
2020-06-03,Russia,NA,Kursk Oblast,1115237,76,0,3199,0
2020-06-04,Russia,NA,Kursk Oblast,1115237,73,0,3272,0
2020-06-05,Russia,NA,Kursk Oblast,1115237,85,0,3357,0
2020-06-06,Russia,NA,Kursk Oblast,1115237,68,0,3425,0
2020-06-07,Russia,NA,Kursk Oblast,1115237,76,0,3501,0
2020-06-08,Russia,NA,Kursk Oblast,1115237,60,0,3561,0
2020-06-09,Russia,NA,Kursk Oblast,1115237,58,0,3619,0
2020-06-10,Russia,NA,Kursk Oblast,1115237,71,0,3690,0
2020-06-11,Russia,NA,Kursk Oblast,1115237,79,0,3769,0
2020-06-12,Russia,NA,Kursk Oblast,1115237,70,0,3839,0
2020-06-13,Russia,NA,Kursk Oblast,1115237,83,0,3922,0
2020-06-14,Russia,NA,Kursk Oblast,1115237,72,0,3994,0
2020-06-15,Russia,NA,Kursk Oblast,1115237,64,0,4058,0
2020-06-16,Russia,NA,Kursk Oblast,1115237,60,0,4118,0
2020-06-17,Russia,NA,Kursk Oblast,1115237,63,0,4181,0
2020-06-18,Russia,NA,Kursk Oblast,1115237,75,0,4256,0
2020-06-19,Russia,NA,Kursk Oblast,1115237,77,0,4333,0
2020-06-20,Russia,NA,Kursk Oblast,1115237,70,0,4403,0
2020-06-21,Russia,NA,Kursk Oblast,1115237,79,0,4482,0
2020-06-22,Russia,NA,Kursk Oblast,1115237,68,0,4550,0
2020-06-23,Russia,NA,Kursk Oblast,1115237,57,0,4607,0
2020-06-24,Russia,NA,Kursk Oblast,1115237,66,0,4673,0
2020-06-25,Russia,NA,Kursk Oblast,1115237,74,0,4747,0
2020-06-26,Russia,NA,Kursk Oblast,1115237,70,0,4817,0
2020-06-27,Russia,NA,Kursk Oblast,1115237,65,0,4882,0
2020-06-28,Russia,NA,Kursk Oblast,1115237,76,0,4958,0
2020-06-29,Russia,NA,Kursk Oblast,1115237,63,0,5021,0
2020-06-30,Russia,NA,Kursk Oblast,1115237,59,0,5080,0
2020-07-01,Russia,NA,Kursk Oblast,1115237,58,0,5138,0
2020-07-02,Russia,NA,Kursk Oblast,1115237,55,0,5193,0
2020-07-03,Russia,NA,Kursk Oblast,1115237,50,0,5243,0
2020-07-04,Russia,NA,Kursk Oblast,1115237,51,0,5294,0
2020-07-05,Russia,NA,Kursk Oblast,1115237,46,0,5340,0
2020-07-06,Russia,NA,Kursk Oblast,1115237,43,0,5383,0
2020-07-07,Russia,NA,Kursk Oblast,1115237,39,0,5422,0
2020-07-08,Russia,NA,Kursk Oblast,1115237,44,0,5466,0
2020-07-09,Russia,NA,Kursk Oblast,1115237,48,0,5514,0
2020-07-10,Russia,NA,Kursk Oblast,1115237,46,0,5560,0
2020-07-11,Russia,NA,Kursk Oblast,1115237,40,0,5600,0
2020-07-12,Russia,NA,Kursk Oblast,1115237,34,0,5634,0
2020-07-13,Russia,NA,Kursk Oblast,1115237,32,0,5666,0
2020-07-14,Russia,NA,Kursk Oblast,1115237,35,0,5701,0
2020-07-15,Russia,NA,Kursk Oblast,1115237,33,0,5734,0
2020-07-16,Russia,NA,Kursk Oblast,1115237,31,0,5765,0
2020-07-17,Russia,NA,Kursk Oblast,1115237,34,0,5799,0
2020-07-18,Russia,NA,Kursk Oblast,1115237,29,0,5828,0
2020-07-19,Russia,NA,Kursk Oblast,1115237,33,0,5861,0
2020-07-20,Russia,NA,Kursk Oblast,1115237,32,0,5893,0
2020-07-21,Russia,NA,Kursk Oblast,1115237,28,0,5921,0
2020-07-22,Russia,NA,Kursk Oblast,1115237,36,0,5957,0
2020-07-23,Russia,NA,Kursk Oblast,1115237,34,0,5991,0
2020-07-24,Russia,NA,Kursk Oblast,1115237,35,0,6026,0
2020-07-25,Russia,NA,Kursk Oblast,1115237,30,0,6056,0
2020-07-26,Russia,NA,Kursk Oblast,1115237,31,0,6087,0
2020-07-27,Russia,NA,Kursk Oblast,1115237,29,0,6116,0
2020-07-28,Russia,NA,Kursk Oblast,1115237,21,0,6137,0
2020-07-29,Russia,NA,Kursk Oblast,1115237,25,0,6162,0
2020-07-30,Russia,NA,Kursk Oblast,1115237,27,0,6189,0
2020-07-31,Russia,NA,Kursk Oblast,1115237,26,0,6215,0
2020-08-01,Russia,NA,Kursk Oblast,1115237,25,0,6240,0
2020-08-02,Russia,NA,Kursk Oblast,1115237,30,0,6270,0
2020-08-26,Russia,NA,Kursk Oblast,1115237,0,0,6975,53
2020-08-27,Russia,NA,Kursk Oblast,1115237,33,0,7008,53
2020-08-28,Russia,NA,Kursk Oblast,1115237,33,0,7041,53
2020-08-29,Russia,NA,Kursk Oblast,1115237,31,0,7072,53
2020-08-30,Russia,NA,Kursk Oblast,1115237,23,0,7095,53
2020-08-31,Russia,NA,Kursk Oblast,1115237,25,0,7120,53
2020-09-01,Russia,NA,Kursk Oblast,1115237,25,0,7145,53
2020-09-02,Russia,NA,Kursk Oblast,1115237,32,0,7177,53
2020-09-03,Russia,NA,Kursk Oblast,1115237,28,1,7205,54
2020-09-04,Russia,NA,Kursk Oblast,1115237,35,0,7240,54
2020-09-05,Russia,NA,Kursk Oblast,1115237,29,0,7269,54
2020-09-06,Russia,NA,Kursk Oblast,1115237,22,0,7291,54
2020-09-07,Russia,NA,Kursk Oblast,1115237,24,0,7315,54
2020-09-08,Russia,NA,Kursk Oblast,1115237,28,0,7343,54
2020-09-09,Russia,NA,Kursk Oblast,1115237,29,0,7372,54
2020-09-10,Russia,NA,Kursk Oblast,1115237,33,0,7405,54
2020-09-11,Russia,NA,Kursk Oblast,1115237,38,0,7443,54
2020-09-12,Russia,NA,Kursk Oblast,1115237,36,0,7479,54
2020-09-13,Russia,NA,Kursk Oblast,1115237,27,0,7506,54
2020-09-14,Russia,NA,Kursk Oblast,1115237,23,0,7529,54
2020-09-15,Russia,NA,Kursk Oblast,1115237,29,1,7558,55
2020-09-16,Russia,NA,Kursk Oblast,1115237,28,1,7586,56
2020-09-17,Russia,NA,Kursk Oblast,1115237,32,0,7618,56
2020-09-18,Russia,NA,Kursk Oblast,1115237,33,0,7651,56
2020-09-19,Russia,NA,Kursk Oblast,1115237,31,0,7682,56
2020-09-20,Russia,NA,Kursk Oblast,1115237,27,0,7709,56
2020-09-21,Russia,NA,Kursk Oblast,1115237,26,0,7735,56
2020-09-22,Russia,NA,Kursk Oblast,1115237,29,0,7764,56
2020-09-23,Russia,NA,Kursk Oblast,1115237,37,0,7801,56
2020-03-30,Russia,NA,Leningrad Oblast,1813816,2,0,11,0
2020-03-31,Russia,NA,Leningrad Oblast,1813816,3,0,14,0
2020-04-01,Russia,NA,Leningrad Oblast,1813816,6,0,20,0
2020-04-02,Russia,NA,Leningrad Oblast,1813816,11,0,31,0
2020-04-03,Russia,NA,Leningrad Oblast,1813816,10,0,41,0
2020-04-04,Russia,NA,Leningrad Oblast,1813816,6,0,47,0
2020-04-05,Russia,NA,Leningrad Oblast,1813816,10,0,57,0
2020-04-06,Russia,NA,Leningrad Oblast,1813816,5,0,62,0
2020-04-08,Russia,NA,Leningrad Oblast,1813816,32,0,94,0
2020-04-09,Russia,NA,Leningrad Oblast,1813816,18,0,112,0
2020-04-10,Russia,NA,Leningrad Oblast,1813816,17,0,129,0
2020-04-11,Russia,NA,Leningrad Oblast,1813816,5,0,134,0
2020-04-12,Russia,NA,Leningrad Oblast,1813816,5,0,139,0
2020-04-13,Russia,NA,Leningrad Oblast,1813816,16,0,155,0
2020-04-14,Russia,NA,Leningrad Oblast,1813816,35,0,190,0
2020-04-15,Russia,NA,Leningrad Oblast,1813816,108,0,298,0
2020-04-16,Russia,NA,Leningrad Oblast,1813816,32,0,330,0
2020-04-17,Russia,NA,Leningrad Oblast,1813816,24,0,354,0
2020-04-18,Russia,NA,Leningrad Oblast,1813816,34,0,388,0
2020-04-19,Russia,NA,Leningrad Oblast,1813816,29,0,417,0
2020-04-20,Russia,NA,Leningrad Oblast,1813816,37,0,454,0
2020-04-21,Russia,NA,Leningrad Oblast,1813816,42,0,496,0
2020-04-22,Russia,NA,Leningrad Oblast,1813816,41,0,537,0
2020-04-23,Russia,NA,Leningrad Oblast,1813816,39,0,576,0
2020-04-24,Russia,NA,Leningrad Oblast,1813816,39,0,615,0
2020-04-25,Russia,NA,Leningrad Oblast,1813816,43,0,658,0
2020-04-26,Russia,NA,Leningrad Oblast,1813816,42,0,700,0
2020-04-27,Russia,NA,Leningrad Oblast,1813816,43,0,743,0
2020-04-29,Russia,NA,Leningrad Oblast,1813816,53,0,796,0
2020-04-30,Russia,NA,Leningrad Oblast,1813816,51,0,847,0
2020-05-01,Russia,NA,Leningrad Oblast,1813816,44,0,891,0
2020-05-02,Russia,NA,Leningrad Oblast,1813816,46,0,937,0
2020-05-03,Russia,NA,Leningrad Oblast,1813816,62,0,999,0
2020-05-04,Russia,NA,Leningrad Oblast,1813816,59,0,1058,0
2020-05-05,Russia,NA,Leningrad Oblast,1813816,53,0,1111,0
2020-05-06,Russia,NA,Leningrad Oblast,1813816,51,0,1162,0
2020-05-07,Russia,NA,Leningrad Oblast,1813816,63,0,1225,0
2020-05-08,Russia,NA,Leningrad Oblast,1813816,91,0,1316,0
2020-05-09,Russia,NA,Leningrad Oblast,1813816,79,0,1395,0
2020-05-10,Russia,NA,Leningrad Oblast,1813816,67,0,1462,0
2020-05-11,Russia,NA,Leningrad Oblast,1813816,66,0,1528,0
2020-05-12,Russia,NA,Leningrad Oblast,1813816,74,0,1602,0
2020-05-13,Russia,NA,Leningrad Oblast,1813816,66,0,1668,0
2020-05-14,Russia,NA,Leningrad Oblast,1813816,69,0,1737,0
2020-05-15,Russia,NA,Leningrad Oblast,1813816,66,0,1803,0
2020-05-16,Russia,NA,Leningrad Oblast,1813816,72,0,1875,0
2020-05-17,Russia,NA,Leningrad Oblast,1813816,69,0,1944,0
2020-05-18,Russia,NA,Leningrad Oblast,1813816,70,0,2014,0
2020-05-19,Russia,NA,Leningrad Oblast,1813816,81,0,2095,0
2020-05-20,Russia,NA,Leningrad Oblast,1813816,75,0,2170,0
2020-05-21,Russia,NA,Leningrad Oblast,1813816,61,0,2231,0
2020-05-22,Russia,NA,Leningrad Oblast,1813816,54,0,2285,0
2020-05-23,Russia,NA,Leningrad Oblast,1813816,57,0,2342,0
2020-05-24,Russia,NA,Leningrad Oblast,1813816,57,0,2399,0
2020-05-25,Russia,NA,Leningrad Oblast,1813816,58,0,2457,0
2020-05-26,Russia,NA,Leningrad Oblast,1813816,58,0,2515,0
2020-05-27,Russia,NA,Leningrad Oblast,1813816,56,0,2571,0
2020-05-28,Russia,NA,Leningrad Oblast,1813816,51,0,2622,0
2020-05-29,Russia,NA,Leningrad Oblast,1813816,53,0,2675,0
2020-05-30,Russia,NA,Leningrad Oblast,1813816,55,0,2730,0
2020-05-31,Russia,NA,Leningrad Oblast,1813816,54,0,2784,0
2020-06-01,Russia,NA,Leningrad Oblast,1813816,53,0,2837,0
2020-06-02,Russia,NA,Leningrad Oblast,1813816,53,0,2890,0
2020-06-03,Russia,NA,Leningrad Oblast,1813816,54,0,2944,0
2020-06-04,Russia,NA,Leningrad Oblast,1813816,52,0,2996,0
2020-06-05,Russia,NA,Leningrad Oblast,1813816,52,0,3048,0
2020-06-06,Russia,NA,Leningrad Oblast,1813816,51,0,3099,0
2020-06-07,Russia,NA,Leningrad Oblast,1813816,51,0,3150,0
2020-06-08,Russia,NA,Leningrad Oblast,1813816,50,0,3200,0
2020-06-09,Russia,NA,Leningrad Oblast,1813816,49,0,3249,0
2020-06-10,Russia,NA,Leningrad Oblast,1813816,55,0,3304,0
2020-06-11,Russia,NA,Leningrad Oblast,1813816,54,0,3358,0
2020-06-12,Russia,NA,Leningrad Oblast,1813816,52,0,3410,0
2020-06-13,Russia,NA,Leningrad Oblast,1813816,53,0,3463,0
2020-06-14,Russia,NA,Leningrad Oblast,1813816,52,0,3515,0
2020-06-15,Russia,NA,Leningrad Oblast,1813816,73,0,3588,0
2020-06-16,Russia,NA,Leningrad Oblast,1813816,70,0,3658,0
2020-06-17,Russia,NA,Leningrad Oblast,1813816,55,0,3713,0
2020-06-18,Russia,NA,Leningrad Oblast,1813816,54,0,3767,0
2020-06-19,Russia,NA,Leningrad Oblast,1813816,53,0,3820,0
2020-06-20,Russia,NA,Leningrad Oblast,1813816,54,0,3874,0
2020-06-21,Russia,NA,Leningrad Oblast,1813816,52,0,3926,0
2020-06-22,Russia,NA,Leningrad Oblast,1813816,52,0,3978,0
2020-06-23,Russia,NA,Leningrad Oblast,1813816,51,0,4029,0
2020-06-24,Russia,NA,Leningrad Oblast,1813816,52,0,4081,0
2020-06-25,Russia,NA,Leningrad Oblast,1813816,51,0,4132,0
2020-06-26,Russia,NA,Leningrad Oblast,1813816,50,0,4182,0
2020-06-27,Russia,NA,Leningrad Oblast,1813816,51,0,4233,0
2020-06-28,Russia,NA,Leningrad Oblast,1813816,50,0,4283,0
2020-06-29,Russia,NA,Leningrad Oblast,1813816,49,0,4332,0
2020-06-30,Russia,NA,Leningrad Oblast,1813816,50,0,4382,0
2020-07-01,Russia,NA,Leningrad Oblast,1813816,53,0,4435,0
2020-07-02,Russia,NA,Leningrad Oblast,1813816,57,0,4492,0
2020-07-03,Russia,NA,Leningrad Oblast,1813816,54,0,4546,0
2020-07-04,Russia,NA,Leningrad Oblast,1813816,51,0,4597,0
2020-07-05,Russia,NA,Leningrad Oblast,1813816,53,0,4650,0
2020-07-06,Russia,NA,Leningrad Oblast,1813816,52,0,4702,0
2020-07-07,Russia,NA,Leningrad Oblast,1813816,52,0,4754,0
2020-07-08,Russia,NA,Leningrad Oblast,1813816,50,0,4804,0
2020-07-09,Russia,NA,Leningrad Oblast,1813816,50,0,4854,0
2020-07-10,Russia,NA,Leningrad Oblast,1813816,50,0,4904,0
2020-07-11,Russia,NA,Leningrad Oblast,1813816,47,0,4951,0
2020-07-12,Russia,NA,Leningrad Oblast,1813816,48,0,4999,0
2020-07-13,Russia,NA,Leningrad Oblast,1813816,47,0,5046,0
2020-07-14,Russia,NA,Leningrad Oblast,1813816,46,0,5092,0
2020-07-15,Russia,NA,Leningrad Oblast,1813816,47,0,5139,0
2020-07-16,Russia,NA,Leningrad Oblast,1813816,47,0,5186,0
2020-07-17,Russia,NA,Leningrad Oblast,1813816,45,0,5231,0
2020-07-18,Russia,NA,Leningrad Oblast,1813816,46,0,5277,0
2020-07-19,Russia,NA,Leningrad Oblast,1813816,45,0,5322,0
2020-07-20,Russia,NA,Leningrad Oblast,1813816,45,0,5367,0
2020-07-21,Russia,NA,Leningrad Oblast,1813816,44,0,5411,0
2020-07-22,Russia,NA,Leningrad Oblast,1813816,44,0,5455,0
2020-07-23,Russia,NA,Leningrad Oblast,1813816,45,0,5500,0
2020-07-24,Russia,NA,Leningrad Oblast,1813816,45,0,5545,0
2020-07-25,Russia,NA,Leningrad Oblast,1813816,43,0,5588,0
2020-07-26,Russia,NA,Leningrad Oblast,1813816,43,0,5631,0
2020-07-27,Russia,NA,Leningrad Oblast,1813816,41,0,5672,0
2020-07-28,Russia,NA,Leningrad Oblast,1813816,47,0,5719,0
2020-07-29,Russia,NA,Leningrad Oblast,1813816,40,0,5759,0
2020-07-30,Russia,NA,Leningrad Oblast,1813816,40,0,5799,0
2020-07-31,Russia,NA,Leningrad Oblast,1813816,39,0,5838,0
2020-08-01,Russia,NA,Leningrad Oblast,1813816,40,0,5878,0
2020-08-02,Russia,NA,Leningrad Oblast,1813816,39,0,5917,0
2020-08-26,Russia,NA,Leningrad Oblast,1813816,0,0,6656,74
2020-08-27,Russia,NA,Leningrad Oblast,1813816,29,5,6685,79
2020-08-28,Russia,NA,Leningrad Oblast,1813816,31,0,6716,79
2020-08-29,Russia,NA,Leningrad Oblast,1813816,31,0,6747,79
2020-08-30,Russia,NA,Leningrad Oblast,1813816,32,0,6779,79
2020-08-31,Russia,NA,Leningrad Oblast,1813816,32,0,6811,79
2020-09-01,Russia,NA,Leningrad Oblast,1813816,31,0,6842,79
2020-09-02,Russia,NA,Leningrad Oblast,1813816,35,1,6877,80
2020-09-03,Russia,NA,Leningrad Oblast,1813816,34,0,6911,80
2020-09-04,Russia,NA,Leningrad Oblast,1813816,33,2,6944,82
2020-09-05,Russia,NA,Leningrad Oblast,1813816,34,0,6978,82
2020-09-06,Russia,NA,Leningrad Oblast,1813816,35,1,7013,83
2020-09-07,Russia,NA,Leningrad Oblast,1813816,36,0,7049,83
2020-09-08,Russia,NA,Leningrad Oblast,1813816,37,2,7086,85
2020-09-09,Russia,NA,Leningrad Oblast,1813816,35,1,7121,86
2020-09-10,Russia,NA,Leningrad Oblast,1813816,35,0,7156,86
2020-09-11,Russia,NA,Leningrad Oblast,1813816,36,0,7192,86
2020-09-12,Russia,NA,Leningrad Oblast,1813816,36,0,7228,86
2020-09-13,Russia,NA,Leningrad Oblast,1813816,37,0,7265,86
2020-09-14,Russia,NA,Leningrad Oblast,1813816,36,1,7301,87
2020-09-15,Russia,NA,Leningrad Oblast,1813816,38,3,7339,90
2020-09-16,Russia,NA,Leningrad Oblast,1813816,39,1,7378,91
2020-09-17,Russia,NA,Leningrad Oblast,1813816,46,0,7424,91
2020-09-18,Russia,NA,Leningrad Oblast,1813816,44,0,7468,91
2020-09-19,Russia,NA,Leningrad Oblast,1813816,51,0,7519,91
2020-09-20,Russia,NA,Leningrad Oblast,1813816,50,0,7569,91
2020-09-21,Russia,NA,Leningrad Oblast,1813816,52,0,7621,91
2020-09-22,Russia,NA,Leningrad Oblast,1813816,56,4,7677,95
2020-09-23,Russia,NA,Leningrad Oblast,1813816,55,1,7732,96
2020-04-01,Russia,NA,Lipetsk Oblast,1150201,1,0,11,0
2020-04-02,Russia,NA,Lipetsk Oblast,1150201,4,0,15,0
2020-04-03,Russia,NA,Lipetsk Oblast,1150201,3,0,18,0
2020-04-06,Russia,NA,Lipetsk Oblast,1150201,8,0,26,0
2020-04-08,Russia,NA,Lipetsk Oblast,1150201,18,0,44,0
2020-04-09,Russia,NA,Lipetsk Oblast,1150201,4,0,48,0
2020-04-10,Russia,NA,Lipetsk Oblast,1150201,7,0,55,0
2020-04-11,Russia,NA,Lipetsk Oblast,1150201,3,0,58,0
2020-04-12,Russia,NA,Lipetsk Oblast,1150201,5,0,63,0
2020-04-13,Russia,NA,Lipetsk Oblast,1150201,6,0,69,0
2020-04-14,Russia,NA,Lipetsk Oblast,1150201,5,0,74,0
2020-04-15,Russia,NA,Lipetsk Oblast,1150201,11,0,85,0
2020-04-16,Russia,NA,Lipetsk Oblast,1150201,11,0,96,0
2020-04-17,Russia,NA,Lipetsk Oblast,1150201,12,0,108,0
2020-04-18,Russia,NA,Lipetsk Oblast,1150201,21,0,129,0
2020-04-19,Russia,NA,Lipetsk Oblast,1150201,20,0,149,0
2020-04-20,Russia,NA,Lipetsk Oblast,1150201,20,0,169,0
2020-04-21,Russia,NA,Lipetsk Oblast,1150201,20,0,189,0
2020-04-22,Russia,NA,Lipetsk Oblast,1150201,24,0,213,0
2020-04-23,Russia,NA,Lipetsk Oblast,1150201,25,0,238,0
2020-04-24,Russia,NA,Lipetsk Oblast,1150201,25,0,263,0
2020-04-25,Russia,NA,Lipetsk Oblast,1150201,21,0,284,0
2020-04-26,Russia,NA,Lipetsk Oblast,1150201,22,0,306,0
2020-04-27,Russia,NA,Lipetsk Oblast,1150201,24,0,330,0
2020-04-28,Russia,NA,Lipetsk Oblast,1150201,26,0,356,0
2020-04-29,Russia,NA,Lipetsk Oblast,1150201,28,0,384,0
2020-04-30,Russia,NA,Lipetsk Oblast,1150201,31,0,415,0
2020-05-01,Russia,NA,Lipetsk Oblast,1150201,31,0,446,0
2020-05-02,Russia,NA,Lipetsk Oblast,1150201,35,0,481,0
2020-05-03,Russia,NA,Lipetsk Oblast,1150201,39,0,520,0
2020-05-04,Russia,NA,Lipetsk Oblast,1150201,43,0,563,0
2020-05-05,Russia,NA,Lipetsk Oblast,1150201,47,0,610,0
2020-05-06,Russia,NA,Lipetsk Oblast,1150201,46,0,656,0
2020-05-07,Russia,NA,Lipetsk Oblast,1150201,47,0,703,0
2020-05-08,Russia,NA,Lipetsk Oblast,1150201,49,0,752,0
2020-05-09,Russia,NA,Lipetsk Oblast,1150201,49,0,801,0
2020-05-10,Russia,NA,Lipetsk Oblast,1150201,48,0,849,0
2020-05-11,Russia,NA,Lipetsk Oblast,1150201,48,0,897,0
2020-05-12,Russia,NA,Lipetsk Oblast,1150201,47,0,944,0
2020-05-13,Russia,NA,Lipetsk Oblast,1150201,46,0,990,0
2020-05-14,Russia,NA,Lipetsk Oblast,1150201,46,0,1036,0
2020-05-15,Russia,NA,Lipetsk Oblast,1150201,47,0,1083,0
2020-05-16,Russia,NA,Lipetsk Oblast,1150201,50,0,1133,0
2020-05-17,Russia,NA,Lipetsk Oblast,1150201,53,0,1186,0
2020-05-18,Russia,NA,Lipetsk Oblast,1150201,54,0,1240,0
2020-05-19,Russia,NA,Lipetsk Oblast,1150201,58,0,1298,0
2020-05-20,Russia,NA,Lipetsk Oblast,1150201,79,0,1377,0
2020-05-21,Russia,NA,Lipetsk Oblast,1150201,62,0,1439,0
2020-05-22,Russia,NA,Lipetsk Oblast,1150201,64,0,1503,0
2020-05-23,Russia,NA,Lipetsk Oblast,1150201,65,0,1568,0
2020-05-24,Russia,NA,Lipetsk Oblast,1150201,65,0,1633,0
2020-05-25,Russia,NA,Lipetsk Oblast,1150201,63,0,1696,0
2020-05-26,Russia,NA,Lipetsk Oblast,1150201,68,0,1764,0
2020-05-27,Russia,NA,Lipetsk Oblast,1150201,72,0,1836,0
2020-05-28,Russia,NA,Lipetsk Oblast,1150201,70,0,1906,0
2020-05-29,Russia,NA,Lipetsk Oblast,1150201,70,0,1976,0
2020-05-30,Russia,NA,Lipetsk Oblast,1150201,72,0,2048,0
2020-05-31,Russia,NA,Lipetsk Oblast,1150201,75,0,2123,0
2020-06-01,Russia,NA,Lipetsk Oblast,1150201,71,0,2194,0
2020-06-02,Russia,NA,Lipetsk Oblast,1150201,67,0,2261,0
2020-06-03,Russia,NA,Lipetsk Oblast,1150201,65,0,2326,0
2020-06-04,Russia,NA,Lipetsk Oblast,1150201,62,0,2388,0
2020-06-05,Russia,NA,Lipetsk Oblast,1150201,64,0,2452,0
2020-06-06,Russia,NA,Lipetsk Oblast,1150201,64,0,2516,0
2020-06-07,Russia,NA,Lipetsk Oblast,1150201,61,0,2577,0
2020-06-08,Russia,NA,Lipetsk Oblast,1150201,60,0,2637,0
2020-06-09,Russia,NA,Lipetsk Oblast,1150201,60,0,2697,0
2020-06-10,Russia,NA,Lipetsk Oblast,1150201,61,0,2758,0
2020-06-11,Russia,NA,Lipetsk Oblast,1150201,59,0,2817,0
2020-06-12,Russia,NA,Lipetsk Oblast,1150201,61,0,2878,0
2020-06-13,Russia,NA,Lipetsk Oblast,1150201,59,0,2937,0
2020-06-14,Russia,NA,Lipetsk Oblast,1150201,58,0,2995,0
2020-06-15,Russia,NA,Lipetsk Oblast,1150201,58,0,3053,0
2020-06-16,Russia,NA,Lipetsk Oblast,1150201,60,0,3113,0
2020-06-17,Russia,NA,Lipetsk Oblast,1150201,58,0,3171,0
2020-06-18,Russia,NA,Lipetsk Oblast,1150201,57,0,3228,0
2020-06-19,Russia,NA,Lipetsk Oblast,1150201,57,0,3285,0
2020-06-20,Russia,NA,Lipetsk Oblast,1150201,52,0,3337,0
2020-06-21,Russia,NA,Lipetsk Oblast,1150201,51,0,3388,0
2020-06-22,Russia,NA,Lipetsk Oblast,1150201,50,0,3438,0
2020-06-23,Russia,NA,Lipetsk Oblast,1150201,49,0,3487,0
2020-06-24,Russia,NA,Lipetsk Oblast,1150201,49,0,3536,0
2020-06-25,Russia,NA,Lipetsk Oblast,1150201,47,0,3583,0
2020-06-26,Russia,NA,Lipetsk Oblast,1150201,40,0,3623,0
2020-06-27,Russia,NA,Lipetsk Oblast,1150201,40,0,3663,0
2020-06-28,Russia,NA,Lipetsk Oblast,1150201,39,0,3702,0
2020-06-29,Russia,NA,Lipetsk Oblast,1150201,39,0,3741,0
2020-06-30,Russia,NA,Lipetsk Oblast,1150201,38,0,3779,0
2020-07-01,Russia,NA,Lipetsk Oblast,1150201,37,0,3816,0
2020-07-02,Russia,NA,Lipetsk Oblast,1150201,36,0,3852,0
2020-07-03,Russia,NA,Lipetsk Oblast,1150201,36,0,3888,0
2020-07-04,Russia,NA,Lipetsk Oblast,1150201,35,0,3923,0
2020-07-05,Russia,NA,Lipetsk Oblast,1150201,35,0,3958,0
2020-07-06,Russia,NA,Lipetsk Oblast,1150201,34,0,3992,0
2020-07-07,Russia,NA,Lipetsk Oblast,1150201,34,0,4026,0
2020-07-08,Russia,NA,Lipetsk Oblast,1150201,34,0,4060,0
2020-07-09,Russia,NA,Lipetsk Oblast,1150201,33,0,4093,0
2020-07-10,Russia,NA,Lipetsk Oblast,1150201,32,0,4125,0
2020-07-11,Russia,NA,Lipetsk Oblast,1150201,33,0,4158,0
2020-07-12,Russia,NA,Lipetsk Oblast,1150201,32,0,4190,0
2020-07-13,Russia,NA,Lipetsk Oblast,1150201,33,0,4223,0
2020-07-14,Russia,NA,Lipetsk Oblast,1150201,32,0,4255,0
2020-07-15,Russia,NA,Lipetsk Oblast,1150201,32,0,4287,0
2020-07-16,Russia,NA,Lipetsk Oblast,1150201,31,0,4318,0
2020-07-17,Russia,NA,Lipetsk Oblast,1150201,31,0,4349,0
2020-07-18,Russia,NA,Lipetsk Oblast,1150201,25,0,4374,0
2020-07-19,Russia,NA,Lipetsk Oblast,1150201,21,0,4395,0
2020-07-20,Russia,NA,Lipetsk Oblast,1150201,15,0,4410,0
2020-07-21,Russia,NA,Lipetsk Oblast,1150201,13,0,4423,0
2020-07-22,Russia,NA,Lipetsk Oblast,1150201,12,0,4435,0
2020-07-23,Russia,NA,Lipetsk Oblast,1150201,13,0,4448,0
2020-07-24,Russia,NA,Lipetsk Oblast,1150201,12,0,4460,0
2020-07-25,Russia,NA,Lipetsk Oblast,1150201,14,0,4474,0
2020-07-26,Russia,NA,Lipetsk Oblast,1150201,14,0,4488,0
2020-07-27,Russia,NA,Lipetsk Oblast,1150201,11,0,4499,0
2020-07-28,Russia,NA,Lipetsk Oblast,1150201,11,0,4510,0
2020-07-29,Russia,NA,Lipetsk Oblast,1150201,12,0,4522,0
2020-07-30,Russia,NA,Lipetsk Oblast,1150201,14,0,4536,0
2020-07-31,Russia,NA,Lipetsk Oblast,1150201,14,0,4550,0
2020-08-01,Russia,NA,Lipetsk Oblast,1150201,15,0,4565,0
2020-08-02,Russia,NA,Lipetsk Oblast,1150201,13,0,4578,0
2020-08-26,Russia,NA,Lipetsk Oblast,1150201,0,0,4985,25
2020-08-27,Russia,NA,Lipetsk Oblast,1150201,16,1,5001,26
2020-08-28,Russia,NA,Lipetsk Oblast,1150201,19,0,5020,26
2020-08-29,Russia,NA,Lipetsk Oblast,1150201,21,0,5041,26
2020-08-30,Russia,NA,Lipetsk Oblast,1150201,22,0,5063,26
2020-08-31,Russia,NA,Lipetsk Oblast,1150201,31,0,5094,26
2020-09-01,Russia,NA,Lipetsk Oblast,1150201,31,1,5125,27
2020-09-02,Russia,NA,Lipetsk Oblast,1150201,34,0,5159,27
2020-09-03,Russia,NA,Lipetsk Oblast,1150201,34,1,5193,28
2020-09-04,Russia,NA,Lipetsk Oblast,1150201,32,1,5225,29
2020-09-05,Russia,NA,Lipetsk Oblast,1150201,32,1,5257,30
2020-09-06,Russia,NA,Lipetsk Oblast,1150201,31,0,5288,30
2020-09-07,Russia,NA,Lipetsk Oblast,1150201,30,0,5318,30
2020-09-08,Russia,NA,Lipetsk Oblast,1150201,33,0,5351,30
2020-09-09,Russia,NA,Lipetsk Oblast,1150201,35,0,5386,30
2020-09-10,Russia,NA,Lipetsk Oblast,1150201,37,1,5423,31
2020-09-11,Russia,NA,Lipetsk Oblast,1150201,33,1,5456,32
2020-09-12,Russia,NA,Lipetsk Oblast,1150201,32,0,5488,32
2020-09-13,Russia,NA,Lipetsk Oblast,1150201,30,0,5518,32
2020-09-14,Russia,NA,Lipetsk Oblast,1150201,31,2,5549,34
2020-09-15,Russia,NA,Lipetsk Oblast,1150201,33,0,5582,34
2020-09-16,Russia,NA,Lipetsk Oblast,1150201,34,1,5616,35
2020-09-17,Russia,NA,Lipetsk Oblast,1150201,34,0,5650,35
2020-09-18,Russia,NA,Lipetsk Oblast,1150201,32,1,5682,36
2020-09-19,Russia,NA,Lipetsk Oblast,1150201,33,1,5715,37
2020-09-20,Russia,NA,Lipetsk Oblast,1150201,32,0,5747,37
2020-09-21,Russia,NA,Lipetsk Oblast,1150201,32,1,5779,38
2020-09-22,Russia,NA,Lipetsk Oblast,1150201,33,1,5812,39
2020-09-23,Russia,NA,Lipetsk Oblast,1150201,35,2,5847,41
2020-04-16,Russia,NA,Magadan Oblast,144091,15,0,18,0
2020-04-18,Russia,NA,Magadan Oblast,144091,44,0,62,0
2020-04-19,Russia,NA,Magadan Oblast,144091,1,0,63,0
2020-04-21,Russia,NA,Magadan Oblast,144091,2,0,65,0
2020-04-22,Russia,NA,Magadan Oblast,144091,2,0,67,0
2020-04-23,Russia,NA,Magadan Oblast,144091,9,0,76,0
2020-04-24,Russia,NA,Magadan Oblast,144091,2,0,78,0
2020-04-25,Russia,NA,Magadan Oblast,144091,9,0,87,0
2020-04-26,Russia,NA,Magadan Oblast,144091,1,0,88,0
2020-04-27,Russia,NA,Magadan Oblast,144091,3,0,91,0
2020-04-28,Russia,NA,Magadan Oblast,144091,1,0,92,0
2020-04-29,Russia,NA,Magadan Oblast,144091,7,0,99,0
2020-04-30,Russia,NA,Magadan Oblast,144091,2,0,101,0
2020-05-01,Russia,NA,Magadan Oblast,144091,9,0,110,0
2020-05-02,Russia,NA,Magadan Oblast,144091,4,0,114,0
2020-05-03,Russia,NA,Magadan Oblast,144091,2,0,116,0
2020-05-05,Russia,NA,Magadan Oblast,144091,15,0,131,0
2020-05-06,Russia,NA,Magadan Oblast,144091,5,0,136,0
2020-05-07,Russia,NA,Magadan Oblast,144091,2,0,138,0
2020-05-08,Russia,NA,Magadan Oblast,144091,8,0,146,0
2020-05-09,Russia,NA,Magadan Oblast,144091,8,0,154,0
2020-05-10,Russia,NA,Magadan Oblast,144091,1,0,155,0
2020-05-12,Russia,NA,Magadan Oblast,144091,2,0,157,0
2020-05-13,Russia,NA,Magadan Oblast,144091,5,0,162,0
2020-05-14,Russia,NA,Magadan Oblast,144091,1,0,163,0
2020-05-15,Russia,NA,Magadan Oblast,144091,8,0,171,0
2020-05-16,Russia,NA,Magadan Oblast,144091,3,0,174,0
2020-05-17,Russia,NA,Magadan Oblast,144091,12,0,186,0
2020-05-18,Russia,NA,Magadan Oblast,144091,3,0,189,0
2020-05-19,Russia,NA,Magadan Oblast,144091,7,0,196,0
2020-05-20,Russia,NA,Magadan Oblast,144091,5,0,201,0
2020-05-21,Russia,NA,Magadan Oblast,144091,5,0,206,0
2020-05-22,Russia,NA,Magadan Oblast,144091,3,0,209,0
2020-05-23,Russia,NA,Magadan Oblast,144091,9,0,218,0
2020-05-24,Russia,NA,Magadan Oblast,144091,5,0,223,0
2020-05-26,Russia,NA,Magadan Oblast,144091,4,0,227,0
2020-05-27,Russia,NA,Magadan Oblast,144091,1,0,228,0
2020-05-28,Russia,NA,Magadan Oblast,144091,2,0,230,0
2020-05-29,Russia,NA,Magadan Oblast,144091,8,0,238,0
2020-05-31,Russia,NA,Magadan Oblast,144091,5,0,243,0
2020-06-01,Russia,NA,Magadan Oblast,144091,3,0,246,0
2020-06-02,Russia,NA,Magadan Oblast,144091,2,0,248,0
2020-06-03,Russia,NA,Magadan Oblast,144091,12,0,260,0
2020-06-04,Russia,NA,Magadan Oblast,144091,11,0,271,0
2020-06-05,Russia,NA,Magadan Oblast,144091,15,0,286,0
2020-06-06,Russia,NA,Magadan Oblast,144091,27,0,313,0
2020-06-07,Russia,NA,Magadan Oblast,144091,14,0,327,0
2020-06-08,Russia,NA,Magadan Oblast,144091,12,0,339,0
2020-06-09,Russia,NA,Magadan Oblast,144091,9,0,348,0
2020-06-10,Russia,NA,Magadan Oblast,144091,11,0,359,0
2020-06-11,Russia,NA,Magadan Oblast,144091,38,0,397,0
2020-06-12,Russia,NA,Magadan Oblast,144091,35,0,432,0
2020-06-13,Russia,NA,Magadan Oblast,144091,27,0,459,0
2020-06-14,Russia,NA,Magadan Oblast,144091,21,0,480,0
2020-06-15,Russia,NA,Magadan Oblast,144091,21,0,501,0
2020-06-16,Russia,NA,Magadan Oblast,144091,10,0,511,0
2020-06-17,Russia,NA,Magadan Oblast,144091,8,0,519,0
2020-06-18,Russia,NA,Magadan Oblast,144091,2,0,521,0
2020-06-19,Russia,NA,Magadan Oblast,144091,19,0,540,0
2020-06-20,Russia,NA,Magadan Oblast,144091,19,0,559,0
2020-06-21,Russia,NA,Magadan Oblast,144091,27,0,586,0
2020-06-22,Russia,NA,Magadan Oblast,144091,20,0,606,0
2020-06-23,Russia,NA,Magadan Oblast,144091,3,0,609,0
2020-06-24,Russia,NA,Magadan Oblast,144091,11,0,620,0
2020-06-25,Russia,NA,Magadan Oblast,144091,22,0,642,0
2020-06-26,Russia,NA,Magadan Oblast,144091,12,0,654,0
2020-06-27,Russia,NA,Magadan Oblast,144091,15,0,669,0
2020-06-28,Russia,NA,Magadan Oblast,144091,28,0,697,0
2020-06-29,Russia,NA,Magadan Oblast,144091,34,0,731,0
2020-06-30,Russia,NA,Magadan Oblast,144091,33,0,764,0
2020-07-01,Russia,NA,Magadan Oblast,144091,27,0,791,0
2020-07-02,Russia,NA,Magadan Oblast,144091,42,0,833,0
2020-07-03,Russia,NA,Magadan Oblast,144091,42,0,875,0
2020-07-04,Russia,NA,Magadan Oblast,144091,32,0,907,0
2020-07-05,Russia,NA,Magadan Oblast,144091,21,0,928,0
2020-07-06,Russia,NA,Magadan Oblast,144091,7,0,935,0
2020-07-07,Russia,NA,Magadan Oblast,144091,12,0,947,0
2020-07-08,Russia,NA,Magadan Oblast,144091,4,0,951,0
2020-07-09,Russia,NA,Magadan Oblast,144091,27,0,978,0
2020-07-10,Russia,NA,Magadan Oblast,144091,23,0,1001,0
2020-07-11,Russia,NA,Magadan Oblast,144091,13,0,1014,0
2020-07-12,Russia,NA,Magadan Oblast,144091,24,0,1038,0
2020-07-13,Russia,NA,Magadan Oblast,144091,17,0,1055,0
2020-07-14,Russia,NA,Magadan Oblast,144091,13,0,1068,0
2020-07-15,Russia,NA,Magadan Oblast,144091,6,0,1074,0
2020-07-16,Russia,NA,Magadan Oblast,144091,24,0,1098,0
2020-07-17,Russia,NA,Magadan Oblast,144091,22,0,1120,0
2020-07-18,Russia,NA,Magadan Oblast,144091,12,0,1132,0
2020-07-19,Russia,NA,Magadan Oblast,144091,12,0,1144,0
2020-07-20,Russia,NA,Magadan Oblast,144091,17,0,1161,0
2020-07-21,Russia,NA,Magadan Oblast,144091,7,0,1168,0
2020-07-22,Russia,NA,Magadan Oblast,144091,18,0,1186,0
2020-07-23,Russia,NA,Magadan Oblast,144091,17,0,1203,0
2020-07-24,Russia,NA,Magadan Oblast,144091,13,0,1216,0
2020-07-25,Russia,NA,Magadan Oblast,144091,15,0,1231,0
2020-07-26,Russia,NA,Magadan Oblast,144091,12,0,1243,0
2020-07-27,Russia,NA,Magadan Oblast,144091,20,0,1263,0
2020-07-28,Russia,NA,Magadan Oblast,144091,6,0,1269,0
2020-07-29,Russia,NA,Magadan Oblast,144091,9,0,1278,0
2020-07-30,Russia,NA,Magadan Oblast,144091,20,0,1298,0
2020-07-31,Russia,NA,Magadan Oblast,144091,19,0,1317,0
2020-08-01,Russia,NA,Magadan Oblast,144091,19,0,1336,0
2020-08-02,Russia,NA,Magadan Oblast,144091,21,0,1357,0
2020-08-26,Russia,NA,Magadan Oblast,144091,0,0,1809,18
2020-08-27,Russia,NA,Magadan Oblast,144091,16,0,1825,18
2020-08-28,Russia,NA,Magadan Oblast,144091,32,0,1857,18
2020-08-29,Russia,NA,Magadan Oblast,144091,26,0,1883,18
2020-08-30,Russia,NA,Magadan Oblast,144091,21,0,1904,18
2020-08-31,Russia,NA,Magadan Oblast,144091,24,0,1928,18
2020-09-01,Russia,NA,Magadan Oblast,144091,15,0,1943,18
2020-09-02,Russia,NA,Magadan Oblast,144091,23,0,1966,18
2020-09-03,Russia,NA,Magadan Oblast,144091,26,0,1992,18
2020-09-04,Russia,NA,Magadan Oblast,144091,28,0,2020,18
2020-09-05,Russia,NA,Magadan Oblast,144091,29,0,2049,18
2020-09-06,Russia,NA,Magadan Oblast,144091,34,0,2083,18
2020-09-07,Russia,NA,Magadan Oblast,144091,33,0,2116,18
2020-09-08,Russia,NA,Magadan Oblast,144091,34,0,2150,18
2020-09-09,Russia,NA,Magadan Oblast,144091,31,1,2181,19
2020-09-10,Russia,NA,Magadan Oblast,144091,29,0,2210,19
2020-09-11,Russia,NA,Magadan Oblast,144091,31,0,2241,19
2020-09-12,Russia,NA,Magadan Oblast,144091,34,0,2275,19
2020-09-13,Russia,NA,Magadan Oblast,144091,33,0,2308,19
2020-09-14,Russia,NA,Magadan Oblast,144091,32,0,2340,19
2020-09-15,Russia,NA,Magadan Oblast,144091,32,0,2372,19
2020-09-16,Russia,NA,Magadan Oblast,144091,34,0,2406,19
2020-09-17,Russia,NA,Magadan Oblast,144091,45,2,2451,21
2020-09-18,Russia,NA,Magadan Oblast,144091,33,1,2484,22
2020-09-19,Russia,NA,Magadan Oblast,144091,38,1,2522,23
2020-09-20,Russia,NA,Magadan Oblast,144091,34,1,2556,24
2020-09-21,Russia,NA,Magadan Oblast,144091,38,0,2594,24
2020-09-22,Russia,NA,Magadan Oblast,144091,43,1,2637,25
2020-09-23,Russia,NA,Magadan Oblast,144091,43,0,2680,25
2020-04-06,Russia,NA,Mari El,680380,9,0,13,0
2020-04-08,Russia,NA,Mari El,680380,27,0,40,0
2020-04-09,Russia,NA,Mari El,680380,1,0,41,0
2020-04-10,Russia,NA,Mari El,680380,22,0,63,0
2020-04-12,Russia,NA,Mari El,680380,7,0,70,0
2020-04-13,Russia,NA,Mari El,680380,10,0,80,0
2020-04-14,Russia,NA,Mari El,680380,11,0,91,0
2020-04-15,Russia,NA,Mari El,680380,27,0,118,0
2020-04-16,Russia,NA,Mari El,680380,29,0,147,0
2020-04-17,Russia,NA,Mari El,680380,32,0,179,0
2020-04-18,Russia,NA,Mari El,680380,40,0,219,0
2020-04-19,Russia,NA,Mari El,680380,43,0,262,0
2020-04-20,Russia,NA,Mari El,680380,29,0,291,0
2020-04-21,Russia,NA,Mari El,680380,20,0,311,0
2020-04-22,Russia,NA,Mari El,680380,22,0,333,0
2020-04-23,Russia,NA,Mari El,680380,15,0,348,0
2020-04-24,Russia,NA,Mari El,680380,29,0,377,0
2020-04-25,Russia,NA,Mari El,680380,30,0,407,0
2020-04-26,Russia,NA,Mari El,680380,24,0,431,0
2020-04-27,Russia,NA,Mari El,680380,31,0,462,0
2020-04-28,Russia,NA,Mari El,680380,38,0,500,0
2020-04-29,Russia,NA,Mari El,680380,35,0,535,0
2020-04-30,Russia,NA,Mari El,680380,31,0,566,0
2020-05-01,Russia,NA,Mari El,680380,31,0,597,0
2020-05-02,Russia,NA,Mari El,680380,31,0,628,0
2020-05-03,Russia,NA,Mari El,680380,40,0,668,0
2020-05-04,Russia,NA,Mari El,680380,49,0,717,0
2020-05-05,Russia,NA,Mari El,680380,33,0,750,0
2020-05-06,Russia,NA,Mari El,680380,33,0,783,0
2020-05-07,Russia,NA,Mari El,680380,31,0,814,0
2020-05-08,Russia,NA,Mari El,680380,31,0,845,0
2020-05-09,Russia,NA,Mari El,680380,37,0,882,0
2020-05-10,Russia,NA,Mari El,680380,21,0,903,0
2020-05-11,Russia,NA,Mari El,680380,25,0,928,0
2020-05-12,Russia,NA,Mari El,680380,36,0,964,0
2020-05-13,Russia,NA,Mari El,680380,32,0,996,0
2020-05-14,Russia,NA,Mari El,680380,37,0,1033,0
2020-05-15,Russia,NA,Mari El,680380,45,0,1078,0
2020-05-16,Russia,NA,Mari El,680380,52,0,1130,0
2020-05-17,Russia,NA,Mari El,680380,54,0,1184,0
2020-05-18,Russia,NA,Mari El,680380,51,0,1235,0
2020-05-19,Russia,NA,Mari El,680380,50,0,1285,0
2020-05-20,Russia,NA,Mari El,680380,37,0,1322,0
2020-05-21,Russia,NA,Mari El,680380,38,0,1360,0
2020-05-22,Russia,NA,Mari El,680380,37,0,1397,0
2020-05-23,Russia,NA,Mari El,680380,41,0,1438,0
2020-05-24,Russia,NA,Mari El,680380,41,0,1479,0
2020-05-25,Russia,NA,Mari El,680380,39,0,1518,0
2020-05-26,Russia,NA,Mari El,680380,41,0,1559,0
2020-05-27,Russia,NA,Mari El,680380,43,0,1602,0
2020-05-28,Russia,NA,Mari El,680380,41,0,1643,0
2020-05-29,Russia,NA,Mari El,680380,46,0,1689,0
2020-05-30,Russia,NA,Mari El,680380,44,0,1733,0
2020-05-31,Russia,NA,Mari El,680380,41,0,1774,0
2020-06-01,Russia,NA,Mari El,680380,41,0,1815,0
2020-06-02,Russia,NA,Mari El,680380,39,0,1854,0
2020-06-03,Russia,NA,Mari El,680380,40,0,1894,0
2020-06-04,Russia,NA,Mari El,680380,39,0,1933,0
2020-06-05,Russia,NA,Mari El,680380,42,0,1975,0
2020-06-06,Russia,NA,Mari El,680380,44,0,2019,0
2020-06-07,Russia,NA,Mari El,680380,42,0,2061,0
2020-06-08,Russia,NA,Mari El,680380,43,0,2104,0
2020-06-09,Russia,NA,Mari El,680380,47,0,2151,0
2020-06-10,Russia,NA,Mari El,680380,42,0,2193,0
2020-06-11,Russia,NA,Mari El,680380,43,0,2236,0
2020-06-12,Russia,NA,Mari El,680380,47,0,2283,0
2020-06-13,Russia,NA,Mari El,680380,48,0,2331,0
2020-06-14,Russia,NA,Mari El,680380,44,0,2375,0
2020-06-15,Russia,NA,Mari El,680380,44,0,2419,0
2020-06-16,Russia,NA,Mari El,680380,43,0,2462,0
2020-06-17,Russia,NA,Mari El,680380,48,0,2510,0
2020-06-18,Russia,NA,Mari El,680380,47,0,2557,0
2020-06-19,Russia,NA,Mari El,680380,45,0,2602,0
2020-06-20,Russia,NA,Mari El,680380,40,0,2642,0
2020-06-21,Russia,NA,Mari El,680380,37,0,2679,0
2020-06-22,Russia,NA,Mari El,680380,31,0,2710,0
2020-06-23,Russia,NA,Mari El,680380,35,0,2745,0
2020-06-24,Russia,NA,Mari El,680380,38,0,2783,0
2020-06-25,Russia,NA,Mari El,680380,36,0,2819,0
2020-06-26,Russia,NA,Mari El,680380,30,0,2849,0
2020-06-27,Russia,NA,Mari El,680380,31,0,2880,0
2020-06-28,Russia,NA,Mari El,680380,25,0,2905,0
2020-06-29,Russia,NA,Mari El,680380,25,0,2930,0
2020-06-30,Russia,NA,Mari El,680380,29,0,2959,0
2020-07-01,Russia,NA,Mari El,680380,31,0,2990,0
2020-07-02,Russia,NA,Mari El,680380,30,0,3020,0
2020-07-03,Russia,NA,Mari El,680380,25,0,3045,0
2020-07-04,Russia,NA,Mari El,680380,28,0,3073,0
2020-07-05,Russia,NA,Mari El,680380,27,0,3100,0
2020-07-06,Russia,NA,Mari El,680380,28,0,3128,0
2020-07-07,Russia,NA,Mari El,680380,29,0,3157,0
2020-07-08,Russia,NA,Mari El,680380,27,0,3184,0
2020-07-09,Russia,NA,Mari El,680380,29,0,3213,0
2020-07-10,Russia,NA,Mari El,680380,28,0,3241,0
2020-07-11,Russia,NA,Mari El,680380,27,0,3268,0
2020-07-12,Russia,NA,Mari El,680380,28,0,3296,0
2020-07-13,Russia,NA,Mari El,680380,29,0,3325,0
2020-07-14,Russia,NA,Mari El,680380,28,0,3353,0
2020-07-15,Russia,NA,Mari El,680380,27,0,3380,0
2020-07-16,Russia,NA,Mari El,680380,29,0,3409,0
2020-07-17,Russia,NA,Mari El,680380,27,0,3436,0
2020-07-18,Russia,NA,Mari El,680380,28,0,3464,0
2020-07-19,Russia,NA,Mari El,680380,29,0,3493,0
2020-07-20,Russia,NA,Mari El,680380,27,0,3520,0
2020-07-21,Russia,NA,Mari El,680380,28,0,3548,0
2020-07-22,Russia,NA,Mari El,680380,26,0,3574,0
2020-07-23,Russia,NA,Mari El,680380,27,0,3601,0
2020-07-24,Russia,NA,Mari El,680380,26,0,3627,0
2020-07-25,Russia,NA,Mari El,680380,25,0,3652,0
2020-07-26,Russia,NA,Mari El,680380,23,0,3675,0
2020-07-27,Russia,NA,Mari El,680380,22,0,3697,0
2020-07-28,Russia,NA,Mari El,680380,19,0,3716,0
2020-07-29,Russia,NA,Mari El,680380,18,0,3734,0
2020-07-30,Russia,NA,Mari El,680380,18,0,3752,0
2020-07-31,Russia,NA,Mari El,680380,18,0,3770,0
2020-08-01,Russia,NA,Mari El,680380,16,0,3786,0
2020-08-02,Russia,NA,Mari El,680380,14,0,3800,0
2020-08-26,Russia,NA,Mari El,680380,0,0,4178,38
2020-08-27,Russia,NA,Mari El,680380,16,1,4194,39
2020-08-28,Russia,NA,Mari El,680380,17,0,4211,39
2020-08-29,Russia,NA,Mari El,680380,16,0,4227,39
2020-08-30,Russia,NA,Mari El,680380,17,0,4244,39
2020-08-31,Russia,NA,Mari El,680380,16,0,4260,39
2020-09-01,Russia,NA,Mari El,680380,16,0,4276,39
2020-09-02,Russia,NA,Mari El,680380,17,0,4293,39
2020-09-03,Russia,NA,Mari El,680380,16,2,4309,41
2020-09-04,Russia,NA,Mari El,680380,17,0,4326,41
2020-09-05,Russia,NA,Mari El,680380,17,0,4343,41
2020-09-06,Russia,NA,Mari El,680380,16,0,4359,41
2020-09-07,Russia,NA,Mari El,680380,16,0,4375,41
2020-09-08,Russia,NA,Mari El,680380,17,2,4392,43
2020-09-09,Russia,NA,Mari El,680380,18,1,4410,44
2020-09-10,Russia,NA,Mari El,680380,17,0,4427,44
2020-09-11,Russia,NA,Mari El,680380,17,0,4444,44
2020-09-12,Russia,NA,Mari El,680380,21,1,4465,45
2020-09-13,Russia,NA,Mari El,680380,19,0,4484,45
2020-09-14,Russia,NA,Mari El,680380,21,0,4505,45
2020-09-15,Russia,NA,Mari El,680380,22,1,4527,46
2020-09-16,Russia,NA,Mari El,680380,22,0,4549,46
2020-09-17,Russia,NA,Mari El,680380,20,0,4569,46
2020-09-18,Russia,NA,Mari El,680380,21,0,4590,46
2020-09-19,Russia,NA,Mari El,680380,22,1,4612,47
2020-09-20,Russia,NA,Mari El,680380,20,0,4632,47
2020-09-21,Russia,NA,Mari El,680380,21,0,4653,47
2020-09-22,Russia,NA,Mari El,680380,22,1,4675,48
2020-09-23,Russia,NA,Mari El,680380,23,1,4698,49
2020-04-08,Russia,NA,Mordovia,805056,7,0,13,0
2020-04-09,Russia,NA,Mordovia,805056,4,0,17,0
2020-04-10,Russia,NA,Mordovia,805056,2,0,19,0
2020-04-12,Russia,NA,Mordovia,805056,23,0,42,0
2020-04-13,Russia,NA,Mordovia,805056,16,0,58,0
2020-04-14,Russia,NA,Mordovia,805056,13,0,71,0
2020-04-17,Russia,NA,Mordovia,805056,65,0,136,0
2020-04-18,Russia,NA,Mordovia,805056,62,0,198,0
2020-04-19,Russia,NA,Mordovia,805056,60,0,258,0
2020-04-20,Russia,NA,Mordovia,805056,35,0,293,0
2020-04-21,Russia,NA,Mordovia,805056,34,0,327,0
2020-04-22,Russia,NA,Mordovia,805056,30,0,357,0
2020-04-23,Russia,NA,Mordovia,805056,28,0,385,0
2020-04-24,Russia,NA,Mordovia,805056,39,0,424,0
2020-04-25,Russia,NA,Mordovia,805056,45,0,469,0
2020-04-26,Russia,NA,Mordovia,805056,49,0,518,0
2020-04-27,Russia,NA,Mordovia,805056,42,0,560,0
2020-04-28,Russia,NA,Mordovia,805056,32,0,592,0
2020-04-29,Russia,NA,Mordovia,805056,67,0,659,0
2020-04-30,Russia,NA,Mordovia,805056,39,0,698,0
2020-05-01,Russia,NA,Mordovia,805056,30,0,728,0
2020-05-02,Russia,NA,Mordovia,805056,37,0,765,0
2020-05-03,Russia,NA,Mordovia,805056,43,0,808,0
2020-05-04,Russia,NA,Mordovia,805056,59,0,867,0
2020-05-05,Russia,NA,Mordovia,805056,56,0,923,0
2020-05-06,Russia,NA,Mordovia,805056,54,0,977,0
2020-05-07,Russia,NA,Mordovia,805056,41,0,1018,0
2020-05-08,Russia,NA,Mordovia,805056,37,0,1055,0
2020-05-09,Russia,NA,Mordovia,805056,47,0,1102,0
2020-05-10,Russia,NA,Mordovia,805056,46,0,1148,0
2020-05-11,Russia,NA,Mordovia,805056,42,0,1190,0
2020-05-12,Russia,NA,Mordovia,805056,35,0,1225,0
2020-05-13,Russia,NA,Mordovia,805056,37,0,1262,0
2020-05-14,Russia,NA,Mordovia,805056,34,0,1296,0
2020-05-15,Russia,NA,Mordovia,805056,27,0,1323,0
2020-05-16,Russia,NA,Mordovia,805056,25,0,1348,0
2020-05-17,Russia,NA,Mordovia,805056,28,0,1376,0
2020-05-18,Russia,NA,Mordovia,805056,33,0,1409,0
2020-05-19,Russia,NA,Mordovia,805056,34,0,1443,0
2020-05-20,Russia,NA,Mordovia,805056,34,0,1477,0
2020-05-21,Russia,NA,Mordovia,805056,35,0,1512,0
2020-05-22,Russia,NA,Mordovia,805056,36,0,1548,0
2020-05-23,Russia,NA,Mordovia,805056,32,0,1580,0
2020-05-24,Russia,NA,Mordovia,805056,32,0,1612,0
2020-05-25,Russia,NA,Mordovia,805056,34,0,1646,0
2020-05-26,Russia,NA,Mordovia,805056,38,0,1684,0
2020-05-27,Russia,NA,Mordovia,805056,43,0,1727,0
2020-05-28,Russia,NA,Mordovia,805056,49,0,1776,0
2020-05-29,Russia,NA,Mordovia,805056,44,0,1820,0
2020-05-30,Russia,NA,Mordovia,805056,40,0,1860,0
2020-05-31,Russia,NA,Mordovia,805056,35,0,1895,0
2020-06-01,Russia,NA,Mordovia,805056,36,0,1931,0
2020-06-02,Russia,NA,Mordovia,805056,39,0,1970,0
2020-06-03,Russia,NA,Mordovia,805056,42,0,2012,0
2020-06-04,Russia,NA,Mordovia,805056,39,0,2051,0
2020-06-05,Russia,NA,Mordovia,805056,47,0,2098,0
2020-06-06,Russia,NA,Mordovia,805056,40,0,2138,0
2020-06-07,Russia,NA,Mordovia,805056,47,0,2185,0
2020-06-08,Russia,NA,Mordovia,805056,45,0,2230,0
2020-06-09,Russia,NA,Mordovia,805056,66,0,2296,0
2020-06-10,Russia,NA,Mordovia,805056,64,0,2360,0
2020-06-11,Russia,NA,Mordovia,805056,58,0,2418,0
2020-06-12,Russia,NA,Mordovia,805056,62,0,2480,0
2020-06-13,Russia,NA,Mordovia,805056,58,0,2538,0
2020-06-14,Russia,NA,Mordovia,805056,58,0,2596,0
2020-06-15,Russia,NA,Mordovia,805056,56,0,2652,0
2020-06-16,Russia,NA,Mordovia,805056,55,0,2707,0
2020-06-17,Russia,NA,Mordovia,805056,55,0,2762,0
2020-06-18,Russia,NA,Mordovia,805056,56,0,2818,0
2020-06-19,Russia,NA,Mordovia,805056,56,0,2874,0
2020-06-20,Russia,NA,Mordovia,805056,57,0,2931,0
2020-06-21,Russia,NA,Mordovia,805056,55,0,2986,0
2020-06-22,Russia,NA,Mordovia,805056,54,0,3040,0
2020-06-23,Russia,NA,Mordovia,805056,54,0,3094,0
2020-06-24,Russia,NA,Mordovia,805056,49,0,3143,0
2020-06-25,Russia,NA,Mordovia,805056,49,0,3192,0
2020-06-26,Russia,NA,Mordovia,805056,48,0,3240,0
2020-06-27,Russia,NA,Mordovia,805056,44,0,3284,0
2020-06-28,Russia,NA,Mordovia,805056,40,0,3324,0
2020-06-29,Russia,NA,Mordovia,805056,35,0,3359,0
2020-06-30,Russia,NA,Mordovia,805056,35,0,3394,0
2020-07-01,Russia,NA,Mordovia,805056,37,0,3431,0
2020-07-02,Russia,NA,Mordovia,805056,36,0,3467,0
2020-07-03,Russia,NA,Mordovia,805056,38,0,3505,0
2020-07-04,Russia,NA,Mordovia,805056,37,0,3542,0
2020-07-05,Russia,NA,Mordovia,805056,35,0,3577,0
2020-07-06,Russia,NA,Mordovia,805056,34,0,3611,0
2020-07-07,Russia,NA,Mordovia,805056,35,0,3646,0
2020-07-08,Russia,NA,Mordovia,805056,34,0,3680,0
2020-07-09,Russia,NA,Mordovia,805056,37,0,3717,0
2020-07-10,Russia,NA,Mordovia,805056,38,0,3755,0
2020-07-11,Russia,NA,Mordovia,805056,37,0,3792,0
2020-07-12,Russia,NA,Mordovia,805056,37,0,3829,0
2020-07-13,Russia,NA,Mordovia,805056,36,0,3865,0
2020-07-14,Russia,NA,Mordovia,805056,36,0,3901,0
2020-07-15,Russia,NA,Mordovia,805056,37,0,3938,0
2020-07-16,Russia,NA,Mordovia,805056,38,0,3976,0
2020-07-17,Russia,NA,Mordovia,805056,38,0,4014,0
2020-07-18,Russia,NA,Mordovia,805056,37,0,4051,0
2020-07-19,Russia,NA,Mordovia,805056,35,0,4086,0
2020-07-20,Russia,NA,Mordovia,805056,35,0,4121,0
2020-07-21,Russia,NA,Mordovia,805056,36,0,4157,0
2020-07-22,Russia,NA,Mordovia,805056,35,0,4192,0
2020-07-23,Russia,NA,Mordovia,805056,35,0,4227,0
2020-07-24,Russia,NA,Mordovia,805056,34,0,4261,0
2020-07-25,Russia,NA,Mordovia,805056,34,0,4295,0
2020-07-26,Russia,NA,Mordovia,805056,33,0,4328,0
2020-07-27,Russia,NA,Mordovia,805056,32,0,4360,0
2020-07-28,Russia,NA,Mordovia,805056,32,0,4392,0
2020-07-29,Russia,NA,Mordovia,805056,32,0,4424,0
2020-07-30,Russia,NA,Mordovia,805056,33,0,4457,0
2020-07-31,Russia,NA,Mordovia,805056,33,0,4490,0
2020-08-01,Russia,NA,Mordovia,805056,32,0,4522,0
2020-08-02,Russia,NA,Mordovia,805056,31,0,4553,0
2020-08-26,Russia,NA,Mordovia,805056,0,0,5301,38
2020-08-27,Russia,NA,Mordovia,805056,33,0,5334,38
2020-08-28,Russia,NA,Mordovia,805056,33,0,5367,38
2020-08-29,Russia,NA,Mordovia,805056,32,0,5399,38
2020-08-30,Russia,NA,Mordovia,805056,31,0,5430,38
2020-08-31,Russia,NA,Mordovia,805056,32,0,5462,38
2020-09-01,Russia,NA,Mordovia,805056,31,0,5493,38
2020-09-02,Russia,NA,Mordovia,805056,31,0,5524,38
2020-09-03,Russia,NA,Mordovia,805056,32,0,5556,38
2020-09-04,Russia,NA,Mordovia,805056,31,0,5587,38
2020-09-05,Russia,NA,Mordovia,805056,33,0,5620,38
2020-09-06,Russia,NA,Mordovia,805056,32,0,5652,38
2020-09-07,Russia,NA,Mordovia,805056,31,0,5683,38
2020-09-08,Russia,NA,Mordovia,805056,31,0,5714,38
2020-09-09,Russia,NA,Mordovia,805056,31,0,5745,38
2020-09-10,Russia,NA,Mordovia,805056,31,0,5776,38
2020-09-11,Russia,NA,Mordovia,805056,32,1,5808,39
2020-09-12,Russia,NA,Mordovia,805056,30,0,5838,39
2020-09-13,Russia,NA,Mordovia,805056,32,0,5870,39
2020-09-14,Russia,NA,Mordovia,805056,31,0,5901,39
2020-09-15,Russia,NA,Mordovia,805056,30,0,5931,39
2020-09-16,Russia,NA,Mordovia,805056,30,0,5961,39
2020-09-17,Russia,NA,Mordovia,805056,31,0,5992,39
2020-09-18,Russia,NA,Mordovia,805056,32,1,6024,40
2020-09-19,Russia,NA,Mordovia,805056,33,0,6057,40
2020-09-20,Russia,NA,Mordovia,805056,33,0,6090,40
2020-09-21,Russia,NA,Mordovia,805056,32,0,6122,40
2020-09-22,Russia,NA,Mordovia,805056,33,0,6155,40
2020-09-23,Russia,NA,Mordovia,805056,33,0,6188,40
2020-03-11,Russia,NA,Moscow,12500123,6,0,14,0
2020-03-12,Russia,NA,Moscow,12500123,4,0,18,0
2020-03-13,Russia,NA,Moscow,12500123,5,0,23,0
2020-03-14,Russia,NA,Moscow,12500123,9,0,32,0
2020-03-16,Russia,NA,Moscow,12500123,20,0,52,0
2020-03-17,Russia,NA,Moscow,12500123,4,0,56,0
2020-03-18,Russia,NA,Moscow,12500123,31,0,87,0
2020-03-19,Russia,NA,Moscow,12500123,12,0,99,0
2020-03-20,Russia,NA,Moscow,12500123,33,0,132,0
2020-03-21,Russia,NA,Moscow,12500123,6,0,138,0
2020-03-22,Russia,NA,Moscow,12500123,54,0,192,0
2020-03-23,Russia,NA,Moscow,12500123,71,0,263,0
2020-03-24,Russia,NA,Moscow,12500123,28,0,291,0
2020-03-25,Russia,NA,Moscow,12500123,120,0,411,0
2020-03-26,Russia,NA,Moscow,12500123,136,0,547,0
2020-03-27,Russia,NA,Moscow,12500123,157,0,704,0
2020-03-28,Russia,NA,Moscow,12500123,114,0,818,0
2020-03-29,Russia,NA,Moscow,12500123,197,0,1015,0
2020-03-30,Russia,NA,Moscow,12500123,212,0,1227,0
2020-03-31,Russia,NA,Moscow,12500123,387,0,1614,0
2020-04-01,Russia,NA,Moscow,12500123,267,0,1881,0
2020-04-02,Russia,NA,Moscow,12500123,595,0,2476,0
2020-04-03,Russia,NA,Moscow,12500123,448,0,2924,0
2020-04-04,Russia,NA,Moscow,12500123,434,0,3358,0
2020-04-05,Russia,NA,Moscow,12500123,536,0,3894,0
2020-04-06,Russia,NA,Moscow,12500123,591,0,4485,0
2020-04-07,Russia,NA,Moscow,12500123,697,0,5182,0
2020-04-08,Russia,NA,Moscow,12500123,660,0,5842,0
2020-04-09,Russia,NA,Moscow,12500123,857,0,6699,0
2020-04-10,Russia,NA,Moscow,12500123,1124,0,7823,0
2020-04-11,Russia,NA,Moscow,12500123,1030,0,8853,0
2020-04-12,Russia,NA,Moscow,12500123,1306,0,10159,0
2020-04-13,Russia,NA,Moscow,12500123,1355,0,11514,0
2020-04-14,Russia,NA,Moscow,12500123,1489,0,13003,0
2020-04-15,Russia,NA,Moscow,12500123,1774,0,14777,0
2020-04-16,Russia,NA,Moscow,12500123,1370,0,16147,0
2020-04-17,Russia,NA,Moscow,12500123,1959,0,18106,0
2020-04-18,Russia,NA,Moscow,12500123,2649,0,20755,0
2020-04-19,Russia,NA,Moscow,12500123,3570,0,24325,0
2020-04-20,Russia,NA,Moscow,12500123,2026,0,26351,0
2020-04-21,Russia,NA,Moscow,12500123,3083,0,29434,0
2020-04-22,Russia,NA,Moscow,12500123,2548,0,31982,0
2020-04-23,Russia,NA,Moscow,12500123,1959,0,33941,0
2020-04-24,Russia,NA,Moscow,12500123,2957,0,36898,0
2020-04-25,Russia,NA,Moscow,12500123,2612,0,39510,0
2020-04-26,Russia,NA,Moscow,12500123,2971,0,42481,0
2020-04-27,Russia,NA,Moscow,12500123,2871,0,45352,0
2020-04-28,Russia,NA,Moscow,12500123,3075,0,48427,0
2020-04-29,Russia,NA,Moscow,12500123,2220,0,50647,0
2020-04-30,Russia,NA,Moscow,12500123,3093,0,53740,0
2020-05-01,Russia,NA,Moscow,12500123,3561,0,57301,0
2020-05-02,Russia,NA,Moscow,12500123,5358,0,62659,0
2020-05-03,Russia,NA,Moscow,12500123,5948,0,68607,0
2020-05-04,Russia,NA,Moscow,12500123,5795,0,74402,0
2020-05-05,Russia,NA,Moscow,12500123,5714,0,80116,0
2020-05-06,Russia,NA,Moscow,12500123,5858,0,85974,0
2020-05-07,Russia,NA,Moscow,12500123,6703,0,92677,0
2020-05-08,Russia,NA,Moscow,12500123,5846,0,98523,0
2020-05-09,Russia,NA,Moscow,12500123,5667,0,104190,0
2020-05-10,Russia,NA,Moscow,12500123,5551,0,109741,0
2020-05-11,Russia,NA,Moscow,12500123,6169,0,115910,0
2020-05-12,Russia,NA,Moscow,12500123,5392,0,121302,0
2020-05-13,Russia,NA,Moscow,12500123,4703,0,126005,0
2020-05-14,Russia,NA,Moscow,12500123,4712,0,130717,0
2020-05-15,Russia,NA,Moscow,12500123,4748,0,135465,0
2020-05-16,Russia,NA,Moscow,12500123,3505,0,138970,0
2020-05-17,Russia,NA,Moscow,12500123,3855,0,142825,0
2020-05-18,Russia,NA,Moscow,12500123,3238,0,146063,0
2020-05-19,Russia,NA,Moscow,12500123,3545,0,149608,0
2020-05-20,Russia,NA,Moscow,12500123,2699,0,152307,0
2020-05-21,Russia,NA,Moscow,12500123,2913,0,155220,0
2020-05-22,Russia,NA,Moscow,12500123,2988,0,158208,0
2020-05-23,Russia,NA,Moscow,12500123,3190,0,161398,0
2020-05-24,Russia,NA,Moscow,12500123,2516,0,163914,0
2020-05-25,Russia,NA,Moscow,12500123,2560,0,166474,0
2020-05-26,Russia,NA,Moscow,12500123,2830,0,169304,0
2020-05-27,Russia,NA,Moscow,12500123,2140,0,171444,0
2020-05-28,Russia,NA,Moscow,12500123,2054,0,173498,0
2020-05-29,Russia,NA,Moscow,12500123,2332,0,175830,0
2020-05-30,Russia,NA,Moscow,12500123,2367,0,178197,0
2020-05-31,Russia,NA,Moscow,12500123,2595,0,180792,0
2020-06-01,Russia,NA,Moscow,12500123,2297,0,183089,0
2020-06-02,Russia,NA,Moscow,12500123,2286,0,185375,0
2020-06-03,Russia,NA,Moscow,12500123,1842,0,187217,0
2020-06-04,Russia,NA,Moscow,12500123,1998,0,189215,0
2020-06-05,Russia,NA,Moscow,12500123,1855,0,191070,0
2020-06-06,Russia,NA,Moscow,12500123,1992,0,193062,0
2020-06-07,Russia,NA,Moscow,12500123,1956,0,195018,0
2020-06-08,Russia,NA,Moscow,12500123,2001,0,197019,0
2020-06-09,Russia,NA,Moscow,12500123,1572,0,198591,0
2020-06-10,Russia,NA,Moscow,12500123,1195,0,199786,0
2020-06-11,Russia,NA,Moscow,12500123,1436,0,201222,0
2020-06-12,Russia,NA,Moscow,12500123,1714,0,202936,0
2020-06-13,Russia,NA,Moscow,12500123,1493,0,204429,0
2020-06-14,Russia,NA,Moscow,12500123,1477,0,205906,0
2020-06-15,Russia,NA,Moscow,12500123,1359,0,207265,0
2020-06-16,Russia,NA,Moscow,12500123,1416,0,208681,0
2020-06-17,Russia,NA,Moscow,12500123,1065,0,209746,0
2020-06-18,Russia,NA,Moscow,12500123,1040,0,210786,0
2020-06-19,Russia,NA,Moscow,12500123,1136,0,211922,0
2020-06-20,Russia,NA,Moscow,12500123,1057,0,212979,0
2020-06-21,Russia,NA,Moscow,12500123,968,0,213947,0
2020-06-22,Russia,NA,Moscow,12500123,1068,0,215015,0
2020-06-23,Russia,NA,Moscow,12500123,1081,0,216096,0
2020-06-24,Russia,NA,Moscow,12500123,811,0,216907,0
2020-06-25,Russia,NA,Moscow,12500123,885,0,217792,0
2020-06-26,Russia,NA,Moscow,12500123,813,0,218605,0
2020-06-27,Russia,NA,Moscow,12500123,750,0,219355,0
2020-06-28,Russia,NA,Moscow,12500123,717,0,220072,0
2020-06-29,Russia,NA,Moscow,12500123,782,0,220854,0
2020-06-30,Russia,NA,Moscow,12500123,745,0,221599,0
2020-07-01,Russia,NA,Moscow,12500123,611,0,222210,0
2020-07-02,Russia,NA,Moscow,12500123,662,0,222872,0
2020-07-03,Russia,NA,Moscow,12500123,659,0,223531,0
2020-07-04,Russia,NA,Moscow,12500123,680,0,224211,0
2020-07-05,Russia,NA,Moscow,12500123,650,0,224861,0
2020-07-06,Russia,NA,Moscow,12500123,685,0,225546,0
2020-07-07,Russia,NA,Moscow,12500123,629,0,226175,0
2020-07-08,Russia,NA,Moscow,12500123,621,0,226796,0
2020-07-09,Russia,NA,Moscow,12500123,568,0,227364,0
2020-07-10,Russia,NA,Moscow,12500123,637,0,228001,0
2020-07-11,Russia,NA,Moscow,12500123,678,0,228679,0
2020-07-12,Russia,NA,Moscow,12500123,679,0,229358,0
2020-07-13,Russia,NA,Moscow,12500123,672,0,230030,0
2020-07-14,Russia,NA,Moscow,12500123,613,0,230643,0
2020-07-15,Russia,NA,Moscow,12500123,628,0,231271,0
2020-07-16,Russia,NA,Moscow,12500123,531,0,231802,0
2020-07-17,Russia,NA,Moscow,12500123,575,0,232377,0
2020-07-18,Russia,NA,Moscow,12500123,578,0,232955,0
2020-07-19,Russia,NA,Moscow,12500123,591,0,233546,0
2020-07-20,Russia,NA,Moscow,12500123,578,0,234124,0
2020-07-21,Russia,NA,Moscow,12500123,602,0,234726,0
2020-07-22,Russia,NA,Moscow,12500123,638,0,235364,0
2020-07-23,Russia,NA,Moscow,12500123,608,0,235972,0
2020-07-24,Russia,NA,Moscow,12500123,645,0,236617,0
2020-07-25,Russia,NA,Moscow,12500123,648,0,237265,0
2020-07-26,Russia,NA,Moscow,12500123,683,0,237948,0
2020-07-27,Russia,NA,Moscow,12500123,694,0,238642,0
2020-07-28,Russia,NA,Moscow,12500123,674,0,239316,0
2020-07-29,Russia,NA,Moscow,12500123,671,0,239987,0
2020-07-30,Russia,NA,Moscow,12500123,678,0,240665,0
2020-07-31,Russia,NA,Moscow,12500123,695,0,241360,0
2020-08-01,Russia,NA,Moscow,12500123,690,0,242050,0
2020-08-02,Russia,NA,Moscow,12500123,664,0,242714,0
2020-08-26,Russia,NA,Moscow,12500123,0,0,259070,4764
2020-08-27,Russia,NA,Moscow,12500123,637,12,259707,4776
2020-08-28,Russia,NA,Moscow,12500123,654,10,260361,4786
2020-08-29,Russia,NA,Moscow,12500123,677,12,261038,4798
2020-08-30,Russia,NA,Moscow,12500123,695,11,261733,4809
2020-08-31,Russia,NA,Moscow,12500123,685,12,262418,4821
2020-09-01,Russia,NA,Moscow,12500123,641,11,263059,4832
2020-09-02,Russia,NA,Moscow,12500123,625,12,263684,4844
2020-09-03,Russia,NA,Moscow,12500123,690,13,264374,4857
2020-09-04,Russia,NA,Moscow,12500123,692,10,265066,4867
2020-09-05,Russia,NA,Moscow,12500123,671,11,265737,4878
2020-09-06,Russia,NA,Moscow,12500123,620,13,266357,4891
2020-09-07,Russia,NA,Moscow,12500123,690,14,267047,4905
2020-09-08,Russia,NA,Moscow,12500123,695,16,267742,4921
2020-09-09,Russia,NA,Moscow,12500123,642,12,268384,4933
2020-09-10,Russia,NA,Moscow,12500123,695,14,269079,4947
2020-09-11,Russia,NA,Moscow,12500123,698,9,269777,4956
2020-09-12,Russia,NA,Moscow,12500123,670,12,270447,4968
2020-09-13,Russia,NA,Moscow,12500123,650,14,271097,4982
2020-09-14,Russia,NA,Moscow,12500123,696,11,271793,4993
2020-09-15,Russia,NA,Moscow,12500123,730,13,272523,5006
2020-09-16,Russia,NA,Moscow,12500123,750,10,273273,5016
2020-09-17,Russia,NA,Moscow,12500123,730,9,274003,5025
2020-09-18,Russia,NA,Moscow,12500123,805,8,274808,5033
2020-09-19,Russia,NA,Moscow,12500123,825,11,275633,5044
2020-09-20,Russia,NA,Moscow,12500123,860,13,276493,5057
2020-09-21,Russia,NA,Moscow,12500123,915,12,277408,5069
2020-09-22,Russia,NA,Moscow,12500123,980,15,278388,5084
2020-09-23,Russia,NA,Moscow,12500123,970,16,279358,5100
2020-03-17,Russia,NA,Moscow Oblast,7503385,1,0,11,0
2020-03-19,Russia,NA,Moscow Oblast,7503385,5,0,16,0
2020-03-20,Russia,NA,Moscow Oblast,7503385,1,0,17,0
2020-03-21,Russia,NA,Moscow Oblast,7503385,17,0,34,0
2020-03-25,Russia,NA,Moscow Oblast,7503385,6,0,40,0
2020-03-27,Russia,NA,Moscow Oblast,7503385,8,0,48,0
2020-03-28,Russia,NA,Moscow Oblast,7503385,36,0,84,0
2020-03-29,Russia,NA,Moscow Oblast,7503385,27,0,111,0
2020-03-30,Russia,NA,Moscow Oblast,7503385,7,0,118,0
2020-04-01,Russia,NA,Moscow Oblast,7503385,15,0,133,0
2020-04-02,Russia,NA,Moscow Oblast,7503385,43,0,176,0
2020-04-03,Russia,NA,Moscow Oblast,7503385,34,0,210,0
2020-04-04,Russia,NA,Moscow Oblast,7503385,49,0,259,0
2020-04-05,Russia,NA,Moscow Oblast,7503385,45,0,304,0
2020-04-06,Russia,NA,Moscow Oblast,7503385,82,0,386,0
2020-04-07,Russia,NA,Moscow Oblast,7503385,67,0,453,0
2020-04-08,Russia,NA,Moscow Oblast,7503385,95,0,548,0
2020-04-09,Russia,NA,Moscow Oblast,7503385,199,0,747,0
2020-04-10,Russia,NA,Moscow Oblast,7503385,182,0,929,0
2020-04-11,Russia,NA,Moscow Oblast,7503385,152,0,1081,0
2020-04-12,Russia,NA,Moscow Oblast,7503385,278,0,1359,0
2020-04-13,Russia,NA,Moscow Oblast,7503385,495,0,1854,0
2020-04-14,Russia,NA,Moscow Oblast,7503385,460,0,2314,0
2020-04-15,Russia,NA,Moscow Oblast,7503385,272,0,2586,0
2020-04-16,Russia,NA,Moscow Oblast,7503385,467,0,3053,0
2020-04-17,Russia,NA,Moscow Oblast,7503385,472,0,3525,0
2020-04-18,Russia,NA,Moscow Oblast,7503385,428,0,3953,0
2020-04-19,Russia,NA,Moscow Oblast,7503385,709,0,4662,0
2020-04-20,Russia,NA,Moscow Oblast,7503385,578,0,5240,0
2020-04-21,Russia,NA,Moscow Oblast,7503385,718,0,5958,0
2020-04-22,Russia,NA,Moscow Oblast,7503385,631,0,6589,0
2020-04-23,Russia,NA,Moscow Oblast,7503385,688,0,7277,0
2020-04-24,Russia,NA,Moscow Oblast,7503385,611,0,7888,0
2020-04-25,Russia,NA,Moscow Oblast,7503385,605,0,8493,0
2020-04-26,Russia,NA,Moscow Oblast,7503385,576,0,9069,0
2020-04-27,Russia,NA,Moscow Oblast,7503385,638,0,9707,0
2020-04-28,Russia,NA,Moscow Oblast,7503385,523,0,10230,0
2020-04-29,Russia,NA,Moscow Oblast,7503385,686,0,10916,0
2020-04-30,Russia,NA,Moscow Oblast,7503385,793,0,11709,0
2020-05-01,Russia,NA,Moscow Oblast,7503385,797,0,12506,0
2020-05-02,Russia,NA,Moscow Oblast,7503385,807,0,13313,0
2020-05-03,Russia,NA,Moscow Oblast,7503385,822,0,14135,0
2020-05-04,Russia,NA,Moscow Oblast,7503385,803,0,14938,0
2020-05-05,Russia,NA,Moscow Oblast,7503385,822,0,15760,0
2020-05-06,Russia,NA,Moscow Oblast,7503385,829,0,16589,0
2020-05-07,Russia,NA,Moscow Oblast,7503385,842,0,17431,0
2020-05-08,Russia,NA,Moscow Oblast,7503385,918,0,18349,0
2020-05-09,Russia,NA,Moscow Oblast,7503385,1075,0,19424,0
2020-05-10,Russia,NA,Moscow Oblast,7503385,1133,0,20557,0
2020-05-11,Russia,NA,Moscow Oblast,7503385,1079,0,21636,0
2020-05-12,Russia,NA,Moscow Oblast,7503385,1063,0,22699,0
2020-05-13,Russia,NA,Moscow Oblast,7503385,962,0,23661,0
2020-05-14,Russia,NA,Moscow Oblast,7503385,918,0,24579,0
2020-05-15,Russia,NA,Moscow Oblast,7503385,945,0,25524,0
2020-05-16,Russia,NA,Moscow Oblast,7503385,937,0,26461,0
2020-05-17,Russia,NA,Moscow Oblast,7503385,907,0,27368,0
2020-05-18,Russia,NA,Moscow Oblast,7503385,921,0,28289,0
2020-05-19,Russia,NA,Moscow Oblast,7503385,898,0,29187,0
2020-05-20,Russia,NA,Moscow Oblast,7503385,903,0,30090,0
2020-05-21,Russia,NA,Moscow Oblast,7503385,892,0,30982,0
2020-05-22,Russia,NA,Moscow Oblast,7503385,824,0,31806,0
2020-05-23,Russia,NA,Moscow Oblast,7503385,846,0,32652,0
2020-05-24,Russia,NA,Moscow Oblast,7503385,862,0,33514,0
2020-05-25,Russia,NA,Moscow Oblast,7503385,831,0,34345,0
2020-05-26,Russia,NA,Moscow Oblast,7503385,817,0,35162,0
2020-05-27,Russia,NA,Moscow Oblast,7503385,793,0,35955,0
2020-05-28,Russia,NA,Moscow Oblast,7503385,774,0,36729,0
2020-05-29,Russia,NA,Moscow Oblast,7503385,773,0,37502,0
2020-05-30,Russia,NA,Moscow Oblast,7503385,735,0,38237,0
2020-05-31,Russia,NA,Moscow Oblast,7503385,757,0,38994,0
2020-06-01,Russia,NA,Moscow Oblast,7503385,728,0,39722,0
2020-06-02,Russia,NA,Moscow Oblast,7503385,732,0,40454,0
2020-06-03,Russia,NA,Moscow Oblast,7503385,736,0,41190,0
2020-06-04,Russia,NA,Moscow Oblast,7503385,767,0,41957,0
2020-06-05,Russia,NA,Moscow Oblast,7503385,762,0,42719,0
2020-06-06,Russia,NA,Moscow Oblast,7503385,758,0,43477,0
2020-06-07,Russia,NA,Moscow Oblast,7503385,754,0,44231,0
2020-06-08,Russia,NA,Moscow Oblast,7503385,751,0,44982,0
2020-06-09,Russia,NA,Moscow Oblast,7503385,739,0,45721,0
2020-06-10,Russia,NA,Moscow Oblast,7503385,735,0,46456,0
2020-06-11,Russia,NA,Moscow Oblast,7503385,724,0,47180,0
2020-06-12,Russia,NA,Moscow Oblast,7503385,730,0,47910,0
2020-06-13,Russia,NA,Moscow Oblast,7503385,725,0,48635,0
2020-06-14,Russia,NA,Moscow Oblast,7503385,717,0,49352,0
2020-06-15,Russia,NA,Moscow Oblast,7503385,689,0,50041,0
2020-06-16,Russia,NA,Moscow Oblast,7503385,694,0,50735,0
2020-06-17,Russia,NA,Moscow Oblast,7503385,680,0,51415,0
2020-06-18,Russia,NA,Moscow Oblast,7503385,667,0,52082,0
2020-06-19,Russia,NA,Moscow Oblast,7503385,646,0,52728,0
2020-06-20,Russia,NA,Moscow Oblast,7503385,591,0,53319,0
2020-06-21,Russia,NA,Moscow Oblast,7503385,549,0,53868,0
2020-06-22,Russia,NA,Moscow Oblast,7503385,506,0,54374,0
2020-06-23,Russia,NA,Moscow Oblast,7503385,504,0,54878,0
2020-06-24,Russia,NA,Moscow Oblast,7503385,507,0,55385,0
2020-06-25,Russia,NA,Moscow Oblast,7503385,467,0,55852,0
2020-06-26,Russia,NA,Moscow Oblast,7503385,390,0,56242,0
2020-06-27,Russia,NA,Moscow Oblast,7503385,366,0,56608,0
2020-06-28,Russia,NA,Moscow Oblast,7503385,325,0,56933,0
2020-06-29,Russia,NA,Moscow Oblast,7503385,335,0,57268,0
2020-06-30,Russia,NA,Moscow Oblast,7503385,301,0,57569,0
2020-07-01,Russia,NA,Moscow Oblast,7503385,306,0,57875,0
2020-07-02,Russia,NA,Moscow Oblast,7503385,317,0,58192,0
2020-07-03,Russia,NA,Moscow Oblast,7503385,298,0,58490,0
2020-07-04,Russia,NA,Moscow Oblast,7503385,275,0,58765,0
2020-07-05,Russia,NA,Moscow Oblast,7503385,287,0,59052,0
2020-07-06,Russia,NA,Moscow Oblast,7503385,292,0,59344,0
2020-07-07,Russia,NA,Moscow Oblast,7503385,177,0,59521,0
2020-07-08,Russia,NA,Moscow Oblast,7503385,194,0,59715,0
2020-07-09,Russia,NA,Moscow Oblast,7503385,192,0,59907,0
2020-07-10,Russia,NA,Moscow Oblast,7503385,199,0,60106,0
2020-07-11,Russia,NA,Moscow Oblast,7503385,188,0,60294,0
2020-07-12,Russia,NA,Moscow Oblast,7503385,197,0,60491,0
2020-07-13,Russia,NA,Moscow Oblast,7503385,196,0,60687,0
2020-07-14,Russia,NA,Moscow Oblast,7503385,198,0,60885,0
2020-07-15,Russia,NA,Moscow Oblast,7503385,173,0,61058,0
2020-07-16,Russia,NA,Moscow Oblast,7503385,174,0,61232,0
2020-07-17,Russia,NA,Moscow Oblast,7503385,166,0,61398,0
2020-07-18,Russia,NA,Moscow Oblast,7503385,173,0,61571,0
2020-07-19,Russia,NA,Moscow Oblast,7503385,171,0,61742,0
2020-07-20,Russia,NA,Moscow Oblast,7503385,153,0,61895,0
2020-07-21,Russia,NA,Moscow Oblast,7503385,149,0,62044,0
2020-07-22,Russia,NA,Moscow Oblast,7503385,128,0,62172,0
2020-07-23,Russia,NA,Moscow Oblast,7503385,145,0,62317,0
2020-07-24,Russia,NA,Moscow Oblast,7503385,143,0,62460,0
2020-07-25,Russia,NA,Moscow Oblast,7503385,148,0,62608,0
2020-07-26,Russia,NA,Moscow Oblast,7503385,144,0,62752,0
2020-07-27,Russia,NA,Moscow Oblast,7503385,139,0,62891,0
2020-07-28,Russia,NA,Moscow Oblast,7503385,126,0,63017,0
2020-07-29,Russia,NA,Moscow Oblast,7503385,137,0,63154,0
2020-07-30,Russia,NA,Moscow Oblast,7503385,144,0,63298,0
2020-07-31,Russia,NA,Moscow Oblast,7503385,150,0,63448,0
2020-08-01,Russia,NA,Moscow Oblast,7503385,149,0,63597,0
2020-08-02,Russia,NA,Moscow Oblast,7503385,157,0,63754,0
2020-08-26,Russia,NA,Moscow Oblast,7503385,0,0,67451,1174
2020-08-27,Russia,NA,Moscow Oblast,7503385,148,0,67599,1174
2020-08-28,Russia,NA,Moscow Oblast,7503385,150,4,67749,1178
2020-08-29,Russia,NA,Moscow Oblast,7503385,163,4,67912,1182
2020-08-30,Russia,NA,Moscow Oblast,7503385,165,3,68077,1185
2020-08-31,Russia,NA,Moscow Oblast,7503385,146,2,68223,1187
2020-09-01,Russia,NA,Moscow Oblast,7503385,156,6,68379,1193
2020-09-02,Russia,NA,Moscow Oblast,7503385,158,5,68537,1198
2020-09-03,Russia,NA,Moscow Oblast,7503385,163,6,68700,1204
2020-09-04,Russia,NA,Moscow Oblast,7503385,164,5,68864,1209
2020-09-05,Russia,NA,Moscow Oblast,7503385,168,4,69032,1213
2020-09-06,Russia,NA,Moscow Oblast,7503385,167,3,69199,1216
2020-09-07,Russia,NA,Moscow Oblast,7503385,166,2,69365,1218
2020-09-08,Russia,NA,Moscow Oblast,7503385,135,5,69500,1223
2020-09-09,Russia,NA,Moscow Oblast,7503385,164,3,69664,1226
2020-09-10,Russia,NA,Moscow Oblast,7503385,169,6,69833,1232
2020-09-11,Russia,NA,Moscow Oblast,7503385,175,5,70008,1237
2020-09-12,Russia,NA,Moscow Oblast,7503385,170,4,70178,1241
2020-09-13,Russia,NA,Moscow Oblast,7503385,166,3,70344,1244
2020-09-14,Russia,NA,Moscow Oblast,7503385,163,5,70507,1249
2020-09-15,Russia,NA,Moscow Oblast,7503385,151,6,70658,1255
2020-09-16,Russia,NA,Moscow Oblast,7503385,173,6,70831,1261
2020-09-17,Russia,NA,Moscow Oblast,7503385,177,6,71008,1267
2020-09-18,Russia,NA,Moscow Oblast,7503385,165,5,71173,1272
2020-09-19,Russia,NA,Moscow Oblast,7503385,175,6,71348,1278
2020-09-20,Russia,NA,Moscow Oblast,7503385,188,3,71536,1281
2020-09-21,Russia,NA,Moscow Oblast,7503385,193,4,71729,1285
2020-09-22,Russia,NA,Moscow Oblast,7503385,172,7,71901,1292
2020-09-23,Russia,NA,Moscow Oblast,7503385,215,6,72116,1298
2020-03-31,Russia,NA,Murmansk Oblast,753557,6,0,11,0
2020-04-02,Russia,NA,Murmansk Oblast,753557,4,0,15,0
2020-04-06,Russia,NA,Murmansk Oblast,753557,3,0,18,0
2020-04-08,Russia,NA,Murmansk Oblast,753557,25,0,43,0
2020-04-09,Russia,NA,Murmansk Oblast,753557,1,0,44,0
2020-04-10,Russia,NA,Murmansk Oblast,753557,23,0,67,0
2020-04-12,Russia,NA,Murmansk Oblast,753557,61,0,128,0
2020-04-15,Russia,NA,Murmansk Oblast,753557,137,0,265,0
2020-04-16,Russia,NA,Murmansk Oblast,753557,41,0,306,0
2020-04-17,Russia,NA,Murmansk Oblast,753557,8,0,314,0
2020-04-18,Russia,NA,Murmansk Oblast,753557,7,0,321,0
2020-04-19,Russia,NA,Murmansk Oblast,753557,33,0,354,0
2020-04-20,Russia,NA,Murmansk Oblast,753557,46,0,400,0
2020-04-21,Russia,NA,Murmansk Oblast,753557,35,0,435,0
2020-04-22,Russia,NA,Murmansk Oblast,753557,71,0,506,0
2020-04-23,Russia,NA,Murmansk Oblast,753557,97,0,603,0
2020-04-24,Russia,NA,Murmansk Oblast,753557,60,0,663,0
2020-04-25,Russia,NA,Murmansk Oblast,753557,193,0,856,0
2020-04-26,Russia,NA,Murmansk Oblast,753557,105,0,961,0
2020-04-27,Russia,NA,Murmansk Oblast,753557,28,0,989,0
2020-04-28,Russia,NA,Murmansk Oblast,753557,67,0,1056,0
2020-04-29,Russia,NA,Murmansk Oblast,753557,70,0,1126,0
2020-04-30,Russia,NA,Murmansk Oblast,753557,101,0,1227,0
2020-05-01,Russia,NA,Murmansk Oblast,753557,86,0,1313,0
2020-05-02,Russia,NA,Murmansk Oblast,753557,143,0,1456,0
2020-05-03,Russia,NA,Murmansk Oblast,753557,238,0,1694,0
2020-05-04,Russia,NA,Murmansk Oblast,753557,280,0,1974,0
2020-05-05,Russia,NA,Murmansk Oblast,753557,127,0,2101,0
2020-05-06,Russia,NA,Murmansk Oblast,753557,136,0,2237,0
2020-05-07,Russia,NA,Murmansk Oblast,753557,35,0,2272,0
2020-05-08,Russia,NA,Murmansk Oblast,753557,50,0,2322,0
2020-05-09,Russia,NA,Murmansk Oblast,753557,18,0,2340,0
2020-05-10,Russia,NA,Murmansk Oblast,753557,31,0,2371,0
2020-05-11,Russia,NA,Murmansk Oblast,753557,45,0,2416,0
2020-05-12,Russia,NA,Murmansk Oblast,753557,12,0,2428,0
2020-05-13,Russia,NA,Murmansk Oblast,753557,43,0,2471,0
2020-05-14,Russia,NA,Murmansk Oblast,753557,21,0,2492,0
2020-05-15,Russia,NA,Murmansk Oblast,753557,59,0,2551,0
2020-05-16,Russia,NA,Murmansk Oblast,753557,93,0,2644,0
2020-05-17,Russia,NA,Murmansk Oblast,753557,10,0,2654,0
2020-05-18,Russia,NA,Murmansk Oblast,753557,12,0,2666,0
2020-05-19,Russia,NA,Murmansk Oblast,753557,18,0,2684,0
2020-05-20,Russia,NA,Murmansk Oblast,753557,30,0,2714,0
2020-05-21,Russia,NA,Murmansk Oblast,753557,67,0,2781,0
2020-05-22,Russia,NA,Murmansk Oblast,753557,53,0,2834,0
2020-05-23,Russia,NA,Murmansk Oblast,753557,34,0,2868,0
2020-05-24,Russia,NA,Murmansk Oblast,753557,32,0,2900,0
2020-05-25,Russia,NA,Murmansk Oblast,753557,36,0,2936,0
2020-05-26,Russia,NA,Murmansk Oblast,753557,45,0,2981,0
2020-05-27,Russia,NA,Murmansk Oblast,753557,49,0,3030,0
2020-05-28,Russia,NA,Murmansk Oblast,753557,46,0,3076,0
2020-05-29,Russia,NA,Murmansk Oblast,753557,60,0,3136,0
2020-05-30,Russia,NA,Murmansk Oblast,753557,45,0,3181,0
2020-05-31,Russia,NA,Murmansk Oblast,753557,41,0,3222,0
2020-06-01,Russia,NA,Murmansk Oblast,753557,42,0,3264,0
2020-06-02,Russia,NA,Murmansk Oblast,753557,32,0,3296,0
2020-06-03,Russia,NA,Murmansk Oblast,753557,46,0,3342,0
2020-06-04,Russia,NA,Murmansk Oblast,753557,33,0,3375,0
2020-06-05,Russia,NA,Murmansk Oblast,753557,47,0,3422,0
2020-06-06,Russia,NA,Murmansk Oblast,753557,50,0,3472,0
2020-06-07,Russia,NA,Murmansk Oblast,753557,58,0,3530,0
2020-06-08,Russia,NA,Murmansk Oblast,753557,46,0,3576,0
2020-06-09,Russia,NA,Murmansk Oblast,753557,98,0,3674,0
2020-06-10,Russia,NA,Murmansk Oblast,753557,26,0,3700,0
2020-06-11,Russia,NA,Murmansk Oblast,753557,60,0,3760,0
2020-06-12,Russia,NA,Murmansk Oblast,753557,58,0,3818,0
2020-06-13,Russia,NA,Murmansk Oblast,753557,71,0,3889,0
2020-06-14,Russia,NA,Murmansk Oblast,753557,57,0,3946,0
2020-06-15,Russia,NA,Murmansk Oblast,753557,65,0,4011,0
2020-06-16,Russia,NA,Murmansk Oblast,753557,72,0,4083,0
2020-06-17,Russia,NA,Murmansk Oblast,753557,72,0,4155,0
2020-06-18,Russia,NA,Murmansk Oblast,753557,64,0,4219,0
2020-06-19,Russia,NA,Murmansk Oblast,753557,61,0,4280,0
2020-06-20,Russia,NA,Murmansk Oblast,753557,66,0,4346,0
2020-06-21,Russia,NA,Murmansk Oblast,753557,85,0,4431,0
2020-06-22,Russia,NA,Murmansk Oblast,753557,85,0,4516,0
2020-06-23,Russia,NA,Murmansk Oblast,753557,70,0,4586,0
2020-06-24,Russia,NA,Murmansk Oblast,753557,74,0,4660,0
2020-06-25,Russia,NA,Murmansk Oblast,753557,72,0,4732,0
2020-06-26,Russia,NA,Murmansk Oblast,753557,79,0,4811,0
2020-06-27,Russia,NA,Murmansk Oblast,753557,90,0,4901,0
2020-06-28,Russia,NA,Murmansk Oblast,753557,93,0,4994,0
2020-06-29,Russia,NA,Murmansk Oblast,753557,99,0,5093,0
2020-06-30,Russia,NA,Murmansk Oblast,753557,118,0,5211,0
2020-07-01,Russia,NA,Murmansk Oblast,753557,135,0,5346,0
2020-07-02,Russia,NA,Murmansk Oblast,753557,139,0,5485,0
2020-07-03,Russia,NA,Murmansk Oblast,753557,147,0,5632,0
2020-07-04,Russia,NA,Murmansk Oblast,753557,134,0,5766,0
2020-07-05,Russia,NA,Murmansk Oblast,753557,137,0,5903,0
2020-07-06,Russia,NA,Murmansk Oblast,753557,135,0,6038,0
2020-07-07,Russia,NA,Murmansk Oblast,753557,158,0,6196,0
2020-07-08,Russia,NA,Murmansk Oblast,753557,163,0,6359,0
2020-07-09,Russia,NA,Murmansk Oblast,753557,153,0,6512,0
2020-07-10,Russia,NA,Murmansk Oblast,753557,173,0,6685,0
2020-07-11,Russia,NA,Murmansk Oblast,753557,181,0,6866,0
2020-07-12,Russia,NA,Murmansk Oblast,753557,183,0,7049,0
2020-07-13,Russia,NA,Murmansk Oblast,753557,179,0,7228,0
2020-07-14,Russia,NA,Murmansk Oblast,753557,182,0,7410,0
2020-07-15,Russia,NA,Murmansk Oblast,753557,187,0,7597,0
2020-07-16,Russia,NA,Murmansk Oblast,753557,183,0,7780,0
2020-07-17,Russia,NA,Murmansk Oblast,753557,163,0,7943,0
2020-07-18,Russia,NA,Murmansk Oblast,753557,162,0,8105,0
2020-07-19,Russia,NA,Murmansk Oblast,753557,167,0,8272,0
2020-07-20,Russia,NA,Murmansk Oblast,753557,172,0,8444,0
2020-07-21,Russia,NA,Murmansk Oblast,753557,172,0,8616,0
2020-07-22,Russia,NA,Murmansk Oblast,753557,183,0,8799,0
2020-07-23,Russia,NA,Murmansk Oblast,753557,177,0,8976,0
2020-07-24,Russia,NA,Murmansk Oblast,753557,170,0,9146,0
2020-07-25,Russia,NA,Murmansk Oblast,753557,165,0,9311,0
2020-07-26,Russia,NA,Murmansk Oblast,753557,158,0,9469,0
2020-07-27,Russia,NA,Murmansk Oblast,753557,158,0,9627,0
2020-07-28,Russia,NA,Murmansk Oblast,753557,164,0,9791,0
2020-07-29,Russia,NA,Murmansk Oblast,753557,156,0,9947,0
2020-07-30,Russia,NA,Murmansk Oblast,753557,146,0,10093,0
2020-07-31,Russia,NA,Murmansk Oblast,753557,139,0,10232,0
2020-08-01,Russia,NA,Murmansk Oblast,753557,138,0,10370,0
2020-08-02,Russia,NA,Murmansk Oblast,753557,137,0,10507,0
2020-08-26,Russia,NA,Murmansk Oblast,753557,0,0,12496,154
2020-08-27,Russia,NA,Murmansk Oblast,753557,69,3,12565,157
2020-08-28,Russia,NA,Murmansk Oblast,753557,66,0,12631,157
2020-08-29,Russia,NA,Murmansk Oblast,753557,65,1,12696,158
2020-08-30,Russia,NA,Murmansk Oblast,753557,64,1,12760,159
2020-08-31,Russia,NA,Murmansk Oblast,753557,67,0,12827,159
2020-09-01,Russia,NA,Murmansk Oblast,753557,65,3,12892,162
2020-09-02,Russia,NA,Murmansk Oblast,753557,75,3,12967,165
2020-09-03,Russia,NA,Murmansk Oblast,753557,73,1,13040,166
2020-09-04,Russia,NA,Murmansk Oblast,753557,70,2,13110,168
2020-09-05,Russia,NA,Murmansk Oblast,753557,63,1,13173,169
2020-09-06,Russia,NA,Murmansk Oblast,753557,60,1,13233,170
2020-09-07,Russia,NA,Murmansk Oblast,753557,62,1,13295,171
2020-09-08,Russia,NA,Murmansk Oblast,753557,63,2,13358,173
2020-09-09,Russia,NA,Murmansk Oblast,753557,66,2,13424,175
2020-09-10,Russia,NA,Murmansk Oblast,753557,69,1,13493,176
2020-09-11,Russia,NA,Murmansk Oblast,753557,67,1,13560,177
2020-09-12,Russia,NA,Murmansk Oblast,753557,68,3,13628,180
2020-09-13,Russia,NA,Murmansk Oblast,753557,67,3,13695,183
2020-09-14,Russia,NA,Murmansk Oblast,753557,69,2,13764,185
2020-09-15,Russia,NA,Murmansk Oblast,753557,72,0,13836,185
2020-09-16,Russia,NA,Murmansk Oblast,753557,75,3,13911,188
2020-09-17,Russia,NA,Murmansk Oblast,753557,73,1,13984,189
2020-09-18,Russia,NA,Murmansk Oblast,753557,76,3,14060,192
2020-09-19,Russia,NA,Murmansk Oblast,753557,78,2,14138,194
2020-09-20,Russia,NA,Murmansk Oblast,753557,77,2,14215,196
2020-09-21,Russia,NA,Murmansk Oblast,753557,75,1,14290,197
2020-09-22,Russia,NA,Murmansk Oblast,753557,72,2,14362,199
2020-09-23,Russia,NA,Murmansk Oblast,753557,73,3,14435,202
2020-03-28,Russia,NA,Nizhny Novgorod Oblast,3234752,3,0,11,0
2020-03-31,Russia,NA,Nizhny Novgorod Oblast,3234752,1,0,12,0
2020-04-02,Russia,NA,Nizhny Novgorod Oblast,3234752,13,0,25,0
2020-04-05,Russia,NA,Nizhny Novgorod Oblast,3234752,22,0,47,0
2020-04-06,Russia,NA,Nizhny Novgorod Oblast,3234752,9,0,56,0
2020-04-08,Russia,NA,Nizhny Novgorod Oblast,3234752,24,0,80,0
2020-04-09,Russia,NA,Nizhny Novgorod Oblast,3234752,7,0,87,0
2020-04-10,Russia,NA,Nizhny Novgorod Oblast,3234752,32,0,119,0
2020-04-11,Russia,NA,Nizhny Novgorod Oblast,3234752,33,0,152,0
2020-04-12,Russia,NA,Nizhny Novgorod Oblast,3234752,42,0,194,0
2020-04-13,Russia,NA,Nizhny Novgorod Oblast,3234752,30,0,224,0
2020-04-14,Russia,NA,Nizhny Novgorod Oblast,3234752,68,0,292,0
2020-04-15,Russia,NA,Nizhny Novgorod Oblast,3234752,47,0,339,0
2020-04-16,Russia,NA,Nizhny Novgorod Oblast,3234752,65,0,404,0
2020-04-17,Russia,NA,Nizhny Novgorod Oblast,3234752,54,0,458,0
2020-04-18,Russia,NA,Nizhny Novgorod Oblast,3234752,59,0,517,0
2020-04-19,Russia,NA,Nizhny Novgorod Oblast,3234752,129,0,646,0
2020-04-20,Russia,NA,Nizhny Novgorod Oblast,3234752,113,0,759,0
2020-04-21,Russia,NA,Nizhny Novgorod Oblast,3234752,101,0,860,0
2020-04-22,Russia,NA,Nizhny Novgorod Oblast,3234752,69,0,929,0
2020-04-23,Russia,NA,Nizhny Novgorod Oblast,3234752,73,0,1002,0
2020-04-24,Russia,NA,Nizhny Novgorod Oblast,3234752,94,0,1096,0
2020-04-25,Russia,NA,Nizhny Novgorod Oblast,3234752,118,0,1214,0
2020-04-26,Russia,NA,Nizhny Novgorod Oblast,3234752,153,0,1367,0
2020-04-27,Russia,NA,Nizhny Novgorod Oblast,3234752,207,0,1574,0
2020-04-28,Russia,NA,Nizhny Novgorod Oblast,3234752,89,0,1663,0
2020-04-29,Russia,NA,Nizhny Novgorod Oblast,3234752,131,0,1794,0
2020-04-30,Russia,NA,Nizhny Novgorod Oblast,3234752,150,0,1944,0
2020-05-01,Russia,NA,Nizhny Novgorod Oblast,3234752,179,0,2123,0
2020-05-02,Russia,NA,Nizhny Novgorod Oblast,3234752,320,0,2443,0
2020-05-03,Russia,NA,Nizhny Novgorod Oblast,3234752,252,0,2695,0
2020-05-04,Russia,NA,Nizhny Novgorod Oblast,3234752,157,0,2852,0
2020-05-05,Russia,NA,Nizhny Novgorod Oblast,3234752,174,0,3026,0
2020-05-06,Russia,NA,Nizhny Novgorod Oblast,3234752,272,0,3298,0
2020-05-07,Russia,NA,Nizhny Novgorod Oblast,3234752,312,0,3610,0
2020-05-08,Russia,NA,Nizhny Novgorod Oblast,3234752,276,0,3886,0
2020-05-09,Russia,NA,Nizhny Novgorod Oblast,3234752,294,0,4180,0
2020-05-10,Russia,NA,Nizhny Novgorod Oblast,3234752,262,0,4442,0
2020-05-11,Russia,NA,Nizhny Novgorod Oblast,3234752,291,0,4733,0
2020-05-12,Russia,NA,Nizhny Novgorod Oblast,3234752,354,0,5087,0
2020-05-13,Russia,NA,Nizhny Novgorod Oblast,3234752,271,0,5358,0
2020-05-14,Russia,NA,Nizhny Novgorod Oblast,3234752,238,0,5596,0
2020-05-15,Russia,NA,Nizhny Novgorod Oblast,3234752,307,0,5903,0
2020-05-16,Russia,NA,Nizhny Novgorod Oblast,3234752,229,0,6132,0
2020-05-17,Russia,NA,Nizhny Novgorod Oblast,3234752,281,0,6413,0
2020-05-18,Russia,NA,Nizhny Novgorod Oblast,3234752,279,0,6692,0
2020-05-19,Russia,NA,Nizhny Novgorod Oblast,3234752,260,0,6952,0
2020-05-20,Russia,NA,Nizhny Novgorod Oblast,3234752,257,0,7209,0
2020-05-21,Russia,NA,Nizhny Novgorod Oblast,3234752,204,0,7413,0
2020-05-22,Russia,NA,Nizhny Novgorod Oblast,3234752,202,0,7615,0
2020-05-23,Russia,NA,Nizhny Novgorod Oblast,3234752,211,0,7826,0
2020-05-24,Russia,NA,Nizhny Novgorod Oblast,3234752,221,0,8047,0
2020-05-25,Russia,NA,Nizhny Novgorod Oblast,3234752,229,0,8276,0
2020-05-26,Russia,NA,Nizhny Novgorod Oblast,3234752,228,0,8504,0
2020-05-27,Russia,NA,Nizhny Novgorod Oblast,3234752,231,0,8735,0
2020-05-28,Russia,NA,Nizhny Novgorod Oblast,3234752,228,0,8963,0
2020-05-29,Russia,NA,Nizhny Novgorod Oblast,3234752,281,0,9244,0
2020-05-30,Russia,NA,Nizhny Novgorod Oblast,3234752,289,0,9533,0
2020-05-31,Russia,NA,Nizhny Novgorod Oblast,3234752,301,0,9834,0
2020-06-01,Russia,NA,Nizhny Novgorod Oblast,3234752,315,0,10149,0
2020-06-02,Russia,NA,Nizhny Novgorod Oblast,3234752,354,0,10503,0
2020-06-03,Russia,NA,Nizhny Novgorod Oblast,3234752,347,0,10850,0
2020-06-04,Russia,NA,Nizhny Novgorod Oblast,3234752,319,0,11169,0
2020-06-05,Russia,NA,Nizhny Novgorod Oblast,3234752,330,0,11499,0
2020-06-06,Russia,NA,Nizhny Novgorod Oblast,3234752,321,0,11820,0
2020-06-07,Russia,NA,Nizhny Novgorod Oblast,3234752,317,0,12137,0
2020-06-08,Russia,NA,Nizhny Novgorod Oblast,3234752,305,0,12442,0
2020-06-09,Russia,NA,Nizhny Novgorod Oblast,3234752,292,0,12734,0
2020-06-10,Russia,NA,Nizhny Novgorod Oblast,3234752,304,0,13038,0
2020-06-11,Russia,NA,Nizhny Novgorod Oblast,3234752,303,0,13341,0
2020-06-12,Russia,NA,Nizhny Novgorod Oblast,3234752,221,0,13562,0
2020-06-13,Russia,NA,Nizhny Novgorod Oblast,3234752,218,0,13780,0
2020-06-14,Russia,NA,Nizhny Novgorod Oblast,3234752,215,0,13995,0
2020-06-15,Russia,NA,Nizhny Novgorod Oblast,3234752,209,0,14204,0
2020-06-16,Russia,NA,Nizhny Novgorod Oblast,3234752,206,0,14410,0
2020-06-17,Russia,NA,Nizhny Novgorod Oblast,3234752,238,0,14648,0
2020-06-18,Russia,NA,Nizhny Novgorod Oblast,3234752,233,0,14881,0
2020-06-19,Russia,NA,Nizhny Novgorod Oblast,3234752,219,0,15100,0
2020-06-20,Russia,NA,Nizhny Novgorod Oblast,3234752,228,0,15328,0
2020-06-21,Russia,NA,Nizhny Novgorod Oblast,3234752,227,0,15555,0
2020-06-22,Russia,NA,Nizhny Novgorod Oblast,3234752,219,0,15774,0
2020-06-23,Russia,NA,Nizhny Novgorod Oblast,3234752,216,0,15990,0
2020-06-24,Russia,NA,Nizhny Novgorod Oblast,3234752,207,0,16197,0
2020-06-25,Russia,NA,Nizhny Novgorod Oblast,3234752,217,0,16414,0
2020-06-26,Russia,NA,Nizhny Novgorod Oblast,3234752,210,0,16624,0
2020-06-27,Russia,NA,Nizhny Novgorod Oblast,3234752,214,0,16838,0
2020-06-28,Russia,NA,Nizhny Novgorod Oblast,3234752,222,0,17060,0
2020-06-29,Russia,NA,Nizhny Novgorod Oblast,3234752,218,0,17278,0
2020-06-30,Russia,NA,Nizhny Novgorod Oblast,3234752,203,0,17481,0
2020-07-01,Russia,NA,Nizhny Novgorod Oblast,3234752,228,0,17709,0
2020-07-02,Russia,NA,Nizhny Novgorod Oblast,3234752,234,0,17943,0
2020-07-03,Russia,NA,Nizhny Novgorod Oblast,3234752,229,0,18172,0
2020-07-04,Russia,NA,Nizhny Novgorod Oblast,3234752,225,0,18397,0
2020-07-05,Russia,NA,Nizhny Novgorod Oblast,3234752,217,0,18614,0
2020-07-06,Russia,NA,Nizhny Novgorod Oblast,3234752,212,0,18826,0
2020-07-07,Russia,NA,Nizhny Novgorod Oblast,3234752,198,0,19024,0
2020-07-08,Russia,NA,Nizhny Novgorod Oblast,3234752,217,0,19241,0
2020-07-09,Russia,NA,Nizhny Novgorod Oblast,3234752,224,0,19465,0
2020-07-10,Russia,NA,Nizhny Novgorod Oblast,3234752,219,0,19684,0
2020-07-11,Russia,NA,Nizhny Novgorod Oblast,3234752,223,0,19907,0
2020-07-12,Russia,NA,Nizhny Novgorod Oblast,3234752,222,0,20129,0
2020-07-13,Russia,NA,Nizhny Novgorod Oblast,3234752,212,0,20341,0
2020-07-14,Russia,NA,Nizhny Novgorod Oblast,3234752,193,0,20534,0
2020-07-15,Russia,NA,Nizhny Novgorod Oblast,3234752,229,0,20763,0
2020-07-16,Russia,NA,Nizhny Novgorod Oblast,3234752,221,0,20984,0
2020-07-17,Russia,NA,Nizhny Novgorod Oblast,3234752,216,0,21200,0
2020-07-18,Russia,NA,Nizhny Novgorod Oblast,3234752,205,0,21405,0
2020-07-19,Russia,NA,Nizhny Novgorod Oblast,3234752,218,0,21623,0
2020-07-20,Russia,NA,Nizhny Novgorod Oblast,3234752,191,0,21814,0
2020-07-21,Russia,NA,Nizhny Novgorod Oblast,3234752,196,0,22010,0
2020-07-22,Russia,NA,Nizhny Novgorod Oblast,3234752,217,0,22227,0
2020-07-23,Russia,NA,Nizhny Novgorod Oblast,3234752,202,0,22429,0
2020-07-24,Russia,NA,Nizhny Novgorod Oblast,3234752,194,0,22623,0
2020-07-25,Russia,NA,Nizhny Novgorod Oblast,3234752,184,0,22807,0
2020-07-26,Russia,NA,Nizhny Novgorod Oblast,3234752,177,0,22984,0
2020-07-27,Russia,NA,Nizhny Novgorod Oblast,3234752,188,0,23172,0
2020-07-28,Russia,NA,Nizhny Novgorod Oblast,3234752,163,0,23335,0
2020-07-29,Russia,NA,Nizhny Novgorod Oblast,3234752,154,0,23489,0
2020-07-30,Russia,NA,Nizhny Novgorod Oblast,3234752,158,0,23647,0
2020-07-31,Russia,NA,Nizhny Novgorod Oblast,3234752,145,0,23792,0
2020-08-01,Russia,NA,Nizhny Novgorod Oblast,3234752,159,0,23951,0
2020-08-02,Russia,NA,Nizhny Novgorod Oblast,3234752,146,0,24097,0
2020-08-26,Russia,NA,Nizhny Novgorod Oblast,3234752,0,0,26995,453
2020-08-27,Russia,NA,Nizhny Novgorod Oblast,3234752,134,3,27129,456
2020-08-28,Russia,NA,Nizhny Novgorod Oblast,3234752,133,4,27262,460
2020-08-29,Russia,NA,Nizhny Novgorod Oblast,3234752,145,5,27407,465
2020-08-30,Russia,NA,Nizhny Novgorod Oblast,3234752,143,4,27550,469
2020-08-31,Russia,NA,Nizhny Novgorod Oblast,3234752,138,4,27688,473
2020-09-01,Russia,NA,Nizhny Novgorod Oblast,3234752,132,4,27820,477
2020-09-02,Russia,NA,Nizhny Novgorod Oblast,3234752,147,4,27967,481
2020-09-03,Russia,NA,Nizhny Novgorod Oblast,3234752,143,4,28110,485
2020-09-04,Russia,NA,Nizhny Novgorod Oblast,3234752,145,3,28255,488
2020-09-05,Russia,NA,Nizhny Novgorod Oblast,3234752,154,4,28409,492
2020-09-06,Russia,NA,Nizhny Novgorod Oblast,3234752,153,2,28562,494
2020-09-07,Russia,NA,Nizhny Novgorod Oblast,3234752,151,3,28713,497
2020-09-08,Russia,NA,Nizhny Novgorod Oblast,3234752,146,4,28859,501
2020-09-09,Russia,NA,Nizhny Novgorod Oblast,3234752,159,3,29018,504
2020-09-10,Russia,NA,Nizhny Novgorod Oblast,3234752,163,2,29181,506
2020-09-11,Russia,NA,Nizhny Novgorod Oblast,3234752,161,3,29342,509
2020-09-12,Russia,NA,Nizhny Novgorod Oblast,3234752,156,6,29498,515
2020-09-13,Russia,NA,Nizhny Novgorod Oblast,3234752,159,5,29657,520
2020-09-14,Russia,NA,Nizhny Novgorod Oblast,3234752,147,6,29804,526
2020-09-15,Russia,NA,Nizhny Novgorod Oblast,3234752,139,3,29943,529
2020-09-16,Russia,NA,Nizhny Novgorod Oblast,3234752,165,3,30108,532
2020-09-17,Russia,NA,Nizhny Novgorod Oblast,3234752,166,3,30274,535
2020-09-18,Russia,NA,Nizhny Novgorod Oblast,3234752,161,3,30435,538
2020-09-19,Russia,NA,Nizhny Novgorod Oblast,3234752,164,5,30599,543
2020-09-20,Russia,NA,Nizhny Novgorod Oblast,3234752,165,0,30764,543
2020-09-21,Russia,NA,Nizhny Novgorod Oblast,3234752,162,3,30926,546
2020-09-22,Russia,NA,Nizhny Novgorod Oblast,3234752,157,4,31083,550
2020-09-23,Russia,NA,Nizhny Novgorod Oblast,3234752,147,3,31230,553
2020-04-08,Russia,NA,North Ossetia-Alania,701765,6,0,15,0
2020-04-09,Russia,NA,North Ossetia-Alania,701765,7,0,22,0
2020-04-10,Russia,NA,North Ossetia-Alania,701765,5,0,27,0
2020-04-12,Russia,NA,North Ossetia-Alania,701765,7,0,34,0
2020-04-14,Russia,NA,North Ossetia-Alania,701765,18,0,52,0
2020-04-17,Russia,NA,North Ossetia-Alania,701765,13,0,65,0
2020-04-18,Russia,NA,North Ossetia-Alania,701765,29,0,94,0
2020-04-19,Russia,NA,North Ossetia-Alania,701765,26,0,120,0
2020-04-20,Russia,NA,North Ossetia-Alania,701765,25,0,145,0
2020-04-21,Russia,NA,North Ossetia-Alania,701765,32,0,177,0
2020-04-22,Russia,NA,North Ossetia-Alania,701765,34,0,211,0
2020-04-23,Russia,NA,North Ossetia-Alania,701765,31,0,242,0
2020-04-24,Russia,NA,North Ossetia-Alania,701765,33,0,275,0
2020-04-25,Russia,NA,North Ossetia-Alania,701765,30,0,305,0
2020-04-26,Russia,NA,North Ossetia-Alania,701765,43,0,348,0
2020-04-27,Russia,NA,North Ossetia-Alania,701765,53,0,401,0
2020-04-28,Russia,NA,North Ossetia-Alania,701765,148,0,549,0
2020-04-29,Russia,NA,North Ossetia-Alania,701765,121,0,670,0
2020-04-30,Russia,NA,North Ossetia-Alania,701765,93,0,763,0
2020-05-01,Russia,NA,North Ossetia-Alania,701765,73,0,836,0
2020-05-02,Russia,NA,North Ossetia-Alania,701765,85,0,921,0
2020-05-03,Russia,NA,North Ossetia-Alania,701765,69,0,990,0
2020-05-04,Russia,NA,North Ossetia-Alania,701765,79,0,1069,0
2020-05-05,Russia,NA,North Ossetia-Alania,701765,91,0,1160,0
2020-05-06,Russia,NA,North Ossetia-Alania,701765,93,0,1253,0
2020-05-07,Russia,NA,North Ossetia-Alania,701765,89,0,1342,0
2020-05-08,Russia,NA,North Ossetia-Alania,701765,94,0,1436,0
2020-05-09,Russia,NA,North Ossetia-Alania,701765,69,0,1505,0
2020-05-10,Russia,NA,North Ossetia-Alania,701765,70,0,1575,0
2020-05-11,Russia,NA,North Ossetia-Alania,701765,72,0,1647,0
2020-05-12,Russia,NA,North Ossetia-Alania,701765,76,0,1723,0
2020-05-13,Russia,NA,North Ossetia-Alania,701765,78,0,1801,0
2020-05-14,Russia,NA,North Ossetia-Alania,701765,70,0,1871,0
2020-05-15,Russia,NA,North Ossetia-Alania,701765,72,0,1943,0
2020-05-16,Russia,NA,North Ossetia-Alania,701765,73,0,2016,0
2020-05-17,Russia,NA,North Ossetia-Alania,701765,74,0,2090,0
2020-05-18,Russia,NA,North Ossetia-Alania,701765,75,0,2165,0
2020-05-19,Russia,NA,North Ossetia-Alania,701765,77,0,2242,0
2020-05-20,Russia,NA,North Ossetia-Alania,701765,72,0,2314,0
2020-05-21,Russia,NA,North Ossetia-Alania,701765,73,0,2387,0
2020-05-22,Russia,NA,North Ossetia-Alania,701765,69,0,2456,0
2020-05-23,Russia,NA,North Ossetia-Alania,701765,67,0,2523,0
2020-05-24,Russia,NA,North Ossetia-Alania,701765,62,0,2585,0
2020-05-25,Russia,NA,North Ossetia-Alania,701765,60,0,2645,0
2020-05-26,Russia,NA,North Ossetia-Alania,701765,57,0,2702,0
2020-05-27,Russia,NA,North Ossetia-Alania,701765,53,0,2755,0
2020-05-28,Russia,NA,North Ossetia-Alania,701765,52,0,2807,0
2020-05-29,Russia,NA,North Ossetia-Alania,701765,51,0,2858,0
2020-05-30,Russia,NA,North Ossetia-Alania,701765,49,0,2907,0
2020-05-31,Russia,NA,North Ossetia-Alania,701765,50,0,2957,0
2020-06-01,Russia,NA,North Ossetia-Alania,701765,48,0,3005,0
2020-06-02,Russia,NA,North Ossetia-Alania,701765,50,0,3055,0
2020-06-03,Russia,NA,North Ossetia-Alania,701765,49,0,3104,0
2020-06-04,Russia,NA,North Ossetia-Alania,701765,47,0,3151,0
2020-06-05,Russia,NA,North Ossetia-Alania,701765,46,0,3197,0
2020-06-06,Russia,NA,North Ossetia-Alania,701765,44,0,3241,0
2020-06-07,Russia,NA,North Ossetia-Alania,701765,42,0,3283,0
2020-06-08,Russia,NA,North Ossetia-Alania,701765,41,0,3324,0
2020-06-09,Russia,NA,North Ossetia-Alania,701765,40,0,3364,0
2020-06-10,Russia,NA,North Ossetia-Alania,701765,39,0,3403,0
2020-06-11,Russia,NA,North Ossetia-Alania,701765,37,0,3440,0
2020-06-12,Russia,NA,North Ossetia-Alania,701765,37,0,3477,0
2020-06-13,Russia,NA,North Ossetia-Alania,701765,36,0,3513,0
2020-06-14,Russia,NA,North Ossetia-Alania,701765,34,0,3547,0
2020-06-15,Russia,NA,North Ossetia-Alania,701765,34,0,3581,0
2020-06-16,Russia,NA,North Ossetia-Alania,701765,32,0,3613,0
2020-06-17,Russia,NA,North Ossetia-Alania,701765,32,0,3645,0
2020-06-18,Russia,NA,North Ossetia-Alania,701765,31,0,3676,0
2020-06-19,Russia,NA,North Ossetia-Alania,701765,30,0,3706,0
2020-06-20,Russia,NA,North Ossetia-Alania,701765,31,0,3737,0
2020-06-21,Russia,NA,North Ossetia-Alania,701765,31,0,3768,0
2020-06-22,Russia,NA,North Ossetia-Alania,701765,30,0,3798,0
2020-06-23,Russia,NA,North Ossetia-Alania,701765,28,0,3826,0
2020-06-24,Russia,NA,North Ossetia-Alania,701765,28,0,3854,0
2020-06-25,Russia,NA,North Ossetia-Alania,701765,29,0,3883,0
2020-06-26,Russia,NA,North Ossetia-Alania,701765,27,0,3910,0
2020-06-27,Russia,NA,North Ossetia-Alania,701765,25,0,3935,0
2020-06-28,Russia,NA,North Ossetia-Alania,701765,25,0,3960,0
2020-06-29,Russia,NA,North Ossetia-Alania,701765,24,0,3984,0
2020-06-30,Russia,NA,North Ossetia-Alania,701765,22,0,4006,0
2020-07-01,Russia,NA,North Ossetia-Alania,701765,22,0,4028,0
2020-07-02,Russia,NA,North Ossetia-Alania,701765,21,0,4049,0
2020-07-03,Russia,NA,North Ossetia-Alania,701765,21,0,4070,0
2020-07-04,Russia,NA,North Ossetia-Alania,701765,22,0,4092,0
2020-07-05,Russia,NA,North Ossetia-Alania,701765,22,0,4114,0
2020-07-06,Russia,NA,North Ossetia-Alania,701765,21,0,4135,0
2020-07-07,Russia,NA,North Ossetia-Alania,701765,20,0,4155,0
2020-07-08,Russia,NA,North Ossetia-Alania,701765,20,0,4175,0
2020-07-09,Russia,NA,North Ossetia-Alania,701765,18,0,4193,0
2020-07-10,Russia,NA,North Ossetia-Alania,701765,16,0,4209,0
2020-07-11,Russia,NA,North Ossetia-Alania,701765,15,0,4224,0
2020-07-12,Russia,NA,North Ossetia-Alania,701765,16,0,4240,0
2020-07-13,Russia,NA,North Ossetia-Alania,701765,16,0,4256,0
2020-07-14,Russia,NA,North Ossetia-Alania,701765,15,0,4271,0
2020-07-15,Russia,NA,North Ossetia-Alania,701765,16,0,4287,0
2020-07-16,Russia,NA,North Ossetia-Alania,701765,16,0,4303,0
2020-07-17,Russia,NA,North Ossetia-Alania,701765,17,0,4320,0
2020-07-18,Russia,NA,North Ossetia-Alania,701765,17,0,4337,0
2020-07-19,Russia,NA,North Ossetia-Alania,701765,16,0,4353,0
2020-07-20,Russia,NA,North Ossetia-Alania,701765,16,0,4369,0
2020-07-21,Russia,NA,North Ossetia-Alania,701765,15,0,4384,0
2020-07-22,Russia,NA,North Ossetia-Alania,701765,15,0,4399,0
2020-07-23,Russia,NA,North Ossetia-Alania,701765,16,0,4415,0
2020-07-24,Russia,NA,North Ossetia-Alania,701765,16,0,4431,0
2020-07-25,Russia,NA,North Ossetia-Alania,701765,17,0,4448,0
2020-07-26,Russia,NA,North Ossetia-Alania,701765,17,0,4465,0
2020-07-27,Russia,NA,North Ossetia-Alania,701765,18,0,4483,0
2020-07-28,Russia,NA,North Ossetia-Alania,701765,18,0,4501,0
2020-07-29,Russia,NA,North Ossetia-Alania,701765,16,0,4517,0
2020-07-30,Russia,NA,North Ossetia-Alania,701765,14,0,4531,0
2020-07-31,Russia,NA,North Ossetia-Alania,701765,13,0,4544,0
2020-08-01,Russia,NA,North Ossetia-Alania,701765,13,0,4557,0
2020-08-02,Russia,NA,North Ossetia-Alania,701765,11,0,4568,0
2020-08-26,Russia,NA,North Ossetia-Alania,701765,0,0,4821,67
2020-08-27,Russia,NA,North Ossetia-Alania,701765,19,0,4840,67
2020-08-28,Russia,NA,North Ossetia-Alania,701765,20,0,4860,67
2020-08-29,Russia,NA,North Ossetia-Alania,701765,20,0,4880,67
2020-08-30,Russia,NA,North Ossetia-Alania,701765,21,0,4901,67
2020-08-31,Russia,NA,North Ossetia-Alania,701765,21,0,4922,67
2020-09-01,Russia,NA,North Ossetia-Alania,701765,21,0,4943,67
2020-09-02,Russia,NA,North Ossetia-Alania,701765,23,0,4966,67
2020-09-03,Russia,NA,North Ossetia-Alania,701765,23,0,4989,67
2020-09-04,Russia,NA,North Ossetia-Alania,701765,24,0,5013,67
2020-09-05,Russia,NA,North Ossetia-Alania,701765,24,0,5037,67
2020-09-06,Russia,NA,North Ossetia-Alania,701765,25,0,5062,67
2020-09-07,Russia,NA,North Ossetia-Alania,701765,25,0,5087,67
2020-09-08,Russia,NA,North Ossetia-Alania,701765,24,0,5111,67
2020-09-09,Russia,NA,North Ossetia-Alania,701765,26,0,5137,67
2020-09-10,Russia,NA,North Ossetia-Alania,701765,26,1,5163,68
2020-09-11,Russia,NA,North Ossetia-Alania,701765,28,0,5191,68
2020-09-12,Russia,NA,North Ossetia-Alania,701765,29,0,5220,68
2020-09-13,Russia,NA,North Ossetia-Alania,701765,30,0,5250,68
2020-09-14,Russia,NA,North Ossetia-Alania,701765,30,0,5280,68
2020-09-15,Russia,NA,North Ossetia-Alania,701765,31,0,5311,68
2020-09-16,Russia,NA,North Ossetia-Alania,701765,32,0,5343,68
2020-09-17,Russia,NA,North Ossetia-Alania,701765,32,0,5375,68
2020-09-18,Russia,NA,North Ossetia-Alania,701765,33,0,5408,68
2020-09-19,Russia,NA,North Ossetia-Alania,701765,32,0,5440,68
2020-09-20,Russia,NA,North Ossetia-Alania,701765,34,0,5474,68
2020-09-21,Russia,NA,North Ossetia-Alania,701765,34,0,5508,68
2020-09-22,Russia,NA,North Ossetia-Alania,701765,33,0,5541,68
2020-09-23,Russia,NA,North Ossetia-Alania,701765,34,0,5575,68
2020-04-09,Russia,NA,Novgorod Oblast,606476,7,0,12,0
2020-04-10,Russia,NA,Novgorod Oblast,606476,6,0,18,0
2020-04-13,Russia,NA,Novgorod Oblast,606476,8,0,26,0
2020-04-16,Russia,NA,Novgorod Oblast,606476,27,0,53,0
2020-04-17,Russia,NA,Novgorod Oblast,606476,21,0,74,0
2020-04-18,Russia,NA,Novgorod Oblast,606476,6,0,80,0
2020-04-19,Russia,NA,Novgorod Oblast,606476,18,0,98,0
2020-04-20,Russia,NA,Novgorod Oblast,606476,10,0,108,0
2020-04-21,Russia,NA,Novgorod Oblast,606476,6,0,114,0
2020-04-22,Russia,NA,Novgorod Oblast,606476,26,0,140,0
2020-04-23,Russia,NA,Novgorod Oblast,606476,17,0,157,0
2020-04-24,Russia,NA,Novgorod Oblast,606476,14,0,171,0
2020-04-25,Russia,NA,Novgorod Oblast,606476,15,0,186,0
2020-04-26,Russia,NA,Novgorod Oblast,606476,25,0,211,0
2020-04-27,Russia,NA,Novgorod Oblast,606476,33,0,244,0
2020-04-28,Russia,NA,Novgorod Oblast,606476,10,0,254,0
2020-04-29,Russia,NA,Novgorod Oblast,606476,12,0,266,0
2020-04-30,Russia,NA,Novgorod Oblast,606476,13,0,279,0
2020-05-01,Russia,NA,Novgorod Oblast,606476,18,0,297,0
2020-05-02,Russia,NA,Novgorod Oblast,606476,25,0,322,0
2020-05-03,Russia,NA,Novgorod Oblast,606476,26,0,348,0
2020-05-04,Russia,NA,Novgorod Oblast,606476,24,0,372,0
2020-05-05,Russia,NA,Novgorod Oblast,606476,27,0,399,0
2020-05-06,Russia,NA,Novgorod Oblast,606476,18,0,417,0
2020-05-07,Russia,NA,Novgorod Oblast,606476,21,0,438,0
2020-05-08,Russia,NA,Novgorod Oblast,606476,19,0,457,0
2020-05-09,Russia,NA,Novgorod Oblast,606476,12,0,469,0
2020-05-10,Russia,NA,Novgorod Oblast,606476,28,0,497,0
2020-05-11,Russia,NA,Novgorod Oblast,606476,17,0,514,0
2020-05-12,Russia,NA,Novgorod Oblast,606476,27,0,541,0
2020-05-13,Russia,NA,Novgorod Oblast,606476,14,0,555,0
2020-05-14,Russia,NA,Novgorod Oblast,606476,15,0,570,0
2020-05-15,Russia,NA,Novgorod Oblast,606476,14,0,584,0
2020-05-16,Russia,NA,Novgorod Oblast,606476,14,0,598,0
2020-05-17,Russia,NA,Novgorod Oblast,606476,33,0,631,0
2020-05-18,Russia,NA,Novgorod Oblast,606476,21,0,652,0
2020-05-19,Russia,NA,Novgorod Oblast,606476,33,0,685,0
2020-05-20,Russia,NA,Novgorod Oblast,606476,10,0,695,0
2020-05-21,Russia,NA,Novgorod Oblast,606476,32,0,727,0
2020-05-22,Russia,NA,Novgorod Oblast,606476,22,0,749,0
2020-05-23,Russia,NA,Novgorod Oblast,606476,35,0,784,0
2020-05-24,Russia,NA,Novgorod Oblast,606476,60,0,844,0
2020-05-25,Russia,NA,Novgorod Oblast,606476,70,0,914,0
2020-05-26,Russia,NA,Novgorod Oblast,606476,89,0,1003,0
2020-05-27,Russia,NA,Novgorod Oblast,606476,46,0,1049,0
2020-05-28,Russia,NA,Novgorod Oblast,606476,45,0,1094,0
2020-05-29,Russia,NA,Novgorod Oblast,606476,73,0,1167,0
2020-05-30,Russia,NA,Novgorod Oblast,606476,63,0,1230,0
2020-05-31,Russia,NA,Novgorod Oblast,606476,51,0,1281,0
2020-06-01,Russia,NA,Novgorod Oblast,606476,72,0,1353,0
2020-06-02,Russia,NA,Novgorod Oblast,606476,77,0,1430,0
2020-06-03,Russia,NA,Novgorod Oblast,606476,63,0,1493,0
2020-06-04,Russia,NA,Novgorod Oblast,606476,53,0,1546,0
2020-06-05,Russia,NA,Novgorod Oblast,606476,42,0,1588,0
2020-06-06,Russia,NA,Novgorod Oblast,606476,46,0,1634,0
2020-06-07,Russia,NA,Novgorod Oblast,606476,42,0,1676,0
2020-06-08,Russia,NA,Novgorod Oblast,606476,58,0,1734,0
2020-06-09,Russia,NA,Novgorod Oblast,606476,45,0,1779,0
2020-06-10,Russia,NA,Novgorod Oblast,606476,44,0,1823,0
2020-06-11,Russia,NA,Novgorod Oblast,606476,44,0,1867,0
2020-06-12,Russia,NA,Novgorod Oblast,606476,46,0,1913,0
2020-06-13,Russia,NA,Novgorod Oblast,606476,50,0,1963,0
2020-06-14,Russia,NA,Novgorod Oblast,606476,48,0,2011,0
2020-06-15,Russia,NA,Novgorod Oblast,606476,52,0,2063,0
2020-06-16,Russia,NA,Novgorod Oblast,606476,58,0,2121,0
2020-06-17,Russia,NA,Novgorod Oblast,606476,62,0,2183,0
2020-06-18,Russia,NA,Novgorod Oblast,606476,62,0,2245,0
2020-06-19,Russia,NA,Novgorod Oblast,606476,58,0,2303,0
2020-06-20,Russia,NA,Novgorod Oblast,606476,59,0,2362,0
2020-06-21,Russia,NA,Novgorod Oblast,606476,55,0,2417,0
2020-06-22,Russia,NA,Novgorod Oblast,606476,61,0,2478,0
2020-06-23,Russia,NA,Novgorod Oblast,606476,57,0,2535,0
2020-06-24,Russia,NA,Novgorod Oblast,606476,56,0,2591,0
2020-06-25,Russia,NA,Novgorod Oblast,606476,62,0,2653,0
2020-06-26,Russia,NA,Novgorod Oblast,606476,45,0,2698,0
2020-06-27,Russia,NA,Novgorod Oblast,606476,44,0,2742,0
2020-06-28,Russia,NA,Novgorod Oblast,606476,50,0,2792,0
2020-06-29,Russia,NA,Novgorod Oblast,606476,47,0,2839,0
2020-06-30,Russia,NA,Novgorod Oblast,606476,45,0,2884,0
2020-07-01,Russia,NA,Novgorod Oblast,606476,47,0,2931,0
2020-07-02,Russia,NA,Novgorod Oblast,606476,47,0,2978,0
2020-07-03,Russia,NA,Novgorod Oblast,606476,44,0,3022,0
2020-07-04,Russia,NA,Novgorod Oblast,606476,46,0,3068,0
2020-07-05,Russia,NA,Novgorod Oblast,606476,37,0,3105,0
2020-07-06,Russia,NA,Novgorod Oblast,606476,37,0,3142,0
2020-07-07,Russia,NA,Novgorod Oblast,606476,36,0,3178,0
2020-07-08,Russia,NA,Novgorod Oblast,606476,39,0,3217,0
2020-07-09,Russia,NA,Novgorod Oblast,606476,39,0,3256,0
2020-07-10,Russia,NA,Novgorod Oblast,606476,40,0,3296,0
2020-07-11,Russia,NA,Novgorod Oblast,606476,41,0,3337,0
2020-07-12,Russia,NA,Novgorod Oblast,606476,39,0,3376,0
2020-07-13,Russia,NA,Novgorod Oblast,606476,37,0,3413,0
2020-07-14,Russia,NA,Novgorod Oblast,606476,18,0,3431,0
2020-07-15,Russia,NA,Novgorod Oblast,606476,19,0,3450,0
2020-07-16,Russia,NA,Novgorod Oblast,606476,20,0,3470,0
2020-07-17,Russia,NA,Novgorod Oblast,606476,19,0,3489,0
2020-07-18,Russia,NA,Novgorod Oblast,606476,21,0,3510,0
2020-07-19,Russia,NA,Novgorod Oblast,606476,20,0,3530,0
2020-07-20,Russia,NA,Novgorod Oblast,606476,19,0,3549,0
2020-07-21,Russia,NA,Novgorod Oblast,606476,20,0,3569,0
2020-07-22,Russia,NA,Novgorod Oblast,606476,15,0,3584,0
2020-07-23,Russia,NA,Novgorod Oblast,606476,19,0,3603,0
2020-07-24,Russia,NA,Novgorod Oblast,606476,18,0,3621,0
2020-07-25,Russia,NA,Novgorod Oblast,606476,18,0,3639,0
2020-07-26,Russia,NA,Novgorod Oblast,606476,17,0,3656,0
2020-07-27,Russia,NA,Novgorod Oblast,606476,16,0,3672,0
2020-07-28,Russia,NA,Novgorod Oblast,606476,18,0,3690,0
2020-07-29,Russia,NA,Novgorod Oblast,606476,20,0,3710,0
2020-07-30,Russia,NA,Novgorod Oblast,606476,19,0,3729,0
2020-07-31,Russia,NA,Novgorod Oblast,606476,17,0,3746,0
2020-08-01,Russia,NA,Novgorod Oblast,606476,20,0,3766,0
2020-08-02,Russia,NA,Novgorod Oblast,606476,25,0,3791,0
2020-08-26,Russia,NA,Novgorod Oblast,606476,0,0,4235,72
2020-08-27,Russia,NA,Novgorod Oblast,606476,19,0,4254,72
2020-08-28,Russia,NA,Novgorod Oblast,606476,20,0,4274,72
2020-08-29,Russia,NA,Novgorod Oblast,606476,22,4,4296,76
2020-08-30,Russia,NA,Novgorod Oblast,606476,23,0,4319,76
2020-08-31,Russia,NA,Novgorod Oblast,606476,21,0,4340,76
2020-09-01,Russia,NA,Novgorod Oblast,606476,23,10,4363,86
2020-09-02,Russia,NA,Novgorod Oblast,606476,22,0,4385,86
2020-09-03,Russia,NA,Novgorod Oblast,606476,21,0,4406,86
2020-09-04,Russia,NA,Novgorod Oblast,606476,22,0,4428,86
2020-09-05,Russia,NA,Novgorod Oblast,606476,24,0,4452,86
2020-09-06,Russia,NA,Novgorod Oblast,606476,25,0,4477,86
2020-09-07,Russia,NA,Novgorod Oblast,606476,24,0,4501,86
2020-09-08,Russia,NA,Novgorod Oblast,606476,26,0,4527,86
2020-09-09,Russia,NA,Novgorod Oblast,606476,27,0,4554,86
2020-09-10,Russia,NA,Novgorod Oblast,606476,26,0,4580,86
2020-09-11,Russia,NA,Novgorod Oblast,606476,29,0,4609,86
2020-09-12,Russia,NA,Novgorod Oblast,606476,26,0,4635,86
2020-09-13,Russia,NA,Novgorod Oblast,606476,26,0,4661,86
2020-09-14,Russia,NA,Novgorod Oblast,606476,28,0,4689,86
2020-09-15,Russia,NA,Novgorod Oblast,606476,27,0,4716,86
2020-09-16,Russia,NA,Novgorod Oblast,606476,29,0,4745,86
2020-09-17,Russia,NA,Novgorod Oblast,606476,30,0,4775,86
2020-09-18,Russia,NA,Novgorod Oblast,606476,28,0,4803,86
2020-09-19,Russia,NA,Novgorod Oblast,606476,29,0,4832,86
2020-09-20,Russia,NA,Novgorod Oblast,606476,30,0,4862,86
2020-09-21,Russia,NA,Novgorod Oblast,606476,29,0,4891,86
2020-09-22,Russia,NA,Novgorod Oblast,606476,32,0,4923,86
2020-09-23,Russia,NA,Novgorod Oblast,606476,30,0,4953,86
2020-04-05,Russia,NA,Novosibirsk Oblast,2788849,1,0,11,0
2020-04-08,Russia,NA,Novosibirsk Oblast,2788849,2,0,13,0
2020-04-09,Russia,NA,Novosibirsk Oblast,2788849,5,0,18,0
2020-04-10,Russia,NA,Novosibirsk Oblast,2788849,3,0,21,0
2020-04-11,Russia,NA,Novosibirsk Oblast,2788849,7,0,28,0
2020-04-13,Russia,NA,Novosibirsk Oblast,2788849,8,0,36,0
2020-04-15,Russia,NA,Novosibirsk Oblast,2788849,17,0,53,0
2020-04-16,Russia,NA,Novosibirsk Oblast,2788849,11,0,64,0
2020-04-17,Russia,NA,Novosibirsk Oblast,2788849,12,0,76,0
2020-04-18,Russia,NA,Novosibirsk Oblast,2788849,10,0,86,0
2020-04-19,Russia,NA,Novosibirsk Oblast,2788849,22,0,108,0
2020-04-20,Russia,NA,Novosibirsk Oblast,2788849,24,0,132,0
2020-04-21,Russia,NA,Novosibirsk Oblast,2788849,3,0,135,0
2020-04-22,Russia,NA,Novosibirsk Oblast,2788849,16,0,151,0
2020-04-23,Russia,NA,Novosibirsk Oblast,2788849,17,0,168,0
2020-04-24,Russia,NA,Novosibirsk Oblast,2788849,41,0,209,0
2020-04-25,Russia,NA,Novosibirsk Oblast,2788849,38,0,247,0
2020-04-26,Russia,NA,Novosibirsk Oblast,2788849,58,0,305,0
2020-04-27,Russia,NA,Novosibirsk Oblast,2788849,42,0,347,0
2020-04-28,Russia,NA,Novosibirsk Oblast,2788849,60,0,407,0
2020-04-29,Russia,NA,Novosibirsk Oblast,2788849,29,0,436,0
2020-04-30,Russia,NA,Novosibirsk Oblast,2788849,35,0,471,0
2020-05-01,Russia,NA,Novosibirsk Oblast,2788849,55,0,526,0
2020-05-02,Russia,NA,Novosibirsk Oblast,2788849,43,0,569,0
2020-05-03,Russia,NA,Novosibirsk Oblast,2788849,51,0,620,0
2020-05-04,Russia,NA,Novosibirsk Oblast,2788849,61,0,681,0
2020-05-05,Russia,NA,Novosibirsk Oblast,2788849,65,0,746,0
2020-05-06,Russia,NA,Novosibirsk Oblast,2788849,63,0,809,0
2020-05-07,Russia,NA,Novosibirsk Oblast,2788849,67,0,876,0
2020-05-08,Russia,NA,Novosibirsk Oblast,2788849,73,0,949,0
2020-05-09,Russia,NA,Novosibirsk Oblast,2788849,76,0,1025,0
2020-05-10,Russia,NA,Novosibirsk Oblast,2788849,75,0,1100,0
2020-05-11,Russia,NA,Novosibirsk Oblast,2788849,71,0,1171,0
2020-05-12,Russia,NA,Novosibirsk Oblast,2788849,55,0,1226,0
2020-05-13,Russia,NA,Novosibirsk Oblast,2788849,74,0,1300,0
2020-05-14,Russia,NA,Novosibirsk Oblast,2788849,76,0,1376,0
2020-05-15,Russia,NA,Novosibirsk Oblast,2788849,71,0,1447,0
2020-05-16,Russia,NA,Novosibirsk Oblast,2788849,64,0,1511,0
2020-05-17,Russia,NA,Novosibirsk Oblast,2788849,70,0,1581,0
2020-05-18,Russia,NA,Novosibirsk Oblast,2788849,71,0,1652,0
2020-05-19,Russia,NA,Novosibirsk Oblast,2788849,76,0,1728,0
2020-05-20,Russia,NA,Novosibirsk Oblast,2788849,77,0,1805,0
2020-05-21,Russia,NA,Novosibirsk Oblast,2788849,76,0,1881,0
2020-05-22,Russia,NA,Novosibirsk Oblast,2788849,79,0,1960,0
2020-05-23,Russia,NA,Novosibirsk Oblast,2788849,83,0,2043,0
2020-05-24,Russia,NA,Novosibirsk Oblast,2788849,81,0,2124,0
2020-05-25,Russia,NA,Novosibirsk Oblast,2788849,89,0,2213,0
2020-05-26,Russia,NA,Novosibirsk Oblast,2788849,87,0,2300,0
2020-05-27,Russia,NA,Novosibirsk Oblast,2788849,97,0,2397,0
2020-05-28,Russia,NA,Novosibirsk Oblast,2788849,96,0,2493,0
2020-05-29,Russia,NA,Novosibirsk Oblast,2788849,103,0,2596,0
2020-05-30,Russia,NA,Novosibirsk Oblast,2788849,109,0,2705,0
2020-05-31,Russia,NA,Novosibirsk Oblast,2788849,104,0,2809,0
2020-06-01,Russia,NA,Novosibirsk Oblast,2788849,105,0,2914,0
2020-06-02,Russia,NA,Novosibirsk Oblast,2788849,106,0,3020,0
2020-06-03,Russia,NA,Novosibirsk Oblast,2788849,102,0,3122,0
2020-06-04,Russia,NA,Novosibirsk Oblast,2788849,104,0,3226,0
2020-06-05,Russia,NA,Novosibirsk Oblast,2788849,108,0,3334,0
2020-06-06,Russia,NA,Novosibirsk Oblast,2788849,107,0,3441,0
2020-06-07,Russia,NA,Novosibirsk Oblast,2788849,105,0,3546,0
2020-06-08,Russia,NA,Novosibirsk Oblast,2788849,102,0,3648,0
2020-06-09,Russia,NA,Novosibirsk Oblast,2788849,104,0,3752,0
2020-06-10,Russia,NA,Novosibirsk Oblast,2788849,106,0,3858,0
2020-06-11,Russia,NA,Novosibirsk Oblast,2788849,102,0,3960,0
2020-06-12,Russia,NA,Novosibirsk Oblast,2788849,109,0,4069,0
2020-06-13,Russia,NA,Novosibirsk Oblast,2788849,108,0,4177,0
2020-06-14,Russia,NA,Novosibirsk Oblast,2788849,108,0,4285,0
2020-06-15,Russia,NA,Novosibirsk Oblast,2788849,109,0,4394,0
2020-06-16,Russia,NA,Novosibirsk Oblast,2788849,103,0,4497,0
2020-06-17,Russia,NA,Novosibirsk Oblast,2788849,107,0,4604,0
2020-06-18,Russia,NA,Novosibirsk Oblast,2788849,107,0,4711,0
2020-06-19,Russia,NA,Novosibirsk Oblast,2788849,108,0,4819,0
2020-06-20,Russia,NA,Novosibirsk Oblast,2788849,109,0,4928,0
2020-06-21,Russia,NA,Novosibirsk Oblast,2788849,105,0,5033,0
2020-06-22,Russia,NA,Novosibirsk Oblast,2788849,109,0,5142,0
2020-06-23,Russia,NA,Novosibirsk Oblast,2788849,106,0,5248,0
2020-06-24,Russia,NA,Novosibirsk Oblast,2788849,108,0,5356,0
2020-06-25,Russia,NA,Novosibirsk Oblast,2788849,102,0,5458,0
2020-06-26,Russia,NA,Novosibirsk Oblast,2788849,108,0,5566,0
2020-06-27,Russia,NA,Novosibirsk Oblast,2788849,105,0,5671,0
2020-06-28,Russia,NA,Novosibirsk Oblast,2788849,98,0,5769,0
2020-06-29,Russia,NA,Novosibirsk Oblast,2788849,107,0,5876,0
2020-06-30,Russia,NA,Novosibirsk Oblast,2788849,109,0,5985,0
2020-07-01,Russia,NA,Novosibirsk Oblast,2788849,100,0,6085,0
2020-07-02,Russia,NA,Novosibirsk Oblast,2788849,92,0,6177,0
2020-07-03,Russia,NA,Novosibirsk Oblast,2788849,105,0,6282,0
2020-07-04,Russia,NA,Novosibirsk Oblast,2788849,111,0,6393,0
2020-07-05,Russia,NA,Novosibirsk Oblast,2788849,112,0,6505,0
2020-07-06,Russia,NA,Novosibirsk Oblast,2788849,106,0,6611,0
2020-07-07,Russia,NA,Novosibirsk Oblast,2788849,113,0,6724,0
2020-07-08,Russia,NA,Novosibirsk Oblast,2788849,107,0,6831,0
2020-07-09,Russia,NA,Novosibirsk Oblast,2788849,101,0,6932,0
2020-07-10,Russia,NA,Novosibirsk Oblast,2788849,111,0,7043,0
2020-07-11,Russia,NA,Novosibirsk Oblast,2788849,110,0,7153,0
2020-07-12,Russia,NA,Novosibirsk Oblast,2788849,121,0,7274,0
2020-07-13,Russia,NA,Novosibirsk Oblast,2788849,112,0,7386,0
2020-07-14,Russia,NA,Novosibirsk Oblast,2788849,119,0,7505,0
2020-07-15,Russia,NA,Novosibirsk Oblast,2788849,103,0,7608,0
2020-07-16,Russia,NA,Novosibirsk Oblast,2788849,120,0,7728,0
2020-07-17,Russia,NA,Novosibirsk Oblast,2788849,117,0,7845,0
2020-07-18,Russia,NA,Novosibirsk Oblast,2788849,114,0,7959,0
2020-07-19,Russia,NA,Novosibirsk Oblast,2788849,118,0,8077,0
2020-07-20,Russia,NA,Novosibirsk Oblast,2788849,109,0,8186,0
2020-07-21,Russia,NA,Novosibirsk Oblast,2788849,102,0,8288,0
2020-07-22,Russia,NA,Novosibirsk Oblast,2788849,113,0,8401,0
2020-07-23,Russia,NA,Novosibirsk Oblast,2788849,110,0,8511,0
2020-07-24,Russia,NA,Novosibirsk Oblast,2788849,105,0,8616,0
2020-07-25,Russia,NA,Novosibirsk Oblast,2788849,101,0,8717,0
2020-07-26,Russia,NA,Novosibirsk Oblast,2788849,109,0,8826,0
2020-07-27,Russia,NA,Novosibirsk Oblast,2788849,104,0,8930,0
2020-07-28,Russia,NA,Novosibirsk Oblast,2788849,103,0,9033,0
2020-07-29,Russia,NA,Novosibirsk Oblast,2788849,107,0,9140,0
2020-07-30,Russia,NA,Novosibirsk Oblast,2788849,101,0,9241,0
2020-07-31,Russia,NA,Novosibirsk Oblast,2788849,105,0,9346,0
2020-08-01,Russia,NA,Novosibirsk Oblast,2788849,98,0,9444,0
2020-08-02,Russia,NA,Novosibirsk Oblast,2788849,104,0,9548,0
2020-08-26,Russia,NA,Novosibirsk Oblast,2788849,0,0,11141,346
2020-08-27,Russia,NA,Novosibirsk Oblast,2788849,51,3,11192,349
2020-08-28,Russia,NA,Novosibirsk Oblast,2788849,46,3,11238,352
2020-08-29,Russia,NA,Novosibirsk Oblast,2788849,51,2,11289,354
2020-08-30,Russia,NA,Novosibirsk Oblast,2788849,55,1,11344,355
2020-08-31,Russia,NA,Novosibirsk Oblast,2788849,60,3,11404,358
2020-09-01,Russia,NA,Novosibirsk Oblast,2788849,52,3,11456,361
2020-09-02,Russia,NA,Novosibirsk Oblast,2788849,45,3,11501,364
2020-09-03,Russia,NA,Novosibirsk Oblast,2788849,50,3,11551,367
2020-09-04,Russia,NA,Novosibirsk Oblast,2788849,56,4,11607,371
2020-09-05,Russia,NA,Novosibirsk Oblast,2788849,63,5,11670,376
2020-09-06,Russia,NA,Novosibirsk Oblast,2788849,57,2,11727,378
2020-09-07,Russia,NA,Novosibirsk Oblast,2788849,50,0,11777,378
2020-09-08,Russia,NA,Novosibirsk Oblast,2788849,52,3,11829,381
2020-09-09,Russia,NA,Novosibirsk Oblast,2788849,56,3,11885,384
2020-09-10,Russia,NA,Novosibirsk Oblast,2788849,56,3,11941,387
2020-09-11,Russia,NA,Novosibirsk Oblast,2788849,53,2,11994,389
2020-09-12,Russia,NA,Novosibirsk Oblast,2788849,50,1,12044,390
2020-09-13,Russia,NA,Novosibirsk Oblast,2788849,49,4,12093,394
2020-09-14,Russia,NA,Novosibirsk Oblast,2788849,55,3,12148,397
2020-09-15,Russia,NA,Novosibirsk Oblast,2788849,59,1,12207,398
2020-09-16,Russia,NA,Novosibirsk Oblast,2788849,53,3,12260,401
2020-09-17,Russia,NA,Novosibirsk Oblast,2788849,47,2,12307,403
2020-09-18,Russia,NA,Novosibirsk Oblast,2788849,49,4,12356,407
2020-09-19,Russia,NA,Novosibirsk Oblast,2788849,54,3,12410,410
2020-09-20,Russia,NA,Novosibirsk Oblast,2788849,61,3,12471,413
2020-09-21,Russia,NA,Novosibirsk Oblast,2788849,55,4,12526,417
2020-09-22,Russia,NA,Novosibirsk Oblast,2788849,61,3,12587,420
2020-09-23,Russia,NA,Novosibirsk Oblast,2788849,65,5,12652,425
2020-04-07,Russia,NA,Omsk Oblast,1960081,4,0,14,0
2020-04-08,Russia,NA,Omsk Oblast,1960081,1,0,15,0
2020-04-10,Russia,NA,Omsk Oblast,1960081,2,0,17,0
2020-04-12,Russia,NA,Omsk Oblast,1960081,2,0,19,0
2020-04-13,Russia,NA,Omsk Oblast,1960081,1,0,20,0
2020-04-15,Russia,NA,Omsk Oblast,1960081,2,0,22,0
2020-04-16,Russia,NA,Omsk Oblast,1960081,1,0,23,0
2020-04-17,Russia,NA,Omsk Oblast,1960081,3,0,26,0
2020-04-18,Russia,NA,Omsk Oblast,1960081,5,0,31,0
2020-04-19,Russia,NA,Omsk Oblast,1960081,2,0,33,0
2020-04-20,Russia,NA,Omsk Oblast,1960081,3,0,36,0
2020-04-21,Russia,NA,Omsk Oblast,1960081,5,0,41,0
2020-04-22,Russia,NA,Omsk Oblast,1960081,4,0,45,0
2020-04-23,Russia,NA,Omsk Oblast,1960081,8,0,53,0
2020-04-24,Russia,NA,Omsk Oblast,1960081,1,0,54,0
2020-04-25,Russia,NA,Omsk Oblast,1960081,4,0,58,0
2020-04-26,Russia,NA,Omsk Oblast,1960081,4,0,62,0
2020-04-27,Russia,NA,Omsk Oblast,1960081,9,0,71,0
2020-04-28,Russia,NA,Omsk Oblast,1960081,11,0,82,0
2020-04-29,Russia,NA,Omsk Oblast,1960081,5,0,87,0
2020-04-30,Russia,NA,Omsk Oblast,1960081,10,0,97,0
2020-05-01,Russia,NA,Omsk Oblast,1960081,10,0,107,0
2020-05-02,Russia,NA,Omsk Oblast,1960081,9,0,116,0
2020-05-03,Russia,NA,Omsk Oblast,1960081,11,0,127,0
2020-05-04,Russia,NA,Omsk Oblast,1960081,34,0,161,0
2020-05-05,Russia,NA,Omsk Oblast,1960081,30,0,191,0
2020-05-06,Russia,NA,Omsk Oblast,1960081,6,0,197,0
2020-05-07,Russia,NA,Omsk Oblast,1960081,11,0,208,0
2020-05-08,Russia,NA,Omsk Oblast,1960081,15,0,223,0
2020-05-09,Russia,NA,Omsk Oblast,1960081,22,0,245,0
2020-05-10,Russia,NA,Omsk Oblast,1960081,34,0,279,0
2020-05-11,Russia,NA,Omsk Oblast,1960081,23,0,302,0
2020-05-12,Russia,NA,Omsk Oblast,1960081,30,0,332,0
2020-05-13,Russia,NA,Omsk Oblast,1960081,23,0,355,0
2020-05-14,Russia,NA,Omsk Oblast,1960081,34,0,389,0
2020-05-15,Russia,NA,Omsk Oblast,1960081,47,0,436,0
2020-05-16,Russia,NA,Omsk Oblast,1960081,40,0,476,0
2020-05-17,Russia,NA,Omsk Oblast,1960081,58,0,534,0
2020-05-18,Russia,NA,Omsk Oblast,1960081,65,0,599,0
2020-05-19,Russia,NA,Omsk Oblast,1960081,53,0,652,0
2020-05-20,Russia,NA,Omsk Oblast,1960081,65,0,717,0
2020-05-21,Russia,NA,Omsk Oblast,1960081,47,0,764,0
2020-05-22,Russia,NA,Omsk Oblast,1960081,74,0,838,0
2020-05-23,Russia,NA,Omsk Oblast,1960081,87,0,925,0
2020-05-24,Russia,NA,Omsk Oblast,1960081,60,0,985,0
2020-05-25,Russia,NA,Omsk Oblast,1960081,59,0,1044,0
2020-05-26,Russia,NA,Omsk Oblast,1960081,53,0,1097,0
2020-05-27,Russia,NA,Omsk Oblast,1960081,42,0,1139,0
2020-05-28,Russia,NA,Omsk Oblast,1960081,87,0,1226,0
2020-05-29,Russia,NA,Omsk Oblast,1960081,42,0,1268,0
2020-05-30,Russia,NA,Omsk Oblast,1960081,50,0,1318,0
2020-05-31,Russia,NA,Omsk Oblast,1960081,69,0,1387,0
2020-06-01,Russia,NA,Omsk Oblast,1960081,24,0,1411,0
2020-06-02,Russia,NA,Omsk Oblast,1960081,26,0,1437,0
2020-06-03,Russia,NA,Omsk Oblast,1960081,45,0,1482,0
2020-06-04,Russia,NA,Omsk Oblast,1960081,58,0,1540,0
2020-06-05,Russia,NA,Omsk Oblast,1960081,55,0,1595,0
2020-06-06,Russia,NA,Omsk Oblast,1960081,81,0,1676,0
2020-06-07,Russia,NA,Omsk Oblast,1960081,42,0,1718,0
2020-06-08,Russia,NA,Omsk Oblast,1960081,58,0,1776,0
2020-06-09,Russia,NA,Omsk Oblast,1960081,75,0,1851,0
2020-06-10,Russia,NA,Omsk Oblast,1960081,79,0,1930,0
2020-06-11,Russia,NA,Omsk Oblast,1960081,47,0,1977,0
2020-06-12,Russia,NA,Omsk Oblast,1960081,86,0,2063,0
2020-06-13,Russia,NA,Omsk Oblast,1960081,85,0,2148,0
2020-06-14,Russia,NA,Omsk Oblast,1960081,99,0,2247,0
2020-06-15,Russia,NA,Omsk Oblast,1960081,93,0,2340,0
2020-06-16,Russia,NA,Omsk Oblast,1960081,97,0,2437,0
2020-06-17,Russia,NA,Omsk Oblast,1960081,98,0,2535,0
2020-06-18,Russia,NA,Omsk Oblast,1960081,89,0,2624,0
2020-06-19,Russia,NA,Omsk Oblast,1960081,103,0,2727,0
2020-06-20,Russia,NA,Omsk Oblast,1960081,94,0,2821,0
2020-06-21,Russia,NA,Omsk Oblast,1960081,99,0,2920,0
2020-06-22,Russia,NA,Omsk Oblast,1960081,98,0,3018,0
2020-06-23,Russia,NA,Omsk Oblast,1960081,82,0,3100,0
2020-06-24,Russia,NA,Omsk Oblast,1960081,84,0,3184,0
2020-06-25,Russia,NA,Omsk Oblast,1960081,52,0,3236,0
2020-06-26,Russia,NA,Omsk Oblast,1960081,61,0,3297,0
2020-06-27,Russia,NA,Omsk Oblast,1960081,75,0,3372,0
2020-06-28,Russia,NA,Omsk Oblast,1960081,83,0,3455,0
2020-06-29,Russia,NA,Omsk Oblast,1960081,78,0,3533,0
2020-06-30,Russia,NA,Omsk Oblast,1960081,82,0,3615,0
2020-07-01,Russia,NA,Omsk Oblast,1960081,86,0,3701,0
2020-07-02,Russia,NA,Omsk Oblast,1960081,79,0,3780,0
2020-07-03,Russia,NA,Omsk Oblast,1960081,83,0,3863,0
2020-07-04,Russia,NA,Omsk Oblast,1960081,87,0,3950,0
2020-07-05,Russia,NA,Omsk Oblast,1960081,86,0,4036,0
2020-07-06,Russia,NA,Omsk Oblast,1960081,84,0,4120,0
2020-07-07,Russia,NA,Omsk Oblast,1960081,82,0,4202,0
2020-07-08,Russia,NA,Omsk Oblast,1960081,83,0,4285,0
2020-07-09,Russia,NA,Omsk Oblast,1960081,89,0,4374,0
2020-07-10,Russia,NA,Omsk Oblast,1960081,95,0,4469,0
2020-07-11,Russia,NA,Omsk Oblast,1960081,94,0,4563,0
2020-07-12,Russia,NA,Omsk Oblast,1960081,93,0,4656,0
2020-07-13,Russia,NA,Omsk Oblast,1960081,95,0,4751,0
2020-07-14,Russia,NA,Omsk Oblast,1960081,93,0,4844,0
2020-07-15,Russia,NA,Omsk Oblast,1960081,105,0,4949,0
2020-07-16,Russia,NA,Omsk Oblast,1960081,117,0,5066,0
2020-07-17,Russia,NA,Omsk Oblast,1960081,106,0,5172,0
2020-07-18,Russia,NA,Omsk Oblast,1960081,114,0,5286,0
2020-07-19,Russia,NA,Omsk Oblast,1960081,109,0,5395,0
2020-07-20,Russia,NA,Omsk Oblast,1960081,108,0,5503,0
2020-07-21,Russia,NA,Omsk Oblast,1960081,104,0,5607,0
2020-07-22,Russia,NA,Omsk Oblast,1960081,118,0,5725,0
2020-07-23,Russia,NA,Omsk Oblast,1960081,129,0,5854,0
2020-07-24,Russia,NA,Omsk Oblast,1960081,115,0,5969,0
2020-07-25,Russia,NA,Omsk Oblast,1960081,108,0,6077,0
2020-07-26,Russia,NA,Omsk Oblast,1960081,107,0,6184,0
2020-07-27,Russia,NA,Omsk Oblast,1960081,114,0,6298,0
2020-07-28,Russia,NA,Omsk Oblast,1960081,115,0,6413,0
2020-07-29,Russia,NA,Omsk Oblast,1960081,111,0,6524,0
2020-07-30,Russia,NA,Omsk Oblast,1960081,119,0,6643,0
2020-07-31,Russia,NA,Omsk Oblast,1960081,125,0,6768,0
2020-08-01,Russia,NA,Omsk Oblast,1960081,114,0,6882,0
2020-08-02,Russia,NA,Omsk Oblast,1960081,108,0,6990,0
2020-08-26,Russia,NA,Omsk Oblast,1960081,0,0,9085,167
2020-08-27,Russia,NA,Omsk Oblast,1960081,30,4,9115,171
2020-08-28,Russia,NA,Omsk Oblast,1960081,39,4,9154,175
2020-08-29,Russia,NA,Omsk Oblast,1960081,43,5,9197,180
2020-08-30,Russia,NA,Omsk Oblast,1960081,44,0,9241,180
2020-08-31,Russia,NA,Omsk Oblast,1960081,41,7,9282,187
2020-09-01,Russia,NA,Omsk Oblast,1960081,42,6,9324,193
2020-09-02,Russia,NA,Omsk Oblast,1960081,45,5,9369,198
2020-09-03,Russia,NA,Omsk Oblast,1960081,43,5,9412,203
2020-09-04,Russia,NA,Omsk Oblast,1960081,46,4,9458,207
2020-09-05,Russia,NA,Omsk Oblast,1960081,49,4,9507,211
2020-09-06,Russia,NA,Omsk Oblast,1960081,53,4,9560,215
2020-09-07,Russia,NA,Omsk Oblast,1960081,54,5,9614,220
2020-09-08,Russia,NA,Omsk Oblast,1960081,56,4,9670,224
2020-09-09,Russia,NA,Omsk Oblast,1960081,54,4,9724,228
2020-09-10,Russia,NA,Omsk Oblast,1960081,55,4,9779,232
2020-09-11,Russia,NA,Omsk Oblast,1960081,51,3,9830,235
2020-09-12,Russia,NA,Omsk Oblast,1960081,55,4,9885,239
2020-09-13,Russia,NA,Omsk Oblast,1960081,45,3,9930,242
2020-09-14,Russia,NA,Omsk Oblast,1960081,32,0,9962,242
2020-09-15,Russia,NA,Omsk Oblast,1960081,44,6,10006,248
2020-09-16,Russia,NA,Omsk Oblast,1960081,34,4,10040,252
2020-09-17,Russia,NA,Omsk Oblast,1960081,48,3,10088,255
2020-09-18,Russia,NA,Omsk Oblast,1960081,52,0,10140,255
2020-09-19,Russia,NA,Omsk Oblast,1960081,50,6,10190,261
2020-09-20,Russia,NA,Omsk Oblast,1960081,59,4,10249,265
2020-09-21,Russia,NA,Omsk Oblast,1960081,58,3,10307,268
2020-09-22,Russia,NA,Omsk Oblast,1960081,69,3,10376,271
2020-09-23,Russia,NA,Omsk Oblast,1960081,73,0,10449,271
2020-04-02,Russia,NA,Orenburg Oblast,1977720,5,0,12,0
2020-04-06,Russia,NA,Orenburg Oblast,1977720,2,0,14,0
2020-04-08,Russia,NA,Orenburg Oblast,1977720,8,0,22,0
2020-04-10,Russia,NA,Orenburg Oblast,1977720,3,0,25,0
2020-04-13,Russia,NA,Orenburg Oblast,1977720,20,0,45,0
2020-04-14,Russia,NA,Orenburg Oblast,1977720,8,0,53,0
2020-04-15,Russia,NA,Orenburg Oblast,1977720,1,0,54,0
2020-04-16,Russia,NA,Orenburg Oblast,1977720,28,0,82,0
2020-04-17,Russia,NA,Orenburg Oblast,1977720,38,0,120,0
2020-04-18,Russia,NA,Orenburg Oblast,1977720,20,0,140,0
2020-04-19,Russia,NA,Orenburg Oblast,1977720,44,0,184,0
2020-04-21,Russia,NA,Orenburg Oblast,1977720,42,0,226,0
2020-04-22,Russia,NA,Orenburg Oblast,1977720,28,0,254,0
2020-04-23,Russia,NA,Orenburg Oblast,1977720,23,0,277,0
2020-04-24,Russia,NA,Orenburg Oblast,1977720,28,0,305,0
2020-04-25,Russia,NA,Orenburg Oblast,1977720,56,0,361,0
2020-04-26,Russia,NA,Orenburg Oblast,1977720,16,0,377,0
2020-04-27,Russia,NA,Orenburg Oblast,1977720,14,0,391,0
2020-04-28,Russia,NA,Orenburg Oblast,1977720,65,0,456,0
2020-04-29,Russia,NA,Orenburg Oblast,1977720,37,0,493,0
2020-04-30,Russia,NA,Orenburg Oblast,1977720,27,0,520,0
2020-05-01,Russia,NA,Orenburg Oblast,1977720,49,0,569,0
2020-05-02,Russia,NA,Orenburg Oblast,1977720,22,0,591,0
2020-05-03,Russia,NA,Orenburg Oblast,1977720,28,0,619,0
2020-05-04,Russia,NA,Orenburg Oblast,1977720,81,0,700,0
2020-05-05,Russia,NA,Orenburg Oblast,1977720,28,0,728,0
2020-05-06,Russia,NA,Orenburg Oblast,1977720,39,0,767,0
2020-05-07,Russia,NA,Orenburg Oblast,1977720,31,0,798,0
2020-05-08,Russia,NA,Orenburg Oblast,1977720,49,0,847,0
2020-05-09,Russia,NA,Orenburg Oblast,1977720,48,0,895,0
2020-05-10,Russia,NA,Orenburg Oblast,1977720,42,0,937,0
2020-05-11,Russia,NA,Orenburg Oblast,1977720,49,0,986,0
2020-05-12,Russia,NA,Orenburg Oblast,1977720,53,0,1039,0
2020-05-13,Russia,NA,Orenburg Oblast,1977720,50,0,1089,0
2020-05-14,Russia,NA,Orenburg Oblast,1977720,89,0,1178,0
2020-05-15,Russia,NA,Orenburg Oblast,1977720,30,0,1208,0
2020-05-16,Russia,NA,Orenburg Oblast,1977720,35,0,1243,0
2020-05-17,Russia,NA,Orenburg Oblast,1977720,35,0,1278,0
2020-05-18,Russia,NA,Orenburg Oblast,1977720,34,0,1312,0
2020-05-19,Russia,NA,Orenburg Oblast,1977720,38,0,1350,0
2020-05-20,Russia,NA,Orenburg Oblast,1977720,42,0,1392,0
2020-05-21,Russia,NA,Orenburg Oblast,1977720,45,0,1437,0
2020-05-22,Russia,NA,Orenburg Oblast,1977720,45,0,1482,0
2020-05-23,Russia,NA,Orenburg Oblast,1977720,42,0,1524,0
2020-05-24,Russia,NA,Orenburg Oblast,1977720,42,0,1566,0
2020-05-25,Russia,NA,Orenburg Oblast,1977720,44,0,1610,0
2020-05-26,Russia,NA,Orenburg Oblast,1977720,54,0,1664,0
2020-05-27,Russia,NA,Orenburg Oblast,1977720,54,0,1718,0
2020-05-28,Russia,NA,Orenburg Oblast,1977720,54,0,1772,0
2020-05-29,Russia,NA,Orenburg Oblast,1977720,54,0,1826,0
2020-05-30,Russia,NA,Orenburg Oblast,1977720,45,0,1871,0
2020-05-31,Russia,NA,Orenburg Oblast,1977720,54,0,1925,0
2020-06-01,Russia,NA,Orenburg Oblast,1977720,54,0,1979,0
2020-06-02,Russia,NA,Orenburg Oblast,1977720,53,0,2032,0
2020-06-03,Russia,NA,Orenburg Oblast,1977720,53,0,2085,0
2020-06-04,Russia,NA,Orenburg Oblast,1977720,56,0,2141,0
2020-06-05,Russia,NA,Orenburg Oblast,1977720,63,0,2204,0
2020-06-06,Russia,NA,Orenburg Oblast,1977720,63,0,2267,0
2020-06-07,Russia,NA,Orenburg Oblast,1977720,64,0,2331,0
2020-06-08,Russia,NA,Orenburg Oblast,1977720,66,0,2397,0
2020-06-09,Russia,NA,Orenburg Oblast,1977720,64,0,2461,0
2020-06-10,Russia,NA,Orenburg Oblast,1977720,60,0,2521,0
2020-06-11,Russia,NA,Orenburg Oblast,1977720,59,0,2580,0
2020-06-12,Russia,NA,Orenburg Oblast,1977720,63,0,2643,0
2020-06-13,Russia,NA,Orenburg Oblast,1977720,62,0,2705,0
2020-06-14,Russia,NA,Orenburg Oblast,1977720,63,0,2768,0
2020-06-15,Russia,NA,Orenburg Oblast,1977720,62,0,2830,0
2020-06-16,Russia,NA,Orenburg Oblast,1977720,60,0,2890,0
2020-06-17,Russia,NA,Orenburg Oblast,1977720,58,0,2948,0
2020-06-18,Russia,NA,Orenburg Oblast,1977720,59,0,3007,0
2020-06-19,Russia,NA,Orenburg Oblast,1977720,60,0,3067,0
2020-06-20,Russia,NA,Orenburg Oblast,1977720,58,0,3125,0
2020-06-21,Russia,NA,Orenburg Oblast,1977720,56,0,3181,0
2020-06-22,Russia,NA,Orenburg Oblast,1977720,64,0,3245,0
2020-06-23,Russia,NA,Orenburg Oblast,1977720,65,0,3310,0
2020-06-24,Russia,NA,Orenburg Oblast,1977720,67,0,3377,0
2020-06-25,Russia,NA,Orenburg Oblast,1977720,62,0,3439,0
2020-06-26,Russia,NA,Orenburg Oblast,1977720,60,0,3499,0
2020-06-27,Russia,NA,Orenburg Oblast,1977720,63,0,3562,0
2020-06-28,Russia,NA,Orenburg Oblast,1977720,64,0,3626,0
2020-06-29,Russia,NA,Orenburg Oblast,1977720,74,0,3700,0
2020-06-30,Russia,NA,Orenburg Oblast,1977720,77,0,3777,0
2020-07-01,Russia,NA,Orenburg Oblast,1977720,76,0,3853,0
2020-07-02,Russia,NA,Orenburg Oblast,1977720,76,0,3929,0
2020-07-03,Russia,NA,Orenburg Oblast,1977720,78,0,4007,0
2020-07-04,Russia,NA,Orenburg Oblast,1977720,81,0,4088,0
2020-07-05,Russia,NA,Orenburg Oblast,1977720,82,0,4170,0
2020-07-06,Russia,NA,Orenburg Oblast,1977720,83,0,4253,0
2020-07-07,Russia,NA,Orenburg Oblast,1977720,86,0,4339,0
2020-07-08,Russia,NA,Orenburg Oblast,1977720,88,0,4427,0
2020-07-09,Russia,NA,Orenburg Oblast,1977720,88,0,4515,0
2020-07-10,Russia,NA,Orenburg Oblast,1977720,95,0,4610,0
2020-07-11,Russia,NA,Orenburg Oblast,1977720,98,0,4708,0
2020-07-12,Russia,NA,Orenburg Oblast,1977720,100,0,4808,0
2020-07-13,Russia,NA,Orenburg Oblast,1977720,102,0,4910,0
2020-07-14,Russia,NA,Orenburg Oblast,1977720,108,0,5018,0
2020-07-15,Russia,NA,Orenburg Oblast,1977720,108,0,5126,0
2020-07-16,Russia,NA,Orenburg Oblast,1977720,111,0,5237,0
2020-07-17,Russia,NA,Orenburg Oblast,1977720,115,0,5352,0
2020-07-18,Russia,NA,Orenburg Oblast,1977720,118,0,5470,0
2020-07-19,Russia,NA,Orenburg Oblast,1977720,116,0,5586,0
2020-07-20,Russia,NA,Orenburg Oblast,1977720,115,0,5701,0
2020-07-21,Russia,NA,Orenburg Oblast,1977720,114,0,5815,0
2020-07-22,Russia,NA,Orenburg Oblast,1977720,114,0,5929,0
2020-07-23,Russia,NA,Orenburg Oblast,1977720,113,0,6042,0
2020-07-24,Russia,NA,Orenburg Oblast,1977720,112,0,6154,0
2020-07-25,Russia,NA,Orenburg Oblast,1977720,110,0,6264,0
2020-07-26,Russia,NA,Orenburg Oblast,1977720,110,0,6374,0
2020-07-27,Russia,NA,Orenburg Oblast,1977720,111,0,6485,0
2020-07-28,Russia,NA,Orenburg Oblast,1977720,109,0,6594,0
2020-07-29,Russia,NA,Orenburg Oblast,1977720,108,0,6702,0
2020-07-30,Russia,NA,Orenburg Oblast,1977720,107,0,6809,0
2020-07-31,Russia,NA,Orenburg Oblast,1977720,106,0,6915,0
2020-08-01,Russia,NA,Orenburg Oblast,1977720,106,0,7021,0
2020-08-02,Russia,NA,Orenburg Oblast,1977720,110,0,7131,0
2020-08-26,Russia,NA,Orenburg Oblast,1977720,0,0,9524,72
2020-08-27,Russia,NA,Orenburg Oblast,1977720,86,2,9610,74
2020-08-28,Russia,NA,Orenburg Oblast,1977720,84,0,9694,74
2020-08-29,Russia,NA,Orenburg Oblast,1977720,84,1,9778,75
2020-08-30,Russia,NA,Orenburg Oblast,1977720,83,1,9861,76
2020-08-31,Russia,NA,Orenburg Oblast,1977720,83,0,9944,76
2020-09-01,Russia,NA,Orenburg Oblast,1977720,86,1,10030,77
2020-09-02,Russia,NA,Orenburg Oblast,1977720,87,0,10117,77
2020-09-03,Russia,NA,Orenburg Oblast,1977720,88,0,10205,77
2020-09-04,Russia,NA,Orenburg Oblast,1977720,90,4,10295,81
2020-09-05,Russia,NA,Orenburg Oblast,1977720,92,0,10387,81
2020-09-06,Russia,NA,Orenburg Oblast,1977720,92,0,10479,81
2020-09-07,Russia,NA,Orenburg Oblast,1977720,91,0,10570,81
2020-09-08,Russia,NA,Orenburg Oblast,1977720,89,0,10659,81
2020-09-09,Russia,NA,Orenburg Oblast,1977720,91,0,10750,81
2020-09-10,Russia,NA,Orenburg Oblast,1977720,93,0,10843,81
2020-09-11,Russia,NA,Orenburg Oblast,1977720,95,0,10938,81
2020-09-12,Russia,NA,Orenburg Oblast,1977720,96,0,11034,81
2020-09-13,Russia,NA,Orenburg Oblast,1977720,96,0,11130,81
2020-09-14,Russia,NA,Orenburg Oblast,1977720,98,0,11228,81
2020-09-15,Russia,NA,Orenburg Oblast,1977720,100,1,11328,82
2020-09-16,Russia,NA,Orenburg Oblast,1977720,100,0,11428,82
2020-09-17,Russia,NA,Orenburg Oblast,1977720,101,0,11529,82
2020-09-18,Russia,NA,Orenburg Oblast,1977720,99,0,11628,82
2020-09-19,Russia,NA,Orenburg Oblast,1977720,101,0,11729,82
2020-09-20,Russia,NA,Orenburg Oblast,1977720,98,0,11827,82
2020-09-21,Russia,NA,Orenburg Oblast,1977720,100,0,11927,82
2020-09-22,Russia,NA,Orenburg Oblast,1977720,100,0,12027,82
2020-09-23,Russia,NA,Orenburg Oblast,1977720,102,0,12129,82
2020-04-07,Russia,NA,Oryol Oblast,747247,5,0,12,0
2020-04-09,Russia,NA,Oryol Oblast,747247,5,0,17,0
2020-04-10,Russia,NA,Oryol Oblast,747247,7,0,24,0
2020-04-11,Russia,NA,Oryol Oblast,747247,5,0,29,0
2020-04-13,Russia,NA,Oryol Oblast,747247,5,0,34,0
2020-04-14,Russia,NA,Oryol Oblast,747247,7,0,41,0
2020-04-16,Russia,NA,Oryol Oblast,747247,32,0,73,0
2020-04-17,Russia,NA,Oryol Oblast,747247,12,0,85,0
2020-04-18,Russia,NA,Oryol Oblast,747247,34,0,119,0
2020-04-19,Russia,NA,Oryol Oblast,747247,13,0,132,0
2020-04-20,Russia,NA,Oryol Oblast,747247,43,0,175,0
2020-04-21,Russia,NA,Oryol Oblast,747247,23,0,198,0
2020-04-22,Russia,NA,Oryol Oblast,747247,40,0,238,0
2020-04-23,Russia,NA,Oryol Oblast,747247,11,0,249,0
2020-04-24,Russia,NA,Oryol Oblast,747247,47,0,296,0
2020-04-25,Russia,NA,Oryol Oblast,747247,25,0,321,0
2020-04-26,Russia,NA,Oryol Oblast,747247,42,0,363,0
2020-04-27,Russia,NA,Oryol Oblast,747247,44,0,407,0
2020-04-28,Russia,NA,Oryol Oblast,747247,53,0,460,0
2020-04-29,Russia,NA,Oryol Oblast,747247,38,0,498,0
2020-04-30,Russia,NA,Oryol Oblast,747247,27,0,525,0
2020-05-01,Russia,NA,Oryol Oblast,747247,37,0,562,0
2020-05-02,Russia,NA,Oryol Oblast,747247,32,0,594,0
2020-05-03,Russia,NA,Oryol Oblast,747247,68,0,662,0
2020-05-04,Russia,NA,Oryol Oblast,747247,19,0,681,0
2020-05-05,Russia,NA,Oryol Oblast,747247,75,0,756,0
2020-05-06,Russia,NA,Oryol Oblast,747247,57,0,813,0
2020-05-07,Russia,NA,Oryol Oblast,747247,52,0,865,0
2020-05-08,Russia,NA,Oryol Oblast,747247,58,0,923,0
2020-05-09,Russia,NA,Oryol Oblast,747247,50,0,973,0
2020-05-10,Russia,NA,Oryol Oblast,747247,50,0,1023,0
2020-05-11,Russia,NA,Oryol Oblast,747247,64,0,1087,0
2020-05-12,Russia,NA,Oryol Oblast,747247,61,0,1148,0
2020-05-13,Russia,NA,Oryol Oblast,747247,59,0,1207,0
2020-05-14,Russia,NA,Oryol Oblast,747247,57,0,1264,0
2020-05-15,Russia,NA,Oryol Oblast,747247,65,0,1329,0
2020-05-16,Russia,NA,Oryol Oblast,747247,52,0,1381,0
2020-05-17,Russia,NA,Oryol Oblast,747247,68,0,1449,0
2020-05-18,Russia,NA,Oryol Oblast,747247,68,0,1517,0
2020-05-19,Russia,NA,Oryol Oblast,747247,32,0,1549,0
2020-05-20,Russia,NA,Oryol Oblast,747247,49,0,1598,0
2020-05-21,Russia,NA,Oryol Oblast,747247,49,0,1647,0
2020-05-22,Russia,NA,Oryol Oblast,747247,32,0,1679,0
2020-05-23,Russia,NA,Oryol Oblast,747247,61,0,1740,0
2020-05-24,Russia,NA,Oryol Oblast,747247,68,0,1808,0
2020-05-25,Russia,NA,Oryol Oblast,747247,59,0,1867,0
2020-05-26,Russia,NA,Oryol Oblast,747247,75,0,1942,0
2020-05-27,Russia,NA,Oryol Oblast,747247,81,0,2023,0
2020-05-28,Russia,NA,Oryol Oblast,747247,59,0,2082,0
2020-05-29,Russia,NA,Oryol Oblast,747247,65,0,2147,0
2020-05-30,Russia,NA,Oryol Oblast,747247,78,0,2225,0
2020-05-31,Russia,NA,Oryol Oblast,747247,75,0,2300,0
2020-06-01,Russia,NA,Oryol Oblast,747247,41,0,2341,0
2020-06-02,Russia,NA,Oryol Oblast,747247,31,0,2372,0
2020-06-03,Russia,NA,Oryol Oblast,747247,71,0,2443,0
2020-06-04,Russia,NA,Oryol Oblast,747247,85,0,2528,0
2020-06-05,Russia,NA,Oryol Oblast,747247,121,0,2649,0
2020-06-06,Russia,NA,Oryol Oblast,747247,111,0,2760,0
2020-06-07,Russia,NA,Oryol Oblast,747247,110,0,2870,0
2020-06-08,Russia,NA,Oryol Oblast,747247,97,0,2967,0
2020-06-09,Russia,NA,Oryol Oblast,747247,125,0,3092,0
2020-06-10,Russia,NA,Oryol Oblast,747247,89,0,3181,0
2020-06-11,Russia,NA,Oryol Oblast,747247,102,0,3283,0
2020-06-12,Russia,NA,Oryol Oblast,747247,109,0,3392,0
2020-06-13,Russia,NA,Oryol Oblast,747247,81,0,3473,0
2020-06-14,Russia,NA,Oryol Oblast,747247,86,0,3559,0
2020-06-15,Russia,NA,Oryol Oblast,747247,122,0,3681,0
2020-06-16,Russia,NA,Oryol Oblast,747247,110,0,3791,0
2020-06-17,Russia,NA,Oryol Oblast,747247,67,0,3858,0
2020-06-18,Russia,NA,Oryol Oblast,747247,71,0,3929,0
2020-06-19,Russia,NA,Oryol Oblast,747247,74,0,4003,0
2020-06-20,Russia,NA,Oryol Oblast,747247,65,0,4068,0
2020-06-21,Russia,NA,Oryol Oblast,747247,60,0,4128,0
2020-06-22,Russia,NA,Oryol Oblast,747247,58,0,4186,0
2020-06-23,Russia,NA,Oryol Oblast,747247,55,0,4241,0
2020-06-24,Russia,NA,Oryol Oblast,747247,40,0,4281,0
2020-06-25,Russia,NA,Oryol Oblast,747247,37,0,4318,0
2020-06-26,Russia,NA,Oryol Oblast,747247,40,0,4358,0
2020-06-27,Russia,NA,Oryol Oblast,747247,38,0,4396,0
2020-06-28,Russia,NA,Oryol Oblast,747247,41,0,4437,0
2020-06-29,Russia,NA,Oryol Oblast,747247,43,0,4480,0
2020-06-30,Russia,NA,Oryol Oblast,747247,33,0,4513,0
2020-07-01,Russia,NA,Oryol Oblast,747247,31,0,4544,0
2020-07-02,Russia,NA,Oryol Oblast,747247,35,0,4579,0
2020-07-03,Russia,NA,Oryol Oblast,747247,31,0,4610,0
2020-07-04,Russia,NA,Oryol Oblast,747247,34,0,4644,0
2020-07-05,Russia,NA,Oryol Oblast,747247,40,0,4684,0
2020-07-06,Russia,NA,Oryol Oblast,747247,57,0,4741,0
2020-07-07,Russia,NA,Oryol Oblast,747247,54,0,4795,0
2020-07-08,Russia,NA,Oryol Oblast,747247,45,0,4840,0
2020-07-09,Russia,NA,Oryol Oblast,747247,43,0,4883,0
2020-07-10,Russia,NA,Oryol Oblast,747247,47,0,4930,0
2020-07-11,Russia,NA,Oryol Oblast,747247,44,0,4974,0
2020-07-12,Russia,NA,Oryol Oblast,747247,46,0,5020,0
2020-07-13,Russia,NA,Oryol Oblast,747247,49,0,5069,0
2020-07-14,Russia,NA,Oryol Oblast,747247,44,0,5113,0
2020-07-15,Russia,NA,Oryol Oblast,747247,40,0,5153,0
2020-07-16,Russia,NA,Oryol Oblast,747247,45,0,5198,0
2020-07-17,Russia,NA,Oryol Oblast,747247,42,0,5240,0
2020-07-18,Russia,NA,Oryol Oblast,747247,40,0,5280,0
2020-07-19,Russia,NA,Oryol Oblast,747247,38,0,5318,0
2020-07-20,Russia,NA,Oryol Oblast,747247,31,0,5349,0
2020-07-21,Russia,NA,Oryol Oblast,747247,29,0,5378,0
2020-07-22,Russia,NA,Oryol Oblast,747247,25,0,5403,0
2020-07-23,Russia,NA,Oryol Oblast,747247,22,0,5425,0
2020-07-24,Russia,NA,Oryol Oblast,747247,22,0,5447,0
2020-07-25,Russia,NA,Oryol Oblast,747247,21,0,5468,0
2020-07-26,Russia,NA,Oryol Oblast,747247,25,0,5493,0
2020-07-27,Russia,NA,Oryol Oblast,747247,30,0,5523,0
2020-07-28,Russia,NA,Oryol Oblast,747247,29,0,5552,0
2020-07-29,Russia,NA,Oryol Oblast,747247,30,0,5582,0
2020-07-30,Russia,NA,Oryol Oblast,747247,32,0,5614,0
2020-07-31,Russia,NA,Oryol Oblast,747247,31,0,5645,0
2020-08-01,Russia,NA,Oryol Oblast,747247,30,0,5675,0
2020-08-02,Russia,NA,Oryol Oblast,747247,32,0,5707,0
2020-08-26,Russia,NA,Oryol Oblast,747247,0,0,6808,104
2020-08-27,Russia,NA,Oryol Oblast,747247,41,0,6849,104
2020-08-28,Russia,NA,Oryol Oblast,747247,40,1,6889,105
2020-08-29,Russia,NA,Oryol Oblast,747247,47,1,6936,106
2020-08-30,Russia,NA,Oryol Oblast,747247,46,0,6982,106
2020-08-31,Russia,NA,Oryol Oblast,747247,47,0,7029,106
2020-09-01,Russia,NA,Oryol Oblast,747247,51,2,7080,108
2020-09-02,Russia,NA,Oryol Oblast,747247,51,1,7131,109
2020-09-03,Russia,NA,Oryol Oblast,747247,48,1,7179,110
2020-09-04,Russia,NA,Oryol Oblast,747247,49,0,7228,110
2020-09-05,Russia,NA,Oryol Oblast,747247,50,0,7278,110
2020-09-06,Russia,NA,Oryol Oblast,747247,48,1,7326,111
2020-09-07,Russia,NA,Oryol Oblast,747247,51,0,7377,111
2020-09-08,Russia,NA,Oryol Oblast,747247,50,0,7427,111
2020-09-09,Russia,NA,Oryol Oblast,747247,49,2,7476,113
2020-09-10,Russia,NA,Oryol Oblast,747247,49,0,7525,113
2020-09-11,Russia,NA,Oryol Oblast,747247,50,1,7575,114
2020-09-12,Russia,NA,Oryol Oblast,747247,49,1,7624,115
2020-09-13,Russia,NA,Oryol Oblast,747247,51,0,7675,115
2020-09-14,Russia,NA,Oryol Oblast,747247,48,0,7723,115
2020-09-15,Russia,NA,Oryol Oblast,747247,51,1,7774,116
2020-09-16,Russia,NA,Oryol Oblast,747247,52,4,7826,120
2020-09-17,Russia,NA,Oryol Oblast,747247,48,0,7874,120
2020-09-18,Russia,NA,Oryol Oblast,747247,51,1,7925,121
2020-09-19,Russia,NA,Oryol Oblast,747247,50,1,7975,122
2020-09-20,Russia,NA,Oryol Oblast,747247,50,0,8025,122
2020-09-21,Russia,NA,Oryol Oblast,747247,51,0,8076,122
2020-09-22,Russia,NA,Oryol Oblast,747247,52,1,8128,123
2020-09-23,Russia,NA,Oryol Oblast,747247,53,2,8181,125
2020-03-31,Russia,NA,Penza Oblast,1331655,5,0,12,0
2020-04-01,Russia,NA,Penza Oblast,1331655,4,0,16,0
2020-04-03,Russia,NA,Penza Oblast,1331655,11,0,27,0
2020-04-06,Russia,NA,Penza Oblast,1331655,5,0,32,0
2020-04-07,Russia,NA,Penza Oblast,1331655,19,0,51,0
2020-04-08,Russia,NA,Penza Oblast,1331655,1,0,52,0
2020-04-10,Russia,NA,Penza Oblast,1331655,15,0,67,0
2020-04-13,Russia,NA,Penza Oblast,1331655,17,0,84,0
2020-04-15,Russia,NA,Penza Oblast,1331655,16,0,100,0
2020-04-16,Russia,NA,Penza Oblast,1331655,7,0,107,0
2020-04-17,Russia,NA,Penza Oblast,1331655,12,0,119,0
2020-04-18,Russia,NA,Penza Oblast,1331655,21,0,140,0
2020-04-20,Russia,NA,Penza Oblast,1331655,25,0,165,0
2020-04-21,Russia,NA,Penza Oblast,1331655,15,0,180,0
2020-04-22,Russia,NA,Penza Oblast,1331655,16,0,196,0
2020-04-23,Russia,NA,Penza Oblast,1331655,15,0,211,0
2020-04-24,Russia,NA,Penza Oblast,1331655,21,0,232,0
2020-04-25,Russia,NA,Penza Oblast,1331655,23,0,255,0
2020-04-26,Russia,NA,Penza Oblast,1331655,6,0,261,0
2020-04-27,Russia,NA,Penza Oblast,1331655,22,0,283,0
2020-04-29,Russia,NA,Penza Oblast,1331655,42,0,325,0
2020-04-30,Russia,NA,Penza Oblast,1331655,40,0,365,0
2020-05-01,Russia,NA,Penza Oblast,1331655,44,0,409,0
2020-05-02,Russia,NA,Penza Oblast,1331655,33,0,442,0
2020-05-03,Russia,NA,Penza Oblast,1331655,31,0,473,0
2020-05-04,Russia,NA,Penza Oblast,1331655,27,0,500,0
2020-05-05,Russia,NA,Penza Oblast,1331655,30,0,530,0
2020-05-06,Russia,NA,Penza Oblast,1331655,32,0,562,0
2020-05-07,Russia,NA,Penza Oblast,1331655,34,0,596,0
2020-05-08,Russia,NA,Penza Oblast,1331655,43,0,639,0
2020-05-09,Russia,NA,Penza Oblast,1331655,45,0,684,0
2020-05-10,Russia,NA,Penza Oblast,1331655,41,0,725,0
2020-05-11,Russia,NA,Penza Oblast,1331655,38,0,763,0
2020-05-12,Russia,NA,Penza Oblast,1331655,35,0,798,0
2020-05-13,Russia,NA,Penza Oblast,1331655,42,0,840,0
2020-05-14,Russia,NA,Penza Oblast,1331655,45,0,885,0
2020-05-15,Russia,NA,Penza Oblast,1331655,61,0,946,0
2020-05-16,Russia,NA,Penza Oblast,1331655,56,0,1002,0
2020-05-17,Russia,NA,Penza Oblast,1331655,60,0,1062,0
2020-05-18,Russia,NA,Penza Oblast,1331655,71,0,1133,0
2020-05-19,Russia,NA,Penza Oblast,1331655,73,0,1206,0
2020-05-20,Russia,NA,Penza Oblast,1331655,72,0,1278,0
2020-05-21,Russia,NA,Penza Oblast,1331655,83,0,1361,0
2020-05-22,Russia,NA,Penza Oblast,1331655,110,0,1471,0
2020-05-23,Russia,NA,Penza Oblast,1331655,102,0,1573,0
2020-05-24,Russia,NA,Penza Oblast,1331655,97,0,1670,0
2020-05-25,Russia,NA,Penza Oblast,1331655,94,0,1764,0
2020-05-26,Russia,NA,Penza Oblast,1331655,89,0,1853,0
2020-05-27,Russia,NA,Penza Oblast,1331655,88,0,1941,0
2020-05-28,Russia,NA,Penza Oblast,1331655,86,0,2027,0
2020-05-29,Russia,NA,Penza Oblast,1331655,89,0,2116,0
2020-05-30,Russia,NA,Penza Oblast,1331655,90,0,2206,0
2020-05-31,Russia,NA,Penza Oblast,1331655,87,0,2293,0
2020-06-01,Russia,NA,Penza Oblast,1331655,85,0,2378,0
2020-06-02,Russia,NA,Penza Oblast,1331655,85,0,2463,0
2020-06-03,Russia,NA,Penza Oblast,1331655,83,0,2546,0
2020-06-04,Russia,NA,Penza Oblast,1331655,84,0,2630,0
2020-06-05,Russia,NA,Penza Oblast,1331655,90,0,2720,0
2020-06-06,Russia,NA,Penza Oblast,1331655,86,0,2806,0
2020-06-07,Russia,NA,Penza Oblast,1331655,98,0,2904,0
2020-06-08,Russia,NA,Penza Oblast,1331655,110,0,3014,0
2020-06-09,Russia,NA,Penza Oblast,1331655,138,0,3152,0
2020-06-10,Russia,NA,Penza Oblast,1331655,126,0,3278,0
2020-06-11,Russia,NA,Penza Oblast,1331655,115,0,3393,0
2020-06-12,Russia,NA,Penza Oblast,1331655,103,0,3496,0
2020-06-13,Russia,NA,Penza Oblast,1331655,99,0,3595,0
2020-06-14,Russia,NA,Penza Oblast,1331655,95,0,3690,0
2020-06-15,Russia,NA,Penza Oblast,1331655,94,0,3784,0
2020-06-16,Russia,NA,Penza Oblast,1331655,92,0,3876,0
2020-06-17,Russia,NA,Penza Oblast,1331655,91,0,3967,0
2020-06-18,Russia,NA,Penza Oblast,1331655,70,0,4037,0
2020-06-19,Russia,NA,Penza Oblast,1331655,75,0,4112,0
2020-06-20,Russia,NA,Penza Oblast,1331655,73,0,4185,0
2020-06-21,Russia,NA,Penza Oblast,1331655,83,0,4268,0
2020-06-22,Russia,NA,Penza Oblast,1331655,73,0,4341,0
2020-06-23,Russia,NA,Penza Oblast,1331655,71,0,4412,0
2020-06-24,Russia,NA,Penza Oblast,1331655,72,0,4484,0
2020-06-25,Russia,NA,Penza Oblast,1331655,70,0,4554,0
2020-06-26,Russia,NA,Penza Oblast,1331655,71,0,4625,0
2020-06-27,Russia,NA,Penza Oblast,1331655,75,0,4700,0
2020-06-28,Russia,NA,Penza Oblast,1331655,80,0,4780,0
2020-06-29,Russia,NA,Penza Oblast,1331655,74,0,4854,0
2020-06-30,Russia,NA,Penza Oblast,1331655,77,0,4931,0
2020-07-01,Russia,NA,Penza Oblast,1331655,75,0,5006,0
2020-07-02,Russia,NA,Penza Oblast,1331655,73,0,5079,0
2020-07-03,Russia,NA,Penza Oblast,1331655,75,0,5154,0
2020-07-04,Russia,NA,Penza Oblast,1331655,75,0,5229,0
2020-07-05,Russia,NA,Penza Oblast,1331655,79,0,5308,0
2020-07-06,Russia,NA,Penza Oblast,1331655,71,0,5379,0
2020-07-07,Russia,NA,Penza Oblast,1331655,68,0,5447,0
2020-07-08,Russia,NA,Penza Oblast,1331655,72,0,5519,0
2020-07-09,Russia,NA,Penza Oblast,1331655,70,0,5589,0
2020-07-10,Russia,NA,Penza Oblast,1331655,35,0,5624,0
2020-07-11,Russia,NA,Penza Oblast,1331655,36,0,5660,0
2020-07-12,Russia,NA,Penza Oblast,1331655,34,0,5694,0
2020-07-13,Russia,NA,Penza Oblast,1331655,35,0,5729,0
2020-07-14,Russia,NA,Penza Oblast,1331655,35,0,5764,0
2020-07-15,Russia,NA,Penza Oblast,1331655,41,0,5805,0
2020-07-16,Russia,NA,Penza Oblast,1331655,39,0,5844,0
2020-07-17,Russia,NA,Penza Oblast,1331655,36,0,5880,0
2020-07-18,Russia,NA,Penza Oblast,1331655,35,0,5915,0
2020-07-19,Russia,NA,Penza Oblast,1331655,37,0,5952,0
2020-07-20,Russia,NA,Penza Oblast,1331655,37,0,5989,0
2020-07-21,Russia,NA,Penza Oblast,1331655,40,0,6029,0
2020-07-22,Russia,NA,Penza Oblast,1331655,41,0,6070,0
2020-07-23,Russia,NA,Penza Oblast,1331655,45,0,6115,0
2020-07-24,Russia,NA,Penza Oblast,1331655,44,0,6159,0
2020-07-25,Russia,NA,Penza Oblast,1331655,46,0,6205,0
2020-07-26,Russia,NA,Penza Oblast,1331655,42,0,6247,0
2020-07-27,Russia,NA,Penza Oblast,1331655,38,0,6285,0
2020-07-28,Russia,NA,Penza Oblast,1331655,40,0,6325,0
2020-07-29,Russia,NA,Penza Oblast,1331655,45,0,6370,0
2020-07-30,Russia,NA,Penza Oblast,1331655,43,0,6413,0
2020-07-31,Russia,NA,Penza Oblast,1331655,47,0,6460,0
2020-08-01,Russia,NA,Penza Oblast,1331655,46,0,6506,0
2020-08-02,Russia,NA,Penza Oblast,1331655,49,0,6555,0
2020-08-26,Russia,NA,Penza Oblast,1331655,0,0,7801,104
2020-08-27,Russia,NA,Penza Oblast,1331655,62,1,7863,105
2020-08-28,Russia,NA,Penza Oblast,1331655,66,1,7929,106
2020-08-29,Russia,NA,Penza Oblast,1331655,65,1,7994,107
2020-08-30,Russia,NA,Penza Oblast,1331655,63,0,8057,107
2020-08-31,Russia,NA,Penza Oblast,1331655,68,0,8125,107
2020-09-01,Russia,NA,Penza Oblast,1331655,75,1,8200,108
2020-09-02,Russia,NA,Penza Oblast,1331655,79,1,8279,109
2020-09-03,Russia,NA,Penza Oblast,1331655,85,1,8364,110
2020-09-04,Russia,NA,Penza Oblast,1331655,90,1,8454,111
2020-09-05,Russia,NA,Penza Oblast,1331655,93,1,8547,112
2020-09-06,Russia,NA,Penza Oblast,1331655,98,0,8645,112
2020-09-07,Russia,NA,Penza Oblast,1331655,97,0,8742,112
2020-09-08,Russia,NA,Penza Oblast,1331655,94,1,8836,113
2020-09-09,Russia,NA,Penza Oblast,1331655,96,1,8932,114
2020-09-10,Russia,NA,Penza Oblast,1331655,97,1,9029,115
2020-09-11,Russia,NA,Penza Oblast,1331655,92,1,9121,116
2020-09-12,Russia,NA,Penza Oblast,1331655,90,1,9211,117
2020-09-13,Russia,NA,Penza Oblast,1331655,85,0,9296,117
2020-09-14,Russia,NA,Penza Oblast,1331655,93,0,9389,117
2020-09-15,Russia,NA,Penza Oblast,1331655,95,1,9484,118
2020-09-16,Russia,NA,Penza Oblast,1331655,98,1,9582,119
2020-09-17,Russia,NA,Penza Oblast,1331655,97,1,9679,120
2020-09-18,Russia,NA,Penza Oblast,1331655,99,1,9778,121
2020-09-19,Russia,NA,Penza Oblast,1331655,97,1,9875,122
2020-09-20,Russia,NA,Penza Oblast,1331655,94,0,9969,122
2020-09-21,Russia,NA,Penza Oblast,1331655,92,0,10061,122
2020-09-22,Russia,NA,Penza Oblast,1331655,93,1,10154,123
2020-09-23,Russia,NA,Penza Oblast,1331655,95,1,10249,124
2020-03-28,Russia,NA,Perm Krai,2623122,1,0,11,0
2020-03-30,Russia,NA,Perm Krai,2623122,2,0,13,0
2020-04-02,Russia,NA,Perm Krai,2623122,7,0,20,0
2020-04-03,Russia,NA,Perm Krai,2623122,1,0,21,0
2020-04-07,Russia,NA,Perm Krai,2623122,11,0,32,0
2020-04-09,Russia,NA,Perm Krai,2623122,9,0,41,0
2020-04-10,Russia,NA,Perm Krai,2623122,4,0,45,0
2020-04-12,Russia,NA,Perm Krai,2623122,15,0,60,0
2020-04-14,Russia,NA,Perm Krai,2623122,27,0,87,0
2020-04-15,Russia,NA,Perm Krai,2623122,27,0,114,0
2020-04-16,Russia,NA,Perm Krai,2623122,18,0,132,0
2020-04-17,Russia,NA,Perm Krai,2623122,12,0,144,0
2020-04-18,Russia,NA,Perm Krai,2623122,26,0,170,0
2020-04-19,Russia,NA,Perm Krai,2623122,28,0,198,0
2020-04-20,Russia,NA,Perm Krai,2623122,17,0,215,0
2020-04-21,Russia,NA,Perm Krai,2623122,22,0,237,0
2020-04-22,Russia,NA,Perm Krai,2623122,29,0,266,0
2020-04-23,Russia,NA,Perm Krai,2623122,21,0,287,0
2020-04-24,Russia,NA,Perm Krai,2623122,31,0,318,0
2020-04-25,Russia,NA,Perm Krai,2623122,55,0,373,0
2020-04-26,Russia,NA,Perm Krai,2623122,61,0,434,0
2020-04-27,Russia,NA,Perm Krai,2623122,20,0,454,0
2020-04-28,Russia,NA,Perm Krai,2623122,17,0,471,0
2020-04-29,Russia,NA,Perm Krai,2623122,10,0,481,0
2020-04-30,Russia,NA,Perm Krai,2623122,19,0,500,0
2020-05-01,Russia,NA,Perm Krai,2623122,24,0,524,0
2020-05-02,Russia,NA,Perm Krai,2623122,32,0,556,0
2020-05-03,Russia,NA,Perm Krai,2623122,39,0,595,0
2020-05-04,Russia,NA,Perm Krai,2623122,35,0,630,0
2020-05-05,Russia,NA,Perm Krai,2623122,18,0,648,0
2020-05-06,Russia,NA,Perm Krai,2623122,25,0,673,0
2020-05-07,Russia,NA,Perm Krai,2623122,26,0,699,0
2020-05-08,Russia,NA,Perm Krai,2623122,20,0,719,0
2020-05-09,Russia,NA,Perm Krai,2623122,16,0,735,0
2020-05-10,Russia,NA,Perm Krai,2623122,8,0,743,0
2020-05-11,Russia,NA,Perm Krai,2623122,10,0,753,0
2020-05-12,Russia,NA,Perm Krai,2623122,28,0,781,0
2020-05-13,Russia,NA,Perm Krai,2623122,48,0,829,0
2020-05-14,Russia,NA,Perm Krai,2623122,42,0,871,0
2020-05-15,Russia,NA,Perm Krai,2623122,50,0,921,0
2020-05-16,Russia,NA,Perm Krai,2623122,52,0,973,0
2020-05-17,Russia,NA,Perm Krai,2623122,51,0,1024,0
2020-05-18,Russia,NA,Perm Krai,2623122,49,0,1073,0
2020-05-19,Russia,NA,Perm Krai,2623122,52,0,1125,0
2020-05-20,Russia,NA,Perm Krai,2623122,53,0,1178,0
2020-05-21,Russia,NA,Perm Krai,2623122,48,0,1226,0
2020-05-22,Russia,NA,Perm Krai,2623122,51,0,1277,0
2020-05-23,Russia,NA,Perm Krai,2623122,47,0,1324,0
2020-05-24,Russia,NA,Perm Krai,2623122,43,0,1367,0
2020-05-25,Russia,NA,Perm Krai,2623122,43,0,1410,0
2020-05-26,Russia,NA,Perm Krai,2623122,41,0,1451,0
2020-05-27,Russia,NA,Perm Krai,2623122,44,0,1495,0
2020-05-28,Russia,NA,Perm Krai,2623122,44,0,1539,0
2020-05-29,Russia,NA,Perm Krai,2623122,47,0,1586,0
2020-05-30,Russia,NA,Perm Krai,2623122,70,0,1656,0
2020-05-31,Russia,NA,Perm Krai,2623122,57,0,1713,0
2020-06-01,Russia,NA,Perm Krai,2623122,69,0,1782,0
2020-06-02,Russia,NA,Perm Krai,2623122,57,0,1839,0
2020-06-03,Russia,NA,Perm Krai,2623122,72,0,1911,0
2020-06-04,Russia,NA,Perm Krai,2623122,51,0,1962,0
2020-06-05,Russia,NA,Perm Krai,2623122,49,0,2011,0
2020-06-06,Russia,NA,Perm Krai,2623122,56,0,2067,0
2020-06-07,Russia,NA,Perm Krai,2623122,68,0,2135,0
2020-06-08,Russia,NA,Perm Krai,2623122,67,0,2202,0
2020-06-09,Russia,NA,Perm Krai,2623122,65,0,2267,0
2020-06-10,Russia,NA,Perm Krai,2623122,93,0,2360,0
2020-06-11,Russia,NA,Perm Krai,2623122,74,0,2434,0
2020-06-12,Russia,NA,Perm Krai,2623122,72,0,2506,0
2020-06-13,Russia,NA,Perm Krai,2623122,74,0,2580,0
2020-06-14,Russia,NA,Perm Krai,2623122,107,0,2687,0
2020-06-15,Russia,NA,Perm Krai,2623122,68,0,2755,0
2020-06-16,Russia,NA,Perm Krai,2623122,50,0,2805,0
2020-06-17,Russia,NA,Perm Krai,2623122,67,0,2872,0
2020-06-18,Russia,NA,Perm Krai,2623122,65,0,2937,0
2020-06-19,Russia,NA,Perm Krai,2623122,64,0,3001,0
2020-06-20,Russia,NA,Perm Krai,2623122,68,0,3069,0
2020-06-21,Russia,NA,Perm Krai,2623122,67,0,3136,0
2020-06-22,Russia,NA,Perm Krai,2623122,66,0,3202,0
2020-06-23,Russia,NA,Perm Krai,2623122,64,0,3266,0
2020-06-24,Russia,NA,Perm Krai,2623122,89,0,3355,0
2020-06-25,Russia,NA,Perm Krai,2623122,61,0,3416,0
2020-06-26,Russia,NA,Perm Krai,2623122,58,0,3474,0
2020-06-27,Russia,NA,Perm Krai,2623122,55,0,3529,0
2020-06-28,Russia,NA,Perm Krai,2623122,52,0,3581,0
2020-06-29,Russia,NA,Perm Krai,2623122,56,0,3637,0
2020-06-30,Russia,NA,Perm Krai,2623122,54,0,3691,0
2020-07-01,Russia,NA,Perm Krai,2623122,52,0,3743,0
2020-07-02,Russia,NA,Perm Krai,2623122,58,0,3801,0
2020-07-03,Russia,NA,Perm Krai,2623122,56,0,3857,0
2020-07-04,Russia,NA,Perm Krai,2623122,54,0,3911,0
2020-07-05,Russia,NA,Perm Krai,2623122,53,0,3964,0
2020-07-06,Russia,NA,Perm Krai,2623122,53,0,4017,0
2020-07-07,Russia,NA,Perm Krai,2623122,52,0,4069,0
2020-07-08,Russia,NA,Perm Krai,2623122,86,0,4155,0
2020-07-09,Russia,NA,Perm Krai,2623122,70,0,4225,0
2020-07-10,Russia,NA,Perm Krai,2623122,57,0,4282,0
2020-07-11,Russia,NA,Perm Krai,2623122,60,0,4342,0
2020-07-12,Russia,NA,Perm Krai,2623122,61,0,4403,0
2020-07-13,Russia,NA,Perm Krai,2623122,71,0,4474,0
2020-07-14,Russia,NA,Perm Krai,2623122,69,0,4543,0
2020-07-15,Russia,NA,Perm Krai,2623122,75,0,4618,0
2020-07-16,Russia,NA,Perm Krai,2623122,87,0,4705,0
2020-07-17,Russia,NA,Perm Krai,2623122,98,0,4803,0
2020-07-18,Russia,NA,Perm Krai,2623122,90,0,4893,0
2020-07-19,Russia,NA,Perm Krai,2623122,89,0,4982,0
2020-07-20,Russia,NA,Perm Krai,2623122,87,0,5069,0
2020-07-21,Russia,NA,Perm Krai,2623122,73,0,5142,0
2020-07-22,Russia,NA,Perm Krai,2623122,69,0,5211,0
2020-07-23,Russia,NA,Perm Krai,2623122,72,0,5283,0
2020-07-24,Russia,NA,Perm Krai,2623122,71,0,5354,0
2020-07-25,Russia,NA,Perm Krai,2623122,75,0,5429,0
2020-07-26,Russia,NA,Perm Krai,2623122,73,0,5502,0
2020-07-27,Russia,NA,Perm Krai,2623122,76,0,5578,0
2020-07-28,Russia,NA,Perm Krai,2623122,73,0,5651,0
2020-07-29,Russia,NA,Perm Krai,2623122,71,0,5722,0
2020-07-30,Russia,NA,Perm Krai,2623122,72,0,5794,0
2020-07-31,Russia,NA,Perm Krai,2623122,70,0,5864,0
2020-08-01,Russia,NA,Perm Krai,2623122,69,0,5933,0
2020-08-02,Russia,NA,Perm Krai,2623122,85,0,6018,0
2020-08-26,Russia,NA,Perm Krai,2623122,0,0,7580,203
2020-08-27,Russia,NA,Perm Krai,2623122,58,3,7638,206
2020-08-28,Russia,NA,Perm Krai,2623122,59,3,7697,209
2020-08-29,Russia,NA,Perm Krai,2623122,56,2,7753,211
2020-08-30,Russia,NA,Perm Krai,2623122,58,2,7811,213
2020-08-31,Russia,NA,Perm Krai,2623122,55,2,7866,215
2020-09-01,Russia,NA,Perm Krai,2623122,57,0,7923,215
2020-09-02,Russia,NA,Perm Krai,2623122,60,0,7983,215
2020-09-03,Russia,NA,Perm Krai,2623122,59,0,8042,215
2020-09-04,Russia,NA,Perm Krai,2623122,60,2,8102,217
2020-09-05,Russia,NA,Perm Krai,2623122,58,3,8160,220
2020-09-06,Russia,NA,Perm Krai,2623122,59,1,8219,221
2020-09-07,Russia,NA,Perm Krai,2623122,56,0,8275,221
2020-09-08,Russia,NA,Perm Krai,2623122,60,3,8335,224
2020-09-09,Russia,NA,Perm Krai,2623122,59,3,8394,227
2020-09-10,Russia,NA,Perm Krai,2623122,60,3,8454,230
2020-09-11,Russia,NA,Perm Krai,2623122,57,2,8511,232
2020-09-12,Russia,NA,Perm Krai,2623122,59,2,8570,234
2020-09-13,Russia,NA,Perm Krai,2623122,57,2,8627,236
2020-09-14,Russia,NA,Perm Krai,2623122,58,2,8685,238
2020-09-15,Russia,NA,Perm Krai,2623122,61,2,8746,240
2020-09-16,Russia,NA,Perm Krai,2623122,64,2,8810,242
2020-09-17,Russia,NA,Perm Krai,2623122,67,2,8877,244
2020-09-18,Russia,NA,Perm Krai,2623122,67,2,8944,246
2020-09-19,Russia,NA,Perm Krai,2623122,68,2,9012,248
2020-09-20,Russia,NA,Perm Krai,2623122,71,2,9083,250
2020-09-21,Russia,NA,Perm Krai,2623122,70,3,9153,253
2020-09-22,Russia,NA,Perm Krai,2623122,72,2,9225,255
2020-09-23,Russia,NA,Perm Krai,2623122,74,3,9299,258
2020-04-08,Russia,NA,Primorsky Krai,1913037,7,0,15,0
2020-04-09,Russia,NA,Primorsky Krai,1913037,5,0,20,0
2020-04-11,Russia,NA,Primorsky Krai,1913037,3,0,23,0
2020-04-12,Russia,NA,Primorsky Krai,1913037,1,0,24,0
2020-04-13,Russia,NA,Primorsky Krai,1913037,4,0,28,0
2020-04-14,Russia,NA,Primorsky Krai,1913037,4,0,32,0
2020-04-15,Russia,NA,Primorsky Krai,1913037,4,0,36,0
2020-04-16,Russia,NA,Primorsky Krai,1913037,4,0,40,0
2020-04-17,Russia,NA,Primorsky Krai,1913037,9,0,49,0
2020-04-18,Russia,NA,Primorsky Krai,1913037,18,0,67,0
2020-04-19,Russia,NA,Primorsky Krai,1913037,13,0,80,0
2020-04-20,Russia,NA,Primorsky Krai,1913037,17,0,97,0
2020-04-21,Russia,NA,Primorsky Krai,1913037,7,0,104,0
2020-04-22,Russia,NA,Primorsky Krai,1913037,62,0,166,0
2020-04-23,Russia,NA,Primorsky Krai,1913037,19,0,185,0
2020-04-24,Russia,NA,Primorsky Krai,1913037,35,0,220,0
2020-04-25,Russia,NA,Primorsky Krai,1913037,34,0,254,0
2020-04-26,Russia,NA,Primorsky Krai,1913037,24,0,278,0
2020-04-27,Russia,NA,Primorsky Krai,1913037,24,0,302,0
2020-04-28,Russia,NA,Primorsky Krai,1913037,45,0,347,0
2020-04-29,Russia,NA,Primorsky Krai,1913037,20,0,367,0
2020-04-30,Russia,NA,Primorsky Krai,1913037,36,0,403,0
2020-05-01,Russia,NA,Primorsky Krai,1913037,27,0,430,0
2020-05-02,Russia,NA,Primorsky Krai,1913037,25,0,455,0
2020-05-03,Russia,NA,Primorsky Krai,1913037,39,0,494,0
2020-05-04,Russia,NA,Primorsky Krai,1913037,53,0,547,0
2020-05-05,Russia,NA,Primorsky Krai,1913037,88,0,635,0
2020-05-06,Russia,NA,Primorsky Krai,1913037,49,0,684,0
2020-05-07,Russia,NA,Primorsky Krai,1913037,43,0,727,0
2020-05-08,Russia,NA,Primorsky Krai,1913037,36,0,763,0
2020-05-09,Russia,NA,Primorsky Krai,1913037,45,0,808,0
2020-05-10,Russia,NA,Primorsky Krai,1913037,48,0,856,0
2020-05-11,Russia,NA,Primorsky Krai,1913037,51,0,907,0
2020-05-12,Russia,NA,Primorsky Krai,1913037,48,0,955,0
2020-05-13,Russia,NA,Primorsky Krai,1913037,53,0,1008,0
2020-05-14,Russia,NA,Primorsky Krai,1913037,49,0,1057,0
2020-05-15,Russia,NA,Primorsky Krai,1913037,53,0,1110,0
2020-05-16,Russia,NA,Primorsky Krai,1913037,87,0,1197,0
2020-05-17,Russia,NA,Primorsky Krai,1913037,71,0,1268,0
2020-05-18,Russia,NA,Primorsky Krai,1913037,71,0,1339,0
2020-05-19,Russia,NA,Primorsky Krai,1913037,63,0,1402,0
2020-05-20,Russia,NA,Primorsky Krai,1913037,44,0,1446,0
2020-05-21,Russia,NA,Primorsky Krai,1913037,49,0,1495,0
2020-05-22,Russia,NA,Primorsky Krai,1913037,47,0,1542,0
2020-05-23,Russia,NA,Primorsky Krai,1913037,53,0,1595,0
2020-05-24,Russia,NA,Primorsky Krai,1913037,51,0,1646,0
2020-05-25,Russia,NA,Primorsky Krai,1913037,49,0,1695,0
2020-05-26,Russia,NA,Primorsky Krai,1913037,40,0,1735,0
2020-05-27,Russia,NA,Primorsky Krai,1913037,44,0,1779,0
2020-05-28,Russia,NA,Primorsky Krai,1913037,57,0,1836,0
2020-05-29,Russia,NA,Primorsky Krai,1913037,57,0,1893,0
2020-05-30,Russia,NA,Primorsky Krai,1913037,50,0,1943,0
2020-05-31,Russia,NA,Primorsky Krai,1913037,52,0,1995,0
2020-06-01,Russia,NA,Primorsky Krai,1913037,54,0,2049,0
2020-06-02,Russia,NA,Primorsky Krai,1913037,54,0,2103,0
2020-06-03,Russia,NA,Primorsky Krai,1913037,52,0,2155,0
2020-06-04,Russia,NA,Primorsky Krai,1913037,56,0,2211,0
2020-06-05,Russia,NA,Primorsky Krai,1913037,51,0,2262,0
2020-06-06,Russia,NA,Primorsky Krai,1913037,51,0,2313,0
2020-06-07,Russia,NA,Primorsky Krai,1913037,62,0,2375,0
2020-06-08,Russia,NA,Primorsky Krai,1913037,67,0,2442,0
2020-06-09,Russia,NA,Primorsky Krai,1913037,58,0,2500,0
2020-06-10,Russia,NA,Primorsky Krai,1913037,52,0,2552,0
2020-06-11,Russia,NA,Primorsky Krai,1913037,57,0,2609,0
2020-06-12,Russia,NA,Primorsky Krai,1913037,93,0,2702,0
2020-06-13,Russia,NA,Primorsky Krai,1913037,85,0,2787,0
2020-06-14,Russia,NA,Primorsky Krai,1913037,99,0,2886,0
2020-06-15,Russia,NA,Primorsky Krai,1913037,91,0,2977,0
2020-06-16,Russia,NA,Primorsky Krai,1913037,88,0,3065,0
2020-06-17,Russia,NA,Primorsky Krai,1913037,104,0,3169,0
2020-06-18,Russia,NA,Primorsky Krai,1913037,101,0,3270,0
2020-06-19,Russia,NA,Primorsky Krai,1913037,103,0,3373,0
2020-06-20,Russia,NA,Primorsky Krai,1913037,91,0,3464,0
2020-06-21,Russia,NA,Primorsky Krai,1913037,89,0,3553,0
2020-06-22,Russia,NA,Primorsky Krai,1913037,90,0,3643,0
2020-06-23,Russia,NA,Primorsky Krai,1913037,85,0,3728,0
2020-06-24,Russia,NA,Primorsky Krai,1913037,83,0,3811,0
2020-06-25,Russia,NA,Primorsky Krai,1913037,84,0,3895,0
2020-06-26,Russia,NA,Primorsky Krai,1913037,85,0,3980,0
2020-06-27,Russia,NA,Primorsky Krai,1913037,83,0,4063,0
2020-06-28,Russia,NA,Primorsky Krai,1913037,81,0,4144,0
2020-06-29,Russia,NA,Primorsky Krai,1913037,82,0,4226,0
2020-06-30,Russia,NA,Primorsky Krai,1913037,80,0,4306,0
2020-07-01,Russia,NA,Primorsky Krai,1913037,77,0,4383,0
2020-07-02,Russia,NA,Primorsky Krai,1913037,75,0,4458,0
2020-07-03,Russia,NA,Primorsky Krai,1913037,75,0,4533,0
2020-07-04,Russia,NA,Primorsky Krai,1913037,69,0,4602,0
2020-07-05,Russia,NA,Primorsky Krai,1913037,65,0,4667,0
2020-07-06,Russia,NA,Primorsky Krai,1913037,65,0,4732,0
2020-07-07,Russia,NA,Primorsky Krai,1913037,60,0,4792,0
2020-07-08,Russia,NA,Primorsky Krai,1913037,57,0,4849,0
2020-07-09,Russia,NA,Primorsky Krai,1913037,55,0,4904,0
2020-07-10,Russia,NA,Primorsky Krai,1913037,55,0,4959,0
2020-07-11,Russia,NA,Primorsky Krai,1913037,51,0,5010,0
2020-07-12,Russia,NA,Primorsky Krai,1913037,54,0,5064,0
2020-07-13,Russia,NA,Primorsky Krai,1913037,54,0,5118,0
2020-07-14,Russia,NA,Primorsky Krai,1913037,56,0,5174,0
2020-07-15,Russia,NA,Primorsky Krai,1913037,62,0,5236,0
2020-07-16,Russia,NA,Primorsky Krai,1913037,69,0,5305,0
2020-07-17,Russia,NA,Primorsky Krai,1913037,75,0,5380,0
2020-07-18,Russia,NA,Primorsky Krai,1913037,80,0,5460,0
2020-07-19,Russia,NA,Primorsky Krai,1913037,88,0,5548,0
2020-07-20,Russia,NA,Primorsky Krai,1913037,92,0,5640,0
2020-07-21,Russia,NA,Primorsky Krai,1913037,94,0,5734,0
2020-07-22,Russia,NA,Primorsky Krai,1913037,104,0,5838,0
2020-07-23,Russia,NA,Primorsky Krai,1913037,110,0,5948,0
2020-07-24,Russia,NA,Primorsky Krai,1913037,112,0,6060,0
2020-07-25,Russia,NA,Primorsky Krai,1913037,110,0,6170,0
2020-07-26,Russia,NA,Primorsky Krai,1913037,111,0,6281,0
2020-07-27,Russia,NA,Primorsky Krai,1913037,109,0,6390,0
2020-07-28,Russia,NA,Primorsky Krai,1913037,110,0,6500,0
2020-07-29,Russia,NA,Primorsky Krai,1913037,108,0,6608,0
2020-07-30,Russia,NA,Primorsky Krai,1913037,104,0,6712,0
2020-07-31,Russia,NA,Primorsky Krai,1913037,104,0,6816,0
2020-08-01,Russia,NA,Primorsky Krai,1913037,102,0,6918,0
2020-08-02,Russia,NA,Primorsky Krai,1913037,101,0,7019,0
2020-08-26,Russia,NA,Primorsky Krai,1913037,0,0,9202,101
2020-08-27,Russia,NA,Primorsky Krai,1913037,82,0,9284,101
2020-08-28,Russia,NA,Primorsky Krai,1913037,80,0,9364,101
2020-08-29,Russia,NA,Primorsky Krai,1913037,78,2,9442,103
2020-08-30,Russia,NA,Primorsky Krai,1913037,82,0,9524,103
2020-08-31,Russia,NA,Primorsky Krai,1913037,79,0,9603,103
2020-09-01,Russia,NA,Primorsky Krai,1913037,78,1,9681,104
2020-09-02,Russia,NA,Primorsky Krai,1913037,78,1,9759,105
2020-09-03,Russia,NA,Primorsky Krai,1913037,77,0,9836,105
2020-09-04,Russia,NA,Primorsky Krai,1913037,74,2,9910,107
2020-09-05,Russia,NA,Primorsky Krai,1913037,78,0,9988,107
2020-09-06,Russia,NA,Primorsky Krai,1913037,76,0,10064,107
2020-09-07,Russia,NA,Primorsky Krai,1913037,73,0,10137,107
2020-09-08,Russia,NA,Primorsky Krai,1913037,75,1,10212,108
2020-09-09,Russia,NA,Primorsky Krai,1913037,72,1,10284,109
2020-09-10,Russia,NA,Primorsky Krai,1913037,70,0,10354,109
2020-09-11,Russia,NA,Primorsky Krai,1913037,68,0,10422,109
2020-09-12,Russia,NA,Primorsky Krai,1913037,71,0,10493,109
2020-09-13,Russia,NA,Primorsky Krai,1913037,71,0,10564,109
2020-09-14,Russia,NA,Primorsky Krai,1913037,69,0,10633,109
2020-09-15,Russia,NA,Primorsky Krai,1913037,68,1,10701,110
2020-09-16,Russia,NA,Primorsky Krai,1913037,70,1,10771,111
2020-09-17,Russia,NA,Primorsky Krai,1913037,68,1,10839,112
2020-09-18,Russia,NA,Primorsky Krai,1913037,71,0,10910,112
2020-09-19,Russia,NA,Primorsky Krai,1913037,75,1,10985,113
2020-09-20,Russia,NA,Primorsky Krai,1913037,70,0,11055,113
2020-09-21,Russia,NA,Primorsky Krai,1913037,71,2,11126,115
2020-09-22,Russia,NA,Primorsky Krai,1913037,68,0,11194,115
2020-09-23,Russia,NA,Primorsky Krai,1913037,68,0,11262,115
2020-04-07,Russia,NA,Pskov Oblast,636546,4,0,14,0
2020-04-09,Russia,NA,Pskov Oblast,636546,2,0,16,0
2020-04-13,Russia,NA,Pskov Oblast,636546,5,0,21,0
2020-04-15,Russia,NA,Pskov Oblast,636546,6,0,27,0
2020-04-16,Russia,NA,Pskov Oblast,636546,5,0,32,0
2020-04-17,Russia,NA,Pskov Oblast,636546,5,0,37,0
2020-04-18,Russia,NA,Pskov Oblast,636546,5,0,42,0
2020-04-19,Russia,NA,Pskov Oblast,636546,2,0,44,0
2020-04-20,Russia,NA,Pskov Oblast,636546,8,0,52,0
2020-04-21,Russia,NA,Pskov Oblast,636546,6,0,58,0
2020-04-22,Russia,NA,Pskov Oblast,636546,4,0,62,0
2020-04-23,Russia,NA,Pskov Oblast,636546,4,0,66,0
2020-04-24,Russia,NA,Pskov Oblast,636546,15,0,81,0
2020-04-25,Russia,NA,Pskov Oblast,636546,12,0,93,0
2020-04-26,Russia,NA,Pskov Oblast,636546,17,0,110,0
2020-04-27,Russia,NA,Pskov Oblast,636546,14,0,124,0
2020-04-28,Russia,NA,Pskov Oblast,636546,4,0,128,0
2020-04-29,Russia,NA,Pskov Oblast,636546,14,0,142,0
2020-04-30,Russia,NA,Pskov Oblast,636546,7,0,149,0
2020-05-01,Russia,NA,Pskov Oblast,636546,4,0,153,0
2020-05-02,Russia,NA,Pskov Oblast,636546,24,0,177,0
2020-05-03,Russia,NA,Pskov Oblast,636546,18,0,195,0
2020-05-04,Russia,NA,Pskov Oblast,636546,1,0,196,0
2020-05-05,Russia,NA,Pskov Oblast,636546,18,0,214,0
2020-05-06,Russia,NA,Pskov Oblast,636546,12,0,226,0
2020-05-07,Russia,NA,Pskov Oblast,636546,17,0,243,0
2020-05-08,Russia,NA,Pskov Oblast,636546,27,0,270,0
2020-05-09,Russia,NA,Pskov Oblast,636546,7,0,277,0
2020-05-10,Russia,NA,Pskov Oblast,636546,16,0,293,0
2020-05-11,Russia,NA,Pskov Oblast,636546,15,0,308,0
2020-05-12,Russia,NA,Pskov Oblast,636546,20,0,328,0
2020-05-13,Russia,NA,Pskov Oblast,636546,11,0,339,0
2020-05-14,Russia,NA,Pskov Oblast,636546,12,0,351,0
2020-05-15,Russia,NA,Pskov Oblast,636546,16,0,367,0
2020-05-16,Russia,NA,Pskov Oblast,636546,19,0,386,0
2020-05-17,Russia,NA,Pskov Oblast,636546,19,0,405,0
2020-05-18,Russia,NA,Pskov Oblast,636546,19,0,424,0
2020-05-19,Russia,NA,Pskov Oblast,636546,27,0,451,0
2020-05-20,Russia,NA,Pskov Oblast,636546,10,0,461,0
2020-05-21,Russia,NA,Pskov Oblast,636546,33,0,494,0
2020-05-22,Russia,NA,Pskov Oblast,636546,19,0,513,0
2020-05-23,Russia,NA,Pskov Oblast,636546,30,0,543,0
2020-05-24,Russia,NA,Pskov Oblast,636546,23,0,566,0
2020-05-25,Russia,NA,Pskov Oblast,636546,26,0,592,0
2020-05-26,Russia,NA,Pskov Oblast,636546,16,0,608,0
2020-05-27,Russia,NA,Pskov Oblast,636546,21,0,629,0
2020-05-28,Russia,NA,Pskov Oblast,636546,42,0,671,0
2020-05-29,Russia,NA,Pskov Oblast,636546,52,0,723,0
2020-05-30,Russia,NA,Pskov Oblast,636546,42,0,765,0
2020-05-31,Russia,NA,Pskov Oblast,636546,59,0,824,0
2020-06-01,Russia,NA,Pskov Oblast,636546,63,0,887,0
2020-06-02,Russia,NA,Pskov Oblast,636546,23,0,910,0
2020-06-03,Russia,NA,Pskov Oblast,636546,44,0,954,0
2020-06-04,Russia,NA,Pskov Oblast,636546,112,0,1066,0
2020-06-05,Russia,NA,Pskov Oblast,636546,65,0,1131,0
2020-06-06,Russia,NA,Pskov Oblast,636546,32,0,1163,0
2020-06-07,Russia,NA,Pskov Oblast,636546,69,0,1232,0
2020-06-08,Russia,NA,Pskov Oblast,636546,37,0,1269,0
2020-06-09,Russia,NA,Pskov Oblast,636546,37,0,1306,0
2020-06-10,Russia,NA,Pskov Oblast,636546,60,0,1366,0
2020-06-11,Russia,NA,Pskov Oblast,636546,59,0,1425,0
2020-06-12,Russia,NA,Pskov Oblast,636546,110,0,1535,0
2020-06-13,Russia,NA,Pskov Oblast,636546,100,0,1635,0
2020-06-14,Russia,NA,Pskov Oblast,636546,105,0,1740,0
2020-06-15,Russia,NA,Pskov Oblast,636546,98,0,1838,0
2020-06-16,Russia,NA,Pskov Oblast,636546,63,0,1901,0
2020-06-17,Russia,NA,Pskov Oblast,636546,95,0,1996,0
2020-06-18,Russia,NA,Pskov Oblast,636546,51,0,2047,0
2020-06-19,Russia,NA,Pskov Oblast,636546,41,0,2088,0
2020-06-20,Russia,NA,Pskov Oblast,636546,95,0,2183,0
2020-06-21,Russia,NA,Pskov Oblast,636546,95,0,2278,0
2020-06-22,Russia,NA,Pskov Oblast,636546,75,0,2353,0
2020-06-23,Russia,NA,Pskov Oblast,636546,61,0,2414,0
2020-06-24,Russia,NA,Pskov Oblast,636546,44,0,2458,0
2020-06-25,Russia,NA,Pskov Oblast,636546,69,0,2527,0
2020-06-26,Russia,NA,Pskov Oblast,636546,37,0,2564,0
2020-06-27,Russia,NA,Pskov Oblast,636546,45,0,2609,0
2020-06-28,Russia,NA,Pskov Oblast,636546,58,0,2667,0
2020-06-29,Russia,NA,Pskov Oblast,636546,55,0,2722,0
2020-06-30,Russia,NA,Pskov Oblast,636546,35,0,2757,0
2020-07-01,Russia,NA,Pskov Oblast,636546,73,0,2830,0
2020-07-02,Russia,NA,Pskov Oblast,636546,45,0,2875,0
2020-07-03,Russia,NA,Pskov Oblast,636546,57,0,2932,0
2020-07-04,Russia,NA,Pskov Oblast,636546,35,0,2967,0
2020-07-05,Russia,NA,Pskov Oblast,636546,51,0,3018,0
2020-07-06,Russia,NA,Pskov Oblast,636546,26,0,3044,0
2020-07-07,Russia,NA,Pskov Oblast,636546,38,0,3082,0
2020-07-08,Russia,NA,Pskov Oblast,636546,27,0,3109,0
2020-07-09,Russia,NA,Pskov Oblast,636546,28,0,3137,0
2020-07-10,Russia,NA,Pskov Oblast,636546,35,0,3172,0
2020-07-11,Russia,NA,Pskov Oblast,636546,26,0,3198,0
2020-07-12,Russia,NA,Pskov Oblast,636546,16,0,3214,0
2020-07-13,Russia,NA,Pskov Oblast,636546,31,0,3245,0
2020-07-14,Russia,NA,Pskov Oblast,636546,12,0,3257,0
2020-07-15,Russia,NA,Pskov Oblast,636546,34,0,3291,0
2020-07-16,Russia,NA,Pskov Oblast,636546,36,0,3327,0
2020-07-17,Russia,NA,Pskov Oblast,636546,27,0,3354,0
2020-07-18,Russia,NA,Pskov Oblast,636546,18,0,3372,0
2020-07-19,Russia,NA,Pskov Oblast,636546,30,0,3402,0
2020-07-20,Russia,NA,Pskov Oblast,636546,19,0,3421,0
2020-07-21,Russia,NA,Pskov Oblast,636546,16,0,3437,0
2020-07-22,Russia,NA,Pskov Oblast,636546,17,0,3454,0
2020-07-23,Russia,NA,Pskov Oblast,636546,32,0,3486,0
2020-07-24,Russia,NA,Pskov Oblast,636546,48,0,3534,0
2020-07-25,Russia,NA,Pskov Oblast,636546,20,0,3554,0
2020-07-26,Russia,NA,Pskov Oblast,636546,28,0,3582,0
2020-07-27,Russia,NA,Pskov Oblast,636546,36,0,3618,0
2020-07-28,Russia,NA,Pskov Oblast,636546,15,0,3633,0
2020-07-29,Russia,NA,Pskov Oblast,636546,13,0,3646,0
2020-07-30,Russia,NA,Pskov Oblast,636546,40,0,3686,0
2020-07-31,Russia,NA,Pskov Oblast,636546,42,0,3728,0
2020-08-01,Russia,NA,Pskov Oblast,636546,33,0,3761,0
2020-08-02,Russia,NA,Pskov Oblast,636546,36,0,3797,0
2020-08-26,Russia,NA,Pskov Oblast,636546,0,0,4499,61
2020-08-27,Russia,NA,Pskov Oblast,636546,28,1,4527,62
2020-08-28,Russia,NA,Pskov Oblast,636546,30,0,4557,62
2020-08-29,Russia,NA,Pskov Oblast,636546,24,0,4581,62
2020-08-30,Russia,NA,Pskov Oblast,636546,22,3,4603,65
2020-08-31,Russia,NA,Pskov Oblast,636546,32,0,4635,65
2020-09-01,Russia,NA,Pskov Oblast,636546,3,0,4638,65
2020-09-02,Russia,NA,Pskov Oblast,636546,24,0,4662,65
2020-09-03,Russia,NA,Pskov Oblast,636546,23,0,4685,65
2020-09-04,Russia,NA,Pskov Oblast,636546,26,0,4711,65
2020-09-05,Russia,NA,Pskov Oblast,636546,34,0,4745,65
2020-09-06,Russia,NA,Pskov Oblast,636546,21,0,4766,65
2020-09-07,Russia,NA,Pskov Oblast,636546,25,0,4791,65
2020-09-08,Russia,NA,Pskov Oblast,636546,21,0,4812,65
2020-09-09,Russia,NA,Pskov Oblast,636546,20,0,4832,65
2020-09-10,Russia,NA,Pskov Oblast,636546,27,0,4859,65
2020-09-11,Russia,NA,Pskov Oblast,636546,18,0,4877,65
2020-09-12,Russia,NA,Pskov Oblast,636546,38,0,4915,65
2020-09-13,Russia,NA,Pskov Oblast,636546,32,0,4947,65
2020-09-14,Russia,NA,Pskov Oblast,636546,21,0,4968,65
2020-09-15,Russia,NA,Pskov Oblast,636546,14,0,4982,65
2020-09-16,Russia,NA,Pskov Oblast,636546,19,0,5001,65
2020-09-17,Russia,NA,Pskov Oblast,636546,29,0,5030,65
2020-09-18,Russia,NA,Pskov Oblast,636546,27,0,5057,65
2020-09-19,Russia,NA,Pskov Oblast,636546,34,0,5091,65
2020-09-20,Russia,NA,Pskov Oblast,636546,42,0,5133,65
2020-09-21,Russia,NA,Pskov Oblast,636546,39,0,5172,65
2020-09-22,Russia,NA,Pskov Oblast,636546,24,0,5196,65
2020-09-23,Russia,NA,Pskov Oblast,636546,23,0,5219,65
2020-03-27,Russia,NA,Republic of Crimea,1957801,7,0,14,0
2020-03-28,Russia,NA,Republic of Crimea,1957801,1,0,15,0
2020-03-31,Russia,NA,Republic of Crimea,1957801,1,0,16,0
2020-04-03,Russia,NA,Republic of Crimea,1957801,2,0,18,0
2020-04-05,Russia,NA,Republic of Crimea,1957801,2,0,20,0
2020-04-06,Russia,NA,Republic of Crimea,1957801,1,0,21,0
2020-04-07,Russia,NA,Republic of Crimea,1957801,1,0,22,0
2020-04-08,Russia,NA,Republic of Crimea,1957801,1,0,23,0
2020-04-09,Russia,NA,Republic of Crimea,1957801,3,0,26,0
2020-04-10,Russia,NA,Republic of Crimea,1957801,3,0,29,0
2020-04-12,Russia,NA,Republic of Crimea,1957801,2,0,31,0
2020-04-13,Russia,NA,Republic of Crimea,1957801,1,0,32,0
2020-04-15,Russia,NA,Republic of Crimea,1957801,2,0,34,0
2020-04-16,Russia,NA,Republic of Crimea,1957801,3,0,37,0
2020-04-17,Russia,NA,Republic of Crimea,1957801,3,0,40,0
2020-04-18,Russia,NA,Republic of Crimea,1957801,3,0,43,0
2020-04-19,Russia,NA,Republic of Crimea,1957801,2,0,45,0
2020-04-21,Russia,NA,Republic of Crimea,1957801,1,0,46,0
2020-04-23,Russia,NA,Republic of Crimea,1957801,5,0,51,0
2020-04-24,Russia,NA,Republic of Crimea,1957801,2,0,53,0
2020-04-25,Russia,NA,Republic of Crimea,1957801,4,0,57,0
2020-04-26,Russia,NA,Republic of Crimea,1957801,10,0,67,0
2020-04-27,Russia,NA,Republic of Crimea,1957801,2,0,69,0
2020-04-28,Russia,NA,Republic of Crimea,1957801,1,0,70,0
2020-04-29,Russia,NA,Republic of Crimea,1957801,9,0,79,0
2020-04-30,Russia,NA,Republic of Crimea,1957801,10,0,89,0
2020-05-01,Russia,NA,Republic of Crimea,1957801,3,0,92,0
2020-05-02,Russia,NA,Republic of Crimea,1957801,8,0,100,0
2020-05-03,Russia,NA,Republic of Crimea,1957801,4,0,104,0
2020-05-04,Russia,NA,Republic of Crimea,1957801,1,0,105,0
2020-05-05,Russia,NA,Republic of Crimea,1957801,6,0,111,0
2020-05-06,Russia,NA,Republic of Crimea,1957801,17,0,128,0
2020-05-07,Russia,NA,Republic of Crimea,1957801,32,0,160,0
2020-05-08,Russia,NA,Republic of Crimea,1957801,8,0,168,0
2020-05-09,Russia,NA,Republic of Crimea,1957801,9,0,177,0
2020-05-10,Russia,NA,Republic of Crimea,1957801,12,0,189,0
2020-05-11,Russia,NA,Republic of Crimea,1957801,4,0,193,0
2020-05-12,Russia,NA,Republic of Crimea,1957801,9,0,202,0
2020-05-13,Russia,NA,Republic of Crimea,1957801,7,0,209,0
2020-05-14,Russia,NA,Republic of Crimea,1957801,30,0,239,0
2020-05-15,Russia,NA,Republic of Crimea,1957801,6,0,245,0
2020-05-16,Russia,NA,Republic of Crimea,1957801,13,0,258,0
2020-05-17,Russia,NA,Republic of Crimea,1957801,14,0,272,0
2020-05-18,Russia,NA,Republic of Crimea,1957801,9,0,281,0
2020-05-19,Russia,NA,Republic of Crimea,1957801,13,0,294,0
2020-05-20,Russia,NA,Republic of Crimea,1957801,4,0,298,0
2020-05-21,Russia,NA,Republic of Crimea,1957801,1,0,299,0
2020-05-22,Russia,NA,Republic of Crimea,1957801,15,0,314,0
2020-05-23,Russia,NA,Republic of Crimea,1957801,10,0,324,0
2020-05-24,Russia,NA,Republic of Crimea,1957801,2,0,326,0
2020-05-25,Russia,NA,Republic of Crimea,1957801,14,0,340,0
2020-05-26,Russia,NA,Republic of Crimea,1957801,6,0,346,0
2020-05-27,Russia,NA,Republic of Crimea,1957801,3,0,349,0
2020-05-28,Russia,NA,Republic of Crimea,1957801,6,0,355,0
2020-05-29,Russia,NA,Republic of Crimea,1957801,6,0,361,0
2020-05-30,Russia,NA,Republic of Crimea,1957801,8,0,369,0
2020-05-31,Russia,NA,Republic of Crimea,1957801,6,0,375,0
2020-06-01,Russia,NA,Republic of Crimea,1957801,10,0,385,0
2020-06-02,Russia,NA,Republic of Crimea,1957801,2,0,387,0
2020-06-03,Russia,NA,Republic of Crimea,1957801,5,0,392,0
2020-06-04,Russia,NA,Republic of Crimea,1957801,7,0,399,0
2020-06-05,Russia,NA,Republic of Crimea,1957801,6,0,405,0
2020-06-06,Russia,NA,Republic of Crimea,1957801,8,0,413,0
2020-06-07,Russia,NA,Republic of Crimea,1957801,11,0,424,0
2020-06-08,Russia,NA,Republic of Crimea,1957801,14,0,438,0
2020-06-09,Russia,NA,Republic of Crimea,1957801,8,0,446,0
2020-06-10,Russia,NA,Republic of Crimea,1957801,11,0,457,0
2020-06-11,Russia,NA,Republic of Crimea,1957801,1,0,458,0
2020-06-12,Russia,NA,Republic of Crimea,1957801,25,0,483,0
2020-06-13,Russia,NA,Republic of Crimea,1957801,7,0,490,0
2020-06-14,Russia,NA,Republic of Crimea,1957801,22,0,512,0
2020-06-15,Russia,NA,Republic of Crimea,1957801,27,0,539,0
2020-06-16,Russia,NA,Republic of Crimea,1957801,7,0,546,0
2020-06-17,Russia,NA,Republic of Crimea,1957801,15,0,561,0
2020-06-18,Russia,NA,Republic of Crimea,1957801,14,0,575,0
2020-06-20,Russia,NA,Republic of Crimea,1957801,15,0,590,0
2020-06-21,Russia,NA,Republic of Crimea,1957801,5,0,595,0
2020-06-22,Russia,NA,Republic of Crimea,1957801,13,0,608,0
2020-06-23,Russia,NA,Republic of Crimea,1957801,5,0,613,0
2020-06-24,Russia,NA,Republic of Crimea,1957801,10,0,623,0
2020-06-25,Russia,NA,Republic of Crimea,1957801,8,0,631,0
2020-06-26,Russia,NA,Republic of Crimea,1957801,7,0,638,0
2020-06-27,Russia,NA,Republic of Crimea,1957801,6,0,644,0
2020-06-28,Russia,NA,Republic of Crimea,1957801,2,0,646,0
2020-06-29,Russia,NA,Republic of Crimea,1957801,35,0,681,0
2020-06-30,Russia,NA,Republic of Crimea,1957801,4,0,685,0
2020-07-01,Russia,NA,Republic of Crimea,1957801,6,0,691,0
2020-07-02,Russia,NA,Republic of Crimea,1957801,7,0,698,0
2020-07-03,Russia,NA,Republic of Crimea,1957801,8,0,706,0
2020-07-04,Russia,NA,Republic of Crimea,1957801,6,0,712,0
2020-07-05,Russia,NA,Republic of Crimea,1957801,11,0,723,0
2020-07-06,Russia,NA,Republic of Crimea,1957801,38,0,761,0
2020-07-08,Russia,NA,Republic of Crimea,1957801,28,0,789,0
2020-07-09,Russia,NA,Republic of Crimea,1957801,15,0,804,0
2020-07-10,Russia,NA,Republic of Crimea,1957801,11,0,815,0
2020-07-11,Russia,NA,Republic of Crimea,1957801,16,0,831,0
2020-07-12,Russia,NA,Republic of Crimea,1957801,24,0,855,0
2020-07-13,Russia,NA,Republic of Crimea,1957801,16,0,871,0
2020-07-14,Russia,NA,Republic of Crimea,1957801,7,0,878,0
2020-07-15,Russia,NA,Republic of Crimea,1957801,11,0,889,0
2020-07-16,Russia,NA,Republic of Crimea,1957801,11,0,900,0
2020-07-17,Russia,NA,Republic of Crimea,1957801,17,0,917,0
2020-07-18,Russia,NA,Republic of Crimea,1957801,14,0,931,0
2020-07-19,Russia,NA,Republic of Crimea,1957801,12,0,943,0
2020-07-20,Russia,NA,Republic of Crimea,1957801,26,0,969,0
2020-07-21,Russia,NA,Republic of Crimea,1957801,14,0,983,0
2020-07-22,Russia,NA,Republic of Crimea,1957801,11,0,994,0
2020-07-23,Russia,NA,Republic of Crimea,1957801,18,0,1012,0
2020-07-24,Russia,NA,Republic of Crimea,1957801,26,0,1038,0
2020-07-25,Russia,NA,Republic of Crimea,1957801,18,0,1056,0
2020-07-26,Russia,NA,Republic of Crimea,1957801,21,0,1077,0
2020-07-27,Russia,NA,Republic of Crimea,1957801,27,0,1104,0
2020-07-28,Russia,NA,Republic of Crimea,1957801,12,0,1116,0
2020-07-29,Russia,NA,Republic of Crimea,1957801,23,0,1139,0
2020-07-30,Russia,NA,Republic of Crimea,1957801,24,0,1163,0
2020-07-31,Russia,NA,Republic of Crimea,1957801,13,0,1176,0
2020-08-01,Russia,NA,Republic of Crimea,1957801,28,0,1204,0
2020-08-02,Russia,NA,Republic of Crimea,1957801,37,0,1241,0
2020-04-18,Russia,NA,Republic of Karelia,622484,6,0,15,0
2020-04-19,Russia,NA,Republic of Karelia,622484,4,0,19,0
2020-04-20,Russia,NA,Republic of Karelia,622484,8,0,27,0
2020-04-21,Russia,NA,Republic of Karelia,622484,3,0,30,0
2020-04-23,Russia,NA,Republic of Karelia,622484,5,0,35,0
2020-04-24,Russia,NA,Republic of Karelia,622484,2,0,37,0
2020-04-25,Russia,NA,Republic of Karelia,622484,5,0,42,0
2020-04-26,Russia,NA,Republic of Karelia,622484,2,0,44,0
2020-04-27,Russia,NA,Republic of Karelia,622484,12,0,56,0
2020-04-28,Russia,NA,Republic of Karelia,622484,6,0,62,0
2020-04-29,Russia,NA,Republic of Karelia,622484,1,0,63,0
2020-04-30,Russia,NA,Republic of Karelia,622484,3,0,66,0
2020-05-01,Russia,NA,Republic of Karelia,622484,8,0,74,0
2020-05-02,Russia,NA,Republic of Karelia,622484,7,0,81,0
2020-05-03,Russia,NA,Republic of Karelia,622484,4,0,85,0
2020-05-04,Russia,NA,Republic of Karelia,622484,4,0,89,0
2020-05-05,Russia,NA,Republic of Karelia,622484,2,0,91,0
2020-05-06,Russia,NA,Republic of Karelia,622484,12,0,103,0
2020-05-07,Russia,NA,Republic of Karelia,622484,9,0,112,0
2020-05-08,Russia,NA,Republic of Karelia,622484,13,0,125,0
2020-05-09,Russia,NA,Republic of Karelia,622484,3,0,128,0
2020-05-10,Russia,NA,Republic of Karelia,622484,20,0,148,0
2020-05-11,Russia,NA,Republic of Karelia,622484,12,0,160,0
2020-05-12,Russia,NA,Republic of Karelia,622484,11,0,171,0
2020-05-13,Russia,NA,Republic of Karelia,622484,5,0,176,0
2020-05-14,Russia,NA,Republic of Karelia,622484,12,0,188,0
2020-05-15,Russia,NA,Republic of Karelia,622484,6,0,194,0
2020-05-16,Russia,NA,Republic of Karelia,622484,8,0,202,0
2020-05-17,Russia,NA,Republic of Karelia,622484,13,0,215,0
2020-05-18,Russia,NA,Republic of Karelia,622484,10,0,225,0
2020-05-19,Russia,NA,Republic of Karelia,622484,8,0,233,0
2020-05-20,Russia,NA,Republic of Karelia,622484,8,0,241,0
2020-05-21,Russia,NA,Republic of Karelia,622484,19,0,260,0
2020-05-22,Russia,NA,Republic of Karelia,622484,8,0,268,0
2020-05-23,Russia,NA,Republic of Karelia,622484,16,0,284,0
2020-05-24,Russia,NA,Republic of Karelia,622484,16,0,300,0
2020-05-25,Russia,NA,Republic of Karelia,622484,16,0,316,0
2020-05-26,Russia,NA,Republic of Karelia,622484,15,0,331,0
2020-05-27,Russia,NA,Republic of Karelia,622484,22,0,353,0
2020-05-28,Russia,NA,Republic of Karelia,622484,18,0,371,0
2020-05-29,Russia,NA,Republic of Karelia,622484,11,0,382,0
2020-05-30,Russia,NA,Republic of Karelia,622484,25,0,407,0
2020-05-31,Russia,NA,Republic of Karelia,622484,23,0,430,0
2020-06-01,Russia,NA,Republic of Karelia,622484,15,0,445,0
2020-06-02,Russia,NA,Republic of Karelia,622484,8,0,453,0
2020-06-03,Russia,NA,Republic of Karelia,622484,43,0,496,0
2020-06-04,Russia,NA,Republic of Karelia,622484,24,0,520,0
2020-06-05,Russia,NA,Republic of Karelia,622484,28,0,548,0
2020-06-06,Russia,NA,Republic of Karelia,622484,25,0,573,0
2020-06-07,Russia,NA,Republic of Karelia,622484,41,0,614,0
2020-06-08,Russia,NA,Republic of Karelia,622484,19,0,633,0
2020-06-09,Russia,NA,Republic of Karelia,622484,23,0,656,0
2020-06-10,Russia,NA,Republic of Karelia,622484,20,0,676,0
2020-06-11,Russia,NA,Republic of Karelia,622484,9,0,685,0
2020-06-12,Russia,NA,Republic of Karelia,622484,17,0,702,0
2020-06-13,Russia,NA,Republic of Karelia,622484,30,0,732,0
2020-06-14,Russia,NA,Republic of Karelia,622484,52,0,784,0
2020-06-15,Russia,NA,Republic of Karelia,622484,18,0,802,0
2020-06-16,Russia,NA,Republic of Karelia,622484,7,0,809,0
2020-06-17,Russia,NA,Republic of Karelia,622484,60,0,869,0
2020-06-18,Russia,NA,Republic of Karelia,622484,43,0,912,0
2020-06-19,Russia,NA,Republic of Karelia,622484,22,0,934,0
2020-06-20,Russia,NA,Republic of Karelia,622484,26,0,960,0
2020-06-21,Russia,NA,Republic of Karelia,622484,31,0,991,0
2020-06-22,Russia,NA,Republic of Karelia,622484,34,0,1025,0
2020-06-23,Russia,NA,Republic of Karelia,622484,18,0,1043,0
2020-06-24,Russia,NA,Republic of Karelia,622484,31,0,1074,0
2020-06-25,Russia,NA,Republic of Karelia,622484,35,0,1109,0
2020-06-26,Russia,NA,Republic of Karelia,622484,24,0,1133,0
2020-06-27,Russia,NA,Republic of Karelia,622484,44,0,1177,0
2020-06-28,Russia,NA,Republic of Karelia,622484,59,0,1236,0
2020-06-29,Russia,NA,Republic of Karelia,622484,30,0,1266,0
2020-06-30,Russia,NA,Republic of Karelia,622484,28,0,1294,0
2020-07-01,Russia,NA,Republic of Karelia,622484,43,0,1337,0
2020-07-02,Russia,NA,Republic of Karelia,622484,41,0,1378,0
2020-07-03,Russia,NA,Republic of Karelia,622484,30,0,1408,0
2020-07-04,Russia,NA,Republic of Karelia,622484,43,0,1451,0
2020-07-05,Russia,NA,Republic of Karelia,622484,48,0,1499,0
2020-07-06,Russia,NA,Republic of Karelia,622484,15,0,1514,0
2020-07-07,Russia,NA,Republic of Karelia,622484,17,0,1531,0
2020-07-08,Russia,NA,Republic of Karelia,622484,50,0,1581,0
2020-07-09,Russia,NA,Republic of Karelia,622484,42,0,1623,0
2020-07-10,Russia,NA,Republic of Karelia,622484,33,0,1656,0
2020-07-11,Russia,NA,Republic of Karelia,622484,28,0,1684,0
2020-07-12,Russia,NA,Republic of Karelia,622484,39,0,1723,0
2020-07-13,Russia,NA,Republic of Karelia,622484,15,0,1738,0
2020-07-14,Russia,NA,Republic of Karelia,622484,9,0,1747,0
2020-07-15,Russia,NA,Republic of Karelia,622484,45,0,1792,0
2020-07-16,Russia,NA,Republic of Karelia,622484,13,0,1805,0
2020-07-17,Russia,NA,Republic of Karelia,622484,47,0,1852,0
2020-07-18,Russia,NA,Republic of Karelia,622484,30,0,1882,0
2020-07-19,Russia,NA,Republic of Karelia,622484,39,0,1921,0
2020-07-20,Russia,NA,Republic of Karelia,622484,19,0,1940,0
2020-07-21,Russia,NA,Republic of Karelia,622484,13,0,1953,0
2020-07-22,Russia,NA,Republic of Karelia,622484,41,0,1994,0
2020-07-23,Russia,NA,Republic of Karelia,622484,45,0,2039,0
2020-07-24,Russia,NA,Republic of Karelia,622484,28,0,2067,0
2020-07-25,Russia,NA,Republic of Karelia,622484,42,0,2109,0
2020-07-26,Russia,NA,Republic of Karelia,622484,42,0,2151,0
2020-07-27,Russia,NA,Republic of Karelia,622484,19,0,2170,0
2020-07-28,Russia,NA,Republic of Karelia,622484,9,0,2179,0
2020-07-29,Russia,NA,Republic of Karelia,622484,32,0,2211,0
2020-07-30,Russia,NA,Republic of Karelia,622484,34,0,2245,0
2020-07-31,Russia,NA,Republic of Karelia,622484,30,0,2275,0
2020-08-01,Russia,NA,Republic of Karelia,622484,37,0,2312,0
2020-08-02,Russia,NA,Republic of Karelia,622484,45,0,2357,0
2020-08-26,Russia,NA,Republic of Karelia,622484,0,0,2957,15
2020-08-27,Russia,NA,Republic of Karelia,622484,35,1,2992,16
2020-08-28,Russia,NA,Republic of Karelia,622484,26,0,3018,16
2020-08-29,Russia,NA,Republic of Karelia,622484,34,0,3052,16
2020-08-30,Russia,NA,Republic of Karelia,622484,46,0,3098,16
2020-08-31,Russia,NA,Republic of Karelia,622484,32,0,3130,16
2020-09-01,Russia,NA,Republic of Karelia,622484,13,0,3143,16
2020-09-02,Russia,NA,Republic of Karelia,622484,36,0,3179,16
2020-09-03,Russia,NA,Republic of Karelia,622484,27,0,3206,16
2020-09-04,Russia,NA,Republic of Karelia,622484,23,0,3229,16
2020-09-05,Russia,NA,Republic of Karelia,622484,35,0,3264,16
2020-09-06,Russia,NA,Republic of Karelia,622484,33,0,3297,16
2020-09-07,Russia,NA,Republic of Karelia,622484,19,0,3316,16
2020-09-08,Russia,NA,Republic of Karelia,622484,5,0,3321,16
2020-09-09,Russia,NA,Republic of Karelia,622484,31,0,3352,16
2020-09-10,Russia,NA,Republic of Karelia,622484,33,0,3385,16
2020-09-11,Russia,NA,Republic of Karelia,622484,28,0,3413,16
2020-09-12,Russia,NA,Republic of Karelia,622484,28,0,3441,16
2020-09-13,Russia,NA,Republic of Karelia,622484,20,0,3461,16
2020-09-14,Russia,NA,Republic of Karelia,622484,16,0,3477,16
2020-09-15,Russia,NA,Republic of Karelia,622484,8,0,3485,16
2020-09-16,Russia,NA,Republic of Karelia,622484,29,0,3514,16
2020-09-17,Russia,NA,Republic of Karelia,622484,39,0,3553,16
2020-09-18,Russia,NA,Republic of Karelia,622484,34,0,3587,16
2020-09-19,Russia,NA,Republic of Karelia,622484,23,0,3610,16
2020-09-20,Russia,NA,Republic of Karelia,622484,17,0,3627,16
2020-09-21,Russia,NA,Republic of Karelia,622484,17,0,3644,16
2020-09-22,Russia,NA,Republic of Karelia,622484,15,0,3659,16
2020-09-23,Russia,NA,Republic of Karelia,622484,43,0,3702,16
2020-04-07,Russia,NA,Rostov Oblast,4220452,8,0,17,0
2020-04-08,Russia,NA,Rostov Oblast,4220452,4,0,21,0
2020-04-09,Russia,NA,Rostov Oblast,4220452,3,0,24,0
2020-04-10,Russia,NA,Rostov Oblast,4220452,5,0,29,0
2020-04-11,Russia,NA,Rostov Oblast,4220452,9,0,38,0
2020-04-12,Russia,NA,Rostov Oblast,4220452,14,0,52,0
2020-04-13,Russia,NA,Rostov Oblast,4220452,26,0,78,0
2020-04-14,Russia,NA,Rostov Oblast,4220452,20,0,98,0
2020-04-15,Russia,NA,Rostov Oblast,4220452,6,0,104,0
2020-04-16,Russia,NA,Rostov Oblast,4220452,41,0,145,0
2020-04-17,Russia,NA,Rostov Oblast,4220452,23,0,168,0
2020-04-18,Russia,NA,Rostov Oblast,4220452,29,0,197,0
2020-04-19,Russia,NA,Rostov Oblast,4220452,35,0,232,0
2020-04-20,Russia,NA,Rostov Oblast,4220452,60,0,292,0
2020-04-21,Russia,NA,Rostov Oblast,4220452,54,0,346,0
2020-04-22,Russia,NA,Rostov Oblast,4220452,52,0,398,0
2020-04-23,Russia,NA,Rostov Oblast,4220452,71,0,469,0
2020-04-24,Russia,NA,Rostov Oblast,4220452,64,0,533,0
2020-04-25,Russia,NA,Rostov Oblast,4220452,51,0,584,0
2020-04-26,Russia,NA,Rostov Oblast,4220452,65,0,649,0
2020-04-27,Russia,NA,Rostov Oblast,4220452,65,0,714,0
2020-04-28,Russia,NA,Rostov Oblast,4220452,64,0,778,0
2020-04-29,Russia,NA,Rostov Oblast,4220452,86,0,864,0
2020-04-30,Russia,NA,Rostov Oblast,4220452,79,0,943,0
2020-05-01,Russia,NA,Rostov Oblast,4220452,83,0,1026,0
2020-05-02,Russia,NA,Rostov Oblast,4220452,80,0,1106,0
2020-05-03,Russia,NA,Rostov Oblast,4220452,72,0,1178,0
2020-05-04,Russia,NA,Rostov Oblast,4220452,85,0,1263,0
2020-05-05,Russia,NA,Rostov Oblast,4220452,90,0,1353,0
2020-05-06,Russia,NA,Rostov Oblast,4220452,81,0,1434,0
2020-05-07,Russia,NA,Rostov Oblast,4220452,80,0,1514,0
2020-05-08,Russia,NA,Rostov Oblast,4220452,80,0,1594,0
2020-05-09,Russia,NA,Rostov Oblast,4220452,80,0,1674,0
2020-05-10,Russia,NA,Rostov Oblast,4220452,89,0,1763,0
2020-05-11,Russia,NA,Rostov Oblast,4220452,88,0,1851,0
2020-05-12,Russia,NA,Rostov Oblast,4220452,95,0,1946,0
2020-05-13,Russia,NA,Rostov Oblast,4220452,87,0,2033,0
2020-05-14,Russia,NA,Rostov Oblast,4220452,78,0,2111,0
2020-05-15,Russia,NA,Rostov Oblast,4220452,89,0,2200,0
2020-05-16,Russia,NA,Rostov Oblast,4220452,112,0,2312,0
2020-05-17,Russia,NA,Rostov Oblast,4220452,115,0,2427,0
2020-05-18,Russia,NA,Rostov Oblast,4220452,87,0,2514,0
2020-05-19,Russia,NA,Rostov Oblast,4220452,131,0,2645,0
2020-05-20,Russia,NA,Rostov Oblast,4220452,139,0,2784,0
2020-05-21,Russia,NA,Rostov Oblast,4220452,142,0,2926,0
2020-05-22,Russia,NA,Rostov Oblast,4220452,138,0,3064,0
2020-05-23,Russia,NA,Rostov Oblast,4220452,353,0,3417,0
2020-05-24,Russia,NA,Rostov Oblast,4220452,152,0,3569,0
2020-05-25,Russia,NA,Rostov Oblast,4220452,158,0,3727,0
2020-05-26,Russia,NA,Rostov Oblast,4220452,203,0,3930,0
2020-05-27,Russia,NA,Rostov Oblast,4220452,203,0,4133,0
2020-05-28,Russia,NA,Rostov Oblast,4220452,154,0,4287,0
2020-05-29,Russia,NA,Rostov Oblast,4220452,141,0,4428,0
2020-05-30,Russia,NA,Rostov Oblast,4220452,152,0,4580,0
2020-05-31,Russia,NA,Rostov Oblast,4220452,178,0,4758,0
2020-06-01,Russia,NA,Rostov Oblast,4220452,184,0,4942,0
2020-06-02,Russia,NA,Rostov Oblast,4220452,253,0,5195,0
2020-06-03,Russia,NA,Rostov Oblast,4220452,178,0,5373,0
2020-06-04,Russia,NA,Rostov Oblast,4220452,184,0,5557,0
2020-06-05,Russia,NA,Rostov Oblast,4220452,196,0,5753,0
2020-06-06,Russia,NA,Rostov Oblast,4220452,212,0,5965,0
2020-06-07,Russia,NA,Rostov Oblast,4220452,201,0,6166,0
2020-06-08,Russia,NA,Rostov Oblast,4220452,189,0,6355,0
2020-06-09,Russia,NA,Rostov Oblast,4220452,187,0,6542,0
2020-06-10,Russia,NA,Rostov Oblast,4220452,192,0,6734,0
2020-06-11,Russia,NA,Rostov Oblast,4220452,220,0,6954,0
2020-06-12,Russia,NA,Rostov Oblast,4220452,198,0,7152,0
2020-06-13,Russia,NA,Rostov Oblast,4220452,162,0,7314,0
2020-06-14,Russia,NA,Rostov Oblast,4220452,167,0,7481,0
2020-06-15,Russia,NA,Rostov Oblast,4220452,160,0,7641,0
2020-06-16,Russia,NA,Rostov Oblast,4220452,158,0,7799,0
2020-06-17,Russia,NA,Rostov Oblast,4220452,152,0,7951,0
2020-06-18,Russia,NA,Rostov Oblast,4220452,146,0,8097,0
2020-06-19,Russia,NA,Rostov Oblast,4220452,139,0,8236,0
2020-06-20,Russia,NA,Rostov Oblast,4220452,145,0,8381,0
2020-06-21,Russia,NA,Rostov Oblast,4220452,153,0,8534,0
2020-06-22,Russia,NA,Rostov Oblast,4220452,141,0,8675,0
2020-06-23,Russia,NA,Rostov Oblast,4220452,140,0,8815,0
2020-06-24,Russia,NA,Rostov Oblast,4220452,135,0,8950,0
2020-06-25,Russia,NA,Rostov Oblast,4220452,124,0,9074,0
2020-06-26,Russia,NA,Rostov Oblast,4220452,121,0,9195,0
2020-06-27,Russia,NA,Rostov Oblast,4220452,116,0,9311,0
2020-06-28,Russia,NA,Rostov Oblast,4220452,109,0,9420,0
2020-06-29,Russia,NA,Rostov Oblast,4220452,97,0,9517,0
2020-06-30,Russia,NA,Rostov Oblast,4220452,94,0,9611,0
2020-07-01,Russia,NA,Rostov Oblast,4220452,95,0,9706,0
2020-07-02,Russia,NA,Rostov Oblast,4220452,90,0,9796,0
2020-07-03,Russia,NA,Rostov Oblast,4220452,92,0,9888,0
2020-07-04,Russia,NA,Rostov Oblast,4220452,94,0,9982,0
2020-07-05,Russia,NA,Rostov Oblast,4220452,93,0,10075,0
2020-07-06,Russia,NA,Rostov Oblast,4220452,91,0,10166,0
2020-07-07,Russia,NA,Rostov Oblast,4220452,90,0,10256,0
2020-07-08,Russia,NA,Rostov Oblast,4220452,94,0,10350,0
2020-07-09,Russia,NA,Rostov Oblast,4220452,91,0,10441,0
2020-07-10,Russia,NA,Rostov Oblast,4220452,92,0,10533,0
2020-07-11,Russia,NA,Rostov Oblast,4220452,95,0,10628,0
2020-07-12,Russia,NA,Rostov Oblast,4220452,98,0,10726,0
2020-07-13,Russia,NA,Rostov Oblast,4220452,97,0,10823,0
2020-07-14,Russia,NA,Rostov Oblast,4220452,99,0,10922,0
2020-07-15,Russia,NA,Rostov Oblast,4220452,97,0,11019,0
2020-07-16,Russia,NA,Rostov Oblast,4220452,98,0,11117,0
2020-07-17,Russia,NA,Rostov Oblast,4220452,97,0,11214,0
2020-07-18,Russia,NA,Rostov Oblast,4220452,102,0,11316,0
2020-07-19,Russia,NA,Rostov Oblast,4220452,103,0,11419,0
2020-07-20,Russia,NA,Rostov Oblast,4220452,115,0,11534,0
2020-07-21,Russia,NA,Rostov Oblast,4220452,123,0,11657,0
2020-07-22,Russia,NA,Rostov Oblast,4220452,121,0,11778,0
2020-07-23,Russia,NA,Rostov Oblast,4220452,120,0,11898,0
2020-07-24,Russia,NA,Rostov Oblast,4220452,122,0,12020,0
2020-07-25,Russia,NA,Rostov Oblast,4220452,124,0,12144,0
2020-07-26,Russia,NA,Rostov Oblast,4220452,126,0,12270,0
2020-07-27,Russia,NA,Rostov Oblast,4220452,135,0,12405,0
2020-07-28,Russia,NA,Rostov Oblast,4220452,133,0,12538,0
2020-07-29,Russia,NA,Rostov Oblast,4220452,136,0,12674,0
2020-07-30,Russia,NA,Rostov Oblast,4220452,134,0,12808,0
2020-07-31,Russia,NA,Rostov Oblast,4220452,133,0,12941,0
2020-08-01,Russia,NA,Rostov Oblast,4220452,133,0,13074,0
2020-08-02,Russia,NA,Rostov Oblast,4220452,131,0,13205,0
2020-08-26,Russia,NA,Rostov Oblast,4220452,0,0,16278,326
2020-08-27,Russia,NA,Rostov Oblast,4220452,128,6,16406,332
2020-08-28,Russia,NA,Rostov Oblast,4220452,132,6,16538,338
2020-08-29,Russia,NA,Rostov Oblast,4220452,127,6,16665,344
2020-08-30,Russia,NA,Rostov Oblast,4220452,134,4,16799,348
2020-08-31,Russia,NA,Rostov Oblast,4220452,128,3,16927,351
2020-09-01,Russia,NA,Rostov Oblast,4220452,133,3,17060,354
2020-09-02,Russia,NA,Rostov Oblast,4220452,145,5,17205,359
2020-09-03,Russia,NA,Rostov Oblast,4220452,139,4,17344,363
2020-09-04,Russia,NA,Rostov Oblast,4220452,142,6,17486,369
2020-09-05,Russia,NA,Rostov Oblast,4220452,144,4,17630,373
2020-09-06,Russia,NA,Rostov Oblast,4220452,155,0,17785,373
2020-09-07,Russia,NA,Rostov Oblast,4220452,151,0,17936,373
2020-09-08,Russia,NA,Rostov Oblast,4220452,147,5,18083,378
2020-09-09,Russia,NA,Rostov Oblast,4220452,153,5,18236,383
2020-09-10,Russia,NA,Rostov Oblast,4220452,155,6,18391,389
2020-09-11,Russia,NA,Rostov Oblast,4220452,158,4,18549,393
2020-09-12,Russia,NA,Rostov Oblast,4220452,159,4,18708,397
2020-09-13,Russia,NA,Rostov Oblast,4220452,162,3,18870,400
2020-09-14,Russia,NA,Rostov Oblast,4220452,160,3,19030,403
2020-09-15,Russia,NA,Rostov Oblast,4220452,165,7,19195,410
2020-09-16,Russia,NA,Rostov Oblast,4220452,167,6,19362,416
2020-09-17,Russia,NA,Rostov Oblast,4220452,171,7,19533,423
2020-09-18,Russia,NA,Rostov Oblast,4220452,172,7,19705,430
2020-09-19,Russia,NA,Rostov Oblast,4220452,180,6,19885,436
2020-09-20,Russia,NA,Rostov Oblast,4220452,178,5,20063,441
2020-09-21,Russia,NA,Rostov Oblast,4220452,177,4,20240,445
2020-09-22,Russia,NA,Rostov Oblast,4220452,181,6,20421,451
2020-09-23,Russia,NA,Rostov Oblast,4220452,183,9,20604,460
2020-04-04,Russia,NA,Ryazan Oblast,1121474,6,0,12,0
2020-04-06,Russia,NA,Ryazan Oblast,1121474,5,0,17,0
2020-04-08,Russia,NA,Ryazan Oblast,1121474,15,0,32,0
2020-04-10,Russia,NA,Ryazan Oblast,1121474,6,0,38,0
2020-04-11,Russia,NA,Ryazan Oblast,1121474,17,0,55,0
2020-04-12,Russia,NA,Ryazan Oblast,1121474,16,0,71,0
2020-04-13,Russia,NA,Ryazan Oblast,1121474,18,0,89,0
2020-04-14,Russia,NA,Ryazan Oblast,1121474,27,0,116,0
2020-04-16,Russia,NA,Ryazan Oblast,1121474,38,0,154,0
2020-04-17,Russia,NA,Ryazan Oblast,1121474,30,0,184,0
2020-04-18,Russia,NA,Ryazan Oblast,1121474,41,0,225,0
2020-04-19,Russia,NA,Ryazan Oblast,1121474,42,0,267,0
2020-04-20,Russia,NA,Ryazan Oblast,1121474,22,0,289,0
2020-04-21,Russia,NA,Ryazan Oblast,1121474,27,0,316,0
2020-04-22,Russia,NA,Ryazan Oblast,1121474,76,0,392,0
2020-04-23,Russia,NA,Ryazan Oblast,1121474,37,0,429,0
2020-04-24,Russia,NA,Ryazan Oblast,1121474,46,0,475,0
2020-04-25,Russia,NA,Ryazan Oblast,1121474,64,0,539,0
2020-04-26,Russia,NA,Ryazan Oblast,1121474,63,0,602,0
2020-04-27,Russia,NA,Ryazan Oblast,1121474,85,0,687,0
2020-04-28,Russia,NA,Ryazan Oblast,1121474,101,0,788,0
2020-04-29,Russia,NA,Ryazan Oblast,1121474,52,0,840,0
2020-04-30,Russia,NA,Ryazan Oblast,1121474,40,0,880,0
2020-05-01,Russia,NA,Ryazan Oblast,1121474,43,0,923,0
2020-05-02,Russia,NA,Ryazan Oblast,1121474,98,0,1021,0
2020-05-03,Russia,NA,Ryazan Oblast,1121474,55,0,1076,0
2020-05-04,Russia,NA,Ryazan Oblast,1121474,61,0,1137,0
2020-05-05,Russia,NA,Ryazan Oblast,1121474,89,0,1226,0
2020-05-06,Russia,NA,Ryazan Oblast,1121474,84,0,1310,0
2020-05-07,Russia,NA,Ryazan Oblast,1121474,86,0,1396,0
2020-05-08,Russia,NA,Ryazan Oblast,1121474,79,0,1475,0
2020-05-09,Russia,NA,Ryazan Oblast,1121474,85,0,1560,0
2020-05-10,Russia,NA,Ryazan Oblast,1121474,88,0,1648,0
2020-05-11,Russia,NA,Ryazan Oblast,1121474,96,0,1744,0
2020-05-12,Russia,NA,Ryazan Oblast,1121474,98,0,1842,0
2020-05-13,Russia,NA,Ryazan Oblast,1121474,97,0,1939,0
2020-05-14,Russia,NA,Ryazan Oblast,1121474,89,0,2028,0
2020-05-15,Russia,NA,Ryazan Oblast,1121474,95,0,2123,0
2020-05-16,Russia,NA,Ryazan Oblast,1121474,91,0,2214,0
2020-05-17,Russia,NA,Ryazan Oblast,1121474,86,0,2300,0
2020-05-18,Russia,NA,Ryazan Oblast,1121474,94,0,2394,0
2020-05-19,Russia,NA,Ryazan Oblast,1121474,91,0,2485,0
2020-05-20,Russia,NA,Ryazan Oblast,1121474,92,0,2577,0
2020-05-21,Russia,NA,Ryazan Oblast,1121474,96,0,2673,0
2020-05-22,Russia,NA,Ryazan Oblast,1121474,94,0,2767,0
2020-05-23,Russia,NA,Ryazan Oblast,1121474,98,0,2865,0
2020-05-24,Russia,NA,Ryazan Oblast,1121474,88,0,2953,0
2020-05-25,Russia,NA,Ryazan Oblast,1121474,87,0,3040,0
2020-05-26,Russia,NA,Ryazan Oblast,1121474,85,0,3125,0
2020-05-27,Russia,NA,Ryazan Oblast,1121474,81,0,3206,0
2020-05-28,Russia,NA,Ryazan Oblast,1121474,77,0,3283,0
2020-05-29,Russia,NA,Ryazan Oblast,1121474,75,0,3358,0
2020-05-30,Russia,NA,Ryazan Oblast,1121474,74,0,3432,0
2020-05-31,Russia,NA,Ryazan Oblast,1121474,76,0,3508,0
2020-06-01,Russia,NA,Ryazan Oblast,1121474,73,0,3581,0
2020-06-02,Russia,NA,Ryazan Oblast,1121474,72,0,3653,0
2020-06-03,Russia,NA,Ryazan Oblast,1121474,75,0,3728,0
2020-06-04,Russia,NA,Ryazan Oblast,1121474,73,0,3801,0
2020-06-05,Russia,NA,Ryazan Oblast,1121474,71,0,3872,0
2020-06-06,Russia,NA,Ryazan Oblast,1121474,68,0,3940,0
2020-06-07,Russia,NA,Ryazan Oblast,1121474,73,0,4013,0
2020-06-08,Russia,NA,Ryazan Oblast,1121474,75,0,4088,0
2020-06-09,Russia,NA,Ryazan Oblast,1121474,76,0,4164,0
2020-06-10,Russia,NA,Ryazan Oblast,1121474,64,0,4228,0
2020-06-11,Russia,NA,Ryazan Oblast,1121474,59,0,4287,0
2020-06-12,Russia,NA,Ryazan Oblast,1121474,58,0,4345,0
2020-06-13,Russia,NA,Ryazan Oblast,1121474,56,0,4401,0
2020-06-14,Russia,NA,Ryazan Oblast,1121474,57,0,4458,0
2020-06-15,Russia,NA,Ryazan Oblast,1121474,49,0,4507,0
2020-06-16,Russia,NA,Ryazan Oblast,1121474,50,0,4557,0
2020-06-17,Russia,NA,Ryazan Oblast,1121474,49,0,4606,0
2020-06-18,Russia,NA,Ryazan Oblast,1121474,50,0,4656,0
2020-06-19,Russia,NA,Ryazan Oblast,1121474,52,0,4708,0
2020-06-20,Russia,NA,Ryazan Oblast,1121474,51,0,4759,0
2020-06-21,Russia,NA,Ryazan Oblast,1121474,49,0,4808,0
2020-06-22,Russia,NA,Ryazan Oblast,1121474,47,0,4855,0
2020-06-23,Russia,NA,Ryazan Oblast,1121474,45,0,4900,0
2020-06-24,Russia,NA,Ryazan Oblast,1121474,43,0,4943,0
2020-06-25,Russia,NA,Ryazan Oblast,1121474,41,0,4984,0
2020-06-26,Russia,NA,Ryazan Oblast,1121474,43,0,5027,0
2020-06-27,Russia,NA,Ryazan Oblast,1121474,42,0,5069,0
2020-06-28,Russia,NA,Ryazan Oblast,1121474,44,0,5113,0
2020-06-29,Russia,NA,Ryazan Oblast,1121474,41,0,5154,0
2020-06-30,Russia,NA,Ryazan Oblast,1121474,43,0,5197,0
2020-07-01,Russia,NA,Ryazan Oblast,1121474,40,0,5237,0
2020-07-02,Russia,NA,Ryazan Oblast,1121474,40,0,5277,0
2020-07-03,Russia,NA,Ryazan Oblast,1121474,38,0,5315,0
2020-07-04,Russia,NA,Ryazan Oblast,1121474,39,0,5354,0
2020-07-05,Russia,NA,Ryazan Oblast,1121474,40,0,5394,0
2020-07-06,Russia,NA,Ryazan Oblast,1121474,39,0,5433,0
2020-07-07,Russia,NA,Ryazan Oblast,1121474,36,0,5469,0
2020-07-08,Russia,NA,Ryazan Oblast,1121474,38,0,5507,0
2020-07-09,Russia,NA,Ryazan Oblast,1121474,40,0,5547,0
2020-07-10,Russia,NA,Ryazan Oblast,1121474,38,0,5585,0
2020-07-11,Russia,NA,Ryazan Oblast,1121474,36,0,5621,0
2020-07-12,Russia,NA,Ryazan Oblast,1121474,35,0,5656,0
2020-07-13,Russia,NA,Ryazan Oblast,1121474,38,0,5694,0
2020-07-14,Russia,NA,Ryazan Oblast,1121474,37,0,5731,0
2020-07-15,Russia,NA,Ryazan Oblast,1121474,35,0,5766,0
2020-07-16,Russia,NA,Ryazan Oblast,1121474,38,0,5804,0
2020-07-17,Russia,NA,Ryazan Oblast,1121474,39,0,5843,0
2020-07-18,Russia,NA,Ryazan Oblast,1121474,40,0,5883,0
2020-07-19,Russia,NA,Ryazan Oblast,1121474,38,0,5921,0
2020-07-20,Russia,NA,Ryazan Oblast,1121474,36,0,5957,0
2020-07-21,Russia,NA,Ryazan Oblast,1121474,35,0,5992,0
2020-07-22,Russia,NA,Ryazan Oblast,1121474,32,0,6024,0
2020-07-23,Russia,NA,Ryazan Oblast,1121474,34,0,6058,0
2020-07-24,Russia,NA,Ryazan Oblast,1121474,36,0,6094,0
2020-07-25,Russia,NA,Ryazan Oblast,1121474,32,0,6126,0
2020-07-26,Russia,NA,Ryazan Oblast,1121474,29,0,6155,0
2020-07-27,Russia,NA,Ryazan Oblast,1121474,28,0,6183,0
2020-07-28,Russia,NA,Ryazan Oblast,1121474,30,0,6213,0
2020-07-29,Russia,NA,Ryazan Oblast,1121474,27,0,6240,0
2020-07-30,Russia,NA,Ryazan Oblast,1121474,26,0,6266,0
2020-07-31,Russia,NA,Ryazan Oblast,1121474,29,0,6295,0
2020-08-01,Russia,NA,Ryazan Oblast,1121474,28,0,6323,0
2020-08-02,Russia,NA,Ryazan Oblast,1121474,29,0,6352,0
2020-08-26,Russia,NA,Ryazan Oblast,1121474,0,0,7019,42
2020-08-27,Russia,NA,Ryazan Oblast,1121474,28,1,7047,43
2020-08-28,Russia,NA,Ryazan Oblast,1121474,31,0,7078,43
2020-08-29,Russia,NA,Ryazan Oblast,1121474,27,1,7105,44
2020-08-30,Russia,NA,Ryazan Oblast,1121474,30,0,7135,44
2020-08-31,Russia,NA,Ryazan Oblast,1121474,26,0,7161,44
2020-09-01,Russia,NA,Ryazan Oblast,1121474,29,0,7190,44
2020-09-02,Russia,NA,Ryazan Oblast,1121474,27,0,7217,44
2020-09-03,Russia,NA,Ryazan Oblast,1121474,29,1,7246,45
2020-09-04,Russia,NA,Ryazan Oblast,1121474,32,1,7278,46
2020-09-05,Russia,NA,Ryazan Oblast,1121474,30,0,7308,46
2020-09-06,Russia,NA,Ryazan Oblast,1121474,33,0,7341,46
2020-09-07,Russia,NA,Ryazan Oblast,1121474,31,0,7372,46
2020-09-08,Russia,NA,Ryazan Oblast,1121474,30,0,7402,46
2020-09-09,Russia,NA,Ryazan Oblast,1121474,29,1,7431,47
2020-09-10,Russia,NA,Ryazan Oblast,1121474,28,0,7459,47
2020-09-11,Russia,NA,Ryazan Oblast,1121474,31,0,7490,47
2020-09-12,Russia,NA,Ryazan Oblast,1121474,33,0,7523,47
2020-09-13,Russia,NA,Ryazan Oblast,1121474,29,0,7552,47
2020-09-14,Russia,NA,Ryazan Oblast,1121474,32,0,7584,47
2020-09-15,Russia,NA,Ryazan Oblast,1121474,30,0,7614,47
2020-09-16,Russia,NA,Ryazan Oblast,1121474,33,0,7647,47
2020-09-17,Russia,NA,Ryazan Oblast,1121474,31,0,7678,47
2020-09-18,Russia,NA,Ryazan Oblast,1121474,34,0,7712,47
2020-09-19,Russia,NA,Ryazan Oblast,1121474,35,0,7747,47
2020-09-20,Russia,NA,Ryazan Oblast,1121474,34,0,7781,47
2020-09-21,Russia,NA,Ryazan Oblast,1121474,35,0,7816,47
2020-09-22,Russia,NA,Ryazan Oblast,1121474,36,2,7852,49
2020-09-23,Russia,NA,Ryazan Oblast,1121474,39,0,7891,49
2020-03-20,Russia,NA,Saint Petersburg,5351935,4,0,14,0
2020-03-21,Russia,NA,Saint Petersburg,5351935,2,0,16,0
2020-03-24,Russia,NA,Saint Petersburg,5351935,5,0,21,0
2020-03-26,Russia,NA,Saint Petersburg,5351935,5,0,26,0
2020-03-28,Russia,NA,Saint Petersburg,5351935,11,0,37,0
2020-03-29,Russia,NA,Saint Petersburg,5351935,5,0,42,0
2020-03-30,Russia,NA,Saint Petersburg,5351935,8,0,50,0
2020-03-31,Russia,NA,Saint Petersburg,5351935,48,0,98,0
2020-04-01,Russia,NA,Saint Petersburg,5351935,27,0,125,0
2020-04-02,Russia,NA,Saint Petersburg,5351935,22,0,147,0
2020-04-03,Russia,NA,Saint Petersburg,5351935,9,0,156,0
2020-04-04,Russia,NA,Saint Petersburg,5351935,15,0,171,0
2020-04-05,Russia,NA,Saint Petersburg,5351935,20,0,191,0
2020-04-06,Russia,NA,Saint Petersburg,5351935,35,0,226,0
2020-04-07,Russia,NA,Saint Petersburg,5351935,69,0,295,0
2020-04-08,Russia,NA,Saint Petersburg,5351935,34,0,329,0
2020-04-09,Russia,NA,Saint Petersburg,5351935,44,0,373,0
2020-04-10,Russia,NA,Saint Petersburg,5351935,35,0,408,0
2020-04-11,Russia,NA,Saint Petersburg,5351935,80,0,488,0
2020-04-12,Russia,NA,Saint Petersburg,5351935,69,0,557,0
2020-04-13,Russia,NA,Saint Petersburg,5351935,121,0,678,0
2020-04-14,Russia,NA,Saint Petersburg,5351935,121,0,799,0
2020-04-15,Russia,NA,Saint Petersburg,5351935,130,0,929,0
2020-04-16,Russia,NA,Saint Petersburg,5351935,154,0,1083,0
2020-04-17,Russia,NA,Saint Petersburg,5351935,424,0,1507,0
2020-04-18,Russia,NA,Saint Petersburg,5351935,139,0,1646,0
2020-04-19,Russia,NA,Saint Petersburg,5351935,114,0,1760,0
2020-04-20,Russia,NA,Saint Petersburg,5351935,86,0,1846,0
2020-04-21,Russia,NA,Saint Petersburg,5351935,127,0,1973,0
2020-04-22,Russia,NA,Saint Petersburg,5351935,294,0,2267,0
2020-04-23,Russia,NA,Saint Petersburg,5351935,191,0,2458,0
2020-04-24,Russia,NA,Saint Petersburg,5351935,253,0,2711,0
2020-04-25,Russia,NA,Saint Petersburg,5351935,215,0,2926,0
2020-04-26,Russia,NA,Saint Petersburg,5351935,151,0,3077,0
2020-04-27,Russia,NA,Saint Petersburg,5351935,161,0,3238,0
2020-04-28,Russia,NA,Saint Petersburg,5351935,198,0,3436,0
2020-04-29,Russia,NA,Saint Petersburg,5351935,290,0,3726,0
2020-04-30,Russia,NA,Saint Petersburg,5351935,336,0,4062,0
2020-05-01,Russia,NA,Saint Petersburg,5351935,349,0,4411,0
2020-05-02,Russia,NA,Saint Petersburg,5351935,323,0,4734,0
2020-05-03,Russia,NA,Saint Petersburg,5351935,295,0,5029,0
2020-05-04,Russia,NA,Saint Petersburg,5351935,317,0,5346,0
2020-05-05,Russia,NA,Saint Petersburg,5351935,226,0,5572,0
2020-05-06,Russia,NA,Saint Petersburg,5351935,312,0,5884,0
2020-05-07,Russia,NA,Saint Petersburg,5351935,306,0,6190,0
2020-05-08,Russia,NA,Saint Petersburg,5351935,375,0,6565,0
2020-05-09,Russia,NA,Saint Petersburg,5351935,425,0,6990,0
2020-05-10,Russia,NA,Saint Petersburg,5351935,414,0,7404,0
2020-05-11,Russia,NA,Saint Petersburg,5351935,307,0,7711,0
2020-05-12,Russia,NA,Saint Petersburg,5351935,339,0,8050,0
2020-05-13,Russia,NA,Saint Petersburg,5351935,435,0,8485,0
2020-05-14,Russia,NA,Saint Petersburg,5351935,460,0,8945,0
2020-05-15,Russia,NA,Saint Petersburg,5351935,541,0,9486,0
2020-05-16,Russia,NA,Saint Petersburg,5351935,525,0,10011,0
2020-05-17,Russia,NA,Saint Petersburg,5351935,451,0,10462,0
2020-05-18,Russia,NA,Saint Petersburg,5351935,425,0,10887,0
2020-05-19,Russia,NA,Saint Petersburg,5351935,453,0,11340,0
2020-05-20,Russia,NA,Saint Petersburg,5351935,455,0,11795,0
2020-05-21,Russia,NA,Saint Petersburg,5351935,408,0,12203,0
2020-05-22,Russia,NA,Saint Petersburg,5351935,389,0,12592,0
2020-05-23,Russia,NA,Saint Petersburg,5351935,363,0,12955,0
2020-05-24,Russia,NA,Saint Petersburg,5351935,384,0,13339,0
2020-05-25,Russia,NA,Saint Petersburg,5351935,374,0,13713,0
2020-05-26,Russia,NA,Saint Petersburg,5351935,363,0,14076,0
2020-05-27,Russia,NA,Saint Petersburg,5351935,387,0,14463,0
2020-05-28,Russia,NA,Saint Petersburg,5351935,383,0,14846,0
2020-05-29,Russia,NA,Saint Petersburg,5351935,369,0,15215,0
2020-05-30,Russia,NA,Saint Petersburg,5351935,365,0,15580,0
2020-05-31,Russia,NA,Saint Petersburg,5351935,369,0,15949,0
2020-06-01,Russia,NA,Saint Petersburg,5351935,364,0,16313,0
2020-06-02,Russia,NA,Saint Petersburg,5351935,376,0,16689,0
2020-06-03,Russia,NA,Saint Petersburg,5351935,380,0,17069,0
2020-06-04,Russia,NA,Saint Petersburg,5351935,375,0,17444,0
2020-06-05,Russia,NA,Saint Petersburg,5351935,378,0,17822,0
2020-06-06,Russia,NA,Saint Petersburg,5351935,347,0,18169,0
2020-06-07,Russia,NA,Saint Petersburg,5351935,340,0,18509,0
2020-06-08,Russia,NA,Saint Petersburg,5351935,326,0,18835,0
2020-06-09,Russia,NA,Saint Petersburg,5351935,318,0,19153,0
2020-06-10,Russia,NA,Saint Petersburg,5351935,313,0,19466,0
2020-06-11,Russia,NA,Saint Petersburg,5351935,303,0,19769,0
2020-06-12,Russia,NA,Saint Petersburg,5351935,274,0,20043,0
2020-06-13,Russia,NA,Saint Petersburg,5351935,262,0,20305,0
2020-06-14,Russia,NA,Saint Petersburg,5351935,256,0,20561,0
2020-06-15,Russia,NA,Saint Petersburg,5351935,252,0,20813,0
2020-06-16,Russia,NA,Saint Petersburg,5351935,234,0,21047,0
2020-06-17,Russia,NA,Saint Petersburg,5351935,228,0,21275,0
2020-06-18,Russia,NA,Saint Petersburg,5351935,231,0,21506,0
2020-06-19,Russia,NA,Saint Petersburg,5351935,228,0,21734,0
2020-06-20,Russia,NA,Saint Petersburg,5351935,232,0,21966,0
2020-06-21,Russia,NA,Saint Petersburg,5351935,229,0,22195,0
2020-06-22,Russia,NA,Saint Petersburg,5351935,217,0,22412,0
2020-06-23,Russia,NA,Saint Petersburg,5351935,220,0,22632,0
2020-06-24,Russia,NA,Saint Petersburg,5351935,218,0,22850,0
2020-06-25,Russia,NA,Saint Petersburg,5351935,221,0,23071,0
2020-06-26,Russia,NA,Saint Petersburg,5351935,223,0,23294,0
2020-06-27,Russia,NA,Saint Petersburg,5351935,224,0,23518,0
2020-06-28,Russia,NA,Saint Petersburg,5351935,217,0,23735,0
2020-06-29,Russia,NA,Saint Petersburg,5351935,219,0,23954,0
2020-06-30,Russia,NA,Saint Petersburg,5351935,253,0,24207,0
2020-07-01,Russia,NA,Saint Petersburg,5351935,262,0,24469,0
2020-07-02,Russia,NA,Saint Petersburg,5351935,258,0,24727,0
2020-07-03,Russia,NA,Saint Petersburg,5351935,263,0,24990,0
2020-07-04,Russia,NA,Saint Petersburg,5351935,271,0,25261,0
2020-07-05,Russia,NA,Saint Petersburg,5351935,275,0,25536,0
2020-07-06,Russia,NA,Saint Petersburg,5351935,280,0,25816,0
2020-07-07,Russia,NA,Saint Petersburg,5351935,278,0,26094,0
2020-07-08,Russia,NA,Saint Petersburg,5351935,295,0,26389,0
2020-07-09,Russia,NA,Saint Petersburg,5351935,292,0,26681,0
2020-07-10,Russia,NA,Saint Petersburg,5351935,300,0,26981,0
2020-07-11,Russia,NA,Saint Petersburg,5351935,296,0,27277,0
2020-07-12,Russia,NA,Saint Petersburg,5351935,293,0,27570,0
2020-07-13,Russia,NA,Saint Petersburg,5351935,291,0,27861,0
2020-07-14,Russia,NA,Saint Petersburg,5351935,281,0,28142,0
2020-07-15,Russia,NA,Saint Petersburg,5351935,264,0,28406,0
2020-07-16,Russia,NA,Saint Petersburg,5351935,256,0,28662,0
2020-07-17,Russia,NA,Saint Petersburg,5351935,244,0,28906,0
2020-07-18,Russia,NA,Saint Petersburg,5351935,238,0,29144,0
2020-07-19,Russia,NA,Saint Petersburg,5351935,202,0,29346,0
2020-07-20,Russia,NA,Saint Petersburg,5351935,195,0,29541,0
2020-07-21,Russia,NA,Saint Petersburg,5351935,189,0,29730,0
2020-07-22,Russia,NA,Saint Petersburg,5351935,186,0,29916,0
2020-07-23,Russia,NA,Saint Petersburg,5351935,184,0,30100,0
2020-07-24,Russia,NA,Saint Petersburg,5351935,181,0,30281,0
2020-07-25,Russia,NA,Saint Petersburg,5351935,179,0,30460,0
2020-07-26,Russia,NA,Saint Petersburg,5351935,175,0,30635,0
2020-07-27,Russia,NA,Saint Petersburg,5351935,172,0,30807,0
2020-07-28,Russia,NA,Saint Petersburg,5351935,168,0,30975,0
2020-07-29,Russia,NA,Saint Petersburg,5351935,165,0,31140,0
2020-07-30,Russia,NA,Saint Petersburg,5351935,162,0,31302,0
2020-07-31,Russia,NA,Saint Petersburg,5351935,159,0,31461,0
2020-08-01,Russia,NA,Saint Petersburg,5351935,161,0,31622,0
2020-08-02,Russia,NA,Saint Petersburg,5351935,163,0,31785,0
2020-08-26,Russia,NA,Saint Petersburg,5351935,0,0,35733,2375
2020-08-27,Russia,NA,Saint Petersburg,5351935,184,17,35917,2392
2020-08-28,Russia,NA,Saint Petersburg,5351935,187,9,36104,2401
2020-08-29,Russia,NA,Saint Petersburg,5351935,189,15,36293,2416
2020-08-30,Russia,NA,Saint Petersburg,5351935,186,5,36479,2421
2020-08-31,Russia,NA,Saint Petersburg,5351935,188,0,36667,2421
2020-09-01,Russia,NA,Saint Petersburg,5351935,185,19,36852,2440
2020-09-02,Russia,NA,Saint Petersburg,5351935,189,21,37041,2461
2020-09-03,Russia,NA,Saint Petersburg,5351935,191,22,37232,2483
2020-09-04,Russia,NA,Saint Petersburg,5351935,193,20,37425,2503
2020-09-05,Russia,NA,Saint Petersburg,5351935,195,19,37620,2522
2020-09-06,Russia,NA,Saint Petersburg,5351935,192,10,37812,2532
2020-09-07,Russia,NA,Saint Petersburg,5351935,196,0,38008,2532
2020-09-08,Russia,NA,Saint Petersburg,5351935,210,20,38218,2552
2020-09-09,Russia,NA,Saint Petersburg,5351935,218,22,38436,2574
2020-09-10,Russia,NA,Saint Petersburg,5351935,215,16,38651,2590
2020-09-11,Russia,NA,Saint Petersburg,5351935,216,17,38867,2607
2020-09-12,Russia,NA,Saint Petersburg,5351935,203,23,39070,2630
2020-09-13,Russia,NA,Saint Petersburg,5351935,206,20,39276,2650
2020-09-14,Russia,NA,Saint Petersburg,5351935,199,0,39475,2650
2020-09-15,Russia,NA,Saint Petersburg,5351935,206,26,39681,2676
2020-09-16,Russia,NA,Saint Petersburg,5351935,207,25,39888,2701
2020-09-17,Russia,NA,Saint Petersburg,5351935,211,24,40099,2725
2020-09-18,Russia,NA,Saint Petersburg,5351935,206,19,40305,2744
2020-09-19,Russia,NA,Saint Petersburg,5351935,212,18,40517,2762
2020-09-20,Russia,NA,Saint Petersburg,5351935,214,15,40731,2777
2020-09-21,Russia,NA,Saint Petersburg,5351935,209,0,40940,2777
2020-09-22,Russia,NA,Saint Petersburg,5351935,211,25,41151,2802
2020-09-23,Russia,NA,Saint Petersburg,5351935,208,15,41359,2817
2020-04-08,Russia,NA,Sakhalin Oblast,490181,5,0,11,0
2020-04-15,Russia,NA,Sakhalin Oblast,490181,1,0,12,0
2020-04-17,Russia,NA,Sakhalin Oblast,490181,7,0,19,0
2020-04-24,Russia,NA,Sakhalin Oblast,490181,1,0,20,0
2020-04-27,Russia,NA,Sakhalin Oblast,490181,1,0,21,0
2020-04-28,Russia,NA,Sakhalin Oblast,490181,1,0,22,0
2020-04-30,Russia,NA,Sakhalin Oblast,490181,1,0,23,0
2020-05-01,Russia,NA,Sakhalin Oblast,490181,1,0,24,0
2020-05-03,Russia,NA,Sakhalin Oblast,490181,2,0,26,0
2020-05-04,Russia,NA,Sakhalin Oblast,490181,2,0,28,0
2020-05-05,Russia,NA,Sakhalin Oblast,490181,1,0,29,0
2020-05-07,Russia,NA,Sakhalin Oblast,490181,2,0,31,0
2020-05-09,Russia,NA,Sakhalin Oblast,490181,6,0,37,0
2020-05-11,Russia,NA,Sakhalin Oblast,490181,1,0,38,0
2020-05-12,Russia,NA,Sakhalin Oblast,490181,3,0,41,0
2020-05-13,Russia,NA,Sakhalin Oblast,490181,1,0,42,0
2020-05-14,Russia,NA,Sakhalin Oblast,490181,2,0,44,0
2020-05-15,Russia,NA,Sakhalin Oblast,490181,1,0,45,0
2020-05-16,Russia,NA,Sakhalin Oblast,490181,3,0,48,0
2020-05-17,Russia,NA,Sakhalin Oblast,490181,2,0,50,0
2020-05-19,Russia,NA,Sakhalin Oblast,490181,6,0,56,0
2020-05-20,Russia,NA,Sakhalin Oblast,490181,1,0,57,0
2020-05-21,Russia,NA,Sakhalin Oblast,490181,2,0,59,0
2020-05-22,Russia,NA,Sakhalin Oblast,490181,4,0,63,0
2020-05-23,Russia,NA,Sakhalin Oblast,490181,3,0,66,0
2020-05-24,Russia,NA,Sakhalin Oblast,490181,2,0,68,0
2020-05-25,Russia,NA,Sakhalin Oblast,490181,1,0,69,0
2020-05-26,Russia,NA,Sakhalin Oblast,490181,5,0,74,0
2020-05-27,Russia,NA,Sakhalin Oblast,490181,2,0,76,0
2020-05-28,Russia,NA,Sakhalin Oblast,490181,4,0,80,0
2020-05-29,Russia,NA,Sakhalin Oblast,490181,14,0,94,0
2020-05-30,Russia,NA,Sakhalin Oblast,490181,7,0,101,0
2020-05-31,Russia,NA,Sakhalin Oblast,490181,14,0,115,0
2020-06-01,Russia,NA,Sakhalin Oblast,490181,3,0,118,0
2020-06-02,Russia,NA,Sakhalin Oblast,490181,15,0,133,0
2020-06-03,Russia,NA,Sakhalin Oblast,490181,10,0,143,0
2020-06-04,Russia,NA,Sakhalin Oblast,490181,4,0,147,0
2020-06-05,Russia,NA,Sakhalin Oblast,490181,13,0,160,0
2020-06-06,Russia,NA,Sakhalin Oblast,490181,10,0,170,0
2020-06-07,Russia,NA,Sakhalin Oblast,490181,18,0,188,0
2020-06-08,Russia,NA,Sakhalin Oblast,490181,16,0,204,0
2020-06-09,Russia,NA,Sakhalin Oblast,490181,12,0,216,0
2020-06-10,Russia,NA,Sakhalin Oblast,490181,34,0,250,0
2020-06-11,Russia,NA,Sakhalin Oblast,490181,14,0,264,0
2020-06-12,Russia,NA,Sakhalin Oblast,490181,41,0,305,0
2020-06-13,Russia,NA,Sakhalin Oblast,490181,15,0,320,0
2020-06-14,Russia,NA,Sakhalin Oblast,490181,10,0,330,0
2020-06-15,Russia,NA,Sakhalin Oblast,490181,13,0,343,0
2020-06-16,Russia,NA,Sakhalin Oblast,490181,19,0,362,0
2020-06-17,Russia,NA,Sakhalin Oblast,490181,32,0,394,0
2020-06-18,Russia,NA,Sakhalin Oblast,490181,29,0,423,0
2020-06-19,Russia,NA,Sakhalin Oblast,490181,24,0,447,0
2020-06-20,Russia,NA,Sakhalin Oblast,490181,48,0,495,0
2020-06-21,Russia,NA,Sakhalin Oblast,490181,30,0,525,0
2020-06-22,Russia,NA,Sakhalin Oblast,490181,41,0,566,0
2020-06-23,Russia,NA,Sakhalin Oblast,490181,1,0,567,0
2020-06-24,Russia,NA,Sakhalin Oblast,490181,61,0,628,0
2020-06-25,Russia,NA,Sakhalin Oblast,490181,35,0,663,0
2020-06-26,Russia,NA,Sakhalin Oblast,490181,39,0,702,0
2020-06-27,Russia,NA,Sakhalin Oblast,490181,19,0,721,0
2020-06-28,Russia,NA,Sakhalin Oblast,490181,21,0,742,0
2020-06-29,Russia,NA,Sakhalin Oblast,490181,29,0,771,0
2020-06-30,Russia,NA,Sakhalin Oblast,490181,29,0,800,0
2020-07-01,Russia,NA,Sakhalin Oblast,490181,28,0,828,0
2020-07-02,Russia,NA,Sakhalin Oblast,490181,25,0,853,0
2020-07-03,Russia,NA,Sakhalin Oblast,490181,32,0,885,0
2020-07-04,Russia,NA,Sakhalin Oblast,490181,33,0,918,0
2020-07-05,Russia,NA,Sakhalin Oblast,490181,35,0,953,0
2020-07-06,Russia,NA,Sakhalin Oblast,490181,40,0,993,0
2020-07-07,Russia,NA,Sakhalin Oblast,490181,42,0,1035,0
2020-07-08,Russia,NA,Sakhalin Oblast,490181,68,0,1103,0
2020-07-09,Russia,NA,Sakhalin Oblast,490181,69,0,1172,0
2020-07-10,Russia,NA,Sakhalin Oblast,490181,68,0,1240,0
2020-07-11,Russia,NA,Sakhalin Oblast,490181,67,0,1307,0
2020-07-12,Russia,NA,Sakhalin Oblast,490181,69,0,1376,0
2020-07-13,Russia,NA,Sakhalin Oblast,490181,67,0,1443,0
2020-07-14,Russia,NA,Sakhalin Oblast,490181,64,0,1507,0
2020-07-15,Russia,NA,Sakhalin Oblast,490181,61,0,1568,0
2020-07-16,Russia,NA,Sakhalin Oblast,490181,60,0,1628,0
2020-07-17,Russia,NA,Sakhalin Oblast,490181,59,0,1687,0
2020-07-18,Russia,NA,Sakhalin Oblast,490181,60,0,1747,0
2020-07-19,Russia,NA,Sakhalin Oblast,490181,59,0,1806,0
2020-07-20,Russia,NA,Sakhalin Oblast,490181,57,0,1863,0
2020-07-21,Russia,NA,Sakhalin Oblast,490181,63,0,1926,0
2020-07-22,Russia,NA,Sakhalin Oblast,490181,68,0,1994,0
2020-07-23,Russia,NA,Sakhalin Oblast,490181,67,0,2061,0
2020-07-24,Russia,NA,Sakhalin Oblast,490181,65,0,2126,0
2020-07-25,Russia,NA,Sakhalin Oblast,490181,59,0,2185,0
2020-07-26,Russia,NA,Sakhalin Oblast,490181,50,0,2235,0
2020-07-27,Russia,NA,Sakhalin Oblast,490181,59,0,2294,0
2020-07-28,Russia,NA,Sakhalin Oblast,490181,68,0,2362,0
2020-07-29,Russia,NA,Sakhalin Oblast,490181,69,0,2431,0
2020-07-30,Russia,NA,Sakhalin Oblast,490181,67,0,2498,0
2020-07-31,Russia,NA,Sakhalin Oblast,490181,61,0,2559,0
2020-08-01,Russia,NA,Sakhalin Oblast,490181,66,0,2625,0
2020-08-02,Russia,NA,Sakhalin Oblast,490181,60,0,2685,0
2020-08-26,Russia,NA,Sakhalin Oblast,490181,0,0,4152,0
2020-08-27,Russia,NA,Sakhalin Oblast,490181,58,0,4210,0
2020-08-28,Russia,NA,Sakhalin Oblast,490181,55,0,4265,0
2020-08-29,Russia,NA,Sakhalin Oblast,490181,54,0,4319,0
2020-08-30,Russia,NA,Sakhalin Oblast,490181,52,0,4371,0
2020-08-31,Russia,NA,Sakhalin Oblast,490181,49,0,4420,0
2020-09-01,Russia,NA,Sakhalin Oblast,490181,53,0,4473,0
2020-09-02,Russia,NA,Sakhalin Oblast,490181,51,0,4524,0
2020-09-03,Russia,NA,Sakhalin Oblast,490181,48,0,4572,0
2020-09-04,Russia,NA,Sakhalin Oblast,490181,50,0,4622,0
2020-09-05,Russia,NA,Sakhalin Oblast,490181,49,0,4671,0
2020-09-06,Russia,NA,Sakhalin Oblast,490181,47,0,4718,0
2020-09-07,Russia,NA,Sakhalin Oblast,490181,44,0,4762,0
2020-09-08,Russia,NA,Sakhalin Oblast,490181,46,0,4808,0
2020-09-09,Russia,NA,Sakhalin Oblast,490181,43,0,4851,0
2020-09-10,Russia,NA,Sakhalin Oblast,490181,41,0,4892,0
2020-09-11,Russia,NA,Sakhalin Oblast,490181,39,0,4931,0
2020-09-12,Russia,NA,Sakhalin Oblast,490181,37,0,4968,0
2020-09-13,Russia,NA,Sakhalin Oblast,490181,40,0,5008,0
2020-09-14,Russia,NA,Sakhalin Oblast,490181,38,0,5046,0
2020-09-15,Russia,NA,Sakhalin Oblast,490181,35,0,5081,0
2020-09-16,Russia,NA,Sakhalin Oblast,490181,31,0,5112,0
2020-09-17,Russia,NA,Sakhalin Oblast,490181,33,0,5145,0
2020-09-18,Russia,NA,Sakhalin Oblast,490181,29,0,5174,0
2020-09-19,Russia,NA,Sakhalin Oblast,490181,32,0,5206,0
2020-09-20,Russia,NA,Sakhalin Oblast,490181,30,0,5236,0
2020-09-21,Russia,NA,Sakhalin Oblast,490181,28,0,5264,0
2020-09-22,Russia,NA,Sakhalin Oblast,490181,44,0,5308,0
2020-09-23,Russia,NA,Sakhalin Oblast,490181,39,0,5347,0
2020-03-26,Russia,NA,Samara Oblast,3193514,2,0,12,0
2020-03-27,Russia,NA,Samara Oblast,3193514,2,0,14,0
2020-03-31,Russia,NA,Samara Oblast,3193514,1,0,15,0
2020-04-02,Russia,NA,Samara Oblast,3193514,2,0,17,0
2020-04-08,Russia,NA,Samara Oblast,3193514,1,0,18,0
2020-04-10,Russia,NA,Samara Oblast,3193514,2,0,20,0
2020-04-11,Russia,NA,Samara Oblast,3193514,1,0,21,0
2020-04-12,Russia,NA,Samara Oblast,3193514,3,0,24,0
2020-04-13,Russia,NA,Samara Oblast,3193514,5,0,29,0
2020-04-14,Russia,NA,Samara Oblast,3193514,11,0,40,0
2020-04-16,Russia,NA,Samara Oblast,3193514,10,0,50,0
2020-04-17,Russia,NA,Samara Oblast,3193514,13,0,63,0
2020-04-18,Russia,NA,Samara Oblast,3193514,1,0,64,0
2020-04-19,Russia,NA,Samara Oblast,3193514,15,0,79,0
2020-04-20,Russia,NA,Samara Oblast,3193514,16,0,95,0
2020-04-21,Russia,NA,Samara Oblast,3193514,8,0,103,0
2020-04-23,Russia,NA,Samara Oblast,3193514,26,0,129,0
2020-04-24,Russia,NA,Samara Oblast,3193514,44,0,173,0
2020-04-25,Russia,NA,Samara Oblast,3193514,24,0,197,0
2020-04-26,Russia,NA,Samara Oblast,3193514,20,0,217,0
2020-04-27,Russia,NA,Samara Oblast,3193514,35,0,252,0
2020-04-28,Russia,NA,Samara Oblast,3193514,8,0,260,0
2020-04-29,Russia,NA,Samara Oblast,3193514,55,0,315,0
2020-04-30,Russia,NA,Samara Oblast,3193514,40,0,355,0
2020-05-01,Russia,NA,Samara Oblast,3193514,25,0,380,0
2020-05-02,Russia,NA,Samara Oblast,3193514,41,0,421,0
2020-05-03,Russia,NA,Samara Oblast,3193514,85,0,506,0
2020-05-04,Russia,NA,Samara Oblast,3193514,60,0,566,0
2020-05-05,Russia,NA,Samara Oblast,3193514,17,0,583,0
2020-05-06,Russia,NA,Samara Oblast,3193514,81,0,664,0
2020-05-07,Russia,NA,Samara Oblast,3193514,67,0,731,0
2020-05-08,Russia,NA,Samara Oblast,3193514,59,0,790,0
2020-05-09,Russia,NA,Samara Oblast,3193514,75,0,865,0
2020-05-10,Russia,NA,Samara Oblast,3193514,74,0,939,0
2020-05-11,Russia,NA,Samara Oblast,3193514,66,0,1005,0
2020-05-12,Russia,NA,Samara Oblast,3193514,66,0,1071,0
2020-05-13,Russia,NA,Samara Oblast,3193514,79,0,1150,0
2020-05-14,Russia,NA,Samara Oblast,3193514,84,0,1234,0
2020-05-15,Russia,NA,Samara Oblast,3193514,56,0,1290,0
2020-05-16,Russia,NA,Samara Oblast,3193514,70,0,1360,0
2020-05-17,Russia,NA,Samara Oblast,3193514,65,0,1425,0
2020-05-18,Russia,NA,Samara Oblast,3193514,68,0,1493,0
2020-05-19,Russia,NA,Samara Oblast,3193514,65,0,1558,0
2020-05-20,Russia,NA,Samara Oblast,3193514,98,0,1656,0
2020-05-21,Russia,NA,Samara Oblast,3193514,74,0,1730,0
2020-05-22,Russia,NA,Samara Oblast,3193514,74,0,1804,0
2020-05-23,Russia,NA,Samara Oblast,3193514,86,0,1890,0
2020-05-24,Russia,NA,Samara Oblast,3193514,121,0,2011,0
2020-05-25,Russia,NA,Samara Oblast,3193514,97,0,2108,0
2020-05-26,Russia,NA,Samara Oblast,3193514,87,0,2195,0
2020-05-27,Russia,NA,Samara Oblast,3193514,135,0,2330,0
2020-05-28,Russia,NA,Samara Oblast,3193514,97,0,2427,0
2020-05-29,Russia,NA,Samara Oblast,3193514,48,0,2475,0
2020-05-30,Russia,NA,Samara Oblast,3193514,42,0,2517,0
2020-05-31,Russia,NA,Samara Oblast,3193514,85,0,2602,0
2020-06-01,Russia,NA,Samara Oblast,3193514,36,0,2638,0
2020-06-02,Russia,NA,Samara Oblast,3193514,76,0,2714,0
2020-06-03,Russia,NA,Samara Oblast,3193514,46,0,2760,0
2020-06-04,Russia,NA,Samara Oblast,3193514,63,0,2823,0
2020-06-05,Russia,NA,Samara Oblast,3193514,89,0,2912,0
2020-06-06,Russia,NA,Samara Oblast,3193514,104,0,3016,0
2020-06-07,Russia,NA,Samara Oblast,3193514,88,0,3104,0
2020-06-08,Russia,NA,Samara Oblast,3193514,86,0,3190,0
2020-06-09,Russia,NA,Samara Oblast,3193514,46,0,3236,0
2020-06-10,Russia,NA,Samara Oblast,3193514,113,0,3349,0
2020-06-11,Russia,NA,Samara Oblast,3193514,111,0,3460,0
2020-06-12,Russia,NA,Samara Oblast,3193514,78,0,3538,0
2020-06-13,Russia,NA,Samara Oblast,3193514,146,0,3684,0
2020-06-14,Russia,NA,Samara Oblast,3193514,110,0,3794,0
2020-06-15,Russia,NA,Samara Oblast,3193514,106,0,3900,0
2020-06-16,Russia,NA,Samara Oblast,3193514,70,0,3970,0
2020-06-17,Russia,NA,Samara Oblast,3193514,44,0,4014,0
2020-06-18,Russia,NA,Samara Oblast,3193514,76,0,4090,0
2020-06-19,Russia,NA,Samara Oblast,3193514,83,0,4173,0
2020-06-20,Russia,NA,Samara Oblast,3193514,67,0,4240,0
2020-06-21,Russia,NA,Samara Oblast,3193514,75,0,4315,0
2020-06-22,Russia,NA,Samara Oblast,3193514,63,0,4378,0
2020-06-23,Russia,NA,Samara Oblast,3193514,63,0,4441,0
2020-06-24,Russia,NA,Samara Oblast,3193514,51,0,4492,0
2020-06-25,Russia,NA,Samara Oblast,3193514,55,0,4547,0
2020-06-26,Russia,NA,Samara Oblast,3193514,60,0,4607,0
2020-06-27,Russia,NA,Samara Oblast,3193514,59,0,4666,0
2020-06-28,Russia,NA,Samara Oblast,3193514,62,0,4728,0
2020-06-29,Russia,NA,Samara Oblast,3193514,48,0,4776,0
2020-06-30,Russia,NA,Samara Oblast,3193514,51,0,4827,0
2020-07-01,Russia,NA,Samara Oblast,3193514,63,0,4890,0
2020-07-02,Russia,NA,Samara Oblast,3193514,73,0,4963,0
2020-07-03,Russia,NA,Samara Oblast,3193514,77,0,5040,0
2020-07-04,Russia,NA,Samara Oblast,3193514,87,0,5127,0
2020-07-05,Russia,NA,Samara Oblast,3193514,127,0,5254,0
2020-07-06,Russia,NA,Samara Oblast,3193514,135,0,5389,0
2020-07-07,Russia,NA,Samara Oblast,3193514,102,0,5491,0
2020-07-08,Russia,NA,Samara Oblast,3193514,75,0,5566,0
2020-07-09,Russia,NA,Samara Oblast,3193514,68,0,5634,0
2020-07-10,Russia,NA,Samara Oblast,3193514,77,0,5711,0
2020-07-11,Russia,NA,Samara Oblast,3193514,83,0,5794,0
2020-07-12,Russia,NA,Samara Oblast,3193514,78,0,5872,0
2020-07-13,Russia,NA,Samara Oblast,3193514,72,0,5944,0
2020-07-14,Russia,NA,Samara Oblast,3193514,65,0,6009,0
2020-07-15,Russia,NA,Samara Oblast,3193514,59,0,6068,0
2020-07-16,Russia,NA,Samara Oblast,3193514,57,0,6125,0
2020-07-17,Russia,NA,Samara Oblast,3193514,62,0,6187,0
2020-07-18,Russia,NA,Samara Oblast,3193514,62,0,6249,0
2020-07-19,Russia,NA,Samara Oblast,3193514,61,0,6310,0
2020-07-20,Russia,NA,Samara Oblast,3193514,60,0,6370,0
2020-07-21,Russia,NA,Samara Oblast,3193514,57,0,6427,0
2020-07-22,Russia,NA,Samara Oblast,3193514,52,0,6479,0
2020-07-23,Russia,NA,Samara Oblast,3193514,49,0,6528,0
2020-07-24,Russia,NA,Samara Oblast,3193514,42,0,6570,0
2020-07-25,Russia,NA,Samara Oblast,3193514,39,0,6609,0
2020-07-26,Russia,NA,Samara Oblast,3193514,41,0,6650,0
2020-07-27,Russia,NA,Samara Oblast,3193514,37,0,6687,0
2020-07-28,Russia,NA,Samara Oblast,3193514,32,0,6719,0
2020-07-29,Russia,NA,Samara Oblast,3193514,32,0,6751,0
2020-07-30,Russia,NA,Samara Oblast,3193514,36,0,6787,0
2020-07-31,Russia,NA,Samara Oblast,3193514,43,0,6830,0
2020-08-01,Russia,NA,Samara Oblast,3193514,43,0,6873,0
2020-08-02,Russia,NA,Samara Oblast,3193514,47,0,6920,0
2020-08-26,Russia,NA,Samara Oblast,3193514,0,0,8126,123
2020-08-27,Russia,NA,Samara Oblast,3193514,74,1,8200,124
2020-08-28,Russia,NA,Samara Oblast,3193514,75,0,8275,124
2020-08-29,Russia,NA,Samara Oblast,3193514,75,0,8350,124
2020-08-30,Russia,NA,Samara Oblast,3193514,76,1,8426,125
2020-08-31,Russia,NA,Samara Oblast,3193514,79,0,8505,125
2020-09-01,Russia,NA,Samara Oblast,3193514,81,4,8586,129
2020-09-02,Russia,NA,Samara Oblast,3193514,97,4,8683,133
2020-09-03,Russia,NA,Samara Oblast,3193514,98,0,8781,133
2020-09-04,Russia,NA,Samara Oblast,3193514,107,1,8888,134
2020-09-05,Russia,NA,Samara Oblast,3193514,105,1,8993,135
2020-09-06,Russia,NA,Samara Oblast,3193514,101,0,9094,135
2020-09-07,Russia,NA,Samara Oblast,3193514,102,0,9196,135
2020-09-08,Russia,NA,Samara Oblast,3193514,98,2,9294,137
2020-09-09,Russia,NA,Samara Oblast,3193514,101,1,9395,138
2020-09-10,Russia,NA,Samara Oblast,3193514,105,0,9500,138
2020-09-11,Russia,NA,Samara Oblast,3193514,107,4,9607,142
2020-09-12,Russia,NA,Samara Oblast,3193514,106,0,9713,142
2020-09-13,Russia,NA,Samara Oblast,3193514,111,2,9824,144
2020-09-14,Russia,NA,Samara Oblast,3193514,120,0,9944,144
2020-09-15,Russia,NA,Samara Oblast,3193514,122,0,10066,144
2020-09-16,Russia,NA,Samara Oblast,3193514,121,1,10187,145
2020-09-17,Russia,NA,Samara Oblast,3193514,125,14,10312,159
2020-09-18,Russia,NA,Samara Oblast,3193514,123,4,10435,163
2020-09-19,Russia,NA,Samara Oblast,3193514,115,9,10550,172
2020-09-20,Russia,NA,Samara Oblast,3193514,114,0,10664,172
2020-09-21,Russia,NA,Samara Oblast,3193514,112,1,10776,173
2020-09-22,Russia,NA,Samara Oblast,3193514,112,2,10888,175
2020-09-23,Russia,NA,Samara Oblast,3193514,111,2,10999,177
2020-04-01,Russia,NA,Saratov Oblast,2462950,11,0,15,0
2020-04-03,Russia,NA,Saratov Oblast,2462950,4,0,19,0
2020-04-07,Russia,NA,Saratov Oblast,2462950,6,0,25,0
2020-04-08,Russia,NA,Saratov Oblast,2462950,1,0,26,0
2020-04-09,Russia,NA,Saratov Oblast,2462950,4,0,30,0
2020-04-10,Russia,NA,Saratov Oblast,2462950,4,0,34,0
2020-04-11,Russia,NA,Saratov Oblast,2462950,1,0,35,0
2020-04-12,Russia,NA,Saratov Oblast,2462950,7,0,42,0
2020-04-13,Russia,NA,Saratov Oblast,2462950,2,0,44,0
2020-04-14,Russia,NA,Saratov Oblast,2462950,5,0,49,0
2020-04-15,Russia,NA,Saratov Oblast,2462950,7,0,56,0
2020-04-16,Russia,NA,Saratov Oblast,2462950,14,0,70,0
2020-04-17,Russia,NA,Saratov Oblast,2462950,17,0,87,0
2020-04-18,Russia,NA,Saratov Oblast,2462950,11,0,98,0
2020-04-19,Russia,NA,Saratov Oblast,2462950,16,0,114,0
2020-04-20,Russia,NA,Saratov Oblast,2462950,28,0,142,0
2020-04-21,Russia,NA,Saratov Oblast,2462950,26,0,168,0
2020-04-22,Russia,NA,Saratov Oblast,2462950,22,0,190,0
2020-04-23,Russia,NA,Saratov Oblast,2462950,39,0,229,0
2020-04-24,Russia,NA,Saratov Oblast,2462950,16,0,245,0
2020-04-25,Russia,NA,Saratov Oblast,2462950,20,0,265,0
2020-04-26,Russia,NA,Saratov Oblast,2462950,40,0,305,0
2020-04-27,Russia,NA,Saratov Oblast,2462950,22,0,327,0
2020-04-28,Russia,NA,Saratov Oblast,2462950,32,0,359,0
2020-04-29,Russia,NA,Saratov Oblast,2462950,33,0,392,0
2020-04-30,Russia,NA,Saratov Oblast,2462950,46,0,438,0
2020-05-01,Russia,NA,Saratov Oblast,2462950,49,0,487,0
2020-05-02,Russia,NA,Saratov Oblast,2462950,48,0,535,0
2020-05-03,Russia,NA,Saratov Oblast,2462950,50,0,585,0
2020-05-04,Russia,NA,Saratov Oblast,2462950,74,0,659,0
2020-05-05,Russia,NA,Saratov Oblast,2462950,78,0,737,0
2020-05-06,Russia,NA,Saratov Oblast,2462950,98,0,835,0
2020-05-07,Russia,NA,Saratov Oblast,2462950,41,0,876,0
2020-05-08,Russia,NA,Saratov Oblast,2462950,74,0,950,0
2020-05-09,Russia,NA,Saratov Oblast,2462950,57,0,1007,0
2020-05-10,Russia,NA,Saratov Oblast,2462950,69,0,1076,0
2020-05-11,Russia,NA,Saratov Oblast,2462950,92,0,1168,0
2020-05-12,Russia,NA,Saratov Oblast,2462950,64,0,1232,0
2020-05-13,Russia,NA,Saratov Oblast,2462950,85,0,1317,0
2020-05-14,Russia,NA,Saratov Oblast,2462950,96,0,1413,0
2020-05-15,Russia,NA,Saratov Oblast,2462950,113,0,1526,0
2020-05-16,Russia,NA,Saratov Oblast,2462950,107,0,1633,0
2020-05-17,Russia,NA,Saratov Oblast,2462950,121,0,1754,0
2020-05-18,Russia,NA,Saratov Oblast,2462950,117,0,1871,0
2020-05-19,Russia,NA,Saratov Oblast,2462950,109,0,1980,0
2020-05-20,Russia,NA,Saratov Oblast,2462950,92,0,2072,0
2020-05-21,Russia,NA,Saratov Oblast,2462950,67,0,2139,0
2020-05-22,Russia,NA,Saratov Oblast,2462950,84,0,2223,0
2020-05-23,Russia,NA,Saratov Oblast,2462950,98,0,2321,0
2020-05-24,Russia,NA,Saratov Oblast,2462950,97,0,2418,0
2020-05-25,Russia,NA,Saratov Oblast,2462950,98,0,2516,0
2020-05-26,Russia,NA,Saratov Oblast,2462950,65,0,2581,0
2020-05-27,Russia,NA,Saratov Oblast,2462950,68,0,2649,0
2020-05-28,Russia,NA,Saratov Oblast,2462950,97,0,2746,0
2020-05-29,Russia,NA,Saratov Oblast,2462950,94,0,2840,0
2020-05-30,Russia,NA,Saratov Oblast,2462950,96,0,2936,0
2020-05-31,Russia,NA,Saratov Oblast,2462950,142,0,3078,0
2020-06-01,Russia,NA,Saratov Oblast,2462950,96,0,3174,0
2020-06-02,Russia,NA,Saratov Oblast,2462950,95,0,3269,0
2020-06-03,Russia,NA,Saratov Oblast,2462950,94,0,3363,0
2020-06-04,Russia,NA,Saratov Oblast,2462950,94,0,3457,0
2020-06-05,Russia,NA,Saratov Oblast,2462950,96,0,3553,0
2020-06-06,Russia,NA,Saratov Oblast,2462950,98,0,3651,0
2020-06-07,Russia,NA,Saratov Oblast,2462950,112,0,3763,0
2020-06-08,Russia,NA,Saratov Oblast,2462950,137,0,3900,0
2020-06-09,Russia,NA,Saratov Oblast,2462950,115,0,4015,0
2020-06-10,Russia,NA,Saratov Oblast,2462950,117,0,4132,0
2020-06-11,Russia,NA,Saratov Oblast,2462950,114,0,4246,0
2020-06-12,Russia,NA,Saratov Oblast,2462950,116,0,4362,0
2020-06-13,Russia,NA,Saratov Oblast,2462950,118,0,4480,0
2020-06-14,Russia,NA,Saratov Oblast,2462950,126,0,4606,0
2020-06-15,Russia,NA,Saratov Oblast,2462950,128,0,4734,0
2020-06-16,Russia,NA,Saratov Oblast,2462950,123,0,4857,0
2020-06-17,Russia,NA,Saratov Oblast,2462950,125,0,4982,0
2020-06-18,Russia,NA,Saratov Oblast,2462950,119,0,5101,0
2020-06-19,Russia,NA,Saratov Oblast,2462950,116,0,5217,0
2020-06-20,Russia,NA,Saratov Oblast,2462950,118,0,5335,0
2020-06-21,Russia,NA,Saratov Oblast,2462950,115,0,5450,0
2020-06-22,Russia,NA,Saratov Oblast,2462950,112,0,5562,0
2020-06-23,Russia,NA,Saratov Oblast,2462950,109,0,5671,0
2020-06-24,Russia,NA,Saratov Oblast,2462950,111,0,5782,0
2020-06-25,Russia,NA,Saratov Oblast,2462950,110,0,5892,0
2020-06-26,Russia,NA,Saratov Oblast,2462950,111,0,6003,0
2020-06-27,Russia,NA,Saratov Oblast,2462950,112,0,6115,0
2020-06-28,Russia,NA,Saratov Oblast,2462950,110,0,6225,0
2020-06-29,Russia,NA,Saratov Oblast,2462950,109,0,6334,0
2020-06-30,Russia,NA,Saratov Oblast,2462950,110,0,6444,0
2020-07-01,Russia,NA,Saratov Oblast,2462950,102,0,6546,0
2020-07-02,Russia,NA,Saratov Oblast,2462950,99,0,6645,0
2020-07-03,Russia,NA,Saratov Oblast,2462950,101,0,6746,0
2020-07-04,Russia,NA,Saratov Oblast,2462950,98,0,6844,0
2020-07-05,Russia,NA,Saratov Oblast,2462950,97,0,6941,0
2020-07-06,Russia,NA,Saratov Oblast,2462950,99,0,7040,0
2020-07-07,Russia,NA,Saratov Oblast,2462950,95,0,7135,0
2020-07-08,Russia,NA,Saratov Oblast,2462950,96,0,7231,0
2020-07-09,Russia,NA,Saratov Oblast,2462950,94,0,7325,0
2020-07-10,Russia,NA,Saratov Oblast,2462950,92,0,7417,0
2020-07-11,Russia,NA,Saratov Oblast,2462950,91,0,7508,0
2020-07-12,Russia,NA,Saratov Oblast,2462950,92,0,7600,0
2020-07-13,Russia,NA,Saratov Oblast,2462950,89,0,7689,0
2020-07-14,Russia,NA,Saratov Oblast,2462950,93,0,7782,0
2020-07-15,Russia,NA,Saratov Oblast,2462950,92,0,7874,0
2020-07-16,Russia,NA,Saratov Oblast,2462950,95,0,7969,0
2020-07-17,Russia,NA,Saratov Oblast,2462950,94,0,8063,0
2020-07-18,Russia,NA,Saratov Oblast,2462950,96,0,8159,0
2020-07-19,Russia,NA,Saratov Oblast,2462950,97,0,8256,0
2020-07-20,Russia,NA,Saratov Oblast,2462950,93,0,8349,0
2020-07-21,Russia,NA,Saratov Oblast,2462950,94,0,8443,0
2020-07-22,Russia,NA,Saratov Oblast,2462950,93,0,8536,0
2020-07-23,Russia,NA,Saratov Oblast,2462950,95,0,8631,0
2020-07-24,Russia,NA,Saratov Oblast,2462950,94,0,8725,0
2020-07-25,Russia,NA,Saratov Oblast,2462950,98,0,8823,0
2020-07-26,Russia,NA,Saratov Oblast,2462950,97,0,8920,0
2020-07-27,Russia,NA,Saratov Oblast,2462950,95,0,9015,0
2020-07-28,Russia,NA,Saratov Oblast,2462950,96,0,9111,0
2020-07-29,Russia,NA,Saratov Oblast,2462950,98,0,9209,0
2020-07-30,Russia,NA,Saratov Oblast,2462950,99,0,9308,0
2020-07-31,Russia,NA,Saratov Oblast,2462950,98,0,9406,0
2020-08-01,Russia,NA,Saratov Oblast,2462950,96,0,9502,0
2020-08-02,Russia,NA,Saratov Oblast,2462950,95,0,9597,0
2020-08-26,Russia,NA,Saratov Oblast,2462950,0,0,11877,69
2020-08-27,Russia,NA,Saratov Oblast,2462950,97,0,11974,69
2020-08-28,Russia,NA,Saratov Oblast,2462950,93,2,12067,71
2020-08-29,Russia,NA,Saratov Oblast,2462950,96,0,12163,71
2020-08-30,Russia,NA,Saratov Oblast,2462950,88,2,12251,73
2020-08-31,Russia,NA,Saratov Oblast,2462950,94,2,12345,75
2020-09-01,Russia,NA,Saratov Oblast,2462950,93,1,12438,76
2020-09-02,Russia,NA,Saratov Oblast,2462950,112,0,12550,76
2020-09-03,Russia,NA,Saratov Oblast,2462950,108,1,12658,77
2020-09-04,Russia,NA,Saratov Oblast,2462950,102,2,12760,79
2020-09-05,Russia,NA,Saratov Oblast,2462950,103,1,12863,80
2020-09-06,Russia,NA,Saratov Oblast,2462950,104,0,12967,80
2020-09-07,Russia,NA,Saratov Oblast,2462950,101,2,13068,82
2020-09-08,Russia,NA,Saratov Oblast,2462950,98,0,13166,82
2020-09-09,Russia,NA,Saratov Oblast,2462950,102,0,13268,82
2020-09-10,Russia,NA,Saratov Oblast,2462950,103,2,13371,84
2020-09-11,Russia,NA,Saratov Oblast,2462950,101,1,13472,85
2020-09-12,Russia,NA,Saratov Oblast,2462950,101,0,13573,85
2020-09-13,Russia,NA,Saratov Oblast,2462950,105,0,13678,85
2020-09-14,Russia,NA,Saratov Oblast,2462950,110,0,13788,85
2020-09-15,Russia,NA,Saratov Oblast,2462950,109,2,13897,87
2020-09-16,Russia,NA,Saratov Oblast,2462950,111,1,14008,88
2020-09-17,Russia,NA,Saratov Oblast,2462950,107,1,14115,89
2020-09-18,Russia,NA,Saratov Oblast,2462950,107,2,14222,91
2020-09-19,Russia,NA,Saratov Oblast,2462950,110,2,14332,93
2020-09-20,Russia,NA,Saratov Oblast,2462950,108,0,14440,93
2020-09-21,Russia,NA,Saratov Oblast,2462950,102,0,14542,93
2020-09-22,Russia,NA,Saratov Oblast,2462950,105,0,14647,93
2020-09-23,Russia,NA,Saratov Oblast,2462950,108,2,14755,95
2020-04-09,Russia,NA,Smolensk Oblast,949348,4,0,11,0
2020-04-10,Russia,NA,Smolensk Oblast,949348,2,0,13,0
2020-04-11,Russia,NA,Smolensk Oblast,949348,4,0,17,0
2020-04-13,Russia,NA,Smolensk Oblast,949348,4,0,21,0
2020-04-14,Russia,NA,Smolensk Oblast,949348,34,0,55,0
2020-04-15,Russia,NA,Smolensk Oblast,949348,51,0,106,0
2020-04-16,Russia,NA,Smolensk Oblast,949348,26,0,132,0
2020-04-17,Russia,NA,Smolensk Oblast,949348,7,0,139,0
2020-04-18,Russia,NA,Smolensk Oblast,949348,13,0,152,0
2020-04-19,Russia,NA,Smolensk Oblast,949348,21,0,173,0
2020-04-20,Russia,NA,Smolensk Oblast,949348,16,0,189,0
2020-04-21,Russia,NA,Smolensk Oblast,949348,19,0,208,0
2020-04-22,Russia,NA,Smolensk Oblast,949348,36,0,244,0
2020-04-23,Russia,NA,Smolensk Oblast,949348,7,0,251,0
2020-04-24,Russia,NA,Smolensk Oblast,949348,11,0,262,0
2020-04-25,Russia,NA,Smolensk Oblast,949348,17,0,279,0
2020-04-26,Russia,NA,Smolensk Oblast,949348,10,0,289,0
2020-04-27,Russia,NA,Smolensk Oblast,949348,35,0,324,0
2020-04-28,Russia,NA,Smolensk Oblast,949348,45,0,369,0
2020-04-29,Russia,NA,Smolensk Oblast,949348,34,0,403,0
2020-04-30,Russia,NA,Smolensk Oblast,949348,26,0,429,0
2020-05-01,Russia,NA,Smolensk Oblast,949348,26,0,455,0
2020-05-02,Russia,NA,Smolensk Oblast,949348,44,0,499,0
2020-05-03,Russia,NA,Smolensk Oblast,949348,9,0,508,0
2020-05-04,Russia,NA,Smolensk Oblast,949348,12,0,520,0
2020-05-05,Russia,NA,Smolensk Oblast,949348,14,0,534,0
2020-05-06,Russia,NA,Smolensk Oblast,949348,1,0,535,0
2020-05-07,Russia,NA,Smolensk Oblast,949348,55,0,590,0
2020-05-08,Russia,NA,Smolensk Oblast,949348,56,0,646,0
2020-05-09,Russia,NA,Smolensk Oblast,949348,22,0,668,0
2020-05-10,Russia,NA,Smolensk Oblast,949348,70,0,738,0
2020-05-11,Russia,NA,Smolensk Oblast,949348,164,0,902,0
2020-05-12,Russia,NA,Smolensk Oblast,949348,9,0,911,0
2020-05-13,Russia,NA,Smolensk Oblast,949348,97,0,1008,0
2020-05-14,Russia,NA,Smolensk Oblast,949348,36,0,1044,0
2020-05-15,Russia,NA,Smolensk Oblast,949348,61,0,1105,0
2020-05-16,Russia,NA,Smolensk Oblast,949348,41,0,1146,0
2020-05-17,Russia,NA,Smolensk Oblast,949348,44,0,1190,0
2020-05-18,Russia,NA,Smolensk Oblast,949348,56,0,1246,0
2020-05-19,Russia,NA,Smolensk Oblast,949348,51,0,1297,0
2020-05-20,Russia,NA,Smolensk Oblast,949348,60,0,1357,0
2020-05-21,Russia,NA,Smolensk Oblast,949348,61,0,1418,0
2020-05-22,Russia,NA,Smolensk Oblast,949348,53,0,1471,0
2020-05-23,Russia,NA,Smolensk Oblast,949348,65,0,1536,0
2020-05-24,Russia,NA,Smolensk Oblast,949348,67,0,1603,0
2020-05-25,Russia,NA,Smolensk Oblast,949348,82,0,1685,0
2020-05-26,Russia,NA,Smolensk Oblast,949348,84,0,1769,0
2020-05-27,Russia,NA,Smolensk Oblast,949348,84,0,1853,0
2020-05-28,Russia,NA,Smolensk Oblast,949348,80,0,1933,0
2020-05-29,Russia,NA,Smolensk Oblast,949348,91,0,2024,0
2020-05-30,Russia,NA,Smolensk Oblast,949348,95,0,2119,0
2020-05-31,Russia,NA,Smolensk Oblast,949348,88,0,2207,0
2020-06-01,Russia,NA,Smolensk Oblast,949348,92,0,2299,0
2020-06-02,Russia,NA,Smolensk Oblast,949348,110,0,2409,0
2020-06-03,Russia,NA,Smolensk Oblast,949348,127,0,2536,0
2020-06-04,Russia,NA,Smolensk Oblast,949348,142,0,2678,0
2020-06-05,Russia,NA,Smolensk Oblast,949348,150,0,2828,0
2020-06-06,Russia,NA,Smolensk Oblast,949348,95,0,2923,0
2020-06-07,Russia,NA,Smolensk Oblast,949348,112,0,3035,0
2020-06-08,Russia,NA,Smolensk Oblast,949348,122,0,3157,0
2020-06-09,Russia,NA,Smolensk Oblast,949348,143,0,3300,0
2020-06-10,Russia,NA,Smolensk Oblast,949348,132,0,3432,0
2020-06-11,Russia,NA,Smolensk Oblast,949348,107,0,3539,0
2020-06-12,Russia,NA,Smolensk Oblast,949348,70,0,3609,0
2020-06-13,Russia,NA,Smolensk Oblast,949348,103,0,3712,0
2020-06-14,Russia,NA,Smolensk Oblast,949348,79,0,3791,0
2020-06-15,Russia,NA,Smolensk Oblast,949348,77,0,3868,0
2020-06-16,Russia,NA,Smolensk Oblast,949348,59,0,3927,0
2020-06-17,Russia,NA,Smolensk Oblast,949348,61,0,3988,0
2020-06-18,Russia,NA,Smolensk Oblast,949348,63,0,4051,0
2020-06-19,Russia,NA,Smolensk Oblast,949348,59,0,4110,0
2020-06-20,Russia,NA,Smolensk Oblast,949348,53,0,4163,0
2020-06-21,Russia,NA,Smolensk Oblast,949348,45,0,4208,0
2020-06-22,Russia,NA,Smolensk Oblast,949348,44,0,4252,0
2020-06-23,Russia,NA,Smolensk Oblast,949348,41,0,4293,0
2020-06-24,Russia,NA,Smolensk Oblast,949348,45,0,4338,0
2020-06-25,Russia,NA,Smolensk Oblast,949348,42,0,4380,0
2020-06-26,Russia,NA,Smolensk Oblast,949348,43,0,4423,0
2020-06-27,Russia,NA,Smolensk Oblast,949348,40,0,4463,0
2020-06-28,Russia,NA,Smolensk Oblast,949348,42,0,4505,0
2020-06-29,Russia,NA,Smolensk Oblast,949348,39,0,4544,0
2020-06-30,Russia,NA,Smolensk Oblast,949348,37,0,4581,0
2020-07-01,Russia,NA,Smolensk Oblast,949348,38,0,4619,0
2020-07-02,Russia,NA,Smolensk Oblast,949348,40,0,4659,0
2020-07-03,Russia,NA,Smolensk Oblast,949348,43,0,4702,0
2020-07-04,Russia,NA,Smolensk Oblast,949348,42,0,4744,0
2020-07-05,Russia,NA,Smolensk Oblast,949348,38,0,4782,0
2020-07-06,Russia,NA,Smolensk Oblast,949348,41,0,4823,0
2020-07-07,Russia,NA,Smolensk Oblast,949348,42,0,4865,0
2020-07-08,Russia,NA,Smolensk Oblast,949348,39,0,4904,0
2020-07-09,Russia,NA,Smolensk Oblast,949348,40,0,4944,0
2020-07-10,Russia,NA,Smolensk Oblast,949348,42,0,4986,0
2020-07-11,Russia,NA,Smolensk Oblast,949348,42,0,5028,0
2020-07-12,Russia,NA,Smolensk Oblast,949348,41,0,5069,0
2020-07-13,Russia,NA,Smolensk Oblast,949348,39,0,5108,0
2020-07-14,Russia,NA,Smolensk Oblast,949348,47,0,5155,0
2020-07-15,Russia,NA,Smolensk Oblast,949348,57,0,5212,0
2020-07-16,Russia,NA,Smolensk Oblast,949348,50,0,5262,0
2020-07-17,Russia,NA,Smolensk Oblast,949348,44,0,5306,0
2020-07-18,Russia,NA,Smolensk Oblast,949348,43,0,5349,0
2020-07-19,Russia,NA,Smolensk Oblast,949348,32,0,5381,0
2020-07-20,Russia,NA,Smolensk Oblast,949348,27,0,5408,0
2020-07-21,Russia,NA,Smolensk Oblast,949348,19,0,5427,0
2020-07-22,Russia,NA,Smolensk Oblast,949348,27,0,5454,0
2020-07-23,Russia,NA,Smolensk Oblast,949348,31,0,5485,0
2020-07-24,Russia,NA,Smolensk Oblast,949348,19,0,5504,0
2020-07-25,Russia,NA,Smolensk Oblast,949348,30,0,5534,0
2020-07-26,Russia,NA,Smolensk Oblast,949348,19,0,5553,0
2020-07-27,Russia,NA,Smolensk Oblast,949348,18,0,5571,0
2020-07-28,Russia,NA,Smolensk Oblast,949348,18,0,5589,0
2020-07-29,Russia,NA,Smolensk Oblast,949348,20,0,5609,0
2020-07-30,Russia,NA,Smolensk Oblast,949348,24,0,5633,0
2020-07-31,Russia,NA,Smolensk Oblast,949348,23,0,5656,0
2020-08-01,Russia,NA,Smolensk Oblast,949348,24,0,5680,0
2020-08-02,Russia,NA,Smolensk Oblast,949348,25,0,5705,0
2020-08-26,Russia,NA,Smolensk Oblast,949348,0,0,6085,125
2020-08-27,Russia,NA,Smolensk Oblast,949348,17,1,6102,126
2020-08-28,Russia,NA,Smolensk Oblast,949348,21,1,6123,127
2020-08-29,Russia,NA,Smolensk Oblast,949348,19,0,6142,127
2020-08-30,Russia,NA,Smolensk Oblast,949348,15,0,6157,127
2020-08-31,Russia,NA,Smolensk Oblast,949348,10,0,6167,127
2020-09-01,Russia,NA,Smolensk Oblast,949348,9,1,6176,128
2020-09-02,Russia,NA,Smolensk Oblast,949348,10,1,6186,129
2020-09-03,Russia,NA,Smolensk Oblast,949348,16,1,6202,130
2020-09-04,Russia,NA,Smolensk Oblast,949348,20,0,6222,130
2020-09-05,Russia,NA,Smolensk Oblast,949348,17,1,6239,131
2020-09-06,Russia,NA,Smolensk Oblast,949348,17,0,6256,131
2020-09-07,Russia,NA,Smolensk Oblast,949348,12,1,6268,132
2020-09-08,Russia,NA,Smolensk Oblast,949348,6,1,6274,133
2020-09-09,Russia,NA,Smolensk Oblast,949348,13,0,6287,133
2020-09-10,Russia,NA,Smolensk Oblast,949348,13,1,6300,134
2020-09-11,Russia,NA,Smolensk Oblast,949348,10,0,6310,134
2020-09-12,Russia,NA,Smolensk Oblast,949348,13,1,6323,135
2020-09-13,Russia,NA,Smolensk Oblast,949348,14,0,6337,135
2020-09-14,Russia,NA,Smolensk Oblast,949348,12,0,6349,135
2020-09-15,Russia,NA,Smolensk Oblast,949348,9,1,6358,136
2020-09-16,Russia,NA,Smolensk Oblast,949348,11,1,6369,137
2020-09-17,Russia,NA,Smolensk Oblast,949348,9,0,6378,137
2020-09-18,Russia,NA,Smolensk Oblast,949348,14,0,6392,137
2020-09-19,Russia,NA,Smolensk Oblast,949348,16,0,6408,137
2020-09-20,Russia,NA,Smolensk Oblast,949348,15,0,6423,137
2020-09-21,Russia,NA,Smolensk Oblast,949348,15,1,6438,138
2020-09-22,Russia,NA,Smolensk Oblast,949348,12,0,6450,138
2020-09-23,Russia,NA,Smolensk Oblast,949348,19,0,6469,138
2020-04-02,Russia,NA,Stavropol Krai,2800674,5,0,11,0
2020-04-06,Russia,NA,Stavropol Krai,2800674,9,0,20,0
2020-04-07,Russia,NA,Stavropol Krai,2800674,19,0,39,0
2020-04-09,Russia,NA,Stavropol Krai,2800674,3,0,42,0
2020-04-10,Russia,NA,Stavropol Krai,2800674,10,0,52,0
2020-04-11,Russia,NA,Stavropol Krai,2800674,14,0,66,0
2020-04-12,Russia,NA,Stavropol Krai,2800674,8,0,74,0
2020-04-13,Russia,NA,Stavropol Krai,2800674,12,0,86,0
2020-04-14,Russia,NA,Stavropol Krai,2800674,9,0,95,0
2020-04-15,Russia,NA,Stavropol Krai,2800674,20,0,115,0
2020-04-16,Russia,NA,Stavropol Krai,2800674,28,0,143,0
2020-04-17,Russia,NA,Stavropol Krai,2800674,12,0,155,0
2020-04-18,Russia,NA,Stavropol Krai,2800674,54,0,209,0
2020-04-19,Russia,NA,Stavropol Krai,2800674,23,0,232,0
2020-04-20,Russia,NA,Stavropol Krai,2800674,12,0,244,0
2020-04-21,Russia,NA,Stavropol Krai,2800674,22,0,266,0
2020-04-22,Russia,NA,Stavropol Krai,2800674,11,0,277,0
2020-04-23,Russia,NA,Stavropol Krai,2800674,55,0,332,0
2020-04-24,Russia,NA,Stavropol Krai,2800674,26,0,358,0
2020-04-25,Russia,NA,Stavropol Krai,2800674,27,0,385,0
2020-04-26,Russia,NA,Stavropol Krai,2800674,36,0,421,0
2020-04-27,Russia,NA,Stavropol Krai,2800674,33,0,454,0
2020-04-28,Russia,NA,Stavropol Krai,2800674,37,0,491,0
2020-04-29,Russia,NA,Stavropol Krai,2800674,28,0,519,0
2020-04-30,Russia,NA,Stavropol Krai,2800674,43,0,562,0
2020-05-01,Russia,NA,Stavropol Krai,2800674,89,0,651,0
2020-05-02,Russia,NA,Stavropol Krai,2800674,25,0,676,0
2020-05-03,Russia,NA,Stavropol Krai,2800674,55,0,731,0
2020-05-04,Russia,NA,Stavropol Krai,2800674,57,0,788,0
2020-05-05,Russia,NA,Stavropol Krai,2800674,36,0,824,0
2020-05-06,Russia,NA,Stavropol Krai,2800674,40,0,864,0
2020-05-07,Russia,NA,Stavropol Krai,2800674,23,0,887,0
2020-05-08,Russia,NA,Stavropol Krai,2800674,56,0,943,0
2020-05-09,Russia,NA,Stavropol Krai,2800674,69,0,1012,0
2020-05-10,Russia,NA,Stavropol Krai,2800674,38,0,1050,0
2020-05-11,Russia,NA,Stavropol Krai,2800674,34,0,1084,0
2020-05-12,Russia,NA,Stavropol Krai,2800674,41,0,1125,0
2020-05-13,Russia,NA,Stavropol Krai,2800674,51,0,1176,0
2020-05-14,Russia,NA,Stavropol Krai,2800674,72,0,1248,0
2020-05-15,Russia,NA,Stavropol Krai,2800674,60,0,1308,0
2020-05-16,Russia,NA,Stavropol Krai,2800674,59,0,1367,0
2020-05-17,Russia,NA,Stavropol Krai,2800674,98,0,1465,0
2020-05-18,Russia,NA,Stavropol Krai,2800674,65,0,1530,0
2020-05-19,Russia,NA,Stavropol Krai,2800674,70,0,1600,0
2020-05-20,Russia,NA,Stavropol Krai,2800674,59,0,1659,0
2020-05-21,Russia,NA,Stavropol Krai,2800674,69,0,1728,0
2020-05-22,Russia,NA,Stavropol Krai,2800674,53,0,1781,0
2020-05-23,Russia,NA,Stavropol Krai,2800674,74,0,1855,0
2020-05-24,Russia,NA,Stavropol Krai,2800674,77,0,1932,0
2020-05-25,Russia,NA,Stavropol Krai,2800674,79,0,2011,0
2020-05-26,Russia,NA,Stavropol Krai,2800674,75,0,2086,0
2020-05-27,Russia,NA,Stavropol Krai,2800674,72,0,2158,0
2020-05-28,Russia,NA,Stavropol Krai,2800674,80,0,2238,0
2020-05-29,Russia,NA,Stavropol Krai,2800674,82,0,2320,0
2020-05-30,Russia,NA,Stavropol Krai,2800674,84,0,2404,0
2020-05-31,Russia,NA,Stavropol Krai,2800674,81,0,2485,0
2020-06-01,Russia,NA,Stavropol Krai,2800674,83,0,2568,0
2020-06-02,Russia,NA,Stavropol Krai,2800674,85,0,2653,0
2020-06-03,Russia,NA,Stavropol Krai,2800674,80,0,2733,0
2020-06-04,Russia,NA,Stavropol Krai,2800674,86,0,2819,0
2020-06-05,Russia,NA,Stavropol Krai,2800674,84,0,2903,0
2020-06-06,Russia,NA,Stavropol Krai,2800674,87,0,2990,0
2020-06-07,Russia,NA,Stavropol Krai,2800674,89,0,3079,0
2020-06-08,Russia,NA,Stavropol Krai,2800674,88,0,3167,0
2020-06-09,Russia,NA,Stavropol Krai,2800674,86,0,3253,0
2020-06-10,Russia,NA,Stavropol Krai,2800674,85,0,3338,0
2020-06-11,Russia,NA,Stavropol Krai,2800674,87,0,3425,0
2020-06-12,Russia,NA,Stavropol Krai,2800674,84,0,3509,0
2020-06-13,Russia,NA,Stavropol Krai,2800674,85,0,3594,0
2020-06-14,Russia,NA,Stavropol Krai,2800674,83,0,3677,0
2020-06-15,Russia,NA,Stavropol Krai,2800674,82,0,3759,0
2020-06-16,Russia,NA,Stavropol Krai,2800674,86,0,3845,0
2020-06-17,Russia,NA,Stavropol Krai,2800674,83,0,3928,0
2020-06-18,Russia,NA,Stavropol Krai,2800674,90,0,4018,0
2020-06-19,Russia,NA,Stavropol Krai,2800674,137,0,4155,0
2020-06-20,Russia,NA,Stavropol Krai,2800674,93,0,4248,0
2020-06-21,Russia,NA,Stavropol Krai,2800674,101,0,4349,0
2020-06-22,Russia,NA,Stavropol Krai,2800674,102,0,4451,0
2020-06-23,Russia,NA,Stavropol Krai,2800674,90,0,4541,0
2020-06-24,Russia,NA,Stavropol Krai,2800674,75,0,4616,0
2020-06-25,Russia,NA,Stavropol Krai,2800674,79,0,4695,0
2020-06-26,Russia,NA,Stavropol Krai,2800674,76,0,4771,0
2020-06-27,Russia,NA,Stavropol Krai,2800674,104,0,4875,0
2020-06-28,Russia,NA,Stavropol Krai,2800674,98,0,4973,0
2020-06-29,Russia,NA,Stavropol Krai,2800674,90,0,5063,0
2020-06-30,Russia,NA,Stavropol Krai,2800674,78,0,5141,0
2020-07-01,Russia,NA,Stavropol Krai,2800674,84,0,5225,0
2020-07-02,Russia,NA,Stavropol Krai,2800674,93,0,5318,0
2020-07-03,Russia,NA,Stavropol Krai,2800674,73,0,5391,0
2020-07-04,Russia,NA,Stavropol Krai,2800674,96,0,5487,0
2020-07-05,Russia,NA,Stavropol Krai,2800674,82,0,5569,0
2020-07-06,Russia,NA,Stavropol Krai,2800674,80,0,5649,0
2020-07-07,Russia,NA,Stavropol Krai,2800674,79,0,5728,0
2020-07-08,Russia,NA,Stavropol Krai,2800674,85,0,5813,0
2020-07-09,Russia,NA,Stavropol Krai,2800674,79,0,5892,0
2020-07-10,Russia,NA,Stavropol Krai,2800674,83,0,5975,0
2020-07-11,Russia,NA,Stavropol Krai,2800674,79,0,6054,0
2020-07-12,Russia,NA,Stavropol Krai,2800674,110,0,6164,0
2020-07-13,Russia,NA,Stavropol Krai,2800674,75,0,6239,0
2020-07-14,Russia,NA,Stavropol Krai,2800674,64,0,6303,0
2020-07-15,Russia,NA,Stavropol Krai,2800674,91,0,6394,0
2020-07-16,Russia,NA,Stavropol Krai,2800674,102,0,6496,0
2020-07-17,Russia,NA,Stavropol Krai,2800674,129,0,6625,0
2020-07-18,Russia,NA,Stavropol Krai,2800674,141,0,6766,0
2020-07-19,Russia,NA,Stavropol Krai,2800674,123,0,6889,0
2020-07-20,Russia,NA,Stavropol Krai,2800674,101,0,6990,0
2020-07-21,Russia,NA,Stavropol Krai,2800674,109,0,7099,0
2020-07-22,Russia,NA,Stavropol Krai,2800674,96,0,7195,0
2020-07-23,Russia,NA,Stavropol Krai,2800674,125,0,7320,0
2020-07-24,Russia,NA,Stavropol Krai,2800674,131,0,7451,0
2020-07-25,Russia,NA,Stavropol Krai,2800674,118,0,7569,0
2020-07-26,Russia,NA,Stavropol Krai,2800674,109,0,7678,0
2020-07-27,Russia,NA,Stavropol Krai,2800674,92,0,7770,0
2020-07-28,Russia,NA,Stavropol Krai,2800674,110,0,7880,0
2020-07-29,Russia,NA,Stavropol Krai,2800674,119,0,7999,0
2020-07-30,Russia,NA,Stavropol Krai,2800674,110,0,8109,0
2020-07-31,Russia,NA,Stavropol Krai,2800674,114,0,8223,0
2020-08-01,Russia,NA,Stavropol Krai,2800674,118,0,8341,0
2020-08-02,Russia,NA,Stavropol Krai,2800674,108,0,8449,0
2020-08-26,Russia,NA,Stavropol Krai,2800674,0,0,11361,221
2020-08-27,Russia,NA,Stavropol Krai,2800674,120,3,11481,224
2020-08-28,Russia,NA,Stavropol Krai,2800674,125,3,11606,227
2020-08-29,Russia,NA,Stavropol Krai,2800674,124,3,11730,230
2020-08-30,Russia,NA,Stavropol Krai,2800674,127,3,11857,233
2020-08-31,Russia,NA,Stavropol Krai,2800674,128,4,11985,237
2020-09-01,Russia,NA,Stavropol Krai,2800674,125,3,12110,240
2020-09-02,Russia,NA,Stavropol Krai,2800674,127,1,12237,241
2020-09-03,Russia,NA,Stavropol Krai,2800674,130,3,12367,244
2020-09-04,Russia,NA,Stavropol Krai,2800674,132,3,12499,247
2020-09-05,Russia,NA,Stavropol Krai,2800674,129,3,12628,250
2020-09-06,Russia,NA,Stavropol Krai,2800674,126,0,12754,250
2020-09-07,Russia,NA,Stavropol Krai,2800674,124,2,12878,252
2020-09-08,Russia,NA,Stavropol Krai,2800674,124,2,13002,254
2020-09-09,Russia,NA,Stavropol Krai,2800674,127,3,13129,257
2020-09-10,Russia,NA,Stavropol Krai,2800674,129,3,13258,260
2020-09-11,Russia,NA,Stavropol Krai,2800674,133,3,13391,263
2020-09-12,Russia,NA,Stavropol Krai,2800674,135,2,13526,265
2020-09-13,Russia,NA,Stavropol Krai,2800674,137,3,13663,268
2020-09-14,Russia,NA,Stavropol Krai,2800674,136,3,13799,271
2020-09-15,Russia,NA,Stavropol Krai,2800674,134,3,13933,274
2020-09-16,Russia,NA,Stavropol Krai,2800674,137,1,14070,275
2020-09-17,Russia,NA,Stavropol Krai,2800674,138,4,14208,279
2020-09-18,Russia,NA,Stavropol Krai,2800674,140,3,14348,282
2020-09-19,Russia,NA,Stavropol Krai,2800674,139,5,14487,287
2020-09-20,Russia,NA,Stavropol Krai,2800674,142,5,14629,292
2020-09-21,Russia,NA,Stavropol Krai,2800674,140,2,14769,294
2020-09-22,Russia,NA,Stavropol Krai,2800674,145,3,14914,297
2020-09-23,Russia,NA,Stavropol Krai,2800674,143,2,15057,299
2020-03-24,Russia,NA,Sverdlovsk Oblast,4325256,4,0,13,0
2020-03-26,Russia,NA,Sverdlovsk Oblast,4325256,7,0,20,0
2020-03-28,Russia,NA,Sverdlovsk Oblast,4325256,4,0,24,0
2020-03-31,Russia,NA,Sverdlovsk Oblast,4325256,9,0,33,0
2020-04-02,Russia,NA,Sverdlovsk Oblast,4325256,5,0,38,0
2020-04-03,Russia,NA,Sverdlovsk Oblast,4325256,1,0,39,0
2020-04-04,Russia,NA,Sverdlovsk Oblast,4325256,1,0,40,0
2020-04-06,Russia,NA,Sverdlovsk Oblast,4325256,4,0,44,0
2020-04-07,Russia,NA,Sverdlovsk Oblast,4325256,7,0,51,0
2020-04-08,Russia,NA,Sverdlovsk Oblast,4325256,5,0,56,0
2020-04-09,Russia,NA,Sverdlovsk Oblast,4325256,3,0,59,0
2020-04-10,Russia,NA,Sverdlovsk Oblast,4325256,2,0,61,0
2020-04-11,Russia,NA,Sverdlovsk Oblast,4325256,13,0,74,0
2020-04-12,Russia,NA,Sverdlovsk Oblast,4325256,4,0,78,0
2020-04-13,Russia,NA,Sverdlovsk Oblast,4325256,7,0,85,0
2020-04-14,Russia,NA,Sverdlovsk Oblast,4325256,8,0,93,0
2020-04-15,Russia,NA,Sverdlovsk Oblast,4325256,12,0,105,0
2020-04-16,Russia,NA,Sverdlovsk Oblast,4325256,6,0,111,0
2020-04-17,Russia,NA,Sverdlovsk Oblast,4325256,4,0,115,0
2020-04-18,Russia,NA,Sverdlovsk Oblast,4325256,11,0,126,0
2020-04-19,Russia,NA,Sverdlovsk Oblast,4325256,15,0,141,0
2020-04-20,Russia,NA,Sverdlovsk Oblast,4325256,8,0,149,0
2020-04-21,Russia,NA,Sverdlovsk Oblast,4325256,84,0,233,0
2020-04-22,Russia,NA,Sverdlovsk Oblast,4325256,10,0,243,0
2020-04-23,Russia,NA,Sverdlovsk Oblast,4325256,28,0,271,0
2020-04-24,Russia,NA,Sverdlovsk Oblast,4325256,33,0,304,0
2020-04-25,Russia,NA,Sverdlovsk Oblast,4325256,33,0,337,0
2020-04-26,Russia,NA,Sverdlovsk Oblast,4325256,58,0,395,0
2020-04-27,Russia,NA,Sverdlovsk Oblast,4325256,59,0,454,0
2020-04-28,Russia,NA,Sverdlovsk Oblast,4325256,85,0,539,0
2020-04-29,Russia,NA,Sverdlovsk Oblast,4325256,90,0,629,0
2020-04-30,Russia,NA,Sverdlovsk Oblast,4325256,74,0,703,0
2020-05-01,Russia,NA,Sverdlovsk Oblast,4325256,232,0,935,0
2020-05-02,Russia,NA,Sverdlovsk Oblast,4325256,81,0,1016,0
2020-05-03,Russia,NA,Sverdlovsk Oblast,4325256,75,0,1091,0
2020-05-04,Russia,NA,Sverdlovsk Oblast,4325256,53,0,1144,0
2020-05-05,Russia,NA,Sverdlovsk Oblast,4325256,133,0,1277,0
2020-05-06,Russia,NA,Sverdlovsk Oblast,4325256,76,0,1353,0
2020-05-07,Russia,NA,Sverdlovsk Oblast,4325256,76,0,1429,0
2020-05-08,Russia,NA,Sverdlovsk Oblast,4325256,155,0,1584,0
2020-05-09,Russia,NA,Sverdlovsk Oblast,4325256,121,0,1705,0
2020-05-10,Russia,NA,Sverdlovsk Oblast,4325256,139,0,1844,0
2020-05-11,Russia,NA,Sverdlovsk Oblast,4325256,108,0,1952,0
2020-05-12,Russia,NA,Sverdlovsk Oblast,4325256,211,0,2163,0
2020-05-13,Russia,NA,Sverdlovsk Oblast,4325256,135,0,2298,0
2020-05-14,Russia,NA,Sverdlovsk Oblast,4325256,64,0,2362,0
2020-05-15,Russia,NA,Sverdlovsk Oblast,4325256,104,0,2466,0
2020-05-16,Russia,NA,Sverdlovsk Oblast,4325256,105,0,2571,0
2020-05-17,Russia,NA,Sverdlovsk Oblast,4325256,160,0,2731,0
2020-05-18,Russia,NA,Sverdlovsk Oblast,4325256,130,0,2861,0
2020-05-19,Russia,NA,Sverdlovsk Oblast,4325256,138,0,2999,0
2020-05-20,Russia,NA,Sverdlovsk Oblast,4325256,135,0,3134,0
2020-05-21,Russia,NA,Sverdlovsk Oblast,4325256,174,0,3308,0
2020-05-22,Russia,NA,Sverdlovsk Oblast,4325256,135,0,3443,0
2020-05-23,Russia,NA,Sverdlovsk Oblast,4325256,171,0,3614,0
2020-05-24,Russia,NA,Sverdlovsk Oblast,4325256,90,0,3704,0
2020-05-25,Russia,NA,Sverdlovsk Oblast,4325256,279,0,3983,0
2020-05-26,Russia,NA,Sverdlovsk Oblast,4325256,207,0,4190,0
2020-05-27,Russia,NA,Sverdlovsk Oblast,4325256,235,0,4425,0
2020-05-28,Russia,NA,Sverdlovsk Oblast,4325256,268,0,4693,0
2020-05-29,Russia,NA,Sverdlovsk Oblast,4325256,230,0,4923,0
2020-05-30,Russia,NA,Sverdlovsk Oblast,4325256,261,0,5184,0
2020-05-31,Russia,NA,Sverdlovsk Oblast,4325256,265,0,5449,0
2020-06-01,Russia,NA,Sverdlovsk Oblast,4325256,283,0,5732,0
2020-06-02,Russia,NA,Sverdlovsk Oblast,4325256,292,0,6024,0
2020-06-03,Russia,NA,Sverdlovsk Oblast,4325256,357,0,6381,0
2020-06-04,Russia,NA,Sverdlovsk Oblast,4325256,298,0,6679,0
2020-06-05,Russia,NA,Sverdlovsk Oblast,4325256,251,0,6930,0
2020-06-06,Russia,NA,Sverdlovsk Oblast,4325256,249,0,7179,0
2020-06-07,Russia,NA,Sverdlovsk Oblast,4325256,240,0,7419,0
2020-06-08,Russia,NA,Sverdlovsk Oblast,4325256,249,0,7668,0
2020-06-09,Russia,NA,Sverdlovsk Oblast,4325256,242,0,7910,0
2020-06-10,Russia,NA,Sverdlovsk Oblast,4325256,284,0,8194,0
2020-06-11,Russia,NA,Sverdlovsk Oblast,4325256,312,0,8506,0
2020-06-12,Russia,NA,Sverdlovsk Oblast,4325256,320,0,8826,0
2020-06-13,Russia,NA,Sverdlovsk Oblast,4325256,245,0,9071,0
2020-06-14,Russia,NA,Sverdlovsk Oblast,4325256,254,0,9325,0
2020-06-15,Russia,NA,Sverdlovsk Oblast,4325256,233,0,9558,0
2020-06-16,Russia,NA,Sverdlovsk Oblast,4325256,231,0,9789,0
2020-06-17,Russia,NA,Sverdlovsk Oblast,4325256,227,0,10016,0
2020-06-18,Russia,NA,Sverdlovsk Oblast,4325256,231,0,10247,0
2020-06-19,Russia,NA,Sverdlovsk Oblast,4325256,254,0,10501,0
2020-06-20,Russia,NA,Sverdlovsk Oblast,4325256,224,0,10725,0
2020-06-21,Russia,NA,Sverdlovsk Oblast,4325256,207,0,10932,0
2020-06-22,Russia,NA,Sverdlovsk Oblast,4325256,197,0,11129,0
2020-06-23,Russia,NA,Sverdlovsk Oblast,4325256,182,0,11311,0
2020-06-24,Russia,NA,Sverdlovsk Oblast,4325256,181,0,11492,0
2020-06-25,Russia,NA,Sverdlovsk Oblast,4325256,192,0,11684,0
2020-06-26,Russia,NA,Sverdlovsk Oblast,4325256,193,0,11877,0
2020-06-27,Russia,NA,Sverdlovsk Oblast,4325256,216,0,12093,0
2020-06-28,Russia,NA,Sverdlovsk Oblast,4325256,209,0,12302,0
2020-06-29,Russia,NA,Sverdlovsk Oblast,4325256,214,0,12516,0
2020-06-30,Russia,NA,Sverdlovsk Oblast,4325256,276,0,12792,0
2020-07-01,Russia,NA,Sverdlovsk Oblast,4325256,256,0,13048,0
2020-07-02,Russia,NA,Sverdlovsk Oblast,4325256,224,0,13272,0
2020-07-03,Russia,NA,Sverdlovsk Oblast,4325256,227,0,13499,0
2020-07-04,Russia,NA,Sverdlovsk Oblast,4325256,268,0,13767,0
2020-07-05,Russia,NA,Sverdlovsk Oblast,4325256,266,0,14033,0
2020-07-06,Russia,NA,Sverdlovsk Oblast,4325256,270,0,14303,0
2020-07-07,Russia,NA,Sverdlovsk Oblast,4325256,226,0,14529,0
2020-07-08,Russia,NA,Sverdlovsk Oblast,4325256,263,0,14792,0
2020-07-09,Russia,NA,Sverdlovsk Oblast,4325256,276,0,15068,0
2020-07-10,Russia,NA,Sverdlovsk Oblast,4325256,275,0,15343,0
2020-07-11,Russia,NA,Sverdlovsk Oblast,4325256,280,0,15623,0
2020-07-12,Russia,NA,Sverdlovsk Oblast,4325256,286,0,15909,0
2020-07-13,Russia,NA,Sverdlovsk Oblast,4325256,218,0,16127,0
2020-07-14,Russia,NA,Sverdlovsk Oblast,4325256,245,0,16372,0
2020-07-15,Russia,NA,Sverdlovsk Oblast,4325256,263,0,16635,0
2020-07-16,Russia,NA,Sverdlovsk Oblast,4325256,349,0,16984,0
2020-07-17,Russia,NA,Sverdlovsk Oblast,4325256,301,0,17285,0
2020-07-18,Russia,NA,Sverdlovsk Oblast,4325256,259,0,17544,0
2020-07-19,Russia,NA,Sverdlovsk Oblast,4325256,245,0,17789,0
2020-07-20,Russia,NA,Sverdlovsk Oblast,4325256,234,0,18023,0
2020-07-21,Russia,NA,Sverdlovsk Oblast,4325256,227,0,18250,0
2020-07-22,Russia,NA,Sverdlovsk Oblast,4325256,234,0,18484,0
2020-07-23,Russia,NA,Sverdlovsk Oblast,4325256,249,0,18733,0
2020-07-24,Russia,NA,Sverdlovsk Oblast,4325256,248,0,18981,0
2020-07-25,Russia,NA,Sverdlovsk Oblast,4325256,251,0,19232,0
2020-07-26,Russia,NA,Sverdlovsk Oblast,4325256,241,0,19473,0
2020-07-27,Russia,NA,Sverdlovsk Oblast,4325256,252,0,19725,0
2020-07-28,Russia,NA,Sverdlovsk Oblast,4325256,209,0,19934,0
2020-07-29,Russia,NA,Sverdlovsk Oblast,4325256,223,0,20157,0
2020-07-30,Russia,NA,Sverdlovsk Oblast,4325256,215,0,20372,0
2020-07-31,Russia,NA,Sverdlovsk Oblast,4325256,210,0,20582,0
2020-08-01,Russia,NA,Sverdlovsk Oblast,4325256,202,0,20784,0
2020-08-02,Russia,NA,Sverdlovsk Oblast,4325256,199,0,20983,0
2020-08-26,Russia,NA,Sverdlovsk Oblast,4325256,0,0,24720,432
2020-08-27,Russia,NA,Sverdlovsk Oblast,4325256,119,3,24839,435
2020-08-28,Russia,NA,Sverdlovsk Oblast,4325256,121,6,24960,441
2020-08-29,Russia,NA,Sverdlovsk Oblast,4325256,116,7,25076,448
2020-08-30,Russia,NA,Sverdlovsk Oblast,4325256,120,0,25196,448
2020-08-31,Russia,NA,Sverdlovsk Oblast,4325256,119,2,25315,450
2020-09-01,Russia,NA,Sverdlovsk Oblast,4325256,117,4,25432,454
2020-09-02,Russia,NA,Sverdlovsk Oblast,4325256,115,6,25547,460
2020-09-03,Russia,NA,Sverdlovsk Oblast,4325256,121,6,25668,466
2020-09-04,Russia,NA,Sverdlovsk Oblast,4325256,123,4,25791,470
2020-09-05,Russia,NA,Sverdlovsk Oblast,4325256,119,5,25910,475
2020-09-06,Russia,NA,Sverdlovsk Oblast,4325256,128,2,26038,477
2020-09-07,Russia,NA,Sverdlovsk Oblast,4325256,125,2,26163,479
2020-09-08,Russia,NA,Sverdlovsk Oblast,4325256,123,4,26286,483
2020-09-09,Russia,NA,Sverdlovsk Oblast,4325256,115,12,26401,495
2020-09-10,Russia,NA,Sverdlovsk Oblast,4325256,126,14,26527,509
2020-09-11,Russia,NA,Sverdlovsk Oblast,4325256,133,3,26660,512
2020-09-12,Russia,NA,Sverdlovsk Oblast,4325256,128,10,26788,522
2020-09-13,Russia,NA,Sverdlovsk Oblast,4325256,131,0,26919,522
2020-09-14,Russia,NA,Sverdlovsk Oblast,4325256,129,2,27048,524
2020-09-15,Russia,NA,Sverdlovsk Oblast,4325256,124,9,27172,533
2020-09-16,Russia,NA,Sverdlovsk Oblast,4325256,127,4,27299,537
2020-09-17,Russia,NA,Sverdlovsk Oblast,4325256,126,12,27425,549
2020-09-18,Russia,NA,Sverdlovsk Oblast,4325256,129,10,27554,559
2020-09-19,Russia,NA,Sverdlovsk Oblast,4325256,125,8,27679,567
2020-09-20,Russia,NA,Sverdlovsk Oblast,4325256,120,1,27799,568
2020-09-21,Russia,NA,Sverdlovsk Oblast,4325256,123,0,27922,568
2020-09-22,Russia,NA,Sverdlovsk Oblast,4325256,121,7,28043,575
2020-09-23,Russia,NA,Sverdlovsk Oblast,4325256,125,5,28168,580
2020-04-06,Russia,NA,Tambov Oblast,1033552,8,0,15,0
2020-04-08,Russia,NA,Tambov Oblast,1033552,6,0,21,0
2020-04-10,Russia,NA,Tambov Oblast,1033552,12,0,33,0
2020-04-12,Russia,NA,Tambov Oblast,1033552,15,0,48,0
2020-04-14,Russia,NA,Tambov Oblast,1033552,35,0,83,0
2020-04-16,Russia,NA,Tambov Oblast,1033552,50,0,133,0
2020-04-18,Russia,NA,Tambov Oblast,1033552,32,0,165,0
2020-04-19,Russia,NA,Tambov Oblast,1033552,22,0,187,0
2020-04-20,Russia,NA,Tambov Oblast,1033552,22,0,209,0
2020-04-21,Russia,NA,Tambov Oblast,1033552,13,0,222,0
2020-04-22,Russia,NA,Tambov Oblast,1033552,18,0,240,0
2020-04-23,Russia,NA,Tambov Oblast,1033552,23,0,263,0
2020-04-24,Russia,NA,Tambov Oblast,1033552,35,0,298,0
2020-04-25,Russia,NA,Tambov Oblast,1033552,45,0,343,0
2020-04-26,Russia,NA,Tambov Oblast,1033552,56,0,399,0
2020-04-27,Russia,NA,Tambov Oblast,1033552,61,0,460,0
2020-04-28,Russia,NA,Tambov Oblast,1033552,33,0,493,0
2020-04-29,Russia,NA,Tambov Oblast,1033552,44,0,537,0
2020-04-30,Russia,NA,Tambov Oblast,1033552,75,0,612,0
2020-05-01,Russia,NA,Tambov Oblast,1033552,63,0,675,0
2020-05-02,Russia,NA,Tambov Oblast,1033552,54,0,729,0
2020-05-03,Russia,NA,Tambov Oblast,1033552,60,0,789,0
2020-05-04,Russia,NA,Tambov Oblast,1033552,53,0,842,0
2020-05-05,Russia,NA,Tambov Oblast,1033552,67,0,909,0
2020-05-06,Russia,NA,Tambov Oblast,1033552,62,0,971,0
2020-05-07,Russia,NA,Tambov Oblast,1033552,75,0,1046,0
2020-05-08,Russia,NA,Tambov Oblast,1033552,85,0,1131,0
2020-05-09,Russia,NA,Tambov Oblast,1033552,90,0,1221,0
2020-05-10,Russia,NA,Tambov Oblast,1033552,91,0,1312,0
2020-05-11,Russia,NA,Tambov Oblast,1033552,91,0,1403,0
2020-05-12,Russia,NA,Tambov Oblast,1033552,80,0,1483,0
2020-05-13,Russia,NA,Tambov Oblast,1033552,85,0,1568,0
2020-05-14,Russia,NA,Tambov Oblast,1033552,86,0,1654,0
2020-05-15,Russia,NA,Tambov Oblast,1033552,83,0,1737,0
2020-05-16,Russia,NA,Tambov Oblast,1033552,82,0,1819,0
2020-05-17,Russia,NA,Tambov Oblast,1033552,83,0,1902,0
2020-05-18,Russia,NA,Tambov Oblast,1033552,82,0,1984,0
2020-05-19,Russia,NA,Tambov Oblast,1033552,85,0,2069,0
2020-05-20,Russia,NA,Tambov Oblast,1033552,85,0,2154,0
2020-05-21,Russia,NA,Tambov Oblast,1033552,84,0,2238,0
2020-05-22,Russia,NA,Tambov Oblast,1033552,83,0,2321,0
2020-05-23,Russia,NA,Tambov Oblast,1033552,79,0,2400,0
2020-05-24,Russia,NA,Tambov Oblast,1033552,75,0,2475,0
2020-05-25,Russia,NA,Tambov Oblast,1033552,72,0,2547,0
2020-05-26,Russia,NA,Tambov Oblast,1033552,75,0,2622,0
2020-05-27,Russia,NA,Tambov Oblast,1033552,77,0,2699,0
2020-05-28,Russia,NA,Tambov Oblast,1033552,73,0,2772,0
2020-05-29,Russia,NA,Tambov Oblast,1033552,73,0,2845,0
2020-05-30,Russia,NA,Tambov Oblast,1033552,71,0,2916,0
2020-05-31,Russia,NA,Tambov Oblast,1033552,67,0,2983,0
2020-06-01,Russia,NA,Tambov Oblast,1033552,64,0,3047,0
2020-06-02,Russia,NA,Tambov Oblast,1033552,63,0,3110,0
2020-06-03,Russia,NA,Tambov Oblast,1033552,65,0,3175,0
2020-06-04,Russia,NA,Tambov Oblast,1033552,67,0,3242,0
2020-06-05,Russia,NA,Tambov Oblast,1033552,65,0,3307,0
2020-06-06,Russia,NA,Tambov Oblast,1033552,64,0,3371,0
2020-06-07,Russia,NA,Tambov Oblast,1033552,68,0,3439,0
2020-06-08,Russia,NA,Tambov Oblast,1033552,65,0,3504,0
2020-06-09,Russia,NA,Tambov Oblast,1033552,65,0,3569,0
2020-06-10,Russia,NA,Tambov Oblast,1033552,67,0,3636,0
2020-06-11,Russia,NA,Tambov Oblast,1033552,68,0,3704,0
2020-06-12,Russia,NA,Tambov Oblast,1033552,66,0,3770,0
2020-06-13,Russia,NA,Tambov Oblast,1033552,64,0,3834,0
2020-06-14,Russia,NA,Tambov Oblast,1033552,63,0,3897,0
2020-06-15,Russia,NA,Tambov Oblast,1033552,65,0,3962,0
2020-06-16,Russia,NA,Tambov Oblast,1033552,64,0,4026,0
2020-06-17,Russia,NA,Tambov Oblast,1033552,62,0,4088,0
2020-06-18,Russia,NA,Tambov Oblast,1033552,64,0,4152,0
2020-06-19,Russia,NA,Tambov Oblast,1033552,58,0,4210,0
2020-06-20,Russia,NA,Tambov Oblast,1033552,55,0,4265,0
2020-06-21,Russia,NA,Tambov Oblast,1033552,53,0,4318,0
2020-06-22,Russia,NA,Tambov Oblast,1033552,50,0,4368,0
2020-06-23,Russia,NA,Tambov Oblast,1033552,45,0,4413,0
2020-06-24,Russia,NA,Tambov Oblast,1033552,44,0,4457,0
2020-06-25,Russia,NA,Tambov Oblast,1033552,46,0,4503,0
2020-06-26,Russia,NA,Tambov Oblast,1033552,45,0,4548,0
2020-06-27,Russia,NA,Tambov Oblast,1033552,44,0,4592,0
2020-06-28,Russia,NA,Tambov Oblast,1033552,45,0,4637,0
2020-06-29,Russia,NA,Tambov Oblast,1033552,44,0,4681,0
2020-06-30,Russia,NA,Tambov Oblast,1033552,46,0,4727,0
2020-07-01,Russia,NA,Tambov Oblast,1033552,45,0,4772,0
2020-07-02,Russia,NA,Tambov Oblast,1033552,44,0,4816,0
2020-07-03,Russia,NA,Tambov Oblast,1033552,43,0,4859,0
2020-07-04,Russia,NA,Tambov Oblast,1033552,42,0,4901,0
2020-07-05,Russia,NA,Tambov Oblast,1033552,43,0,4944,0
2020-07-06,Russia,NA,Tambov Oblast,1033552,44,0,4988,0
2020-07-07,Russia,NA,Tambov Oblast,1033552,42,0,5030,0
2020-07-08,Russia,NA,Tambov Oblast,1033552,43,0,5073,0
2020-07-09,Russia,NA,Tambov Oblast,1033552,41,0,5114,0
2020-07-10,Russia,NA,Tambov Oblast,1033552,43,0,5157,0
2020-07-11,Russia,NA,Tambov Oblast,1033552,42,0,5199,0
2020-07-12,Russia,NA,Tambov Oblast,1033552,40,0,5239,0
2020-07-13,Russia,NA,Tambov Oblast,1033552,41,0,5280,0
2020-07-14,Russia,NA,Tambov Oblast,1033552,40,0,5320,0
2020-07-15,Russia,NA,Tambov Oblast,1033552,41,0,5361,0
2020-07-16,Russia,NA,Tambov Oblast,1033552,40,0,5401,0
2020-07-17,Russia,NA,Tambov Oblast,1033552,42,0,5443,0
2020-07-18,Russia,NA,Tambov Oblast,1033552,41,0,5484,0
2020-07-19,Russia,NA,Tambov Oblast,1033552,40,0,5524,0
2020-07-20,Russia,NA,Tambov Oblast,1033552,42,0,5566,0
2020-07-21,Russia,NA,Tambov Oblast,1033552,41,0,5607,0
2020-07-22,Russia,NA,Tambov Oblast,1033552,42,0,5649,0
2020-07-23,Russia,NA,Tambov Oblast,1033552,40,0,5689,0
2020-07-24,Russia,NA,Tambov Oblast,1033552,39,0,5728,0
2020-07-25,Russia,NA,Tambov Oblast,1033552,38,0,5766,0
2020-07-26,Russia,NA,Tambov Oblast,1033552,39,0,5805,0
2020-07-27,Russia,NA,Tambov Oblast,1033552,37,0,5842,0
2020-07-28,Russia,NA,Tambov Oblast,1033552,36,0,5878,0
2020-07-29,Russia,NA,Tambov Oblast,1033552,48,0,5926,0
2020-07-30,Russia,NA,Tambov Oblast,1033552,33,0,5959,0
2020-07-31,Russia,NA,Tambov Oblast,1033552,31,0,5990,0
2020-08-01,Russia,NA,Tambov Oblast,1033552,29,0,6019,0
2020-08-02,Russia,NA,Tambov Oblast,1033552,28,0,6047,0
2020-08-26,Russia,NA,Tambov Oblast,1033552,0,0,6633,45
2020-08-27,Russia,NA,Tambov Oblast,1033552,22,0,6655,45
2020-08-28,Russia,NA,Tambov Oblast,1033552,23,0,6678,45
2020-08-29,Russia,NA,Tambov Oblast,1033552,23,0,6701,45
2020-08-30,Russia,NA,Tambov Oblast,1033552,25,0,6726,45
2020-08-31,Russia,NA,Tambov Oblast,1033552,25,0,6751,45
2020-09-01,Russia,NA,Tambov Oblast,1033552,25,0,6776,45
2020-09-02,Russia,NA,Tambov Oblast,1033552,25,0,6801,45
2020-09-03,Russia,NA,Tambov Oblast,1033552,26,0,6827,45
2020-09-04,Russia,NA,Tambov Oblast,1033552,26,0,6853,45
2020-09-05,Russia,NA,Tambov Oblast,1033552,26,0,6879,45
2020-09-06,Russia,NA,Tambov Oblast,1033552,26,0,6905,45
2020-09-07,Russia,NA,Tambov Oblast,1033552,26,0,6931,45
2020-09-08,Russia,NA,Tambov Oblast,1033552,27,1,6958,46
2020-09-09,Russia,NA,Tambov Oblast,1033552,27,0,6985,46
2020-09-10,Russia,NA,Tambov Oblast,1033552,27,0,7012,46
2020-09-11,Russia,NA,Tambov Oblast,1033552,27,0,7039,46
2020-09-12,Russia,NA,Tambov Oblast,1033552,28,0,7067,46
2020-09-13,Russia,NA,Tambov Oblast,1033552,28,0,7095,46
2020-09-14,Russia,NA,Tambov Oblast,1033552,29,0,7124,46
2020-09-15,Russia,NA,Tambov Oblast,1033552,29,0,7153,46
2020-09-16,Russia,NA,Tambov Oblast,1033552,31,0,7184,46
2020-09-17,Russia,NA,Tambov Oblast,1033552,33,0,7217,46
2020-09-18,Russia,NA,Tambov Oblast,1033552,35,0,7252,46
2020-09-19,Russia,NA,Tambov Oblast,1033552,36,0,7288,46
2020-09-20,Russia,NA,Tambov Oblast,1033552,36,0,7324,46
2020-09-21,Russia,NA,Tambov Oblast,1033552,38,0,7362,46
2020-09-22,Russia,NA,Tambov Oblast,1033552,38,0,7400,46
2020-09-23,Russia,NA,Tambov Oblast,1033552,39,0,7439,46
2020-03-27,Russia,NA,Tatarstan,3894284,1,0,11,0
2020-03-28,Russia,NA,Tatarstan,3894284,3,0,14,0
2020-03-31,Russia,NA,Tatarstan,3894284,5,0,19,0
2020-04-03,Russia,NA,Tatarstan,3894284,6,0,25,0
2020-04-06,Russia,NA,Tatarstan,3894284,16,0,41,0
2020-04-09,Russia,NA,Tatarstan,3894284,9,0,50,0
2020-04-11,Russia,NA,Tatarstan,3894284,23,0,73,0
2020-04-13,Russia,NA,Tatarstan,3894284,11,0,84,0
2020-04-14,Russia,NA,Tatarstan,3894284,23,0,107,0
2020-04-16,Russia,NA,Tatarstan,3894284,21,0,128,0
2020-04-17,Russia,NA,Tatarstan,3894284,16,0,144,0
2020-04-18,Russia,NA,Tatarstan,3894284,16,0,160,0
2020-04-19,Russia,NA,Tatarstan,3894284,31,0,191,0
2020-04-20,Russia,NA,Tatarstan,3894284,39,0,230,0
2020-04-21,Russia,NA,Tatarstan,3894284,50,0,280,0
2020-04-22,Russia,NA,Tatarstan,3894284,75,0,355,0
2020-04-23,Russia,NA,Tatarstan,3894284,57,0,412,0
2020-04-24,Russia,NA,Tatarstan,3894284,14,0,426,0
2020-04-25,Russia,NA,Tatarstan,3894284,65,0,491,0
2020-04-26,Russia,NA,Tatarstan,3894284,71,0,562,0
2020-04-27,Russia,NA,Tatarstan,3894284,70,0,632,0
2020-04-28,Russia,NA,Tatarstan,3894284,65,0,697,0
2020-04-29,Russia,NA,Tatarstan,3894284,55,0,752,0
2020-04-30,Russia,NA,Tatarstan,3894284,71,0,823,0
2020-05-01,Russia,NA,Tatarstan,3894284,71,0,894,0
2020-05-02,Russia,NA,Tatarstan,3894284,66,0,960,0
2020-05-03,Russia,NA,Tatarstan,3894284,71,0,1031,0
2020-05-04,Russia,NA,Tatarstan,3894284,86,0,1117,0
2020-05-05,Russia,NA,Tatarstan,3894284,91,0,1208,0
2020-05-06,Russia,NA,Tatarstan,3894284,102,0,1310,0
2020-05-07,Russia,NA,Tatarstan,3894284,105,0,1415,0
2020-05-08,Russia,NA,Tatarstan,3894284,83,0,1498,0
2020-05-09,Russia,NA,Tatarstan,3894284,88,0,1586,0
2020-05-10,Russia,NA,Tatarstan,3894284,85,0,1671,0
2020-05-11,Russia,NA,Tatarstan,3894284,90,0,1761,0
2020-05-12,Russia,NA,Tatarstan,3894284,71,0,1832,0
2020-05-13,Russia,NA,Tatarstan,3894284,87,0,1919,0
2020-05-14,Russia,NA,Tatarstan,3894284,61,0,1980,0
2020-05-15,Russia,NA,Tatarstan,3894284,84,0,2064,0
2020-05-16,Russia,NA,Tatarstan,3894284,84,0,2148,0
2020-05-17,Russia,NA,Tatarstan,3894284,84,0,2232,0
2020-05-18,Russia,NA,Tatarstan,3894284,80,0,2312,0
2020-05-19,Russia,NA,Tatarstan,3894284,88,0,2400,0
2020-05-20,Russia,NA,Tatarstan,3894284,75,0,2475,0
2020-05-21,Russia,NA,Tatarstan,3894284,71,0,2546,0
2020-05-22,Russia,NA,Tatarstan,3894284,75,0,2621,0
2020-05-23,Russia,NA,Tatarstan,3894284,76,0,2697,0
2020-05-24,Russia,NA,Tatarstan,3894284,90,0,2787,0
2020-05-25,Russia,NA,Tatarstan,3894284,62,0,2849,0
2020-05-26,Russia,NA,Tatarstan,3894284,63,0,2912,0
2020-05-27,Russia,NA,Tatarstan,3894284,54,0,2966,0
2020-05-28,Russia,NA,Tatarstan,3894284,60,0,3026,0
2020-05-29,Russia,NA,Tatarstan,3894284,53,0,3079,0
2020-05-30,Russia,NA,Tatarstan,3894284,63,0,3142,0
2020-05-31,Russia,NA,Tatarstan,3894284,52,0,3194,0
2020-06-01,Russia,NA,Tatarstan,3894284,50,0,3244,0
2020-06-02,Russia,NA,Tatarstan,3894284,53,0,3297,0
2020-06-03,Russia,NA,Tatarstan,3894284,54,0,3351,0
2020-06-04,Russia,NA,Tatarstan,3894284,51,0,3402,0
2020-06-05,Russia,NA,Tatarstan,3894284,50,0,3452,0
2020-06-06,Russia,NA,Tatarstan,3894284,52,0,3504,0
2020-06-07,Russia,NA,Tatarstan,3894284,54,0,3558,0
2020-06-08,Russia,NA,Tatarstan,3894284,53,0,3611,0
2020-06-09,Russia,NA,Tatarstan,3894284,54,0,3665,0
2020-06-10,Russia,NA,Tatarstan,3894284,55,0,3720,0
2020-06-11,Russia,NA,Tatarstan,3894284,54,0,3774,0
2020-06-12,Russia,NA,Tatarstan,3894284,49,0,3823,0
2020-06-13,Russia,NA,Tatarstan,3894284,45,0,3868,0
2020-06-14,Russia,NA,Tatarstan,3894284,46,0,3914,0
2020-06-15,Russia,NA,Tatarstan,3894284,44,0,3958,0
2020-06-16,Russia,NA,Tatarstan,3894284,43,0,4001,0
2020-06-17,Russia,NA,Tatarstan,3894284,39,0,4040,0
2020-06-18,Russia,NA,Tatarstan,3894284,38,0,4078,0
2020-06-19,Russia,NA,Tatarstan,3894284,36,0,4114,0
2020-06-20,Russia,NA,Tatarstan,3894284,38,0,4152,0
2020-06-21,Russia,NA,Tatarstan,3894284,40,0,4192,0
2020-06-22,Russia,NA,Tatarstan,3894284,39,0,4231,0
2020-06-23,Russia,NA,Tatarstan,3894284,40,0,4271,0
2020-06-24,Russia,NA,Tatarstan,3894284,39,0,4310,0
2020-06-25,Russia,NA,Tatarstan,3894284,40,0,4350,0
2020-06-26,Russia,NA,Tatarstan,3894284,40,0,4390,0
2020-06-27,Russia,NA,Tatarstan,3894284,41,0,4431,0
2020-06-28,Russia,NA,Tatarstan,3894284,41,0,4472,0
2020-06-29,Russia,NA,Tatarstan,3894284,42,0,4514,0
2020-06-30,Russia,NA,Tatarstan,3894284,41,0,4555,0
2020-07-01,Russia,NA,Tatarstan,3894284,40,0,4595,0
2020-07-02,Russia,NA,Tatarstan,3894284,39,0,4634,0
2020-07-03,Russia,NA,Tatarstan,3894284,39,0,4673,0
2020-07-04,Russia,NA,Tatarstan,3894284,38,0,4711,0
2020-07-05,Russia,NA,Tatarstan,3894284,38,0,4749,0
2020-07-06,Russia,NA,Tatarstan,3894284,38,0,4787,0
2020-07-07,Russia,NA,Tatarstan,3894284,36,0,4823,0
2020-07-08,Russia,NA,Tatarstan,3894284,35,0,4858,0
2020-07-09,Russia,NA,Tatarstan,3894284,35,0,4893,0
2020-07-10,Russia,NA,Tatarstan,3894284,36,0,4929,0
2020-07-11,Russia,NA,Tatarstan,3894284,35,0,4964,0
2020-07-12,Russia,NA,Tatarstan,3894284,33,0,4997,0
2020-07-13,Russia,NA,Tatarstan,3894284,32,0,5029,0
2020-07-14,Russia,NA,Tatarstan,3894284,32,0,5061,0
2020-07-15,Russia,NA,Tatarstan,3894284,32,0,5093,0
2020-07-16,Russia,NA,Tatarstan,3894284,33,0,5126,0
2020-07-17,Russia,NA,Tatarstan,3894284,31,0,5157,0
2020-07-18,Russia,NA,Tatarstan,3894284,29,0,5186,0
2020-07-19,Russia,NA,Tatarstan,3894284,29,0,5215,0
2020-07-20,Russia,NA,Tatarstan,3894284,33,0,5248,0
2020-07-21,Russia,NA,Tatarstan,3894284,30,0,5278,0
2020-07-22,Russia,NA,Tatarstan,3894284,31,0,5309,0
2020-07-23,Russia,NA,Tatarstan,3894284,32,0,5341,0
2020-07-24,Russia,NA,Tatarstan,3894284,31,0,5372,0
2020-07-25,Russia,NA,Tatarstan,3894284,32,0,5404,0
2020-07-26,Russia,NA,Tatarstan,3894284,32,0,5436,0
2020-07-27,Russia,NA,Tatarstan,3894284,33,0,5469,0
2020-07-28,Russia,NA,Tatarstan,3894284,32,0,5501,0
2020-07-29,Russia,NA,Tatarstan,3894284,33,0,5534,0
2020-07-30,Russia,NA,Tatarstan,3894284,35,0,5569,0
2020-07-31,Russia,NA,Tatarstan,3894284,33,0,5602,0
2020-08-01,Russia,NA,Tatarstan,3894284,31,0,5633,0
2020-08-02,Russia,NA,Tatarstan,3894284,31,0,5664,0
2020-04-14,Russia,NA,Tomsk Oblast,1078280,7,0,15,0
2020-04-16,Russia,NA,Tomsk Oblast,1078280,6,0,21,0
2020-04-18,Russia,NA,Tomsk Oblast,1078280,3,0,24,0
2020-04-19,Russia,NA,Tomsk Oblast,1078280,5,0,29,0
2020-04-20,Russia,NA,Tomsk Oblast,1078280,4,0,33,0
2020-04-21,Russia,NA,Tomsk Oblast,1078280,4,0,37,0
2020-04-22,Russia,NA,Tomsk Oblast,1078280,6,0,43,0
2020-04-23,Russia,NA,Tomsk Oblast,1078280,9,0,52,0
2020-04-24,Russia,NA,Tomsk Oblast,1078280,7,0,59,0
2020-04-25,Russia,NA,Tomsk Oblast,1078280,7,0,66,0
2020-04-26,Russia,NA,Tomsk Oblast,1078280,1,0,67,0
2020-04-27,Russia,NA,Tomsk Oblast,1078280,9,0,76,0
2020-04-28,Russia,NA,Tomsk Oblast,1078280,5,0,81,0
2020-04-29,Russia,NA,Tomsk Oblast,1078280,6,0,87,0
2020-04-30,Russia,NA,Tomsk Oblast,1078280,2,0,89,0
2020-05-01,Russia,NA,Tomsk Oblast,1078280,8,0,97,0
2020-05-02,Russia,NA,Tomsk Oblast,1078280,5,0,102,0
2020-05-03,Russia,NA,Tomsk Oblast,1078280,17,0,119,0
2020-05-04,Russia,NA,Tomsk Oblast,1078280,9,0,128,0
2020-05-05,Russia,NA,Tomsk Oblast,1078280,19,0,147,0
2020-05-06,Russia,NA,Tomsk Oblast,1078280,13,0,160,0
2020-05-07,Russia,NA,Tomsk Oblast,1078280,2,0,162,0
2020-05-08,Russia,NA,Tomsk Oblast,1078280,14,0,176,0
2020-05-09,Russia,NA,Tomsk Oblast,1078280,15,0,191,0
2020-05-10,Russia,NA,Tomsk Oblast,1078280,19,0,210,0
2020-05-11,Russia,NA,Tomsk Oblast,1078280,69,0,279,0
2020-05-12,Russia,NA,Tomsk Oblast,1078280,15,0,294,0
2020-05-13,Russia,NA,Tomsk Oblast,1078280,17,0,311,0
2020-05-14,Russia,NA,Tomsk Oblast,1078280,9,0,320,0
2020-05-15,Russia,NA,Tomsk Oblast,1078280,9,0,329,0
2020-05-16,Russia,NA,Tomsk Oblast,1078280,14,0,343,0
2020-05-17,Russia,NA,Tomsk Oblast,1078280,20,0,363,0
2020-05-18,Russia,NA,Tomsk Oblast,1078280,18,0,381,0
2020-05-19,Russia,NA,Tomsk Oblast,1078280,16,0,397,0
2020-05-20,Russia,NA,Tomsk Oblast,1078280,12,0,409,0
2020-05-21,Russia,NA,Tomsk Oblast,1078280,20,0,429,0
2020-05-22,Russia,NA,Tomsk Oblast,1078280,21,0,450,0
2020-05-23,Russia,NA,Tomsk Oblast,1078280,29,0,479,0
2020-05-24,Russia,NA,Tomsk Oblast,1078280,28,0,507,0
2020-05-25,Russia,NA,Tomsk Oblast,1078280,29,0,536,0
2020-05-26,Russia,NA,Tomsk Oblast,1078280,28,0,564,0
2020-05-27,Russia,NA,Tomsk Oblast,1078280,31,0,595,0
2020-05-28,Russia,NA,Tomsk Oblast,1078280,27,0,622,0
2020-05-29,Russia,NA,Tomsk Oblast,1078280,23,0,645,0
2020-05-30,Russia,NA,Tomsk Oblast,1078280,22,0,667,0
2020-05-31,Russia,NA,Tomsk Oblast,1078280,21,0,688,0
2020-06-01,Russia,NA,Tomsk Oblast,1078280,28,0,716,0
2020-06-02,Russia,NA,Tomsk Oblast,1078280,23,0,739,0
2020-06-03,Russia,NA,Tomsk Oblast,1078280,26,0,765,0
2020-06-04,Russia,NA,Tomsk Oblast,1078280,32,0,797,0
2020-06-05,Russia,NA,Tomsk Oblast,1078280,35,0,832,0
2020-06-06,Russia,NA,Tomsk Oblast,1078280,36,0,868,0
2020-06-07,Russia,NA,Tomsk Oblast,1078280,54,0,922,0
2020-06-08,Russia,NA,Tomsk Oblast,1078280,49,0,971,0
2020-06-09,Russia,NA,Tomsk Oblast,1078280,47,0,1018,0
2020-06-10,Russia,NA,Tomsk Oblast,1078280,48,0,1066,0
2020-06-11,Russia,NA,Tomsk Oblast,1078280,50,0,1116,0
2020-06-12,Russia,NA,Tomsk Oblast,1078280,51,0,1167,0
2020-06-13,Russia,NA,Tomsk Oblast,1078280,48,0,1215,0
2020-06-14,Russia,NA,Tomsk Oblast,1078280,53,0,1268,0
2020-06-15,Russia,NA,Tomsk Oblast,1078280,46,0,1314,0
2020-06-16,Russia,NA,Tomsk Oblast,1078280,56,0,1370,0
2020-06-17,Russia,NA,Tomsk Oblast,1078280,56,0,1426,0
2020-06-18,Russia,NA,Tomsk Oblast,1078280,89,0,1515,0
2020-06-19,Russia,NA,Tomsk Oblast,1078280,83,0,1598,0
2020-06-20,Russia,NA,Tomsk Oblast,1078280,69,0,1667,0
2020-06-21,Russia,NA,Tomsk Oblast,1078280,58,0,1725,0
2020-06-22,Russia,NA,Tomsk Oblast,1078280,60,0,1785,0
2020-06-23,Russia,NA,Tomsk Oblast,1078280,61,0,1846,0
2020-06-24,Russia,NA,Tomsk Oblast,1078280,63,0,1909,0
2020-06-25,Russia,NA,Tomsk Oblast,1078280,59,0,1968,0
2020-06-26,Russia,NA,Tomsk Oblast,1078280,63,0,2031,0
2020-06-27,Russia,NA,Tomsk Oblast,1078280,58,0,2089,0
2020-06-28,Russia,NA,Tomsk Oblast,1078280,55,0,2144,0
2020-06-29,Russia,NA,Tomsk Oblast,1078280,53,0,2197,0
2020-06-30,Russia,NA,Tomsk Oblast,1078280,57,0,2254,0
2020-07-01,Russia,NA,Tomsk Oblast,1078280,53,0,2307,0
2020-07-02,Russia,NA,Tomsk Oblast,1078280,57,0,2364,0
2020-07-03,Russia,NA,Tomsk Oblast,1078280,53,0,2417,0
2020-07-04,Russia,NA,Tomsk Oblast,1078280,63,0,2480,0
2020-07-05,Russia,NA,Tomsk Oblast,1078280,77,0,2557,0
2020-07-06,Russia,NA,Tomsk Oblast,1078280,51,0,2608,0
2020-07-07,Russia,NA,Tomsk Oblast,1078280,53,0,2661,0
2020-07-08,Russia,NA,Tomsk Oblast,1078280,56,0,2717,0
2020-07-09,Russia,NA,Tomsk Oblast,1078280,54,0,2771,0
2020-07-10,Russia,NA,Tomsk Oblast,1078280,75,0,2846,0
2020-07-11,Russia,NA,Tomsk Oblast,1078280,69,0,2915,0
2020-07-12,Russia,NA,Tomsk Oblast,1078280,59,0,2974,0
2020-07-13,Russia,NA,Tomsk Oblast,1078280,67,0,3041,0
2020-07-14,Russia,NA,Tomsk Oblast,1078280,71,0,3112,0
2020-07-15,Russia,NA,Tomsk Oblast,1078280,61,0,3173,0
2020-07-16,Russia,NA,Tomsk Oblast,1078280,89,0,3262,0
2020-07-17,Russia,NA,Tomsk Oblast,1078280,52,0,3314,0
2020-07-18,Russia,NA,Tomsk Oblast,1078280,61,0,3375,0
2020-07-19,Russia,NA,Tomsk Oblast,1078280,60,0,3435,0
2020-07-20,Russia,NA,Tomsk Oblast,1078280,58,0,3493,0
2020-07-21,Russia,NA,Tomsk Oblast,1078280,115,0,3608,0
2020-07-22,Russia,NA,Tomsk Oblast,1078280,53,0,3661,0
2020-07-23,Russia,NA,Tomsk Oblast,1078280,56,0,3717,0
2020-07-24,Russia,NA,Tomsk Oblast,1078280,49,0,3766,0
2020-07-25,Russia,NA,Tomsk Oblast,1078280,55,0,3821,0
2020-07-26,Russia,NA,Tomsk Oblast,1078280,51,0,3872,0
2020-07-27,Russia,NA,Tomsk Oblast,1078280,54,0,3926,0
2020-07-28,Russia,NA,Tomsk Oblast,1078280,53,0,3979,0
2020-07-29,Russia,NA,Tomsk Oblast,1078280,61,0,4040,0
2020-07-30,Russia,NA,Tomsk Oblast,1078280,51,0,4091,0
2020-07-31,Russia,NA,Tomsk Oblast,1078280,59,0,4150,0
2020-08-01,Russia,NA,Tomsk Oblast,1078280,60,0,4210,0
2020-08-02,Russia,NA,Tomsk Oblast,1078280,51,0,4261,0
2020-08-26,Russia,NA,Tomsk Oblast,1078280,0,0,5409,62
2020-08-27,Russia,NA,Tomsk Oblast,1078280,43,2,5452,64
2020-08-28,Russia,NA,Tomsk Oblast,1078280,42,1,5494,65
2020-08-29,Russia,NA,Tomsk Oblast,1078280,42,1,5536,66
2020-08-30,Russia,NA,Tomsk Oblast,1078280,60,1,5596,67
2020-08-31,Russia,NA,Tomsk Oblast,1078280,110,2,5706,69
2020-09-01,Russia,NA,Tomsk Oblast,1078280,42,0,5748,69
2020-09-02,Russia,NA,Tomsk Oblast,1078280,47,0,5795,69
2020-09-03,Russia,NA,Tomsk Oblast,1078280,44,0,5839,69
2020-09-04,Russia,NA,Tomsk Oblast,1078280,51,2,5890,71
2020-09-05,Russia,NA,Tomsk Oblast,1078280,52,0,5942,71
2020-09-06,Russia,NA,Tomsk Oblast,1078280,52,1,5994,72
2020-09-07,Russia,NA,Tomsk Oblast,1078280,45,0,6039,72
2020-09-08,Russia,NA,Tomsk Oblast,1078280,55,0,6094,72
2020-09-09,Russia,NA,Tomsk Oblast,1078280,53,2,6147,74
2020-09-10,Russia,NA,Tomsk Oblast,1078280,56,0,6203,74
2020-09-11,Russia,NA,Tomsk Oblast,1078280,61,1,6264,75
2020-09-12,Russia,NA,Tomsk Oblast,1078280,55,0,6319,75
2020-09-13,Russia,NA,Tomsk Oblast,1078280,50,1,6369,76
2020-09-14,Russia,NA,Tomsk Oblast,1078280,52,0,6421,76
2020-09-15,Russia,NA,Tomsk Oblast,1078280,58,1,6479,77
2020-09-16,Russia,NA,Tomsk Oblast,1078280,51,0,6530,77
2020-09-17,Russia,NA,Tomsk Oblast,1078280,53,0,6583,77
2020-09-18,Russia,NA,Tomsk Oblast,1078280,62,1,6645,78
2020-09-19,Russia,NA,Tomsk Oblast,1078280,68,0,6713,78
2020-09-20,Russia,NA,Tomsk Oblast,1078280,62,1,6775,79
2020-09-21,Russia,NA,Tomsk Oblast,1078280,59,0,6834,79
2020-09-22,Russia,NA,Tomsk Oblast,1078280,61,0,6895,79
2020-09-23,Russia,NA,Tomsk Oblast,1078280,65,2,6960,81
2020-03-28,Russia,NA,Tula Oblast,1491855,3,0,11,0
2020-03-30,Russia,NA,Tula Oblast,1491855,1,0,12,0
2020-04-01,Russia,NA,Tula Oblast,1491855,5,0,17,0
2020-04-04,Russia,NA,Tula Oblast,1491855,2,0,19,0
2020-04-05,Russia,NA,Tula Oblast,1491855,10,0,29,0
2020-04-06,Russia,NA,Tula Oblast,1491855,10,0,39,0
2020-04-07,Russia,NA,Tula Oblast,1491855,10,0,49,0
2020-04-08,Russia,NA,Tula Oblast,1491855,5,0,54,0
2020-04-09,Russia,NA,Tula Oblast,1491855,12,0,66,0
2020-04-10,Russia,NA,Tula Oblast,1491855,5,0,71,0
2020-04-12,Russia,NA,Tula Oblast,1491855,4,0,75,0
2020-04-13,Russia,NA,Tula Oblast,1491855,11,0,86,0
2020-04-15,Russia,NA,Tula Oblast,1491855,45,0,131,0
2020-04-16,Russia,NA,Tula Oblast,1491855,44,0,175,0
2020-04-17,Russia,NA,Tula Oblast,1491855,25,0,200,0
2020-04-18,Russia,NA,Tula Oblast,1491855,30,0,230,0
2020-04-19,Russia,NA,Tula Oblast,1491855,58,0,288,0
2020-04-20,Russia,NA,Tula Oblast,1491855,22,0,310,0
2020-04-21,Russia,NA,Tula Oblast,1491855,75,0,385,0
2020-04-22,Russia,NA,Tula Oblast,1491855,52,0,437,0
2020-04-23,Russia,NA,Tula Oblast,1491855,25,0,462,0
2020-04-24,Russia,NA,Tula Oblast,1491855,44,0,506,0
2020-04-25,Russia,NA,Tula Oblast,1491855,73,0,579,0
2020-04-26,Russia,NA,Tula Oblast,1491855,66,0,645,0
2020-04-27,Russia,NA,Tula Oblast,1491855,69,0,714,0
2020-04-28,Russia,NA,Tula Oblast,1491855,70,0,784,0
2020-04-29,Russia,NA,Tula Oblast,1491855,90,0,874,0
2020-04-30,Russia,NA,Tula Oblast,1491855,92,0,966,0
2020-05-01,Russia,NA,Tula Oblast,1491855,82,0,1048,0
2020-05-02,Russia,NA,Tula Oblast,1491855,88,0,1136,0
2020-05-03,Russia,NA,Tula Oblast,1491855,83,0,1219,0
2020-05-04,Russia,NA,Tula Oblast,1491855,75,0,1294,0
2020-05-05,Russia,NA,Tula Oblast,1491855,75,0,1369,0
2020-05-06,Russia,NA,Tula Oblast,1491855,77,0,1446,0
2020-05-07,Russia,NA,Tula Oblast,1491855,85,0,1531,0
2020-05-08,Russia,NA,Tula Oblast,1491855,90,0,1621,0
2020-05-09,Russia,NA,Tula Oblast,1491855,86,0,1707,0
2020-05-10,Russia,NA,Tula Oblast,1491855,89,0,1796,0
2020-05-11,Russia,NA,Tula Oblast,1491855,86,0,1882,0
2020-05-12,Russia,NA,Tula Oblast,1491855,90,0,1972,0
2020-05-13,Russia,NA,Tula Oblast,1491855,89,0,2061,0
2020-05-14,Russia,NA,Tula Oblast,1491855,98,0,2159,0
2020-05-15,Russia,NA,Tula Oblast,1491855,105,0,2264,0
2020-05-16,Russia,NA,Tula Oblast,1491855,101,0,2365,0
2020-05-17,Russia,NA,Tula Oblast,1491855,97,0,2462,0
2020-05-18,Russia,NA,Tula Oblast,1491855,84,0,2546,0
2020-05-19,Russia,NA,Tula Oblast,1491855,92,0,2638,0
2020-05-20,Russia,NA,Tula Oblast,1491855,98,0,2736,0
2020-05-21,Russia,NA,Tula Oblast,1491855,89,0,2825,0
2020-05-22,Russia,NA,Tula Oblast,1491855,91,0,2916,0
2020-05-23,Russia,NA,Tula Oblast,1491855,90,0,3006,0
2020-05-24,Russia,NA,Tula Oblast,1491855,97,0,3103,0
2020-05-25,Russia,NA,Tula Oblast,1491855,111,0,3214,0
2020-05-26,Russia,NA,Tula Oblast,1491855,105,0,3319,0
2020-05-27,Russia,NA,Tula Oblast,1491855,104,0,3423,0
2020-05-28,Russia,NA,Tula Oblast,1491855,110,0,3533,0
2020-05-29,Russia,NA,Tula Oblast,1491855,112,0,3645,0
2020-05-30,Russia,NA,Tula Oblast,1491855,107,0,3752,0
2020-05-31,Russia,NA,Tula Oblast,1491855,104,0,3856,0
2020-06-01,Russia,NA,Tula Oblast,1491855,113,0,3969,0
2020-06-02,Russia,NA,Tula Oblast,1491855,106,0,4075,0
2020-06-03,Russia,NA,Tula Oblast,1491855,109,0,4184,0
2020-06-04,Russia,NA,Tula Oblast,1491855,110,0,4294,0
2020-06-05,Russia,NA,Tula Oblast,1491855,105,0,4399,0
2020-06-06,Russia,NA,Tula Oblast,1491855,107,0,4506,0
2020-06-07,Russia,NA,Tula Oblast,1491855,115,0,4621,0
2020-06-08,Russia,NA,Tula Oblast,1491855,114,0,4735,0
2020-06-09,Russia,NA,Tula Oblast,1491855,109,0,4844,0
2020-06-10,Russia,NA,Tula Oblast,1491855,103,0,4947,0
2020-06-11,Russia,NA,Tula Oblast,1491855,101,0,5048,0
2020-06-12,Russia,NA,Tula Oblast,1491855,100,0,5148,0
2020-06-13,Russia,NA,Tula Oblast,1491855,98,0,5246,0
2020-06-14,Russia,NA,Tula Oblast,1491855,95,0,5341,0
2020-06-15,Russia,NA,Tula Oblast,1491855,96,0,5437,0
2020-06-16,Russia,NA,Tula Oblast,1491855,93,0,5530,0
2020-06-17,Russia,NA,Tula Oblast,1491855,91,0,5621,0
2020-06-18,Russia,NA,Tula Oblast,1491855,92,0,5713,0
2020-06-19,Russia,NA,Tula Oblast,1491855,90,0,5803,0
2020-06-20,Russia,NA,Tula Oblast,1491855,85,0,5888,0
2020-06-21,Russia,NA,Tula Oblast,1491855,86,0,5974,0
2020-06-22,Russia,NA,Tula Oblast,1491855,83,0,6057,0
2020-06-23,Russia,NA,Tula Oblast,1491855,81,0,6138,0
2020-06-24,Russia,NA,Tula Oblast,1491855,83,0,6221,0
2020-06-25,Russia,NA,Tula Oblast,1491855,82,0,6303,0
2020-06-26,Russia,NA,Tula Oblast,1491855,80,0,6383,0
2020-06-27,Russia,NA,Tula Oblast,1491855,78,0,6461,0
2020-06-28,Russia,NA,Tula Oblast,1491855,76,0,6537,0
2020-06-29,Russia,NA,Tula Oblast,1491855,77,0,6614,0
2020-06-30,Russia,NA,Tula Oblast,1491855,73,0,6687,0
2020-07-01,Russia,NA,Tula Oblast,1491855,76,0,6763,0
2020-07-02,Russia,NA,Tula Oblast,1491855,74,0,6837,0
2020-07-03,Russia,NA,Tula Oblast,1491855,72,0,6909,0
2020-07-04,Russia,NA,Tula Oblast,1491855,68,0,6977,0
2020-07-05,Russia,NA,Tula Oblast,1491855,70,0,7047,0
2020-07-06,Russia,NA,Tula Oblast,1491855,69,0,7116,0
2020-07-07,Russia,NA,Tula Oblast,1491855,67,0,7183,0
2020-07-08,Russia,NA,Tula Oblast,1491855,66,0,7249,0
2020-07-09,Russia,NA,Tula Oblast,1491855,64,0,7313,0
2020-07-10,Russia,NA,Tula Oblast,1491855,64,0,7377,0
2020-07-11,Russia,NA,Tula Oblast,1491855,63,0,7440,0
2020-07-12,Russia,NA,Tula Oblast,1491855,61,0,7501,0
2020-07-13,Russia,NA,Tula Oblast,1491855,68,0,7569,0
2020-07-14,Russia,NA,Tula Oblast,1491855,61,0,7630,0
2020-07-15,Russia,NA,Tula Oblast,1491855,59,0,7689,0
2020-07-16,Russia,NA,Tula Oblast,1491855,57,0,7746,0
2020-07-17,Russia,NA,Tula Oblast,1491855,51,0,7797,0
2020-07-18,Russia,NA,Tula Oblast,1491855,49,0,7846,0
2020-07-19,Russia,NA,Tula Oblast,1491855,45,0,7891,0
2020-07-20,Russia,NA,Tula Oblast,1491855,43,0,7934,0
2020-07-21,Russia,NA,Tula Oblast,1491855,44,0,7978,0
2020-07-22,Russia,NA,Tula Oblast,1491855,41,0,8019,0
2020-07-23,Russia,NA,Tula Oblast,1491855,38,0,8057,0
2020-07-24,Russia,NA,Tula Oblast,1491855,37,0,8094,0
2020-07-25,Russia,NA,Tula Oblast,1491855,37,0,8131,0
2020-07-26,Russia,NA,Tula Oblast,1491855,35,0,8166,0
2020-07-27,Russia,NA,Tula Oblast,1491855,33,0,8199,0
2020-07-28,Russia,NA,Tula Oblast,1491855,32,0,8231,0
2020-07-29,Russia,NA,Tula Oblast,1491855,31,0,8262,0
2020-07-30,Russia,NA,Tula Oblast,1491855,32,0,8294,0
2020-07-31,Russia,NA,Tula Oblast,1491855,30,0,8324,0
2020-08-01,Russia,NA,Tula Oblast,1491855,28,0,8352,0
2020-08-02,Russia,NA,Tula Oblast,1491855,28,0,8380,0
2020-08-26,Russia,NA,Tula Oblast,1491855,0,0,9114,313
2020-08-27,Russia,NA,Tula Oblast,1491855,26,2,9140,315
2020-08-28,Russia,NA,Tula Oblast,1491855,27,2,9167,317
2020-08-29,Russia,NA,Tula Oblast,1491855,29,1,9196,318
2020-08-30,Russia,NA,Tula Oblast,1491855,30,2,9226,320
2020-08-31,Russia,NA,Tula Oblast,1491855,28,2,9254,322
2020-09-01,Russia,NA,Tula Oblast,1491855,29,2,9283,324
2020-09-02,Russia,NA,Tula Oblast,1491855,30,1,9313,325
2020-09-03,Russia,NA,Tula Oblast,1491855,28,2,9341,327
2020-09-04,Russia,NA,Tula Oblast,1491855,27,2,9368,329
2020-09-05,Russia,NA,Tula Oblast,1491855,30,2,9398,331
2020-09-06,Russia,NA,Tula Oblast,1491855,29,2,9427,333
2020-09-07,Russia,NA,Tula Oblast,1491855,27,2,9454,335
2020-09-08,Russia,NA,Tula Oblast,1491855,28,2,9482,337
2020-09-09,Russia,NA,Tula Oblast,1491855,31,2,9513,339
2020-09-10,Russia,NA,Tula Oblast,1491855,29,2,9542,341
2020-09-11,Russia,NA,Tula Oblast,1491855,27,2,9569,343
2020-09-12,Russia,NA,Tula Oblast,1491855,26,2,9595,345
2020-09-13,Russia,NA,Tula Oblast,1491855,28,2,9623,347
2020-09-14,Russia,NA,Tula Oblast,1491855,31,1,9654,348
2020-09-15,Russia,NA,Tula Oblast,1491855,32,2,9686,350
2020-09-16,Russia,NA,Tula Oblast,1491855,30,1,9716,351
2020-09-17,Russia,NA,Tula Oblast,1491855,32,2,9748,353
2020-09-18,Russia,NA,Tula Oblast,1491855,31,1,9779,354
2020-09-19,Russia,NA,Tula Oblast,1491855,29,2,9808,356
2020-09-20,Russia,NA,Tula Oblast,1491855,32,2,9840,358
2020-09-21,Russia,NA,Tula Oblast,1491855,32,1,9872,359
2020-09-22,Russia,NA,Tula Oblast,1491855,31,2,9903,361
2020-09-23,Russia,NA,Tula Oblast,1491855,32,2,9935,363
2020-04-19,Russia,NA,Tuva,321722,4,0,13,0
2020-04-23,Russia,NA,Tuva,321722,1,0,14,0
2020-04-24,Russia,NA,Tuva,321722,1,0,15,0
2020-04-25,Russia,NA,Tuva,321722,9,0,24,0
2020-04-26,Russia,NA,Tuva,321722,3,0,27,0
2020-04-27,Russia,NA,Tuva,321722,3,0,30,0
2020-04-28,Russia,NA,Tuva,321722,1,0,31,0
2020-04-30,Russia,NA,Tuva,321722,2,0,33,0
2020-05-01,Russia,NA,Tuva,321722,6,0,39,0
2020-05-02,Russia,NA,Tuva,321722,2,0,41,0
2020-05-03,Russia,NA,Tuva,321722,3,0,44,0
2020-05-04,Russia,NA,Tuva,321722,4,0,48,0
2020-05-05,Russia,NA,Tuva,321722,4,0,52,0
2020-05-07,Russia,NA,Tuva,321722,4,0,56,0
2020-05-08,Russia,NA,Tuva,321722,1,0,57,0
2020-05-09,Russia,NA,Tuva,321722,4,0,61,0
2020-05-10,Russia,NA,Tuva,321722,21,0,82,0
2020-05-11,Russia,NA,Tuva,321722,12,0,94,0
2020-05-12,Russia,NA,Tuva,321722,51,0,145,0
2020-05-13,Russia,NA,Tuva,321722,13,0,158,0
2020-05-14,Russia,NA,Tuva,321722,39,0,197,0
2020-05-15,Russia,NA,Tuva,321722,26,0,223,0
2020-05-16,Russia,NA,Tuva,321722,30,0,253,0
2020-05-17,Russia,NA,Tuva,321722,17,0,270,0
2020-05-18,Russia,NA,Tuva,321722,30,0,300,0
2020-05-19,Russia,NA,Tuva,321722,52,0,352,0
2020-05-20,Russia,NA,Tuva,321722,56,0,408,0
2020-05-21,Russia,NA,Tuva,321722,44,0,452,0
2020-05-22,Russia,NA,Tuva,321722,79,0,531,0
2020-05-23,Russia,NA,Tuva,321722,46,0,577,0
2020-05-24,Russia,NA,Tuva,321722,52,0,629,0
2020-05-25,Russia,NA,Tuva,321722,78,0,707,0
2020-05-26,Russia,NA,Tuva,321722,54,0,761,0
2020-05-27,Russia,NA,Tuva,321722,58,0,819,0
2020-05-28,Russia,NA,Tuva,321722,58,0,877,0
2020-05-29,Russia,NA,Tuva,321722,66,0,943,0
2020-05-30,Russia,NA,Tuva,321722,55,0,998,0
2020-05-31,Russia,NA,Tuva,321722,58,0,1056,0
2020-06-01,Russia,NA,Tuva,321722,60,0,1116,0
2020-06-02,Russia,NA,Tuva,321722,46,0,1162,0
2020-06-03,Russia,NA,Tuva,321722,60,0,1222,0
2020-06-04,Russia,NA,Tuva,321722,76,0,1298,0
2020-06-05,Russia,NA,Tuva,321722,94,0,1392,0
2020-06-06,Russia,NA,Tuva,321722,98,0,1490,0
2020-06-07,Russia,NA,Tuva,321722,118,0,1608,0
2020-06-08,Russia,NA,Tuva,321722,131,0,1739,0
2020-06-09,Russia,NA,Tuva,321722,97,0,1836,0
2020-06-10,Russia,NA,Tuva,321722,79,0,1915,0
2020-06-11,Russia,NA,Tuva,321722,113,0,2028,0
2020-06-12,Russia,NA,Tuva,321722,176,0,2204,0
2020-06-13,Russia,NA,Tuva,321722,101,0,2305,0
2020-06-14,Russia,NA,Tuva,321722,190,0,2495,0
2020-06-15,Russia,NA,Tuva,321722,72,0,2567,0
2020-06-16,Russia,NA,Tuva,321722,85,0,2652,0
2020-06-17,Russia,NA,Tuva,321722,110,0,2762,0
2020-06-18,Russia,NA,Tuva,321722,122,0,2884,0
2020-06-19,Russia,NA,Tuva,321722,115,0,2999,0
2020-06-20,Russia,NA,Tuva,321722,140,0,3139,0
2020-06-21,Russia,NA,Tuva,321722,147,0,3286,0
2020-06-22,Russia,NA,Tuva,321722,150,0,3436,0
2020-06-23,Russia,NA,Tuva,321722,140,0,3576,0
2020-06-24,Russia,NA,Tuva,321722,138,0,3714,0
2020-06-25,Russia,NA,Tuva,321722,140,0,3854,0
2020-06-26,Russia,NA,Tuva,321722,130,0,3984,0
2020-06-27,Russia,NA,Tuva,321722,128,0,4112,0
2020-06-28,Russia,NA,Tuva,321722,124,0,4236,0
2020-06-29,Russia,NA,Tuva,321722,126,0,4362,0
2020-06-30,Russia,NA,Tuva,321722,125,0,4487,0
2020-07-01,Russia,NA,Tuva,321722,119,0,4606,0
2020-07-02,Russia,NA,Tuva,321722,112,0,4718,0
2020-07-03,Russia,NA,Tuva,321722,110,0,4828,0
2020-07-04,Russia,NA,Tuva,321722,100,0,4928,0
2020-07-05,Russia,NA,Tuva,321722,81,0,5009,0
2020-07-06,Russia,NA,Tuva,321722,75,0,5084,0
2020-07-07,Russia,NA,Tuva,321722,73,0,5157,0
2020-07-08,Russia,NA,Tuva,321722,70,0,5227,0
2020-07-09,Russia,NA,Tuva,321722,54,0,5281,0
2020-07-10,Russia,NA,Tuva,321722,45,0,5326,0
2020-07-11,Russia,NA,Tuva,321722,40,0,5366,0
2020-07-12,Russia,NA,Tuva,321722,39,0,5405,0
2020-07-13,Russia,NA,Tuva,321722,40,0,5445,0
2020-07-14,Russia,NA,Tuva,321722,46,0,5491,0
2020-07-15,Russia,NA,Tuva,321722,47,0,5538,0
2020-07-16,Russia,NA,Tuva,321722,45,0,5583,0
2020-07-17,Russia,NA,Tuva,321722,32,0,5615,0
2020-07-18,Russia,NA,Tuva,321722,38,0,5653,0
2020-07-19,Russia,NA,Tuva,321722,40,0,5693,0
2020-07-20,Russia,NA,Tuva,321722,40,0,5733,0
2020-07-21,Russia,NA,Tuva,321722,45,0,5778,0
2020-07-22,Russia,NA,Tuva,321722,35,0,5813,0
2020-07-23,Russia,NA,Tuva,321722,35,0,5848,0
2020-07-24,Russia,NA,Tuva,321722,36,0,5884,0
2020-07-25,Russia,NA,Tuva,321722,41,0,5925,0
2020-07-26,Russia,NA,Tuva,321722,32,0,5957,0
2020-07-27,Russia,NA,Tuva,321722,32,0,5989,0
2020-07-28,Russia,NA,Tuva,321722,30,0,6019,0
2020-07-29,Russia,NA,Tuva,321722,30,0,6049,0
2020-07-30,Russia,NA,Tuva,321722,32,0,6081,0
2020-07-31,Russia,NA,Tuva,321722,29,0,6110,0
2020-08-01,Russia,NA,Tuva,321722,28,0,6138,0
2020-08-02,Russia,NA,Tuva,321722,22,0,6160,0
2020-08-26,Russia,NA,Tuva,321722,0,0,6706,60
2020-08-27,Russia,NA,Tuva,321722,24,0,6730,60
2020-08-28,Russia,NA,Tuva,321722,17,0,6747,60
2020-08-29,Russia,NA,Tuva,321722,23,0,6770,60
2020-08-30,Russia,NA,Tuva,321722,26,5,6796,65
2020-08-31,Russia,NA,Tuva,321722,28,0,6824,65
2020-09-01,Russia,NA,Tuva,321722,17,0,6841,65
2020-09-02,Russia,NA,Tuva,321722,21,0,6862,65
2020-09-03,Russia,NA,Tuva,321722,28,0,6890,65
2020-09-04,Russia,NA,Tuva,321722,23,0,6913,65
2020-09-05,Russia,NA,Tuva,321722,21,0,6934,65
2020-09-06,Russia,NA,Tuva,321722,22,0,6956,65
2020-09-07,Russia,NA,Tuva,321722,27,0,6983,65
2020-09-08,Russia,NA,Tuva,321722,24,0,7007,65
2020-09-09,Russia,NA,Tuva,321722,25,2,7032,67
2020-09-10,Russia,NA,Tuva,321722,17,0,7049,67
2020-09-11,Russia,NA,Tuva,321722,24,0,7073,67
2020-09-12,Russia,NA,Tuva,321722,26,0,7099,67
2020-09-13,Russia,NA,Tuva,321722,31,0,7130,67
2020-09-14,Russia,NA,Tuva,321722,26,0,7156,67
2020-09-15,Russia,NA,Tuva,321722,31,0,7187,67
2020-09-16,Russia,NA,Tuva,321722,35,0,7222,67
2020-09-17,Russia,NA,Tuva,321722,33,0,7255,67
2020-09-18,Russia,NA,Tuva,321722,36,4,7291,71
2020-09-19,Russia,NA,Tuva,321722,30,0,7321,71
2020-09-20,Russia,NA,Tuva,321722,36,0,7357,71
2020-09-21,Russia,NA,Tuva,321722,38,0,7395,71
2020-09-22,Russia,NA,Tuva,321722,40,8,7435,79
2020-09-23,Russia,NA,Tuva,321722,44,4,7479,83
2020-04-08,Russia,NA,Tver Oblast,1283873,4,0,12,0
2020-04-09,Russia,NA,Tver Oblast,1283873,7,0,19,0
2020-04-10,Russia,NA,Tver Oblast,1283873,5,0,24,0
2020-04-11,Russia,NA,Tver Oblast,1283873,7,0,31,0
2020-04-13,Russia,NA,Tver Oblast,1283873,44,0,75,0
2020-04-15,Russia,NA,Tver Oblast,1283873,42,0,117,0
2020-04-16,Russia,NA,Tver Oblast,1283873,34,0,151,0
2020-04-17,Russia,NA,Tver Oblast,1283873,37,0,188,0
2020-04-18,Russia,NA,Tver Oblast,1283873,49,0,237,0
2020-04-19,Russia,NA,Tver Oblast,1283873,33,0,270,0
2020-04-20,Russia,NA,Tver Oblast,1283873,26,0,296,0
2020-04-21,Russia,NA,Tver Oblast,1283873,33,0,329,0
2020-04-22,Russia,NA,Tver Oblast,1283873,27,0,356,0
2020-04-23,Russia,NA,Tver Oblast,1283873,27,0,383,0
2020-04-24,Russia,NA,Tver Oblast,1283873,29,0,412,0
2020-04-25,Russia,NA,Tver Oblast,1283873,29,0,441,0
2020-04-26,Russia,NA,Tver Oblast,1283873,23,0,464,0
2020-04-27,Russia,NA,Tver Oblast,1283873,34,0,498,0
2020-04-28,Russia,NA,Tver Oblast,1283873,9,0,507,0
2020-04-29,Russia,NA,Tver Oblast,1283873,11,0,518,0
2020-04-30,Russia,NA,Tver Oblast,1283873,17,0,535,0
2020-05-01,Russia,NA,Tver Oblast,1283873,29,0,564,0
2020-05-02,Russia,NA,Tver Oblast,1283873,46,0,610,0
2020-05-03,Russia,NA,Tver Oblast,1283873,51,0,661,0
2020-05-04,Russia,NA,Tver Oblast,1283873,19,0,680,0
2020-05-05,Russia,NA,Tver Oblast,1283873,29,0,709,0
2020-05-06,Russia,NA,Tver Oblast,1283873,44,0,753,0
2020-05-07,Russia,NA,Tver Oblast,1283873,16,0,769,0
2020-05-08,Russia,NA,Tver Oblast,1283873,45,0,814,0
2020-05-09,Russia,NA,Tver Oblast,1283873,38,0,852,0
2020-05-10,Russia,NA,Tver Oblast,1283873,45,0,897,0
2020-05-11,Russia,NA,Tver Oblast,1283873,31,0,928,0
2020-05-12,Russia,NA,Tver Oblast,1283873,34,0,962,0
2020-05-13,Russia,NA,Tver Oblast,1283873,10,0,972,0
2020-05-14,Russia,NA,Tver Oblast,1283873,20,0,992,0
2020-05-15,Russia,NA,Tver Oblast,1283873,44,0,1036,0
2020-05-16,Russia,NA,Tver Oblast,1283873,53,0,1089,0
2020-05-17,Russia,NA,Tver Oblast,1283873,26,0,1115,0
2020-05-18,Russia,NA,Tver Oblast,1283873,27,0,1142,0
2020-05-19,Russia,NA,Tver Oblast,1283873,19,0,1161,0
2020-05-20,Russia,NA,Tver Oblast,1283873,33,0,1194,0
2020-05-21,Russia,NA,Tver Oblast,1283873,39,0,1233,0
2020-05-22,Russia,NA,Tver Oblast,1283873,39,0,1272,0
2020-05-23,Russia,NA,Tver Oblast,1283873,31,0,1303,0
2020-05-24,Russia,NA,Tver Oblast,1283873,37,0,1340,0
2020-05-25,Russia,NA,Tver Oblast,1283873,53,0,1393,0
2020-05-26,Russia,NA,Tver Oblast,1283873,15,0,1408,0
2020-05-27,Russia,NA,Tver Oblast,1283873,46,0,1454,0
2020-05-28,Russia,NA,Tver Oblast,1283873,52,0,1506,0
2020-05-29,Russia,NA,Tver Oblast,1283873,41,0,1547,0
2020-05-30,Russia,NA,Tver Oblast,1283873,43,0,1590,0
2020-05-31,Russia,NA,Tver Oblast,1283873,44,0,1634,0
2020-06-01,Russia,NA,Tver Oblast,1283873,46,0,1680,0
2020-06-02,Russia,NA,Tver Oblast,1283873,45,0,1725,0
2020-06-03,Russia,NA,Tver Oblast,1283873,36,0,1761,0
2020-06-04,Russia,NA,Tver Oblast,1283873,73,0,1834,0
2020-06-05,Russia,NA,Tver Oblast,1283873,71,0,1905,0
2020-06-06,Russia,NA,Tver Oblast,1283873,87,0,1992,0
2020-06-07,Russia,NA,Tver Oblast,1283873,93,0,2085,0
2020-06-08,Russia,NA,Tver Oblast,1283873,92,0,2177,0
2020-06-09,Russia,NA,Tver Oblast,1283873,84,0,2261,0
2020-06-10,Russia,NA,Tver Oblast,1283873,83,0,2344,0
2020-06-11,Russia,NA,Tver Oblast,1283873,83,0,2427,0
2020-06-12,Russia,NA,Tver Oblast,1283873,91,0,2518,0
2020-06-13,Russia,NA,Tver Oblast,1283873,81,0,2599,0
2020-06-14,Russia,NA,Tver Oblast,1283873,81,0,2680,0
2020-06-15,Russia,NA,Tver Oblast,1283873,78,0,2758,0
2020-06-16,Russia,NA,Tver Oblast,1283873,72,0,2830,0
2020-06-17,Russia,NA,Tver Oblast,1283873,69,0,2899,0
2020-06-18,Russia,NA,Tver Oblast,1283873,65,0,2964,0
2020-06-19,Russia,NA,Tver Oblast,1283873,67,0,3031,0
2020-06-20,Russia,NA,Tver Oblast,1283873,67,0,3098,0
2020-06-21,Russia,NA,Tver Oblast,1283873,66,0,3164,0
2020-06-22,Russia,NA,Tver Oblast,1283873,63,0,3227,0
2020-06-23,Russia,NA,Tver Oblast,1283873,59,0,3286,0
2020-06-24,Russia,NA,Tver Oblast,1283873,55,0,3341,0
2020-06-25,Russia,NA,Tver Oblast,1283873,53,0,3394,0
2020-06-26,Russia,NA,Tver Oblast,1283873,55,0,3449,0
2020-06-27,Russia,NA,Tver Oblast,1283873,52,0,3501,0
2020-06-28,Russia,NA,Tver Oblast,1283873,53,0,3554,0
2020-06-29,Russia,NA,Tver Oblast,1283873,50,0,3604,0
2020-06-30,Russia,NA,Tver Oblast,1283873,48,0,3652,0
2020-07-01,Russia,NA,Tver Oblast,1283873,46,0,3698,0
2020-07-02,Russia,NA,Tver Oblast,1283873,44,0,3742,0
2020-07-03,Russia,NA,Tver Oblast,1283873,41,0,3783,0
2020-07-04,Russia,NA,Tver Oblast,1283873,42,0,3825,0
2020-07-05,Russia,NA,Tver Oblast,1283873,40,0,3865,0
2020-07-06,Russia,NA,Tver Oblast,1283873,38,0,3903,0
2020-07-07,Russia,NA,Tver Oblast,1283873,36,0,3939,0
2020-07-08,Russia,NA,Tver Oblast,1283873,32,0,3971,0
2020-07-09,Russia,NA,Tver Oblast,1283873,30,0,4001,0
2020-07-10,Russia,NA,Tver Oblast,1283873,30,0,4031,0
2020-07-11,Russia,NA,Tver Oblast,1283873,32,0,4063,0
2020-07-12,Russia,NA,Tver Oblast,1283873,31,0,4094,0
2020-07-13,Russia,NA,Tver Oblast,1283873,31,0,4125,0
2020-07-14,Russia,NA,Tver Oblast,1283873,29,0,4154,0
2020-07-15,Russia,NA,Tver Oblast,1283873,29,0,4183,0
2020-07-16,Russia,NA,Tver Oblast,1283873,30,0,4213,0
2020-07-17,Russia,NA,Tver Oblast,1283873,28,0,4241,0
2020-07-18,Russia,NA,Tver Oblast,1283873,26,0,4267,0
2020-07-19,Russia,NA,Tver Oblast,1283873,26,0,4293,0
2020-07-20,Russia,NA,Tver Oblast,1283873,25,0,4318,0
2020-07-21,Russia,NA,Tver Oblast,1283873,24,0,4342,0
2020-07-22,Russia,NA,Tver Oblast,1283873,26,0,4368,0
2020-07-23,Russia,NA,Tver Oblast,1283873,28,0,4396,0
2020-07-24,Russia,NA,Tver Oblast,1283873,27,0,4423,0
2020-07-25,Russia,NA,Tver Oblast,1283873,30,0,4453,0
2020-07-26,Russia,NA,Tver Oblast,1283873,28,0,4481,0
2020-07-27,Russia,NA,Tver Oblast,1283873,27,0,4508,0
2020-07-28,Russia,NA,Tver Oblast,1283873,27,0,4535,0
2020-07-29,Russia,NA,Tver Oblast,1283873,29,0,4564,0
2020-07-30,Russia,NA,Tver Oblast,1283873,33,0,4597,0
2020-07-31,Russia,NA,Tver Oblast,1283873,30,0,4627,0
2020-08-01,Russia,NA,Tver Oblast,1283873,29,0,4656,0
2020-08-02,Russia,NA,Tver Oblast,1283873,29,0,4685,0
2020-08-26,Russia,NA,Tver Oblast,1283873,0,0,5284,181
2020-08-27,Russia,NA,Tver Oblast,1283873,24,3,5308,184
2020-08-28,Russia,NA,Tver Oblast,1283873,25,3,5333,187
2020-08-29,Russia,NA,Tver Oblast,1283873,24,2,5357,189
2020-08-30,Russia,NA,Tver Oblast,1283873,26,2,5383,191
2020-08-31,Russia,NA,Tver Oblast,1283873,24,2,5407,193
2020-09-01,Russia,NA,Tver Oblast,1283873,25,2,5432,195
2020-09-02,Russia,NA,Tver Oblast,1283873,23,1,5455,196
2020-09-03,Russia,NA,Tver Oblast,1283873,22,3,5477,199
2020-09-04,Russia,NA,Tver Oblast,1283873,23,3,5500,202
2020-09-05,Russia,NA,Tver Oblast,1283873,24,3,5524,205
2020-09-06,Russia,NA,Tver Oblast,1283873,23,2,5547,207
2020-09-07,Russia,NA,Tver Oblast,1283873,22,2,5569,209
2020-09-08,Russia,NA,Tver Oblast,1283873,23,1,5592,210
2020-09-09,Russia,NA,Tver Oblast,1283873,20,2,5612,212
2020-09-10,Russia,NA,Tver Oblast,1283873,23,2,5635,214
2020-09-11,Russia,NA,Tver Oblast,1283873,21,2,5656,216
2020-09-12,Russia,NA,Tver Oblast,1283873,24,1,5680,217
2020-09-13,Russia,NA,Tver Oblast,1283873,24,0,5704,217
2020-09-14,Russia,NA,Tver Oblast,1283873,25,0,5729,217
2020-09-15,Russia,NA,Tver Oblast,1283873,26,0,5755,217
2020-09-16,Russia,NA,Tver Oblast,1283873,25,1,5780,218
2020-09-17,Russia,NA,Tver Oblast,1283873,24,3,5804,221
2020-09-18,Russia,NA,Tver Oblast,1283873,28,2,5832,223
2020-09-19,Russia,NA,Tver Oblast,1283873,30,4,5862,227
2020-09-20,Russia,NA,Tver Oblast,1283873,33,1,5895,228
2020-09-21,Russia,NA,Tver Oblast,1283873,35,0,5930,228
2020-09-22,Russia,NA,Tver Oblast,1283873,34,2,5964,230
2020-09-23,Russia,NA,Tver Oblast,1283873,35,1,5999,231
2020-04-03,Russia,NA,Tyumen Oblast,3692400,5,0,11,0
2020-04-07,Russia,NA,Tyumen Oblast,3692400,7,0,18,0
2020-04-09,Russia,NA,Tyumen Oblast,3692400,1,0,19,0
2020-04-10,Russia,NA,Tyumen Oblast,3692400,3,0,22,0
2020-04-11,Russia,NA,Tyumen Oblast,3692400,8,0,30,0
2020-04-12,Russia,NA,Tyumen Oblast,3692400,9,0,39,0
2020-04-13,Russia,NA,Tyumen Oblast,3692400,14,0,53,0
2020-04-14,Russia,NA,Tyumen Oblast,3692400,14,0,67,0
2020-04-15,Russia,NA,Tyumen Oblast,3692400,18,0,85,0
2020-04-16,Russia,NA,Tyumen Oblast,3692400,27,0,112,0
2020-04-17,Russia,NA,Tyumen Oblast,3692400,34,0,146,0
2020-04-18,Russia,NA,Tyumen Oblast,3692400,39,0,185,0
2020-04-19,Russia,NA,Tyumen Oblast,3692400,42,0,227,0
2020-04-20,Russia,NA,Tyumen Oblast,3692400,27,0,254,0
2020-04-21,Russia,NA,Tyumen Oblast,3692400,36,0,290,0
2020-04-22,Russia,NA,Tyumen Oblast,3692400,29,0,319,0
2020-04-23,Russia,NA,Tyumen Oblast,3692400,22,0,341,0
2020-04-24,Russia,NA,Tyumen Oblast,3692400,16,0,357,0
2020-04-25,Russia,NA,Tyumen Oblast,3692400,17,0,374,0
2020-04-26,Russia,NA,Tyumen Oblast,3692400,12,0,386,0
2020-04-27,Russia,NA,Tyumen Oblast,3692400,13,0,399,0
2020-04-28,Russia,NA,Tyumen Oblast,3692400,5,0,404,0
2020-04-29,Russia,NA,Tyumen Oblast,3692400,16,0,420,0
2020-04-30,Russia,NA,Tyumen Oblast,3692400,15,0,435,0
2020-05-01,Russia,NA,Tyumen Oblast,3692400,7,0,442,0
2020-05-02,Russia,NA,Tyumen Oblast,3692400,16,0,458,0
2020-05-03,Russia,NA,Tyumen Oblast,3692400,37,0,495,0
2020-05-04,Russia,NA,Tyumen Oblast,3692400,66,0,561,0
2020-05-05,Russia,NA,Tyumen Oblast,3692400,28,0,589,0
2020-05-06,Russia,NA,Tyumen Oblast,3692400,69,0,658,0
2020-05-07,Russia,NA,Tyumen Oblast,3692400,25,0,683,0
2020-05-08,Russia,NA,Tyumen Oblast,3692400,24,0,707,0
2020-05-09,Russia,NA,Tyumen Oblast,3692400,23,0,730,0
2020-05-10,Russia,NA,Tyumen Oblast,3692400,73,0,803,0
2020-05-11,Russia,NA,Tyumen Oblast,3692400,29,0,832,0
2020-05-12,Russia,NA,Tyumen Oblast,3692400,70,0,902,0
2020-05-13,Russia,NA,Tyumen Oblast,3692400,75,0,977,0
2020-05-14,Russia,NA,Tyumen Oblast,3692400,41,0,1018,0
2020-05-15,Russia,NA,Tyumen Oblast,3692400,39,0,1057,0
2020-05-16,Russia,NA,Tyumen Oblast,3692400,45,0,1102,0
2020-05-17,Russia,NA,Tyumen Oblast,3692400,33,0,1135,0
2020-05-18,Russia,NA,Tyumen Oblast,3692400,46,0,1181,0
2020-05-19,Russia,NA,Tyumen Oblast,3692400,46,0,1227,0
2020-05-20,Russia,NA,Tyumen Oblast,3692400,40,0,1267,0
2020-05-21,Russia,NA,Tyumen Oblast,3692400,11,0,1278,0
2020-05-22,Russia,NA,Tyumen Oblast,3692400,53,0,1331,0
2020-05-23,Russia,NA,Tyumen Oblast,3692400,35,0,1366,0
2020-05-24,Russia,NA,Tyumen Oblast,3692400,45,0,1411,0
2020-05-25,Russia,NA,Tyumen Oblast,3692400,37,0,1448,0
2020-05-26,Russia,NA,Tyumen Oblast,3692400,42,0,1490,0
2020-05-27,Russia,NA,Tyumen Oblast,3692400,42,0,1532,0
2020-05-28,Russia,NA,Tyumen Oblast,3692400,30,0,1562,0
2020-05-29,Russia,NA,Tyumen Oblast,3692400,18,0,1580,0
2020-05-30,Russia,NA,Tyumen Oblast,3692400,28,0,1608,0
2020-05-31,Russia,NA,Tyumen Oblast,3692400,30,0,1638,0
2020-06-01,Russia,NA,Tyumen Oblast,3692400,23,0,1661,0
2020-06-02,Russia,NA,Tyumen Oblast,3692400,41,0,1702,0
2020-06-03,Russia,NA,Tyumen Oblast,3692400,47,0,1749,0
2020-06-04,Russia,NA,Tyumen Oblast,3692400,49,0,1798,0
2020-06-05,Russia,NA,Tyumen Oblast,3692400,36,0,1834,0
2020-06-06,Russia,NA,Tyumen Oblast,3692400,39,0,1873,0
2020-06-07,Russia,NA,Tyumen Oblast,3692400,35,0,1908,0
2020-06-08,Russia,NA,Tyumen Oblast,3692400,39,0,1947,0
2020-06-09,Russia,NA,Tyumen Oblast,3692400,34,0,1981,0
2020-06-10,Russia,NA,Tyumen Oblast,3692400,32,0,2013,0
2020-06-11,Russia,NA,Tyumen Oblast,3692400,34,0,2047,0
2020-06-12,Russia,NA,Tyumen Oblast,3692400,22,0,2069,0
2020-06-13,Russia,NA,Tyumen Oblast,3692400,50,0,2119,0
2020-06-14,Russia,NA,Tyumen Oblast,3692400,77,0,2196,0
2020-06-15,Russia,NA,Tyumen Oblast,3692400,73,0,2269,0
2020-06-16,Russia,NA,Tyumen Oblast,3692400,61,0,2330,0
2020-06-17,Russia,NA,Tyumen Oblast,3692400,52,0,2382,0
2020-06-18,Russia,NA,Tyumen Oblast,3692400,51,0,2433,0
2020-06-19,Russia,NA,Tyumen Oblast,3692400,47,0,2480,0
2020-06-20,Russia,NA,Tyumen Oblast,3692400,49,0,2529,0
2020-06-21,Russia,NA,Tyumen Oblast,3692400,45,0,2574,0
2020-06-22,Russia,NA,Tyumen Oblast,3692400,47,0,2621,0
2020-06-23,Russia,NA,Tyumen Oblast,3692400,46,0,2667,0
2020-06-24,Russia,NA,Tyumen Oblast,3692400,50,0,2717,0
2020-06-25,Russia,NA,Tyumen Oblast,3692400,49,0,2766,0
2020-06-26,Russia,NA,Tyumen Oblast,3692400,61,0,2827,0
2020-06-27,Russia,NA,Tyumen Oblast,3692400,59,0,2886,0
2020-06-28,Russia,NA,Tyumen Oblast,3692400,67,0,2953,0
2020-06-29,Russia,NA,Tyumen Oblast,3692400,65,0,3018,0
2020-06-30,Russia,NA,Tyumen Oblast,3692400,69,0,3087,0
2020-07-01,Russia,NA,Tyumen Oblast,3692400,68,0,3155,0
2020-07-02,Russia,NA,Tyumen Oblast,3692400,76,0,3231,0
2020-07-03,Russia,NA,Tyumen Oblast,3692400,85,0,3316,0
2020-07-04,Russia,NA,Tyumen Oblast,3692400,81,0,3397,0
2020-07-05,Russia,NA,Tyumen Oblast,3692400,83,0,3480,0
2020-07-06,Russia,NA,Tyumen Oblast,3692400,80,0,3560,0
2020-07-07,Russia,NA,Tyumen Oblast,3692400,78,0,3638,0
2020-07-08,Russia,NA,Tyumen Oblast,3692400,75,0,3713,0
2020-07-09,Russia,NA,Tyumen Oblast,3692400,72,0,3785,0
2020-07-10,Russia,NA,Tyumen Oblast,3692400,85,0,3870,0
2020-07-11,Russia,NA,Tyumen Oblast,3692400,82,0,3952,0
2020-07-12,Russia,NA,Tyumen Oblast,3692400,83,0,4035,0
2020-07-13,Russia,NA,Tyumen Oblast,3692400,85,0,4120,0
2020-07-14,Russia,NA,Tyumen Oblast,3692400,84,0,4204,0
2020-07-15,Russia,NA,Tyumen Oblast,3692400,82,0,4286,0
2020-07-16,Russia,NA,Tyumen Oblast,3692400,81,0,4367,0
2020-07-17,Russia,NA,Tyumen Oblast,3692400,84,0,4451,0
2020-07-18,Russia,NA,Tyumen Oblast,3692400,109,0,4560,0
2020-07-19,Russia,NA,Tyumen Oblast,3692400,107,0,4667,0
2020-07-20,Russia,NA,Tyumen Oblast,3692400,112,0,4779,0
2020-07-21,Russia,NA,Tyumen Oblast,3692400,106,0,4885,0
2020-07-22,Russia,NA,Tyumen Oblast,3692400,102,0,4987,0
2020-07-23,Russia,NA,Tyumen Oblast,3692400,103,0,5090,0
2020-07-24,Russia,NA,Tyumen Oblast,3692400,100,0,5190,0
2020-07-25,Russia,NA,Tyumen Oblast,3692400,101,0,5291,0
2020-07-26,Russia,NA,Tyumen Oblast,3692400,98,0,5389,0
2020-07-27,Russia,NA,Tyumen Oblast,3692400,95,0,5484,0
2020-07-28,Russia,NA,Tyumen Oblast,3692400,92,0,5576,0
2020-07-29,Russia,NA,Tyumen Oblast,3692400,90,0,5666,0
2020-07-30,Russia,NA,Tyumen Oblast,3692400,89,0,5755,0
2020-07-31,Russia,NA,Tyumen Oblast,3692400,89,0,5844,0
2020-08-01,Russia,NA,Tyumen Oblast,3692400,85,0,5929,0
2020-08-02,Russia,NA,Tyumen Oblast,3692400,90,0,6019,0
2020-08-26,Russia,NA,Tyumen Oblast,3692400,0,0,7528,30
2020-08-27,Russia,NA,Tyumen Oblast,3692400,47,0,7575,30
2020-08-28,Russia,NA,Tyumen Oblast,3692400,48,0,7623,30
2020-08-29,Russia,NA,Tyumen Oblast,3692400,50,0,7673,30
2020-08-30,Russia,NA,Tyumen Oblast,3692400,51,0,7724,30
2020-08-31,Russia,NA,Tyumen Oblast,3692400,47,0,7771,30
2020-09-01,Russia,NA,Tyumen Oblast,3692400,49,1,7820,31
2020-09-02,Russia,NA,Tyumen Oblast,3692400,45,0,7865,31
2020-09-03,Russia,NA,Tyumen Oblast,3692400,49,0,7914,31
2020-09-04,Russia,NA,Tyumen Oblast,3692400,47,0,7961,31
2020-09-05,Russia,NA,Tyumen Oblast,3692400,51,0,8012,31
2020-09-06,Russia,NA,Tyumen Oblast,3692400,50,0,8062,31
2020-09-07,Russia,NA,Tyumen Oblast,3692400,49,0,8111,31
2020-09-08,Russia,NA,Tyumen Oblast,3692400,47,0,8158,31
2020-09-09,Russia,NA,Tyumen Oblast,3692400,48,0,8206,31
2020-09-10,Russia,NA,Tyumen Oblast,3692400,51,0,8257,31
2020-09-11,Russia,NA,Tyumen Oblast,3692400,53,0,8310,31
2020-09-12,Russia,NA,Tyumen Oblast,3692400,50,0,8360,31
2020-09-13,Russia,NA,Tyumen Oblast,3692400,55,0,8415,31
2020-09-14,Russia,NA,Tyumen Oblast,3692400,54,0,8469,31
2020-09-15,Russia,NA,Tyumen Oblast,3692400,51,1,8520,32
2020-09-16,Russia,NA,Tyumen Oblast,3692400,54,0,8574,32
2020-09-17,Russia,NA,Tyumen Oblast,3692400,57,0,8631,32
2020-09-18,Russia,NA,Tyumen Oblast,3692400,59,3,8690,35
2020-09-19,Russia,NA,Tyumen Oblast,3692400,64,1,8754,36
2020-09-20,Russia,NA,Tyumen Oblast,3692400,62,0,8816,36
2020-09-21,Russia,NA,Tyumen Oblast,3692400,65,0,8881,36
2020-09-22,Russia,NA,Tyumen Oblast,3692400,61,0,8942,36
2020-09-23,Russia,NA,Tyumen Oblast,3692400,63,0,9005,36
2020-04-10,Russia,NA,Udmurtia,1513044,2,0,11,0
2020-04-12,Russia,NA,Udmurtia,1513044,2,0,13,0
2020-04-14,Russia,NA,Udmurtia,1513044,6,0,19,0
2020-04-15,Russia,NA,Udmurtia,1513044,8,0,27,0
2020-04-16,Russia,NA,Udmurtia,1513044,15,0,42,0
2020-04-17,Russia,NA,Udmurtia,1513044,16,0,58,0
2020-04-18,Russia,NA,Udmurtia,1513044,4,0,62,0
2020-04-19,Russia,NA,Udmurtia,1513044,4,0,66,0
2020-04-20,Russia,NA,Udmurtia,1513044,26,0,92,0
2020-04-21,Russia,NA,Udmurtia,1513044,26,0,118,0
2020-04-22,Russia,NA,Udmurtia,1513044,34,0,152,0
2020-04-23,Russia,NA,Udmurtia,1513044,9,0,161,0
2020-04-24,Russia,NA,Udmurtia,1513044,17,0,178,0
2020-04-25,Russia,NA,Udmurtia,1513044,15,0,193,0
2020-04-26,Russia,NA,Udmurtia,1513044,9,0,202,0
2020-04-27,Russia,NA,Udmurtia,1513044,5,0,207,0
2020-04-28,Russia,NA,Udmurtia,1513044,5,0,212,0
2020-04-29,Russia,NA,Udmurtia,1513044,5,0,217,0
2020-04-30,Russia,NA,Udmurtia,1513044,11,0,228,0
2020-05-01,Russia,NA,Udmurtia,1513044,9,0,237,0
2020-05-02,Russia,NA,Udmurtia,1513044,7,0,244,0
2020-05-03,Russia,NA,Udmurtia,1513044,27,0,271,0
2020-05-04,Russia,NA,Udmurtia,1513044,43,0,314,0
2020-05-05,Russia,NA,Udmurtia,1513044,18,0,332,0
2020-05-06,Russia,NA,Udmurtia,1513044,12,0,344,0
2020-05-08,Russia,NA,Udmurtia,1513044,1,0,345,0
2020-05-09,Russia,NA,Udmurtia,1513044,7,0,352,0
2020-05-10,Russia,NA,Udmurtia,1513044,18,0,370,0
2020-05-11,Russia,NA,Udmurtia,1513044,19,0,389,0
2020-05-12,Russia,NA,Udmurtia,1513044,6,0,395,0
2020-05-14,Russia,NA,Udmurtia,1513044,7,0,402,0
2020-05-15,Russia,NA,Udmurtia,1513044,6,0,408,0
2020-05-16,Russia,NA,Udmurtia,1513044,14,0,422,0
2020-05-17,Russia,NA,Udmurtia,1513044,14,0,436,0
2020-05-18,Russia,NA,Udmurtia,1513044,5,0,441,0
2020-05-19,Russia,NA,Udmurtia,1513044,11,0,452,0
2020-05-20,Russia,NA,Udmurtia,1513044,6,0,458,0
2020-05-21,Russia,NA,Udmurtia,1513044,5,0,463,0
2020-05-22,Russia,NA,Udmurtia,1513044,14,0,477,0
2020-05-23,Russia,NA,Udmurtia,1513044,15,0,492,0
2020-05-24,Russia,NA,Udmurtia,1513044,18,0,510,0
2020-05-25,Russia,NA,Udmurtia,1513044,19,0,529,0
2020-05-26,Russia,NA,Udmurtia,1513044,20,0,549,0
2020-05-27,Russia,NA,Udmurtia,1513044,10,0,559,0
2020-05-28,Russia,NA,Udmurtia,1513044,24,0,583,0
2020-05-29,Russia,NA,Udmurtia,1513044,22,0,605,0
2020-05-30,Russia,NA,Udmurtia,1513044,24,0,629,0
2020-05-31,Russia,NA,Udmurtia,1513044,23,0,652,0
2020-06-01,Russia,NA,Udmurtia,1513044,30,0,682,0
2020-06-02,Russia,NA,Udmurtia,1513044,35,0,717,0
2020-06-03,Russia,NA,Udmurtia,1513044,53,0,770,0
2020-06-04,Russia,NA,Udmurtia,1513044,52,0,822,0
2020-06-05,Russia,NA,Udmurtia,1513044,43,0,865,0
2020-06-06,Russia,NA,Udmurtia,1513044,39,0,904,0
2020-06-07,Russia,NA,Udmurtia,1513044,32,0,936,0
2020-06-08,Russia,NA,Udmurtia,1513044,27,0,963,0
2020-06-09,Russia,NA,Udmurtia,1513044,24,0,987,0
2020-06-10,Russia,NA,Udmurtia,1513044,24,0,1011,0
2020-06-11,Russia,NA,Udmurtia,1513044,20,0,1031,0
2020-06-12,Russia,NA,Udmurtia,1513044,22,0,1053,0
2020-06-13,Russia,NA,Udmurtia,1513044,20,0,1073,0
2020-06-14,Russia,NA,Udmurtia,1513044,21,0,1094,0
2020-06-15,Russia,NA,Udmurtia,1513044,20,0,1114,0
2020-06-16,Russia,NA,Udmurtia,1513044,19,0,1133,0
2020-06-17,Russia,NA,Udmurtia,1513044,20,0,1153,0
2020-06-18,Russia,NA,Udmurtia,1513044,22,0,1175,0
2020-06-19,Russia,NA,Udmurtia,1513044,20,0,1195,0
2020-06-20,Russia,NA,Udmurtia,1513044,21,0,1216,0
2020-06-21,Russia,NA,Udmurtia,1513044,19,0,1235,0
2020-06-22,Russia,NA,Udmurtia,1513044,19,0,1254,0
2020-06-23,Russia,NA,Udmurtia,1513044,18,0,1272,0
2020-06-24,Russia,NA,Udmurtia,1513044,22,0,1294,0
2020-06-25,Russia,NA,Udmurtia,1513044,20,0,1314,0
2020-06-26,Russia,NA,Udmurtia,1513044,20,0,1334,0
2020-06-27,Russia,NA,Udmurtia,1513044,23,0,1357,0
2020-06-28,Russia,NA,Udmurtia,1513044,22,0,1379,0
2020-06-29,Russia,NA,Udmurtia,1513044,21,0,1400,0
2020-06-30,Russia,NA,Udmurtia,1513044,20,0,1420,0
2020-07-01,Russia,NA,Udmurtia,1513044,20,0,1440,0
2020-07-02,Russia,NA,Udmurtia,1513044,19,0,1459,0
2020-07-03,Russia,NA,Udmurtia,1513044,17,0,1476,0
2020-07-04,Russia,NA,Udmurtia,1513044,23,0,1499,0
2020-07-05,Russia,NA,Udmurtia,1513044,20,0,1519,0
2020-07-06,Russia,NA,Udmurtia,1513044,18,0,1537,0
2020-07-07,Russia,NA,Udmurtia,1513044,17,0,1554,0
2020-07-08,Russia,NA,Udmurtia,1513044,38,0,1592,0
2020-07-09,Russia,NA,Udmurtia,1513044,31,0,1623,0
2020-07-10,Russia,NA,Udmurtia,1513044,29,0,1652,0
2020-07-11,Russia,NA,Udmurtia,1513044,49,0,1701,0
2020-07-12,Russia,NA,Udmurtia,1513044,46,0,1747,0
2020-07-13,Russia,NA,Udmurtia,1513044,45,0,1792,0
2020-07-14,Russia,NA,Udmurtia,1513044,42,0,1834,0
2020-07-15,Russia,NA,Udmurtia,1513044,46,0,1880,0
2020-07-16,Russia,NA,Udmurtia,1513044,43,0,1923,0
2020-07-17,Russia,NA,Udmurtia,1513044,43,0,1966,0
2020-07-18,Russia,NA,Udmurtia,1513044,40,0,2006,0
2020-07-19,Russia,NA,Udmurtia,1513044,38,0,2044,0
2020-07-20,Russia,NA,Udmurtia,1513044,35,0,2079,0
2020-07-21,Russia,NA,Udmurtia,1513044,32,0,2111,0
2020-07-22,Russia,NA,Udmurtia,1513044,31,0,2142,0
2020-07-23,Russia,NA,Udmurtia,1513044,31,0,2173,0
2020-07-24,Russia,NA,Udmurtia,1513044,29,0,2202,0
2020-07-25,Russia,NA,Udmurtia,1513044,27,0,2229,0
2020-07-26,Russia,NA,Udmurtia,1513044,25,0,2254,0
2020-07-27,Russia,NA,Udmurtia,1513044,25,0,2279,0
2020-07-28,Russia,NA,Udmurtia,1513044,24,0,2303,0
2020-07-29,Russia,NA,Udmurtia,1513044,20,0,2323,0
2020-07-30,Russia,NA,Udmurtia,1513044,18,0,2341,0
2020-07-31,Russia,NA,Udmurtia,1513044,19,0,2360,0
2020-08-01,Russia,NA,Udmurtia,1513044,18,0,2378,0
2020-08-02,Russia,NA,Udmurtia,1513044,20,0,2398,0
2020-08-26,Russia,NA,Udmurtia,1513044,0,0,3040,45
2020-08-27,Russia,NA,Udmurtia,1513044,22,0,3062,45
2020-08-28,Russia,NA,Udmurtia,1513044,30,0,3092,45
2020-08-29,Russia,NA,Udmurtia,1513044,31,0,3123,45
2020-08-30,Russia,NA,Udmurtia,1513044,27,0,3150,45
2020-08-31,Russia,NA,Udmurtia,1513044,29,0,3179,45
2020-09-01,Russia,NA,Udmurtia,1513044,32,0,3211,45
2020-09-02,Russia,NA,Udmurtia,1513044,38,0,3249,45
2020-09-03,Russia,NA,Udmurtia,1513044,45,0,3294,45
2020-09-04,Russia,NA,Udmurtia,1513044,49,0,3343,45
2020-09-05,Russia,NA,Udmurtia,1513044,49,4,3392,49
2020-09-06,Russia,NA,Udmurtia,1513044,51,0,3443,49
2020-09-07,Russia,NA,Udmurtia,1513044,48,0,3491,49
2020-09-08,Russia,NA,Udmurtia,1513044,52,2,3543,51
2020-09-09,Russia,NA,Udmurtia,1513044,50,0,3593,51
2020-09-10,Russia,NA,Udmurtia,1513044,55,3,3648,54
2020-09-11,Russia,NA,Udmurtia,1513044,64,0,3712,54
2020-09-12,Russia,NA,Udmurtia,1513044,61,0,3773,54
2020-09-13,Russia,NA,Udmurtia,1513044,63,0,3836,54
2020-09-14,Russia,NA,Udmurtia,1513044,60,0,3896,54
2020-09-15,Russia,NA,Udmurtia,1513044,65,1,3961,55
2020-09-16,Russia,NA,Udmurtia,1513044,72,2,4033,57
2020-09-17,Russia,NA,Udmurtia,1513044,70,2,4103,59
2020-09-18,Russia,NA,Udmurtia,1513044,67,0,4170,59
2020-09-19,Russia,NA,Udmurtia,1513044,75,3,4245,62
2020-09-20,Russia,NA,Udmurtia,1513044,82,0,4327,62
2020-09-21,Russia,NA,Udmurtia,1513044,81,0,4408,62
2020-09-22,Russia,NA,Udmurtia,1513044,85,0,4493,62
2020-09-23,Russia,NA,Udmurtia,1513044,84,3,4577,65
2020-04-10,Russia,NA,Ulyanovsk Oblast,1246618,34,0,40,0
2020-04-11,Russia,NA,Ulyanovsk Oblast,1246618,22,0,62,0
2020-04-12,Russia,NA,Ulyanovsk Oblast,1246618,8,0,70,0
2020-04-13,Russia,NA,Ulyanovsk Oblast,1246618,16,0,86,0
2020-04-15,Russia,NA,Ulyanovsk Oblast,1246618,18,0,104,0
2020-04-16,Russia,NA,Ulyanovsk Oblast,1246618,19,0,123,0
2020-04-17,Russia,NA,Ulyanovsk Oblast,1246618,15,0,138,0
2020-04-18,Russia,NA,Ulyanovsk Oblast,1246618,19,0,157,0
2020-04-19,Russia,NA,Ulyanovsk Oblast,1246618,11,0,168,0
2020-04-20,Russia,NA,Ulyanovsk Oblast,1246618,19,0,187,0
2020-04-22,Russia,NA,Ulyanovsk Oblast,1246618,9,0,196,0
2020-04-23,Russia,NA,Ulyanovsk Oblast,1246618,32,0,228,0
2020-04-24,Russia,NA,Ulyanovsk Oblast,1246618,25,0,253,0
2020-04-25,Russia,NA,Ulyanovsk Oblast,1246618,27,0,280,0
2020-04-26,Russia,NA,Ulyanovsk Oblast,1246618,27,0,307,0
2020-04-27,Russia,NA,Ulyanovsk Oblast,1246618,24,0,331,0
2020-04-28,Russia,NA,Ulyanovsk Oblast,1246618,29,0,360,0
2020-04-29,Russia,NA,Ulyanovsk Oblast,1246618,19,0,379,0
2020-04-30,Russia,NA,Ulyanovsk Oblast,1246618,27,0,406,0
2020-05-01,Russia,NA,Ulyanovsk Oblast,1246618,23,0,429,0
2020-05-02,Russia,NA,Ulyanovsk Oblast,1246618,32,0,461,0
2020-05-03,Russia,NA,Ulyanovsk Oblast,1246618,38,0,499,0
2020-05-04,Russia,NA,Ulyanovsk Oblast,1246618,29,0,528,0
2020-05-05,Russia,NA,Ulyanovsk Oblast,1246618,16,0,544,0
2020-05-06,Russia,NA,Ulyanovsk Oblast,1246618,29,0,573,0
2020-05-07,Russia,NA,Ulyanovsk Oblast,1246618,32,0,605,0
2020-05-08,Russia,NA,Ulyanovsk Oblast,1246618,76,0,681,0
2020-05-09,Russia,NA,Ulyanovsk Oblast,1246618,84,0,765,0
2020-05-10,Russia,NA,Ulyanovsk Oblast,1246618,42,0,807,0
2020-05-11,Russia,NA,Ulyanovsk Oblast,1246618,41,0,848,0
2020-05-12,Russia,NA,Ulyanovsk Oblast,1246618,38,0,886,0
2020-05-13,Russia,NA,Ulyanovsk Oblast,1246618,46,0,932,0
2020-05-14,Russia,NA,Ulyanovsk Oblast,1246618,80,0,1012,0
2020-05-15,Russia,NA,Ulyanovsk Oblast,1246618,69,0,1081,0
2020-05-16,Russia,NA,Ulyanovsk Oblast,1246618,78,0,1159,0
2020-05-17,Russia,NA,Ulyanovsk Oblast,1246618,101,0,1260,0
2020-05-18,Russia,NA,Ulyanovsk Oblast,1246618,106,0,1366,0
2020-05-19,Russia,NA,Ulyanovsk Oblast,1246618,96,0,1462,0
2020-05-20,Russia,NA,Ulyanovsk Oblast,1246618,64,0,1526,0
2020-05-21,Russia,NA,Ulyanovsk Oblast,1246618,70,0,1596,0
2020-05-22,Russia,NA,Ulyanovsk Oblast,1246618,70,0,1666,0
2020-05-23,Russia,NA,Ulyanovsk Oblast,1246618,98,0,1764,0
2020-05-24,Russia,NA,Ulyanovsk Oblast,1246618,97,0,1861,0
2020-05-25,Russia,NA,Ulyanovsk Oblast,1246618,98,0,1959,0
2020-05-26,Russia,NA,Ulyanovsk Oblast,1246618,92,0,2051,0
2020-05-27,Russia,NA,Ulyanovsk Oblast,1246618,70,0,2121,0
2020-05-28,Russia,NA,Ulyanovsk Oblast,1246618,75,0,2196,0
2020-05-29,Russia,NA,Ulyanovsk Oblast,1246618,75,0,2271,0
2020-05-30,Russia,NA,Ulyanovsk Oblast,1246618,98,0,2369,0
2020-05-31,Russia,NA,Ulyanovsk Oblast,1246618,97,0,2466,0
2020-06-01,Russia,NA,Ulyanovsk Oblast,1246618,101,0,2567,0
2020-06-02,Russia,NA,Ulyanovsk Oblast,1246618,105,0,2672,0
2020-06-03,Russia,NA,Ulyanovsk Oblast,1246618,98,0,2770,0
2020-06-04,Russia,NA,Ulyanovsk Oblast,1246618,100,0,2870,0
2020-06-05,Russia,NA,Ulyanovsk Oblast,1246618,95,0,2965,0
2020-06-06,Russia,NA,Ulyanovsk Oblast,1246618,109,0,3074,0
2020-06-07,Russia,NA,Ulyanovsk Oblast,1246618,94,0,3168,0
2020-06-08,Russia,NA,Ulyanovsk Oblast,1246618,97,0,3265,0
2020-06-09,Russia,NA,Ulyanovsk Oblast,1246618,94,0,3359,0
2020-06-10,Russia,NA,Ulyanovsk Oblast,1246618,91,0,3450,0
2020-06-11,Russia,NA,Ulyanovsk Oblast,1246618,88,0,3538,0
2020-06-12,Russia,NA,Ulyanovsk Oblast,1246618,95,0,3633,0
2020-06-13,Russia,NA,Ulyanovsk Oblast,1246618,150,0,3783,0
2020-06-14,Russia,NA,Ulyanovsk Oblast,1246618,119,0,3902,0
2020-06-15,Russia,NA,Ulyanovsk Oblast,1246618,146,0,4048,0
2020-06-16,Russia,NA,Ulyanovsk Oblast,1246618,147,0,4195,0
2020-06-17,Russia,NA,Ulyanovsk Oblast,1246618,149,0,4344,0
2020-06-18,Russia,NA,Ulyanovsk Oblast,1246618,123,0,4467,0
2020-06-19,Russia,NA,Ulyanovsk Oblast,1246618,122,0,4589,0
2020-06-20,Russia,NA,Ulyanovsk Oblast,1246618,111,0,4700,0
2020-06-21,Russia,NA,Ulyanovsk Oblast,1246618,110,0,4810,0
2020-06-22,Russia,NA,Ulyanovsk Oblast,1246618,110,0,4920,0
2020-06-23,Russia,NA,Ulyanovsk Oblast,1246618,106,0,5026,0
2020-06-24,Russia,NA,Ulyanovsk Oblast,1246618,107,0,5133,0
2020-06-25,Russia,NA,Ulyanovsk Oblast,1246618,109,0,5242,0
2020-06-26,Russia,NA,Ulyanovsk Oblast,1246618,110,0,5352,0
2020-06-27,Russia,NA,Ulyanovsk Oblast,1246618,109,0,5461,0
2020-06-28,Russia,NA,Ulyanovsk Oblast,1246618,106,0,5567,0
2020-06-29,Russia,NA,Ulyanovsk Oblast,1246618,107,0,5674,0
2020-06-30,Russia,NA,Ulyanovsk Oblast,1246618,106,0,5780,0
2020-07-01,Russia,NA,Ulyanovsk Oblast,1246618,108,0,5888,0
2020-07-02,Russia,NA,Ulyanovsk Oblast,1246618,105,0,5993,0
2020-07-03,Russia,NA,Ulyanovsk Oblast,1246618,103,0,6096,0
2020-07-04,Russia,NA,Ulyanovsk Oblast,1246618,107,0,6203,0
2020-07-05,Russia,NA,Ulyanovsk Oblast,1246618,105,0,6308,0
2020-07-06,Russia,NA,Ulyanovsk Oblast,1246618,107,0,6415,0
2020-07-07,Russia,NA,Ulyanovsk Oblast,1246618,105,0,6520,0
2020-07-08,Russia,NA,Ulyanovsk Oblast,1246618,108,0,6628,0
2020-07-09,Russia,NA,Ulyanovsk Oblast,1246618,105,0,6733,0
2020-07-10,Russia,NA,Ulyanovsk Oblast,1246618,103,0,6836,0
2020-07-11,Russia,NA,Ulyanovsk Oblast,1246618,108,0,6944,0
2020-07-12,Russia,NA,Ulyanovsk Oblast,1246618,107,0,7051,0
2020-07-13,Russia,NA,Ulyanovsk Oblast,1246618,111,0,7162,0
2020-07-14,Russia,NA,Ulyanovsk Oblast,1246618,110,0,7272,0
2020-07-15,Russia,NA,Ulyanovsk Oblast,1246618,110,0,7382,0
2020-07-16,Russia,NA,Ulyanovsk Oblast,1246618,111,0,7493,0
2020-07-17,Russia,NA,Ulyanovsk Oblast,1246618,103,0,7596,0
2020-07-18,Russia,NA,Ulyanovsk Oblast,1246618,110,0,7706,0
2020-07-19,Russia,NA,Ulyanovsk Oblast,1246618,112,0,7818,0
2020-07-20,Russia,NA,Ulyanovsk Oblast,1246618,109,0,7927,0
2020-07-21,Russia,NA,Ulyanovsk Oblast,1246618,110,0,8037,0
2020-07-22,Russia,NA,Ulyanovsk Oblast,1246618,100,0,8137,0
2020-07-23,Russia,NA,Ulyanovsk Oblast,1246618,110,0,8247,0
2020-07-24,Russia,NA,Ulyanovsk Oblast,1246618,110,0,8357,0
2020-07-25,Russia,NA,Ulyanovsk Oblast,1246618,104,0,8461,0
2020-07-26,Russia,NA,Ulyanovsk Oblast,1246618,108,0,8569,0
2020-07-27,Russia,NA,Ulyanovsk Oblast,1246618,102,0,8671,0
2020-07-28,Russia,NA,Ulyanovsk Oblast,1246618,110,0,8781,0
2020-07-29,Russia,NA,Ulyanovsk Oblast,1246618,104,0,8885,0
2020-07-30,Russia,NA,Ulyanovsk Oblast,1246618,110,0,8995,0
2020-07-31,Russia,NA,Ulyanovsk Oblast,1246618,100,0,9095,0
2020-08-01,Russia,NA,Ulyanovsk Oblast,1246618,110,0,9205,0
2020-08-02,Russia,NA,Ulyanovsk Oblast,1246618,102,0,9307,0
2020-08-26,Russia,NA,Ulyanovsk Oblast,1246618,0,0,11638,91
2020-08-27,Russia,NA,Ulyanovsk Oblast,1246618,80,0,11718,91
2020-08-28,Russia,NA,Ulyanovsk Oblast,1246618,89,0,11807,91
2020-08-29,Russia,NA,Ulyanovsk Oblast,1246618,85,2,11892,93
2020-08-30,Russia,NA,Ulyanovsk Oblast,1246618,89,0,11981,93
2020-08-31,Russia,NA,Ulyanovsk Oblast,1246618,91,8,12072,101
2020-09-01,Russia,NA,Ulyanovsk Oblast,1246618,92,0,12164,101
2020-09-02,Russia,NA,Ulyanovsk Oblast,1246618,95,9,12259,110
2020-09-03,Russia,NA,Ulyanovsk Oblast,1246618,94,1,12353,111
2020-09-04,Russia,NA,Ulyanovsk Oblast,1246618,98,0,12451,111
2020-09-05,Russia,NA,Ulyanovsk Oblast,1246618,99,0,12550,111
2020-09-06,Russia,NA,Ulyanovsk Oblast,1246618,98,0,12648,111
2020-09-07,Russia,NA,Ulyanovsk Oblast,1246618,97,0,12745,111
2020-09-08,Russia,NA,Ulyanovsk Oblast,1246618,99,0,12844,111
2020-09-09,Russia,NA,Ulyanovsk Oblast,1246618,105,9,12949,120
2020-09-10,Russia,NA,Ulyanovsk Oblast,1246618,108,5,13057,125
2020-09-11,Russia,NA,Ulyanovsk Oblast,1246618,109,0,13166,125
2020-09-12,Russia,NA,Ulyanovsk Oblast,1246618,110,5,13276,130
2020-09-13,Russia,NA,Ulyanovsk Oblast,1246618,128,0,13404,130
2020-09-14,Russia,NA,Ulyanovsk Oblast,1246618,129,0,13533,130
2020-09-15,Russia,NA,Ulyanovsk Oblast,1246618,128,4,13661,134
2020-09-16,Russia,NA,Ulyanovsk Oblast,1246618,127,6,13788,140
2020-09-17,Russia,NA,Ulyanovsk Oblast,1246618,125,0,13913,140
2020-09-18,Russia,NA,Ulyanovsk Oblast,1246618,120,0,14033,140
2020-09-19,Russia,NA,Ulyanovsk Oblast,1246618,121,0,14154,140
2020-09-20,Russia,NA,Ulyanovsk Oblast,1246618,125,0,14279,140
2020-09-21,Russia,NA,Ulyanovsk Oblast,1246618,124,7,14403,147
2020-09-22,Russia,NA,Ulyanovsk Oblast,1246618,125,0,14528,147
2020-09-23,Russia,NA,Ulyanovsk Oblast,1246618,123,0,14651,147
2020-04-07,Russia,NA,Vladimir Oblast,1378337,7,0,12,0
2020-04-08,Russia,NA,Vladimir Oblast,1378337,2,0,14,0
2020-04-09,Russia,NA,Vladimir Oblast,1378337,24,0,38,0
2020-04-10,Russia,NA,Vladimir Oblast,1378337,4,0,42,0
2020-04-11,Russia,NA,Vladimir Oblast,1378337,6,0,48,0
2020-04-12,Russia,NA,Vladimir Oblast,1378337,23,0,71,0
2020-04-13,Russia,NA,Vladimir Oblast,1378337,13,0,84,0
2020-04-14,Russia,NA,Vladimir Oblast,1378337,16,0,100,0
2020-04-15,Russia,NA,Vladimir Oblast,1378337,45,0,145,0
2020-04-16,Russia,NA,Vladimir Oblast,1378337,14,0,159,0
2020-04-17,Russia,NA,Vladimir Oblast,1378337,24,0,183,0
2020-04-18,Russia,NA,Vladimir Oblast,1378337,15,0,198,0
2020-04-19,Russia,NA,Vladimir Oblast,1378337,27,0,225,0
2020-04-20,Russia,NA,Vladimir Oblast,1378337,34,0,259,0
2020-04-21,Russia,NA,Vladimir Oblast,1378337,21,0,280,0
2020-04-22,Russia,NA,Vladimir Oblast,1378337,13,0,293,0
2020-04-23,Russia,NA,Vladimir Oblast,1378337,46,0,339,0
2020-04-24,Russia,NA,Vladimir Oblast,1378337,42,0,381,0
2020-04-25,Russia,NA,Vladimir Oblast,1378337,45,0,426,0
2020-04-26,Russia,NA,Vladimir Oblast,1378337,49,0,475,0
2020-04-27,Russia,NA,Vladimir Oblast,1378337,43,0,518,0
2020-04-28,Russia,NA,Vladimir Oblast,1378337,79,0,597,0
2020-04-29,Russia,NA,Vladimir Oblast,1378337,37,0,634,0
2020-04-30,Russia,NA,Vladimir Oblast,1378337,35,0,669,0
2020-05-01,Russia,NA,Vladimir Oblast,1378337,46,0,715,0
2020-05-02,Russia,NA,Vladimir Oblast,1378337,60,0,775,0
2020-05-03,Russia,NA,Vladimir Oblast,1378337,55,0,830,0
2020-05-04,Russia,NA,Vladimir Oblast,1378337,66,0,896,0
2020-05-05,Russia,NA,Vladimir Oblast,1378337,48,0,944,0
2020-05-06,Russia,NA,Vladimir Oblast,1378337,57,0,1001,0
2020-05-07,Russia,NA,Vladimir Oblast,1378337,78,0,1079,0
2020-05-08,Russia,NA,Vladimir Oblast,1378337,15,0,1094,0
2020-05-09,Russia,NA,Vladimir Oblast,1378337,42,0,1136,0
2020-05-10,Russia,NA,Vladimir Oblast,1378337,83,0,1219,0
2020-05-11,Russia,NA,Vladimir Oblast,1378337,77,0,1296,0
2020-05-12,Russia,NA,Vladimir Oblast,1378337,61,0,1357,0
2020-05-13,Russia,NA,Vladimir Oblast,1378337,72,0,1429,0
2020-05-14,Russia,NA,Vladimir Oblast,1378337,45,0,1474,0
2020-05-15,Russia,NA,Vladimir Oblast,1378337,88,0,1562,0
2020-05-16,Russia,NA,Vladimir Oblast,1378337,65,0,1627,0
2020-05-17,Russia,NA,Vladimir Oblast,1378337,81,0,1708,0
2020-05-18,Russia,NA,Vladimir Oblast,1378337,99,0,1807,0
2020-05-19,Russia,NA,Vladimir Oblast,1378337,83,0,1890,0
2020-05-20,Russia,NA,Vladimir Oblast,1378337,66,0,1956,0
2020-05-21,Russia,NA,Vladimir Oblast,1378337,57,0,2013,0
2020-05-22,Russia,NA,Vladimir Oblast,1378337,77,0,2090,0
2020-05-23,Russia,NA,Vladimir Oblast,1378337,74,0,2164,0
2020-05-24,Russia,NA,Vladimir Oblast,1378337,59,0,2223,0
2020-05-25,Russia,NA,Vladimir Oblast,1378337,69,0,2292,0
2020-05-26,Russia,NA,Vladimir Oblast,1378337,57,0,2349,0
2020-05-27,Russia,NA,Vladimir Oblast,1378337,55,0,2404,0
2020-05-28,Russia,NA,Vladimir Oblast,1378337,61,0,2465,0
2020-05-29,Russia,NA,Vladimir Oblast,1378337,59,0,2524,0
2020-05-30,Russia,NA,Vladimir Oblast,1378337,63,0,2587,0
2020-05-31,Russia,NA,Vladimir Oblast,1378337,59,0,2646,0
2020-06-01,Russia,NA,Vladimir Oblast,1378337,59,0,2705,0
2020-06-02,Russia,NA,Vladimir Oblast,1378337,62,0,2767,0
2020-06-03,Russia,NA,Vladimir Oblast,1378337,56,0,2823,0
2020-06-04,Russia,NA,Vladimir Oblast,1378337,55,0,2878,0
2020-06-05,Russia,NA,Vladimir Oblast,1378337,58,0,2936,0
2020-06-06,Russia,NA,Vladimir Oblast,1378337,60,0,2996,0
2020-06-07,Russia,NA,Vladimir Oblast,1378337,63,0,3059,0
2020-06-08,Russia,NA,Vladimir Oblast,1378337,62,0,3121,0
2020-06-09,Russia,NA,Vladimir Oblast,1378337,54,0,3175,0
2020-06-10,Russia,NA,Vladimir Oblast,1378337,55,0,3230,0
2020-06-11,Russia,NA,Vladimir Oblast,1378337,64,0,3294,0
2020-06-12,Russia,NA,Vladimir Oblast,1378337,66,0,3360,0
2020-06-13,Russia,NA,Vladimir Oblast,1378337,63,0,3423,0
2020-06-14,Russia,NA,Vladimir Oblast,1378337,59,0,3482,0
2020-06-15,Russia,NA,Vladimir Oblast,1378337,57,0,3539,0
2020-06-16,Russia,NA,Vladimir Oblast,1378337,60,0,3599,0
2020-06-17,Russia,NA,Vladimir Oblast,1378337,56,0,3655,0
2020-06-18,Russia,NA,Vladimir Oblast,1378337,54,0,3709,0
2020-06-19,Russia,NA,Vladimir Oblast,1378337,56,0,3765,0
2020-06-20,Russia,NA,Vladimir Oblast,1378337,55,0,3820,0
2020-06-21,Russia,NA,Vladimir Oblast,1378337,53,0,3873,0
2020-06-22,Russia,NA,Vladimir Oblast,1378337,51,0,3924,0
2020-06-23,Russia,NA,Vladimir Oblast,1378337,52,0,3976,0
2020-06-24,Russia,NA,Vladimir Oblast,1378337,50,0,4026,0
2020-06-25,Russia,NA,Vladimir Oblast,1378337,53,0,4079,0
2020-06-26,Russia,NA,Vladimir Oblast,1378337,51,0,4130,0
2020-06-27,Russia,NA,Vladimir Oblast,1378337,54,0,4184,0
2020-06-28,Russia,NA,Vladimir Oblast,1378337,49,0,4233,0
2020-06-29,Russia,NA,Vladimir Oblast,1378337,51,0,4284,0
2020-06-30,Russia,NA,Vladimir Oblast,1378337,48,0,4332,0
2020-07-01,Russia,NA,Vladimir Oblast,1378337,46,0,4378,0
2020-07-02,Russia,NA,Vladimir Oblast,1378337,48,0,4426,0
2020-07-03,Russia,NA,Vladimir Oblast,1378337,49,0,4475,0
2020-07-04,Russia,NA,Vladimir Oblast,1378337,47,0,4522,0
2020-07-05,Russia,NA,Vladimir Oblast,1378337,46,0,4568,0
2020-07-06,Russia,NA,Vladimir Oblast,1378337,49,0,4617,0
2020-07-07,Russia,NA,Vladimir Oblast,1378337,47,0,4664,0
2020-07-08,Russia,NA,Vladimir Oblast,1378337,45,0,4709,0
2020-07-09,Russia,NA,Vladimir Oblast,1378337,46,0,4755,0
2020-07-10,Russia,NA,Vladimir Oblast,1378337,44,0,4799,0
2020-07-11,Russia,NA,Vladimir Oblast,1378337,45,0,4844,0
2020-07-12,Russia,NA,Vladimir Oblast,1378337,43,0,4887,0
2020-07-13,Russia,NA,Vladimir Oblast,1378337,45,0,4932,0
2020-07-14,Russia,NA,Vladimir Oblast,1378337,44,0,4976,0
2020-07-15,Russia,NA,Vladimir Oblast,1378337,42,0,5018,0
2020-07-16,Russia,NA,Vladimir Oblast,1378337,43,0,5061,0
2020-07-17,Russia,NA,Vladimir Oblast,1378337,42,0,5103,0
2020-07-18,Russia,NA,Vladimir Oblast,1378337,44,0,5147,0
2020-07-19,Russia,NA,Vladimir Oblast,1378337,41,0,5188,0
2020-07-20,Russia,NA,Vladimir Oblast,1378337,43,0,5231,0
2020-07-21,Russia,NA,Vladimir Oblast,1378337,37,0,5268,0
2020-07-22,Russia,NA,Vladimir Oblast,1378337,35,0,5303,0
2020-07-23,Russia,NA,Vladimir Oblast,1378337,36,0,5339,0
2020-07-24,Russia,NA,Vladimir Oblast,1378337,33,0,5372,0
2020-07-25,Russia,NA,Vladimir Oblast,1378337,31,0,5403,0
2020-07-26,Russia,NA,Vladimir Oblast,1378337,29,0,5432,0
2020-07-27,Russia,NA,Vladimir Oblast,1378337,28,0,5460,0
2020-07-28,Russia,NA,Vladimir Oblast,1378337,26,0,5486,0
2020-07-29,Russia,NA,Vladimir Oblast,1378337,25,0,5511,0
2020-07-30,Russia,NA,Vladimir Oblast,1378337,22,0,5533,0
2020-07-31,Russia,NA,Vladimir Oblast,1378337,23,0,5556,0
2020-08-01,Russia,NA,Vladimir Oblast,1378337,24,0,5580,0
2020-08-02,Russia,NA,Vladimir Oblast,1378337,25,0,5605,0
2020-08-26,Russia,NA,Vladimir Oblast,1378337,0,0,6185,193
2020-08-27,Russia,NA,Vladimir Oblast,1378337,27,0,6212,193
2020-08-28,Russia,NA,Vladimir Oblast,1378337,25,0,6237,193
2020-08-29,Russia,NA,Vladimir Oblast,1378337,27,1,6264,194
2020-08-30,Russia,NA,Vladimir Oblast,1378337,28,0,6292,194
2020-08-31,Russia,NA,Vladimir Oblast,1378337,26,0,6318,194
2020-09-01,Russia,NA,Vladimir Oblast,1378337,27,0,6345,194
2020-09-02,Russia,NA,Vladimir Oblast,1378337,29,1,6374,195
2020-09-03,Russia,NA,Vladimir Oblast,1378337,31,0,6405,195
2020-09-04,Russia,NA,Vladimir Oblast,1378337,32,1,6437,196
2020-09-05,Russia,NA,Vladimir Oblast,1378337,27,1,6464,197
2020-09-06,Russia,NA,Vladimir Oblast,1378337,29,0,6493,197
2020-09-07,Russia,NA,Vladimir Oblast,1378337,28,0,6521,197
2020-09-08,Russia,NA,Vladimir Oblast,1378337,30,0,6551,197
2020-09-09,Russia,NA,Vladimir Oblast,1378337,32,1,6583,198
2020-09-10,Russia,NA,Vladimir Oblast,1378337,31,0,6614,198
2020-09-11,Russia,NA,Vladimir Oblast,1378337,33,1,6647,199
2020-09-12,Russia,NA,Vladimir Oblast,1378337,32,0,6679,199
2020-09-13,Russia,NA,Vladimir Oblast,1378337,30,0,6709,199
2020-09-14,Russia,NA,Vladimir Oblast,1378337,31,0,6740,199
2020-09-15,Russia,NA,Vladimir Oblast,1378337,32,0,6772,199
2020-09-16,Russia,NA,Vladimir Oblast,1378337,34,0,6806,199
2020-09-17,Russia,NA,Vladimir Oblast,1378337,32,1,6838,200
2020-09-18,Russia,NA,Vladimir Oblast,1378337,33,0,6871,200
2020-09-19,Russia,NA,Vladimir Oblast,1378337,35,1,6906,201
2020-09-20,Russia,NA,Vladimir Oblast,1378337,31,0,6937,201
2020-09-21,Russia,NA,Vladimir Oblast,1378337,32,0,6969,201
2020-09-22,Russia,NA,Vladimir Oblast,1378337,34,0,7003,201
2020-09-23,Russia,NA,Vladimir Oblast,1378337,31,2,7034,203
2020-04-06,Russia,NA,Volgograd Oblast,2521276,7,0,15,0
2020-04-07,Russia,NA,Volgograd Oblast,2521276,11,0,26,0
2020-04-10,Russia,NA,Volgograd Oblast,2521276,2,0,28,0
2020-04-11,Russia,NA,Volgograd Oblast,2521276,5,0,33,0
2020-04-12,Russia,NA,Volgograd Oblast,2521276,5,0,38,0
2020-04-13,Russia,NA,Volgograd Oblast,2521276,6,0,44,0
2020-04-14,Russia,NA,Volgograd Oblast,2521276,2,0,46,0
2020-04-15,Russia,NA,Volgograd Oblast,2521276,1,0,47,0
2020-04-16,Russia,NA,Volgograd Oblast,2521276,11,0,58,0
2020-04-17,Russia,NA,Volgograd Oblast,2521276,4,0,62,0
2020-04-18,Russia,NA,Volgograd Oblast,2521276,17,0,79,0
2020-04-19,Russia,NA,Volgograd Oblast,2521276,14,0,93,0
2020-04-20,Russia,NA,Volgograd Oblast,2521276,18,0,111,0
2020-04-21,Russia,NA,Volgograd Oblast,2521276,23,0,134,0
2020-04-22,Russia,NA,Volgograd Oblast,2521276,11,0,145,0
2020-04-23,Russia,NA,Volgograd Oblast,2521276,20,0,165,0
2020-04-24,Russia,NA,Volgograd Oblast,2521276,21,0,186,0
2020-04-25,Russia,NA,Volgograd Oblast,2521276,26,0,212,0
2020-04-26,Russia,NA,Volgograd Oblast,2521276,30,0,242,0
2020-04-27,Russia,NA,Volgograd Oblast,2521276,30,0,272,0
2020-04-28,Russia,NA,Volgograd Oblast,2521276,25,0,297,0
2020-04-29,Russia,NA,Volgograd Oblast,2521276,16,0,313,0
2020-04-30,Russia,NA,Volgograd Oblast,2521276,31,0,344,0
2020-05-01,Russia,NA,Volgograd Oblast,2521276,42,0,386,0
2020-05-02,Russia,NA,Volgograd Oblast,2521276,46,0,432,0
2020-05-03,Russia,NA,Volgograd Oblast,2521276,42,0,474,0
2020-05-04,Russia,NA,Volgograd Oblast,2521276,42,0,516,0
2020-05-05,Russia,NA,Volgograd Oblast,2521276,62,0,578,0
2020-05-06,Russia,NA,Volgograd Oblast,2521276,69,0,647,0
2020-05-07,Russia,NA,Volgograd Oblast,2521276,64,0,711,0
2020-05-08,Russia,NA,Volgograd Oblast,2521276,80,0,791,0
2020-05-09,Russia,NA,Volgograd Oblast,2521276,102,0,893,0
2020-05-10,Russia,NA,Volgograd Oblast,2521276,119,0,1012,0
2020-05-11,Russia,NA,Volgograd Oblast,2521276,49,0,1061,0
2020-05-12,Russia,NA,Volgograd Oblast,2521276,74,0,1135,0
2020-05-13,Russia,NA,Volgograd Oblast,2521276,124,0,1259,0
2020-05-14,Russia,NA,Volgograd Oblast,2521276,96,0,1355,0
2020-05-15,Russia,NA,Volgograd Oblast,2521276,90,0,1445,0
2020-05-16,Russia,NA,Volgograd Oblast,2521276,86,0,1531,0
2020-05-17,Russia,NA,Volgograd Oblast,2521276,65,0,1596,0
2020-05-18,Russia,NA,Volgograd Oblast,2521276,65,0,1661,0
2020-05-19,Russia,NA,Volgograd Oblast,2521276,86,0,1747,0
2020-05-20,Russia,NA,Volgograd Oblast,2521276,84,0,1831,0
2020-05-21,Russia,NA,Volgograd Oblast,2521276,82,0,1913,0
2020-05-22,Russia,NA,Volgograd Oblast,2521276,89,0,2002,0
2020-05-23,Russia,NA,Volgograd Oblast,2521276,107,0,2109,0
2020-05-24,Russia,NA,Volgograd Oblast,2521276,98,0,2207,0
2020-05-25,Russia,NA,Volgograd Oblast,2521276,89,0,2296,0
2020-05-26,Russia,NA,Volgograd Oblast,2521276,88,0,2384,0
2020-05-27,Russia,NA,Volgograd Oblast,2521276,86,0,2470,0
2020-05-28,Russia,NA,Volgograd Oblast,2521276,111,0,2581,0
2020-05-29,Russia,NA,Volgograd Oblast,2521276,133,0,2714,0
2020-05-30,Russia,NA,Volgograd Oblast,2521276,154,0,2868,0
2020-05-31,Russia,NA,Volgograd Oblast,2521276,158,0,3026,0
2020-06-01,Russia,NA,Volgograd Oblast,2521276,189,0,3215,0
2020-06-02,Russia,NA,Volgograd Oblast,2521276,119,0,3334,0
2020-06-03,Russia,NA,Volgograd Oblast,2521276,98,0,3432,0
2020-06-04,Russia,NA,Volgograd Oblast,2521276,109,0,3541,0
2020-06-05,Russia,NA,Volgograd Oblast,2521276,128,0,3669,0
2020-06-06,Russia,NA,Volgograd Oblast,2521276,125,0,3794,0
2020-06-07,Russia,NA,Volgograd Oblast,2521276,119,0,3913,0
2020-06-08,Russia,NA,Volgograd Oblast,2521276,117,0,4030,0
2020-06-09,Russia,NA,Volgograd Oblast,2521276,92,0,4122,0
2020-06-10,Russia,NA,Volgograd Oblast,2521276,116,0,4238,0
2020-06-11,Russia,NA,Volgograd Oblast,2521276,108,0,4346,0
2020-06-12,Russia,NA,Volgograd Oblast,2521276,114,0,4460,0
2020-06-13,Russia,NA,Volgograd Oblast,2521276,109,0,4569,0
2020-06-14,Russia,NA,Volgograd Oblast,2521276,108,0,4677,0
2020-06-15,Russia,NA,Volgograd Oblast,2521276,106,0,4783,0
2020-06-16,Russia,NA,Volgograd Oblast,2521276,104,0,4887,0
2020-06-17,Russia,NA,Volgograd Oblast,2521276,104,0,4991,0
2020-06-18,Russia,NA,Volgograd Oblast,2521276,109,0,5100,0
2020-06-19,Russia,NA,Volgograd Oblast,2521276,107,0,5207,0
2020-06-20,Russia,NA,Volgograd Oblast,2521276,105,0,5312,0
2020-06-21,Russia,NA,Volgograd Oblast,2521276,98,0,5410,0
2020-06-22,Russia,NA,Volgograd Oblast,2521276,108,0,5518,0
2020-06-23,Russia,NA,Volgograd Oblast,2521276,104,0,5622,0
2020-06-24,Russia,NA,Volgograd Oblast,2521276,102,0,5724,0
2020-06-25,Russia,NA,Volgograd Oblast,2521276,101,0,5825,0
2020-06-26,Russia,NA,Volgograd Oblast,2521276,110,0,5935,0
2020-06-27,Russia,NA,Volgograd Oblast,2521276,102,0,6037,0
2020-06-28,Russia,NA,Volgograd Oblast,2521276,98,0,6135,0
2020-06-29,Russia,NA,Volgograd Oblast,2521276,97,0,6232,0
2020-06-30,Russia,NA,Volgograd Oblast,2521276,95,0,6327,0
2020-07-01,Russia,NA,Volgograd Oblast,2521276,92,0,6419,0
2020-07-02,Russia,NA,Volgograd Oblast,2521276,89,0,6508,0
2020-07-03,Russia,NA,Volgograd Oblast,2521276,89,0,6597,0
2020-07-04,Russia,NA,Volgograd Oblast,2521276,91,0,6688,0
2020-07-05,Russia,NA,Volgograd Oblast,2521276,95,0,6783,0
2020-07-06,Russia,NA,Volgograd Oblast,2521276,94,0,6877,0
2020-07-07,Russia,NA,Volgograd Oblast,2521276,92,0,6969,0
2020-07-08,Russia,NA,Volgograd Oblast,2521276,89,0,7058,0
2020-07-09,Russia,NA,Volgograd Oblast,2521276,88,0,7146,0
2020-07-10,Russia,NA,Volgograd Oblast,2521276,94,0,7240,0
2020-07-11,Russia,NA,Volgograd Oblast,2521276,92,0,7332,0
2020-07-12,Russia,NA,Volgograd Oblast,2521276,96,0,7428,0
2020-07-13,Russia,NA,Volgograd Oblast,2521276,88,0,7516,0
2020-07-14,Russia,NA,Volgograd Oblast,2521276,85,0,7601,0
2020-07-15,Russia,NA,Volgograd Oblast,2521276,93,0,7694,0
2020-07-16,Russia,NA,Volgograd Oblast,2521276,91,0,7785,0
2020-07-17,Russia,NA,Volgograd Oblast,2521276,94,0,7879,0
2020-07-18,Russia,NA,Volgograd Oblast,2521276,89,0,7968,0
2020-07-19,Russia,NA,Volgograd Oblast,2521276,88,0,8056,0
2020-07-20,Russia,NA,Volgograd Oblast,2521276,93,0,8149,0
2020-07-21,Russia,NA,Volgograd Oblast,2521276,95,0,8244,0
2020-07-22,Russia,NA,Volgograd Oblast,2521276,96,0,8340,0
2020-07-23,Russia,NA,Volgograd Oblast,2521276,91,0,8431,0
2020-07-24,Russia,NA,Volgograd Oblast,2521276,86,0,8517,0
2020-07-25,Russia,NA,Volgograd Oblast,2521276,85,0,8602,0
2020-07-26,Russia,NA,Volgograd Oblast,2521276,87,0,8689,0
2020-07-27,Russia,NA,Volgograd Oblast,2521276,89,0,8778,0
2020-07-28,Russia,NA,Volgograd Oblast,2521276,92,0,8870,0
2020-07-29,Russia,NA,Volgograd Oblast,2521276,88,0,8958,0
2020-07-30,Russia,NA,Volgograd Oblast,2521276,94,0,9052,0
2020-07-31,Russia,NA,Volgograd Oblast,2521276,90,0,9142,0
2020-08-01,Russia,NA,Volgograd Oblast,2521276,95,0,9237,0
2020-08-02,Russia,NA,Volgograd Oblast,2521276,91,0,9328,0
2020-08-26,Russia,NA,Volgograd Oblast,2521276,0,0,11617,87
2020-08-27,Russia,NA,Volgograd Oblast,2521276,112,0,11729,87
2020-08-28,Russia,NA,Volgograd Oblast,2521276,107,3,11836,90
2020-08-29,Russia,NA,Volgograd Oblast,2521276,98,3,11934,93
2020-08-30,Russia,NA,Volgograd Oblast,2521276,96,4,12030,97
2020-08-31,Russia,NA,Volgograd Oblast,2521276,95,4,12125,101
2020-09-01,Russia,NA,Volgograd Oblast,2521276,91,3,12216,104
2020-09-02,Russia,NA,Volgograd Oblast,2521276,93,2,12309,106
2020-09-03,Russia,NA,Volgograd Oblast,2521276,98,2,12407,108
2020-09-04,Russia,NA,Volgograd Oblast,2521276,96,2,12503,110
2020-09-05,Russia,NA,Volgograd Oblast,2521276,104,2,12607,112
2020-09-06,Russia,NA,Volgograd Oblast,2521276,102,3,12709,115
2020-09-07,Russia,NA,Volgograd Oblast,2521276,97,2,12806,117
2020-09-08,Russia,NA,Volgograd Oblast,2521276,95,1,12901,118
2020-09-09,Russia,NA,Volgograd Oblast,2521276,92,2,12993,120
2020-09-10,Russia,NA,Volgograd Oblast,2521276,94,1,13087,121
2020-09-11,Russia,NA,Volgograd Oblast,2521276,96,1,13183,122
2020-09-12,Russia,NA,Volgograd Oblast,2521276,97,1,13280,123
2020-09-13,Russia,NA,Volgograd Oblast,2521276,95,2,13375,125
2020-09-14,Russia,NA,Volgograd Oblast,2521276,98,0,13473,125
2020-09-15,Russia,NA,Volgograd Oblast,2521276,97,1,13570,126
2020-09-16,Russia,NA,Volgograd Oblast,2521276,104,1,13674,127
2020-09-17,Russia,NA,Volgograd Oblast,2521276,98,1,13772,128
2020-09-18,Russia,NA,Volgograd Oblast,2521276,97,1,13869,129
2020-09-19,Russia,NA,Volgograd Oblast,2521276,96,1,13965,130
2020-09-20,Russia,NA,Volgograd Oblast,2521276,98,1,14063,131
2020-09-21,Russia,NA,Volgograd Oblast,2521276,95,0,14158,131
2020-09-22,Russia,NA,Volgograd Oblast,2521276,98,1,14256,132
2020-09-23,Russia,NA,Volgograd Oblast,2521276,104,2,14360,134
2020-04-02,Russia,NA,Vologda Oblast,1176689,3,0,12,0
2020-04-04,Russia,NA,Vologda Oblast,1176689,1,0,13,0
2020-04-06,Russia,NA,Vologda Oblast,1176689,10,0,23,0
2020-04-08,Russia,NA,Vologda Oblast,1176689,4,0,27,0
2020-04-09,Russia,NA,Vologda Oblast,1176689,8,0,35,0
2020-04-10,Russia,NA,Vologda Oblast,1176689,3,0,38,0
2020-04-11,Russia,NA,Vologda Oblast,1176689,1,0,39,0
2020-04-12,Russia,NA,Vologda Oblast,1176689,3,0,42,0
2020-04-13,Russia,NA,Vologda Oblast,1176689,1,0,43,0
2020-04-14,Russia,NA,Vologda Oblast,1176689,7,0,50,0
2020-04-15,Russia,NA,Vologda Oblast,1176689,2,0,52,0
2020-04-16,Russia,NA,Vologda Oblast,1176689,15,0,67,0
2020-04-17,Russia,NA,Vologda Oblast,1176689,10,0,77,0
2020-04-18,Russia,NA,Vologda Oblast,1176689,9,0,86,0
2020-04-19,Russia,NA,Vologda Oblast,1176689,7,0,93,0
2020-04-20,Russia,NA,Vologda Oblast,1176689,7,0,100,0
2020-04-21,Russia,NA,Vologda Oblast,1176689,7,0,107,0
2020-04-22,Russia,NA,Vologda Oblast,1176689,7,0,114,0
2020-04-23,Russia,NA,Vologda Oblast,1176689,6,0,120,0
2020-04-24,Russia,NA,Vologda Oblast,1176689,9,0,129,0
2020-04-25,Russia,NA,Vologda Oblast,1176689,9,0,138,0
2020-04-26,Russia,NA,Vologda Oblast,1176689,7,0,145,0
2020-04-27,Russia,NA,Vologda Oblast,1176689,10,0,155,0
2020-04-28,Russia,NA,Vologda Oblast,1176689,5,0,160,0
2020-04-29,Russia,NA,Vologda Oblast,1176689,6,0,166,0
2020-04-30,Russia,NA,Vologda Oblast,1176689,7,0,173,0
2020-05-01,Russia,NA,Vologda Oblast,1176689,11,0,184,0
2020-05-02,Russia,NA,Vologda Oblast,1176689,15,0,199,0
2020-05-03,Russia,NA,Vologda Oblast,1176689,20,0,219,0
2020-05-04,Russia,NA,Vologda Oblast,1176689,4,0,223,0
2020-05-05,Russia,NA,Vologda Oblast,1176689,7,0,230,0
2020-05-06,Russia,NA,Vologda Oblast,1176689,6,0,236,0
2020-05-07,Russia,NA,Vologda Oblast,1176689,6,0,242,0
2020-05-08,Russia,NA,Vologda Oblast,1176689,12,0,254,0
2020-05-09,Russia,NA,Vologda Oblast,1176689,14,0,268,0
2020-05-10,Russia,NA,Vologda Oblast,1176689,19,0,287,0
2020-05-11,Russia,NA,Vologda Oblast,1176689,12,0,299,0
2020-05-12,Russia,NA,Vologda Oblast,1176689,19,0,318,0
2020-05-13,Russia,NA,Vologda Oblast,1176689,17,0,335,0
2020-05-14,Russia,NA,Vologda Oblast,1176689,12,0,347,0
2020-05-15,Russia,NA,Vologda Oblast,1176689,15,0,362,0
2020-05-16,Russia,NA,Vologda Oblast,1176689,37,0,399,0
2020-05-17,Russia,NA,Vologda Oblast,1176689,33,0,432,0
2020-05-18,Russia,NA,Vologda Oblast,1176689,23,0,455,0
2020-05-19,Russia,NA,Vologda Oblast,1176689,23,0,478,0
2020-05-20,Russia,NA,Vologda Oblast,1176689,25,0,503,0
2020-05-21,Russia,NA,Vologda Oblast,1176689,26,0,529,0
2020-05-22,Russia,NA,Vologda Oblast,1176689,34,0,563,0
2020-05-23,Russia,NA,Vologda Oblast,1176689,41,0,604,0
2020-05-24,Russia,NA,Vologda Oblast,1176689,40,0,644,0
2020-05-25,Russia,NA,Vologda Oblast,1176689,22,0,666,0
2020-05-26,Russia,NA,Vologda Oblast,1176689,34,0,700,0
2020-05-27,Russia,NA,Vologda Oblast,1176689,75,0,775,0
2020-05-28,Russia,NA,Vologda Oblast,1176689,59,0,834,0
2020-05-29,Russia,NA,Vologda Oblast,1176689,27,0,861,0
2020-05-30,Russia,NA,Vologda Oblast,1176689,22,0,883,0
2020-05-31,Russia,NA,Vologda Oblast,1176689,47,0,930,0
2020-06-01,Russia,NA,Vologda Oblast,1176689,23,0,953,0
2020-06-02,Russia,NA,Vologda Oblast,1176689,27,0,980,0
2020-06-03,Russia,NA,Vologda Oblast,1176689,19,0,999,0
2020-06-04,Russia,NA,Vologda Oblast,1176689,20,0,1019,0
2020-06-05,Russia,NA,Vologda Oblast,1176689,17,0,1036,0
2020-06-06,Russia,NA,Vologda Oblast,1176689,21,0,1057,0
2020-06-07,Russia,NA,Vologda Oblast,1176689,28,0,1085,0
2020-06-08,Russia,NA,Vologda Oblast,1176689,27,0,1112,0
2020-06-09,Russia,NA,Vologda Oblast,1176689,26,0,1138,0
2020-06-10,Russia,NA,Vologda Oblast,1176689,22,0,1160,0
2020-06-11,Russia,NA,Vologda Oblast,1176689,30,0,1190,0
2020-06-12,Russia,NA,Vologda Oblast,1176689,32,0,1222,0
2020-06-13,Russia,NA,Vologda Oblast,1176689,33,0,1255,0
2020-06-14,Russia,NA,Vologda Oblast,1176689,30,0,1285,0
2020-06-15,Russia,NA,Vologda Oblast,1176689,18,0,1303,0
2020-06-16,Russia,NA,Vologda Oblast,1176689,15,0,1318,0
2020-06-17,Russia,NA,Vologda Oblast,1176689,18,0,1336,0
2020-06-18,Russia,NA,Vologda Oblast,1176689,24,0,1360,0
2020-06-19,Russia,NA,Vologda Oblast,1176689,27,0,1387,0
2020-06-20,Russia,NA,Vologda Oblast,1176689,22,0,1409,0
2020-06-21,Russia,NA,Vologda Oblast,1176689,20,0,1429,0
2020-06-22,Russia,NA,Vologda Oblast,1176689,17,0,1446,0
2020-06-23,Russia,NA,Vologda Oblast,1176689,21,0,1467,0
2020-06-24,Russia,NA,Vologda Oblast,1176689,21,0,1488,0
2020-06-25,Russia,NA,Vologda Oblast,1176689,21,0,1509,0
2020-06-26,Russia,NA,Vologda Oblast,1176689,18,0,1527,0
2020-06-27,Russia,NA,Vologda Oblast,1176689,20,0,1547,0
2020-06-28,Russia,NA,Vologda Oblast,1176689,19,0,1566,0
2020-06-29,Russia,NA,Vologda Oblast,1176689,21,0,1587,0
2020-06-30,Russia,NA,Vologda Oblast,1176689,21,0,1608,0
2020-07-01,Russia,NA,Vologda Oblast,1176689,21,0,1629,0
2020-07-02,Russia,NA,Vologda Oblast,1176689,18,0,1647,0
2020-07-03,Russia,NA,Vologda Oblast,1176689,20,0,1667,0
2020-07-04,Russia,NA,Vologda Oblast,1176689,22,0,1689,0
2020-07-05,Russia,NA,Vologda Oblast,1176689,21,0,1710,0
2020-07-06,Russia,NA,Vologda Oblast,1176689,21,0,1731,0
2020-07-07,Russia,NA,Vologda Oblast,1176689,19,0,1750,0
2020-07-08,Russia,NA,Vologda Oblast,1176689,21,0,1771,0
2020-07-09,Russia,NA,Vologda Oblast,1176689,20,0,1791,0
2020-07-10,Russia,NA,Vologda Oblast,1176689,28,0,1819,0
2020-07-11,Russia,NA,Vologda Oblast,1176689,38,0,1857,0
2020-07-12,Russia,NA,Vologda Oblast,1176689,32,0,1889,0
2020-07-13,Russia,NA,Vologda Oblast,1176689,27,0,1916,0
2020-07-14,Russia,NA,Vologda Oblast,1176689,29,0,1945,0
2020-07-15,Russia,NA,Vologda Oblast,1176689,28,0,1973,0
2020-07-16,Russia,NA,Vologda Oblast,1176689,30,0,2003,0
2020-07-17,Russia,NA,Vologda Oblast,1176689,30,0,2033,0
2020-07-18,Russia,NA,Vologda Oblast,1176689,29,0,2062,0
2020-07-19,Russia,NA,Vologda Oblast,1176689,27,0,2089,0
2020-07-20,Russia,NA,Vologda Oblast,1176689,26,0,2115,0
2020-07-21,Russia,NA,Vologda Oblast,1176689,26,0,2141,0
2020-07-22,Russia,NA,Vologda Oblast,1176689,25,0,2166,0
2020-07-23,Russia,NA,Vologda Oblast,1176689,27,0,2193,0
2020-07-24,Russia,NA,Vologda Oblast,1176689,26,0,2219,0
2020-07-25,Russia,NA,Vologda Oblast,1176689,27,0,2246,0
2020-07-26,Russia,NA,Vologda Oblast,1176689,26,0,2272,0
2020-07-27,Russia,NA,Vologda Oblast,1176689,26,0,2298,0
2020-07-28,Russia,NA,Vologda Oblast,1176689,27,0,2325,0
2020-07-29,Russia,NA,Vologda Oblast,1176689,27,0,2352,0
2020-07-30,Russia,NA,Vologda Oblast,1176689,27,0,2379,0
2020-07-31,Russia,NA,Vologda Oblast,1176689,28,0,2407,0
2020-08-01,Russia,NA,Vologda Oblast,1176689,28,0,2435,0
2020-08-02,Russia,NA,Vologda Oblast,1176689,27,0,2462,0
2020-08-26,Russia,NA,Vologda Oblast,1176689,0,0,3212,34
2020-08-27,Russia,NA,Vologda Oblast,1176689,32,0,3244,34
2020-08-28,Russia,NA,Vologda Oblast,1176689,34,0,3278,34
2020-08-29,Russia,NA,Vologda Oblast,1176689,32,1,3310,35
2020-08-30,Russia,NA,Vologda Oblast,1176689,36,1,3346,36
2020-08-31,Russia,NA,Vologda Oblast,1176689,33,0,3379,36
2020-09-01,Russia,NA,Vologda Oblast,1176689,37,1,3416,37
2020-09-02,Russia,NA,Vologda Oblast,1176689,34,1,3450,38
2020-09-03,Russia,NA,Vologda Oblast,1176689,36,0,3486,38
2020-09-04,Russia,NA,Vologda Oblast,1176689,33,1,3519,39
2020-09-05,Russia,NA,Vologda Oblast,1176689,38,4,3557,43
2020-09-06,Russia,NA,Vologda Oblast,1176689,36,0,3593,43
2020-09-07,Russia,NA,Vologda Oblast,1176689,39,0,3632,43
2020-09-08,Russia,NA,Vologda Oblast,1176689,34,0,3666,43
2020-09-09,Russia,NA,Vologda Oblast,1176689,41,0,3707,43
2020-09-10,Russia,NA,Vologda Oblast,1176689,37,1,3744,44
2020-09-11,Russia,NA,Vologda Oblast,1176689,40,0,3784,44
2020-09-12,Russia,NA,Vologda Oblast,1176689,39,0,3823,44
2020-09-13,Russia,NA,Vologda Oblast,1176689,42,0,3865,44
2020-09-14,Russia,NA,Vologda Oblast,1176689,41,0,3906,44
2020-09-15,Russia,NA,Vologda Oblast,1176689,44,0,3950,44
2020-09-16,Russia,NA,Vologda Oblast,1176689,42,0,3992,44
2020-09-17,Russia,NA,Vologda Oblast,1176689,45,1,4037,45
2020-09-18,Russia,NA,Vologda Oblast,1176689,43,0,4080,45
2020-09-19,Russia,NA,Vologda Oblast,1176689,44,0,4124,45
2020-09-20,Russia,NA,Vologda Oblast,1176689,44,0,4168,45
2020-09-21,Russia,NA,Vologda Oblast,1176689,43,0,4211,45
2020-09-22,Russia,NA,Vologda Oblast,1176689,45,0,4256,45
2020-09-23,Russia,NA,Vologda Oblast,1176689,44,0,4300,45
2020-04-01,Russia,NA,Voronezh Oblast,2333768,4,0,12,0
2020-04-04,Russia,NA,Voronezh Oblast,2333768,2,0,14,0
2020-04-06,Russia,NA,Voronezh Oblast,2333768,9,0,23,0
2020-04-08,Russia,NA,Voronezh Oblast,2333768,10,0,33,0
2020-04-10,Russia,NA,Voronezh Oblast,2333768,4,0,37,0
2020-04-12,Russia,NA,Voronezh Oblast,2333768,12,0,49,0
2020-04-13,Russia,NA,Voronezh Oblast,2333768,11,0,60,0
2020-04-14,Russia,NA,Voronezh Oblast,2333768,8,0,68,0
2020-04-15,Russia,NA,Voronezh Oblast,2333768,7,0,75,0
2020-04-16,Russia,NA,Voronezh Oblast,2333768,14,0,89,0
2020-04-17,Russia,NA,Voronezh Oblast,2333768,19,0,108,0
2020-04-18,Russia,NA,Voronezh Oblast,2333768,22,0,130,0
2020-04-19,Russia,NA,Voronezh Oblast,2333768,26,0,156,0
2020-04-20,Russia,NA,Voronezh Oblast,2333768,24,0,180,0
2020-04-21,Russia,NA,Voronezh Oblast,2333768,31,0,211,0
2020-04-22,Russia,NA,Voronezh Oblast,2333768,25,0,236,0
2020-04-23,Russia,NA,Voronezh Oblast,2333768,25,0,261,0
2020-04-24,Russia,NA,Voronezh Oblast,2333768,30,0,291,0
2020-04-25,Russia,NA,Voronezh Oblast,2333768,22,0,313,0
2020-04-26,Russia,NA,Voronezh Oblast,2333768,25,0,338,0
2020-04-27,Russia,NA,Voronezh Oblast,2333768,20,0,358,0
2020-04-28,Russia,NA,Voronezh Oblast,2333768,62,0,420,0
2020-04-29,Russia,NA,Voronezh Oblast,2333768,39,0,459,0
2020-04-30,Russia,NA,Voronezh Oblast,2333768,34,0,493,0
2020-05-01,Russia,NA,Voronezh Oblast,2333768,36,0,529,0
2020-05-02,Russia,NA,Voronezh Oblast,2333768,36,0,565,0
2020-05-03,Russia,NA,Voronezh Oblast,2333768,37,0,602,0
2020-05-04,Russia,NA,Voronezh Oblast,2333768,34,0,636,0
2020-05-05,Russia,NA,Voronezh Oblast,2333768,31,0,667,0
2020-05-06,Russia,NA,Voronezh Oblast,2333768,30,0,697,0
2020-05-07,Russia,NA,Voronezh Oblast,2333768,34,0,731,0
2020-05-08,Russia,NA,Voronezh Oblast,2333768,35,0,766,0
2020-05-09,Russia,NA,Voronezh Oblast,2333768,43,0,809,0
2020-05-10,Russia,NA,Voronezh Oblast,2333768,39,0,848,0
2020-05-11,Russia,NA,Voronezh Oblast,2333768,51,0,899,0
2020-05-12,Russia,NA,Voronezh Oblast,2333768,44,0,943,0
2020-05-13,Russia,NA,Voronezh Oblast,2333768,40,0,983,0
2020-05-14,Russia,NA,Voronezh Oblast,2333768,45,0,1028,0
2020-05-15,Russia,NA,Voronezh Oblast,2333768,46,0,1074,0
2020-05-16,Russia,NA,Voronezh Oblast,2333768,39,0,1113,0
2020-05-17,Russia,NA,Voronezh Oblast,2333768,38,0,1151,0
2020-05-18,Russia,NA,Voronezh Oblast,2333768,44,0,1195,0
2020-05-19,Russia,NA,Voronezh Oblast,2333768,51,0,1246,0
2020-05-20,Russia,NA,Voronezh Oblast,2333768,20,0,1266,0
2020-05-21,Russia,NA,Voronezh Oblast,2333768,41,0,1307,0
2020-05-22,Russia,NA,Voronezh Oblast,2333768,55,0,1362,0
2020-05-23,Russia,NA,Voronezh Oblast,2333768,57,0,1419,0
2020-05-24,Russia,NA,Voronezh Oblast,2333768,44,0,1463,0
2020-05-25,Russia,NA,Voronezh Oblast,2333768,55,0,1518,0
2020-05-26,Russia,NA,Voronezh Oblast,2333768,63,0,1581,0
2020-05-27,Russia,NA,Voronezh Oblast,2333768,62,0,1643,0
2020-05-28,Russia,NA,Voronezh Oblast,2333768,110,0,1753,0
2020-05-29,Russia,NA,Voronezh Oblast,2333768,104,0,1857,0
2020-05-30,Russia,NA,Voronezh Oblast,2333768,89,0,1946,0
2020-05-31,Russia,NA,Voronezh Oblast,2333768,82,0,2028,0
2020-06-01,Russia,NA,Voronezh Oblast,2333768,111,0,2139,0
2020-06-02,Russia,NA,Voronezh Oblast,2333768,95,0,2234,0
2020-06-03,Russia,NA,Voronezh Oblast,2333768,127,0,2361,0
2020-06-04,Russia,NA,Voronezh Oblast,2333768,105,0,2466,0
2020-06-05,Russia,NA,Voronezh Oblast,2333768,126,0,2592,0
2020-06-06,Russia,NA,Voronezh Oblast,2333768,106,0,2698,0
2020-06-07,Russia,NA,Voronezh Oblast,2333768,139,0,2837,0
2020-06-08,Russia,NA,Voronezh Oblast,2333768,228,0,3065,0
2020-06-09,Russia,NA,Voronezh Oblast,2333768,220,0,3285,0
2020-06-10,Russia,NA,Voronezh Oblast,2333768,242,0,3527,0
2020-06-11,Russia,NA,Voronezh Oblast,2333768,239,0,3766,0
2020-06-12,Russia,NA,Voronezh Oblast,2333768,227,0,3993,0
2020-06-13,Russia,NA,Voronezh Oblast,2333768,228,0,4221,0
2020-06-14,Russia,NA,Voronezh Oblast,2333768,219,0,4440,0
2020-06-15,Russia,NA,Voronezh Oblast,2333768,220,0,4660,0
2020-06-16,Russia,NA,Voronezh Oblast,2333768,201,0,4861,0
2020-06-17,Russia,NA,Voronezh Oblast,2333768,201,0,5062,0
2020-06-18,Russia,NA,Voronezh Oblast,2333768,196,0,5258,0
2020-06-19,Russia,NA,Voronezh Oblast,2333768,203,0,5461,0
2020-06-20,Russia,NA,Voronezh Oblast,2333768,202,0,5663,0
2020-06-21,Russia,NA,Voronezh Oblast,2333768,200,0,5863,0
2020-06-22,Russia,NA,Voronezh Oblast,2333768,199,0,6062,0
2020-06-23,Russia,NA,Voronezh Oblast,2333768,197,0,6259,0
2020-06-24,Russia,NA,Voronezh Oblast,2333768,198,0,6457,0
2020-06-25,Russia,NA,Voronezh Oblast,2333768,196,0,6653,0
2020-06-26,Russia,NA,Voronezh Oblast,2333768,193,0,6846,0
2020-06-27,Russia,NA,Voronezh Oblast,2333768,190,0,7036,0
2020-06-28,Russia,NA,Voronezh Oblast,2333768,188,0,7224,0
2020-06-29,Russia,NA,Voronezh Oblast,2333768,185,0,7409,0
2020-06-30,Russia,NA,Voronezh Oblast,2333768,179,0,7588,0
2020-07-01,Russia,NA,Voronezh Oblast,2333768,166,0,7754,0
2020-07-02,Russia,NA,Voronezh Oblast,2333768,154,0,7908,0
2020-07-03,Russia,NA,Voronezh Oblast,2333768,151,0,8059,0
2020-07-04,Russia,NA,Voronezh Oblast,2333768,152,0,8211,0
2020-07-05,Russia,NA,Voronezh Oblast,2333768,148,0,8359,0
2020-07-06,Russia,NA,Voronezh Oblast,2333768,146,0,8505,0
2020-07-07,Russia,NA,Voronezh Oblast,2333768,139,0,8644,0
2020-07-08,Russia,NA,Voronezh Oblast,2333768,134,0,8778,0
2020-07-09,Russia,NA,Voronezh Oblast,2333768,131,0,8909,0
2020-07-10,Russia,NA,Voronezh Oblast,2333768,127,0,9036,0
2020-07-11,Russia,NA,Voronezh Oblast,2333768,123,0,9159,0
2020-07-12,Russia,NA,Voronezh Oblast,2333768,121,0,9280,0
2020-07-13,Russia,NA,Voronezh Oblast,2333768,119,0,9399,0
2020-07-14,Russia,NA,Voronezh Oblast,2333768,117,0,9516,0
2020-07-15,Russia,NA,Voronezh Oblast,2333768,115,0,9631,0
2020-07-16,Russia,NA,Voronezh Oblast,2333768,112,0,9743,0
2020-07-17,Russia,NA,Voronezh Oblast,2333768,109,0,9852,0
2020-07-18,Russia,NA,Voronezh Oblast,2333768,108,0,9960,0
2020-07-19,Russia,NA,Voronezh Oblast,2333768,105,0,10065,0
2020-07-20,Russia,NA,Voronezh Oblast,2333768,103,0,10168,0
2020-07-21,Russia,NA,Voronezh Oblast,2333768,90,0,10258,0
2020-07-22,Russia,NA,Voronezh Oblast,2333768,89,0,10347,0
2020-07-23,Russia,NA,Voronezh Oblast,2333768,89,0,10436,0
2020-07-24,Russia,NA,Voronezh Oblast,2333768,88,0,10524,0
2020-07-25,Russia,NA,Voronezh Oblast,2333768,99,0,10623,0
2020-07-26,Russia,NA,Voronezh Oblast,2333768,91,0,10714,0
2020-07-27,Russia,NA,Voronezh Oblast,2333768,89,0,10803,0
2020-07-28,Russia,NA,Voronezh Oblast,2333768,87,0,10890,0
2020-07-29,Russia,NA,Voronezh Oblast,2333768,86,0,10976,0
2020-07-30,Russia,NA,Voronezh Oblast,2333768,89,0,11065,0
2020-07-31,Russia,NA,Voronezh Oblast,2333768,88,0,11153,0
2020-08-01,Russia,NA,Voronezh Oblast,2333768,89,0,11242,0
2020-08-02,Russia,NA,Voronezh Oblast,2333768,88,0,11330,0
2020-08-26,Russia,NA,Voronezh Oblast,2333768,0,0,13635,105
2020-08-27,Russia,NA,Voronezh Oblast,2333768,101,2,13736,107
2020-08-28,Russia,NA,Voronezh Oblast,2333768,113,0,13849,107
2020-08-29,Russia,NA,Voronezh Oblast,2333768,98,2,13947,109
2020-08-30,Russia,NA,Voronezh Oblast,2333768,99,0,14046,109
2020-08-31,Russia,NA,Voronezh Oblast,2333768,98,0,14144,109
2020-09-01,Russia,NA,Voronezh Oblast,2333768,97,6,14241,115
2020-09-02,Russia,NA,Voronezh Oblast,2333768,99,0,14340,115
2020-09-03,Russia,NA,Voronezh Oblast,2333768,101,2,14441,117
2020-09-04,Russia,NA,Voronezh Oblast,2333768,99,1,14540,118
2020-09-05,Russia,NA,Voronezh Oblast,2333768,105,5,14645,123
2020-09-06,Russia,NA,Voronezh Oblast,2333768,107,0,14752,123
2020-09-07,Russia,NA,Voronezh Oblast,2333768,109,0,14861,123
2020-09-08,Russia,NA,Voronezh Oblast,2333768,108,6,14969,129
2020-09-09,Russia,NA,Voronezh Oblast,2333768,113,0,15082,129
2020-09-10,Russia,NA,Voronezh Oblast,2333768,110,6,15192,135
2020-09-11,Russia,NA,Voronezh Oblast,2333768,111,3,15303,138
2020-09-12,Russia,NA,Voronezh Oblast,2333768,115,0,15418,138
2020-09-13,Russia,NA,Voronezh Oblast,2333768,110,0,15528,138
2020-09-14,Russia,NA,Voronezh Oblast,2333768,111,0,15639,138
2020-09-15,Russia,NA,Voronezh Oblast,2333768,112,2,15751,140
2020-09-16,Russia,NA,Voronezh Oblast,2333768,116,2,15867,142
2020-09-17,Russia,NA,Voronezh Oblast,2333768,115,6,15982,148
2020-09-18,Russia,NA,Voronezh Oblast,2333768,123,0,16105,148
2020-09-19,Russia,NA,Voronezh Oblast,2333768,151,5,16256,153
2020-09-20,Russia,NA,Voronezh Oblast,2333768,158,0,16414,153
2020-09-21,Russia,NA,Voronezh Oblast,2333768,160,0,16574,153
2020-09-22,Russia,NA,Voronezh Oblast,2333768,149,5,16723,158
2020-09-23,Russia,NA,Voronezh Oblast,2333768,152,5,16875,163
2020-03-26,Russia,NA,Yakutia,964330,4,0,14,0
2020-03-29,Russia,NA,Yakutia,964330,1,0,15,0
2020-04-08,Russia,NA,Yakutia,964330,1,0,16,0
2020-04-11,Russia,NA,Yakutia,964330,3,0,19,0
2020-04-12,Russia,NA,Yakutia,964330,3,0,22,0
2020-04-13,Russia,NA,Yakutia,964330,3,0,25,0
2020-04-14,Russia,NA,Yakutia,964330,1,0,26,0
2020-04-15,Russia,NA,Yakutia,964330,7,0,33,0
2020-04-16,Russia,NA,Yakutia,964330,2,0,35,0
2020-04-17,Russia,NA,Yakutia,964330,3,0,38,0
2020-04-18,Russia,NA,Yakutia,964330,9,0,47,0
2020-04-19,Russia,NA,Yakutia,964330,41,0,88,0
2020-04-20,Russia,NA,Yakutia,964330,19,0,107,0
2020-04-21,Russia,NA,Yakutia,964330,4,0,111,0
2020-04-22,Russia,NA,Yakutia,964330,5,0,116,0
2020-04-23,Russia,NA,Yakutia,964330,12,0,128,0
2020-04-24,Russia,NA,Yakutia,964330,9,0,137,0
2020-04-25,Russia,NA,Yakutia,964330,4,0,141,0
2020-04-26,Russia,NA,Yakutia,964330,11,0,152,0
2020-04-27,Russia,NA,Yakutia,964330,7,0,159,0
2020-04-28,Russia,NA,Yakutia,964330,7,0,166,0
2020-04-29,Russia,NA,Yakutia,964330,17,0,183,0
2020-04-30,Russia,NA,Yakutia,964330,24,0,207,0
2020-05-01,Russia,NA,Yakutia,964330,22,0,229,0
2020-05-02,Russia,NA,Yakutia,964330,34,0,263,0
2020-05-03,Russia,NA,Yakutia,964330,19,0,282,0
2020-05-04,Russia,NA,Yakutia,964330,29,0,311,0
2020-05-05,Russia,NA,Yakutia,964330,20,0,331,0
2020-05-06,Russia,NA,Yakutia,964330,17,0,348,0
2020-05-07,Russia,NA,Yakutia,964330,37,0,385,0
2020-05-08,Russia,NA,Yakutia,964330,52,0,437,0
2020-05-09,Russia,NA,Yakutia,964330,40,0,477,0
2020-05-10,Russia,NA,Yakutia,964330,33,0,510,0
2020-05-11,Russia,NA,Yakutia,964330,41,0,551,0
2020-05-12,Russia,NA,Yakutia,964330,55,0,606,0
2020-05-13,Russia,NA,Yakutia,964330,46,0,652,0
2020-05-14,Russia,NA,Yakutia,964330,35,0,687,0
2020-05-15,Russia,NA,Yakutia,964330,35,0,722,0
2020-05-16,Russia,NA,Yakutia,964330,63,0,785,0
2020-05-17,Russia,NA,Yakutia,964330,43,0,828,0
2020-05-18,Russia,NA,Yakutia,964330,41,0,869,0
2020-05-19,Russia,NA,Yakutia,964330,45,0,914,0
2020-05-20,Russia,NA,Yakutia,964330,46,0,960,0
2020-05-21,Russia,NA,Yakutia,964330,37,0,997,0
2020-05-22,Russia,NA,Yakutia,964330,80,0,1077,0
2020-05-23,Russia,NA,Yakutia,964330,100,0,1177,0
2020-05-24,Russia,NA,Yakutia,964330,99,0,1276,0
2020-05-25,Russia,NA,Yakutia,964330,81,0,1357,0
2020-05-26,Russia,NA,Yakutia,964330,88,0,1445,0
2020-05-27,Russia,NA,Yakutia,964330,84,0,1529,0
2020-05-28,Russia,NA,Yakutia,964330,94,0,1623,0
2020-05-29,Russia,NA,Yakutia,964330,82,0,1705,0
2020-05-30,Russia,NA,Yakutia,964330,114,0,1819,0
2020-05-31,Russia,NA,Yakutia,964330,111,0,1930,0
2020-06-01,Russia,NA,Yakutia,964330,112,0,2042,0
2020-06-02,Russia,NA,Yakutia,964330,74,0,2116,0
2020-06-03,Russia,NA,Yakutia,964330,98,0,2214,0
2020-06-04,Russia,NA,Yakutia,964330,94,0,2308,0
2020-06-05,Russia,NA,Yakutia,964330,72,0,2380,0
2020-06-06,Russia,NA,Yakutia,964330,73,0,2453,0
2020-06-07,Russia,NA,Yakutia,964330,78,0,2531,0
2020-06-08,Russia,NA,Yakutia,964330,80,0,2611,0
2020-06-09,Russia,NA,Yakutia,964330,75,0,2686,0
2020-06-10,Russia,NA,Yakutia,964330,67,0,2753,0
2020-06-11,Russia,NA,Yakutia,964330,69,0,2822,0
2020-06-12,Russia,NA,Yakutia,964330,76,0,2898,0
2020-06-13,Russia,NA,Yakutia,964330,70,0,2968,0
2020-06-14,Russia,NA,Yakutia,964330,69,0,3037,0
2020-06-15,Russia,NA,Yakutia,964330,85,0,3122,0
2020-06-16,Russia,NA,Yakutia,964330,77,0,3199,0
2020-06-17,Russia,NA,Yakutia,964330,91,0,3290,0
2020-06-18,Russia,NA,Yakutia,964330,99,0,3389,0
2020-06-19,Russia,NA,Yakutia,964330,97,0,3486,0
2020-06-20,Russia,NA,Yakutia,964330,84,0,3570,0
2020-06-21,Russia,NA,Yakutia,964330,87,0,3657,0
2020-06-22,Russia,NA,Yakutia,964330,85,0,3742,0
2020-06-23,Russia,NA,Yakutia,964330,75,0,3817,0
2020-06-24,Russia,NA,Yakutia,964330,74,0,3891,0
2020-06-25,Russia,NA,Yakutia,964330,72,0,3963,0
2020-06-26,Russia,NA,Yakutia,964330,50,0,4013,0
2020-06-27,Russia,NA,Yakutia,964330,62,0,4075,0
2020-06-28,Russia,NA,Yakutia,964330,53,0,4128,0
2020-06-29,Russia,NA,Yakutia,964330,50,0,4178,0
2020-06-30,Russia,NA,Yakutia,964330,45,0,4223,0
2020-07-01,Russia,NA,Yakutia,964330,44,0,4267,0
2020-07-02,Russia,NA,Yakutia,964330,48,0,4315,0
2020-07-03,Russia,NA,Yakutia,964330,50,0,4365,0
2020-07-04,Russia,NA,Yakutia,964330,57,0,4422,0
2020-07-05,Russia,NA,Yakutia,964330,45,0,4467,0
2020-07-06,Russia,NA,Yakutia,964330,37,0,4504,0
2020-07-07,Russia,NA,Yakutia,964330,46,0,4550,0
2020-07-08,Russia,NA,Yakutia,964330,48,0,4598,0
2020-07-09,Russia,NA,Yakutia,964330,58,0,4656,0
2020-07-10,Russia,NA,Yakutia,964330,54,0,4710,0
2020-07-11,Russia,NA,Yakutia,964330,47,0,4757,0
2020-07-12,Russia,NA,Yakutia,964330,42,0,4799,0
2020-07-13,Russia,NA,Yakutia,964330,45,0,4844,0
2020-07-14,Russia,NA,Yakutia,964330,60,0,4904,0
2020-07-15,Russia,NA,Yakutia,964330,72,0,4976,0
2020-07-16,Russia,NA,Yakutia,964330,58,0,5034,0
2020-07-17,Russia,NA,Yakutia,964330,55,0,5089,0
2020-07-18,Russia,NA,Yakutia,964330,53,0,5142,0
2020-07-19,Russia,NA,Yakutia,964330,51,0,5193,0
2020-07-20,Russia,NA,Yakutia,964330,46,0,5239,0
2020-07-21,Russia,NA,Yakutia,964330,44,0,5283,0
2020-07-22,Russia,NA,Yakutia,964330,41,0,5324,0
2020-07-23,Russia,NA,Yakutia,964330,51,0,5375,0
2020-07-24,Russia,NA,Yakutia,964330,49,0,5424,0
2020-07-25,Russia,NA,Yakutia,964330,50,0,5474,0
2020-07-26,Russia,NA,Yakutia,964330,47,0,5521,0
2020-07-27,Russia,NA,Yakutia,964330,44,0,5565,0
2020-07-28,Russia,NA,Yakutia,964330,49,0,5614,0
2020-07-29,Russia,NA,Yakutia,964330,57,0,5671,0
2020-07-30,Russia,NA,Yakutia,964330,56,0,5727,0
2020-07-31,Russia,NA,Yakutia,964330,60,0,5787,0
2020-08-01,Russia,NA,Yakutia,964330,58,0,5845,0
2020-08-02,Russia,NA,Yakutia,964330,54,0,5899,0
2020-08-26,Russia,NA,Yakutia,964330,0,0,7166,79
2020-08-27,Russia,NA,Yakutia,964330,44,0,7210,79
2020-08-28,Russia,NA,Yakutia,964330,43,2,7253,81
2020-08-29,Russia,NA,Yakutia,964330,42,0,7295,81
2020-08-30,Russia,NA,Yakutia,964330,43,0,7338,81
2020-08-31,Russia,NA,Yakutia,964330,41,2,7379,83
2020-09-01,Russia,NA,Yakutia,964330,46,0,7425,83
2020-09-02,Russia,NA,Yakutia,964330,48,0,7473,83
2020-09-03,Russia,NA,Yakutia,964330,47,6,7520,89
2020-09-04,Russia,NA,Yakutia,964330,52,1,7572,90
2020-09-05,Russia,NA,Yakutia,964330,50,0,7622,90
2020-09-06,Russia,NA,Yakutia,964330,59,0,7681,90
2020-09-07,Russia,NA,Yakutia,964330,58,0,7739,90
2020-09-08,Russia,NA,Yakutia,964330,58,0,7797,90
2020-09-09,Russia,NA,Yakutia,964330,63,0,7860,90
2020-09-10,Russia,NA,Yakutia,964330,65,0,7925,90
2020-09-11,Russia,NA,Yakutia,964330,67,0,7992,90
2020-09-12,Russia,NA,Yakutia,964330,69,0,8061,90
2020-09-13,Russia,NA,Yakutia,964330,68,0,8129,90
2020-09-14,Russia,NA,Yakutia,964330,69,0,8198,90
2020-09-15,Russia,NA,Yakutia,964330,65,0,8263,90
2020-09-16,Russia,NA,Yakutia,964330,68,0,8331,90
2020-09-17,Russia,NA,Yakutia,964330,69,0,8400,90
2020-09-18,Russia,NA,Yakutia,964330,67,0,8467,90
2020-09-19,Russia,NA,Yakutia,964330,69,3,8536,93
2020-09-20,Russia,NA,Yakutia,964330,68,0,8604,93
2020-09-21,Russia,NA,Yakutia,964330,67,0,8671,93
2020-09-22,Russia,NA,Yakutia,964330,66,0,8737,93
2020-09-23,Russia,NA,Yakutia,964330,70,2,8807,95
2020-04-03,Russia,NA,Yamalo-Nenets Avtonomnyy Okrug,538547,10,0,12,0
2020-04-07,Russia,NA,Yamalo-Nenets Avtonomnyy Okrug,538547,18,0,30,0
2020-04-08,Russia,NA,Yamalo-Nenets Avtonomnyy Okrug,538547,11,0,41,0
2020-04-11,Russia,NA,Yamalo-Nenets Avtonomnyy Okrug,538547,9,0,50,0
2020-04-12,Russia,NA,Yamalo-Nenets Avtonomnyy Okrug,538547,12,0,62,0
2020-04-13,Russia,NA,Yamalo-Nenets Avtonomnyy Okrug,538547,4,0,66,0
2020-04-15,Russia,NA,Yamalo-Nenets Avtonomnyy Okrug,538547,7,0,73,0
2020-04-16,Russia,NA,Yamalo-Nenets Avtonomnyy Okrug,538547,22,0,95,0
2020-04-17,Russia,NA,Yamalo-Nenets Avtonomnyy Okrug,538547,6,0,101,0
2020-04-18,Russia,NA,Yamalo-Nenets Avtonomnyy Okrug,538547,5,0,106,0
2020-04-19,Russia,NA,Yamalo-Nenets Avtonomnyy Okrug,538547,10,0,116,0
2020-04-20,Russia,NA,Yamalo-Nenets Avtonomnyy Okrug,538547,24,0,140,0
2020-04-21,Russia,NA,Yamalo-Nenets Avtonomnyy Okrug,538547,6,0,146,0
2020-04-22,Russia,NA,Yamalo-Nenets Avtonomnyy Okrug,538547,3,0,149,0
2020-04-23,Russia,NA,Yamalo-Nenets Avtonomnyy Okrug,538547,94,0,243,0
2020-04-24,Russia,NA,Yamalo-Nenets Avtonomnyy Okrug,538547,23,0,266,0
2020-04-25,Russia,NA,Yamalo-Nenets Avtonomnyy Okrug,538547,37,0,303,0
2020-04-26,Russia,NA,Yamalo-Nenets Avtonomnyy Okrug,538547,45,0,348,0
2020-04-27,Russia,NA,Yamalo-Nenets Avtonomnyy Okrug,538547,27,0,375,0
2020-04-28,Russia,NA,Yamalo-Nenets Avtonomnyy Okrug,538547,12,0,387,0
2020-04-29,Russia,NA,Yamalo-Nenets Avtonomnyy Okrug,538547,22,0,409,0
2020-04-30,Russia,NA,Yamalo-Nenets Avtonomnyy Okrug,538547,54,0,463,0
2020-05-01,Russia,NA,Yamalo-Nenets Avtonomnyy Okrug,538547,51,0,514,0
2020-05-02,Russia,NA,Yamalo-Nenets Avtonomnyy Okrug,538547,43,0,557,0
2020-05-03,Russia,NA,Yamalo-Nenets Avtonomnyy Okrug,538547,51,0,608,0
2020-05-04,Russia,NA,Yamalo-Nenets Avtonomnyy Okrug,538547,104,0,712,0
2020-05-05,Russia,NA,Yamalo-Nenets Avtonomnyy Okrug,538547,108,0,820,0
2020-05-06,Russia,NA,Yamalo-Nenets Avtonomnyy Okrug,538547,105,0,925,0
2020-05-07,Russia,NA,Yamalo-Nenets Avtonomnyy Okrug,538547,93,0,1018,0
2020-05-08,Russia,NA,Yamalo-Nenets Avtonomnyy Okrug,538547,36,0,1054,0
2020-05-09,Russia,NA,Yamalo-Nenets Avtonomnyy Okrug,538547,51,0,1105,0
2020-05-10,Russia,NA,Yamalo-Nenets Avtonomnyy Okrug,538547,72,0,1177,0
2020-05-11,Russia,NA,Yamalo-Nenets Avtonomnyy Okrug,538547,62,0,1239,0
2020-05-12,Russia,NA,Yamalo-Nenets Avtonomnyy Okrug,538547,72,0,1311,0
2020-05-13,Russia,NA,Yamalo-Nenets Avtonomnyy Okrug,538547,49,0,1360,0
2020-05-14,Russia,NA,Yamalo-Nenets Avtonomnyy Okrug,538547,73,0,1433,0
2020-05-15,Russia,NA,Yamalo-Nenets Avtonomnyy Okrug,538547,115,0,1548,0
2020-05-16,Russia,NA,Yamalo-Nenets Avtonomnyy Okrug,538547,50,0,1598,0
2020-05-17,Russia,NA,Yamalo-Nenets Avtonomnyy Okrug,538547,91,0,1689,0
2020-05-18,Russia,NA,Yamalo-Nenets Avtonomnyy Okrug,538547,59,0,1748,0
2020-05-19,Russia,NA,Yamalo-Nenets Avtonomnyy Okrug,538547,58,0,1806,0
2020-05-20,Russia,NA,Yamalo-Nenets Avtonomnyy Okrug,538547,32,0,1838,0
2020-05-21,Russia,NA,Yamalo-Nenets Avtonomnyy Okrug,538547,64,0,1902,0
2020-05-22,Russia,NA,Yamalo-Nenets Avtonomnyy Okrug,538547,87,0,1989,0
2020-05-23,Russia,NA,Yamalo-Nenets Avtonomnyy Okrug,538547,36,0,2025,0
2020-05-24,Russia,NA,Yamalo-Nenets Avtonomnyy Okrug,538547,29,0,2054,0
2020-05-25,Russia,NA,Yamalo-Nenets Avtonomnyy Okrug,538547,38,0,2092,0
2020-05-26,Russia,NA,Yamalo-Nenets Avtonomnyy Okrug,538547,59,0,2151,0
2020-05-27,Russia,NA,Yamalo-Nenets Avtonomnyy Okrug,538547,51,0,2202,0
2020-05-28,Russia,NA,Yamalo-Nenets Avtonomnyy Okrug,538547,47,0,2249,0
2020-05-29,Russia,NA,Yamalo-Nenets Avtonomnyy Okrug,538547,31,0,2280,0
2020-05-30,Russia,NA,Yamalo-Nenets Avtonomnyy Okrug,538547,30,0,2310,0
2020-05-31,Russia,NA,Yamalo-Nenets Avtonomnyy Okrug,538547,65,0,2375,0
2020-06-01,Russia,NA,Yamalo-Nenets Avtonomnyy Okrug,538547,40,0,2415,0
2020-06-02,Russia,NA,Yamalo-Nenets Avtonomnyy Okrug,538547,51,0,2466,0
2020-06-03,Russia,NA,Yamalo-Nenets Avtonomnyy Okrug,538547,13,0,2479,0
2020-06-04,Russia,NA,Yamalo-Nenets Avtonomnyy Okrug,538547,55,0,2534,0
2020-06-05,Russia,NA,Yamalo-Nenets Avtonomnyy Okrug,538547,45,0,2579,0
2020-06-06,Russia,NA,Yamalo-Nenets Avtonomnyy Okrug,538547,42,0,2621,0
2020-06-07,Russia,NA,Yamalo-Nenets Avtonomnyy Okrug,538547,73,0,2694,0
2020-06-08,Russia,NA,Yamalo-Nenets Avtonomnyy Okrug,538547,83,0,2777,0
2020-06-09,Russia,NA,Yamalo-Nenets Avtonomnyy Okrug,538547,56,0,2833,0
2020-06-10,Russia,NA,Yamalo-Nenets Avtonomnyy Okrug,538547,54,0,2887,0
2020-06-11,Russia,NA,Yamalo-Nenets Avtonomnyy Okrug,538547,77,0,2964,0
2020-06-12,Russia,NA,Yamalo-Nenets Avtonomnyy Okrug,538547,122,0,3086,0
2020-06-13,Russia,NA,Yamalo-Nenets Avtonomnyy Okrug,538547,125,0,3211,0
2020-06-14,Russia,NA,Yamalo-Nenets Avtonomnyy Okrug,538547,114,0,3325,0
2020-06-15,Russia,NA,Yamalo-Nenets Avtonomnyy Okrug,538547,87,0,3412,0
2020-06-16,Russia,NA,Yamalo-Nenets Avtonomnyy Okrug,538547,93,0,3505,0
2020-06-17,Russia,NA,Yamalo-Nenets Avtonomnyy Okrug,538547,81,0,3586,0
2020-06-18,Russia,NA,Yamalo-Nenets Avtonomnyy Okrug,538547,127,0,3713,0
2020-06-19,Russia,NA,Yamalo-Nenets Avtonomnyy Okrug,538547,121,0,3834,0
2020-06-20,Russia,NA,Yamalo-Nenets Avtonomnyy Okrug,538547,132,0,3966,0
2020-06-21,Russia,NA,Yamalo-Nenets Avtonomnyy Okrug,538547,165,0,4131,0
2020-06-22,Russia,NA,Yamalo-Nenets Avtonomnyy Okrug,538547,140,0,4271,0
2020-06-23,Russia,NA,Yamalo-Nenets Avtonomnyy Okrug,538547,145,0,4416,0
2020-06-24,Russia,NA,Yamalo-Nenets Avtonomnyy Okrug,538547,137,0,4553,0
2020-06-25,Russia,NA,Yamalo-Nenets Avtonomnyy Okrug,538547,156,0,4709,0
2020-06-26,Russia,NA,Yamalo-Nenets Avtonomnyy Okrug,538547,149,0,4858,0
2020-06-27,Russia,NA,Yamalo-Nenets Avtonomnyy Okrug,538547,147,0,5005,0
2020-06-28,Russia,NA,Yamalo-Nenets Avtonomnyy Okrug,538547,154,0,5159,0
2020-06-29,Russia,NA,Yamalo-Nenets Avtonomnyy Okrug,538547,173,0,5332,0
2020-06-30,Russia,NA,Yamalo-Nenets Avtonomnyy Okrug,538547,248,0,5580,0
2020-07-01,Russia,NA,Yamalo-Nenets Avtonomnyy Okrug,538547,203,0,5783,0
2020-07-02,Russia,NA,Yamalo-Nenets Avtonomnyy Okrug,538547,197,0,5980,0
2020-07-03,Russia,NA,Yamalo-Nenets Avtonomnyy Okrug,538547,191,0,6171,0
2020-07-04,Russia,NA,Yamalo-Nenets Avtonomnyy Okrug,538547,197,0,6368,0
2020-07-05,Russia,NA,Yamalo-Nenets Avtonomnyy Okrug,538547,187,0,6555,0
2020-07-06,Russia,NA,Yamalo-Nenets Avtonomnyy Okrug,538547,197,0,6752,0
2020-07-07,Russia,NA,Yamalo-Nenets Avtonomnyy Okrug,538547,189,0,6941,0
2020-07-08,Russia,NA,Yamalo-Nenets Avtonomnyy Okrug,538547,202,0,7143,0
2020-07-09,Russia,NA,Yamalo-Nenets Avtonomnyy Okrug,538547,196,0,7339,0
2020-07-10,Russia,NA,Yamalo-Nenets Avtonomnyy Okrug,538547,208,0,7547,0
2020-07-11,Russia,NA,Yamalo-Nenets Avtonomnyy Okrug,538547,195,0,7742,0
2020-07-12,Russia,NA,Yamalo-Nenets Avtonomnyy Okrug,538547,212,0,7954,0
2020-07-13,Russia,NA,Yamalo-Nenets Avtonomnyy Okrug,538547,205,0,8159,0
2020-07-14,Russia,NA,Yamalo-Nenets Avtonomnyy Okrug,538547,211,0,8370,0
2020-07-15,Russia,NA,Yamalo-Nenets Avtonomnyy Okrug,538547,202,0,8572,0
2020-07-16,Russia,NA,Yamalo-Nenets Avtonomnyy Okrug,538547,187,0,8759,0
2020-07-17,Russia,NA,Yamalo-Nenets Avtonomnyy Okrug,538547,206,0,8965,0
2020-07-18,Russia,NA,Yamalo-Nenets Avtonomnyy Okrug,538547,182,0,9147,0
2020-07-19,Russia,NA,Yamalo-Nenets Avtonomnyy Okrug,538547,176,0,9323,0
2020-07-20,Russia,NA,Yamalo-Nenets Avtonomnyy Okrug,538547,155,0,9478,0
2020-07-21,Russia,NA,Yamalo-Nenets Avtonomnyy Okrug,538547,178,0,9656,0
2020-07-22,Russia,NA,Yamalo-Nenets Avtonomnyy Okrug,538547,175,0,9831,0
2020-07-23,Russia,NA,Yamalo-Nenets Avtonomnyy Okrug,538547,170,0,10001,0
2020-07-24,Russia,NA,Yamalo-Nenets Avtonomnyy Okrug,538547,158,0,10159,0
2020-07-25,Russia,NA,Yamalo-Nenets Avtonomnyy Okrug,538547,130,0,10289,0
2020-07-26,Russia,NA,Yamalo-Nenets Avtonomnyy Okrug,538547,125,0,10414,0
2020-07-27,Russia,NA,Yamalo-Nenets Avtonomnyy Okrug,538547,123,0,10537,0
2020-07-28,Russia,NA,Yamalo-Nenets Avtonomnyy Okrug,538547,136,0,10673,0
2020-07-29,Russia,NA,Yamalo-Nenets Avtonomnyy Okrug,538547,115,0,10788,0
2020-07-30,Russia,NA,Yamalo-Nenets Avtonomnyy Okrug,538547,116,0,10904,0
2020-07-31,Russia,NA,Yamalo-Nenets Avtonomnyy Okrug,538547,112,0,11016,0
2020-08-01,Russia,NA,Yamalo-Nenets Avtonomnyy Okrug,538547,111,0,11127,0
2020-08-02,Russia,NA,Yamalo-Nenets Avtonomnyy Okrug,538547,108,0,11235,0
2020-08-26,Russia,NA,Yamalo-Nenets Avtonomnyy Okrug,538547,0,0,13180,90
2020-08-27,Russia,NA,Yamalo-Nenets Avtonomnyy Okrug,538547,42,0,13222,90
2020-08-28,Russia,NA,Yamalo-Nenets Avtonomnyy Okrug,538547,47,0,13269,90
2020-08-29,Russia,NA,Yamalo-Nenets Avtonomnyy Okrug,538547,46,0,13315,90
2020-08-30,Russia,NA,Yamalo-Nenets Avtonomnyy Okrug,538547,49,0,13364,90
2020-08-31,Russia,NA,Yamalo-Nenets Avtonomnyy Okrug,538547,47,0,13411,90
2020-09-01,Russia,NA,Yamalo-Nenets Avtonomnyy Okrug,538547,46,0,13457,90
2020-09-02,Russia,NA,Yamalo-Nenets Avtonomnyy Okrug,538547,46,0,13503,90
2020-09-03,Russia,NA,Yamalo-Nenets Avtonomnyy Okrug,538547,44,1,13547,91
2020-09-04,Russia,NA,Yamalo-Nenets Avtonomnyy Okrug,538547,47,1,13594,92
2020-09-05,Russia,NA,Yamalo-Nenets Avtonomnyy Okrug,538547,46,1,13640,93
2020-09-06,Russia,NA,Yamalo-Nenets Avtonomnyy Okrug,538547,55,0,13695,93
2020-09-07,Russia,NA,Yamalo-Nenets Avtonomnyy Okrug,538547,44,0,13739,93
2020-09-08,Russia,NA,Yamalo-Nenets Avtonomnyy Okrug,538547,53,1,13792,94
2020-09-09,Russia,NA,Yamalo-Nenets Avtonomnyy Okrug,538547,48,0,13840,94
2020-09-10,Russia,NA,Yamalo-Nenets Avtonomnyy Okrug,538547,54,1,13894,95
2020-09-11,Russia,NA,Yamalo-Nenets Avtonomnyy Okrug,538547,50,0,13944,95
2020-09-12,Russia,NA,Yamalo-Nenets Avtonomnyy Okrug,538547,48,0,13992,95
2020-09-13,Russia,NA,Yamalo-Nenets Avtonomnyy Okrug,538547,50,2,14042,97
2020-09-14,Russia,NA,Yamalo-Nenets Avtonomnyy Okrug,538547,59,0,14101,97
2020-09-15,Russia,NA,Yamalo-Nenets Avtonomnyy Okrug,538547,61,0,14162,97
2020-09-16,Russia,NA,Yamalo-Nenets Avtonomnyy Okrug,538547,58,0,14220,97
2020-09-17,Russia,NA,Yamalo-Nenets Avtonomnyy Okrug,538547,62,0,14282,97
2020-09-18,Russia,NA,Yamalo-Nenets Avtonomnyy Okrug,538547,59,1,14341,98
2020-09-19,Russia,NA,Yamalo-Nenets Avtonomnyy Okrug,538547,57,0,14398,98
2020-09-20,Russia,NA,Yamalo-Nenets Avtonomnyy Okrug,538547,63,1,14461,99
2020-09-21,Russia,NA,Yamalo-Nenets Avtonomnyy Okrug,538547,65,0,14526,99
2020-09-22,Russia,NA,Yamalo-Nenets Avtonomnyy Okrug,538547,68,0,14594,99
2020-09-23,Russia,NA,Yamalo-Nenets Avtonomnyy Okrug,538547,75,0,14669,99
2020-04-07,Russia,NA,Yaroslavl Oblast,1265684,5,0,11,0
2020-04-09,Russia,NA,Yaroslavl Oblast,1265684,2,0,13,0
2020-04-12,Russia,NA,Yaroslavl Oblast,1265684,14,0,27,0
2020-04-15,Russia,NA,Yaroslavl Oblast,1265684,12,0,39,0
2020-04-16,Russia,NA,Yaroslavl Oblast,1265684,23,0,62,0
2020-04-17,Russia,NA,Yaroslavl Oblast,1265684,19,0,81,0
2020-04-18,Russia,NA,Yaroslavl Oblast,1265684,24,0,105,0
2020-04-19,Russia,NA,Yaroslavl Oblast,1265684,12,0,117,0
2020-04-20,Russia,NA,Yaroslavl Oblast,1265684,27,0,144,0
2020-04-21,Russia,NA,Yaroslavl Oblast,1265684,43,0,187,0
2020-04-22,Russia,NA,Yaroslavl Oblast,1265684,11,0,198,0
2020-04-23,Russia,NA,Yaroslavl Oblast,1265684,65,0,263,0
2020-04-24,Russia,NA,Yaroslavl Oblast,1265684,42,0,305,0
2020-04-25,Russia,NA,Yaroslavl Oblast,1265684,37,0,342,0
2020-04-26,Russia,NA,Yaroslavl Oblast,1265684,42,0,384,0
2020-04-27,Russia,NA,Yaroslavl Oblast,1265684,25,0,409,0
2020-04-28,Russia,NA,Yaroslavl Oblast,1265684,47,0,456,0
2020-04-29,Russia,NA,Yaroslavl Oblast,1265684,27,0,483,0
2020-04-30,Russia,NA,Yaroslavl Oblast,1265684,23,0,506,0
2020-05-01,Russia,NA,Yaroslavl Oblast,1265684,64,0,570,0
2020-05-02,Russia,NA,Yaroslavl Oblast,1265684,64,0,634,0
2020-05-03,Russia,NA,Yaroslavl Oblast,1265684,76,0,710,0
2020-05-04,Russia,NA,Yaroslavl Oblast,1265684,79,0,789,0
2020-05-05,Russia,NA,Yaroslavl Oblast,1265684,40,0,829,0
2020-05-06,Russia,NA,Yaroslavl Oblast,1265684,51,0,880,0
2020-05-07,Russia,NA,Yaroslavl Oblast,1265684,55,0,935,0
2020-05-08,Russia,NA,Yaroslavl Oblast,1265684,58,0,993,0
2020-05-09,Russia,NA,Yaroslavl Oblast,1265684,58,0,1051,0
2020-05-10,Russia,NA,Yaroslavl Oblast,1265684,63,0,1114,0
2020-05-11,Russia,NA,Yaroslavl Oblast,1265684,78,0,1192,0
2020-05-12,Russia,NA,Yaroslavl Oblast,1265684,83,0,1275,0
2020-05-13,Russia,NA,Yaroslavl Oblast,1265684,88,0,1363,0
2020-05-14,Russia,NA,Yaroslavl Oblast,1265684,87,0,1450,0
2020-05-15,Russia,NA,Yaroslavl Oblast,1265684,87,0,1537,0
2020-05-16,Russia,NA,Yaroslavl Oblast,1265684,92,0,1629,0
2020-05-17,Russia,NA,Yaroslavl Oblast,1265684,97,0,1726,0
2020-05-18,Russia,NA,Yaroslavl Oblast,1265684,103,0,1829,0
2020-05-19,Russia,NA,Yaroslavl Oblast,1265684,109,0,1938,0
2020-05-20,Russia,NA,Yaroslavl Oblast,1265684,135,0,2073,0
2020-05-21,Russia,NA,Yaroslavl Oblast,1265684,133,0,2206,0
2020-05-22,Russia,NA,Yaroslavl Oblast,1265684,103,0,2309,0
2020-05-23,Russia,NA,Yaroslavl Oblast,1265684,115,0,2424,0
2020-05-24,Russia,NA,Yaroslavl Oblast,1265684,107,0,2531,0
2020-05-25,Russia,NA,Yaroslavl Oblast,1265684,101,0,2632,0
2020-05-26,Russia,NA,Yaroslavl Oblast,1265684,94,0,2726,0
2020-05-27,Russia,NA,Yaroslavl Oblast,1265684,82,0,2808,0
2020-05-28,Russia,NA,Yaroslavl Oblast,1265684,84,0,2892,0
2020-05-29,Russia,NA,Yaroslavl Oblast,1265684,84,0,2976,0
2020-05-30,Russia,NA,Yaroslavl Oblast,1265684,79,0,3055,0
2020-05-31,Russia,NA,Yaroslavl Oblast,1265684,77,0,3132,0
2020-06-01,Russia,NA,Yaroslavl Oblast,1265684,78,0,3210,0
2020-06-02,Russia,NA,Yaroslavl Oblast,1265684,74,0,3284,0
2020-06-03,Russia,NA,Yaroslavl Oblast,1265684,72,0,3356,0
2020-06-04,Russia,NA,Yaroslavl Oblast,1265684,74,0,3430,0
2020-06-05,Russia,NA,Yaroslavl Oblast,1265684,71,0,3501,0
2020-06-06,Russia,NA,Yaroslavl Oblast,1265684,75,0,3576,0
2020-06-07,Russia,NA,Yaroslavl Oblast,1265684,70,0,3646,0
2020-06-08,Russia,NA,Yaroslavl Oblast,1265684,68,0,3714,0
2020-06-09,Russia,NA,Yaroslavl Oblast,1265684,67,0,3781,0
2020-06-10,Russia,NA,Yaroslavl Oblast,1265684,63,0,3844,0
2020-06-11,Russia,NA,Yaroslavl Oblast,1265684,59,0,3903,0
2020-06-12,Russia,NA,Yaroslavl Oblast,1265684,60,0,3963,0
2020-06-13,Russia,NA,Yaroslavl Oblast,1265684,57,0,4020,0
2020-06-14,Russia,NA,Yaroslavl Oblast,1265684,53,0,4073,0
2020-06-15,Russia,NA,Yaroslavl Oblast,1265684,48,0,4121,0
2020-06-16,Russia,NA,Yaroslavl Oblast,1265684,41,0,4162,0
2020-06-17,Russia,NA,Yaroslavl Oblast,1265684,49,0,4211,0
2020-06-18,Russia,NA,Yaroslavl Oblast,1265684,45,0,4256,0
2020-06-19,Russia,NA,Yaroslavl Oblast,1265684,39,0,4295,0
2020-06-20,Russia,NA,Yaroslavl Oblast,1265684,47,0,4342,0
2020-06-21,Russia,NA,Yaroslavl Oblast,1265684,48,0,4390,0
2020-06-22,Russia,NA,Yaroslavl Oblast,1265684,45,0,4435,0
2020-06-23,Russia,NA,Yaroslavl Oblast,1265684,47,0,4482,0
2020-06-24,Russia,NA,Yaroslavl Oblast,1265684,44,0,4526,0
2020-06-25,Russia,NA,Yaroslavl Oblast,1265684,45,0,4571,0
2020-06-26,Russia,NA,Yaroslavl Oblast,1265684,43,0,4614,0
2020-06-27,Russia,NA,Yaroslavl Oblast,1265684,44,0,4658,0
2020-06-28,Russia,NA,Yaroslavl Oblast,1265684,41,0,4699,0
2020-06-29,Russia,NA,Yaroslavl Oblast,1265684,42,0,4741,0
2020-06-30,Russia,NA,Yaroslavl Oblast,1265684,44,0,4785,0
2020-07-01,Russia,NA,Yaroslavl Oblast,1265684,40,0,4825,0
2020-07-02,Russia,NA,Yaroslavl Oblast,1265684,41,0,4866,0
2020-07-03,Russia,NA,Yaroslavl Oblast,1265684,43,0,4909,0
2020-07-04,Russia,NA,Yaroslavl Oblast,1265684,45,0,4954,0
2020-07-05,Russia,NA,Yaroslavl Oblast,1265684,37,0,4991,0
2020-07-06,Russia,NA,Yaroslavl Oblast,1265684,40,0,5031,0
2020-07-07,Russia,NA,Yaroslavl Oblast,1265684,38,0,5069,0
2020-07-08,Russia,NA,Yaroslavl Oblast,1265684,37,0,5106,0
2020-07-09,Russia,NA,Yaroslavl Oblast,1265684,41,0,5147,0
2020-07-10,Russia,NA,Yaroslavl Oblast,1265684,43,0,5190,0
2020-07-11,Russia,NA,Yaroslavl Oblast,1265684,40,0,5230,0
2020-07-12,Russia,NA,Yaroslavl Oblast,1265684,37,0,5267,0
2020-07-13,Russia,NA,Yaroslavl Oblast,1265684,39,0,5306,0
2020-07-14,Russia,NA,Yaroslavl Oblast,1265684,41,0,5347,0
2020-07-15,Russia,NA,Yaroslavl Oblast,1265684,40,0,5387,0
2020-07-16,Russia,NA,Yaroslavl Oblast,1265684,44,0,5431,0
2020-07-17,Russia,NA,Yaroslavl Oblast,1265684,45,0,5476,0
2020-07-18,Russia,NA,Yaroslavl Oblast,1265684,43,0,5519,0
2020-07-19,Russia,NA,Yaroslavl Oblast,1265684,41,0,5560,0
2020-07-20,Russia,NA,Yaroslavl Oblast,1265684,38,0,5598,0
2020-07-21,Russia,NA,Yaroslavl Oblast,1265684,39,0,5637,0
2020-07-22,Russia,NA,Yaroslavl Oblast,1265684,40,0,5677,0
2020-07-23,Russia,NA,Yaroslavl Oblast,1265684,42,0,5719,0
2020-07-24,Russia,NA,Yaroslavl Oblast,1265684,41,0,5760,0
2020-07-25,Russia,NA,Yaroslavl Oblast,1265684,37,0,5797,0
2020-07-26,Russia,NA,Yaroslavl Oblast,1265684,38,0,5835,0
2020-07-27,Russia,NA,Yaroslavl Oblast,1265684,42,0,5877,0
2020-07-28,Russia,NA,Yaroslavl Oblast,1265684,39,0,5916,0
2020-07-29,Russia,NA,Yaroslavl Oblast,1265684,39,0,5955,0
2020-07-30,Russia,NA,Yaroslavl Oblast,1265684,41,0,5996,0
2020-07-31,Russia,NA,Yaroslavl Oblast,1265684,38,0,6034,0
2020-08-01,Russia,NA,Yaroslavl Oblast,1265684,37,0,6071,0
2020-08-02,Russia,NA,Yaroslavl Oblast,1265684,41,0,6112,0
2020-08-26,Russia,NA,Yaroslavl Oblast,1265684,0,0,7037,33
2020-08-27,Russia,NA,Yaroslavl Oblast,1265684,40,0,7077,33
2020-08-28,Russia,NA,Yaroslavl Oblast,1265684,40,2,7117,35
2020-08-29,Russia,NA,Yaroslavl Oblast,1265684,33,0,7150,35
2020-08-30,Russia,NA,Yaroslavl Oblast,1265684,38,0,7188,35
2020-08-31,Russia,NA,Yaroslavl Oblast,1265684,40,1,7228,36
2020-09-01,Russia,NA,Yaroslavl Oblast,1265684,41,1,7269,37
2020-09-02,Russia,NA,Yaroslavl Oblast,1265684,39,0,7308,37
2020-09-03,Russia,NA,Yaroslavl Oblast,1265684,37,1,7345,38
2020-09-04,Russia,NA,Yaroslavl Oblast,1265684,40,0,7385,38
2020-09-05,Russia,NA,Yaroslavl Oblast,1265684,38,0,7423,38
2020-09-06,Russia,NA,Yaroslavl Oblast,1265684,42,0,7465,38
2020-09-07,Russia,NA,Yaroslavl Oblast,1265684,39,0,7504,38
2020-09-08,Russia,NA,Yaroslavl Oblast,1265684,38,4,7542,42
2020-09-09,Russia,NA,Yaroslavl Oblast,1265684,42,0,7584,42
2020-09-10,Russia,NA,Yaroslavl Oblast,1265684,45,0,7629,42
2020-09-11,Russia,NA,Yaroslavl Oblast,1265684,49,0,7678,42
2020-09-12,Russia,NA,Yaroslavl Oblast,1265684,44,0,7722,42
2020-09-13,Russia,NA,Yaroslavl Oblast,1265684,41,0,7763,42
2020-09-14,Russia,NA,Yaroslavl Oblast,1265684,46,0,7809,42
2020-09-15,Russia,NA,Yaroslavl Oblast,1265684,42,1,7851,43
2020-09-16,Russia,NA,Yaroslavl Oblast,1265684,53,2,7904,45
2020-09-17,Russia,NA,Yaroslavl Oblast,1265684,46,0,7950,45
2020-09-18,Russia,NA,Yaroslavl Oblast,1265684,47,0,7997,45
2020-09-19,Russia,NA,Yaroslavl Oblast,1265684,44,0,8041,45
2020-09-20,Russia,NA,Yaroslavl Oblast,1265684,47,0,8088,45
2020-09-21,Russia,NA,Yaroslavl Oblast,1265684,50,0,8138,45
2020-09-22,Russia,NA,Yaroslavl Oblast,1265684,48,1,8186,46
2020-09-23,Russia,NA,Yaroslavl Oblast,1265684,49,0,8235,46
2020-04-13,Russia,NA,Zabaykalsky Krai,1072806,6,0,14,0
2020-04-16,Russia,NA,Zabaykalsky Krai,1072806,14,0,28,0
2020-04-17,Russia,NA,Zabaykalsky Krai,1072806,2,0,30,0
2020-04-18,Russia,NA,Zabaykalsky Krai,1072806,3,0,33,0
2020-04-19,Russia,NA,Zabaykalsky Krai,1072806,1,0,34,0
2020-04-20,Russia,NA,Zabaykalsky Krai,1072806,9,0,43,0
2020-04-21,Russia,NA,Zabaykalsky Krai,1072806,7,0,50,0
2020-04-22,Russia,NA,Zabaykalsky Krai,1072806,11,0,61,0
2020-04-23,Russia,NA,Zabaykalsky Krai,1072806,3,0,64,0
2020-04-24,Russia,NA,Zabaykalsky Krai,1072806,9,0,73,0
2020-04-25,Russia,NA,Zabaykalsky Krai,1072806,10,0,83,0
2020-04-26,Russia,NA,Zabaykalsky Krai,1072806,7,0,90,0
2020-04-27,Russia,NA,Zabaykalsky Krai,1072806,6,0,96,0
2020-04-28,Russia,NA,Zabaykalsky Krai,1072806,7,0,103,0
2020-04-29,Russia,NA,Zabaykalsky Krai,1072806,6,0,109,0
2020-04-30,Russia,NA,Zabaykalsky Krai,1072806,5,0,114,0
2020-05-01,Russia,NA,Zabaykalsky Krai,1072806,20,0,134,0
2020-05-02,Russia,NA,Zabaykalsky Krai,1072806,21,0,155,0
2020-05-03,Russia,NA,Zabaykalsky Krai,1072806,12,0,167,0
2020-05-04,Russia,NA,Zabaykalsky Krai,1072806,31,0,198,0
2020-05-05,Russia,NA,Zabaykalsky Krai,1072806,17,0,215,0
2020-05-06,Russia,NA,Zabaykalsky Krai,1072806,23,0,238,0
2020-05-07,Russia,NA,Zabaykalsky Krai,1072806,16,0,254,0
2020-05-08,Russia,NA,Zabaykalsky Krai,1072806,8,0,262,0
2020-05-09,Russia,NA,Zabaykalsky Krai,1072806,10,0,272,0
2020-05-10,Russia,NA,Zabaykalsky Krai,1072806,33,0,305,0
2020-05-11,Russia,NA,Zabaykalsky Krai,1072806,39,0,344,0
2020-05-12,Russia,NA,Zabaykalsky Krai,1072806,20,0,364,0
2020-05-13,Russia,NA,Zabaykalsky Krai,1072806,22,0,386,0
2020-05-14,Russia,NA,Zabaykalsky Krai,1072806,46,0,432,0
2020-05-15,Russia,NA,Zabaykalsky Krai,1072806,22,0,454,0
2020-05-16,Russia,NA,Zabaykalsky Krai,1072806,32,0,486,0
2020-05-17,Russia,NA,Zabaykalsky Krai,1072806,24,0,510,0
2020-05-18,Russia,NA,Zabaykalsky Krai,1072806,40,0,550,0
2020-05-19,Russia,NA,Zabaykalsky Krai,1072806,45,0,595,0
2020-05-20,Russia,NA,Zabaykalsky Krai,1072806,20,0,615,0
2020-05-21,Russia,NA,Zabaykalsky Krai,1072806,31,0,646,0
2020-05-22,Russia,NA,Zabaykalsky Krai,1072806,38,0,684,0
2020-05-23,Russia,NA,Zabaykalsky Krai,1072806,43,0,727,0
2020-05-24,Russia,NA,Zabaykalsky Krai,1072806,31,0,758,0
2020-05-25,Russia,NA,Zabaykalsky Krai,1072806,59,0,817,0
2020-05-26,Russia,NA,Zabaykalsky Krai,1072806,62,0,879,0
2020-05-27,Russia,NA,Zabaykalsky Krai,1072806,59,0,938,0
2020-05-28,Russia,NA,Zabaykalsky Krai,1072806,53,0,991,0
2020-05-29,Russia,NA,Zabaykalsky Krai,1072806,28,0,1019,0
2020-05-30,Russia,NA,Zabaykalsky Krai,1072806,33,0,1052,0
2020-05-31,Russia,NA,Zabaykalsky Krai,1072806,45,0,1097,0
2020-06-01,Russia,NA,Zabaykalsky Krai,1072806,39,0,1136,0
2020-06-02,Russia,NA,Zabaykalsky Krai,1072806,29,0,1165,0
2020-06-03,Russia,NA,Zabaykalsky Krai,1072806,53,0,1218,0
2020-06-04,Russia,NA,Zabaykalsky Krai,1072806,39,0,1257,0
2020-06-05,Russia,NA,Zabaykalsky Krai,1072806,64,0,1321,0
2020-06-06,Russia,NA,Zabaykalsky Krai,1072806,77,0,1398,0
2020-06-07,Russia,NA,Zabaykalsky Krai,1072806,73,0,1471,0
2020-06-08,Russia,NA,Zabaykalsky Krai,1072806,80,0,1551,0
2020-06-09,Russia,NA,Zabaykalsky Krai,1072806,83,0,1634,0
2020-06-10,Russia,NA,Zabaykalsky Krai,1072806,70,0,1704,0
2020-06-11,Russia,NA,Zabaykalsky Krai,1072806,61,0,1765,0
2020-06-12,Russia,NA,Zabaykalsky Krai,1072806,76,0,1841,0
2020-06-13,Russia,NA,Zabaykalsky Krai,1072806,66,0,1907,0
2020-06-14,Russia,NA,Zabaykalsky Krai,1072806,89,0,1996,0
2020-06-15,Russia,NA,Zabaykalsky Krai,1072806,85,0,2081,0
2020-06-16,Russia,NA,Zabaykalsky Krai,1072806,93,0,2174,0
2020-06-17,Russia,NA,Zabaykalsky Krai,1072806,89,0,2263,0
2020-06-18,Russia,NA,Zabaykalsky Krai,1072806,62,0,2325,0
2020-06-19,Russia,NA,Zabaykalsky Krai,1072806,66,0,2391,0
2020-06-20,Russia,NA,Zabaykalsky Krai,1072806,67,0,2458,0
2020-06-21,Russia,NA,Zabaykalsky Krai,1072806,69,0,2527,0
2020-06-22,Russia,NA,Zabaykalsky Krai,1072806,69,0,2596,0
2020-06-23,Russia,NA,Zabaykalsky Krai,1072806,71,0,2667,0
2020-06-24,Russia,NA,Zabaykalsky Krai,1072806,71,0,2738,0
2020-06-25,Russia,NA,Zabaykalsky Krai,1072806,55,0,2793,0
2020-06-26,Russia,NA,Zabaykalsky Krai,1072806,61,0,2854,0
2020-06-27,Russia,NA,Zabaykalsky Krai,1072806,62,0,2916,0
2020-06-28,Russia,NA,Zabaykalsky Krai,1072806,59,0,2975,0
2020-06-29,Russia,NA,Zabaykalsky Krai,1072806,63,0,3038,0
2020-06-30,Russia,NA,Zabaykalsky Krai,1072806,62,0,3100,0
2020-07-01,Russia,NA,Zabaykalsky Krai,1072806,61,0,3161,0
2020-07-02,Russia,NA,Zabaykalsky Krai,1072806,51,0,3212,0
2020-07-03,Russia,NA,Zabaykalsky Krai,1072806,48,0,3260,0
2020-07-04,Russia,NA,Zabaykalsky Krai,1072806,49,0,3309,0
2020-07-05,Russia,NA,Zabaykalsky Krai,1072806,46,0,3355,0
2020-07-06,Russia,NA,Zabaykalsky Krai,1072806,44,0,3399,0
2020-07-07,Russia,NA,Zabaykalsky Krai,1072806,42,0,3441,0
2020-07-08,Russia,NA,Zabaykalsky Krai,1072806,39,0,3480,0
2020-07-09,Russia,NA,Zabaykalsky Krai,1072806,36,0,3516,0
2020-07-10,Russia,NA,Zabaykalsky Krai,1072806,39,0,3555,0
2020-07-11,Russia,NA,Zabaykalsky Krai,1072806,40,0,3595,0
2020-07-12,Russia,NA,Zabaykalsky Krai,1072806,43,0,3638,0
2020-07-13,Russia,NA,Zabaykalsky Krai,1072806,45,0,3683,0
2020-07-14,Russia,NA,Zabaykalsky Krai,1072806,45,0,3728,0
2020-07-15,Russia,NA,Zabaykalsky Krai,1072806,39,0,3767,0
2020-07-16,Russia,NA,Zabaykalsky Krai,1072806,35,0,3802,0
2020-07-17,Russia,NA,Zabaykalsky Krai,1072806,33,0,3835,0
2020-07-18,Russia,NA,Zabaykalsky Krai,1072806,32,0,3867,0
2020-07-19,Russia,NA,Zabaykalsky Krai,1072806,30,0,3897,0
2020-07-20,Russia,NA,Zabaykalsky Krai,1072806,30,0,3927,0
2020-07-21,Russia,NA,Zabaykalsky Krai,1072806,25,0,3952,0
2020-07-22,Russia,NA,Zabaykalsky Krai,1072806,19,0,3971,0
2020-07-23,Russia,NA,Zabaykalsky Krai,1072806,17,0,3988,0
2020-07-24,Russia,NA,Zabaykalsky Krai,1072806,14,0,4002,0
2020-07-25,Russia,NA,Zabaykalsky Krai,1072806,13,0,4015,0
2020-07-26,Russia,NA,Zabaykalsky Krai,1072806,11,0,4026,0
2020-07-27,Russia,NA,Zabaykalsky Krai,1072806,12,0,4038,0
2020-07-28,Russia,NA,Zabaykalsky Krai,1072806,12,0,4050,0
2020-07-29,Russia,NA,Zabaykalsky Krai,1072806,9,0,4059,0
2020-07-30,Russia,NA,Zabaykalsky Krai,1072806,11,0,4070,0
2020-07-31,Russia,NA,Zabaykalsky Krai,1072806,11,0,4081,0
2020-08-01,Russia,NA,Zabaykalsky Krai,1072806,13,0,4094,0
2020-08-02,Russia,NA,Zabaykalsky Krai,1072806,12,0,4106,0
2020-08-26,Russia,NA,Zabaykalsky Krai,1072806,0,0,4470,55
2020-08-27,Russia,NA,Zabaykalsky Krai,1072806,23,0,4493,55
2020-08-28,Russia,NA,Zabaykalsky Krai,1072806,24,1,4517,56
2020-08-29,Russia,NA,Zabaykalsky Krai,1072806,24,0,4541,56
2020-08-30,Russia,NA,Zabaykalsky Krai,1072806,29,0,4570,56
2020-08-31,Russia,NA,Zabaykalsky Krai,1072806,30,1,4600,57
2020-09-01,Russia,NA,Zabaykalsky Krai,1072806,32,0,4632,57
2020-09-02,Russia,NA,Zabaykalsky Krai,1072806,33,1,4665,58
2020-09-03,Russia,NA,Zabaykalsky Krai,1072806,34,0,4699,58
2020-09-04,Russia,NA,Zabaykalsky Krai,1072806,36,1,4735,59
2020-09-05,Russia,NA,Zabaykalsky Krai,1072806,35,0,4770,59
2020-09-06,Russia,NA,Zabaykalsky Krai,1072806,34,1,4804,60
2020-09-07,Russia,NA,Zabaykalsky Krai,1072806,35,0,4839,60
2020-09-08,Russia,NA,Zabaykalsky Krai,1072806,40,0,4879,60
2020-09-09,Russia,NA,Zabaykalsky Krai,1072806,43,1,4922,61
2020-09-10,Russia,NA,Zabaykalsky Krai,1072806,45,0,4967,61
2020-09-11,Russia,NA,Zabaykalsky Krai,1072806,48,1,5015,62
2020-09-12,Russia,NA,Zabaykalsky Krai,1072806,51,0,5066,62
2020-09-13,Russia,NA,Zabaykalsky Krai,1072806,63,1,5129,63
2020-09-14,Russia,NA,Zabaykalsky Krai,1072806,66,0,5195,63
2020-09-15,Russia,NA,Zabaykalsky Krai,1072806,66,1,5261,64
2020-09-16,Russia,NA,Zabaykalsky Krai,1072806,61,0,5322,64
2020-09-17,Russia,NA,Zabaykalsky Krai,1072806,52,1,5374,65
2020-09-18,Russia,NA,Zabaykalsky Krai,1072806,52,0,5426,65
2020-09-19,Russia,NA,Zabaykalsky Krai,1072806,55,0,5481,65
2020-09-20,Russia,NA,Zabaykalsky Krai,1072806,57,0,5538,65
2020-09-21,Russia,NA,Zabaykalsky Krai,1072806,58,0,5596,65
2020-09-22,Russia,NA,Zabaykalsky Krai,1072806,61,1,5657,66
2020-09-23,Russia,NA,Zabaykalsky Krai,1072806,70,0,5727,66
2020-03-29,South Africa,NA,Eastern Cape,6436761,2,0,12,0
2020-03-30,South Africa,NA,Eastern Cape,6436761,0,0,12,0
2020-03-31,South Africa,NA,Eastern Cape,6436761,0,0,12,0
2020-04-01,South Africa,NA,Eastern Cape,6436761,3,0,15,0
2020-04-02,South Africa,NA,Eastern Cape,6436761,2,0,17,0
2020-04-03,South Africa,NA,Eastern Cape,6436761,4,0,21,0
2020-04-04,South Africa,NA,Eastern Cape,6436761,4,0,25,0
2020-04-05,South Africa,NA,Eastern Cape,6436761,6,0,31,0
2020-04-06,South Africa,NA,Eastern Cape,6436761,1,0,32,0
2020-04-08,South Africa,NA,Eastern Cape,6436761,13,0,45,0
2020-04-09,South Africa,NA,Eastern Cape,6436761,16,0,61,0
2020-04-10,South Africa,NA,Eastern Cape,6436761,7,0,68,0
2020-04-11,South Africa,NA,Eastern Cape,6436761,1,0,69,0
2020-04-12,South Africa,NA,Eastern Cape,6436761,19,0,88,0
2020-04-13,South Africa,NA,Eastern Cape,6436761,16,0,104,0
2020-04-14,South Africa,NA,Eastern Cape,6436761,70,0,174,0
2020-04-15,South Africa,NA,Eastern Cape,6436761,25,0,199,0
2020-04-16,South Africa,NA,Eastern Cape,6436761,21,4,220,4
2020-04-17,South Africa,NA,Eastern Cape,6436761,26,0,246,4
2020-04-18,South Africa,NA,Eastern Cape,6436761,24,0,270,4
2020-04-19,South Africa,NA,Eastern Cape,6436761,23,0,293,4
2020-04-20,South Africa,NA,Eastern Cape,6436761,17,1,310,5
2020-04-21,South Africa,NA,Eastern Cape,6436761,35,0,345,5
2020-04-22,South Africa,NA,Eastern Cape,6436761,32,0,377,5
2020-04-23,South Africa,NA,Eastern Cape,6436761,40,1,417,6
2020-04-24,South Africa,NA,Eastern Cape,6436761,63,0,480,6
2020-04-25,South Africa,NA,Eastern Cape,6436761,8,4,488,10
2020-04-26,South Africa,NA,Eastern Cape,6436761,47,0,535,10
2020-04-27,South Africa,NA,Eastern Cape,6436761,53,0,588,10
2020-04-28,South Africa,NA,Eastern Cape,6436761,28,0,616,10
2020-04-29,South Africa,NA,Eastern Cape,6436761,14,1,630,11
2020-04-30,South Africa,NA,Eastern Cape,6436761,17,0,647,11
2020-05-01,South Africa,NA,Eastern Cape,6436761,44,0,691,11
2020-05-02,South Africa,NA,Eastern Cape,6436761,41,2,732,13
2020-05-03,South Africa,NA,Eastern Cape,6436761,42,4,774,17
2020-05-04,South Africa,NA,Eastern Cape,6436761,40,0,814,17
2020-05-05,South Africa,NA,Eastern Cape,6436761,24,1,838,18
2020-05-06,South Africa,NA,Eastern Cape,6436761,11,0,849,18
2020-05-07,South Africa,NA,Eastern Cape,6436761,80,0,929,18
2020-05-08,South Africa,NA,Eastern Cape,6436761,60,3,989,21
2020-05-09,South Africa,NA,Eastern Cape,6436761,89,0,1078,21
2020-05-10,South Africa,NA,Eastern Cape,6436761,140,1,1218,22
2020-05-11,South Africa,NA,Eastern Cape,6436761,138,2,1356,24
2020-05-12,South Africa,NA,Eastern Cape,6436761,148,0,1504,24
2020-05-13,South Africa,NA,Eastern Cape,6436761,30,0,1534,24
2020-05-14,South Africa,NA,Eastern Cape,6436761,35,7,1569,31
2020-05-15,South Africa,NA,Eastern Cape,6436761,93,0,1662,31
2020-05-16,South Africa,NA,Eastern Cape,6436761,150,1,1812,32
2020-05-17,South Africa,NA,Eastern Cape,6436761,124,3,1936,35
2020-05-18,South Africa,NA,Eastern Cape,6436761,116,4,2052,39
2020-05-19,South Africa,NA,Eastern Cape,6436761,83,2,2135,41
2020-05-20,South Africa,NA,Eastern Cape,6436761,80,4,2215,45
2020-05-21,South Africa,NA,Eastern Cape,6436761,109,5,2324,50
2020-05-22,South Africa,NA,Eastern Cape,6436761,135,3,2459,53
2020-05-23,South Africa,NA,Eastern Cape,6436761,110,5,2569,58
2020-05-24,South Africa,NA,Eastern Cape,6436761,121,1,2690,59
2020-05-25,South Africa,NA,Eastern Cape,6436761,58,2,2748,61
2020-05-26,South Africa,NA,Eastern Cape,6436761,116,9,2864,70
2020-05-27,South Africa,NA,Eastern Cape,6436761,183,0,3047,70
2020-05-28,South Africa,NA,Eastern Cape,6436761,259,7,3306,77
2020-05-29,South Africa,NA,Eastern Cape,6436761,277,3,3583,80
2020-05-30,South Africa,NA,Eastern Cape,6436761,176,2,3759,82
2020-05-31,South Africa,NA,Eastern Cape,6436761,168,0,3927,82
2020-06-01,South Africa,NA,Eastern Cape,6436761,184,0,4111,82
2020-06-02,South Africa,NA,Eastern Cape,6436761,213,6,4324,88
2020-06-03,South Africa,NA,Eastern Cape,6436761,202,7,4526,95
2020-06-04,South Africa,NA,Eastern Cape,6436761,410,0,4936,95
2020-06-05,South Africa,NA,Eastern Cape,6436761,304,0,5240,95
2020-06-06,South Africa,NA,Eastern Cape,6436761,389,6,5629,101
2020-06-07,South Africa,NA,Eastern Cape,6436761,345,0,5974,101
2020-06-08,South Africa,NA,Eastern Cape,6436761,367,26,6341,127
2020-06-09,South Africa,NA,Eastern Cape,6436761,419,11,6760,138
2020-06-10,South Africa,NA,Eastern Cape,6436761,394,9,7154,147
2020-06-11,South Africa,NA,Eastern Cape,6436761,714,31,7868,178
2020-06-12,South Africa,NA,Eastern Cape,6436761,747,30,8615,208
2020-06-13,South Africa,NA,Eastern Cape,6436761,635,9,9250,217
2020-06-14,South Africa,NA,Eastern Cape,6436761,777,10,10027,227
2020-06-15,South Africa,NA,Eastern Cape,6436761,570,9,10597,236
2020-06-16,South Africa,NA,Eastern Cape,6436761,442,9,11039,245
2020-06-17,South Africa,NA,Eastern Cape,6436761,880,6,11919,251
2020-06-18,South Africa,NA,Eastern Cape,6436761,720,6,12639,257
2020-06-19,South Africa,NA,Eastern Cape,6436761,867,0,13506,257
2020-06-20,South Africa,NA,Eastern Cape,6436761,1215,11,14721,268
2020-06-21,South Africa,NA,Eastern Cape,6436761,1030,17,15751,285
2020-06-22,South Africa,NA,Eastern Cape,6436761,1144,18,16895,303
2020-06-23,South Africa,NA,Eastern Cape,6436761,1213,28,18108,331
2020-06-24,South Africa,NA,Eastern Cape,6436761,1106,15,19214,346
2020-06-25,South Africa,NA,Eastern Cape,6436761,1273,17,20487,363
2020-06-26,South Africa,NA,Eastern Cape,6436761,1451,8,21938,371
2020-06-27,South Africa,NA,Eastern Cape,6436761,1720,13,23658,384
2020-06-28,South Africa,NA,Eastern Cape,6436761,1441,3,25099,387
2020-06-29,South Africa,NA,Eastern Cape,6436761,1096,10,26195,397
2020-06-30,South Africa,NA,Eastern Cape,6436761,1491,25,27686,422
2020-07-01,South Africa,NA,Eastern Cape,6436761,1654,17,29340,439
2020-07-02,South Africa,NA,Eastern Cape,6436761,1263,12,30603,451
2020-07-03,South Africa,NA,Eastern Cape,6436761,1554,8,32157,459
2020-07-04,South Africa,NA,Eastern Cape,6436761,2004,31,34161,490
2020-07-05,South Africa,NA,Eastern Cape,6436761,1487,29,35648,519
2020-07-06,South Africa,NA,Eastern Cape,6436761,2433,9,38081,528
2020-07-07,South Africa,NA,Eastern Cape,6436761,2320,36,40401,564
2020-07-08,South Africa,NA,Eastern Cape,6436761,1956,18,42357,582
2020-07-09,South Africa,NA,Eastern Cape,6436761,2075,28,44432,610
2020-07-10,South Africa,NA,Eastern Cape,6436761,1852,24,46284,634
2020-07-11,South Africa,NA,Eastern Cape,6436761,1948,30,48232,664
2020-07-12,South Africa,NA,Eastern Cape,6436761,2068,22,50300,686
2020-07-13,South Africa,NA,Eastern Cape,6436761,1758,23,52058,709
2020-07-14,South Africa,NA,Eastern Cape,6436761,1901,17,53959,726
2020-07-15,South Africa,NA,Eastern Cape,6436761,1625,12,55584,738
2020-07-16,South Africa,NA,Eastern Cape,6436761,1602,25,57186,763
2020-07-17,South Africa,NA,Eastern Cape,6436761,1674,9,58860,772
2020-07-18,South Africa,NA,Eastern Cape,6436761,2116,39,60976,811
2020-07-19,South Africa,NA,Eastern Cape,6436761,2205,14,63181,825
2020-07-20,South Africa,NA,Eastern Cape,6436761,2135,46,65316,871
2020-07-21,South Africa,NA,Eastern Cape,6436761,1443,74,66759,945
2020-07-22,South Africa,NA,Eastern Cape,6436761,1059,400,67818,1345
2020-07-23,South Africa,NA,Eastern Cape,6436761,1627,48,69445,1393
2020-07-24,South Africa,NA,Eastern Cape,6436761,1893,13,71338,1406
2020-07-25,South Africa,NA,Eastern Cape,6436761,1434,44,72772,1450
2020-07-26,South Africa,NA,Eastern Cape,6436761,813,7,73585,1457
2020-07-27,South Africa,NA,Eastern Cape,6436761,646,77,74231,1534
2020-07-28,South Africa,NA,Eastern Cape,6436761,836,11,75067,1545
2020-07-29,South Africa,NA,Eastern Cape,6436761,715,34,75782,1579
2020-07-30,South Africa,NA,Eastern Cape,6436761,1273,121,77055,1700
2020-07-31,South Africa,NA,Eastern Cape,6436761,883,8,77938,1708
2020-08-01,South Africa,NA,Eastern Cape,6436761,844,36,78782,1744
2020-08-02,South Africa,NA,Eastern Cape,6436761,628,25,79410,1769
2020-08-03,South Africa,NA,Eastern Cape,6436761,264,20,79674,1789
2020-08-04,South Africa,NA,Eastern Cape,6436761,170,43,79844,1832
2020-08-05,South Africa,NA,Eastern Cape,6436761,556,135,80400,1967
2020-08-06,South Africa,NA,Eastern Cape,6436761,614,66,81014,2033
2020-08-07,South Africa,NA,Eastern Cape,6436761,601,57,81615,2090
2020-08-08,South Africa,NA,Eastern Cape,6436761,459,39,82074,2129
2020-08-09,South Africa,NA,Eastern Cape,6436761,327,80,82401,2209
2020-08-10,South Africa,NA,Eastern Cape,6436761,177,57,82578,2266
2020-08-11,South Africa,NA,Eastern Cape,6436761,137,20,82715,2286
2020-08-12,South Africa,NA,Eastern Cape,6436761,64,46,82779,2332
2020-08-13,South Africa,NA,Eastern Cape,6436761,223,68,83002,2400
2020-08-14,South Africa,NA,Eastern Cape,6436761,370,42,83372,2442
2020-08-15,South Africa,NA,Eastern Cape,6436761,299,5,83671,2447
2020-08-16,South Africa,NA,Eastern Cape,6436761,335,70,84006,2517
2020-08-17,South Africa,NA,Eastern Cape,6436761,86,50,84092,2567
2020-08-18,South Africa,NA,Eastern Cape,6436761,52,66,84144,2633
2020-08-19,South Africa,NA,Eastern Cape,6436761,218,37,84362,2670
2020-08-20,South Africa,NA,Eastern Cape,6436761,224,26,84586,2696
2020-08-21,South Africa,NA,Eastern Cape,6436761,201,57,84787,2753
2020-08-22,South Africa,NA,Eastern Cape,6436761,252,25,85039,2778
2020-08-23,South Africa,NA,Eastern Cape,6436761,164,11,85203,2789
2020-08-24,South Africa,NA,Eastern Cape,6436761,37,11,85240,2800
2020-08-25,South Africa,NA,Eastern Cape,6436761,71,16,85311,2816
2020-08-26,South Africa,NA,Eastern Cape,6436761,161,12,85472,2828
2020-08-27,South Africa,NA,Eastern Cape,6436761,153,25,85625,2853
2020-08-28,South Africa,NA,Eastern Cape,6436761,76,10,85701,2863
2020-08-29,South Africa,NA,Eastern Cape,6436761,198,6,85899,2869
2020-08-30,South Africa,NA,Eastern Cape,6436761,161,7,86060,2876
2020-08-31,South Africa,NA,Eastern Cape,6436761,103,20,86163,2896
2020-09-01,South Africa,NA,Eastern Cape,6436761,54,7,86217,2903
2020-09-02,South Africa,NA,Eastern Cape,6436761,105,29,86322,2932
2020-09-03,South Africa,NA,Eastern Cape,6436761,167,24,86489,2956
2020-09-04,South Africa,NA,Eastern Cape,6436761,146,12,86635,2968
2020-09-05,South Africa,NA,Eastern Cape,6436761,120,11,86755,2979
2020-09-06,South Africa,NA,Eastern Cape,6436761,94,7,86849,2986
2020-09-07,South Africa,NA,Eastern Cape,6436761,19,12,86868,2998
2020-09-08,South Africa,NA,Eastern Cape,6436761,58,9,86926,3007
2020-09-09,South Africa,NA,Eastern Cape,6436761,114,5,87040,3012
2020-09-10,South Africa,NA,Eastern Cape,6436761,88,7,87128,3019
2020-09-11,South Africa,NA,Eastern Cape,6436761,94,16,87222,3035
2020-09-12,South Africa,NA,Eastern Cape,6436761,101,8,87323,3043
2020-09-13,South Africa,NA,Eastern Cape,6436761,92,4,87415,3047
2020-09-14,South Africa,NA,Eastern Cape,6436761,41,4,87456,3051
2020-09-15,South Africa,NA,Eastern Cape,6436761,58,4,87514,3055
2020-09-16,South Africa,NA,Eastern Cape,6436761,149,0,87663,3055
2020-09-17,South Africa,NA,Eastern Cape,6436761,113,3,87776,3058
2020-09-18,South Africa,NA,Eastern Cape,6436761,118,5,87894,3063
2020-09-19,South Africa,NA,Eastern Cape,6436761,140,4,88034,3067
2020-09-20,South Africa,NA,Eastern Cape,6436761,130,3,88164,3070
2020-09-21,South Africa,NA,Eastern Cape,6436761,41,9,88205,3079
2020-09-22,South Africa,NA,Eastern Cape,6436761,114,5,88319,3084
2020-09-23,South Africa,NA,Eastern Cape,6436761,101,2,88420,3086
2020-03-23,South Africa,NA,Free State,2928903,4,0,13,0
2020-03-24,South Africa,NA,Free State,2928903,5,0,18,0
2020-03-25,South Africa,NA,Free State,2928903,12,0,30,0
2020-03-26,South Africa,NA,Free State,2928903,19,0,49,0
2020-03-28,South Africa,NA,Free State,2928903,19,0,68,0
2020-03-29,South Africa,NA,Free State,2928903,4,0,72,0
2020-03-30,South Africa,NA,Free State,2928903,0,1,72,1
2020-03-31,South Africa,NA,Free State,2928903,2,0,74,1
2020-04-01,South Africa,NA,Free State,2928903,2,0,76,1
2020-04-02,South Africa,NA,Free State,2928903,8,0,84,1
2020-04-03,South Africa,NA,Free State,2928903,0,0,84,1
2020-04-04,South Africa,NA,Free State,2928903,1,0,85,1
2020-04-05,South Africa,NA,Free State,2928903,2,0,87,1
2020-04-06,South Africa,NA,Free State,2928903,2,0,89,1
2020-04-08,South Africa,NA,Free State,2928903,0,2,89,3
2020-04-09,South Africa,NA,Free State,2928903,5,0,93,3
2020-04-10,South Africa,NA,Free State,2928903,1,0,94,3
2020-04-11,South Africa,NA,Free State,2928903,0,0,94,3
2020-04-12,South Africa,NA,Free State,2928903,2,0,96,3
2020-04-13,South Africa,NA,Free State,2928903,0,0,96,3
2020-04-14,South Africa,NA,Free State,2928903,2,0,98,3
2020-04-15,South Africa,NA,Free State,2928903,0,0,98,3
2020-04-16,South Africa,NA,Free State,2928903,1,1,98,4
2020-04-17,South Africa,NA,Free State,2928903,2,0,100,4
2020-04-18,South Africa,NA,Free State,2928903,0,0,100,4
2020-04-19,South Africa,NA,Free State,2928903,0,0,100,4
2020-04-20,South Africa,NA,Free State,2928903,5,1,105,5
2020-04-21,South Africa,NA,Free State,2928903,1,0,106,5
2020-04-22,South Africa,NA,Free State,2928903,0,0,106,5
2020-04-23,South Africa,NA,Free State,2928903,0,0,106,5
2020-04-24,South Africa,NA,Free State,2928903,5,0,111,5
2020-04-25,South Africa,NA,Free State,2928903,0,0,111,5
2020-04-26,South Africa,NA,Free State,2928903,0,0,111,5
2020-04-27,South Africa,NA,Free State,2928903,1,0,111,5
2020-04-28,South Africa,NA,Free State,2928903,2,0,113,5
2020-04-29,South Africa,NA,Free State,2928903,0,0,113,5
2020-04-30,South Africa,NA,Free State,2928903,3,0,116,5
2020-05-01,South Africa,NA,Free State,2928903,2,0,118,5
2020-05-02,South Africa,NA,Free State,2928903,3,1,121,6
2020-05-03,South Africa,NA,Free State,2928903,1,0,122,6
2020-05-04,South Africa,NA,Free State,2928903,3,0,125,6
2020-05-05,South Africa,NA,Free State,2928903,3,0,128,6
2020-05-06,South Africa,NA,Free State,2928903,2,0,130,6
2020-05-07,South Africa,NA,Free State,2928903,4,0,134,6
2020-05-08,South Africa,NA,Free State,2928903,0,0,134,6
2020-05-09,South Africa,NA,Free State,2928903,1,0,134,6
2020-05-10,South Africa,NA,Free State,2928903,1,0,135,6
2020-05-11,South Africa,NA,Free State,2928903,0,0,135,6
2020-05-12,South Africa,NA,Free State,2928903,0,0,135,6
2020-05-13,South Africa,NA,Free State,2928903,3,0,138,6
2020-05-14,South Africa,NA,Free State,2928903,7,0,145,6
2020-05-15,South Africa,NA,Free State,2928903,6,0,151,6
2020-05-16,South Africa,NA,Free State,2928903,2,0,153,6
2020-05-17,South Africa,NA,Free State,2928903,5,0,158,6
2020-05-18,South Africa,NA,Free State,2928903,5,0,163,6
2020-05-19,South Africa,NA,Free State,2928903,5,0,168,6
2020-05-20,South Africa,NA,Free State,2928903,12,0,180,6
2020-05-21,South Africa,NA,Free State,2928903,4,0,184,6
2020-05-22,South Africa,NA,Free State,2928903,1,0,185,6
2020-05-23,South Africa,NA,Free State,2928903,11,0,196,6
2020-05-24,South Africa,NA,Free State,2928903,6,0,202,6
2020-05-25,South Africa,NA,Free State,2928903,6,0,208,6
2020-05-26,South Africa,NA,Free State,2928903,0,0,208,6
2020-05-27,South Africa,NA,Free State,2928903,15,0,221,6
2020-05-28,South Africa,NA,Free State,2928903,4,2,225,8
2020-05-29,South Africa,NA,Free State,2928903,6,0,231,8
2020-05-30,South Africa,NA,Free State,2928903,30,0,261,8
2020-05-31,South Africa,NA,Free State,2928903,17,0,278,8
2020-06-01,South Africa,NA,Free State,2928903,7,0,285,8
2020-06-02,South Africa,NA,Free State,2928903,14,0,299,8
2020-06-03,South Africa,NA,Free State,2928903,20,0,319,8
2020-06-04,South Africa,NA,Free State,2928903,3,1,322,9
2020-06-05,South Africa,NA,Free State,2928903,14,0,336,9
2020-06-06,South Africa,NA,Free State,2928903,12,0,348,9
2020-06-07,South Africa,NA,Free State,2928903,13,0,361,9
2020-06-08,South Africa,NA,Free State,2928903,12,0,373,9
2020-06-09,South Africa,NA,Free State,2928903,18,0,391,9
2020-06-10,South Africa,NA,Free State,2928903,10,0,401,9
2020-06-11,South Africa,NA,Free State,2928903,5,0,406,9
2020-06-12,South Africa,NA,Free State,2928903,29,0,435,9
2020-06-13,South Africa,NA,Free State,2928903,22,0,457,9
2020-06-14,South Africa,NA,Free State,2928903,38,0,495,9
2020-06-15,South Africa,NA,Free State,2928903,17,0,512,9
2020-06-16,South Africa,NA,Free State,2928903,66,0,578,9
2020-06-17,South Africa,NA,Free State,2928903,30,0,608,9
2020-06-18,South Africa,NA,Free State,2928903,41,0,649,9
2020-06-19,South Africa,NA,Free State,2928903,9,0,658,9
2020-06-20,South Africa,NA,Free State,2928903,42,0,700,9
2020-06-21,South Africa,NA,Free State,2928903,33,0,733,9
2020-06-22,South Africa,NA,Free State,2928903,39,0,772,9
2020-06-23,South Africa,NA,Free State,2928903,42,0,814,9
2020-06-24,South Africa,NA,Free State,2928903,75,0,889,9
2020-06-25,South Africa,NA,Free State,2928903,87,0,976,9
2020-06-26,South Africa,NA,Free State,2928903,93,0,1069,9
2020-06-27,South Africa,NA,Free State,2928903,91,0,1160,9
2020-06-28,South Africa,NA,Free State,2928903,119,0,1279,9
2020-06-29,South Africa,NA,Free State,2928903,98,0,1377,9
2020-06-30,South Africa,NA,Free State,2928903,137,0,1514,9
2020-07-01,South Africa,NA,Free State,2928903,158,0,1672,9
2020-07-02,South Africa,NA,Free State,2928903,214,0,1886,9
2020-07-03,South Africa,NA,Free State,2928903,244,0,2130,9
2020-07-04,South Africa,NA,Free State,2928903,246,0,2376,9
2020-07-05,South Africa,NA,Free State,2928903,177,10,2553,19
2020-07-06,South Africa,NA,Free State,2928903,251,0,2804,19
2020-07-07,South Africa,NA,Free State,2928903,230,0,3034,19
2020-07-08,South Africa,NA,Free State,2928903,225,0,3259,19
2020-07-09,South Africa,NA,Free State,2928903,465,0,3724,19
2020-07-10,South Africa,NA,Free State,2928903,497,0,4221,19
2020-07-11,South Africa,NA,Free State,2928903,458,0,4679,19
2020-07-12,South Africa,NA,Free State,2928903,545,0,5224,19
2020-07-13,South Africa,NA,Free State,2928903,408,16,5632,35
2020-07-14,South Africa,NA,Free State,2928903,341,0,5973,35
2020-07-15,South Africa,NA,Free State,2928903,588,0,6561,35
2020-07-16,South Africa,NA,Free State,2928903,751,10,7312,45
2020-07-17,South Africa,NA,Free State,2928903,978,2,8290,47
2020-07-18,South Africa,NA,Free State,2928903,714,0,9004,47
2020-07-19,South Africa,NA,Free State,2928903,989,0,9993,47
2020-07-20,South Africa,NA,Free State,2928903,734,10,10727,57
2020-07-21,South Africa,NA,Free State,2928903,625,0,11352,57
2020-07-22,South Africa,NA,Free State,2928903,980,5,12332,62
2020-07-23,South Africa,NA,Free State,2928903,1111,0,13443,62
2020-07-24,South Africa,NA,Free State,2928903,1099,1,14542,63
2020-07-25,South Africa,NA,Free State,2928903,970,0,15512,63
2020-07-26,South Africa,NA,Free State,2928903,970,0,16482,63
2020-07-27,South Africa,NA,Free State,2928903,740,91,17222,154
2020-07-28,South Africa,NA,Free State,2928903,912,0,18134,154
2020-07-29,South Africa,NA,Free State,2928903,1073,0,19207,154
2020-07-30,South Africa,NA,Free State,2928903,1731,0,20938,154
2020-07-31,South Africa,NA,Free State,2928903,324,0,21262,154
2020-08-01,South Africa,NA,Free State,2928903,1046,0,22308,154
2020-08-02,South Africa,NA,Free State,2928903,791,51,23099,205
2020-08-03,South Africa,NA,Free State,2928903,606,0,23705,205
2020-08-04,South Africa,NA,Free State,2928903,628,0,24333,205
2020-08-05,South Africa,NA,Free State,2928903,899,122,25232,327
2020-08-06,South Africa,NA,Free State,2928903,891,23,26123,350
2020-08-07,South Africa,NA,Free State,2928903,754,0,26877,350
2020-08-08,South Africa,NA,Free State,2928903,865,0,27742,350
2020-08-09,South Africa,NA,Free State,2928903,628,0,28370,350
2020-08-10,South Africa,NA,Free State,2928903,539,64,28909,414
2020-08-11,South Africa,NA,Free State,2928903,300,0,29209,414
2020-08-12,South Africa,NA,Free State,2928903,369,0,29578,414
2020-08-13,South Africa,NA,Free State,2928903,471,62,30049,476
2020-08-14,South Africa,NA,Free State,2928903,788,20,30837,496
2020-08-15,South Africa,NA,Free State,2928903,628,17,31465,513
2020-08-16,South Africa,NA,Free State,2928903,405,6,31870,519
2020-08-17,South Africa,NA,Free State,2928903,434,5,32304,524
2020-08-18,South Africa,NA,Free State,2928903,289,13,32593,537
2020-08-19,South Africa,NA,Free State,2928903,570,5,33163,542
2020-08-20,South Africa,NA,Free State,2928903,502,25,33665,567
2020-08-21,South Africa,NA,Free State,2928903,471,0,34136,567
2020-08-22,South Africa,NA,Free State,2928903,485,0,34621,567
2020-08-23,South Africa,NA,Free State,2928903,359,0,34980,567
2020-08-24,South Africa,NA,Free State,2928903,387,0,35367,567
2020-08-25,South Africa,NA,Free State,2928903,236,0,35603,567
2020-08-26,South Africa,NA,Free State,2928903,377,0,35980,567
2020-08-27,South Africa,NA,Free State,2928903,439,0,36419,567
2020-08-28,South Africa,NA,Free State,2928903,323,0,36742,567
2020-08-29,South Africa,NA,Free State,2928903,415,123,37157,690
2020-08-30,South Africa,NA,Free State,2928903,400,3,37557,693
2020-08-31,South Africa,NA,Free State,2928903,331,16,37888,709
2020-09-01,South Africa,NA,Free State,2928903,237,7,38125,716
2020-09-02,South Africa,NA,Free State,2928903,348,15,38473,731
2020-09-03,South Africa,NA,Free State,2928903,396,8,38869,739
2020-09-04,South Africa,NA,Free State,2928903,323,18,39192,757
2020-09-05,South Africa,NA,Free State,2928903,294,19,39486,776
2020-09-06,South Africa,NA,Free State,2928903,295,9,39781,785
2020-09-07,South Africa,NA,Free State,2928903,205,7,39986,792
2020-09-08,South Africa,NA,Free State,2928903,168,6,40154,798
2020-09-09,South Africa,NA,Free State,2928903,302,8,40456,806
2020-09-10,South Africa,NA,Free State,2928903,376,4,40832,810
2020-09-11,South Africa,NA,Free State,2928903,418,2,41250,812
2020-09-12,South Africa,NA,Free State,2928903,354,5,41604,817
2020-09-13,South Africa,NA,Free State,2928903,271,0,41875,817
2020-09-14,South Africa,NA,Free State,2928903,245,21,42120,838
2020-09-15,South Africa,NA,Free State,2928903,135,0,42255,838
2020-09-16,South Africa,NA,Free State,2928903,347,0,42602,838
2020-09-17,South Africa,NA,Free State,2928903,439,0,43041,838
2020-09-18,South Africa,NA,Free State,2928903,334,0,43375,838
2020-09-19,South Africa,NA,Free State,2928903,401,0,43776,838
2020-09-20,South Africa,NA,Free State,2928903,261,0,44037,838
2020-09-21,South Africa,NA,Free State,2928903,254,0,44291,838
2020-09-22,South Africa,NA,Free State,2928903,325,0,44616,838
2020-09-23,South Africa,NA,Free State,2928903,327,0,44943,838
2020-03-14,South Africa,NA,Gauteng,12272263,7,0,17,0
2020-03-15,South Africa,NA,Gauteng,12272263,7,0,24,0
2020-03-16,South Africa,NA,Gauteng,12272263,7,0,31,0
2020-03-17,South Africa,NA,Gauteng,12272263,14,0,45,0
2020-03-18,South Africa,NA,Gauteng,12272263,16,0,61,0
2020-03-19,South Africa,NA,Gauteng,12272263,15,0,76,0
2020-03-20,South Africa,NA,Gauteng,12272263,33,0,109,0
2020-03-21,South Africa,NA,Gauteng,12272263,16,0,125,0
2020-03-22,South Africa,NA,Gauteng,12272263,7,0,132,0
2020-03-23,South Africa,NA,Gauteng,12272263,75,0,207,0
2020-03-24,South Africa,NA,Gauteng,12272263,95,0,302,0
2020-03-25,South Africa,NA,Gauteng,12272263,17,0,319,0
2020-03-26,South Africa,NA,Gauteng,12272263,90,0,409,0
2020-03-28,South Africa,NA,Gauteng,12272263,124,0,533,0
2020-03-29,South Africa,NA,Gauteng,12272263,51,0,584,0
2020-03-30,South Africa,NA,Gauteng,12272263,34,0,618,0
2020-03-31,South Africa,NA,Gauteng,12272263,15,1,633,1
2020-04-01,South Africa,NA,Gauteng,12272263,12,0,645,1
2020-04-02,South Africa,NA,Gauteng,12272263,18,0,663,1
2020-04-03,South Africa,NA,Gauteng,12272263,9,0,672,1
2020-04-04,South Africa,NA,Gauteng,12272263,21,0,693,1
2020-04-05,South Africa,NA,Gauteng,12272263,11,0,704,1
2020-04-06,South Africa,NA,Gauteng,12272263,9,0,713,1
2020-04-08,South Africa,NA,Gauteng,12272263,69,2,782,3
2020-04-09,South Africa,NA,Gauteng,12272263,13,0,795,3
2020-04-10,South Africa,NA,Gauteng,12272263,6,0,801,3
2020-04-11,South Africa,NA,Gauteng,12272263,12,0,813,3
2020-04-12,South Africa,NA,Gauteng,12272263,52,0,865,3
2020-04-13,South Africa,NA,Gauteng,12272263,25,1,890,4
2020-04-14,South Africa,NA,Gauteng,12272263,19,0,909,4
2020-04-15,South Africa,NA,Gauteng,12272263,21,1,930,5
2020-04-16,South Africa,NA,Gauteng,12272263,39,1,969,6
2020-04-17,South Africa,NA,Gauteng,12272263,49,0,1018,6
2020-04-18,South Africa,NA,Gauteng,12272263,83,0,1101,6
2020-04-19,South Africa,NA,Gauteng,12272263,47,0,1148,6
2020-04-20,South Africa,NA,Gauteng,12272263,22,1,1170,7
2020-04-21,South Africa,NA,Gauteng,12272263,29,0,1199,7
2020-04-22,South Africa,NA,Gauteng,12272263,25,0,1224,7
2020-04-23,South Africa,NA,Gauteng,12272263,28,1,1252,8
2020-04-24,South Africa,NA,Gauteng,12272263,29,0,1281,8
2020-04-25,South Africa,NA,Gauteng,12272263,23,0,1304,8
2020-04-26,South Africa,NA,Gauteng,12272263,27,0,1331,8
2020-04-27,South Africa,NA,Gauteng,12272263,22,0,1353,8
2020-04-28,South Africa,NA,Gauteng,12272263,24,0,1377,8
2020-04-29,South Africa,NA,Gauteng,12272263,31,3,1408,11
2020-04-30,South Africa,NA,Gauteng,12272263,38,0,1446,11
2020-05-01,South Africa,NA,Gauteng,12272263,61,0,1507,11
2020-05-02,South Africa,NA,Gauteng,12272263,91,1,1598,12
2020-05-03,South Africa,NA,Gauteng,12272263,26,2,1624,14
2020-05-04,South Africa,NA,Gauteng,12272263,27,0,1651,14
2020-05-05,South Africa,NA,Gauteng,12272263,46,1,1697,15
2020-05-06,South Africa,NA,Gauteng,12272263,23,0,1720,15
2020-05-07,South Africa,NA,Gauteng,12272263,84,0,1804,15
2020-05-08,South Africa,NA,Gauteng,12272263,47,3,1851,18
2020-05-09,South Africa,NA,Gauteng,12272263,59,1,1910,18
2020-05-10,South Africa,NA,Gauteng,12272263,42,4,1952,22
2020-05-11,South Africa,NA,Gauteng,12272263,19,0,1971,22
2020-05-12,South Africa,NA,Gauteng,12272263,43,0,2014,22
2020-05-13,South Africa,NA,Gauteng,12272263,60,2,2074,24
2020-05-14,South Africa,NA,Gauteng,12272263,61,0,2135,24
2020-05-15,South Africa,NA,Gauteng,12272263,75,0,2210,24
2020-05-16,South Africa,NA,Gauteng,12272263,52,1,2262,25
2020-05-17,South Africa,NA,Gauteng,12272263,67,0,2329,25
2020-05-18,South Africa,NA,Gauteng,12272263,14,1,2343,26
2020-05-19,South Africa,NA,Gauteng,12272263,18,1,2361,27
2020-05-20,South Africa,NA,Gauteng,12272263,39,0,2400,27
2020-05-21,South Africa,NA,Gauteng,12272263,53,0,2453,27
2020-05-22,South Africa,NA,Gauteng,12272263,68,2,2521,29
2020-05-23,South Africa,NA,Gauteng,12272263,112,0,2633,29
2020-05-24,South Africa,NA,Gauteng,12272263,140,0,2773,29
2020-05-25,South Africa,NA,Gauteng,12272263,220,1,2993,30
2020-05-26,South Africa,NA,Gauteng,12272263,50,1,3043,31
2020-05-27,South Africa,NA,Gauteng,12272263,124,0,3167,31
2020-05-28,South Africa,NA,Gauteng,12272263,162,0,3329,31
2020-05-29,South Africa,NA,Gauteng,12272263,254,0,3583,31
2020-05-30,South Africa,NA,Gauteng,12272263,190,0,3773,31
2020-05-31,South Africa,NA,Gauteng,12272263,230,2,4003,33
2020-06-01,South Africa,NA,Gauteng,12272263,228,0,4231,33
2020-06-02,South Africa,NA,Gauteng,12272263,45,0,4276,33
2020-06-03,South Africa,NA,Gauteng,12272263,291,0,4567,33
2020-06-04,South Africa,NA,Gauteng,12272263,278,0,4845,33
2020-06-05,South Africa,NA,Gauteng,12272263,370,7,5215,40
2020-06-06,South Africa,NA,Gauteng,12272263,411,7,5626,47
2020-06-07,South Africa,NA,Gauteng,12272263,320,0,5946,47
2020-06-08,South Africa,NA,Gauteng,12272263,312,0,6258,47
2020-06-09,South Africa,NA,Gauteng,12272263,288,10,6546,57
2020-06-10,South Africa,NA,Gauteng,12272263,649,0,7195,57
2020-06-11,South Africa,NA,Gauteng,12272263,758,0,7953,57
2020-06-12,South Africa,NA,Gauteng,12272263,828,0,8781,57
2020-06-13,South Africa,NA,Gauteng,12272263,1116,24,9897,81
2020-06-14,South Africa,NA,Gauteng,12272263,1267,0,11164,81
2020-06-15,South Africa,NA,Gauteng,12272263,1029,6,12193,87
2020-06-16,South Africa,NA,Gauteng,12272263,830,0,13023,87
2020-06-17,South Africa,NA,Gauteng,12272263,1597,0,14620,87
2020-06-18,South Africa,NA,Gauteng,12272263,1278,0,15898,87
2020-06-19,South Africa,NA,Gauteng,12272263,1363,27,17261,114
2020-06-20,South Africa,NA,Gauteng,12272263,1717,0,18978,114
2020-06-21,South Africa,NA,Gauteng,12272263,1844,8,20822,122
2020-06-22,South Africa,NA,Gauteng,12272263,1519,0,22341,122
2020-06-23,South Africa,NA,Gauteng,12272263,1700,0,24041,122
2020-06-24,South Africa,NA,Gauteng,12272263,2115,25,26156,147
2020-06-25,South Africa,NA,Gauteng,12272263,2590,2,28746,149
2020-06-26,South Africa,NA,Gauteng,12272263,2598,0,31344,149
2020-06-27,South Africa,NA,Gauteng,12272263,2941,17,34285,166
2020-06-28,South Africa,NA,Gauteng,12272263,2610,8,36895,174
2020-06-29,South Africa,NA,Gauteng,12272263,2946,6,39841,180
2020-06-30,South Africa,NA,Gauteng,12272263,3040,36,42881,216
2020-07-01,South Africa,NA,Gauteng,12272263,3063,28,45944,244
2020-07-02,South Africa,NA,Gauteng,12272263,3993,38,49937,282
2020-07-03,South Africa,NA,Gauteng,12272263,4394,0,54331,282
2020-07-04,South Africa,NA,Gauteng,12272263,5042,0,59373,282
2020-07-05,South Africa,NA,Gauteng,12272263,4031,71,63404,353
2020-07-06,South Africa,NA,Gauteng,12272263,3487,50,66891,403
2020-07-07,South Africa,NA,Gauteng,12272263,4597,75,71488,478
2020-07-08,South Africa,NA,Gauteng,12272263,3527,0,75015,478
2020-07-09,South Africa,NA,Gauteng,12272263,6531,37,81546,515
2020-07-10,South Africa,NA,Gauteng,12272263,5487,39,87033,554
2020-07-11,South Africa,NA,Gauteng,12272263,6011,26,93044,580
2020-07-12,South Africa,NA,Gauteng,12272263,5387,64,98431,644
2020-07-13,South Africa,NA,Gauteng,12272263,5282,0,103713,644
2020-07-14,South Africa,NA,Gauteng,12272263,3357,82,107070,726
2020-07-15,South Africa,NA,Gauteng,12272263,5644,41,112714,767
2020-07-16,South Africa,NA,Gauteng,12272263,5181,86,117895,853
2020-07-17,South Africa,NA,Gauteng,12272263,5513,64,123408,917
2020-07-18,South Africa,NA,Gauteng,12272263,5196,39,128604,956
2020-07-19,South Africa,NA,Gauteng,12272263,5013,30,133617,986
2020-07-20,South Africa,NA,Gauteng,12272263,3262,13,136879,999
2020-07-21,South Africa,NA,Gauteng,12272263,2556,43,139435,1042
2020-07-22,South Africa,NA,Gauteng,12272263,5147,114,144582,1156
2020-07-23,South Africa,NA,Gauteng,12272263,4272,31,148854,1187
2020-07-24,South Africa,NA,Gauteng,12272263,4166,139,153020,1326
2020-07-25,South Africa,NA,Gauteng,12272263,3801,209,156821,1535
2020-07-26,South Africa,NA,Gauteng,12272263,3333,29,160154,1564
2020-07-27,South Africa,NA,Gauteng,12272263,2165,61,162319,1625
2020-07-28,South Africa,NA,Gauteng,12272263,2265,55,164584,1680
2020-07-29,South Africa,NA,Gauteng,12272263,3785,156,168369,1836
2020-07-30,South Africa,NA,Gauteng,12272263,3205,96,171574,1932
2020-07-31,South Africa,NA,Gauteng,12272263,3698,103,175272,2035
2020-08-01,South Africa,NA,Gauteng,12272263,2847,40,178119,2075
2020-08-02,South Africa,NA,Gauteng,12272263,2413,40,180532,2115
2020-08-03,South Africa,NA,Gauteng,12272263,1414,37,181946,2152
2020-08-04,South Africa,NA,Gauteng,12272263,1144,116,183090,2268
2020-08-05,South Africa,NA,Gauteng,12272263,2192,45,185282,2313
2020-08-06,South Africa,NA,Gauteng,12272263,2349,75,187631,2388
2020-08-07,South Africa,NA,Gauteng,12272263,1528,136,189159,2524
2020-08-08,South Africa,NA,Gauteng,12272263,1840,23,190999,2547
2020-08-09,South Africa,NA,Gauteng,12272263,1768,32,192767,2579
2020-08-10,South Africa,NA,Gauteng,12272263,794,39,193561,2618
2020-08-11,South Africa,NA,Gauteng,12272263,532,35,194093,2653
2020-08-12,South Africa,NA,Gauteng,12272263,592,108,194685,2761
2020-08-13,South Africa,NA,Gauteng,12272263,1135,30,195820,2791
2020-08-14,South Africa,NA,Gauteng,12272263,1711,76,197531,2867
2020-08-15,South Africa,NA,Gauteng,12272263,1140,21,198671,2888
2020-08-16,South Africa,NA,Gauteng,12272263,964,27,199635,2915
2020-08-17,South Africa,NA,Gauteng,12272263,602,14,200237,2929
2020-08-18,South Africa,NA,Gauteng,12272263,712,89,200949,3018
2020-08-19,South Africa,NA,Gauteng,12272263,1062,43,202011,3061
2020-08-20,South Africa,NA,Gauteng,12272263,944,83,202955,3144
2020-08-21,South Africa,NA,Gauteng,12272263,877,46,203832,3190
2020-08-22,South Africa,NA,Gauteng,12272263,1414,37,205246,3227
2020-08-23,South Africa,NA,Gauteng,12272263,772,41,206018,3268
2020-08-24,South Africa,NA,Gauteng,12272263,507,12,206525,3280
2020-08-25,South Africa,NA,Gauteng,12272263,367,54,206892,3334
2020-08-26,South Africa,NA,Gauteng,12272263,718,61,207610,3395
2020-08-27,South Africa,NA,Gauteng,12272263,546,33,208156,3428
2020-08-28,South Africa,NA,Gauteng,12272263,423,47,208579,3475
2020-08-29,South Africa,NA,Gauteng,12272263,544,81,209123,3556
2020-08-30,South Africa,NA,Gauteng,12272263,525,16,209648,3572
2020-08-31,South Africa,NA,Gauteng,12272263,521,20,210169,3592
2020-09-01,South Africa,NA,Gauteng,12272263,349,39,210518,3631
2020-09-02,South Africa,NA,Gauteng,12272263,639,49,211157,3680
2020-09-03,South Africa,NA,Gauteng,12272263,521,50,211678,3730
2020-09-04,South Africa,NA,Gauteng,12272263,508,43,212186,3773
2020-09-05,South Africa,NA,Gauteng,12272263,378,16,212564,3789
2020-09-06,South Africa,NA,Gauteng,12272263,334,24,212898,3813
2020-09-07,South Africa,NA,Gauteng,12272263,189,5,213087,3818
2020-09-08,South Africa,NA,Gauteng,12272263,246,15,213333,3833
2020-09-09,South Africa,NA,Gauteng,12272263,408,27,213741,3860
2020-09-10,South Africa,NA,Gauteng,12272263,411,21,214152,3881
2020-09-11,South Africa,NA,Gauteng,12272263,334,19,214486,3900
2020-09-12,South Africa,NA,Gauteng,12272263,345,12,214831,3912
2020-09-13,South Africa,NA,Gauteng,12272263,309,6,215140,3918
2020-09-14,South Africa,NA,Gauteng,12272263,167,3,215307,3921
2020-09-15,South Africa,NA,Gauteng,12272263,174,12,215481,3933
2020-09-16,South Africa,NA,Gauteng,12272263,417,14,215898,3947
2020-09-17,South Africa,NA,Gauteng,12272263,443,13,216341,3960
2020-09-18,South Africa,NA,Gauteng,12272263,449,62,216790,4022
2020-09-19,South Africa,NA,Gauteng,12272263,326,5,217116,4027
2020-09-20,South Africa,NA,Gauteng,12272263,254,3,217370,4030
2020-09-21,South Africa,NA,Gauteng,12272263,115,9,217485,4039
2020-09-22,South Africa,NA,Gauteng,12272263,274,45,217759,4084
2020-09-23,South Africa,NA,Gauteng,12272263,356,11,218115,4095
2020-03-14,South Africa,NA,KwaZulu_Natal,10267300,1,0,11,0
2020-03-15,South Africa,NA,KwaZulu_Natal,10267300,1,0,12,0
2020-03-16,South Africa,NA,KwaZulu_Natal,10267300,0,0,12,0
2020-03-17,South Africa,NA,KwaZulu_Natal,10267300,4,0,16,0
2020-03-18,South Africa,NA,KwaZulu_Natal,10267300,3,0,19,0
2020-03-19,South Africa,NA,KwaZulu_Natal,10267300,3,0,22,0
2020-03-20,South Africa,NA,KwaZulu_Natal,10267300,1,0,23,0
2020-03-21,South Africa,NA,KwaZulu_Natal,10267300,3,0,26,0
2020-03-22,South Africa,NA,KwaZulu_Natal,10267300,9,0,35,0
2020-03-23,South Africa,NA,KwaZulu_Natal,10267300,25,0,60,0
2020-03-24,South Africa,NA,KwaZulu_Natal,10267300,20,0,80,0
2020-03-25,South Africa,NA,KwaZulu_Natal,10267300,11,0,91,0
2020-03-26,South Africa,NA,KwaZulu_Natal,10267300,43,0,134,0
2020-03-28,South Africa,NA,KwaZulu_Natal,10267300,22,1,156,1
2020-03-29,South Africa,NA,KwaZulu_Natal,10267300,11,0,167,1
2020-03-30,South Africa,NA,KwaZulu_Natal,10267300,4,0,171,1
2020-03-31,South Africa,NA,KwaZulu_Natal,10267300,8,1,179,2
2020-04-01,South Africa,NA,KwaZulu_Natal,10267300,7,0,186,2
2020-04-02,South Africa,NA,KwaZulu_Natal,10267300,20,0,206,2
2020-04-03,South Africa,NA,KwaZulu_Natal,10267300,9,4,215,6
2020-04-04,South Africa,NA,KwaZulu_Natal,10267300,17,0,232,6
2020-04-05,South Africa,NA,KwaZulu_Natal,10267300,14,1,246,7
2020-04-06,South Africa,NA,KwaZulu_Natal,10267300,11,0,257,7
2020-04-08,South Africa,NA,KwaZulu_Natal,10267300,97,1,354,9
2020-04-09,South Africa,NA,KwaZulu_Natal,10267300,33,0,387,9
2020-04-10,South Africa,NA,KwaZulu_Natal,10267300,25,3,412,12
2020-04-11,South Africa,NA,KwaZulu_Natal,10267300,6,0,418,12
2020-04-12,South Africa,NA,KwaZulu_Natal,10267300,25,0,443,12
2020-04-13,South Africa,NA,KwaZulu_Natal,10267300,22,0,465,12
2020-04-14,South Africa,NA,KwaZulu_Natal,10267300,24,0,489,12
2020-04-15,South Africa,NA,KwaZulu_Natal,10267300,30,6,519,18
2020-04-16,South Africa,NA,KwaZulu_Natal,10267300,20,2,539,20
2020-04-17,South Africa,NA,KwaZulu_Natal,10267300,52,0,591,20
2020-04-18,South Africa,NA,KwaZulu_Natal,10267300,13,1,604,21
2020-04-19,South Africa,NA,KwaZulu_Natal,10267300,13,1,617,22
2020-04-20,South Africa,NA,KwaZulu_Natal,10267300,22,1,639,23
2020-04-21,South Africa,NA,KwaZulu_Natal,10267300,32,0,671,23
2020-04-22,South Africa,NA,KwaZulu_Natal,10267300,87,2,758,25
2020-04-23,South Africa,NA,KwaZulu_Natal,10267300,49,2,807,27
2020-04-24,South Africa,NA,KwaZulu_Natal,10267300,34,2,841,29
2020-04-25,South Africa,NA,KwaZulu_Natal,10267300,0,0,841,29
2020-04-26,South Africa,NA,KwaZulu_Natal,10267300,22,0,863,29
2020-04-27,South Africa,NA,KwaZulu_Natal,10267300,39,1,902,30
2020-04-28,South Africa,NA,KwaZulu_Natal,10267300,17,0,919,30
2020-04-29,South Africa,NA,KwaZulu_Natal,10267300,37,2,956,32
2020-04-30,South Africa,NA,KwaZulu_Natal,10267300,24,0,980,32
2020-05-01,South Africa,NA,KwaZulu_Natal,10267300,26,0,1006,32
2020-05-02,South Africa,NA,KwaZulu_Natal,10267300,45,2,1051,34
2020-05-03,South Africa,NA,KwaZulu_Natal,10267300,25,0,1076,34
2020-05-04,South Africa,NA,KwaZulu_Natal,10267300,30,1,1106,35
2020-05-05,South Africa,NA,KwaZulu_Natal,10267300,36,1,1142,36
2020-05-06,South Africa,NA,KwaZulu_Natal,10267300,7,2,1149,38
2020-05-07,South Africa,NA,KwaZulu_Natal,10267300,55,2,1204,40
2020-05-08,South Africa,NA,KwaZulu_Natal,10267300,49,2,1253,42
2020-05-09,South Africa,NA,KwaZulu_Natal,10267300,55,0,1308,43
2020-05-10,South Africa,NA,KwaZulu_Natal,10267300,45,0,1353,43
2020-05-11,South Africa,NA,KwaZulu_Natal,10267300,19,1,1372,44
2020-05-12,South Africa,NA,KwaZulu_Natal,10267300,22,0,1394,44
2020-05-13,South Africa,NA,KwaZulu_Natal,10267300,19,0,1413,44
2020-05-14,South Africa,NA,KwaZulu_Natal,10267300,31,0,1444,44
2020-05-15,South Africa,NA,KwaZulu_Natal,10267300,38,1,1482,45
2020-05-16,South Africa,NA,KwaZulu_Natal,10267300,16,0,1498,45
2020-05-17,South Africa,NA,KwaZulu_Natal,10267300,45,0,1543,45
2020-05-18,South Africa,NA,KwaZulu_Natal,10267300,24,0,1567,45
2020-05-19,South Africa,NA,KwaZulu_Natal,10267300,49,1,1616,46
2020-05-20,South Africa,NA,KwaZulu_Natal,10267300,34,0,1650,46
2020-05-21,South Africa,NA,KwaZulu_Natal,10267300,43,0,1693,46
2020-05-22,South Africa,NA,KwaZulu_Natal,10267300,42,1,1735,47
2020-05-23,South Africa,NA,KwaZulu_Natal,10267300,42,1,1777,48
2020-05-24,South Africa,NA,KwaZulu_Natal,10267300,38,1,1815,49
2020-05-25,South Africa,NA,KwaZulu_Natal,10267300,67,0,1882,49
2020-05-26,South Africa,NA,KwaZulu_Natal,10267300,45,0,1927,49
2020-05-27,South Africa,NA,KwaZulu_Natal,10267300,259,0,2186,49
2020-05-28,South Africa,NA,KwaZulu_Natal,10267300,163,1,2349,50
2020-05-29,South Africa,NA,KwaZulu_Natal,10267300,79,0,2428,50
2020-05-30,South Africa,NA,KwaZulu_Natal,10267300,48,2,2476,52
2020-05-31,South Africa,NA,KwaZulu_Natal,10267300,69,0,2545,52
2020-06-01,South Africa,NA,KwaZulu_Natal,10267300,20,0,2565,52
2020-06-02,South Africa,NA,KwaZulu_Natal,10267300,72,1,2637,53
2020-06-03,South Africa,NA,KwaZulu_Natal,10267300,70,1,2707,54
2020-06-04,South Africa,NA,KwaZulu_Natal,10267300,162,1,2869,55
2020-06-05,South Africa,NA,KwaZulu_Natal,10267300,67,0,2936,55
2020-06-06,South Africa,NA,KwaZulu_Natal,10267300,80,6,3016,61
2020-06-07,South Africa,NA,KwaZulu_Natal,10267300,92,0,3108,61
2020-06-08,South Africa,NA,KwaZulu_Natal,10267300,67,1,3175,62
2020-06-09,South Africa,NA,KwaZulu_Natal,10267300,80,0,3255,62
2020-06-10,South Africa,NA,KwaZulu_Natal,10267300,92,2,3347,64
2020-06-11,South Africa,NA,KwaZulu_Natal,10267300,125,0,3472,64
2020-06-12,South Africa,NA,KwaZulu_Natal,10267300,101,0,3573,64
2020-06-13,South Africa,NA,KwaZulu_Natal,10267300,190,0,3763,64
2020-06-14,South Africa,NA,KwaZulu_Natal,10267300,111,5,3874,69
2020-06-15,South Africa,NA,KwaZulu_Natal,10267300,85,0,3959,69
2020-06-16,South Africa,NA,KwaZulu_Natal,10267300,89,4,4048,73
2020-06-17,South Africa,NA,KwaZulu_Natal,10267300,190,0,4238,73
2020-06-18,South Africa,NA,KwaZulu_Natal,10267300,122,0,4360,73
2020-06-19,South Africa,NA,KwaZulu_Natal,10267300,188,7,4548,80
2020-06-20,South Africa,NA,KwaZulu_Natal,10267300,258,3,4806,83
2020-06-21,South Africa,NA,KwaZulu_Natal,10267300,224,1,5030,84
2020-06-22,South Africa,NA,KwaZulu_Natal,10267300,248,3,5278,87
2020-06-23,South Africa,NA,KwaZulu_Natal,10267300,347,4,5625,91
2020-06-24,South Africa,NA,KwaZulu_Natal,10267300,450,0,6075,91
2020-06-25,South Africa,NA,KwaZulu_Natal,10267300,515,15,6590,106
2020-06-26,South Africa,NA,KwaZulu_Natal,10267300,500,0,7090,106
2020-06-27,South Africa,NA,KwaZulu_Natal,10267300,696,3,7786,109
2020-06-28,South Africa,NA,KwaZulu_Natal,10267300,647,0,8433,109
2020-06-29,South Africa,NA,KwaZulu_Natal,10267300,608,6,9041,115
2020-06-30,South Africa,NA,KwaZulu_Natal,10267300,633,11,9674,126
2020-07-01,South Africa,NA,KwaZulu_Natal,10267300,958,10,10632,136
2020-07-02,South Africa,NA,KwaZulu_Natal,10267300,1037,16,11669,152
2020-07-03,South Africa,NA,KwaZulu_Natal,10267300,1088,10,12757,162
2020-07-04,South Africa,NA,KwaZulu_Natal,10267300,1227,0,13984,162
2020-07-05,South Africa,NA,KwaZulu_Natal,10267300,1162,21,15146,183
2020-07-06,South Africa,NA,KwaZulu_Natal,10267300,673,0,15819,183
2020-07-07,South Africa,NA,KwaZulu_Natal,10267300,924,22,16743,205
2020-07-08,South Africa,NA,KwaZulu_Natal,10267300,1219,18,17962,223
2020-07-09,South Africa,NA,KwaZulu_Natal,10267300,1668,26,19630,249
2020-07-10,South Africa,NA,KwaZulu_Natal,10267300,1756,11,21386,260
2020-07-11,South Africa,NA,KwaZulu_Natal,10267300,2367,13,23753,273
2020-07-12,South Africa,NA,KwaZulu_Natal,10267300,1819,7,25572,280
2020-07-13,South Africa,NA,KwaZulu_Natal,10267300,1815,6,27387,286
2020-07-14,South Africa,NA,KwaZulu_Natal,10267300,3200,27,30587,313
2020-07-15,South Africa,NA,KwaZulu_Natal,10267300,2352,4,32939,317
2020-07-16,South Africa,NA,KwaZulu_Natal,10267300,2665,41,35604,358
2020-07-17,South Africa,NA,KwaZulu_Natal,10267300,2118,20,37722,378
2020-07-18,South Africa,NA,KwaZulu_Natal,10267300,2364,23,40086,401
2020-07-19,South Africa,NA,KwaZulu_Natal,10267300,3129,15,43215,416
2020-07-20,South Africa,NA,KwaZulu_Natal,10267300,2399,13,45614,429
2020-07-21,South Africa,NA,KwaZulu_Natal,10267300,2071,30,47685,459
2020-07-22,South Africa,NA,KwaZulu_Natal,10267300,2836,18,50521,477
2020-07-23,South Africa,NA,KwaZulu_Natal,10267300,2885,38,53406,515
2020-07-24,South Africa,NA,KwaZulu_Natal,10267300,3756,50,57162,565
2020-07-25,South Africa,NA,KwaZulu_Natal,10267300,3370,37,60532,602
2020-07-26,South Africa,NA,KwaZulu_Natal,10267300,3529,12,64061,614
2020-07-27,South Africa,NA,KwaZulu_Natal,10267300,1921,9,65982,623
2020-07-28,South Africa,NA,KwaZulu_Natal,10267300,2119,62,68101,685
2020-07-29,South Africa,NA,KwaZulu_Natal,10267300,3139,27,71240,712
2020-07-30,South Africa,NA,KwaZulu_Natal,10267300,2679,55,73919,767
2020-07-31,South Africa,NA,KwaZulu_Natal,10267300,2787,36,76706,803
2020-08-01,South Africa,NA,KwaZulu_Natal,10267300,2901,41,79607,844
2020-08-02,South Africa,NA,KwaZulu_Natal,10267300,2693,31,82300,875
2020-08-03,South Africa,NA,KwaZulu_Natal,10267300,2061,12,84361,887
2020-08-04,South Africa,NA,KwaZulu_Natal,10267300,1625,89,85986,976
2020-08-05,South Africa,NA,KwaZulu_Natal,10267300,1812,62,87798,1038
2020-08-06,South Africa,NA,KwaZulu_Natal,10267300,2317,78,90115,1116
2020-08-07,South Africa,NA,KwaZulu_Natal,10267300,2729,76,92844,1192
2020-08-08,South Africa,NA,KwaZulu_Natal,10267300,2804,154,95648,1346
2020-08-09,South Africa,NA,KwaZulu_Natal,10267300,2420,63,98068,1409
2020-08-10,South Africa,NA,KwaZulu_Natal,10267300,1318,11,99386,1420
2020-08-11,South Africa,NA,KwaZulu_Natal,10267300,1108,30,100494,1450
2020-08-12,South Africa,NA,KwaZulu_Natal,10267300,1005,74,101499,1524
2020-08-13,South Africa,NA,KwaZulu_Natal,10267300,734,39,102233,1563
2020-08-14,South Africa,NA,KwaZulu_Natal,10267300,1511,54,103744,1617
2020-08-15,South Africa,NA,KwaZulu_Natal,10267300,875,34,104619,1651
2020-08-16,South Africa,NA,KwaZulu_Natal,10267300,764,21,105383,1672
2020-08-17,South Africa,NA,KwaZulu_Natal,10267300,654,14,106037,1686
2020-08-18,South Africa,NA,KwaZulu_Natal,10267300,528,57,106565,1743
2020-08-19,South Africa,NA,KwaZulu_Natal,10267300,706,45,107271,1788
2020-08-20,South Africa,NA,KwaZulu_Natal,10267300,809,36,108080,1824
2020-08-21,South Africa,NA,KwaZulu_Natal,10267300,708,81,108788,1905
2020-08-22,South Africa,NA,KwaZulu_Natal,10267300,544,31,109332,1936
2020-08-23,South Africa,NA,KwaZulu_Natal,10267300,509,12,109841,1948
2020-08-24,South Africa,NA,KwaZulu_Natal,10267300,261,14,110102,1962
2020-08-25,South Africa,NA,KwaZulu_Natal,10267300,419,35,110521,1997
2020-08-26,South Africa,NA,KwaZulu_Natal,10267300,575,57,111096,2054
2020-08-27,South Africa,NA,KwaZulu_Natal,10267300,489,48,111585,2102
2020-08-28,South Africa,NA,KwaZulu_Natal,10267300,278,14,111863,2116
2020-08-29,South Africa,NA,KwaZulu_Natal,10267300,428,19,112291,2135
2020-08-30,South Africa,NA,KwaZulu_Natal,10267300,435,3,112726,2138
2020-08-31,South Africa,NA,KwaZulu_Natal,10267300,280,1,113006,2139
2020-09-01,South Africa,NA,KwaZulu_Natal,10267300,231,13,113237,2152
2020-09-02,South Africa,NA,KwaZulu_Natal,10267300,424,12,113661,2164
2020-09-03,South Africa,NA,KwaZulu_Natal,10267300,373,39,114034,2203
2020-09-04,South Africa,NA,KwaZulu_Natal,10267300,326,15,114360,2218
2020-09-05,South Africa,NA,KwaZulu_Natal,10267300,286,45,114646,2263
2020-09-06,South Africa,NA,KwaZulu_Natal,10267300,178,31,114824,2294
2020-09-07,South Africa,NA,KwaZulu_Natal,10267300,80,25,114904,2319
2020-09-08,South Africa,NA,KwaZulu_Natal,10267300,177,27,115081,2346
2020-09-09,South Africa,NA,KwaZulu_Natal,10267300,291,10,115372,2356
2020-09-10,South Africa,NA,KwaZulu_Natal,10267300,286,17,115658,2373
2020-09-11,South Africa,NA,KwaZulu_Natal,10267300,281,19,115939,2392
2020-09-12,South Africa,NA,KwaZulu_Natal,10267300,228,11,116167,2403
2020-09-13,South Africa,NA,KwaZulu_Natal,10267300,222,4,116389,2407
2020-09-14,South Africa,NA,KwaZulu_Natal,10267300,124,2,116513,2409
2020-09-15,South Africa,NA,KwaZulu_Natal,10267300,161,16,116674,2425
2020-09-16,South Africa,NA,KwaZulu_Natal,10267300,236,24,116910,2449
2020-09-17,South Africa,NA,KwaZulu_Natal,10267300,237,20,117147,2469
2020-09-18,South Africa,NA,KwaZulu_Natal,10267300,213,9,117360,2478
2020-09-19,South Africa,NA,KwaZulu_Natal,10267300,209,52,117569,2530
2020-09-20,South Africa,NA,KwaZulu_Natal,10267300,174,1,117743,2531
2020-09-21,South Africa,NA,KwaZulu_Natal,10267300,90,1,117833,2532
2020-09-22,South Africa,NA,KwaZulu_Natal,10267300,139,54,117972,2586
2020-09-23,South Africa,NA,KwaZulu_Natal,10267300,202,18,118174,2604
2020-03-28,South Africa,NA,Limpopo,5404868,5,0,11,0
2020-03-29,South Africa,NA,Limpopo,5404868,1,0,12,0
2020-03-30,South Africa,NA,Limpopo,5404868,0,0,12,0
2020-03-31,South Africa,NA,Limpopo,5404868,3,0,14,0
2020-04-01,South Africa,NA,Limpopo,5404868,0,0,14,0
2020-04-02,South Africa,NA,Limpopo,5404868,2,0,16,0
2020-04-03,South Africa,NA,Limpopo,5404868,0,0,16,0
2020-04-04,South Africa,NA,Limpopo,5404868,2,0,18,0
2020-04-05,South Africa,NA,Limpopo,5404868,1,0,19,0
2020-04-06,South Africa,NA,Limpopo,5404868,0,0,19,0
2020-04-08,South Africa,NA,Limpopo,5404868,2,0,21,0
2020-04-09,South Africa,NA,Limpopo,5404868,1,0,22,0
2020-04-10,South Africa,NA,Limpopo,5404868,2,0,24,0
2020-04-11,South Africa,NA,Limpopo,5404868,0,0,24,0
2020-04-12,South Africa,NA,Limpopo,5404868,0,0,24,0
2020-04-13,South Africa,NA,Limpopo,5404868,0,0,24,0
2020-04-14,South Africa,NA,Limpopo,5404868,1,0,24,0
2020-04-15,South Africa,NA,Limpopo,5404868,1,0,25,0
2020-04-16,South Africa,NA,Limpopo,5404868,1,1,26,1
2020-04-17,South Africa,NA,Limpopo,5404868,0,0,26,1
2020-04-18,South Africa,NA,Limpopo,5404868,0,0,26,1
2020-04-19,South Africa,NA,Limpopo,5404868,1,0,27,1
2020-04-20,South Africa,NA,Limpopo,5404868,0,0,27,1
2020-04-21,South Africa,NA,Limpopo,5404868,0,0,27,1
2020-04-22,South Africa,NA,Limpopo,5404868,0,0,27,1
2020-04-23,South Africa,NA,Limpopo,5404868,0,0,27,1
2020-04-24,South Africa,NA,Limpopo,5404868,2,0,29,1
2020-04-25,South Africa,NA,Limpopo,5404868,1,1,30,2
2020-04-26,South Africa,NA,Limpopo,5404868,1,0,31,2
2020-04-27,South Africa,NA,Limpopo,5404868,0,0,31,2
2020-04-28,South Africa,NA,Limpopo,5404868,0,0,31,2
2020-04-29,South Africa,NA,Limpopo,5404868,0,0,31,2
2020-04-30,South Africa,NA,Limpopo,5404868,1,0,32,2
2020-05-01,South Africa,NA,Limpopo,5404868,2,0,34,2
2020-05-02,South Africa,NA,Limpopo,5404868,2,0,36,2
2020-05-03,South Africa,NA,Limpopo,5404868,1,0,37,2
2020-05-04,South Africa,NA,Limpopo,5404868,2,0,39,2
2020-05-05,South Africa,NA,Limpopo,5404868,1,0,40,2
2020-05-06,South Africa,NA,Limpopo,5404868,0,1,40,3
2020-05-07,South Africa,NA,Limpopo,5404868,1,0,41,3
2020-05-08,South Africa,NA,Limpopo,5404868,2,0,43,3
2020-05-09,South Africa,NA,Limpopo,5404868,8,0,51,3
2020-05-10,South Africa,NA,Limpopo,5404868,3,0,54,3
2020-05-11,South Africa,NA,Limpopo,5404868,0,0,54,3
2020-05-12,South Africa,NA,Limpopo,5404868,0,0,54,3
2020-05-13,South Africa,NA,Limpopo,5404868,0,0,54,3
2020-05-14,South Africa,NA,Limpopo,5404868,1,0,55,3
2020-05-15,South Africa,NA,Limpopo,5404868,2,0,57,3
2020-05-16,South Africa,NA,Limpopo,5404868,2,0,59,3
2020-05-17,South Africa,NA,Limpopo,5404868,18,0,77,3
2020-05-18,South Africa,NA,Limpopo,5404868,11,0,88,3
2020-05-19,South Africa,NA,Limpopo,5404868,6,0,94,3
2020-05-20,South Africa,NA,Limpopo,5404868,0,0,94,3
2020-05-21,South Africa,NA,Limpopo,5404868,28,0,121,3
2020-05-22,South Africa,NA,Limpopo,5404868,0,0,121,3
2020-05-23,South Africa,NA,Limpopo,5404868,4,0,124,3
2020-05-24,South Africa,NA,Limpopo,5404868,4,0,128,3
2020-05-25,South Africa,NA,Limpopo,5404868,4,0,132,3
2020-05-26,South Africa,NA,Limpopo,5404868,0,0,132,3
2020-05-27,South Africa,NA,Limpopo,5404868,9,0,141,3
2020-05-28,South Africa,NA,Limpopo,5404868,3,0,144,3
2020-05-29,South Africa,NA,Limpopo,5404868,26,0,170,3
2020-05-30,South Africa,NA,Limpopo,5404868,3,0,173,3
2020-05-31,South Africa,NA,Limpopo,5404868,4,0,177,3
2020-06-01,South Africa,NA,Limpopo,5404868,15,0,192,3
2020-06-02,South Africa,NA,Limpopo,5404868,1,0,193,3
2020-06-03,South Africa,NA,Limpopo,5404868,7,0,200,3
2020-06-04,South Africa,NA,Limpopo,5404868,6,0,206,3
2020-06-05,South Africa,NA,Limpopo,5404868,9,0,215,3
2020-06-06,South Africa,NA,Limpopo,5404868,1,0,216,3
2020-06-07,South Africa,NA,Limpopo,5404868,11,0,227,3
2020-06-08,South Africa,NA,Limpopo,5404868,17,0,244,3
2020-06-09,South Africa,NA,Limpopo,5404868,9,0,253,3
2020-06-10,South Africa,NA,Limpopo,5404868,4,0,257,3
2020-06-11,South Africa,NA,Limpopo,5404868,10,0,267,3
2020-06-12,South Africa,NA,Limpopo,5404868,21,1,288,4
2020-06-13,South Africa,NA,Limpopo,5404868,21,0,309,4
2020-06-14,South Africa,NA,Limpopo,5404868,17,0,326,4
2020-06-15,South Africa,NA,Limpopo,5404868,36,0,362,4
2020-06-16,South Africa,NA,Limpopo,5404868,29,0,391,4
2020-06-17,South Africa,NA,Limpopo,5404868,25,0,416,4
2020-06-18,South Africa,NA,Limpopo,5404868,73,0,489,4
2020-06-19,South Africa,NA,Limpopo,5404868,14,0,503,4
2020-06-20,South Africa,NA,Limpopo,5404868,18,0,521,4
2020-06-21,South Africa,NA,Limpopo,5404868,43,0,564,4
2020-06-22,South Africa,NA,Limpopo,5404868,18,1,582,5
2020-06-23,South Africa,NA,Limpopo,5404868,40,0,622,5
2020-06-24,South Africa,NA,Limpopo,5404868,48,0,670,5
2020-06-25,South Africa,NA,Limpopo,5404868,60,0,730,5
2020-06-26,South Africa,NA,Limpopo,5404868,68,0,798,5
2020-06-27,South Africa,NA,Limpopo,5404868,64,0,862,5
2020-06-28,South Africa,NA,Limpopo,5404868,73,0,935,5
2020-06-29,South Africa,NA,Limpopo,5404868,76,5,1011,10
2020-06-30,South Africa,NA,Limpopo,5404868,120,0,1131,10
2020-07-01,South Africa,NA,Limpopo,5404868,44,0,1175,10
2020-07-02,South Africa,NA,Limpopo,5404868,111,0,1286,10
2020-07-03,South Africa,NA,Limpopo,5404868,122,0,1408,10
2020-07-04,South Africa,NA,Limpopo,5404868,151,0,1559,10
2020-07-05,South Africa,NA,Limpopo,5404868,147,0,1706,10
2020-07-06,South Africa,NA,Limpopo,5404868,79,17,1785,27
2020-07-07,South Africa,NA,Limpopo,5404868,165,15,1950,42
2020-07-08,South Africa,NA,Limpopo,5404868,181,2,2131,44
2020-07-09,South Africa,NA,Limpopo,5404868,250,0,2381,44
2020-07-10,South Africa,NA,Limpopo,5404868,198,0,2579,44
2020-07-11,South Africa,NA,Limpopo,5404868,256,0,2835,44
2020-07-12,South Africa,NA,Limpopo,5404868,179,0,3014,44
2020-07-13,South Africa,NA,Limpopo,5404868,302,0,3316,44
2020-07-14,South Africa,NA,Limpopo,5404868,142,0,3458,44
2020-07-15,South Africa,NA,Limpopo,5404868,187,0,3645,44
2020-07-16,South Africa,NA,Limpopo,5404868,238,0,3883,44
2020-07-17,South Africa,NA,Limpopo,5404868,277,0,4160,44
2020-07-18,South Africa,NA,Limpopo,5404868,330,0,4490,44
2020-07-19,South Africa,NA,Limpopo,5404868,438,0,4928,44
2020-07-20,South Africa,NA,Limpopo,5404868,228,0,5156,44
2020-07-21,South Africa,NA,Limpopo,5404868,199,0,5355,44
2020-07-22,South Africa,NA,Limpopo,5404868,357,0,5712,44
2020-07-23,South Africa,NA,Limpopo,5404868,356,0,6068,44
2020-07-24,South Africa,NA,Limpopo,5404868,326,0,6394,44
2020-07-25,South Africa,NA,Limpopo,5404868,338,0,6732,44
2020-07-26,South Africa,NA,Limpopo,5404868,344,34,7076,67
2020-07-27,South Africa,NA,Limpopo,5404868,184,0,7260,67
2020-07-28,South Africa,NA,Limpopo,5404868,242,0,7502,67
2020-07-29,South Africa,NA,Limpopo,5404868,338,0,7840,67
2020-07-30,South Africa,NA,Limpopo,5404868,400,0,8240,67
2020-07-31,South Africa,NA,Limpopo,5404868,325,0,8565,67
2020-08-01,South Africa,NA,Limpopo,5404868,314,0,8879,67
2020-08-02,South Africa,NA,Limpopo,5404868,165,23,9044,90
2020-08-03,South Africa,NA,Limpopo,5404868,160,0,9204,90
2020-08-04,South Africa,NA,Limpopo,5404868,185,0,9389,90
2020-08-05,South Africa,NA,Limpopo,5404868,236,0,9625,90
2020-08-06,South Africa,NA,Limpopo,5404868,248,0,9873,90
2020-08-07,South Africa,NA,Limpopo,5404868,265,0,10138,90
2020-08-08,South Africa,NA,Limpopo,5404868,207,37,10345,127
2020-08-09,South Africa,NA,Limpopo,5404868,201,0,10546,127
2020-08-10,South Africa,NA,Limpopo,5404868,165,0,10711,127
2020-08-11,South Africa,NA,Limpopo,5404868,96,0,10807,127
2020-08-12,South Africa,NA,Limpopo,5404868,68,0,10875,127
2020-08-13,South Africa,NA,Limpopo,5404868,144,14,11019,141
2020-08-14,South Africa,NA,Limpopo,5404868,195,0,11214,141
2020-08-15,South Africa,NA,Limpopo,5404868,231,18,11445,159
2020-08-16,South Africa,NA,Limpopo,5404868,128,0,11573,159
2020-08-17,South Africa,NA,Limpopo,5404868,184,0,11757,159
2020-08-18,South Africa,NA,Limpopo,5404868,56,0,11813,159
2020-08-19,South Africa,NA,Limpopo,5404868,131,0,11944,159
2020-08-20,South Africa,NA,Limpopo,5404868,142,12,12086,171
2020-08-21,South Africa,NA,Limpopo,5404868,195,0,12281,171
2020-08-22,South Africa,NA,Limpopo,5404868,108,0,12389,171
2020-08-23,South Africa,NA,Limpopo,5404868,174,0,12563,171
2020-08-24,South Africa,NA,Limpopo,5404868,80,8,12643,179
2020-08-25,South Africa,NA,Limpopo,5404868,60,0,12703,179
2020-08-26,South Africa,NA,Limpopo,5404868,92,0,12795,179
2020-08-27,South Africa,NA,Limpopo,5404868,72,0,12867,179
2020-08-28,South Africa,NA,Limpopo,5404868,93,0,12960,179
2020-08-29,South Africa,NA,Limpopo,5404868,79,0,13039,179
2020-08-30,South Africa,NA,Limpopo,5404868,128,0,13167,179
2020-08-31,South Africa,NA,Limpopo,5404868,98,23,13265,202
2020-09-01,South Africa,NA,Limpopo,5404868,36,0,13301,202
2020-09-02,South Africa,NA,Limpopo,5404868,99,0,13400,202
2020-09-03,South Africa,NA,Limpopo,5404868,88,0,13488,202
2020-09-04,South Africa,NA,Limpopo,5404868,108,12,13596,214
2020-09-05,South Africa,NA,Limpopo,5404868,69,0,13665,214
2020-09-06,South Africa,NA,Limpopo,5404868,69,0,13734,214
2020-09-07,South Africa,NA,Limpopo,5404868,35,43,13769,257
2020-09-08,South Africa,NA,Limpopo,5404868,28,0,13797,257
2020-09-09,South Africa,NA,Limpopo,5404868,103,0,13900,257
2020-09-10,South Africa,NA,Limpopo,5404868,79,1,13979,258
2020-09-11,South Africa,NA,Limpopo,5404868,80,0,14059,258
2020-09-12,South Africa,NA,Limpopo,5404868,54,0,14113,258
2020-09-13,South Africa,NA,Limpopo,5404868,70,0,14183,258
2020-09-14,South Africa,NA,Limpopo,5404868,33,0,14216,258
2020-09-15,South Africa,NA,Limpopo,5404868,47,67,14263,325
2020-09-16,South Africa,NA,Limpopo,5404868,101,0,14364,325
2020-09-17,South Africa,NA,Limpopo,5404868,80,19,14444,344
2020-09-18,South Africa,NA,Limpopo,5404868,113,0,14557,344
2020-09-19,South Africa,NA,Limpopo,5404868,101,18,14658,362
2020-09-20,South Africa,NA,Limpopo,5404868,45,0,14703,362
2020-09-21,South Africa,NA,Limpopo,5404868,18,0,14721,362
2020-09-22,South Africa,NA,Limpopo,5404868,56,0,14777,362
2020-09-23,South Africa,NA,Limpopo,5404868,129,22,14906,384
2020-03-29,South Africa,NA,Mpumalanga,4039939,1,0,11,0
2020-03-30,South Africa,NA,Mpumalanga,4039939,0,0,11,0
2020-03-31,South Africa,NA,Mpumalanga,4039939,1,0,12,0
2020-04-01,South Africa,NA,Mpumalanga,4039939,0,0,12,0
2020-04-02,South Africa,NA,Mpumalanga,4039939,1,0,13,0
2020-04-03,South Africa,NA,Mpumalanga,4039939,0,0,13,0
2020-04-04,South Africa,NA,Mpumalanga,4039939,5,0,18,0
2020-04-05,South Africa,NA,Mpumalanga,4039939,0,0,18,0
2020-04-06,South Africa,NA,Mpumalanga,4039939,0,0,18,0
2020-04-08,South Africa,NA,Mpumalanga,4039939,3,0,21,0
2020-04-09,South Africa,NA,Mpumalanga,4039939,0,0,21,0
2020-04-10,South Africa,NA,Mpumalanga,4039939,0,0,21,0
2020-04-11,South Africa,NA,Mpumalanga,4039939,0,0,21,0
2020-04-12,South Africa,NA,Mpumalanga,4039939,1,0,21,0
2020-04-13,South Africa,NA,Mpumalanga,4039939,1,0,22,0
2020-04-14,South Africa,NA,Mpumalanga,4039939,0,0,22,0
2020-04-15,South Africa,NA,Mpumalanga,4039939,0,0,22,0
2020-04-16,South Africa,NA,Mpumalanga,4039939,0,0,22,0
2020-04-17,South Africa,NA,Mpumalanga,4039939,1,0,23,0
2020-04-18,South Africa,NA,Mpumalanga,4039939,2,0,25,0
2020-04-19,South Africa,NA,Mpumalanga,4039939,0,0,25,0
2020-04-20,South Africa,NA,Mpumalanga,4039939,0,0,25,0
2020-04-21,South Africa,NA,Mpumalanga,4039939,1,0,25,0
2020-04-22,South Africa,NA,Mpumalanga,4039939,0,0,25,0
2020-04-23,South Africa,NA,Mpumalanga,4039939,0,0,25,0
2020-04-24,South Africa,NA,Mpumalanga,4039939,1,0,25,0
2020-04-25,South Africa,NA,Mpumalanga,4039939,0,0,25,0
2020-04-26,South Africa,NA,Mpumalanga,4039939,0,0,25,0
2020-04-27,South Africa,NA,Mpumalanga,4039939,3,0,26,0
2020-04-28,South Africa,NA,Mpumalanga,4039939,0,0,26,0
2020-04-29,South Africa,NA,Mpumalanga,4039939,5,0,31,0
2020-04-30,South Africa,NA,Mpumalanga,4039939,5,0,36,0
2020-05-01,South Africa,NA,Mpumalanga,4039939,0,0,36,0
2020-05-02,South Africa,NA,Mpumalanga,4039939,5,0,40,0
2020-05-03,South Africa,NA,Mpumalanga,4039939,6,0,46,0
2020-05-04,South Africa,NA,Mpumalanga,4039939,7,0,53,0
2020-05-05,South Africa,NA,Mpumalanga,4039939,4,0,57,0
2020-05-06,South Africa,NA,Mpumalanga,4039939,0,0,57,0
2020-05-07,South Africa,NA,Mpumalanga,4039939,2,0,59,0
2020-05-08,South Africa,NA,Mpumalanga,4039939,1,0,60,0
2020-05-09,South Africa,NA,Mpumalanga,4039939,1,0,61,0
2020-05-10,South Africa,NA,Mpumalanga,4039939,0,0,61,0
2020-05-11,South Africa,NA,Mpumalanga,4039939,2,0,63,0
2020-05-12,South Africa,NA,Mpumalanga,4039939,0,0,63,0
2020-05-13,South Africa,NA,Mpumalanga,4039939,3,0,66,0
2020-05-14,South Africa,NA,Mpumalanga,4039939,1,0,67,0
2020-05-15,South Africa,NA,Mpumalanga,4039939,0,0,67,0
2020-05-16,South Africa,NA,Mpumalanga,4039939,1,0,68,0
2020-05-17,South Africa,NA,Mpumalanga,4039939,3,0,71,0
2020-05-18,South Africa,NA,Mpumalanga,4039939,5,0,76,0
2020-05-19,South Africa,NA,Mpumalanga,4039939,2,0,78,0
2020-05-20,South Africa,NA,Mpumalanga,4039939,15,0,93,0
2020-05-21,South Africa,NA,Mpumalanga,4039939,2,0,95,0
2020-05-22,South Africa,NA,Mpumalanga,4039939,3,0,98,0
2020-05-23,South Africa,NA,Mpumalanga,4039939,0,0,98,0
2020-05-24,South Africa,NA,Mpumalanga,4039939,4,0,101,0
2020-05-25,South Africa,NA,Mpumalanga,4039939,1,0,102,0
2020-05-26,South Africa,NA,Mpumalanga,4039939,1,0,103,0
2020-05-27,South Africa,NA,Mpumalanga,4039939,3,0,106,0
2020-05-28,South Africa,NA,Mpumalanga,4039939,5,0,111,0
2020-05-29,South Africa,NA,Mpumalanga,4039939,1,0,112,0
2020-05-30,South Africa,NA,Mpumalanga,4039939,1,0,113,0
2020-05-31,South Africa,NA,Mpumalanga,4039939,8,0,121,0
2020-06-01,South Africa,NA,Mpumalanga,4039939,10,0,131,0
2020-06-02,South Africa,NA,Mpumalanga,4039939,1,0,132,0
2020-06-03,South Africa,NA,Mpumalanga,4039939,5,0,137,0
2020-06-04,South Africa,NA,Mpumalanga,4039939,7,0,144,0
2020-06-05,South Africa,NA,Mpumalanga,4039939,25,0,169,0
2020-06-06,South Africa,NA,Mpumalanga,4039939,12,0,181,0
2020-06-07,South Africa,NA,Mpumalanga,4039939,8,1,189,1
2020-06-08,South Africa,NA,Mpumalanga,4039939,0,0,189,1
2020-06-09,South Africa,NA,Mpumalanga,4039939,1,0,189,1
2020-06-10,South Africa,NA,Mpumalanga,4039939,23,0,207,1
2020-06-11,South Africa,NA,Mpumalanga,4039939,21,0,228,1
2020-06-12,South Africa,NA,Mpumalanga,4039939,15,0,243,1
2020-06-13,South Africa,NA,Mpumalanga,4039939,28,0,271,1
2020-06-14,South Africa,NA,Mpumalanga,4039939,26,0,297,1
2020-06-15,South Africa,NA,Mpumalanga,4039939,25,0,322,1
2020-06-16,South Africa,NA,Mpumalanga,4039939,21,0,343,1
2020-06-17,South Africa,NA,Mpumalanga,4039939,48,0,391,1
2020-06-18,South Africa,NA,Mpumalanga,4039939,70,0,461,1
2020-06-19,South Africa,NA,Mpumalanga,4039939,44,0,505,1
2020-06-20,South Africa,NA,Mpumalanga,4039939,39,0,544,1
2020-06-21,South Africa,NA,Mpumalanga,4039939,29,0,573,1
2020-06-22,South Africa,NA,Mpumalanga,4039939,23,0,596,1
2020-06-23,South Africa,NA,Mpumalanga,4039939,66,1,662,2
2020-06-24,South Africa,NA,Mpumalanga,4039939,51,0,713,2
2020-06-25,South Africa,NA,Mpumalanga,4039939,70,0,783,2
2020-06-26,South Africa,NA,Mpumalanga,4039939,72,0,855,2
2020-06-27,South Africa,NA,Mpumalanga,4039939,70,0,925,2
2020-06-28,South Africa,NA,Mpumalanga,4039939,91,0,1016,2
2020-06-29,South Africa,NA,Mpumalanga,4039939,73,1,1089,3
2020-06-30,South Africa,NA,Mpumalanga,4039939,101,4,1190,7
2020-07-01,South Africa,NA,Mpumalanga,4039939,116,0,1306,7
2020-07-02,South Africa,NA,Mpumalanga,4039939,172,0,1478,7
2020-07-03,South Africa,NA,Mpumalanga,4039939,133,0,1611,7
2020-07-04,South Africa,NA,Mpumalanga,4039939,207,0,1818,7
2020-07-05,South Africa,NA,Mpumalanga,4039939,147,0,1965,7
2020-07-06,South Africa,NA,Mpumalanga,4039939,208,0,2173,7
2020-07-07,South Africa,NA,Mpumalanga,4039939,180,0,2353,7
2020-07-08,South Africa,NA,Mpumalanga,4039939,175,15,2528,22
2020-07-09,South Africa,NA,Mpumalanga,4039939,374,0,2902,22
2020-07-10,South Africa,NA,Mpumalanga,4039939,371,0,3273,22
2020-07-11,South Africa,NA,Mpumalanga,4039939,348,0,3621,22
2020-07-12,South Africa,NA,Mpumalanga,4039939,356,0,3977,22
2020-07-13,South Africa,NA,Mpumalanga,4039939,322,11,4299,33
2020-07-14,South Africa,NA,Mpumalanga,4039939,277,0,4576,33
2020-07-15,South Africa,NA,Mpumalanga,4039939,475,0,5051,33
2020-07-16,South Africa,NA,Mpumalanga,4039939,521,7,5572,40
2020-07-17,South Africa,NA,Mpumalanga,4039939,501,4,6073,44
2020-07-18,South Africa,NA,Mpumalanga,4039939,571,0,6644,44
2020-07-19,South Africa,NA,Mpumalanga,4039939,485,0,7129,44
2020-07-20,South Africa,NA,Mpumalanga,4039939,295,8,7424,52
2020-07-21,South Africa,NA,Mpumalanga,4039939,240,0,7664,52
2020-07-22,South Africa,NA,Mpumalanga,4039939,622,0,8286,52
2020-07-23,South Africa,NA,Mpumalanga,4039939,701,0,8987,52
2020-07-24,South Africa,NA,Mpumalanga,4039939,769,0,9756,52
2020-07-25,South Africa,NA,Mpumalanga,4039939,661,0,10417,52
2020-07-26,South Africa,NA,Mpumalanga,4039939,591,0,11008,52
2020-07-27,South Africa,NA,Mpumalanga,4039939,378,13,11386,65
2020-07-28,South Africa,NA,Mpumalanga,4039939,166,0,11552,65
2020-07-29,South Africa,NA,Mpumalanga,4039939,890,0,12442,65
2020-07-30,South Africa,NA,Mpumalanga,4039939,838,0,13280,65
2020-07-31,South Africa,NA,Mpumalanga,4039939,821,13,14101,78
2020-08-01,South Africa,NA,Mpumalanga,4039939,580,0,14681,78
2020-08-02,South Africa,NA,Mpumalanga,4039939,439,0,15120,78
2020-08-03,South Africa,NA,Mpumalanga,4039939,275,45,15395,123
2020-08-04,South Africa,NA,Mpumalanga,4039939,321,0,15716,123
2020-08-05,South Africa,NA,Mpumalanga,4039939,1419,16,17135,139
2020-08-06,South Africa,NA,Mpumalanga,4039939,668,0,17803,139
2020-08-07,South Africa,NA,Mpumalanga,4039939,463,0,18266,139
2020-08-08,South Africa,NA,Mpumalanga,4039939,468,0,18734,139
2020-08-09,South Africa,NA,Mpumalanga,4039939,505,0,19239,139
2020-08-10,South Africa,NA,Mpumalanga,4039939,216,10,19455,149
2020-08-11,South Africa,NA,Mpumalanga,4039939,78,0,19533,149
2020-08-12,South Africa,NA,Mpumalanga,4039939,222,0,19755,149
2020-08-13,South Africa,NA,Mpumalanga,4039939,356,18,20111,167
2020-08-14,South Africa,NA,Mpumalanga,4039939,443,22,20554,189
2020-08-15,South Africa,NA,Mpumalanga,4039939,361,0,20915,189
2020-08-16,South Africa,NA,Mpumalanga,4039939,374,0,21289,189
2020-08-17,South Africa,NA,Mpumalanga,4039939,185,25,21474,214
2020-08-18,South Africa,NA,Mpumalanga,4039939,243,0,21717,214
2020-08-19,South Africa,NA,Mpumalanga,4039939,350,0,22067,214
2020-08-20,South Africa,NA,Mpumalanga,4039939,392,0,22459,214
2020-08-21,South Africa,NA,Mpumalanga,4039939,242,0,22701,214
2020-08-22,South Africa,NA,Mpumalanga,4039939,201,46,22902,260
2020-08-23,South Africa,NA,Mpumalanga,4039939,198,0,23100,260
2020-08-24,South Africa,NA,Mpumalanga,4039939,63,36,23163,296
2020-08-25,South Africa,NA,Mpumalanga,4039939,173,16,23336,312
2020-08-26,South Africa,NA,Mpumalanga,4039939,219,0,23555,312
2020-08-27,South Africa,NA,Mpumalanga,4039939,122,0,23677,312
2020-08-28,South Africa,NA,Mpumalanga,4039939,88,18,23765,330
2020-08-29,South Africa,NA,Mpumalanga,4039939,181,0,23946,330
2020-08-30,South Africa,NA,Mpumalanga,4039939,186,11,24132,341
2020-08-31,South Africa,NA,Mpumalanga,4039939,273,0,24405,341
2020-09-01,South Africa,NA,Mpumalanga,4039939,65,10,24470,351
2020-09-02,South Africa,NA,Mpumalanga,4039939,135,0,24605,351
2020-09-03,South Africa,NA,Mpumalanga,4039939,141,27,24746,378
2020-09-04,South Africa,NA,Mpumalanga,4039939,90,0,24836,378
2020-09-05,South Africa,NA,Mpumalanga,4039939,140,0,24976,378
2020-09-06,South Africa,NA,Mpumalanga,4039939,100,38,25076,416
2020-09-07,South Africa,NA,Mpumalanga,4039939,49,0,25125,416
2020-09-08,South Africa,NA,Mpumalanga,4039939,73,0,25198,416
2020-09-09,South Africa,NA,Mpumalanga,4039939,113,0,25311,416
2020-09-10,South Africa,NA,Mpumalanga,4039939,114,26,25425,442
2020-09-11,South Africa,NA,Mpumalanga,4039939,115,24,25540,466
2020-09-12,South Africa,NA,Mpumalanga,4039939,140,0,25680,466
2020-09-13,South Africa,NA,Mpumalanga,4039939,70,0,25750,466
2020-09-14,South Africa,NA,Mpumalanga,4039939,75,0,25825,466
2020-09-15,South Africa,NA,Mpumalanga,4039939,35,19,25860,485
2020-09-16,South Africa,NA,Mpumalanga,4039939,126,11,25986,496
2020-09-17,South Africa,NA,Mpumalanga,4039939,118,0,26104,496
2020-09-18,South Africa,NA,Mpumalanga,4039939,158,0,26262,496
2020-09-19,South Africa,NA,Mpumalanga,4039939,127,0,26389,496
2020-09-20,South Africa,NA,Mpumalanga,4039939,90,0,26479,496
2020-09-21,South Africa,NA,Mpumalanga,4039939,46,0,26525,496
2020-09-22,South Africa,NA,Mpumalanga,4039939,87,0,26612,496
2020-09-23,South Africa,NA,Mpumalanga,4039939,100,13,26712,509
2020-04-04,South Africa,NA,North West,3509953,2,0,11,0
2020-04-05,South Africa,NA,North West,3509953,0,0,11,0
2020-04-06,South Africa,NA,North West,3509953,0,0,11,0
2020-04-08,South Africa,NA,North West,3509953,4,0,15,0
2020-04-09,South Africa,NA,North West,3509953,0,0,15,0
2020-04-10,South Africa,NA,North West,3509953,3,0,18,0
2020-04-11,South Africa,NA,North West,3509953,1,0,19,0
2020-04-12,South Africa,NA,North West,3509953,0,0,19,0
2020-04-13,South Africa,NA,North West,3509953,3,0,22,0
2020-04-14,South Africa,NA,North West,3509953,0,0,22,0
2020-04-15,South Africa,NA,North West,3509953,1,0,23,0
2020-04-16,South Africa,NA,North West,3509953,1,0,24,0
2020-04-17,South Africa,NA,North West,3509953,0,0,24,0
2020-04-18,South Africa,NA,North West,3509953,0,0,24,0
2020-04-19,South Africa,NA,North West,3509953,0,0,24,0
2020-04-20,South Africa,NA,North West,3509953,1,0,25,0
2020-04-21,South Africa,NA,North West,3509953,0,0,25,0
2020-04-22,South Africa,NA,North West,3509953,0,0,25,0
2020-04-23,South Africa,NA,North West,3509953,1,0,25,0
2020-04-24,South Africa,NA,North West,3509953,0,0,25,0
2020-04-25,South Africa,NA,North West,3509953,3,0,28,0
2020-04-26,South Africa,NA,North West,3509953,0,0,28,0
2020-04-27,South Africa,NA,North West,3509953,3,0,31,0
2020-04-28,South Africa,NA,North West,3509953,0,0,31,0
2020-04-29,South Africa,NA,North West,3509953,0,0,31,0
2020-04-30,South Africa,NA,North West,3509953,2,0,31,0
2020-05-01,South Africa,NA,North West,3509953,4,0,35,0
2020-05-02,South Africa,NA,North West,3509953,0,0,35,0
2020-05-03,South Africa,NA,North West,3509953,1,0,36,0
2020-05-04,South Africa,NA,North West,3509953,0,0,36,0
2020-05-05,South Africa,NA,North West,3509953,0,0,36,0
2020-05-06,South Africa,NA,North West,3509953,2,0,37,0
2020-05-07,South Africa,NA,North West,3509953,3,0,40,0
2020-05-08,South Africa,NA,North West,3509953,2,0,42,0
2020-05-09,South Africa,NA,North West,3509953,0,0,42,0
2020-05-10,South Africa,NA,North West,3509953,4,0,45,0
2020-05-11,South Africa,NA,North West,3509953,5,1,50,1
2020-05-12,South Africa,NA,North West,3509953,1,0,51,1
2020-05-13,South Africa,NA,North West,3509953,1,0,52,1
2020-05-14,South Africa,NA,North West,3509953,6,0,58,1
2020-05-15,South Africa,NA,North West,3509953,5,0,63,1
2020-05-16,South Africa,NA,North West,3509953,1,0,64,1
2020-05-17,South Africa,NA,North West,3509953,6,0,70,1
2020-05-18,South Africa,NA,North West,3509953,2,0,72,1
2020-05-19,South Africa,NA,North West,3509953,0,0,72,1
2020-05-20,South Africa,NA,North West,3509953,0,0,72,1
2020-05-21,South Africa,NA,North West,3509953,5,0,77,1
2020-05-22,South Africa,NA,North West,3509953,3,0,80,1
2020-05-23,South Africa,NA,North West,3509953,1,0,81,1
2020-05-24,South Africa,NA,North West,3509953,13,0,94,1
2020-05-25,South Africa,NA,North West,3509953,15,0,109,1
2020-05-26,South Africa,NA,North West,3509953,6,0,115,1
2020-05-27,South Africa,NA,North West,3509953,13,0,128,1
2020-05-28,South Africa,NA,North West,3509953,6,0,134,1
2020-05-29,South Africa,NA,North West,3509953,9,0,143,1
2020-05-30,South Africa,NA,North West,3509953,19,0,162,1
2020-05-31,South Africa,NA,North West,3509953,13,0,175,1
2020-06-01,South Africa,NA,North West,3509953,12,0,187,1
2020-06-02,South Africa,NA,North West,3509953,84,0,271,1
2020-06-03,South Africa,NA,North West,3509953,43,0,314,1
2020-06-04,South Africa,NA,North West,3509953,50,0,364,1
2020-06-05,South Africa,NA,North West,3509953,45,0,409,1
2020-06-06,South Africa,NA,North West,3509953,59,0,468,1
2020-06-07,South Africa,NA,North West,3509953,55,0,523,1
2020-06-08,South Africa,NA,North West,3509953,57,0,580,1
2020-06-09,South Africa,NA,North West,3509953,25,0,605,1
2020-06-10,South Africa,NA,North West,3509953,52,0,657,1
2020-06-11,South Africa,NA,North West,3509953,100,4,757,5
2020-06-12,South Africa,NA,North West,3509953,108,0,865,5
2020-06-13,South Africa,NA,North West,3509953,112,0,977,5
2020-06-14,South Africa,NA,North West,3509953,120,0,1097,5
2020-06-15,South Africa,NA,North West,3509953,80,0,1177,5
2020-06-16,South Africa,NA,North West,3509953,104,0,1281,5
2020-06-17,South Africa,NA,North West,3509953,121,0,1402,5
2020-06-18,South Africa,NA,North West,3509953,204,0,1606,5
2020-06-19,South Africa,NA,North West,3509953,152,0,1758,5
2020-06-20,South Africa,NA,North West,3509953,199,0,1957,5
2020-06-21,South Africa,NA,North West,3509953,191,0,2148,5
2020-06-22,South Africa,NA,North West,3509953,167,0,2315,5
2020-06-23,South Africa,NA,North West,3509953,139,0,2454,5
2020-06-24,South Africa,NA,North West,3509953,164,0,2618,5
2020-06-25,South Africa,NA,North West,3509953,347,0,2965,5
2020-06-26,South Africa,NA,North West,3509953,253,0,3218,5
2020-06-27,South Africa,NA,North West,3509953,236,0,3454,5
2020-06-28,South Africa,NA,North West,3509953,193,0,3647,5
2020-06-29,South Africa,NA,North West,3509953,284,2,3931,7
2020-06-30,South Africa,NA,North West,3509953,256,0,4187,7
2020-07-01,South Africa,NA,North West,3509953,206,0,4393,7
2020-07-02,South Africa,NA,North West,3509953,395,0,4788,7
2020-07-03,South Africa,NA,North West,3509953,380,29,5168,36
2020-07-04,South Africa,NA,North West,3509953,476,0,5644,36
2020-07-05,South Africa,NA,North West,3509953,419,0,6063,36
2020-07-06,South Africa,NA,North West,3509953,347,0,6410,36
2020-07-07,South Africa,NA,North West,3509953,432,0,6842,36
2020-07-08,South Africa,NA,North West,3509953,305,0,7147,36
2020-07-09,South Africa,NA,North West,3509953,723,0,7870,36
2020-07-10,South Africa,NA,North West,3509953,806,0,8676,36
2020-07-11,South Africa,NA,North West,3509953,742,0,9418,36
2020-07-12,South Africa,NA,North West,3509953,506,0,9924,36
2020-07-13,South Africa,NA,North West,3509953,601,0,10525,36
2020-07-14,South Africa,NA,North West,3509953,259,0,10784,36
2020-07-15,South Africa,NA,North West,3509953,441,12,11225,48
2020-07-16,South Africa,NA,North West,3509953,666,0,11891,48
2020-07-17,South Africa,NA,North West,3509953,831,0,12722,48
2020-07-18,South Africa,NA,North West,3509953,678,0,13400,48
2020-07-19,South Africa,NA,North West,3509953,606,0,14006,48
2020-07-20,South Africa,NA,North West,3509953,331,0,14337,48
2020-07-21,South Africa,NA,North West,3509953,297,0,14634,48
2020-07-22,South Africa,NA,North West,3509953,439,0,15073,48
2020-07-23,South Africa,NA,North West,3509953,828,0,15901,48
2020-07-24,South Africa,NA,North West,3509953,647,0,16548,48
2020-07-25,South Africa,NA,North West,3509953,394,0,16942,48
2020-07-26,South Africa,NA,North West,3509953,396,0,17338,48
2020-07-27,South Africa,NA,North West,3509953,266,11,17604,59
2020-07-28,South Africa,NA,North West,3509953,187,13,17791,72
2020-07-29,South Africa,NA,North West,3509953,440,0,18231,72
2020-07-30,South Africa,NA,North West,3509953,580,9,18811,81
2020-07-31,South Africa,NA,North West,3509953,514,0,19325,81
2020-08-01,South Africa,NA,North West,3509953,389,0,19714,81
2020-08-02,South Africa,NA,North West,3509953,247,0,19961,81
2020-08-03,South Africa,NA,North West,3509953,188,28,20149,109
2020-08-04,South Africa,NA,North West,3509953,121,0,20270,109
2020-08-05,South Africa,NA,North West,3509953,416,0,20686,109
2020-08-06,South Africa,NA,North West,3509953,358,0,21044,109
2020-08-07,South Africa,NA,North West,3509953,271,0,21315,109
2020-08-08,South Africa,NA,North West,3509953,327,21,21642,130
2020-08-09,South Africa,NA,North West,3509953,195,0,21837,130
2020-08-10,South Africa,NA,North West,3509953,96,0,21933,130
2020-08-11,South Africa,NA,North West,3509953,98,20,22031,150
2020-08-12,South Africa,NA,North West,3509953,174,0,22205,150
2020-08-13,South Africa,NA,North West,3509953,278,0,22483,150
2020-08-14,South Africa,NA,North West,3509953,333,26,22816,176
2020-08-15,South Africa,NA,North West,3509953,277,0,23093,176
2020-08-16,South Africa,NA,North West,3509953,157,18,23250,194
2020-08-17,South Africa,NA,North West,3509953,55,0,23305,194
2020-08-18,South Africa,NA,North West,3509953,140,20,23445,214
2020-08-19,South Africa,NA,North West,3509953,196,0,23641,214
2020-08-20,South Africa,NA,North West,3509953,227,0,23868,214
2020-08-21,South Africa,NA,North West,3509953,135,10,24003,224
2020-08-22,South Africa,NA,North West,3509953,182,0,24185,224
2020-08-23,South Africa,NA,North West,3509953,116,0,24301,224
2020-08-24,South Africa,NA,North West,3509953,70,0,24371,224
2020-08-25,South Africa,NA,North West,3509953,74,0,24445,224
2020-08-26,South Africa,NA,North West,3509953,201,0,24646,224
2020-08-27,South Africa,NA,North West,3509953,159,0,24805,224
2020-08-28,South Africa,NA,North West,3509953,117,16,24922,240
2020-08-29,South Africa,NA,North West,3509953,164,0,25086,240
2020-08-30,South Africa,NA,North West,3509953,154,0,25240,240
2020-08-31,South Africa,NA,North West,3509953,108,8,25348,248
2020-09-01,South Africa,NA,North West,3509953,42,18,25390,266
2020-09-02,South Africa,NA,North West,3509953,214,0,25604,266
2020-09-03,South Africa,NA,North West,3509953,212,9,25816,275
2020-09-04,South Africa,NA,North West,3509953,149,0,25965,275
2020-09-05,South Africa,NA,North West,3509953,127,0,26092,275
2020-09-06,South Africa,NA,North West,3509953,153,0,26245,275
2020-09-07,South Africa,NA,North West,3509953,49,10,26294,285
2020-09-08,South Africa,NA,North West,3509953,105,0,26399,285
2020-09-09,South Africa,NA,North West,3509953,181,10,26580,295
2020-09-10,South Africa,NA,North West,3509953,187,15,26767,310
2020-09-11,South Africa,NA,North West,3509953,168,0,26935,310
2020-09-12,South Africa,NA,North West,3509953,159,0,27094,310
2020-09-13,South Africa,NA,North West,3509953,125,0,27219,310
2020-09-14,South Africa,NA,North West,3509953,43,15,27262,325
2020-09-15,South Africa,NA,North West,3509953,59,0,27321,325
2020-09-16,South Africa,NA,North West,3509953,206,0,27527,325
2020-09-17,South Africa,NA,North West,3509953,194,0,27721,325
2020-09-18,South Africa,NA,North West,3509953,135,0,27856,325
2020-09-19,South Africa,NA,North West,3509953,169,0,28025,325
2020-09-20,South Africa,NA,North West,3509953,146,0,28171,325
2020-09-21,South Africa,NA,North West,3509953,16,16,28187,341
2020-09-22,South Africa,NA,North West,3509953,144,0,28331,341
2020-09-23,South Africa,NA,North West,3509953,197,9,28528,350
2020-04-08,South Africa,NA,Northern Cape,1145861,5,0,13,0
2020-04-09,South Africa,NA,Northern Cape,1145861,2,0,15,0
2020-04-10,South Africa,NA,Northern Cape,1145861,0,0,15,0
2020-04-11,South Africa,NA,Northern Cape,1145861,1,0,16,0
2020-04-12,South Africa,NA,Northern Cape,1145861,0,0,16,0
2020-04-13,South Africa,NA,Northern Cape,1145861,0,0,16,0
2020-04-14,South Africa,NA,Northern Cape,1145861,0,0,16,0
2020-04-15,South Africa,NA,Northern Cape,1145861,0,0,16,0
2020-04-16,South Africa,NA,Northern Cape,1145861,0,0,16,0
2020-04-17,South Africa,NA,Northern Cape,1145861,0,0,16,0
2020-04-18,South Africa,NA,Northern Cape,1145861,0,0,16,0
2020-04-19,South Africa,NA,Northern Cape,1145861,0,0,16,0
2020-04-20,South Africa,NA,Northern Cape,1145861,2,0,18,0
2020-04-21,South Africa,NA,Northern Cape,1145861,0,0,18,0
2020-04-22,South Africa,NA,Northern Cape,1145861,0,0,18,0
2020-04-23,South Africa,NA,Northern Cape,1145861,0,0,18,0
2020-04-24,South Africa,NA,Northern Cape,1145861,0,0,18,0
2020-04-25,South Africa,NA,Northern Cape,1145861,0,0,18,0
2020-04-26,South Africa,NA,Northern Cape,1145861,1,0,18,0
2020-04-27,South Africa,NA,Northern Cape,1145861,0,0,18,0
2020-04-28,South Africa,NA,Northern Cape,1145861,0,0,18,0
2020-04-29,South Africa,NA,Northern Cape,1145861,0,0,18,0
2020-04-30,South Africa,NA,Northern Cape,1145861,0,0,18,0
2020-05-01,South Africa,NA,Northern Cape,1145861,0,0,18,0
2020-05-02,South Africa,NA,Northern Cape,1145861,1,0,18,0
2020-05-03,South Africa,NA,Northern Cape,1145861,0,0,24,0
2020-05-04,South Africa,NA,Northern Cape,1145861,7,0,25,0
2020-05-05,South Africa,NA,Northern Cape,1145861,1,0,26,0
2020-05-06,South Africa,NA,Northern Cape,1145861,0,0,26,0
2020-05-07,South Africa,NA,Northern Cape,1145861,0,0,27,0
2020-05-08,South Africa,NA,Northern Cape,1145861,1,0,27,0
2020-05-09,South Africa,NA,Northern Cape,1145861,1,0,28,0
2020-05-10,South Africa,NA,Northern Cape,1145861,1,0,29,0
2020-05-11,South Africa,NA,Northern Cape,1145861,1,0,30,0
2020-05-12,South Africa,NA,Northern Cape,1145861,0,0,30,0
2020-05-13,South Africa,NA,Northern Cape,1145861,0,0,30,0
2020-05-14,South Africa,NA,Northern Cape,1145861,1,0,31,0
2020-05-15,South Africa,NA,Northern Cape,1145861,3,0,34,0
2020-05-16,South Africa,NA,Northern Cape,1145861,1,0,35,0
2020-05-17,South Africa,NA,Northern Cape,1145861,2,0,37,0
2020-05-18,South Africa,NA,Northern Cape,1145861,0,0,37,0
2020-05-19,South Africa,NA,Northern Cape,1145861,0,1,37,1
2020-05-20,South Africa,NA,Northern Cape,1145861,1,0,38,1
2020-05-21,South Africa,NA,Northern Cape,1145861,0,0,38,1
2020-05-22,South Africa,NA,Northern Cape,1145861,2,0,39,1
2020-05-23,South Africa,NA,Northern Cape,1145861,1,0,40,1
2020-05-24,South Africa,NA,Northern Cape,1145861,0,0,40,1
2020-05-25,South Africa,NA,Northern Cape,1145861,5,0,45,1
2020-05-26,South Africa,NA,Northern Cape,1145861,0,0,45,1
2020-05-27,South Africa,NA,Northern Cape,1145861,3,0,48,1
2020-05-28,South Africa,NA,Northern Cape,1145861,3,0,51,1
2020-05-29,South Africa,NA,Northern Cape,1145861,1,0,52,1
2020-05-30,South Africa,NA,Northern Cape,1145861,5,0,57,1
2020-05-31,South Africa,NA,Northern Cape,1145861,12,0,69,1
2020-06-01,South Africa,NA,Northern Cape,1145861,13,0,82,1
2020-06-02,South Africa,NA,Northern Cape,1145861,9,0,91,1
2020-06-03,South Africa,NA,Northern Cape,1145861,2,0,93,1
2020-06-04,South Africa,NA,Northern Cape,1145861,2,0,95,1
2020-06-05,South Africa,NA,Northern Cape,1145861,7,0,102,1
2020-06-06,South Africa,NA,Northern Cape,1145861,3,0,105,1
2020-06-07,South Africa,NA,Northern Cape,1145861,9,0,114,1
2020-06-08,South Africa,NA,Northern Cape,1145861,4,0,118,1
2020-06-09,South Africa,NA,Northern Cape,1145861,4,0,122,1
2020-06-10,South Africa,NA,Northern Cape,1145861,3,0,125,1
2020-06-11,South Africa,NA,Northern Cape,1145861,7,0,132,1
2020-06-12,South Africa,NA,Northern Cape,1145861,6,0,138,1
2020-06-13,South Africa,NA,Northern Cape,1145861,6,0,144,1
2020-06-14,South Africa,NA,Northern Cape,1145861,12,0,156,1
2020-06-15,South Africa,NA,Northern Cape,1145861,49,0,205,1
2020-06-16,South Africa,NA,Northern Cape,1145861,6,0,211,1
2020-06-17,South Africa,NA,Northern Cape,1145861,0,0,211,1
2020-06-18,South Africa,NA,Northern Cape,1145861,3,0,214,1
2020-06-19,South Africa,NA,Northern Cape,1145861,4,0,218,1
2020-06-20,South Africa,NA,Northern Cape,1145861,14,0,232,1
2020-06-21,South Africa,NA,Northern Cape,1145861,5,0,237,1
2020-06-22,South Africa,NA,Northern Cape,1145861,17,0,254,1
2020-06-23,South Africa,NA,Northern Cape,1145861,16,0,270,1
2020-06-24,South Africa,NA,Northern Cape,1145861,29,0,299,1
2020-06-25,South Africa,NA,Northern Cape,1145861,19,0,318,1
2020-06-26,South Africa,NA,Northern Cape,1145861,19,0,337,1
2020-06-27,South Africa,NA,Northern Cape,1145861,18,0,355,1
2020-06-28,South Africa,NA,Northern Cape,1145861,30,0,385,1
2020-06-29,South Africa,NA,Northern Cape,1145861,19,0,404,1
2020-06-30,South Africa,NA,Northern Cape,1145861,61,0,465,1
2020-07-01,South Africa,NA,Northern Cape,1145861,29,0,494,1
2020-07-02,South Africa,NA,Northern Cape,1145861,79,0,573,1
2020-07-03,South Africa,NA,Northern Cape,1145861,53,3,626,4
2020-07-04,South Africa,NA,Northern Cape,1145861,60,0,686,4
2020-07-05,South Africa,NA,Northern Cape,1145861,48,2,734,6
2020-07-06,South Africa,NA,Northern Cape,1145861,86,0,820,6
2020-07-07,South Africa,NA,Northern Cape,1145861,68,0,888,6
2020-07-08,South Africa,NA,Northern Cape,1145861,86,0,974,6
2020-07-09,South Africa,NA,Northern Cape,1145861,65,1,1039,7
2020-07-10,South Africa,NA,Northern Cape,1145861,129,0,1168,7
2020-07-11,South Africa,NA,Northern Cape,1145861,98,4,1266,11
2020-07-12,South Africa,NA,Northern Cape,1145861,135,0,1401,11
2020-07-13,South Africa,NA,Northern Cape,1145861,121,0,1522,11
2020-07-14,South Africa,NA,Northern Cape,1145861,57,4,1579,15
2020-07-15,South Africa,NA,Northern Cape,1145861,88,0,1667,15
2020-07-16,South Africa,NA,Northern Cape,1145861,164,0,1831,15
2020-07-17,South Africa,NA,Northern Cape,1145861,213,0,2044,15
2020-07-18,South Africa,NA,Northern Cape,1145861,153,0,2197,15
2020-07-19,South Africa,NA,Northern Cape,1145861,69,0,2266,15
2020-07-20,South Africa,NA,Northern Cape,1145861,85,0,2351,15
2020-07-21,South Africa,NA,Northern Cape,1145861,188,0,2539,15
2020-07-22,South Africa,NA,Northern Cape,1145861,188,0,2727,15
2020-07-23,South Africa,NA,Northern Cape,1145861,243,8,2970,23
2020-07-24,South Africa,NA,Northern Cape,1145861,205,0,3175,23
2020-07-25,South Africa,NA,Northern Cape,1145861,214,4,3389,27
2020-07-26,South Africa,NA,Northern Cape,1145861,211,2,3600,29
2020-07-27,South Africa,NA,Northern Cape,1145861,275,0,3875,29
2020-07-28,South Africa,NA,Northern Cape,1145861,122,0,3997,29
2020-07-29,South Africa,NA,Northern Cape,1145861,138,0,4135,29
2020-07-30,South Africa,NA,Northern Cape,1145861,267,0,4402,29
2020-07-31,South Africa,NA,Northern Cape,1145861,339,0,4741,29
2020-08-01,South Africa,NA,Northern Cape,1145861,220,7,4961,36
2020-08-02,South Africa,NA,Northern Cape,1145861,170,0,5131,36
2020-08-03,South Africa,NA,Northern Cape,1145861,171,0,5302,36
2020-08-04,South Africa,NA,Northern Cape,1145861,77,0,5379,36
2020-08-05,South Africa,NA,Northern Cape,1145861,259,0,5638,36
2020-08-06,South Africa,NA,Northern Cape,1145861,294,18,5932,54
2020-08-07,South Africa,NA,Northern Cape,1145861,253,7,6185,61
2020-08-08,South Africa,NA,Northern Cape,1145861,181,5,6366,66
2020-08-09,South Africa,NA,Northern Cape,1145861,255,0,6621,66
2020-08-10,South Africa,NA,Northern Cape,1145861,181,2,6802,68
2020-08-11,South Africa,NA,Northern Cape,1145861,59,0,6861,68
2020-08-12,South Africa,NA,Northern Cape,1145861,96,0,6957,68
2020-08-13,South Africa,NA,Northern Cape,1145861,165,8,7122,76
2020-08-14,South Africa,NA,Northern Cape,1145861,321,18,7443,94
2020-08-15,South Africa,NA,Northern Cape,1145861,294,0,7737,94
2020-08-16,South Africa,NA,Northern Cape,1145861,103,0,7840,94
2020-08-17,South Africa,NA,Northern Cape,1145861,181,3,8021,97
2020-08-18,South Africa,NA,Northern Cape,1145861,108,3,8129,100
2020-08-19,South Africa,NA,Northern Cape,1145861,212,0,8341,100
2020-08-20,South Africa,NA,Northern Cape,1145861,234,0,8575,100
2020-08-21,South Africa,NA,Northern Cape,1145861,243,6,8818,106
2020-08-22,South Africa,NA,Northern Cape,1145861,178,0,8996,106
2020-08-23,South Africa,NA,Northern Cape,1145861,133,0,9129,106
2020-08-24,South Africa,NA,Northern Cape,1145861,193,0,9322,106
2020-08-25,South Africa,NA,Northern Cape,1145861,53,10,9375,116
2020-08-26,South Africa,NA,Northern Cape,1145861,0,0,9500,120
2020-08-27,South Africa,NA,Northern Cape,1145861,329,0,9829,120
2020-08-28,South Africa,NA,Northern Cape,1145861,214,0,10043,120
2020-08-29,South Africa,NA,Northern Cape,1145861,241,0,10284,120
2020-08-30,South Africa,NA,Northern Cape,1145861,284,0,10568,120
2020-08-31,South Africa,NA,Northern Cape,1145861,158,9,10726,129
2020-09-01,South Africa,NA,Northern Cape,1145861,111,0,10837,129
2020-09-02,South Africa,NA,Northern Cape,1145861,183,5,11020,134
2020-09-03,South Africa,NA,Northern Cape,1145861,293,0,11313,134
2020-09-04,South Africa,NA,Northern Cape,1145861,208,11,11521,145
2020-09-05,South Africa,NA,Northern Cape,1145861,197,0,11718,145
2020-09-06,South Africa,NA,Northern Cape,1145861,205,0,11923,145
2020-09-07,South Africa,NA,Northern Cape,1145861,162,0,12085,145
2020-09-08,South Africa,NA,Northern Cape,1145861,137,5,12222,150
2020-09-09,South Africa,NA,Northern Cape,1145861,185,0,12407,150
2020-09-10,South Africa,NA,Northern Cape,1145861,223,0,12630,150
2020-09-11,South Africa,NA,Northern Cape,1145861,289,15,12919,165
2020-09-12,South Africa,NA,Northern Cape,1145861,204,0,13123,165
2020-09-13,South Africa,NA,Northern Cape,1145861,268,0,13391,165
2020-09-14,South Africa,NA,Northern Cape,1145861,173,0,13564,165
2020-09-15,South Africa,NA,Northern Cape,1145861,52,11,13616,176
2020-09-16,South Africa,NA,Northern Cape,1145861,111,6,13727,182
2020-09-17,South Africa,NA,Northern Cape,1145861,276,0,14003,182
2020-09-18,South Africa,NA,Northern Cape,1145861,373,2,14376,184
2020-09-19,South Africa,NA,Northern Cape,1145861,355,0,14731,184
2020-09-20,South Africa,NA,Northern Cape,1145861,306,0,15037,184
2020-09-21,South Africa,NA,Northern Cape,1145861,126,0,15163,184
2020-09-22,South Africa,NA,Northern Cape,1145861,117,5,15280,189
2020-09-23,South Africa,NA,Northern Cape,1145861,280,0,15560,189
2020-03-15,South Africa,NA,Western Cape,7005741,5,0,14,0
2020-03-16,South Africa,NA,Western Cape,7005741,2,0,16,0
2020-03-17,South Africa,NA,Western Cape,7005741,5,0,21,0
2020-03-18,South Africa,NA,Western Cape,7005741,10,0,31,0
2020-03-19,South Africa,NA,Western Cape,7005741,15,0,46,0
2020-03-20,South Africa,NA,Western Cape,7005741,11,0,57,0
2020-03-21,South Africa,NA,Western Cape,7005741,18,0,75,0
2020-03-22,South Africa,NA,Western Cape,7005741,14,0,89,0
2020-03-23,South Africa,NA,Western Cape,7005741,11,0,100,0
2020-03-24,South Africa,NA,Western Cape,7005741,13,0,113,0
2020-03-25,South Africa,NA,Western Cape,7005741,70,0,183,0
2020-03-26,South Africa,NA,Western Cape,7005741,46,0,229,0
2020-03-28,South Africa,NA,Western Cape,7005741,42,0,271,1
2020-03-29,South Africa,NA,Western Cape,7005741,39,0,310,1
2020-03-30,South Africa,NA,Western Cape,7005741,14,0,324,1
2020-03-31,South Africa,NA,Western Cape,7005741,1,0,325,1
2020-04-01,South Africa,NA,Western Cape,7005741,1,0,326,1
2020-04-02,South Africa,NA,Western Cape,7005741,27,0,353,1
2020-04-03,South Africa,NA,Western Cape,7005741,21,0,374,1
2020-04-04,South Africa,NA,Western Cape,7005741,59,0,433,1
2020-04-05,South Africa,NA,Western Cape,7005741,21,1,454,2
2020-04-06,South Africa,NA,Western Cape,7005741,8,1,462,3
2020-04-08,South Africa,NA,Western Cape,7005741,33,0,495,3
2020-04-09,South Africa,NA,Western Cape,7005741,20,0,515,3
2020-04-10,South Africa,NA,Western Cape,7005741,26,3,541,6
2020-04-11,South Africa,NA,Western Cape,7005741,5,1,546,7
2020-04-12,South Africa,NA,Western Cape,7005741,41,0,587,7
2020-04-13,South Africa,NA,Western Cape,7005741,30,1,617,8
2020-04-14,South Africa,NA,Western Cape,7005741,26,0,643,8
2020-04-15,South Africa,NA,Western Cape,7005741,14,0,657,8
2020-04-16,South Africa,NA,Western Cape,7005741,18,5,675,13
2020-04-17,South Africa,NA,Western Cape,7005741,42,2,717,15
2020-04-18,South Africa,NA,Western Cape,7005741,119,1,836,16
2020-04-19,South Africa,NA,Western Cape,7005741,32,1,868,17
2020-04-20,South Africa,NA,Western Cape,7005741,72,0,940,17
2020-04-21,South Africa,NA,Western Cape,7005741,70,0,1010,17
2020-04-22,South Africa,NA,Western Cape,7005741,69,5,1079,22
2020-04-23,South Africa,NA,Western Cape,7005741,200,6,1279,28
2020-04-24,South Africa,NA,Western Cape,7005741,134,2,1413,30
2020-04-25,South Africa,NA,Western Cape,7005741,101,2,1514,32
2020-04-26,South Africa,NA,Western Cape,7005741,94,1,1608,33
2020-04-27,South Africa,NA,Western Cape,7005741,129,2,1737,35
2020-04-28,South Africa,NA,Western Cape,7005741,133,3,1870,38
2020-04-29,South Africa,NA,Western Cape,7005741,265,4,2135,42
2020-04-30,South Africa,NA,Western Cape,7005741,207,0,2342,42
2020-05-01,South Africa,NA,Western Cape,7005741,165,13,2507,55
2020-05-02,South Africa,NA,Western Cape,7005741,193,1,2700,56
2020-05-03,South Africa,NA,Western Cape,7005741,344,2,3044,58
2020-05-04,South Africa,NA,Western Cape,7005741,318,6,3362,64
2020-05-05,South Africa,NA,Western Cape,7005741,247,7,3609,71
2020-05-06,South Africa,NA,Western Cape,7005741,151,2,3760,73
2020-05-07,South Africa,NA,Western Cape,7005741,234,6,3994,79
2020-05-08,South Africa,NA,Western Cape,7005741,503,9,4497,88
2020-05-09,South Africa,NA,Western Cape,7005741,312,7,4809,95
2020-05-10,South Africa,NA,Western Cape,7005741,359,3,5168,98
2020-05-11,South Africa,NA,Western Cape,7005741,453,8,5621,106
2020-05-12,South Africa,NA,Western Cape,7005741,484,0,6105,106
2020-05-13,South Africa,NA,Western Cape,7005741,608,11,6713,117
2020-05-14,South Africa,NA,Western Cape,7005741,522,12,7235,129
2020-05-15,South Africa,NA,Western Cape,7005741,563,8,7798,137
2020-05-16,South Africa,NA,Western Cape,7005741,606,12,8404,149
2020-05-17,South Africa,NA,Western Cape,7005741,890,0,9294,149
2020-05-18,South Africa,NA,Western Cape,7005741,741,17,10035,166
2020-05-19,South Africa,NA,Western Cape,7005741,604,21,10639,187
2020-05-20,South Africa,NA,Western Cape,7005741,623,23,11262,210
2020-05-21,South Africa,NA,Western Cape,7005741,891,25,12153,235
2020-05-22,South Africa,NA,Western Cape,7005741,735,22,12888,257
2020-05-23,South Africa,NA,Western Cape,7005741,938,4,13826,261
2020-05-24,South Africa,NA,Western Cape,7005741,914,20,14740,281
2020-05-25,South Africa,NA,Western Cape,7005741,656,49,15396,330
2020-05-26,South Africa,NA,Western Cape,7005741,433,33,15829,363
2020-05-27,South Africa,NA,Western Cape,7005741,1064,28,16893,391
2020-05-28,South Africa,NA,Western Cape,7005741,861,15,17754,406
2020-05-29,South Africa,NA,Western Cape,7005741,1152,31,18906,437
2020-05-30,South Africa,NA,Western Cape,7005741,1254,28,20160,465
2020-05-31,South Africa,NA,Western Cape,7005741,1222,38,21382,503
2020-06-01,South Africa,NA,Western Cape,7005741,1185,22,22567,525
2020-06-02,South Africa,NA,Western Cape,7005741,1016,43,23583,568
2020-06-03,South Africa,NA,Western Cape,7005741,1074,29,24657,597
2020-06-04,South Africa,NA,Western Cape,7005741,2349,54,27006,651
2020-06-05,South Africa,NA,Western Cape,7005741,1801,53,28807,704
2020-06-06,South Africa,NA,Western Cape,7005741,1572,25,30379,729
2020-06-07,South Africa,NA,Western Cape,7005741,1445,45,31824,774
2020-06-08,South Africa,NA,Western Cape,7005741,1744,55,33568,829
2020-06-09,South Africa,NA,Western Cape,7005741,1251,61,34819,890
2020-06-10,South Africa,NA,Western Cape,7005741,1202,37,36021,927
2020-06-11,South Africa,NA,Western Cape,7005741,1401,39,37422,966
2020-06-12,South Africa,NA,Western Cape,7005741,1504,39,38926,1005
2020-06-13,South Africa,NA,Western Cape,7005741,1679,36,40605,1041
2020-06-14,South Africa,NA,Western Cape,7005741,1934,42,42539,1083
2020-06-15,South Africa,NA,Western Cape,7005741,1604,73,44143,1156
2020-06-16,South Africa,NA,Western Cape,7005741,1214,44,45357,1200
2020-06-17,South Africa,NA,Western Cape,7005741,1198,43,46555,1243
2020-06-18,South Africa,NA,Western Cape,7005741,967,57,47522,1300
2020-06-19,South Africa,NA,Western Cape,7005741,1184,60,48706,1360
2020-06-20,South Africa,NA,Western Cape,7005741,1467,32,50173,1392
2020-06-21,South Africa,NA,Western Cape,7005741,1268,27,51441,1419
2020-06-22,South Africa,NA,Western Cape,7005741,1113,39,52554,1458
2020-06-23,South Africa,NA,Western Cape,7005741,958,78,53512,1536
2020-06-24,South Africa,NA,Western Cape,7005741,1650,63,55162,1599
2020-06-25,South Africa,NA,Western Cape,7005741,1618,53,56780,1652
2020-06-26,South Africa,NA,Western Cape,7005741,1161,40,57941,1692
2020-06-27,South Africa,NA,Western Cape,7005741,1374,40,59315,1732
2020-06-28,South Africa,NA,Western Cape,7005741,1130,32,60445,1764
2020-06-29,South Africa,NA,Western Cape,7005741,930,43,61375,1807
2020-06-30,South Africa,NA,Western Cape,7005741,1106,52,62481,1859
2020-07-01,South Africa,NA,Western Cape,7005741,1896,37,64377,1896
2020-07-02,South Africa,NA,Western Cape,7005741,1464,29,65841,1925
2020-07-03,South Africa,NA,Western Cape,7005741,1095,58,66936,1983
2020-07-04,South Africa,NA,Western Cape,7005741,1440,43,68376,2026
2020-07-05,South Africa,NA,Western Cape,7005741,1155,40,69531,2066
2020-07-06,South Africa,NA,Western Cape,7005741,1407,35,70938,2101
2020-07-07,South Africa,NA,Western Cape,7005741,1218,44,72156,2145
2020-07-08,South Africa,NA,Western Cape,7005741,1136,47,73292,2192
2020-07-09,South Africa,NA,Western Cape,7005741,1523,37,74815,2229
2020-07-10,South Africa,NA,Western Cape,7005741,1252,66,76067,2295
2020-07-11,South Africa,NA,Western Cape,7005741,1269,38,77336,2333
2020-07-12,South Africa,NA,Western Cape,7005741,1063,15,78399,2348
2020-07-13,South Africa,NA,Western Cape,7005741,945,37,79344,2385
2020-07-14,South Africa,NA,Western Cape,7005741,855,44,80199,2429
2020-07-15,South Africa,NA,Western Cape,7005741,1357,38,81556,2467
2020-07-16,South Africa,NA,Western Cape,7005741,1430,47,82986,2514
2020-07-17,South Africa,NA,Western Cape,7005741,1268,36,84254,2550
2020-07-18,South Africa,NA,Western Cape,7005741,1157,43,85411,2593
2020-07-19,South Africa,NA,Western Cape,7005741,515,26,85926,2619
2020-07-20,South Africa,NA,Western Cape,7005741,0,50,85926,2669
2020-07-21,South Africa,NA,Western Cape,7005741,557,48,86329,2717
2020-07-22,South Africa,NA,Western Cape,7005741,1518,35,87847,2752
2020-07-23,South Africa,NA,Western Cape,7005741,1081,28,88928,2780
2020-07-24,South Africa,NA,Western Cape,7005741,1083,47,90011,2827
2020-07-25,South Africa,NA,Western Cape,7005741,1022,18,91033,2845
2020-07-26,South Africa,NA,Western Cape,7005741,1046,30,92079,2875
2020-07-27,South Africa,NA,Western Cape,7005741,521,36,92600,2911
2020-07-28,South Africa,NA,Western Cape,7005741,383,49,92983,2960
2020-07-29,South Africa,NA,Western Cape,7005741,754,23,93737,2983
2020-07-30,South Africa,NA,Western Cape,7005741,703,34,94440,3017
2020-07-31,South Africa,NA,Western Cape,7005741,783,33,95223,3050
2020-08-01,South Africa,NA,Western Cape,7005741,966,24,96189,3074
2020-08-02,South Africa,NA,Western Cape,7005741,649,43,96838,3117
2020-08-03,South Africa,NA,Western Cape,7005741,238,31,97076,3148
2020-08-04,South Africa,NA,Western Cape,7005741,185,97,97261,3245
2020-08-05,South Africa,NA,Western Cape,7005741,770,34,98031,3279
2020-08-06,South Africa,NA,Western Cape,7005741,568,46,98599,3325
2020-08-07,South Africa,NA,Western Cape,7005741,428,29,99027,3354
2020-08-08,South Africa,NA,Western Cape,7005741,561,22,99588,3376
2020-08-09,South Africa,NA,Western Cape,7005741,371,23,99959,3399
2020-08-10,South Africa,NA,Western Cape,7005741,254,30,100213,3429
2020-08-11,South Africa,NA,Western Cape,7005741,103,25,100316,3454
2020-08-12,South Africa,NA,Western Cape,7005741,220,31,100536,3485
2020-08-13,South Africa,NA,Western Cape,7005741,440,21,100976,3506
2020-08-14,South Africa,NA,Western Cape,7005741,603,28,101579,3534
2020-08-15,South Africa,NA,Western Cape,7005741,410,26,101989,3560
2020-08-16,South Africa,NA,Western Cape,7005741,460,20,102449,3580
2020-08-17,South Africa,NA,Western Cape,7005741,160,32,102609,3612
2020-08-18,South Africa,NA,Western Cape,7005741,130,34,102739,3646
2020-08-19,South Africa,NA,Western Cape,7005741,471,29,103210,3675
2020-08-20,South Africa,NA,Western Cape,7005741,406,13,103616,3688
2020-08-21,South Africa,NA,Western Cape,7005741,326,25,103942,3713
2020-08-22,South Africa,NA,Western Cape,7005741,343,5,104285,3718
2020-08-23,South Africa,NA,Western Cape,7005741,303,8,104588,3726
2020-08-24,South Africa,NA,Western Cape,7005741,79,19,104667,3745
2020-08-25,South Africa,NA,Western Cape,7005741,114,18,104781,3763
2020-08-26,South Africa,NA,Western Cape,7005741,216,60,104997,3823
2020-08-27,South Africa,NA,Western Cape,7005741,276,20,105273,3843
2020-08-28,South Africa,NA,Western Cape,7005741,234,10,105507,3853
2020-08-29,South Africa,NA,Western Cape,7005741,169,9,105676,3862
2020-08-30,South Africa,NA,Western Cape,7005741,232,7,105908,3869
2020-08-31,South Africa,NA,Western Cape,7005741,113,24,106021,3893
2020-09-01,South Africa,NA,Western Cape,7005741,93,20,106114,3913
2020-09-02,South Africa,NA,Western Cape,7005741,239,16,106353,3929
2020-09-03,South Africa,NA,Western Cape,7005741,229,17,106582,3946
2020-09-04,South Africa,NA,Western Cape,7005741,205,4,106787,3950
2020-09-05,South Africa,NA,Western Cape,7005741,195,10,106982,3960
2020-09-06,South Africa,NA,Western Cape,7005741,205,1,107187,3961
2020-09-07,South Africa,NA,Western Cape,7005741,57,13,107244,3974
2020-09-08,South Africa,NA,Western Cape,7005741,87,20,107331,3994
2020-09-09,South Africa,NA,Western Cape,7005741,293,22,107624,4016
2020-09-10,South Africa,NA,Western Cape,7005741,243,6,107867,4022
2020-09-11,South Africa,NA,Western Cape,7005741,181,18,108048,4040
2020-09-12,South Africa,NA,Western Cape,7005741,231,13,108279,4053
2020-09-13,South Africa,NA,Western Cape,7005741,152,6,108431,4059
2020-09-14,South Africa,NA,Western Cape,7005741,55,7,108486,4066
2020-09-15,South Africa,NA,Western Cape,7005741,51,13,108537,4079
2020-09-16,South Africa,NA,Western Cape,7005741,230,9,108767,4088
2020-09-17,South Africa,NA,Western Cape,7005741,228,12,108995,4100
2020-09-18,South Africa,NA,Western Cape,7005741,162,7,109157,4107
2020-09-19,South Africa,NA,Western Cape,7005741,201,4,109358,4111
2020-09-20,South Africa,NA,Western Cape,7005741,149,6,109507,4117
2020-09-21,South Africa,NA,Western Cape,7005741,19,4,109526,4121
2020-09-22,South Africa,NA,Western Cape,7005741,90,17,109616,4138
2020-09-23,South Africa,NA,Western Cape,7005741,214,13,109830,4151
2020-02-14,Spain,NA,Andalucia,8427405,1,0,11,0
2020-02-15,Spain,NA,Andalucia,8427405,1,0,12,0
2020-02-16,Spain,NA,Andalucia,8427405,0,0,12,0
2020-02-17,Spain,NA,Andalucia,8427405,0,0,12,0
2020-02-18,Spain,NA,Andalucia,8427405,3,0,15,0
2020-02-19,Spain,NA,Andalucia,8427405,1,0,16,0
2020-02-20,Spain,NA,Andalucia,8427405,3,0,19,0
2020-02-21,Spain,NA,Andalucia,8427405,4,0,23,0
2020-02-22,Spain,NA,Andalucia,8427405,2,0,25,0
2020-02-23,Spain,NA,Andalucia,8427405,2,0,27,0
2020-02-24,Spain,NA,Andalucia,8427405,5,0,32,0
2020-02-25,Spain,NA,Andalucia,8427405,9,0,41,0
2020-02-26,Spain,NA,Andalucia,8427405,9,0,50,0
2020-02-27,Spain,NA,Andalucia,8427405,7,0,57,0
2020-02-28,Spain,NA,Andalucia,8427405,7,0,64,0
2020-02-29,Spain,NA,Andalucia,8427405,8,0,72,0
2020-03-01,Spain,NA,Andalucia,8427405,25,0,97,0
2020-03-02,Spain,NA,Andalucia,8427405,31,0,128,0
2020-03-03,Spain,NA,Andalucia,8427405,36,0,164,0
2020-03-04,Spain,NA,Andalucia,8427405,31,0,195,0
2020-03-05,Spain,NA,Andalucia,8427405,55,0,250,0
2020-03-06,Spain,NA,Andalucia,8427405,66,0,316,0
2020-03-07,Spain,NA,Andalucia,8427405,72,0,388,0
2020-03-08,Spain,NA,Andalucia,8427405,78,0,466,0
2020-03-09,Spain,NA,Andalucia,8427405,158,0,624,0
2020-03-10,Spain,NA,Andalucia,8427405,204,0,828,0
2020-03-11,Spain,NA,Andalucia,8427405,246,0,1074,0
2020-03-12,Spain,NA,Andalucia,8427405,301,0,1375,0
2020-03-13,Spain,NA,Andalucia,8427405,447,2,1822,2
2020-03-14,Spain,NA,Andalucia,8427405,392,5,2214,7
2020-03-15,Spain,NA,Andalucia,8427405,409,4,2623,11
2020-03-16,Spain,NA,Andalucia,8427405,536,5,3159,16
2020-03-17,Spain,NA,Andalucia,8427405,538,8,3697,24
2020-03-18,Spain,NA,Andalucia,8427405,493,5,4190,29
2020-03-19,Spain,NA,Andalucia,8427405,522,15,4712,44
2020-03-20,Spain,NA,Andalucia,8427405,748,14,5460,58
2020-03-21,Spain,NA,Andalucia,8427405,517,18,5977,76
2020-03-22,Spain,NA,Andalucia,8427405,489,28,6466,104
2020-03-23,Spain,NA,Andalucia,8427405,535,29,7001,133
2020-03-24,Spain,NA,Andalucia,8427405,463,36,7464,169
2020-03-25,Spain,NA,Andalucia,8427405,487,30,7951,199
2020-03-26,Spain,NA,Andalucia,8427405,435,45,8386,244
2020-03-27,Spain,NA,Andalucia,8427405,392,48,8778,292
2020-03-28,Spain,NA,Andalucia,8427405,296,27,9074,319
2020-03-29,Spain,NA,Andalucia,8427405,319,40,9393,359
2020-03-30,Spain,NA,Andalucia,8427405,302,52,9695,411
2020-03-31,Spain,NA,Andalucia,8427405,239,47,9934,458
2020-04-01,Spain,NA,Andalucia,8427405,323,43,10257,501
2020-04-02,Spain,NA,Andalucia,8427405,216,53,10473,554
2020-04-03,Spain,NA,Andalucia,8427405,172,43,10645,597
2020-04-04,Spain,NA,Andalucia,8427405,166,51,10811,648
2020-04-05,Spain,NA,Andalucia,8427405,160,40,10971,688
2020-04-06,Spain,NA,Andalucia,8427405,137,42,11108,730
2020-04-07,Spain,NA,Andalucia,8427405,163,38,11271,768
2020-04-08,Spain,NA,Andalucia,8427405,133,54,11404,822
2020-04-09,Spain,NA,Andalucia,8427405,85,32,11489,854
2020-04-10,Spain,NA,Andalucia,8427405,98,46,11587,900
2020-04-11,Spain,NA,Andalucia,8427405,94,22,11681,922
2020-04-12,Spain,NA,Andalucia,8427405,81,33,11762,955
2020-04-13,Spain,NA,Andalucia,8427405,71,21,11833,976
2020-04-14,Spain,NA,Andalucia,8427405,57,33,11890,1009
2020-04-15,Spain,NA,Andalucia,8427405,90,26,11980,1035
2020-04-16,Spain,NA,Andalucia,8427405,50,25,12030,1060
2020-04-17,Spain,NA,Andalucia,8427405,63,26,12093,1086
2020-04-18,Spain,NA,Andalucia,8427405,41,18,12134,1104
2020-04-19,Spain,NA,Andalucia,8427405,28,19,12162,1123
2020-04-20,Spain,NA,Andalucia,8427405,38,28,12200,1151
2020-04-21,Spain,NA,Andalucia,8427405,38,22,12238,1173
2020-04-22,Spain,NA,Andalucia,8427405,27,15,12265,1188
2020-04-23,Spain,NA,Andalucia,8427405,35,23,12300,1211
2020-04-24,Spain,NA,Andalucia,8427405,45,11,12345,1222
2020-04-25,Spain,NA,Andalucia,8427405,24,13,12369,1235
2020-04-26,Spain,NA,Andalucia,8427405,15,13,12384,1248
2020-04-27,Spain,NA,Andalucia,8427405,16,11,12400,1259
2020-04-28,Spain,NA,Andalucia,8427405,18,10,12418,1269
2020-04-29,Spain,NA,Andalucia,8427405,32,9,12450,1278
2020-04-30,Spain,NA,Andalucia,8427405,21,6,12471,1284
2020-05-01,Spain,NA,Andalucia,8427405,16,6,12487,1290
2020-05-02,Spain,NA,Andalucia,8427405,15,8,12502,1298
2020-05-03,Spain,NA,Andalucia,8427405,8,8,12510,1306
2020-05-04,Spain,NA,Andalucia,8427405,18,12,12528,1318
2020-05-05,Spain,NA,Andalucia,8427405,12,9,12540,1327
2020-05-06,Spain,NA,Andalucia,8427405,3,5,12543,1332
2020-05-07,Spain,NA,Andalucia,8427405,2,7,12545,1339
2020-05-08,Spain,NA,Andalucia,8427405,8,2,12553,1341
2020-05-09,Spain,NA,Andalucia,8427405,2,7,12555,1348
2020-05-10,Spain,NA,Andalucia,8427405,5,4,12560,1352
2020-05-11,Spain,NA,Andalucia,8427405,18,5,12578,1357
2020-05-12,Spain,NA,Andalucia,8427405,19,3,12597,1360
2020-05-13,Spain,NA,Andalucia,8427405,14,7,12611,1367
2020-05-14,Spain,NA,Andalucia,8427405,11,8,12622,1375
2020-05-15,Spain,NA,Andalucia,8427405,15,4,12637,1379
2020-05-16,Spain,NA,Andalucia,8427405,3,3,12640,1382
2020-05-17,Spain,NA,Andalucia,8427405,4,2,12644,1384
2020-05-18,Spain,NA,Andalucia,8427405,11,4,12655,1388
2020-05-19,Spain,NA,Andalucia,8427405,11,2,12666,1390
2020-05-20,Spain,NA,Andalucia,8427405,13,0,12679,1390
2020-05-21,Spain,NA,Andalucia,8427405,9,3,12688,1393
2020-05-22,Spain,NA,Andalucia,8427405,5,6,12693,1399
2020-05-23,Spain,NA,Andalucia,8427405,7,2,12700,1401
2020-05-24,Spain,NA,Andalucia,8427405,3,4,12703,1405
2020-05-25,Spain,NA,Andalucia,8427405,8,3,12711,1408
2020-05-26,Spain,NA,Andalucia,8427405,8,3,12719,1411
2020-05-27,Spain,NA,Andalucia,8427405,11,0,12730,1411
2020-05-28,Spain,NA,Andalucia,8427405,7,2,12737,1413
2020-05-29,Spain,NA,Andalucia,8427405,12,0,12749,1413
2020-05-30,Spain,NA,Andalucia,8427405,13,2,12762,1415
2020-05-31,Spain,NA,Andalucia,8427405,9,0,12771,1415
2020-06-01,Spain,NA,Andalucia,8427405,19,0,12790,1415
2020-06-02,Spain,NA,Andalucia,8427405,6,0,12796,1415
2020-06-03,Spain,NA,Andalucia,8427405,15,1,12811,1416
2020-06-04,Spain,NA,Andalucia,8427405,5,0,12816,1416
2020-06-05,Spain,NA,Andalucia,8427405,12,0,12828,1416
2020-06-06,Spain,NA,Andalucia,8427405,5,2,12833,1418
2020-06-07,Spain,NA,Andalucia,8427405,2,0,12835,1418
2020-06-08,Spain,NA,Andalucia,8427405,6,0,12841,1418
2020-06-09,Spain,NA,Andalucia,8427405,8,0,12849,1418
2020-06-10,Spain,NA,Andalucia,8427405,6,2,12855,1420
2020-06-11,Spain,NA,Andalucia,8427405,3,0,12858,1420
2020-06-12,Spain,NA,Andalucia,8427405,4,1,12862,1421
2020-06-13,Spain,NA,Andalucia,8427405,4,0,12866,1421
2020-06-14,Spain,NA,Andalucia,8427405,4,0,12870,1421
2020-06-15,Spain,NA,Andalucia,8427405,7,0,12877,1421
2020-06-16,Spain,NA,Andalucia,8427405,10,0,12887,1421
2020-06-17,Spain,NA,Andalucia,8427405,10,2,12897,1423
2020-06-18,Spain,NA,Andalucia,8427405,25,0,12922,1423
2020-06-19,Spain,NA,Andalucia,8427405,11,0,12933,1423
2020-06-20,Spain,NA,Andalucia,8427405,15,0,12948,1423
2020-06-21,Spain,NA,Andalucia,8427405,10,0,12958,1423
2020-06-22,Spain,NA,Andalucia,8427405,17,0,12975,1423
2020-06-23,Spain,NA,Andalucia,8427405,13,0,12988,1423
2020-06-24,Spain,NA,Andalucia,8427405,96,0,13084,1423
2020-06-25,Spain,NA,Andalucia,8427405,22,0,13106,1423
2020-06-26,Spain,NA,Andalucia,8427405,19,1,13125,1424
2020-06-27,Spain,NA,Andalucia,8427405,15,0,13140,1424
2020-06-28,Spain,NA,Andalucia,8427405,27,0,13167,1424
2020-06-29,Spain,NA,Andalucia,8427405,22,1,13189,1425
2020-06-30,Spain,NA,Andalucia,8427405,25,0,13214,1425
2020-07-01,Spain,NA,Andalucia,8427405,23,0,13237,1425
2020-07-02,Spain,NA,Andalucia,8427405,14,0,13251,1425
2020-07-03,Spain,NA,Andalucia,8427405,27,0,13278,1425
2020-07-04,Spain,NA,Andalucia,8427405,25,0,13303,1425
2020-07-05,Spain,NA,Andalucia,8427405,16,0,13319,1425
2020-07-06,Spain,NA,Andalucia,8427405,23,1,13342,1426
2020-07-07,Spain,NA,Andalucia,8427405,32,0,13374,1426
2020-07-08,Spain,NA,Andalucia,8427405,56,1,13430,1427
2020-07-09,Spain,NA,Andalucia,8427405,36,0,13466,1427
2020-07-10,Spain,NA,Andalucia,8427405,60,0,13526,1427
2020-07-11,Spain,NA,Andalucia,8427405,50,0,13576,1427
2020-07-12,Spain,NA,Andalucia,8427405,32,0,13608,1427
2020-07-13,Spain,NA,Andalucia,8427405,48,0,13656,1427
2020-07-14,Spain,NA,Andalucia,8427405,95,1,13751,1428
2020-07-15,Spain,NA,Andalucia,8427405,64,0,13815,1428
2020-07-16,Spain,NA,Andalucia,8427405,75,0,13890,1428
2020-07-17,Spain,NA,Andalucia,8427405,96,0,13986,1428
2020-07-18,Spain,NA,Andalucia,8427405,86,0,14072,1428
2020-07-19,Spain,NA,Andalucia,8427405,114,0,14186,1428
2020-07-20,Spain,NA,Andalucia,8427405,121,0,14307,1428
2020-07-21,Spain,NA,Andalucia,8427405,74,0,14381,1428
2020-07-22,Spain,NA,Andalucia,8427405,78,0,14459,1428
2020-07-23,Spain,NA,Andalucia,8427405,125,0,14584,1428
2020-07-24,Spain,NA,Andalucia,8427405,128,1,14712,1429
2020-07-25,Spain,NA,Andalucia,8427405,110,1,14822,1430
2020-07-26,Spain,NA,Andalucia,8427405,104,0,14926,1430
2020-07-27,Spain,NA,Andalucia,8427405,143,0,15069,1430
2020-07-28,Spain,NA,Andalucia,8427405,148,0,15217,1430
2020-07-29,Spain,NA,Andalucia,8427405,151,0,15368,1430
2020-07-30,Spain,NA,Andalucia,8427405,206,0,15574,1430
2020-07-31,Spain,NA,Andalucia,8427405,258,0,15832,1430
2020-08-01,Spain,NA,Andalucia,8427405,248,0,16080,1430
2020-08-02,Spain,NA,Andalucia,8427405,213,1,16293,1431
2020-08-03,Spain,NA,Andalucia,8427405,288,1,16581,1432
2020-08-04,Spain,NA,Andalucia,8427405,284,0,16865,1432
2020-08-05,Spain,NA,Andalucia,8427405,362,1,17227,1433
2020-08-06,Spain,NA,Andalucia,8427405,368,2,17595,1435
2020-08-07,Spain,NA,Andalucia,8427405,457,1,18052,1436
2020-08-08,Spain,NA,Andalucia,8427405,374,2,18426,1438
2020-08-09,Spain,NA,Andalucia,8427405,323,0,18749,1438
2020-08-10,Spain,NA,Andalucia,8427405,454,0,19203,1438
2020-08-11,Spain,NA,Andalucia,8427405,498,1,19701,1439
2020-08-12,Spain,NA,Andalucia,8427405,577,1,20278,1440
2020-08-13,Spain,NA,Andalucia,8427405,619,1,20897,1441
2020-08-14,Spain,NA,Andalucia,8427405,705,0,21602,1441
2020-08-15,Spain,NA,Andalucia,8427405,635,4,22237,1445
2020-08-16,Spain,NA,Andalucia,8427405,574,2,22811,1447
2020-08-17,Spain,NA,Andalucia,8427405,725,3,23536,1450
2020-08-18,Spain,NA,Andalucia,8427405,795,2,24331,1452
2020-08-19,Spain,NA,Andalucia,8427405,717,2,25048,1454
2020-08-20,Spain,NA,Andalucia,8427405,809,1,25857,1455
2020-08-21,Spain,NA,Andalucia,8427405,868,1,26725,1456
2020-08-22,Spain,NA,Andalucia,8427405,800,2,27525,1458
2020-08-23,Spain,NA,Andalucia,8427405,720,5,28245,1463
2020-08-24,Spain,NA,Andalucia,8427405,832,6,29077,1469
2020-08-25,Spain,NA,Andalucia,8427405,835,1,29912,1470
2020-08-26,Spain,NA,Andalucia,8427405,998,4,30910,1474
2020-08-27,Spain,NA,Andalucia,8427405,977,3,31887,1477
2020-08-28,Spain,NA,Andalucia,8427405,964,4,32851,1481
2020-08-29,Spain,NA,Andalucia,8427405,879,3,33730,1484
2020-08-30,Spain,NA,Andalucia,8427405,772,6,34502,1490
2020-08-31,Spain,NA,Andalucia,8427405,916,7,35418,1497
2020-09-01,Spain,NA,Andalucia,8427405,1071,5,36489,1502
2020-09-02,Spain,NA,Andalucia,8427405,932,11,37421,1513
2020-09-03,Spain,NA,Andalucia,8427405,878,3,38299,1516
2020-09-04,Spain,NA,Andalucia,8427405,1134,7,39433,1523
2020-09-05,Spain,NA,Andalucia,8427405,934,10,40367,1533
2020-09-06,Spain,NA,Andalucia,8427405,826,9,41193,1542
2020-09-07,Spain,NA,Andalucia,8427405,785,5,41978,1547
2020-09-08,Spain,NA,Andalucia,8427405,966,7,42944,1554
2020-09-09,Spain,NA,Andalucia,8427405,1083,15,44027,1569
2020-09-10,Spain,NA,Andalucia,8427405,1059,10,45086,1579
2020-09-11,Spain,NA,Andalucia,8427405,1190,10,46276,1589
2020-09-12,Spain,NA,Andalucia,8427405,832,10,47108,1599
2020-09-13,Spain,NA,Andalucia,8427405,674,12,47782,1611
2020-09-14,Spain,NA,Andalucia,8427405,722,15,48504,1626
2020-09-15,Spain,NA,Andalucia,8427405,806,13,49310,1639
2020-09-16,Spain,NA,Andalucia,8427405,967,8,50277,1647
2020-09-17,Spain,NA,Andalucia,8427405,793,9,51070,1656
2020-09-18,Spain,NA,Andalucia,8427405,941,4,52011,1660
2020-09-19,Spain,NA,Andalucia,8427405,632,7,52643,1667
2020-09-20,Spain,NA,Andalucia,8427405,418,6,53061,1673
2020-09-21,Spain,NA,Andalucia,8427405,353,5,53414,1678
2020-09-22,Spain,NA,Andalucia,8427405,278,3,53692,1681
2020-02-22,Spain,NA,Aragon,1324397,3,0,11,0
2020-02-23,Spain,NA,Aragon,1324397,1,0,12,0
2020-02-24,Spain,NA,Aragon,1324397,1,0,13,0
2020-02-25,Spain,NA,Aragon,1324397,2,0,15,0
2020-02-26,Spain,NA,Aragon,1324397,2,0,17,0
2020-02-27,Spain,NA,Aragon,1324397,0,0,17,0
2020-02-28,Spain,NA,Aragon,1324397,3,0,20,0
2020-02-29,Spain,NA,Aragon,1324397,6,0,26,0
2020-03-01,Spain,NA,Aragon,1324397,8,0,34,0
2020-03-02,Spain,NA,Aragon,1324397,14,0,48,0
2020-03-03,Spain,NA,Aragon,1324397,8,0,56,0
2020-03-04,Spain,NA,Aragon,1324397,14,0,70,0
2020-03-05,Spain,NA,Aragon,1324397,11,0,81,0
2020-03-06,Spain,NA,Aragon,1324397,15,0,96,0
2020-03-07,Spain,NA,Aragon,1324397,22,0,118,0
2020-03-08,Spain,NA,Aragon,1324397,35,2,153,2
2020-03-09,Spain,NA,Aragon,1324397,36,2,189,4
2020-03-10,Spain,NA,Aragon,1324397,52,1,241,5
2020-03-11,Spain,NA,Aragon,1324397,66,0,307,5
2020-03-12,Spain,NA,Aragon,1324397,80,3,387,8
2020-03-13,Spain,NA,Aragon,1324397,115,0,502,8
2020-03-14,Spain,NA,Aragon,1324397,107,1,609,9
2020-03-15,Spain,NA,Aragon,1324397,127,1,736,10
2020-03-16,Spain,NA,Aragon,1324397,163,4,899,14
2020-03-17,Spain,NA,Aragon,1324397,157,0,1056,14
2020-03-18,Spain,NA,Aragon,1324397,168,3,1224,17
2020-03-19,Spain,NA,Aragon,1324397,168,6,1392,23
2020-03-20,Spain,NA,Aragon,1324397,241,5,1633,28
2020-03-21,Spain,NA,Aragon,1324397,177,4,1810,32
2020-03-22,Spain,NA,Aragon,1324397,164,11,1974,43
2020-03-23,Spain,NA,Aragon,1324397,265,11,2239,54
2020-03-24,Spain,NA,Aragon,1324397,192,10,2431,64
2020-03-25,Spain,NA,Aragon,1324397,188,24,2619,88
2020-03-26,Spain,NA,Aragon,1324397,166,19,2785,107
2020-03-27,Spain,NA,Aragon,1324397,212,10,2997,117
2020-03-28,Spain,NA,Aragon,1324397,147,15,3144,132
2020-03-29,Spain,NA,Aragon,1324397,136,19,3280,151
2020-03-30,Spain,NA,Aragon,1324397,131,31,3411,182
2020-03-31,Spain,NA,Aragon,1324397,116,27,3527,209
2020-04-01,Spain,NA,Aragon,1324397,156,29,3683,238
2020-04-02,Spain,NA,Aragon,1324397,127,22,3810,260
2020-04-03,Spain,NA,Aragon,1324397,108,29,3918,289
2020-04-04,Spain,NA,Aragon,1324397,94,20,4012,309
2020-04-05,Spain,NA,Aragon,1324397,94,29,4106,338
2020-04-06,Spain,NA,Aragon,1324397,125,36,4231,374
2020-04-07,Spain,NA,Aragon,1324397,108,31,4339,405
2020-04-08,Spain,NA,Aragon,1324397,110,24,4449,429
2020-04-09,Spain,NA,Aragon,1324397,89,23,4538,452
2020-04-10,Spain,NA,Aragon,1324397,73,32,4611,484
2020-04-11,Spain,NA,Aragon,1324397,57,33,4668,517
2020-04-12,Spain,NA,Aragon,1324397,51,20,4719,537
2020-04-13,Spain,NA,Aragon,1324397,71,22,4790,559
2020-04-14,Spain,NA,Aragon,1324397,44,29,4834,588
2020-04-15,Spain,NA,Aragon,1324397,64,16,4898,604
2020-04-16,Spain,NA,Aragon,1324397,55,17,4953,621
2020-04-17,Spain,NA,Aragon,1324397,53,19,5006,640
2020-04-18,Spain,NA,Aragon,1324397,55,17,5061,657
2020-04-19,Spain,NA,Aragon,1324397,35,10,5096,667
2020-04-20,Spain,NA,Aragon,1324397,30,13,5126,680
2020-04-21,Spain,NA,Aragon,1324397,37,25,5163,705
2020-04-22,Spain,NA,Aragon,1324397,57,12,5220,717
2020-04-23,Spain,NA,Aragon,1324397,22,12,5242,729
2020-04-24,Spain,NA,Aragon,1324397,20,14,5262,743
2020-04-25,Spain,NA,Aragon,1324397,19,10,5281,753
2020-04-26,Spain,NA,Aragon,1324397,16,9,5297,762
2020-04-27,Spain,NA,Aragon,1324397,23,10,5320,772
2020-04-28,Spain,NA,Aragon,1324397,29,7,5349,779
2020-04-29,Spain,NA,Aragon,1324397,23,14,5372,793
2020-04-30,Spain,NA,Aragon,1324397,26,5,5398,798
2020-05-01,Spain,NA,Aragon,1324397,15,1,5413,799
2020-05-02,Spain,NA,Aragon,1324397,16,6,5429,805
2020-05-03,Spain,NA,Aragon,1324397,16,6,5445,811
2020-05-04,Spain,NA,Aragon,1324397,34,10,5479,821
2020-05-05,Spain,NA,Aragon,1324397,6,5,5485,826
2020-05-06,Spain,NA,Aragon,1324397,6,5,5491,831
2020-05-07,Spain,NA,Aragon,1324397,19,10,5510,841
2020-05-08,Spain,NA,Aragon,1324397,12,3,5522,844
2020-05-09,Spain,NA,Aragon,1324397,4,6,5526,850
2020-05-10,Spain,NA,Aragon,1324397,7,3,5533,853
2020-05-11,Spain,NA,Aragon,1324397,5,4,5538,857
2020-05-12,Spain,NA,Aragon,1324397,17,4,5555,861
2020-05-13,Spain,NA,Aragon,1324397,21,5,5576,866
2020-05-14,Spain,NA,Aragon,1324397,23,2,5599,868
2020-05-15,Spain,NA,Aragon,1324397,16,4,5615,872
2020-05-16,Spain,NA,Aragon,1324397,7,1,5622,873
2020-05-17,Spain,NA,Aragon,1324397,8,3,5630,876
2020-05-18,Spain,NA,Aragon,1324397,17,1,5647,877
2020-05-19,Spain,NA,Aragon,1324397,23,2,5670,879
2020-05-20,Spain,NA,Aragon,1324397,13,2,5683,881
2020-05-21,Spain,NA,Aragon,1324397,11,1,5694,882
2020-05-22,Spain,NA,Aragon,1324397,13,0,5707,882
2020-05-23,Spain,NA,Aragon,1324397,11,1,5718,883
2020-05-24,Spain,NA,Aragon,1324397,5,0,5723,883
2020-05-25,Spain,NA,Aragon,1324397,12,3,5735,886
2020-05-26,Spain,NA,Aragon,1324397,12,1,5747,887
2020-05-27,Spain,NA,Aragon,1324397,14,2,5761,889
2020-05-28,Spain,NA,Aragon,1324397,9,2,5770,891
2020-05-29,Spain,NA,Aragon,1324397,11,1,5781,892
2020-05-30,Spain,NA,Aragon,1324397,5,0,5786,892
2020-05-31,Spain,NA,Aragon,1324397,8,2,5794,894
2020-06-01,Spain,NA,Aragon,1324397,8,3,5802,897
2020-06-02,Spain,NA,Aragon,1324397,17,2,5819,899
2020-06-03,Spain,NA,Aragon,1324397,7,0,5826,899
2020-06-04,Spain,NA,Aragon,1324397,9,2,5835,901
2020-06-05,Spain,NA,Aragon,1324397,6,1,5841,902
2020-06-06,Spain,NA,Aragon,1324397,6,1,5847,903
2020-06-07,Spain,NA,Aragon,1324397,5,0,5852,903
2020-06-08,Spain,NA,Aragon,1324397,6,0,5858,903
2020-06-09,Spain,NA,Aragon,1324397,12,0,5870,903
2020-06-10,Spain,NA,Aragon,1324397,2,1,5872,904
2020-06-11,Spain,NA,Aragon,1324397,6,0,5878,904
2020-06-12,Spain,NA,Aragon,1324397,4,0,5882,904
2020-06-13,Spain,NA,Aragon,1324397,3,0,5885,904
2020-06-14,Spain,NA,Aragon,1324397,2,0,5887,904
2020-06-15,Spain,NA,Aragon,1324397,7,0,5894,904
2020-06-16,Spain,NA,Aragon,1324397,11,1,5905,905
2020-06-17,Spain,NA,Aragon,1324397,7,1,5912,906
2020-06-18,Spain,NA,Aragon,1324397,17,1,5929,907
2020-06-19,Spain,NA,Aragon,1324397,25,0,5954,907
2020-06-20,Spain,NA,Aragon,1324397,29,0,5983,907
2020-06-21,Spain,NA,Aragon,1324397,40,0,6023,907
2020-06-22,Spain,NA,Aragon,1324397,57,0,6080,907
2020-06-23,Spain,NA,Aragon,1324397,48,0,6128,907
2020-06-24,Spain,NA,Aragon,1324397,62,0,6190,907
2020-06-25,Spain,NA,Aragon,1324397,47,0,6237,907
2020-06-26,Spain,NA,Aragon,1324397,21,0,6258,907
2020-06-27,Spain,NA,Aragon,1324397,53,0,6311,907
2020-06-28,Spain,NA,Aragon,1324397,17,1,6328,908
2020-06-29,Spain,NA,Aragon,1324397,24,0,6352,908
2020-06-30,Spain,NA,Aragon,1324397,37,0,6389,908
2020-07-01,Spain,NA,Aragon,1324397,36,0,6425,908
2020-07-02,Spain,NA,Aragon,1324397,22,0,6447,908
2020-07-03,Spain,NA,Aragon,1324397,44,3,6491,911
2020-07-04,Spain,NA,Aragon,1324397,32,0,6523,911
2020-07-05,Spain,NA,Aragon,1324397,37,0,6560,911
2020-07-06,Spain,NA,Aragon,1324397,75,1,6635,912
2020-07-07,Spain,NA,Aragon,1324397,88,0,6723,912
2020-07-08,Spain,NA,Aragon,1324397,76,1,6799,913
2020-07-09,Spain,NA,Aragon,1324397,87,0,6886,913
2020-07-10,Spain,NA,Aragon,1324397,125,0,7011,913
2020-07-11,Spain,NA,Aragon,1324397,154,0,7165,913
2020-07-12,Spain,NA,Aragon,1324397,128,0,7293,913
2020-07-13,Spain,NA,Aragon,1324397,229,0,7522,913
2020-07-14,Spain,NA,Aragon,1324397,289,0,7811,913
2020-07-15,Spain,NA,Aragon,1324397,361,0,8172,913
2020-07-16,Spain,NA,Aragon,1324397,294,0,8466,913
2020-07-17,Spain,NA,Aragon,1324397,397,0,8863,913
2020-07-18,Spain,NA,Aragon,1324397,340,0,9203,913
2020-07-19,Spain,NA,Aragon,1324397,333,2,9536,915
2020-07-20,Spain,NA,Aragon,1324397,420,1,9956,916
2020-07-21,Spain,NA,Aragon,1324397,455,1,10411,917
2020-07-22,Spain,NA,Aragon,1324397,460,0,10871,917
2020-07-23,Spain,NA,Aragon,1324397,381,0,11252,917
2020-07-24,Spain,NA,Aragon,1324397,436,0,11688,917
2020-07-25,Spain,NA,Aragon,1324397,378,2,12066,919
2020-07-26,Spain,NA,Aragon,1324397,385,2,12451,921
2020-07-27,Spain,NA,Aragon,1324397,574,0,13025,921
2020-07-28,Spain,NA,Aragon,1324397,515,8,13540,929
2020-07-29,Spain,NA,Aragon,1324397,537,3,14077,932
2020-07-30,Spain,NA,Aragon,1324397,483,3,14560,935
2020-07-31,Spain,NA,Aragon,1324397,500,7,15060,942
2020-08-01,Spain,NA,Aragon,1324397,826,2,15886,944
2020-08-02,Spain,NA,Aragon,1324397,439,3,16325,947
2020-08-03,Spain,NA,Aragon,1324397,450,6,16775,953
2020-08-04,Spain,NA,Aragon,1324397,515,9,17290,962
2020-08-05,Spain,NA,Aragon,1324397,412,4,17702,966
2020-08-06,Spain,NA,Aragon,1324397,496,8,18198,974
2020-08-07,Spain,NA,Aragon,1324397,539,9,18737,983
2020-08-08,Spain,NA,Aragon,1324397,488,17,19225,1000
2020-08-09,Spain,NA,Aragon,1324397,275,5,19500,1005
2020-08-10,Spain,NA,Aragon,1324397,525,9,20025,1014
2020-08-11,Spain,NA,Aragon,1324397,334,12,20359,1026
2020-08-12,Spain,NA,Aragon,1324397,394,13,20753,1039
2020-08-13,Spain,NA,Aragon,1324397,373,6,21126,1045
2020-08-14,Spain,NA,Aragon,1324397,356,11,21482,1056
2020-08-15,Spain,NA,Aragon,1324397,250,5,21732,1061
2020-08-16,Spain,NA,Aragon,1324397,220,5,21952,1066
2020-08-17,Spain,NA,Aragon,1324397,217,8,22169,1074
2020-08-18,Spain,NA,Aragon,1324397,8,17,22177,1091
2020-08-19,Spain,NA,Aragon,1324397,10,15,22187,1106
2020-08-20,Spain,NA,Aragon,1324397,14,6,22201,1112
2020-08-21,Spain,NA,Aragon,1324397,20,13,22221,1125
2020-08-22,Spain,NA,Aragon,1324397,20,10,22241,1135
2020-08-23,Spain,NA,Aragon,1324397,37,12,22278,1147
2020-08-24,Spain,NA,Aragon,1324397,35,3,22313,1150
2020-08-25,Spain,NA,Aragon,1324397,21,9,22334,1159
2020-08-26,Spain,NA,Aragon,1324397,139,2,22473,1161
2020-08-27,Spain,NA,Aragon,1324397,19,10,22492,1171
2020-08-28,Spain,NA,Aragon,1324397,14,3,22506,1174
2020-08-29,Spain,NA,Aragon,1324397,11,1,22517,1175
2020-08-30,Spain,NA,Aragon,1324397,5,6,22522,1181
2020-08-31,Spain,NA,Aragon,1324397,11,7,22533,1188
2020-09-01,Spain,NA,Aragon,1324397,0,12,22533,1200
2020-09-02,Spain,NA,Aragon,1324397,1,10,22534,1210
2020-09-03,Spain,NA,Aragon,1324397,0,3,22534,1213
2020-09-04,Spain,NA,Aragon,1324397,2,3,22536,1216
2020-09-05,Spain,NA,Aragon,1324397,9,2,22545,1218
2020-09-06,Spain,NA,Aragon,1324397,0,3,22545,1221
2020-09-07,Spain,NA,Aragon,1324397,0,8,22545,1229
2020-09-08,Spain,NA,Aragon,1324397,2,11,22547,1240
2020-09-09,Spain,NA,Aragon,1324397,0,8,22547,1248
2020-09-10,Spain,NA,Aragon,1324397,3,9,22550,1257
2020-09-11,Spain,NA,Aragon,1324397,0,6,22550,1263
2020-09-12,Spain,NA,Aragon,1324397,0,8,22550,1271
2020-09-13,Spain,NA,Aragon,1324397,1,9,22551,1280
2020-09-14,Spain,NA,Aragon,1324397,1,3,22552,1283
2020-09-15,Spain,NA,Aragon,1324397,1,11,22553,1294
2020-09-16,Spain,NA,Aragon,1324397,2,4,22555,1298
2020-09-17,Spain,NA,Aragon,1324397,1,8,22556,1306
2020-09-18,Spain,NA,Aragon,1324397,1,6,22557,1312
2020-09-19,Spain,NA,Aragon,1324397,1,7,22558,1319
2020-03-03,Spain,NA,Asturias,1022205,2,0,12,0
2020-03-04,Spain,NA,Asturias,1022205,2,0,14,0
2020-03-05,Spain,NA,Asturias,1022205,5,0,19,0
2020-03-06,Spain,NA,Asturias,1022205,12,0,31,0
2020-03-07,Spain,NA,Asturias,1022205,12,0,43,0
2020-03-08,Spain,NA,Asturias,1022205,14,0,57,0
2020-03-09,Spain,NA,Asturias,1022205,32,0,89,0
2020-03-10,Spain,NA,Asturias,1022205,52,0,141,0
2020-03-11,Spain,NA,Asturias,1022205,43,0,184,0
2020-03-12,Spain,NA,Asturias,1022205,57,1,241,1
2020-03-13,Spain,NA,Asturias,1022205,70,0,311,1
2020-03-14,Spain,NA,Asturias,1022205,81,0,392,1
2020-03-15,Spain,NA,Asturias,1022205,89,0,481,1
2020-03-16,Spain,NA,Asturias,1022205,106,0,587,1
2020-03-17,Spain,NA,Asturias,1022205,80,0,667,1
2020-03-18,Spain,NA,Asturias,1022205,91,0,758,1
2020-03-19,Spain,NA,Asturias,1022205,101,2,859,3
2020-03-20,Spain,NA,Asturias,1022205,83,3,942,6
2020-03-21,Spain,NA,Asturias,1022205,68,5,1010,11
2020-03-22,Spain,NA,Asturias,1022205,75,10,1085,21
2020-03-23,Spain,NA,Asturias,1022205,70,4,1155,25
2020-03-24,Spain,NA,Asturias,1022205,58,3,1213,28
2020-03-25,Spain,NA,Asturias,1022205,57,0,1270,28
2020-03-26,Spain,NA,Asturias,1022205,77,10,1347,38
2020-03-27,Spain,NA,Asturias,1022205,70,5,1417,43
2020-03-28,Spain,NA,Asturias,1022205,53,3,1470,46
2020-03-29,Spain,NA,Asturias,1022205,40,12,1510,58
2020-03-30,Spain,NA,Asturias,1022205,45,7,1555,65
2020-03-31,Spain,NA,Asturias,1022205,42,9,1597,74
2020-04-01,Spain,NA,Asturias,1022205,29,1,1626,75
2020-04-02,Spain,NA,Asturias,1022205,54,4,1680,79
2020-04-03,Spain,NA,Asturias,1022205,38,3,1718,82
2020-04-04,Spain,NA,Asturias,1022205,45,4,1763,86
2020-04-05,Spain,NA,Asturias,1022205,43,6,1806,92
2020-04-06,Spain,NA,Asturias,1022205,41,8,1847,100
2020-04-07,Spain,NA,Asturias,1022205,45,6,1892,106
2020-04-08,Spain,NA,Asturias,1022205,48,6,1940,112
2020-04-09,Spain,NA,Asturias,1022205,43,16,1983,128
2020-04-10,Spain,NA,Asturias,1022205,57,5,2040,133
2020-04-11,Spain,NA,Asturias,1022205,53,16,2093,149
2020-04-12,Spain,NA,Asturias,1022205,23,7,2116,156
2020-04-13,Spain,NA,Asturias,1022205,32,8,2148,164
2020-04-14,Spain,NA,Asturias,1022205,30,8,2178,172
2020-04-15,Spain,NA,Asturias,1022205,40,4,2218,176
2020-04-16,Spain,NA,Asturias,1022205,12,10,2230,186
2020-04-17,Spain,NA,Asturias,1022205,12,4,2242,190
2020-04-18,Spain,NA,Asturias,1022205,9,7,2251,197
2020-04-19,Spain,NA,Asturias,1022205,6,2,2257,199
2020-04-20,Spain,NA,Asturias,1022205,7,4,2264,203
2020-04-21,Spain,NA,Asturias,1022205,16,8,2280,211
2020-04-22,Spain,NA,Asturias,1022205,8,11,2288,222
2020-04-23,Spain,NA,Asturias,1022205,9,6,2297,228
2020-04-24,Spain,NA,Asturias,1022205,17,7,2314,235
2020-04-25,Spain,NA,Asturias,1022205,3,8,2317,243
2020-04-26,Spain,NA,Asturias,1022205,5,5,2322,248
2020-04-27,Spain,NA,Asturias,1022205,5,4,2327,252
2020-04-28,Spain,NA,Asturias,1022205,10,7,2337,259
2020-04-29,Spain,NA,Asturias,1022205,3,4,2340,263
2020-04-30,Spain,NA,Asturias,1022205,10,1,2350,264
2020-05-01,Spain,NA,Asturias,1022205,2,6,2352,270
2020-05-02,Spain,NA,Asturias,1022205,3,0,2355,270
2020-05-03,Spain,NA,Asturias,1022205,3,4,2358,274
2020-05-04,Spain,NA,Asturias,1022205,4,1,2362,275
2020-05-05,Spain,NA,Asturias,1022205,4,3,2366,278
2020-05-06,Spain,NA,Asturias,1022205,4,1,2370,279
2020-05-07,Spain,NA,Asturias,1022205,3,1,2373,280
2020-05-08,Spain,NA,Asturias,1022205,3,0,2376,280
2020-05-09,Spain,NA,Asturias,1022205,3,3,2379,283
2020-05-10,Spain,NA,Asturias,1022205,1,5,2380,288
2020-05-11,Spain,NA,Asturias,1022205,4,3,2384,291
2020-05-12,Spain,NA,Asturias,1022205,0,2,2384,293
2020-05-13,Spain,NA,Asturias,1022205,2,1,2386,294
2020-05-14,Spain,NA,Asturias,1022205,2,5,2388,299
2020-05-15,Spain,NA,Asturias,1022205,4,1,2392,300
2020-05-16,Spain,NA,Asturias,1022205,1,0,2393,300
2020-05-17,Spain,NA,Asturias,1022205,4,3,2397,303
2020-05-18,Spain,NA,Asturias,1022205,0,2,2397,305
2020-05-19,Spain,NA,Asturias,1022205,0,2,2397,307
2020-05-20,Spain,NA,Asturias,1022205,1,2,2398,309
2020-05-21,Spain,NA,Asturias,1022205,1,1,2399,310
2020-05-22,Spain,NA,Asturias,1022205,1,0,2400,310
2020-05-23,Spain,NA,Asturias,1022205,1,1,2401,311
2020-05-24,Spain,NA,Asturias,1022205,2,0,2403,311
2020-05-25,Spain,NA,Asturias,1022205,1,0,2404,311
2020-05-26,Spain,NA,Asturias,1022205,2,1,2406,312
2020-05-27,Spain,NA,Asturias,1022205,0,1,2406,313
2020-05-28,Spain,NA,Asturias,1022205,0,0,2406,313
2020-05-29,Spain,NA,Asturias,1022205,13,0,2419,313
2020-05-30,Spain,NA,Asturias,1022205,4,7,2423,320
2020-05-31,Spain,NA,Asturias,1022205,3,1,2426,321
2020-06-01,Spain,NA,Asturias,1022205,0,0,2426,321
2020-06-02,Spain,NA,Asturias,1022205,0,0,2426,321
2020-06-03,Spain,NA,Asturias,1022205,1,1,2427,322
2020-06-04,Spain,NA,Asturias,1022205,0,2,2427,324
2020-06-05,Spain,NA,Asturias,1022205,2,2,2429,326
2020-06-06,Spain,NA,Asturias,1022205,2,2,2431,328
2020-06-07,Spain,NA,Asturias,1022205,1,1,2432,329
2020-06-08,Spain,NA,Asturias,1022205,0,0,2432,329
2020-06-09,Spain,NA,Asturias,1022205,0,1,2432,330
2020-06-10,Spain,NA,Asturias,1022205,0,1,2432,331
2020-06-11,Spain,NA,Asturias,1022205,3,1,2435,332
2020-06-12,Spain,NA,Asturias,1022205,0,0,2435,332
2020-06-13,Spain,NA,Asturias,1022205,0,0,2435,332
2020-06-14,Spain,NA,Asturias,1022205,0,0,2435,332
2020-06-15,Spain,NA,Asturias,1022205,0,0,2435,332
2020-06-16,Spain,NA,Asturias,1022205,0,1,2435,333
2020-06-17,Spain,NA,Asturias,1022205,0,0,2435,333
2020-06-18,Spain,NA,Asturias,1022205,0,0,2435,333
2020-06-19,Spain,NA,Asturias,1022205,0,0,2435,333
2020-06-20,Spain,NA,Asturias,1022205,0,0,2435,333
2020-06-21,Spain,NA,Asturias,1022205,0,1,2435,334
2020-06-22,Spain,NA,Asturias,1022205,0,0,2435,334
2020-06-23,Spain,NA,Asturias,1022205,0,0,2435,334
2020-06-24,Spain,NA,Asturias,1022205,0,0,2435,334
2020-06-25,Spain,NA,Asturias,1022205,0,0,2435,334
2020-06-26,Spain,NA,Asturias,1022205,0,0,2435,334
2020-06-27,Spain,NA,Asturias,1022205,0,0,2435,334
2020-06-28,Spain,NA,Asturias,1022205,0,0,2435,334
2020-06-29,Spain,NA,Asturias,1022205,1,0,2436,334
2020-06-30,Spain,NA,Asturias,1022205,0,0,2436,334
2020-07-01,Spain,NA,Asturias,1022205,1,0,2437,334
2020-07-02,Spain,NA,Asturias,1022205,0,0,2437,334
2020-07-03,Spain,NA,Asturias,1022205,0,0,2437,334
2020-07-04,Spain,NA,Asturias,1022205,0,0,2437,334
2020-07-05,Spain,NA,Asturias,1022205,0,0,2437,334
2020-07-06,Spain,NA,Asturias,1022205,0,0,2437,334
2020-07-07,Spain,NA,Asturias,1022205,0,0,2437,334
2020-07-08,Spain,NA,Asturias,1022205,2,0,2439,334
2020-07-09,Spain,NA,Asturias,1022205,0,0,2439,334
2020-07-10,Spain,NA,Asturias,1022205,2,0,2441,334
2020-07-11,Spain,NA,Asturias,1022205,3,0,2444,334
2020-07-12,Spain,NA,Asturias,1022205,0,0,2444,334
2020-07-13,Spain,NA,Asturias,1022205,0,0,2444,334
2020-07-14,Spain,NA,Asturias,1022205,2,0,2446,334
2020-07-15,Spain,NA,Asturias,1022205,2,0,2448,334
2020-07-16,Spain,NA,Asturias,1022205,1,0,2449,334
2020-07-17,Spain,NA,Asturias,1022205,1,0,2450,334
2020-07-18,Spain,NA,Asturias,1022205,1,0,2451,334
2020-07-19,Spain,NA,Asturias,1022205,2,0,2453,334
2020-07-20,Spain,NA,Asturias,1022205,1,0,2454,334
2020-07-21,Spain,NA,Asturias,1022205,2,0,2456,334
2020-07-22,Spain,NA,Asturias,1022205,2,0,2458,334
2020-07-23,Spain,NA,Asturias,1022205,4,0,2462,334
2020-07-24,Spain,NA,Asturias,1022205,3,0,2465,334
2020-07-25,Spain,NA,Asturias,1022205,8,0,2473,334
2020-07-26,Spain,NA,Asturias,1022205,7,0,2480,334
2020-07-27,Spain,NA,Asturias,1022205,6,0,2486,334
2020-07-28,Spain,NA,Asturias,1022205,13,0,2499,334
2020-07-29,Spain,NA,Asturias,1022205,15,0,2514,334
2020-07-30,Spain,NA,Asturias,1022205,12,0,2526,334
2020-07-31,Spain,NA,Asturias,1022205,12,0,2538,334
2020-08-01,Spain,NA,Asturias,1022205,17,0,2555,334
2020-08-02,Spain,NA,Asturias,1022205,11,0,2566,334
2020-08-03,Spain,NA,Asturias,1022205,12,0,2578,334
2020-08-04,Spain,NA,Asturias,1022205,19,0,2597,334
2020-08-05,Spain,NA,Asturias,1022205,38,0,2635,334
2020-08-06,Spain,NA,Asturias,1022205,39,0,2674,334
2020-08-07,Spain,NA,Asturias,1022205,28,0,2702,334
2020-08-08,Spain,NA,Asturias,1022205,23,0,2725,334
2020-08-09,Spain,NA,Asturias,1022205,35,0,2760,334
2020-08-10,Spain,NA,Asturias,1022205,26,0,2786,334
2020-08-11,Spain,NA,Asturias,1022205,27,0,2813,334
2020-08-12,Spain,NA,Asturias,1022205,26,0,2839,334
2020-08-13,Spain,NA,Asturias,1022205,17,0,2856,334
2020-08-14,Spain,NA,Asturias,1022205,22,0,2878,334
2020-08-15,Spain,NA,Asturias,1022205,29,0,2907,334
2020-08-16,Spain,NA,Asturias,1022205,24,0,2931,334
2020-08-17,Spain,NA,Asturias,1022205,22,0,2953,334
2020-08-18,Spain,NA,Asturias,1022205,30,0,2983,334
2020-08-19,Spain,NA,Asturias,1022205,29,0,3012,334
2020-08-20,Spain,NA,Asturias,1022205,31,0,3043,334
2020-08-21,Spain,NA,Asturias,1022205,33,0,3076,334
2020-08-22,Spain,NA,Asturias,1022205,36,0,3112,334
2020-08-23,Spain,NA,Asturias,1022205,43,1,3155,335
2020-08-24,Spain,NA,Asturias,1022205,51,0,3206,335
2020-08-25,Spain,NA,Asturias,1022205,39,0,3245,335
2020-08-26,Spain,NA,Asturias,1022205,36,0,3281,335
2020-08-27,Spain,NA,Asturias,1022205,37,0,3318,335
2020-08-28,Spain,NA,Asturias,1022205,45,0,3363,335
2020-08-29,Spain,NA,Asturias,1022205,30,0,3393,335
2020-08-30,Spain,NA,Asturias,1022205,47,0,3440,335
2020-08-31,Spain,NA,Asturias,1022205,36,0,3476,335
2020-09-01,Spain,NA,Asturias,1022205,63,0,3539,335
2020-09-02,Spain,NA,Asturias,1022205,56,0,3595,335
2020-09-03,Spain,NA,Asturias,1022205,88,1,3683,336
2020-09-04,Spain,NA,Asturias,1022205,35,1,3718,337
2020-09-05,Spain,NA,Asturias,1022205,53,0,3771,337
2020-09-06,Spain,NA,Asturias,1022205,27,0,3798,337
2020-09-07,Spain,NA,Asturias,1022205,44,1,3842,338
2020-09-08,Spain,NA,Asturias,1022205,46,0,3888,338
2020-09-09,Spain,NA,Asturias,1022205,49,0,3937,338
2020-09-10,Spain,NA,Asturias,1022205,37,0,3974,338
2020-09-11,Spain,NA,Asturias,1022205,81,1,4055,339
2020-09-12,Spain,NA,Asturias,1022205,88,0,4143,339
2020-09-13,Spain,NA,Asturias,1022205,101,0,4244,339
2020-09-14,Spain,NA,Asturias,1022205,94,1,4338,340
2020-09-15,Spain,NA,Asturias,1022205,96,0,4434,340
2020-09-16,Spain,NA,Asturias,1022205,131,1,4565,341
2020-09-17,Spain,NA,Asturias,1022205,53,0,4618,341
2020-09-18,Spain,NA,Asturias,1022205,71,0,4689,341
2020-09-19,Spain,NA,Asturias,1022205,82,0,4771,341
2020-09-20,Spain,NA,Asturias,1022205,104,0,4875,341
2020-09-21,Spain,NA,Asturias,1022205,1,1,4876,342
2020-03-01,Spain,NA,Cantabria,581641,1,0,11,0
2020-03-02,Spain,NA,Cantabria,581641,0,0,11,0
2020-03-03,Spain,NA,Cantabria,581641,0,0,11,0
2020-03-04,Spain,NA,Cantabria,581641,0,0,11,0
2020-03-05,Spain,NA,Cantabria,581641,0,0,11,0
2020-03-06,Spain,NA,Cantabria,581641,9,0,20,0
2020-03-07,Spain,NA,Cantabria,581641,12,0,32,0
2020-03-08,Spain,NA,Cantabria,581641,17,0,49,0
2020-03-09,Spain,NA,Cantabria,581641,9,0,58,0
2020-03-10,Spain,NA,Cantabria,581641,3,0,61,0
2020-03-11,Spain,NA,Cantabria,581641,17,0,78,0
2020-03-12,Spain,NA,Cantabria,581641,36,0,114,0
2020-03-13,Spain,NA,Cantabria,581641,54,0,168,0
2020-03-14,Spain,NA,Cantabria,581641,59,0,227,0
2020-03-15,Spain,NA,Cantabria,581641,68,0,295,0
2020-03-16,Spain,NA,Cantabria,581641,71,0,366,0
2020-03-17,Spain,NA,Cantabria,581641,76,1,442,1
2020-03-18,Spain,NA,Cantabria,581641,89,1,531,2
2020-03-19,Spain,NA,Cantabria,581641,177,0,708,2
2020-03-20,Spain,NA,Cantabria,581641,144,1,852,3
2020-03-21,Spain,NA,Cantabria,581641,99,3,951,6
2020-03-22,Spain,NA,Cantabria,581641,84,2,1035,8
2020-03-23,Spain,NA,Cantabria,581641,88,4,1123,12
2020-03-24,Spain,NA,Cantabria,581641,57,5,1180,17
2020-03-25,Spain,NA,Cantabria,581641,57,2,1237,19
2020-03-26,Spain,NA,Cantabria,581641,39,5,1276,24
2020-03-27,Spain,NA,Cantabria,581641,74,4,1350,28
2020-03-28,Spain,NA,Cantabria,581641,68,5,1418,33
2020-03-29,Spain,NA,Cantabria,581641,39,3,1457,36
2020-03-30,Spain,NA,Cantabria,581641,28,15,1485,51
2020-03-31,Spain,NA,Cantabria,581641,33,10,1518,61
2020-04-01,Spain,NA,Cantabria,581641,72,5,1590,66
2020-04-02,Spain,NA,Cantabria,581641,53,6,1643,72
2020-04-03,Spain,NA,Cantabria,581641,34,3,1677,75
2020-04-04,Spain,NA,Cantabria,581641,62,5,1739,80
2020-04-05,Spain,NA,Cantabria,581641,25,8,1764,88
2020-04-06,Spain,NA,Cantabria,581641,27,8,1791,96
2020-04-07,Spain,NA,Cantabria,581641,13,4,1804,100
2020-04-08,Spain,NA,Cantabria,581641,26,4,1830,104
2020-04-09,Spain,NA,Cantabria,581641,23,3,1853,107
2020-04-10,Spain,NA,Cantabria,581641,29,11,1882,118
2020-04-11,Spain,NA,Cantabria,581641,24,3,1906,121
2020-04-12,Spain,NA,Cantabria,581641,46,7,1952,128
2020-04-13,Spain,NA,Cantabria,581641,35,4,1987,132
2020-04-14,Spain,NA,Cantabria,581641,14,6,2001,138
2020-04-15,Spain,NA,Cantabria,581641,17,6,2018,144
2020-04-16,Spain,NA,Cantabria,581641,18,5,2036,149
2020-04-17,Spain,NA,Cantabria,581641,26,6,2062,155
2020-04-18,Spain,NA,Cantabria,581641,13,5,2075,160
2020-04-19,Spain,NA,Cantabria,581641,15,4,2090,164
2020-04-20,Spain,NA,Cantabria,581641,24,5,2114,169
2020-04-21,Spain,NA,Cantabria,581641,10,3,2124,172
2020-04-22,Spain,NA,Cantabria,581641,26,4,2150,176
2020-04-23,Spain,NA,Cantabria,581641,26,3,2176,179
2020-04-24,Spain,NA,Cantabria,581641,13,4,2189,183
2020-04-25,Spain,NA,Cantabria,581641,12,4,2201,187
2020-04-26,Spain,NA,Cantabria,581641,4,3,2205,190
2020-04-27,Spain,NA,Cantabria,581641,2,1,2207,191
2020-04-28,Spain,NA,Cantabria,581641,5,1,2212,192
2020-04-29,Spain,NA,Cantabria,581641,5,0,2217,192
2020-04-30,Spain,NA,Cantabria,581641,12,1,2229,193
2020-05-01,Spain,NA,Cantabria,581641,16,2,2245,195
2020-05-02,Spain,NA,Cantabria,581641,0,2,2245,197
2020-05-03,Spain,NA,Cantabria,581641,3,1,2248,198
2020-05-04,Spain,NA,Cantabria,581641,1,2,2249,200
2020-05-05,Spain,NA,Cantabria,581641,6,0,2255,200
2020-05-06,Spain,NA,Cantabria,581641,1,2,2256,202
2020-05-07,Spain,NA,Cantabria,581641,0,0,2256,202
2020-05-08,Spain,NA,Cantabria,581641,2,1,2258,203
2020-05-09,Spain,NA,Cantabria,581641,3,0,2261,203
2020-05-10,Spain,NA,Cantabria,581641,1,0,2262,203
2020-05-11,Spain,NA,Cantabria,581641,9,1,2271,204
2020-05-12,Spain,NA,Cantabria,581641,7,0,2278,204
2020-05-13,Spain,NA,Cantabria,581641,2,0,2280,204
2020-05-14,Spain,NA,Cantabria,581641,2,1,2282,205
2020-05-15,Spain,NA,Cantabria,581641,2,0,2284,205
2020-05-16,Spain,NA,Cantabria,581641,4,1,2288,206
2020-05-17,Spain,NA,Cantabria,581641,0,0,2288,206
2020-05-18,Spain,NA,Cantabria,581641,3,0,2291,206
2020-05-19,Spain,NA,Cantabria,581641,2,0,2293,206
2020-05-20,Spain,NA,Cantabria,581641,0,0,2293,206
2020-05-21,Spain,NA,Cantabria,581641,3,0,2296,206
2020-05-22,Spain,NA,Cantabria,581641,1,1,2297,207
2020-05-23,Spain,NA,Cantabria,581641,2,0,2299,207
2020-05-24,Spain,NA,Cantabria,581641,2,0,2301,207
2020-05-25,Spain,NA,Cantabria,581641,1,0,2302,207
2020-05-26,Spain,NA,Cantabria,581641,4,0,2306,207
2020-05-27,Spain,NA,Cantabria,581641,2,0,2308,207
2020-05-28,Spain,NA,Cantabria,581641,1,0,2309,207
2020-05-29,Spain,NA,Cantabria,581641,3,0,2312,207
2020-05-30,Spain,NA,Cantabria,581641,2,0,2314,207
2020-05-31,Spain,NA,Cantabria,581641,1,0,2315,207
2020-06-01,Spain,NA,Cantabria,581641,4,0,2319,207
2020-06-02,Spain,NA,Cantabria,581641,2,0,2321,207
2020-06-03,Spain,NA,Cantabria,581641,0,0,2321,207
2020-06-04,Spain,NA,Cantabria,581641,1,0,2322,207
2020-06-05,Spain,NA,Cantabria,581641,2,0,2324,207
2020-06-06,Spain,NA,Cantabria,581641,0,0,2324,207
2020-06-07,Spain,NA,Cantabria,581641,3,0,2327,207
2020-06-08,Spain,NA,Cantabria,581641,1,0,2328,207
2020-06-09,Spain,NA,Cantabria,581641,0,0,2328,207
2020-06-10,Spain,NA,Cantabria,581641,0,0,2328,207
2020-06-11,Spain,NA,Cantabria,581641,3,0,2331,207
2020-06-12,Spain,NA,Cantabria,581641,2,0,2333,207
2020-06-13,Spain,NA,Cantabria,581641,1,0,2334,207
2020-06-14,Spain,NA,Cantabria,581641,2,0,2336,207
2020-06-15,Spain,NA,Cantabria,581641,1,0,2337,207
2020-06-16,Spain,NA,Cantabria,581641,2,0,2339,207
2020-06-17,Spain,NA,Cantabria,581641,3,0,2342,207
2020-06-18,Spain,NA,Cantabria,581641,5,1,2347,208
2020-06-19,Spain,NA,Cantabria,581641,0,0,2347,208
2020-06-20,Spain,NA,Cantabria,581641,3,0,2350,208
2020-06-21,Spain,NA,Cantabria,581641,2,0,2352,208
2020-06-22,Spain,NA,Cantabria,581641,1,0,2353,208
2020-06-23,Spain,NA,Cantabria,581641,2,0,2355,208
2020-06-24,Spain,NA,Cantabria,581641,2,0,2357,208
2020-06-25,Spain,NA,Cantabria,581641,0,0,2357,208
2020-06-26,Spain,NA,Cantabria,581641,3,0,2360,208
2020-06-27,Spain,NA,Cantabria,581641,2,0,2362,208
2020-06-28,Spain,NA,Cantabria,581641,0,0,2362,208
2020-06-29,Spain,NA,Cantabria,581641,0,0,2362,208
2020-06-30,Spain,NA,Cantabria,581641,1,0,2363,208
2020-07-01,Spain,NA,Cantabria,581641,1,0,2364,208
2020-07-02,Spain,NA,Cantabria,581641,0,0,2364,208
2020-07-03,Spain,NA,Cantabria,581641,3,0,2367,208
2020-07-04,Spain,NA,Cantabria,581641,0,0,2367,208
2020-07-05,Spain,NA,Cantabria,581641,2,0,2369,208
2020-07-06,Spain,NA,Cantabria,581641,0,0,2369,208
2020-07-07,Spain,NA,Cantabria,581641,1,0,2370,208
2020-07-08,Spain,NA,Cantabria,581641,2,0,2372,208
2020-07-09,Spain,NA,Cantabria,581641,1,0,2373,208
2020-07-10,Spain,NA,Cantabria,581641,1,0,2374,208
2020-07-11,Spain,NA,Cantabria,581641,1,0,2375,208
2020-07-12,Spain,NA,Cantabria,581641,2,0,2377,208
2020-07-13,Spain,NA,Cantabria,581641,1,0,2378,208
2020-07-14,Spain,NA,Cantabria,581641,2,0,2380,208
2020-07-15,Spain,NA,Cantabria,581641,4,0,2384,208
2020-07-16,Spain,NA,Cantabria,581641,5,0,2389,208
2020-07-17,Spain,NA,Cantabria,581641,3,0,2392,208
2020-07-18,Spain,NA,Cantabria,581641,12,0,2404,208
2020-07-19,Spain,NA,Cantabria,581641,5,0,2409,208
2020-07-20,Spain,NA,Cantabria,581641,9,0,2418,208
2020-07-21,Spain,NA,Cantabria,581641,5,0,2423,208
2020-07-22,Spain,NA,Cantabria,581641,6,0,2429,208
2020-07-23,Spain,NA,Cantabria,581641,8,0,2437,208
2020-07-24,Spain,NA,Cantabria,581641,6,0,2443,208
2020-07-25,Spain,NA,Cantabria,581641,9,0,2452,208
2020-07-26,Spain,NA,Cantabria,581641,7,0,2459,208
2020-07-27,Spain,NA,Cantabria,581641,6,0,2465,208
2020-07-28,Spain,NA,Cantabria,581641,7,0,2472,208
2020-07-29,Spain,NA,Cantabria,581641,10,0,2482,208
2020-07-30,Spain,NA,Cantabria,581641,26,0,2508,208
2020-07-31,Spain,NA,Cantabria,581641,16,0,2524,208
2020-08-01,Spain,NA,Cantabria,581641,38,0,2562,208
2020-08-02,Spain,NA,Cantabria,581641,23,0,2585,208
2020-08-03,Spain,NA,Cantabria,581641,41,0,2626,208
2020-08-04,Spain,NA,Cantabria,581641,49,0,2675,208
2020-08-05,Spain,NA,Cantabria,581641,32,0,2707,208
2020-08-06,Spain,NA,Cantabria,581641,45,1,2752,209
2020-08-07,Spain,NA,Cantabria,581641,44,0,2796,209
2020-08-08,Spain,NA,Cantabria,581641,43,0,2839,209
2020-08-09,Spain,NA,Cantabria,581641,28,0,2867,209
2020-08-10,Spain,NA,Cantabria,581641,43,1,2910,210
2020-08-11,Spain,NA,Cantabria,581641,74,1,2984,211
2020-08-12,Spain,NA,Cantabria,581641,51,0,3035,211
2020-08-13,Spain,NA,Cantabria,581641,46,0,3081,211
2020-08-14,Spain,NA,Cantabria,581641,60,0,3141,211
2020-08-15,Spain,NA,Cantabria,581641,57,0,3198,211
2020-08-16,Spain,NA,Cantabria,581641,115,0,3313,211
2020-08-17,Spain,NA,Cantabria,581641,62,0,3375,211
2020-08-18,Spain,NA,Cantabria,581641,80,0,3455,211
2020-08-19,Spain,NA,Cantabria,581641,59,1,3514,212
2020-08-20,Spain,NA,Cantabria,581641,67,0,3581,212
2020-08-21,Spain,NA,Cantabria,581641,81,0,3662,212
2020-08-22,Spain,NA,Cantabria,581641,81,0,3743,212
2020-08-23,Spain,NA,Cantabria,581641,59,0,3802,212
2020-08-24,Spain,NA,Cantabria,581641,65,0,3867,212
2020-08-25,Spain,NA,Cantabria,581641,78,0,3945,212
2020-08-26,Spain,NA,Cantabria,581641,146,0,4091,212
2020-08-27,Spain,NA,Cantabria,581641,96,0,4187,212
2020-08-28,Spain,NA,Cantabria,581641,133,0,4320,212
2020-08-29,Spain,NA,Cantabria,581641,106,2,4426,214
2020-08-30,Spain,NA,Cantabria,581641,97,0,4523,214
2020-08-31,Spain,NA,Cantabria,581641,128,1,4651,215
2020-09-01,Spain,NA,Cantabria,581641,120,0,4771,215
2020-09-02,Spain,NA,Cantabria,581641,106,1,4877,216
2020-09-03,Spain,NA,Cantabria,581641,71,0,4948,216
2020-09-04,Spain,NA,Cantabria,581641,79,1,5027,217
2020-09-05,Spain,NA,Cantabria,581641,102,0,5129,217
2020-09-06,Spain,NA,Cantabria,581641,158,0,5287,217
2020-09-07,Spain,NA,Cantabria,581641,148,1,5435,218
2020-09-08,Spain,NA,Cantabria,581641,106,0,5541,218
2020-09-09,Spain,NA,Cantabria,581641,123,0,5664,218
2020-09-10,Spain,NA,Cantabria,581641,113,0,5777,218
2020-09-11,Spain,NA,Cantabria,581641,74,0,5851,218
2020-09-12,Spain,NA,Cantabria,581641,89,0,5940,218
2020-09-13,Spain,NA,Cantabria,581641,131,0,6071,218
2020-09-14,Spain,NA,Cantabria,581641,52,0,6123,218
2020-09-15,Spain,NA,Cantabria,581641,111,1,6234,219
2020-09-16,Spain,NA,Cantabria,581641,17,0,6251,219
2020-09-17,Spain,NA,Cantabria,581641,65,3,6316,222
2020-09-18,Spain,NA,Cantabria,581641,56,0,6372,222
2020-09-19,Spain,NA,Cantabria,581641,53,0,6425,222
2020-09-20,Spain,NA,Cantabria,581641,56,1,6481,223
2020-09-21,Spain,NA,Cantabria,581641,3,0,6484,223
2020-02-21,Spain,NA,Castilla y Leon,2407733,3,0,13,0
2020-02-22,Spain,NA,Castilla y Leon,2407733,2,0,15,0
2020-02-23,Spain,NA,Castilla y Leon,2407733,4,0,19,0
2020-02-24,Spain,NA,Castilla y Leon,2407733,4,0,23,0
2020-02-25,Spain,NA,Castilla y Leon,2407733,5,0,28,0
2020-02-26,Spain,NA,Castilla y Leon,2407733,7,0,35,0
2020-02-27,Spain,NA,Castilla y Leon,2407733,6,0,41,0
2020-02-28,Spain,NA,Castilla y Leon,2407733,8,0,49,0
2020-02-29,Spain,NA,Castilla y Leon,2407733,10,0,59,0
2020-03-01,Spain,NA,Castilla y Leon,2407733,28,0,87,0
2020-03-02,Spain,NA,Castilla y Leon,2407733,37,0,124,0
2020-03-03,Spain,NA,Castilla y Leon,2407733,28,0,152,0
2020-03-04,Spain,NA,Castilla y Leon,2407733,31,0,183,0
2020-03-05,Spain,NA,Castilla y Leon,2407733,46,0,229,0
2020-03-06,Spain,NA,Castilla y Leon,2407733,50,0,279,0
2020-03-07,Spain,NA,Castilla y Leon,2407733,71,0,350,0
2020-03-08,Spain,NA,Castilla y Leon,2407733,70,0,420,0
2020-03-09,Spain,NA,Castilla y Leon,2407733,147,0,567,0
2020-03-10,Spain,NA,Castilla y Leon,2407733,191,0,758,0
2020-03-11,Spain,NA,Castilla y Leon,2407733,220,0,978,0
2020-03-12,Spain,NA,Castilla y Leon,2407733,309,1,1287,1
2020-03-13,Spain,NA,Castilla y Leon,2407733,446,2,1733,3
2020-03-14,Spain,NA,Castilla y Leon,2407733,466,5,2199,8
2020-03-15,Spain,NA,Castilla y Leon,2407733,473,4,2672,12
2020-03-16,Spain,NA,Castilla y Leon,2407733,680,11,3352,23
2020-03-17,Spain,NA,Castilla y Leon,2407733,655,7,4007,30
2020-03-18,Spain,NA,Castilla y Leon,2407733,735,13,4742,43
2020-03-19,Spain,NA,Castilla y Leon,2407733,801,19,5543,62
2020-03-20,Spain,NA,Castilla y Leon,2407733,831,20,6374,82
2020-03-21,Spain,NA,Castilla y Leon,2407733,697,38,7071,120
2020-03-22,Spain,NA,Castilla y Leon,2407733,635,37,7706,157
2020-03-23,Spain,NA,Castilla y Leon,2407733,667,55,8373,212
2020-03-24,Spain,NA,Castilla y Leon,2407733,556,57,8929,269
2020-03-25,Spain,NA,Castilla y Leon,2407733,597,62,9526,331
2020-03-26,Spain,NA,Castilla y Leon,2407733,480,73,10006,404
2020-03-27,Spain,NA,Castilla y Leon,2407733,456,62,10462,466
2020-03-28,Spain,NA,Castilla y Leon,2407733,461,63,10923,529
2020-03-29,Spain,NA,Castilla y Leon,2407733,388,88,11311,617
2020-03-30,Spain,NA,Castilla y Leon,2407733,425,81,11736,698
2020-03-31,Spain,NA,Castilla y Leon,2407733,361,76,12097,774
2020-04-01,Spain,NA,Castilla y Leon,2407733,449,93,12546,867
2020-04-02,Spain,NA,Castilla y Leon,2407733,446,69,12992,936
2020-04-03,Spain,NA,Castilla y Leon,2407733,492,66,13484,1002
2020-04-04,Spain,NA,Castilla y Leon,2407733,482,89,13966,1091
2020-04-05,Spain,NA,Castilla y Leon,2407733,318,78,14284,1169
2020-04-06,Spain,NA,Castilla y Leon,2407733,461,66,14745,1235
2020-04-07,Spain,NA,Castilla y Leon,2407733,328,69,15073,1304
2020-04-08,Spain,NA,Castilla y Leon,2407733,372,68,15445,1372
2020-04-09,Spain,NA,Castilla y Leon,2407733,351,82,15796,1454
2020-04-10,Spain,NA,Castilla y Leon,2407733,324,63,16120,1517
2020-04-11,Spain,NA,Castilla y Leon,2407733,311,73,16431,1590
2020-04-12,Spain,NA,Castilla y Leon,2407733,159,63,16590,1653
2020-04-13,Spain,NA,Castilla y Leon,2407733,235,56,16825,1709
2020-04-14,Spain,NA,Castilla y Leon,2407733,201,60,17026,1769
2020-04-15,Spain,NA,Castilla y Leon,2407733,174,55,17200,1824
2020-04-16,Spain,NA,Castilla y Leon,2407733,144,49,17344,1873
2020-04-17,Spain,NA,Castilla y Leon,2407733,146,48,17490,1921
2020-04-18,Spain,NA,Castilla y Leon,2407733,94,48,17584,1969
2020-04-19,Spain,NA,Castilla y Leon,2407733,136,37,17720,2006
2020-04-20,Spain,NA,Castilla y Leon,2407733,196,42,17916,2048
2020-04-21,Spain,NA,Castilla y Leon,2407733,120,41,18036,2089
2020-04-22,Spain,NA,Castilla y Leon,2407733,164,31,18200,2120
2020-04-23,Spain,NA,Castilla y Leon,2407733,80,49,18280,2169
2020-04-24,Spain,NA,Castilla y Leon,2407733,138,38,18418,2207
2020-04-25,Spain,NA,Castilla y Leon,2407733,88,35,18506,2242
2020-04-26,Spain,NA,Castilla y Leon,2407733,41,29,18547,2271
2020-04-27,Spain,NA,Castilla y Leon,2407733,44,32,18591,2303
2020-04-28,Spain,NA,Castilla y Leon,2407733,64,28,18655,2331
2020-04-29,Spain,NA,Castilla y Leon,2407733,47,23,18702,2354
2020-04-30,Spain,NA,Castilla y Leon,2407733,68,32,18770,2386
2020-05-01,Spain,NA,Castilla y Leon,2407733,53,17,18823,2403
2020-05-02,Spain,NA,Castilla y Leon,2407733,58,32,18881,2435
2020-05-03,Spain,NA,Castilla y Leon,2407733,58,18,18939,2453
2020-05-04,Spain,NA,Castilla y Leon,2407733,28,20,18967,2473
2020-05-05,Spain,NA,Castilla y Leon,2407733,14,21,18981,2494
2020-05-06,Spain,NA,Castilla y Leon,2407733,13,18,18994,2512
2020-05-07,Spain,NA,Castilla y Leon,2407733,21,14,19015,2526
2020-05-08,Spain,NA,Castilla y Leon,2407733,17,19,19032,2545
2020-05-09,Spain,NA,Castilla y Leon,2407733,9,9,19041,2554
2020-05-10,Spain,NA,Castilla y Leon,2407733,10,15,19051,2569
2020-05-11,Spain,NA,Castilla y Leon,2407733,27,6,19078,2575
2020-05-12,Spain,NA,Castilla y Leon,2407733,30,18,19108,2593
2020-05-13,Spain,NA,Castilla y Leon,2407733,55,8,19163,2601
2020-05-14,Spain,NA,Castilla y Leon,2407733,38,5,19201,2606
2020-05-15,Spain,NA,Castilla y Leon,2407733,33,6,19234,2612
2020-05-16,Spain,NA,Castilla y Leon,2407733,28,4,19262,2616
2020-05-17,Spain,NA,Castilla y Leon,2407733,5,8,19267,2624
2020-05-18,Spain,NA,Castilla y Leon,2407733,33,6,19300,2630
2020-05-19,Spain,NA,Castilla y Leon,2407733,34,3,19334,2633
2020-05-20,Spain,NA,Castilla y Leon,2407733,26,5,19360,2638
2020-05-21,Spain,NA,Castilla y Leon,2407733,38,7,19398,2645
2020-05-22,Spain,NA,Castilla y Leon,2407733,40,6,19438,2651
2020-05-23,Spain,NA,Castilla y Leon,2407733,17,5,19455,2656
2020-05-24,Spain,NA,Castilla y Leon,2407733,13,5,19468,2661
2020-05-25,Spain,NA,Castilla y Leon,2407733,34,7,19502,2668
2020-05-26,Spain,NA,Castilla y Leon,2407733,46,8,19548,2676
2020-05-27,Spain,NA,Castilla y Leon,2407733,26,8,19574,2684
2020-05-28,Spain,NA,Castilla y Leon,2407733,44,5,19618,2689
2020-05-29,Spain,NA,Castilla y Leon,2407733,45,7,19663,2696
2020-05-30,Spain,NA,Castilla y Leon,2407733,37,8,19700,2704
2020-05-31,Spain,NA,Castilla y Leon,2407733,19,8,19719,2712
2020-06-01,Spain,NA,Castilla y Leon,2407733,28,5,19747,2717
2020-06-02,Spain,NA,Castilla y Leon,2407733,19,6,19766,2723
2020-06-03,Spain,NA,Castilla y Leon,2407733,27,5,19793,2728
2020-06-04,Spain,NA,Castilla y Leon,2407733,25,7,19818,2735
2020-06-05,Spain,NA,Castilla y Leon,2407733,35,2,19853,2737
2020-06-06,Spain,NA,Castilla y Leon,2407733,11,4,19864,2741
2020-06-07,Spain,NA,Castilla y Leon,2407733,13,7,19877,2748
2020-06-08,Spain,NA,Castilla y Leon,2407733,34,7,19911,2755
2020-06-09,Spain,NA,Castilla y Leon,2407733,25,2,19936,2757
2020-06-10,Spain,NA,Castilla y Leon,2407733,16,5,19952,2762
2020-06-11,Spain,NA,Castilla y Leon,2407733,17,4,19969,2766
2020-06-12,Spain,NA,Castilla y Leon,2407733,20,3,19989,2769
2020-06-13,Spain,NA,Castilla y Leon,2407733,11,3,20000,2772
2020-06-14,Spain,NA,Castilla y Leon,2407733,5,1,20005,2773
2020-06-15,Spain,NA,Castilla y Leon,2407733,16,3,20021,2776
2020-06-16,Spain,NA,Castilla y Leon,2407733,41,0,20062,2776
2020-06-17,Spain,NA,Castilla y Leon,2407733,18,1,20080,2777
2020-06-18,Spain,NA,Castilla y Leon,2407733,11,0,20091,2777
2020-06-19,Spain,NA,Castilla y Leon,2407733,13,2,20104,2779
2020-06-20,Spain,NA,Castilla y Leon,2407733,17,2,20121,2781
2020-06-21,Spain,NA,Castilla y Leon,2407733,6,2,20127,2783
2020-06-22,Spain,NA,Castilla y Leon,2407733,14,0,20141,2783
2020-06-23,Spain,NA,Castilla y Leon,2407733,28,0,20169,2783
2020-06-24,Spain,NA,Castilla y Leon,2407733,14,0,20183,2783
2020-06-25,Spain,NA,Castilla y Leon,2407733,17,0,20200,2783
2020-06-26,Spain,NA,Castilla y Leon,2407733,15,1,20215,2784
2020-06-27,Spain,NA,Castilla y Leon,2407733,13,0,20228,2784
2020-06-28,Spain,NA,Castilla y Leon,2407733,5,1,20233,2785
2020-06-29,Spain,NA,Castilla y Leon,2407733,11,2,20244,2787
2020-06-30,Spain,NA,Castilla y Leon,2407733,13,0,20257,2787
2020-07-01,Spain,NA,Castilla y Leon,2407733,8,0,20265,2787
2020-07-02,Spain,NA,Castilla y Leon,2407733,9,0,20274,2787
2020-07-03,Spain,NA,Castilla y Leon,2407733,11,1,20285,2788
2020-07-04,Spain,NA,Castilla y Leon,2407733,8,1,20293,2789
2020-07-05,Spain,NA,Castilla y Leon,2407733,3,0,20296,2789
2020-07-06,Spain,NA,Castilla y Leon,2407733,13,1,20309,2790
2020-07-07,Spain,NA,Castilla y Leon,2407733,9,1,20318,2791
2020-07-08,Spain,NA,Castilla y Leon,2407733,12,1,20330,2792
2020-07-09,Spain,NA,Castilla y Leon,2407733,8,0,20338,2792
2020-07-10,Spain,NA,Castilla y Leon,2407733,14,1,20352,2793
2020-07-11,Spain,NA,Castilla y Leon,2407733,13,1,20365,2794
2020-07-12,Spain,NA,Castilla y Leon,2407733,9,0,20374,2794
2020-07-13,Spain,NA,Castilla y Leon,2407733,21,0,20395,2794
2020-07-14,Spain,NA,Castilla y Leon,2407733,20,0,20415,2794
2020-07-15,Spain,NA,Castilla y Leon,2407733,13,1,20428,2795
2020-07-16,Spain,NA,Castilla y Leon,2407733,22,0,20450,2795
2020-07-17,Spain,NA,Castilla y Leon,2407733,15,0,20465,2795
2020-07-18,Spain,NA,Castilla y Leon,2407733,25,0,20490,2795
2020-07-19,Spain,NA,Castilla y Leon,2407733,23,1,20513,2796
2020-07-20,Spain,NA,Castilla y Leon,2407733,34,0,20547,2796
2020-07-21,Spain,NA,Castilla y Leon,2407733,20,0,20567,2796
2020-07-22,Spain,NA,Castilla y Leon,2407733,24,0,20591,2796
2020-07-23,Spain,NA,Castilla y Leon,2407733,44,0,20635,2796
2020-07-24,Spain,NA,Castilla y Leon,2407733,37,1,20672,2797
2020-07-25,Spain,NA,Castilla y Leon,2407733,29,0,20701,2797
2020-07-26,Spain,NA,Castilla y Leon,2407733,31,0,20732,2797
2020-07-27,Spain,NA,Castilla y Leon,2407733,68,0,20800,2797
2020-07-28,Spain,NA,Castilla y Leon,2407733,87,0,20887,2797
2020-07-29,Spain,NA,Castilla y Leon,2407733,76,0,20963,2797
2020-07-30,Spain,NA,Castilla y Leon,2407733,72,0,21035,2797
2020-07-31,Spain,NA,Castilla y Leon,2407733,150,0,21185,2797
2020-08-01,Spain,NA,Castilla y Leon,2407733,91,1,21276,2798
2020-08-02,Spain,NA,Castilla y Leon,2407733,92,0,21368,2798
2020-08-03,Spain,NA,Castilla y Leon,2407733,121,1,21489,2799
2020-08-04,Spain,NA,Castilla y Leon,2407733,205,0,21694,2799
2020-08-05,Spain,NA,Castilla y Leon,2407733,232,0,21926,2799
2020-08-06,Spain,NA,Castilla y Leon,2407733,169,1,22095,2800
2020-08-07,Spain,NA,Castilla y Leon,2407733,251,0,22346,2800
2020-08-08,Spain,NA,Castilla y Leon,2407733,183,1,22529,2801
2020-08-09,Spain,NA,Castilla y Leon,2407733,270,1,22799,2802
2020-08-10,Spain,NA,Castilla y Leon,2407733,234,0,23033,2802
2020-08-11,Spain,NA,Castilla y Leon,2407733,251,1,23284,2803
2020-08-12,Spain,NA,Castilla y Leon,2407733,305,1,23589,2804
2020-08-13,Spain,NA,Castilla y Leon,2407733,321,1,23910,2805
2020-08-14,Spain,NA,Castilla y Leon,2407733,367,3,24277,2808
2020-08-15,Spain,NA,Castilla y Leon,2407733,281,0,24558,2808
2020-08-16,Spain,NA,Castilla y Leon,2407733,284,0,24842,2808
2020-08-17,Spain,NA,Castilla y Leon,2407733,342,1,25184,2809
2020-08-18,Spain,NA,Castilla y Leon,2407733,395,0,25579,2809
2020-08-19,Spain,NA,Castilla y Leon,2407733,397,2,25976,2811
2020-08-20,Spain,NA,Castilla y Leon,2407733,520,1,26496,2812
2020-08-21,Spain,NA,Castilla y Leon,2407733,401,0,26897,2812
2020-08-22,Spain,NA,Castilla y Leon,2407733,279,4,27176,2816
2020-08-23,Spain,NA,Castilla y Leon,2407733,293,0,27469,2816
2020-08-24,Spain,NA,Castilla y Leon,2407733,447,3,27916,2819
2020-08-25,Spain,NA,Castilla y Leon,2407733,512,3,28428,2822
2020-08-26,Spain,NA,Castilla y Leon,2407733,436,4,28864,2826
2020-08-27,Spain,NA,Castilla y Leon,2407733,572,4,29436,2830
2020-08-28,Spain,NA,Castilla y Leon,2407733,510,8,29946,2838
2020-08-29,Spain,NA,Castilla y Leon,2407733,513,5,30459,2843
2020-08-30,Spain,NA,Castilla y Leon,2407733,318,3,30777,2846
2020-08-31,Spain,NA,Castilla y Leon,2407733,323,8,31100,2854
2020-09-01,Spain,NA,Castilla y Leon,2407733,488,1,31588,2855
2020-09-02,Spain,NA,Castilla y Leon,2407733,486,3,32074,2858
2020-09-03,Spain,NA,Castilla y Leon,2407733,603,3,32677,2861
2020-09-04,Spain,NA,Castilla y Leon,2407733,551,5,33228,2866
2020-09-05,Spain,NA,Castilla y Leon,2407733,515,5,33743,2871
2020-09-06,Spain,NA,Castilla y Leon,2407733,526,5,34269,2876
2020-09-07,Spain,NA,Castilla y Leon,2407733,469,5,34738,2881
2020-09-08,Spain,NA,Castilla y Leon,2407733,621,3,35359,2884
2020-09-09,Spain,NA,Castilla y Leon,2407733,572,7,35931,2891
2020-09-10,Spain,NA,Castilla y Leon,2407733,783,3,36714,2894
2020-09-11,Spain,NA,Castilla y Leon,2407733,755,5,37469,2899
2020-09-12,Spain,NA,Castilla y Leon,2407733,555,9,38024,2908
2020-09-13,Spain,NA,Castilla y Leon,2407733,568,7,38592,2915
2020-09-14,Spain,NA,Castilla y Leon,2407733,530,6,39122,2921
2020-09-15,Spain,NA,Castilla y Leon,2407733,740,8,39862,2929
2020-09-16,Spain,NA,Castilla y Leon,2407733,678,4,40540,2933
2020-09-17,Spain,NA,Castilla y Leon,2407733,674,10,41214,2943
2020-09-18,Spain,NA,Castilla y Leon,2407733,694,8,41908,2951
2020-09-19,Spain,NA,Castilla y Leon,2407733,528,7,42436,2958
2020-09-20,Spain,NA,Castilla y Leon,2407733,415,9,42851,2967
2020-09-21,Spain,NA,Castilla y Leon,2407733,319,9,43170,2976
2020-09-22,Spain,NA,Castilla y Leon,2407733,383,7,43553,2983
2020-09-23,Spain,NA,Castilla y Leon,2407733,90,5,43643,2988
2020-02-29,Spain,NA,Castilla-La Mancha,2034877,3,0,13,0
2020-03-01,Spain,NA,Castilla-La Mancha,2034877,16,0,29,0
2020-03-02,Spain,NA,Castilla-La Mancha,2034877,18,0,47,0
2020-03-03,Spain,NA,Castilla-La Mancha,2034877,15,0,62,0
2020-03-04,Spain,NA,Castilla-La Mancha,2034877,17,1,79,1
2020-03-05,Spain,NA,Castilla-La Mancha,2034877,20,0,99,1
2020-03-06,Spain,NA,Castilla-La Mancha,2034877,27,0,126,1
2020-03-07,Spain,NA,Castilla-La Mancha,2034877,32,0,158,1
2020-03-08,Spain,NA,Castilla-La Mancha,2034877,27,0,185,1
2020-03-09,Spain,NA,Castilla-La Mancha,2034877,45,1,230,2
2020-03-10,Spain,NA,Castilla-La Mancha,2034877,81,0,311,2
2020-03-11,Spain,NA,Castilla-La Mancha,2034877,76,2,387,4
2020-03-12,Spain,NA,Castilla-La Mancha,2034877,111,1,498,5
2020-03-13,Spain,NA,Castilla-La Mancha,2034877,183,5,681,10
2020-03-14,Spain,NA,Castilla-La Mancha,2034877,158,8,839,18
2020-03-15,Spain,NA,Castilla-La Mancha,2034877,250,11,1089,29
2020-03-16,Spain,NA,Castilla-La Mancha,2034877,239,12,1328,41
2020-03-17,Spain,NA,Castilla-La Mancha,2034877,199,20,1527,61
2020-03-18,Spain,NA,Castilla-La Mancha,2034877,216,23,1743,84
2020-03-19,Spain,NA,Castilla-La Mancha,2034877,242,24,1985,108
2020-03-20,Spain,NA,Castilla-La Mancha,2034877,310,38,2295,146
2020-03-21,Spain,NA,Castilla-La Mancha,2034877,199,48,2494,194
2020-03-22,Spain,NA,Castilla-La Mancha,2034877,178,55,2672,249
2020-03-23,Spain,NA,Castilla-La Mancha,2034877,249,83,2921,332
2020-03-24,Spain,NA,Castilla-La Mancha,2034877,249,84,3170,416
2020-03-25,Spain,NA,Castilla-La Mancha,2034877,241,104,3411,520
2020-03-26,Spain,NA,Castilla-La Mancha,2034877,240,112,3651,632
2020-03-27,Spain,NA,Castilla-La Mancha,2034877,198,92,3849,724
2020-03-28,Spain,NA,Castilla-La Mancha,2034877,166,104,4015,803
2020-03-29,Spain,NA,Castilla-La Mancha,2034877,171,67,4186,837
2020-03-30,Spain,NA,Castilla-La Mancha,2034877,230,86,4416,883
2020-03-31,Spain,NA,Castilla-La Mancha,2034877,169,91,4585,917
2020-04-01,Spain,NA,Castilla-La Mancha,2034877,193,91,4778,955
2020-04-02,Spain,NA,Castilla-La Mancha,2034877,147,75,4925,985
2020-04-03,Spain,NA,Castilla-La Mancha,2034877,148,76,5073,1014
2020-04-04,Spain,NA,Castilla-La Mancha,2034877,144,94,5217,1043
2020-04-05,Spain,NA,Castilla-La Mancha,2034877,237,69,5454,1090
2020-04-06,Spain,NA,Castilla-La Mancha,2034877,126,71,5580,1116
2020-04-07,Spain,NA,Castilla-La Mancha,2034877,98,60,5678,1135
2020-04-08,Spain,NA,Castilla-La Mancha,2034877,106,90,5784,1156
2020-04-09,Spain,NA,Castilla-La Mancha,2034877,81,67,5865,1173
2020-04-10,Spain,NA,Castilla-La Mancha,2034877,70,54,5935,1187
2020-04-11,Spain,NA,Castilla-La Mancha,2034877,59,56,5994,1198
2020-04-12,Spain,NA,Castilla-La Mancha,2034877,72,44,6066,1213
2020-04-13,Spain,NA,Castilla-La Mancha,2034877,106,54,6172,1234
2020-04-14,Spain,NA,Castilla-La Mancha,2034877,67,66,6239,1247
2020-04-15,Spain,NA,Castilla-La Mancha,2034877,78,58,6317,1263
2020-04-16,Spain,NA,Castilla-La Mancha,2034877,33,46,6350,1270
2020-04-17,Spain,NA,Castilla-La Mancha,2034877,24,51,6374,1274
2020-04-18,Spain,NA,Castilla-La Mancha,2034877,32,44,6406,1281
2020-04-19,Spain,NA,Castilla-La Mancha,2034877,33,43,6439,1287
2020-04-20,Spain,NA,Castilla-La Mancha,2034877,53,43,6492,1298
2020-04-21,Spain,NA,Castilla-La Mancha,2034877,34,33,6526,1305
2020-04-22,Spain,NA,Castilla-La Mancha,2034877,24,30,6550,1310
2020-04-23,Spain,NA,Castilla-La Mancha,2034877,22,27,6572,1314
2020-04-24,Spain,NA,Castilla-La Mancha,2034877,15,31,6587,1317
2020-04-25,Spain,NA,Castilla-La Mancha,2034877,14,28,6601,1320
2020-04-26,Spain,NA,Castilla-La Mancha,2034877,17,27,6618,1323
2020-04-27,Spain,NA,Castilla-La Mancha,2034877,24,25,6642,1328
2020-04-28,Spain,NA,Castilla-La Mancha,2034877,17,24,6659,1331
2020-04-29,Spain,NA,Castilla-La Mancha,2034877,8,29,6667,1333
2020-04-30,Spain,NA,Castilla-La Mancha,2034877,7,17,6674,1334
2020-05-01,Spain,NA,Castilla-La Mancha,2034877,9,12,6683,1336
2020-05-02,Spain,NA,Castilla-La Mancha,2034877,6,16,6689,1337
2020-05-03,Spain,NA,Castilla-La Mancha,2034877,6,16,6695,1339
2020-05-04,Spain,NA,Castilla-La Mancha,2034877,14,17,6709,1341
2020-05-05,Spain,NA,Castilla-La Mancha,2034877,11,21,6720,1344
2020-05-06,Spain,NA,Castilla-La Mancha,2034877,11,18,6731,1346
2020-05-07,Spain,NA,Castilla-La Mancha,2034877,13,10,6744,1348
2020-05-08,Spain,NA,Castilla-La Mancha,2034877,7,17,6751,1350
2020-05-09,Spain,NA,Castilla-La Mancha,2034877,7,14,6758,1351
2020-05-10,Spain,NA,Castilla-La Mancha,2034877,11,17,6769,1353
2020-05-11,Spain,NA,Castilla-La Mancha,2034877,27,13,6796,1359
2020-05-12,Spain,NA,Castilla-La Mancha,2034877,28,11,6824,1364
2020-05-13,Spain,NA,Castilla-La Mancha,2034877,34,12,6858,1371
2020-05-14,Spain,NA,Castilla-La Mancha,2034877,25,8,6883,1376
2020-05-15,Spain,NA,Castilla-La Mancha,2034877,32,7,6915,1383
2020-05-16,Spain,NA,Castilla-La Mancha,2034877,26,6,6941,1388
2020-05-17,Spain,NA,Castilla-La Mancha,2034877,9,3,6950,1390
2020-05-18,Spain,NA,Castilla-La Mancha,2034877,26,4,6976,1395
2020-05-19,Spain,NA,Castilla-La Mancha,2034877,29,10,7005,1401
2020-05-20,Spain,NA,Castilla-La Mancha,2034877,26,4,7031,1406
2020-05-21,Spain,NA,Castilla-La Mancha,2034877,18,13,7049,1409
2020-05-22,Spain,NA,Castilla-La Mancha,2034877,39,10,7088,1417
2020-05-23,Spain,NA,Castilla-La Mancha,2034877,28,6,7116,1423
2020-05-24,Spain,NA,Castilla-La Mancha,2034877,13,3,7129,1425
2020-05-25,Spain,NA,Castilla-La Mancha,2034877,36,6,7165,1433
2020-05-26,Spain,NA,Castilla-La Mancha,2034877,35,1,7200,1440
2020-05-27,Spain,NA,Castilla-La Mancha,2034877,39,2,7239,1447
2020-05-28,Spain,NA,Castilla-La Mancha,2034877,35,3,7274,1454
2020-05-29,Spain,NA,Castilla-La Mancha,2034877,28,2,7302,1460
2020-05-30,Spain,NA,Castilla-La Mancha,2034877,23,5,7325,1465
2020-05-31,Spain,NA,Castilla-La Mancha,2034877,11,3,7336,1467
2020-06-01,Spain,NA,Castilla-La Mancha,2034877,23,3,7359,1471
2020-06-02,Spain,NA,Castilla-La Mancha,2034877,17,3,7376,1475
2020-06-03,Spain,NA,Castilla-La Mancha,2034877,41,1,7417,1483
2020-06-04,Spain,NA,Castilla-La Mancha,2034877,30,2,7447,1489
2020-06-05,Spain,NA,Castilla-La Mancha,2034877,36,0,7483,1496
2020-06-06,Spain,NA,Castilla-La Mancha,2034877,18,0,7501,1500
2020-06-07,Spain,NA,Castilla-La Mancha,2034877,11,0,7512,1502
2020-06-08,Spain,NA,Castilla-La Mancha,2034877,32,0,7544,1508
2020-06-09,Spain,NA,Castilla-La Mancha,2034877,22,1,7566,1513
2020-06-10,Spain,NA,Castilla-La Mancha,2034877,21,1,7587,1517
2020-06-11,Spain,NA,Castilla-La Mancha,2034877,7,0,7594,1518
2020-06-12,Spain,NA,Castilla-La Mancha,2034877,18,0,7612,1522
2020-06-13,Spain,NA,Castilla-La Mancha,2034877,7,1,7619,1523
2020-06-14,Spain,NA,Castilla-La Mancha,2034877,9,1,7628,1525
2020-06-15,Spain,NA,Castilla-La Mancha,2034877,14,0,7642,1528
2020-06-16,Spain,NA,Castilla-La Mancha,2034877,21,0,7663,1532
2020-06-17,Spain,NA,Castilla-La Mancha,2034877,15,0,7678,1535
2020-06-18,Spain,NA,Castilla-La Mancha,2034877,11,1,7689,1537
2020-06-19,Spain,NA,Castilla-La Mancha,2034877,11,0,7700,1540
2020-06-20,Spain,NA,Castilla-La Mancha,2034877,14,0,7714,1542
2020-06-21,Spain,NA,Castilla-La Mancha,2034877,8,0,7722,1544
2020-06-22,Spain,NA,Castilla-La Mancha,2034877,12,0,7734,1546
2020-06-23,Spain,NA,Castilla-La Mancha,2034877,23,1,7757,1551
2020-06-24,Spain,NA,Castilla-La Mancha,2034877,20,0,7777,1555
2020-06-25,Spain,NA,Castilla-La Mancha,2034877,21,0,7798,1559
2020-06-26,Spain,NA,Castilla-La Mancha,2034877,12,1,7810,1562
2020-06-27,Spain,NA,Castilla-La Mancha,2034877,15,0,7825,1565
2020-06-28,Spain,NA,Castilla-La Mancha,2034877,12,2,7837,1567
2020-06-29,Spain,NA,Castilla-La Mancha,2034877,13,1,7850,1570
2020-06-30,Spain,NA,Castilla-La Mancha,2034877,12,1,7862,1572
2020-07-01,Spain,NA,Castilla-La Mancha,2034877,19,0,7881,1576
2020-07-02,Spain,NA,Castilla-La Mancha,2034877,14,0,7895,1579
2020-07-03,Spain,NA,Castilla-La Mancha,2034877,21,0,7916,1583
2020-07-04,Spain,NA,Castilla-La Mancha,2034877,10,0,7926,1585
2020-07-05,Spain,NA,Castilla-La Mancha,2034877,5,0,7931,1586
2020-07-06,Spain,NA,Castilla-La Mancha,2034877,19,0,7950,1590
2020-07-07,Spain,NA,Castilla-La Mancha,2034877,14,0,7964,1592
2020-07-08,Spain,NA,Castilla-La Mancha,2034877,18,0,7982,1596
2020-07-09,Spain,NA,Castilla-La Mancha,2034877,25,0,8007,1601
2020-07-10,Spain,NA,Castilla-La Mancha,2034877,24,1,8031,1606
2020-07-11,Spain,NA,Castilla-La Mancha,2034877,10,0,8041,1608
2020-07-12,Spain,NA,Castilla-La Mancha,2034877,10,0,8051,1610
2020-07-13,Spain,NA,Castilla-La Mancha,2034877,16,1,8067,1613
2020-07-14,Spain,NA,Castilla-La Mancha,2034877,23,0,8090,1618
2020-07-15,Spain,NA,Castilla-La Mancha,2034877,28,2,8118,1623
2020-07-16,Spain,NA,Castilla-La Mancha,2034877,25,0,8143,1628
2020-07-17,Spain,NA,Castilla-La Mancha,2034877,25,0,8168,1633
2020-07-18,Spain,NA,Castilla-La Mancha,2034877,12,0,8180,1636
2020-07-19,Spain,NA,Castilla-La Mancha,2034877,8,0,8188,1637
2020-07-20,Spain,NA,Castilla-La Mancha,2034877,28,0,8216,1643
2020-07-21,Spain,NA,Castilla-La Mancha,2034877,24,0,8240,1648
2020-07-22,Spain,NA,Castilla-La Mancha,2034877,41,0,8281,1656
2020-07-23,Spain,NA,Castilla-La Mancha,2034877,20,0,8301,1660
2020-07-24,Spain,NA,Castilla-La Mancha,2034877,44,0,8345,1669
2020-07-25,Spain,NA,Castilla-La Mancha,2034877,25,0,8370,1674
2020-07-26,Spain,NA,Castilla-La Mancha,2034877,23,0,8393,1678
2020-07-27,Spain,NA,Castilla-La Mancha,2034877,51,1,8444,1688
2020-07-28,Spain,NA,Castilla-La Mancha,2034877,55,0,8499,1699
2020-07-29,Spain,NA,Castilla-La Mancha,2034877,56,0,8555,1711
2020-07-30,Spain,NA,Castilla-La Mancha,2034877,44,0,8599,1719
2020-07-31,Spain,NA,Castilla-La Mancha,2034877,70,1,8669,1733
2020-08-01,Spain,NA,Castilla-La Mancha,2034877,58,0,8727,1745
2020-08-02,Spain,NA,Castilla-La Mancha,2034877,62,1,8789,1757
2020-08-03,Spain,NA,Castilla-La Mancha,2034877,77,0,8866,1773
2020-08-04,Spain,NA,Castilla-La Mancha,2034877,99,0,8965,1793
2020-08-05,Spain,NA,Castilla-La Mancha,2034877,95,0,9060,1812
2020-08-06,Spain,NA,Castilla-La Mancha,2034877,116,1,9176,1835
2020-08-07,Spain,NA,Castilla-La Mancha,2034877,114,0,9290,1858
2020-08-08,Spain,NA,Castilla-La Mancha,2034877,139,1,9429,1885
2020-08-09,Spain,NA,Castilla-La Mancha,2034877,120,0,9549,1909
2020-08-10,Spain,NA,Castilla-La Mancha,2034877,182,0,9731,1946
2020-08-11,Spain,NA,Castilla-La Mancha,2034877,203,1,9934,1986
2020-08-12,Spain,NA,Castilla-La Mancha,2034877,209,1,10143,2028
2020-08-13,Spain,NA,Castilla-La Mancha,2034877,253,0,10396,2079
2020-08-14,Spain,NA,Castilla-La Mancha,2034877,218,0,10614,2122
2020-08-15,Spain,NA,Castilla-La Mancha,2034877,204,0,10818,2163
2020-08-16,Spain,NA,Castilla-La Mancha,2034877,173,0,10991,2198
2020-08-17,Spain,NA,Castilla-La Mancha,2034877,259,0,11250,2250
2020-08-18,Spain,NA,Castilla-La Mancha,2034877,280,0,11530,2306
2020-08-19,Spain,NA,Castilla-La Mancha,2034877,300,0,11830,2366
2020-08-20,Spain,NA,Castilla-La Mancha,2034877,334,1,12164,2432
2020-08-21,Spain,NA,Castilla-La Mancha,2034877,384,0,12548,2509
2020-08-22,Spain,NA,Castilla-La Mancha,2034877,326,1,12874,2574
2020-08-23,Spain,NA,Castilla-La Mancha,2034877,307,0,13181,2636
2020-08-24,Spain,NA,Castilla-La Mancha,2034877,399,0,13580,2716
2020-08-25,Spain,NA,Castilla-La Mancha,2034877,393,1,13973,2794
2020-08-26,Spain,NA,Castilla-La Mancha,2034877,449,1,14422,2884
2020-08-27,Spain,NA,Castilla-La Mancha,2034877,492,0,14914,2920
2020-08-28,Spain,NA,Castilla-La Mancha,2034877,487,1,15401,2921
2020-08-29,Spain,NA,Castilla-La Mancha,2034877,380,1,15781,2922
2020-08-30,Spain,NA,Castilla-La Mancha,2034877,343,1,16124,2923
2020-08-31,Spain,NA,Castilla-La Mancha,2034877,478,0,16602,2923
2020-09-01,Spain,NA,Castilla-La Mancha,2034877,578,2,17180,2925
2020-09-02,Spain,NA,Castilla-La Mancha,2034877,653,2,17833,2927
2020-09-03,Spain,NA,Castilla-La Mancha,2034877,632,0,18465,2927
2020-09-04,Spain,NA,Castilla-La Mancha,2034877,622,2,19087,2929
2020-09-05,Spain,NA,Castilla-La Mancha,2034877,563,2,19650,2931
2020-09-06,Spain,NA,Castilla-La Mancha,2034877,404,1,20054,2932
2020-09-07,Spain,NA,Castilla-La Mancha,2034877,559,0,20613,2932
2020-09-08,Spain,NA,Castilla-La Mancha,2034877,611,2,21224,2934
2020-09-09,Spain,NA,Castilla-La Mancha,2034877,676,0,21900,2934
2020-09-10,Spain,NA,Castilla-La Mancha,2034877,795,1,22695,2935
2020-09-11,Spain,NA,Castilla-La Mancha,2034877,664,5,23359,2940
2020-09-12,Spain,NA,Castilla-La Mancha,2034877,634,1,23993,2941
2020-09-13,Spain,NA,Castilla-La Mancha,2034877,493,0,24486,2941
2020-09-14,Spain,NA,Castilla-La Mancha,2034877,616,1,25102,2942
2020-09-15,Spain,NA,Castilla-La Mancha,2034877,676,4,25778,2946
2020-09-16,Spain,NA,Castilla-La Mancha,2034877,661,5,26439,2951
2020-09-17,Spain,NA,Castilla-La Mancha,2034877,625,1,27064,2952
2020-09-18,Spain,NA,Castilla-La Mancha,2034877,561,4,27625,2956
2020-09-19,Spain,NA,Castilla-La Mancha,2034877,409,3,28034,2959
2020-09-20,Spain,NA,Castilla-La Mancha,2034877,237,3,28271,2962
2020-09-21,Spain,NA,Castilla-La Mancha,2034877,180,5,28451,2967
2020-09-22,Spain,NA,Castilla-La Mancha,2034877,212,0,28663,2967
2020-09-23,Spain,NA,Castilla-La Mancha,2034877,97,2,28760,2969
2020-02-03,Spain,NA,Cataluna,7566431,2,0,11,0
2020-02-04,Spain,NA,Cataluna,7566431,4,0,15,0
2020-02-05,Spain,NA,Cataluna,7566431,2,0,17,0
2020-02-06,Spain,NA,Cataluna,7566431,1,0,18,0
2020-02-07,Spain,NA,Cataluna,7566431,2,0,20,0
2020-02-08,Spain,NA,Cataluna,7566431,0,0,20,0
2020-02-09,Spain,NA,Cataluna,7566431,0,0,20,0
2020-02-10,Spain,NA,Cataluna,7566431,3,0,23,0
2020-02-11,Spain,NA,Cataluna,7566431,2,0,25,0
2020-02-12,Spain,NA,Cataluna,7566431,6,0,31,0
2020-02-13,Spain,NA,Cataluna,7566431,7,0,38,0
2020-02-14,Spain,NA,Cataluna,7566431,1,0,39,0
2020-02-15,Spain,NA,Cataluna,7566431,11,0,50,0
2020-02-16,Spain,NA,Cataluna,7566431,5,0,55,0
2020-02-17,Spain,NA,Cataluna,7566431,1,0,56,0
2020-02-18,Spain,NA,Cataluna,7566431,4,0,60,0
2020-02-19,Spain,NA,Cataluna,7566431,1,0,61,0
2020-02-20,Spain,NA,Cataluna,7566431,11,0,72,0
2020-02-21,Spain,NA,Cataluna,7566431,14,0,86,0
2020-02-22,Spain,NA,Cataluna,7566431,9,0,95,0
2020-02-23,Spain,NA,Cataluna,7566431,6,0,101,0
2020-02-24,Spain,NA,Cataluna,7566431,9,0,110,0
2020-02-25,Spain,NA,Cataluna,7566431,18,0,128,0
2020-02-26,Spain,NA,Cataluna,7566431,20,0,148,0
2020-02-27,Spain,NA,Cataluna,7566431,13,0,161,0
2020-02-28,Spain,NA,Cataluna,7566431,29,0,190,0
2020-02-29,Spain,NA,Cataluna,7566431,19,0,209,0
2020-03-01,Spain,NA,Cataluna,7566431,79,0,288,0
2020-03-02,Spain,NA,Cataluna,7566431,63,0,351,0
2020-03-03,Spain,NA,Cataluna,7566431,76,0,427,0
2020-03-04,Spain,NA,Cataluna,7566431,130,0,557,0
2020-03-05,Spain,NA,Cataluna,7566431,155,0,712,0
2020-03-06,Spain,NA,Cataluna,7566431,238,1,950,1
2020-03-07,Spain,NA,Cataluna,7566431,263,1,1213,2
2020-03-08,Spain,NA,Cataluna,7566431,303,0,1516,2
2020-03-09,Spain,NA,Cataluna,7566431,516,1,2032,3
2020-03-10,Spain,NA,Cataluna,7566431,729,1,2761,4
2020-03-11,Spain,NA,Cataluna,7566431,704,2,3465,6
2020-03-12,Spain,NA,Cataluna,7566431,971,5,4436,11
2020-03-13,Spain,NA,Cataluna,7566431,1268,11,5704,22
2020-03-14,Spain,NA,Cataluna,7566431,1238,12,6942,34
2020-03-15,Spain,NA,Cataluna,7566431,1292,7,8234,41
2020-03-16,Spain,NA,Cataluna,7566431,1545,19,9779,60
2020-03-17,Spain,NA,Cataluna,7566431,1476,23,11255,83
2020-03-18,Spain,NA,Cataluna,7566431,1583,37,12838,120
2020-03-19,Spain,NA,Cataluna,7566431,1523,49,14361,169
2020-03-20,Spain,NA,Cataluna,7566431,1793,63,16154,232
2020-03-21,Spain,NA,Cataluna,7566431,1388,74,17542,306
2020-03-22,Spain,NA,Cataluna,7566431,1237,88,18779,394
2020-03-23,Spain,NA,Cataluna,7566431,1409,126,20188,520
2020-03-24,Spain,NA,Cataluna,7566431,1336,122,21524,642
2020-03-25,Spain,NA,Cataluna,7566431,1253,153,22777,795
2020-03-26,Spain,NA,Cataluna,7566431,1320,156,24097,951
2020-03-27,Spain,NA,Cataluna,7566431,1196,174,25293,1125
2020-03-28,Spain,NA,Cataluna,7566431,1263,164,26556,1289
2020-03-29,Spain,NA,Cataluna,7566431,971,176,27527,1465
2020-03-30,Spain,NA,Cataluna,7566431,1106,198,28633,1663
2020-03-31,Spain,NA,Cataluna,7566431,1072,178,29705,1841
2020-04-01,Spain,NA,Cataluna,7566431,1220,179,30925,2020
2020-04-02,Spain,NA,Cataluna,7566431,1008,160,31933,2180
2020-04-03,Spain,NA,Cataluna,7566431,1167,160,33100,2340
2020-04-04,Spain,NA,Cataluna,7566431,930,149,34030,2489
2020-04-05,Spain,NA,Cataluna,7566431,806,133,34836,2622
2020-04-06,Spain,NA,Cataluna,7566431,738,152,35574,2774
2020-04-07,Spain,NA,Cataluna,7566431,680,145,36254,2919
2020-04-08,Spain,NA,Cataluna,7566431,953,152,37207,3071
2020-04-09,Spain,NA,Cataluna,7566431,1010,152,38217,3223
2020-04-10,Spain,NA,Cataluna,7566431,968,131,39185,3354
2020-04-11,Spain,NA,Cataluna,7566431,1030,119,40215,3473
2020-04-12,Spain,NA,Cataluna,7566431,646,116,40861,3589
2020-04-13,Spain,NA,Cataluna,7566431,552,113,41413,3702
2020-04-14,Spain,NA,Cataluna,7566431,699,118,42112,3820
2020-04-15,Spain,NA,Cataluna,7566431,728,109,42840,3929
2020-04-16,Spain,NA,Cataluna,7566431,702,101,43542,4030
2020-04-17,Spain,NA,Cataluna,7566431,585,109,44127,4139
2020-04-18,Spain,NA,Cataluna,7566431,430,92,44557,4231
2020-04-19,Spain,NA,Cataluna,7566431,258,87,44815,4318
2020-04-20,Spain,NA,Cataluna,7566431,342,68,45157,4386
2020-04-21,Spain,NA,Cataluna,7566431,180,75,45337,4461
2020-04-22,Spain,NA,Cataluna,7566431,302,68,45639,4529
2020-04-23,Spain,NA,Cataluna,7566431,267,52,45906,4581
2020-04-24,Spain,NA,Cataluna,7566431,245,62,46151,4643
2020-04-25,Spain,NA,Cataluna,7566431,162,63,46313,4706
2020-04-26,Spain,NA,Cataluna,7566431,133,68,46446,4774
2020-04-27,Spain,NA,Cataluna,7566431,127,58,46573,4832
2020-04-28,Spain,NA,Cataluna,7566431,152,65,46725,4897
2020-04-29,Spain,NA,Cataluna,7566431,139,58,46864,4955
2020-04-30,Spain,NA,Cataluna,7566431,177,51,47041,5006
2020-05-01,Spain,NA,Cataluna,7566431,155,47,47196,5053
2020-05-02,Spain,NA,Cataluna,7566431,149,45,47345,5098
2020-05-03,Spain,NA,Cataluna,7566431,131,54,47476,5152
2020-05-04,Spain,NA,Cataluna,7566431,116,44,47592,5196
2020-05-05,Spain,NA,Cataluna,7566431,57,45,47649,5241
2020-05-06,Spain,NA,Cataluna,7566431,42,32,47691,5273
2020-05-07,Spain,NA,Cataluna,7566431,62,42,47753,5315
2020-05-08,Spain,NA,Cataluna,7566431,64,30,47817,5345
2020-05-09,Spain,NA,Cataluna,7566431,51,20,47868,5365
2020-05-10,Spain,NA,Cataluna,7566431,81,23,47949,5388
2020-05-11,Spain,NA,Cataluna,7566431,97,31,48046,5419
2020-05-12,Spain,NA,Cataluna,7566431,107,17,48153,5436
2020-05-13,Spain,NA,Cataluna,7566431,126,14,48279,5450
2020-05-14,Spain,NA,Cataluna,7566431,107,17,48386,5467
2020-05-15,Spain,NA,Cataluna,7566431,169,17,48555,5484
2020-05-16,Spain,NA,Cataluna,7566431,125,12,48680,5496
2020-05-17,Spain,NA,Cataluna,7566431,89,9,48769,5505
2020-05-18,Spain,NA,Cataluna,7566431,159,7,48928,5512
2020-05-19,Spain,NA,Cataluna,7566431,159,13,49087,5525
2020-05-20,Spain,NA,Cataluna,7566431,125,14,49212,5539
2020-05-21,Spain,NA,Cataluna,7566431,149,11,49361,5550
2020-05-22,Spain,NA,Cataluna,7566431,201,14,49562,5564
2020-05-23,Spain,NA,Cataluna,7566431,117,14,49679,5578
2020-05-24,Spain,NA,Cataluna,7566431,132,8,49811,5586
2020-05-25,Spain,NA,Cataluna,7566431,162,11,49973,5597
2020-05-26,Spain,NA,Cataluna,7566431,144,5,50117,5602
2020-05-27,Spain,NA,Cataluna,7566431,110,8,50227,5610
2020-05-28,Spain,NA,Cataluna,7566431,149,7,50376,5617
2020-05-29,Spain,NA,Cataluna,7566431,134,8,50510,5625
2020-05-30,Spain,NA,Cataluna,7566431,89,7,50599,5632
2020-05-31,Spain,NA,Cataluna,7566431,53,6,50652,5638
2020-06-01,Spain,NA,Cataluna,7566431,87,1,50739,5639
2020-06-02,Spain,NA,Cataluna,7566431,93,3,50832,5642
2020-06-03,Spain,NA,Cataluna,7566431,102,4,50934,5646
2020-06-04,Spain,NA,Cataluna,7566431,93,6,51027,5652
2020-06-05,Spain,NA,Cataluna,7566431,148,2,51175,5654
2020-06-06,Spain,NA,Cataluna,7566431,64,0,51239,5654
2020-06-07,Spain,NA,Cataluna,7566431,52,0,51291,5654
2020-06-08,Spain,NA,Cataluna,7566431,95,3,51386,5657
2020-06-09,Spain,NA,Cataluna,7566431,57,0,51443,5657
2020-06-10,Spain,NA,Cataluna,7566431,78,2,51521,5659
2020-06-11,Spain,NA,Cataluna,7566431,67,0,51588,5659
2020-06-12,Spain,NA,Cataluna,7566431,83,1,51671,5660
2020-06-13,Spain,NA,Cataluna,7566431,34,2,51705,5662
2020-06-14,Spain,NA,Cataluna,7566431,43,2,51748,5664
2020-06-15,Spain,NA,Cataluna,7566431,59,2,51807,5666
2020-06-16,Spain,NA,Cataluna,7566431,68,0,51875,5666
2020-06-17,Spain,NA,Cataluna,7566431,81,0,51956,5666
2020-06-18,Spain,NA,Cataluna,7566431,89,0,52045,5666
2020-06-19,Spain,NA,Cataluna,7566431,78,0,52123,5666
2020-06-20,Spain,NA,Cataluna,7566431,83,0,52206,5666
2020-06-21,Spain,NA,Cataluna,7566431,73,1,52279,5667
2020-06-22,Spain,NA,Cataluna,7566431,93,0,52372,5667
2020-06-23,Spain,NA,Cataluna,7566431,102,1,52474,5668
2020-06-24,Spain,NA,Cataluna,7566431,92,0,52566,5668
2020-06-25,Spain,NA,Cataluna,7566431,112,2,52678,5670
2020-06-26,Spain,NA,Cataluna,7566431,162,0,52840,5670
2020-06-27,Spain,NA,Cataluna,7566431,119,0,52959,5670
2020-06-28,Spain,NA,Cataluna,7566431,103,0,53062,5670
2020-06-29,Spain,NA,Cataluna,7566431,164,1,53226,5671
2020-06-30,Spain,NA,Cataluna,7566431,167,1,53393,5672
2020-07-01,Spain,NA,Cataluna,7566431,275,1,53668,5673
2020-07-02,Spain,NA,Cataluna,7566431,218,0,53886,5673
2020-07-03,Spain,NA,Cataluna,7566431,268,1,54154,5674
2020-07-04,Spain,NA,Cataluna,7566431,252,1,54406,5675
2020-07-05,Spain,NA,Cataluna,7566431,257,0,54663,5675
2020-07-06,Spain,NA,Cataluna,7566431,372,0,55035,5675
2020-07-07,Spain,NA,Cataluna,7566431,428,0,55463,5675
2020-07-08,Spain,NA,Cataluna,7566431,477,0,55940,5675
2020-07-09,Spain,NA,Cataluna,7566431,507,1,56447,5676
2020-07-10,Spain,NA,Cataluna,7566431,642,0,57089,5676
2020-07-11,Spain,NA,Cataluna,7566431,404,1,57493,5677
2020-07-12,Spain,NA,Cataluna,7566431,456,0,57949,5677
2020-07-13,Spain,NA,Cataluna,7566431,719,0,58668,5677
2020-07-14,Spain,NA,Cataluna,7566431,668,0,59336,5677
2020-07-15,Spain,NA,Cataluna,7566431,884,0,60220,5677
2020-07-16,Spain,NA,Cataluna,7566431,802,0,61022,5677
2020-07-17,Spain,NA,Cataluna,7566431,978,1,62000,5678
2020-07-18,Spain,NA,Cataluna,7566431,759,1,62759,5679
2020-07-19,Spain,NA,Cataluna,7566431,601,0,63360,5679
2020-07-20,Spain,NA,Cataluna,7566431,1044,0,64404,5679
2020-07-21,Spain,NA,Cataluna,7566431,974,2,65378,5681
2020-07-22,Spain,NA,Cataluna,7566431,1027,1,66405,5682
2020-07-23,Spain,NA,Cataluna,7566431,1009,1,67414,5683
2020-07-24,Spain,NA,Cataluna,7566431,1039,2,68453,5685
2020-07-25,Spain,NA,Cataluna,7566431,654,3,69107,5688
2020-07-26,Spain,NA,Cataluna,7566431,570,5,69677,5693
2020-07-27,Spain,NA,Cataluna,7566431,1005,6,70682,5699
2020-07-28,Spain,NA,Cataluna,7566431,1040,0,71722,5699
2020-07-29,Spain,NA,Cataluna,7566431,1083,0,72805,5699
2020-07-30,Spain,NA,Cataluna,7566431,1027,2,73832,5701
2020-07-31,Spain,NA,Cataluna,7566431,1144,1,74976,5702
2020-08-01,Spain,NA,Cataluna,7566431,719,2,75695,5704
2020-08-02,Spain,NA,Cataluna,7566431,474,1,76169,5705
2020-08-03,Spain,NA,Cataluna,7566431,915,0,77084,5705
2020-08-04,Spain,NA,Cataluna,7566431,1000,0,78084,5705
2020-08-05,Spain,NA,Cataluna,7566431,1008,2,79092,5707
2020-08-06,Spain,NA,Cataluna,7566431,942,4,80034,5711
2020-08-07,Spain,NA,Cataluna,7566431,1142,0,81176,5711
2020-08-08,Spain,NA,Cataluna,7566431,707,0,81883,5711
2020-08-09,Spain,NA,Cataluna,7566431,527,3,82410,5714
2020-08-10,Spain,NA,Cataluna,7566431,1063,2,83473,5716
2020-08-11,Spain,NA,Cataluna,7566431,974,1,84447,5717
2020-08-12,Spain,NA,Cataluna,7566431,1053,0,85500,5717
2020-08-13,Spain,NA,Cataluna,7566431,998,3,86498,5720
2020-08-14,Spain,NA,Cataluna,7566431,1111,3,87609,5723
2020-08-15,Spain,NA,Cataluna,7566431,769,4,88378,5727
2020-08-16,Spain,NA,Cataluna,7566431,706,2,89084,5729
2020-08-17,Spain,NA,Cataluna,7566431,1109,4,90193,5733
2020-08-18,Spain,NA,Cataluna,7566431,1174,3,91367,5736
2020-08-19,Spain,NA,Cataluna,7566431,1073,3,92440,5739
2020-08-20,Spain,NA,Cataluna,7566431,1229,5,93669,5744
2020-08-21,Spain,NA,Cataluna,7566431,1232,2,94901,5746
2020-08-22,Spain,NA,Cataluna,7566431,751,1,95652,5747
2020-08-23,Spain,NA,Cataluna,7566431,672,2,96324,5749
2020-08-24,Spain,NA,Cataluna,7566431,1261,6,97585,5755
2020-08-25,Spain,NA,Cataluna,7566431,1153,1,98738,5756
2020-08-26,Spain,NA,Cataluna,7566431,1253,1,99991,5757
2020-08-27,Spain,NA,Cataluna,7566431,1210,3,101201,5760
2020-08-28,Spain,NA,Cataluna,7566431,1201,3,102402,5763
2020-08-29,Spain,NA,Cataluna,7566431,667,1,103069,5764
2020-08-30,Spain,NA,Cataluna,7566431,584,2,103653,5766
2020-08-31,Spain,NA,Cataluna,7566431,1148,2,104801,5768
2020-09-01,Spain,NA,Cataluna,7566431,1212,4,106013,5772
2020-09-02,Spain,NA,Cataluna,7566431,1097,2,107110,5774
2020-09-03,Spain,NA,Cataluna,7566431,1135,2,108245,5776
2020-09-04,Spain,NA,Cataluna,7566431,1253,1,109498,5777
2020-09-05,Spain,NA,Cataluna,7566431,744,4,110242,5781
2020-09-06,Spain,NA,Cataluna,7566431,538,1,110780,5782
2020-09-07,Spain,NA,Cataluna,7566431,974,1,111754,5783
2020-09-08,Spain,NA,Cataluna,7566431,1069,4,112823,5787
2020-09-09,Spain,NA,Cataluna,7566431,1001,6,113824,5793
2020-09-10,Spain,NA,Cataluna,7566431,1194,5,115018,5798
2020-09-11,Spain,NA,Cataluna,7566431,703,2,115721,5800
2020-09-12,Spain,NA,Cataluna,7566431,765,2,116486,5802
2020-09-13,Spain,NA,Cataluna,7566431,554,1,117040,5803
2020-09-14,Spain,NA,Cataluna,7566431,999,6,118039,5809
2020-09-15,Spain,NA,Cataluna,7566431,1109,1,119148,5810
2020-09-16,Spain,NA,Cataluna,7566431,1131,4,120279,5814
2020-09-17,Spain,NA,Cataluna,7566431,969,4,121248,5818
2020-09-18,Spain,NA,Cataluna,7566431,1026,1,122274,5819
2020-09-19,Spain,NA,Cataluna,7566431,462,0,122736,5819
2020-09-20,Spain,NA,Cataluna,7566431,323,0,123059,5819
2020-09-21,Spain,NA,Cataluna,7566431,836,1,123895,5820
2020-09-22,Spain,NA,Cataluna,7566431,885,0,124780,5820
2020-09-23,Spain,NA,Cataluna,7566431,119,0,124899,5820
2020-02-01,Spain,NA,Comunidad de Madrid,6641649,8,0,12,0
2020-02-02,Spain,NA,Comunidad de Madrid,6641649,6,0,18,0
2020-02-03,Spain,NA,Comunidad de Madrid,6641649,7,0,25,0
2020-02-04,Spain,NA,Comunidad de Madrid,6641649,3,0,28,0
2020-02-05,Spain,NA,Comunidad de Madrid,6641649,4,0,32,0
2020-02-06,Spain,NA,Comunidad de Madrid,6641649,4,0,36,0
2020-02-07,Spain,NA,Comunidad de Madrid,6641649,9,0,45,0
2020-02-08,Spain,NA,Comunidad de Madrid,6641649,8,0,53,0
2020-02-09,Spain,NA,Comunidad de Madrid,6641649,2,0,55,0
2020-02-10,Spain,NA,Comunidad de Madrid,6641649,11,0,66,0
2020-02-11,Spain,NA,Comunidad de Madrid,6641649,9,0,75,0
2020-02-12,Spain,NA,Comunidad de Madrid,6641649,10,0,85,0
2020-02-13,Spain,NA,Comunidad de Madrid,6641649,15,0,100,0
2020-02-14,Spain,NA,Comunidad de Madrid,6641649,11,0,111,0
2020-02-15,Spain,NA,Comunidad de Madrid,6641649,12,0,123,0
2020-02-16,Spain,NA,Comunidad de Madrid,6641649,15,0,138,0
2020-02-17,Spain,NA,Comunidad de Madrid,6641649,18,0,156,0
2020-02-18,Spain,NA,Comunidad de Madrid,6641649,14,0,170,0
2020-02-19,Spain,NA,Comunidad de Madrid,6641649,12,0,182,0
2020-02-20,Spain,NA,Comunidad de Madrid,6641649,24,0,206,0
2020-02-21,Spain,NA,Comunidad de Madrid,6641649,27,0,233,0
2020-02-22,Spain,NA,Comunidad de Madrid,6641649,30,0,263,0
2020-02-23,Spain,NA,Comunidad de Madrid,6641649,44,0,307,0
2020-02-24,Spain,NA,Comunidad de Madrid,6641649,57,0,364,0
2020-02-25,Spain,NA,Comunidad de Madrid,6641649,50,0,414,0
2020-02-26,Spain,NA,Comunidad de Madrid,6641649,69,0,483,0
2020-02-27,Spain,NA,Comunidad de Madrid,6641649,96,0,579,0
2020-02-28,Spain,NA,Comunidad de Madrid,6641649,161,0,740,0
2020-02-29,Spain,NA,Comunidad de Madrid,6641649,108,0,848,0
2020-03-01,Spain,NA,Comunidad de Madrid,6641649,325,0,1173,0
2020-03-02,Spain,NA,Comunidad de Madrid,6641649,384,0,1557,0
2020-03-03,Spain,NA,Comunidad de Madrid,6641649,399,1,1956,1
2020-03-04,Spain,NA,Comunidad de Madrid,6641649,462,0,2418,1
2020-03-05,Spain,NA,Comunidad de Madrid,6641649,649,1,3067,2
2020-03-06,Spain,NA,Comunidad de Madrid,6641649,786,2,3853,4
2020-03-07,Spain,NA,Comunidad de Madrid,6641649,840,1,4693,5
2020-03-08,Spain,NA,Comunidad de Madrid,6641649,1054,10,5747,15
2020-03-09,Spain,NA,Comunidad de Madrid,6641649,1516,9,7263,24
2020-03-10,Spain,NA,Comunidad de Madrid,6641649,1981,23,9244,47
2020-03-11,Spain,NA,Comunidad de Madrid,6641649,1972,25,11216,72
2020-03-12,Spain,NA,Comunidad de Madrid,6641649,2336,38,13552,110
2020-03-13,Spain,NA,Comunidad de Madrid,6641649,2832,48,16384,158
2020-03-14,Spain,NA,Comunidad de Madrid,6641649,2550,62,18934,220
2020-03-15,Spain,NA,Comunidad de Madrid,6641649,2660,79,21594,299
2020-03-16,Spain,NA,Comunidad de Madrid,6641649,2950,109,24544,408
2020-03-17,Spain,NA,Comunidad de Madrid,6641649,2786,107,27330,515
2020-03-18,Spain,NA,Comunidad de Madrid,6641649,2632,114,29962,629
2020-03-19,Spain,NA,Comunidad de Madrid,6641649,2428,153,32390,782
2020-03-20,Spain,NA,Comunidad de Madrid,6641649,3101,209,35491,991
2020-03-21,Spain,NA,Comunidad de Madrid,6641649,1917,234,37408,1225
2020-03-22,Spain,NA,Comunidad de Madrid,6641649,1642,226,39050,1451
2020-03-23,Spain,NA,Comunidad de Madrid,6641649,2124,267,41174,1718
2020-03-24,Spain,NA,Comunidad de Madrid,6641649,1984,281,43158,1999
2020-03-25,Spain,NA,Comunidad de Madrid,6641649,1774,282,44932,2281
2020-03-26,Spain,NA,Comunidad de Madrid,6641649,1547,289,46479,2570
2020-03-27,Spain,NA,Comunidad de Madrid,6641649,1491,327,47970,2897
2020-03-28,Spain,NA,Comunidad de Madrid,6641649,1252,273,49222,3170
2020-03-29,Spain,NA,Comunidad de Madrid,6641649,870,242,50092,3412
2020-03-30,Spain,NA,Comunidad de Madrid,6641649,1085,233,51177,3645
2020-03-31,Spain,NA,Comunidad de Madrid,6641649,1074,246,52251,3891
2020-04-01,Spain,NA,Comunidad de Madrid,6641649,1349,263,53600,4154
2020-04-02,Spain,NA,Comunidad de Madrid,6641649,1003,246,54603,4400
2020-04-03,Spain,NA,Comunidad de Madrid,6641649,934,180,55537,4580
2020-04-04,Spain,NA,Comunidad de Madrid,6641649,715,139,56252,4719
2020-04-05,Spain,NA,Comunidad de Madrid,6641649,634,185,56886,4904
2020-04-06,Spain,NA,Comunidad de Madrid,6641649,625,188,57511,5092
2020-04-07,Spain,NA,Comunidad de Madrid,6641649,745,170,58256,5262
2020-04-08,Spain,NA,Comunidad de Madrid,6641649,682,172,58938,5434
2020-04-09,Spain,NA,Comunidad de Madrid,6641649,635,119,59573,5553
2020-04-10,Spain,NA,Comunidad de Madrid,6641649,707,154,60280,5707
2020-04-11,Spain,NA,Comunidad de Madrid,6641649,574,139,60854,5846
2020-04-12,Spain,NA,Comunidad de Madrid,6641649,500,123,61354,5969
2020-04-13,Spain,NA,Comunidad de Madrid,6641649,379,140,61733,6109
2020-04-14,Spain,NA,Comunidad de Madrid,6641649,495,132,62228,6241
2020-04-15,Spain,NA,Comunidad de Madrid,6641649,503,129,62731,6370
2020-04-16,Spain,NA,Comunidad de Madrid,6641649,595,109,63326,6479
2020-04-17,Spain,NA,Comunidad de Madrid,6641649,388,107,63714,6586
2020-04-18,Spain,NA,Comunidad de Madrid,6641649,468,92,64182,6678
2020-04-19,Spain,NA,Comunidad de Madrid,6641649,264,99,64446,6777
2020-04-20,Spain,NA,Comunidad de Madrid,6641649,279,98,64725,6875
2020-04-21,Spain,NA,Comunidad de Madrid,6641649,479,99,65204,6974
2020-04-22,Spain,NA,Comunidad de Madrid,6641649,457,83,65661,7057
2020-04-23,Spain,NA,Comunidad de Madrid,6641649,372,76,66033,7133
2020-04-24,Spain,NA,Comunidad de Madrid,6641649,237,80,66270,7213
2020-04-25,Spain,NA,Comunidad de Madrid,6641649,131,64,66401,7277
2020-04-26,Spain,NA,Comunidad de Madrid,6641649,124,58,66525,7335
2020-04-27,Spain,NA,Comunidad de Madrid,6641649,187,54,66712,7389
2020-04-28,Spain,NA,Comunidad de Madrid,6641649,234,46,66946,7435
2020-04-29,Spain,NA,Comunidad de Madrid,6641649,214,55,67160,7490
2020-04-30,Spain,NA,Comunidad de Madrid,6641649,177,54,67337,7544
2020-05-01,Spain,NA,Comunidad de Madrid,6641649,195,40,67532,7584
2020-05-02,Spain,NA,Comunidad de Madrid,6641649,167,47,67699,7631
2020-05-03,Spain,NA,Comunidad de Madrid,6641649,73,41,67772,7672
2020-05-04,Spain,NA,Comunidad de Madrid,6641649,105,46,67877,7718
2020-05-05,Spain,NA,Comunidad de Madrid,6641649,58,35,67935,7753
2020-05-06,Spain,NA,Comunidad de Madrid,6641649,53,36,67988,7789
2020-05-07,Spain,NA,Comunidad de Madrid,6641649,64,41,68052,7830
2020-05-08,Spain,NA,Comunidad de Madrid,6641649,69,40,68121,7870
2020-05-09,Spain,NA,Comunidad de Madrid,6641649,62,41,68183,7911
2020-05-10,Spain,NA,Comunidad de Madrid,6641649,70,20,68253,7931
2020-05-11,Spain,NA,Comunidad de Madrid,6641649,180,29,68433,7960
2020-05-12,Spain,NA,Comunidad de Madrid,6641649,129,32,68562,7992
2020-05-13,Spain,NA,Comunidad de Madrid,6641649,139,25,68701,8017
2020-05-14,Spain,NA,Comunidad de Madrid,6641649,154,24,68855,8041
2020-05-15,Spain,NA,Comunidad de Madrid,6641649,128,19,68983,8060
2020-05-16,Spain,NA,Comunidad de Madrid,6641649,52,15,69035,8075
2020-05-17,Spain,NA,Comunidad de Madrid,6641649,83,14,69118,8089
2020-05-18,Spain,NA,Comunidad de Madrid,6641649,129,23,69247,8112
2020-05-19,Spain,NA,Comunidad de Madrid,6641649,136,18,69383,8130
2020-05-20,Spain,NA,Comunidad de Madrid,6641649,103,17,69486,8147
2020-05-21,Spain,NA,Comunidad de Madrid,6641649,118,12,69604,8159
2020-05-22,Spain,NA,Comunidad de Madrid,6641649,86,15,69690,8174
2020-05-23,Spain,NA,Comunidad de Madrid,6641649,56,21,69746,8195
2020-05-24,Spain,NA,Comunidad de Madrid,6641649,45,19,69791,8214
2020-05-25,Spain,NA,Comunidad de Madrid,6641649,141,17,69932,8231
2020-05-26,Spain,NA,Comunidad de Madrid,6641649,159,14,70091,8245
2020-05-27,Spain,NA,Comunidad de Madrid,6641649,87,7,70178,8252
2020-05-28,Spain,NA,Comunidad de Madrid,6641649,122,7,70300,8259
2020-05-29,Spain,NA,Comunidad de Madrid,6641649,116,10,70416,8269
2020-05-30,Spain,NA,Comunidad de Madrid,6641649,54,4,70470,8273
2020-05-31,Spain,NA,Comunidad de Madrid,6641649,72,9,70542,8282
2020-06-01,Spain,NA,Comunidad de Madrid,6641649,147,9,70689,8291
2020-06-02,Spain,NA,Comunidad de Madrid,6641649,116,10,70805,8301
2020-06-03,Spain,NA,Comunidad de Madrid,6641649,138,6,70943,8307
2020-06-04,Spain,NA,Comunidad de Madrid,6641649,96,8,71039,8315
2020-06-05,Spain,NA,Comunidad de Madrid,6641649,128,4,71167,8319
2020-06-06,Spain,NA,Comunidad de Madrid,6641649,68,8,71235,8327
2020-06-07,Spain,NA,Comunidad de Madrid,6641649,51,3,71286,8330
2020-06-08,Spain,NA,Comunidad de Madrid,6641649,126,4,71412,8334
2020-06-09,Spain,NA,Comunidad de Madrid,6641649,106,5,71518,8339
2020-06-10,Spain,NA,Comunidad de Madrid,6641649,112,7,71630,8346
2020-06-11,Spain,NA,Comunidad de Madrid,6641649,94,6,71724,8352
2020-06-12,Spain,NA,Comunidad de Madrid,6641649,116,3,71840,8355
2020-06-13,Spain,NA,Comunidad de Madrid,6641649,23,1,71863,8356
2020-06-14,Spain,NA,Comunidad de Madrid,6641649,41,4,71904,8360
2020-06-15,Spain,NA,Comunidad de Madrid,6641649,124,3,72028,8363
2020-06-16,Spain,NA,Comunidad de Madrid,6641649,53,4,72081,8367
2020-06-17,Spain,NA,Comunidad de Madrid,6641649,81,1,72162,8368
2020-06-18,Spain,NA,Comunidad de Madrid,6641649,71,0,72233,8368
2020-06-19,Spain,NA,Comunidad de Madrid,6641649,59,2,72292,8370
2020-06-20,Spain,NA,Comunidad de Madrid,6641649,39,1,72331,8371
2020-06-21,Spain,NA,Comunidad de Madrid,6641649,27,0,72358,8371
2020-06-22,Spain,NA,Comunidad de Madrid,6641649,37,1,72395,8372
2020-06-23,Spain,NA,Comunidad de Madrid,6641649,44,1,72439,8373
2020-06-24,Spain,NA,Comunidad de Madrid,6641649,42,1,72481,8374
2020-06-25,Spain,NA,Comunidad de Madrid,6641649,55,2,72536,8376
2020-06-26,Spain,NA,Comunidad de Madrid,6641649,53,1,72589,8377
2020-06-27,Spain,NA,Comunidad de Madrid,6641649,20,1,72609,8378
2020-06-28,Spain,NA,Comunidad de Madrid,6641649,30,2,72639,8380
2020-06-29,Spain,NA,Comunidad de Madrid,6641649,49,0,72688,8380
2020-06-30,Spain,NA,Comunidad de Madrid,6641649,63,1,72751,8381
2020-07-01,Spain,NA,Comunidad de Madrid,6641649,62,2,72813,8383
2020-07-02,Spain,NA,Comunidad de Madrid,6641649,44,0,72857,8383
2020-07-03,Spain,NA,Comunidad de Madrid,6641649,76,0,72933,8383
2020-07-04,Spain,NA,Comunidad de Madrid,6641649,27,1,72960,8384
2020-07-05,Spain,NA,Comunidad de Madrid,6641649,32,0,72992,8384
2020-07-06,Spain,NA,Comunidad de Madrid,6641649,61,0,73053,8384
2020-07-07,Spain,NA,Comunidad de Madrid,6641649,58,1,73111,8385
2020-07-08,Spain,NA,Comunidad de Madrid,6641649,83,0,73194,8385
2020-07-09,Spain,NA,Comunidad de Madrid,6641649,82,1,73276,8386
2020-07-10,Spain,NA,Comunidad de Madrid,6641649,70,0,73346,8386
2020-07-11,Spain,NA,Comunidad de Madrid,6641649,54,0,73400,8386
2020-07-12,Spain,NA,Comunidad de Madrid,6641649,59,0,73459,8386
2020-07-13,Spain,NA,Comunidad de Madrid,6641649,103,1,73562,8387
2020-07-14,Spain,NA,Comunidad de Madrid,6641649,117,0,73679,8387
2020-07-15,Spain,NA,Comunidad de Madrid,6641649,127,1,73806,8388
2020-07-16,Spain,NA,Comunidad de Madrid,6641649,107,0,73913,8388
2020-07-17,Spain,NA,Comunidad de Madrid,6641649,157,0,74070,8388
2020-07-18,Spain,NA,Comunidad de Madrid,6641649,117,0,74187,8388
2020-07-19,Spain,NA,Comunidad de Madrid,6641649,122,1,74309,8389
2020-07-20,Spain,NA,Comunidad de Madrid,6641649,192,1,74501,8390
2020-07-21,Spain,NA,Comunidad de Madrid,6641649,232,1,74733,8391
2020-07-22,Spain,NA,Comunidad de Madrid,6641649,223,1,74956,8392
2020-07-23,Spain,NA,Comunidad de Madrid,6641649,214,0,75170,8392
2020-07-24,Spain,NA,Comunidad de Madrid,6641649,331,1,75501,8393
2020-07-25,Spain,NA,Comunidad de Madrid,6641649,281,0,75782,8393
2020-07-26,Spain,NA,Comunidad de Madrid,6641649,233,0,76015,8393
2020-07-27,Spain,NA,Comunidad de Madrid,6641649,491,0,76506,8393
2020-07-28,Spain,NA,Comunidad de Madrid,6641649,568,0,77074,8393
2020-07-29,Spain,NA,Comunidad de Madrid,6641649,514,0,77588,8393
2020-07-30,Spain,NA,Comunidad de Madrid,6641649,563,2,78151,8395
2020-07-31,Spain,NA,Comunidad de Madrid,6641649,709,1,78860,8396
2020-08-01,Spain,NA,Comunidad de Madrid,6641649,676,0,79536,8396
2020-08-02,Spain,NA,Comunidad de Madrid,6641649,571,3,80107,8399
2020-08-03,Spain,NA,Comunidad de Madrid,6641649,943,1,81050,8400
2020-08-04,Spain,NA,Comunidad de Madrid,6641649,1089,1,82139,8401
2020-08-05,Spain,NA,Comunidad de Madrid,6641649,1079,2,83218,8403
2020-08-06,Spain,NA,Comunidad de Madrid,6641649,1087,0,84305,8403
2020-08-07,Spain,NA,Comunidad de Madrid,6641649,1362,4,85667,8407
2020-08-08,Spain,NA,Comunidad de Madrid,6641649,1009,4,86676,8411
2020-08-09,Spain,NA,Comunidad de Madrid,6641649,949,1,87625,8412
2020-08-10,Spain,NA,Comunidad de Madrid,6641649,1490,5,89115,8417
2020-08-11,Spain,NA,Comunidad de Madrid,6641649,1943,4,91058,8421
2020-08-12,Spain,NA,Comunidad de Madrid,6641649,1737,4,92795,8425
2020-08-13,Spain,NA,Comunidad de Madrid,6641649,1674,7,94469,8432
2020-08-14,Spain,NA,Comunidad de Madrid,6641649,2231,9,96700,8441
2020-08-15,Spain,NA,Comunidad de Madrid,6641649,1183,7,97883,8448
2020-08-16,Spain,NA,Comunidad de Madrid,6641649,923,8,98806,8456
2020-08-17,Spain,NA,Comunidad de Madrid,6641649,1529,7,100335,8463
2020-08-18,Spain,NA,Comunidad de Madrid,6641649,2700,9,103035,8472
2020-08-19,Spain,NA,Comunidad de Madrid,6641649,2946,7,105981,8479
2020-08-20,Spain,NA,Comunidad de Madrid,6641649,2697,9,108678,8488
2020-08-21,Spain,NA,Comunidad de Madrid,6641649,3923,7,112601,8495
2020-08-22,Spain,NA,Comunidad de Madrid,6641649,1510,8,114111,8503
2020-08-23,Spain,NA,Comunidad de Madrid,6641649,1077,14,115188,8517
2020-08-24,Spain,NA,Comunidad de Madrid,6641649,1789,15,116977,8532
2020-08-25,Spain,NA,Comunidad de Madrid,6641649,3698,11,120675,8543
2020-08-26,Spain,NA,Comunidad de Madrid,6641649,3098,10,123773,8553
2020-08-27,Spain,NA,Comunidad de Madrid,6641649,3083,14,126856,8567
2020-08-28,Spain,NA,Comunidad de Madrid,6641649,4254,19,131110,8586
2020-08-29,Spain,NA,Comunidad de Madrid,6641649,1707,9,132817,8595
2020-08-30,Spain,NA,Comunidad de Madrid,6641649,1538,12,134355,8607
2020-08-31,Spain,NA,Comunidad de Madrid,6641649,2084,19,136439,8626
2020-09-01,Spain,NA,Comunidad de Madrid,6641649,4042,11,140481,8637
2020-09-02,Spain,NA,Comunidad de Madrid,6641649,3640,19,144121,8656
2020-09-03,Spain,NA,Comunidad de Madrid,6641649,3637,25,147758,8681
2020-09-04,Spain,NA,Comunidad de Madrid,6641649,4392,21,152150,8702
2020-09-05,Spain,NA,Comunidad de Madrid,6641649,2567,9,154717,8711
2020-09-06,Spain,NA,Comunidad de Madrid,6641649,2214,14,156931,8725
2020-09-07,Spain,NA,Comunidad de Madrid,6641649,2928,20,159859,8745
2020-09-08,Spain,NA,Comunidad de Madrid,6641649,4185,20,164044,8765
2020-09-09,Spain,NA,Comunidad de Madrid,6641649,4613,13,168657,8778
2020-09-10,Spain,NA,Comunidad de Madrid,6641649,3988,23,172645,8801
2020-09-11,Spain,NA,Comunidad de Madrid,6641649,4809,22,177454,8823
2020-09-12,Spain,NA,Comunidad de Madrid,6641649,2856,33,180310,8856
2020-09-13,Spain,NA,Comunidad de Madrid,6641649,2185,29,182495,8885
2020-09-14,Spain,NA,Comunidad de Madrid,6641649,3118,22,185613,8907
2020-09-15,Spain,NA,Comunidad de Madrid,6641649,4283,30,189896,8937
2020-09-16,Spain,NA,Comunidad de Madrid,6641649,4076,24,193972,8961
2020-09-17,Spain,NA,Comunidad de Madrid,6641649,3988,33,197960,8994
2020-09-18,Spain,NA,Comunidad de Madrid,6641649,5918,37,203878,9031
2020-09-19,Spain,NA,Comunidad de Madrid,6641649,1459,38,205337,9069
2020-09-20,Spain,NA,Comunidad de Madrid,6641649,922,33,206259,9102
2020-09-21,Spain,NA,Comunidad de Madrid,6641649,1387,30,207646,9132
2020-09-22,Spain,NA,Comunidad de Madrid,6641649,1969,5,209615,9137
2020-09-23,Spain,NA,Comunidad de Madrid,6641649,1043,0,210658,9137
2020-02-12,Spain,NA,Comunidad Valenciana,4974969,1,0,11,0
2020-02-13,Spain,NA,Comunidad Valenciana,4974969,1,1,12,1
2020-02-14,Spain,NA,Comunidad Valenciana,4974969,2,0,14,1
2020-02-15,Spain,NA,Comunidad Valenciana,4974969,4,0,18,1
2020-02-16,Spain,NA,Comunidad Valenciana,4974969,1,0,19,1
2020-02-17,Spain,NA,Comunidad Valenciana,4974969,3,0,22,1
2020-02-18,Spain,NA,Comunidad Valenciana,4974969,1,0,23,1
2020-02-19,Spain,NA,Comunidad Valenciana,4974969,1,0,24,1
2020-02-20,Spain,NA,Comunidad Valenciana,4974969,3,0,27,1
2020-02-21,Spain,NA,Comunidad Valenciana,4974969,2,0,29,1
2020-02-22,Spain,NA,Comunidad Valenciana,4974969,2,0,31,1
2020-02-23,Spain,NA,Comunidad Valenciana,4974969,5,0,36,1
2020-02-24,Spain,NA,Comunidad Valenciana,4974969,13,0,49,1
2020-02-25,Spain,NA,Comunidad Valenciana,4974969,8,0,57,1
2020-02-26,Spain,NA,Comunidad Valenciana,4974969,8,0,65,1
2020-02-27,Spain,NA,Comunidad Valenciana,4974969,15,0,80,1
2020-02-28,Spain,NA,Comunidad Valenciana,4974969,22,0,102,1
2020-02-29,Spain,NA,Comunidad Valenciana,4974969,14,0,116,1
2020-03-01,Spain,NA,Comunidad Valenciana,4974969,34,0,150,1
2020-03-02,Spain,NA,Comunidad Valenciana,4974969,36,0,186,1
2020-03-03,Spain,NA,Comunidad Valenciana,4974969,26,0,212,1
2020-03-04,Spain,NA,Comunidad Valenciana,4974969,34,0,246,1
2020-03-05,Spain,NA,Comunidad Valenciana,4974969,46,0,292,1
2020-03-06,Spain,NA,Comunidad Valenciana,4974969,66,0,358,1
2020-03-07,Spain,NA,Comunidad Valenciana,4974969,64,0,422,1
2020-03-08,Spain,NA,Comunidad Valenciana,4974969,99,0,521,1
2020-03-09,Spain,NA,Comunidad Valenciana,4974969,162,0,683,1
2020-03-10,Spain,NA,Comunidad Valenciana,4974969,266,0,949,1
2020-03-11,Spain,NA,Comunidad Valenciana,4974969,263,0,1212,1
2020-03-12,Spain,NA,Comunidad Valenciana,4974969,358,0,1570,1
2020-03-13,Spain,NA,Comunidad Valenciana,4974969,444,2,2014,3
2020-03-14,Spain,NA,Comunidad Valenciana,4974969,452,7,2466,10
2020-03-15,Spain,NA,Comunidad Valenciana,4974969,469,4,2935,14
2020-03-16,Spain,NA,Comunidad Valenciana,4974969,572,4,3507,18
2020-03-17,Spain,NA,Comunidad Valenciana,4974969,509,2,4016,20
2020-03-18,Spain,NA,Comunidad Valenciana,4974969,481,14,4497,34
2020-03-19,Spain,NA,Comunidad Valenciana,4974969,456,9,4953,43
2020-03-20,Spain,NA,Comunidad Valenciana,4974969,511,19,5464,62
2020-03-21,Spain,NA,Comunidad Valenciana,4974969,412,22,5876,84
2020-03-22,Spain,NA,Comunidad Valenciana,4974969,362,29,6238,113
2020-03-23,Spain,NA,Comunidad Valenciana,4974969,431,23,6669,136
2020-03-24,Spain,NA,Comunidad Valenciana,4974969,306,30,6975,166
2020-03-25,Spain,NA,Comunidad Valenciana,4974969,359,33,7334,199
2020-03-26,Spain,NA,Comunidad Valenciana,4974969,271,37,7605,236
2020-03-27,Spain,NA,Comunidad Valenciana,4974969,295,48,7900,284
2020-03-28,Spain,NA,Comunidad Valenciana,4974969,218,44,8118,328
2020-03-29,Spain,NA,Comunidad Valenciana,4974969,183,35,8301,363
2020-03-30,Spain,NA,Comunidad Valenciana,4974969,222,54,8523,417
2020-03-31,Spain,NA,Comunidad Valenciana,4974969,151,59,8674,476
2020-04-01,Spain,NA,Comunidad Valenciana,4974969,202,44,8876,520
2020-04-02,Spain,NA,Comunidad Valenciana,4974969,181,49,9057,569
2020-04-03,Spain,NA,Comunidad Valenciana,4974969,190,53,9247,622
2020-04-04,Spain,NA,Comunidad Valenciana,4974969,118,45,9365,667
2020-04-05,Spain,NA,Comunidad Valenciana,4974969,105,41,9470,708
2020-04-06,Spain,NA,Comunidad Valenciana,4974969,137,36,9607,744
2020-04-07,Spain,NA,Comunidad Valenciana,4974969,127,58,9734,802
2020-04-08,Spain,NA,Comunidad Valenciana,4974969,125,31,9859,833
2020-04-09,Spain,NA,Comunidad Valenciana,4974969,117,28,9976,861
2020-04-10,Spain,NA,Comunidad Valenciana,4974969,95,32,10071,893
2020-04-11,Spain,NA,Comunidad Valenciana,4974969,78,38,10149,931
2020-04-12,Spain,NA,Comunidad Valenciana,4974969,67,30,10216,961
2020-04-13,Spain,NA,Comunidad Valenciana,4974969,63,35,10279,996
2020-04-14,Spain,NA,Comunidad Valenciana,4974969,63,32,10342,1028
2020-04-15,Spain,NA,Comunidad Valenciana,4974969,72,33,10414,1061
2020-04-16,Spain,NA,Comunidad Valenciana,4974969,53,27,10467,1088
2020-04-17,Spain,NA,Comunidad Valenciana,4974969,82,23,10549,1111
2020-04-18,Spain,NA,Comunidad Valenciana,4974969,52,11,10601,1122
2020-04-19,Spain,NA,Comunidad Valenciana,4974969,25,15,10626,1137
2020-04-20,Spain,NA,Comunidad Valenciana,4974969,35,16,10661,1153
2020-04-21,Spain,NA,Comunidad Valenciana,4974969,50,18,10711,1171
2020-04-22,Spain,NA,Comunidad Valenciana,4974969,35,17,10746,1188
2020-04-23,Spain,NA,Comunidad Valenciana,4974969,43,12,10789,1200
2020-04-24,Spain,NA,Comunidad Valenciana,4974969,40,11,10829,1211
2020-04-25,Spain,NA,Comunidad Valenciana,4974969,38,11,10867,1222
2020-04-26,Spain,NA,Comunidad Valenciana,4974969,19,13,10886,1235
2020-04-27,Spain,NA,Comunidad Valenciana,4974969,20,14,10906,1249
2020-04-28,Spain,NA,Comunidad Valenciana,4974969,37,21,10943,1270
2020-04-29,Spain,NA,Comunidad Valenciana,4974969,34,6,10977,1276
2020-04-30,Spain,NA,Comunidad Valenciana,4974969,19,8,10996,1284
2020-05-01,Spain,NA,Comunidad Valenciana,4974969,24,11,11020,1295
2020-05-02,Spain,NA,Comunidad Valenciana,4974969,31,8,11051,1303
2020-05-03,Spain,NA,Comunidad Valenciana,4974969,15,10,11066,1313
2020-05-04,Spain,NA,Comunidad Valenciana,4974969,6,6,11072,1319
2020-05-05,Spain,NA,Comunidad Valenciana,4974969,12,8,11084,1327
2020-05-06,Spain,NA,Comunidad Valenciana,4974969,12,10,11096,1337
2020-05-07,Spain,NA,Comunidad Valenciana,4974969,4,5,11100,1342
2020-05-08,Spain,NA,Comunidad Valenciana,4974969,5,7,11105,1349
2020-05-09,Spain,NA,Comunidad Valenciana,4974969,7,8,11112,1357
2020-05-10,Spain,NA,Comunidad Valenciana,4974969,8,5,11120,1362
2020-05-11,Spain,NA,Comunidad Valenciana,4974969,20,7,11140,1369
2020-05-12,Spain,NA,Comunidad Valenciana,4974969,19,4,11159,1373
2020-05-13,Spain,NA,Comunidad Valenciana,4974969,12,6,11171,1379
2020-05-14,Spain,NA,Comunidad Valenciana,4974969,19,8,11190,1387
2020-05-15,Spain,NA,Comunidad Valenciana,4974969,13,2,11203,1389
2020-05-16,Spain,NA,Comunidad Valenciana,4974969,8,3,11211,1392
2020-05-17,Spain,NA,Comunidad Valenciana,4974969,7,2,11218,1394
2020-05-18,Spain,NA,Comunidad Valenciana,4974969,10,4,11228,1398
2020-05-19,Spain,NA,Comunidad Valenciana,4974969,12,2,11240,1400
2020-05-20,Spain,NA,Comunidad Valenciana,4974969,14,2,11254,1402
2020-05-21,Spain,NA,Comunidad Valenciana,4974969,8,4,11262,1406
2020-05-22,Spain,NA,Comunidad Valenciana,4974969,16,3,11278,1409
2020-05-23,Spain,NA,Comunidad Valenciana,4974969,8,1,11286,1410
2020-05-24,Spain,NA,Comunidad Valenciana,4974969,9,0,11295,1410
2020-05-25,Spain,NA,Comunidad Valenciana,4974969,5,2,11300,1412
2020-05-26,Spain,NA,Comunidad Valenciana,4974969,13,2,11313,1414
2020-05-27,Spain,NA,Comunidad Valenciana,4974969,16,2,11329,1416
2020-05-28,Spain,NA,Comunidad Valenciana,4974969,9,2,11338,1418
2020-05-29,Spain,NA,Comunidad Valenciana,4974969,8,1,11346,1419
2020-05-30,Spain,NA,Comunidad Valenciana,4974969,5,0,11351,1419
2020-05-31,Spain,NA,Comunidad Valenciana,4974969,7,0,11358,1419
2020-06-01,Spain,NA,Comunidad Valenciana,4974969,15,0,11373,1419
2020-06-02,Spain,NA,Comunidad Valenciana,4974969,19,2,11392,1421
2020-06-03,Spain,NA,Comunidad Valenciana,4974969,11,2,11403,1423
2020-06-04,Spain,NA,Comunidad Valenciana,4974969,9,1,11412,1424
2020-06-05,Spain,NA,Comunidad Valenciana,4974969,8,0,11420,1424
2020-06-06,Spain,NA,Comunidad Valenciana,4974969,8,0,11428,1424
2020-06-07,Spain,NA,Comunidad Valenciana,4974969,7,0,11435,1424
2020-06-08,Spain,NA,Comunidad Valenciana,4974969,5,0,11440,1424
2020-06-09,Spain,NA,Comunidad Valenciana,4974969,8,1,11448,1425
2020-06-10,Spain,NA,Comunidad Valenciana,4974969,4,0,11452,1425
2020-06-11,Spain,NA,Comunidad Valenciana,4974969,11,1,11463,1426
2020-06-12,Spain,NA,Comunidad Valenciana,4974969,11,0,11474,1426
2020-06-13,Spain,NA,Comunidad Valenciana,4974969,3,0,11477,1426
2020-06-14,Spain,NA,Comunidad Valenciana,4974969,1,1,11478,1427
2020-06-15,Spain,NA,Comunidad Valenciana,4974969,11,1,11489,1428
2020-06-16,Spain,NA,Comunidad Valenciana,4974969,10,0,11499,1428
2020-06-17,Spain,NA,Comunidad Valenciana,4974969,8,0,11507,1428
2020-06-18,Spain,NA,Comunidad Valenciana,4974969,8,0,11515,1428
2020-06-19,Spain,NA,Comunidad Valenciana,4974969,11,0,11526,1428
2020-06-20,Spain,NA,Comunidad Valenciana,4974969,5,0,11531,1428
2020-06-21,Spain,NA,Comunidad Valenciana,4974969,10,1,11541,1429
2020-06-22,Spain,NA,Comunidad Valenciana,4974969,7,0,11548,1429
2020-06-23,Spain,NA,Comunidad Valenciana,4974969,12,0,11560,1429
2020-06-24,Spain,NA,Comunidad Valenciana,4974969,6,0,11566,1429
2020-06-25,Spain,NA,Comunidad Valenciana,4974969,9,0,11575,1429
2020-06-26,Spain,NA,Comunidad Valenciana,4974969,13,0,11588,1429
2020-06-27,Spain,NA,Comunidad Valenciana,4974969,13,0,11601,1429
2020-06-28,Spain,NA,Comunidad Valenciana,4974969,13,0,11614,1429
2020-06-29,Spain,NA,Comunidad Valenciana,4974969,18,0,11632,1429
2020-06-30,Spain,NA,Comunidad Valenciana,4974969,18,0,11650,1429
2020-07-01,Spain,NA,Comunidad Valenciana,4974969,23,0,11673,1429
2020-07-02,Spain,NA,Comunidad Valenciana,4974969,23,0,11696,1429
2020-07-03,Spain,NA,Comunidad Valenciana,4974969,14,0,11710,1429
2020-07-04,Spain,NA,Comunidad Valenciana,4974969,6,0,11716,1429
2020-07-05,Spain,NA,Comunidad Valenciana,4974969,11,0,11727,1429
2020-07-06,Spain,NA,Comunidad Valenciana,4974969,23,0,11750,1429
2020-07-07,Spain,NA,Comunidad Valenciana,4974969,25,0,11775,1429
2020-07-08,Spain,NA,Comunidad Valenciana,4974969,29,0,11804,1429
2020-07-09,Spain,NA,Comunidad Valenciana,4974969,28,0,11832,1429
2020-07-10,Spain,NA,Comunidad Valenciana,4974969,33,0,11865,1429
2020-07-11,Spain,NA,Comunidad Valenciana,4974969,35,0,11900,1429
2020-07-12,Spain,NA,Comunidad Valenciana,4974969,17,0,11917,1429
2020-07-13,Spain,NA,Comunidad Valenciana,4974969,49,0,11966,1429
2020-07-14,Spain,NA,Comunidad Valenciana,4974969,55,0,12021,1429
2020-07-15,Spain,NA,Comunidad Valenciana,4974969,79,0,12100,1429
2020-07-16,Spain,NA,Comunidad Valenciana,4974969,69,0,12169,1429
2020-07-17,Spain,NA,Comunidad Valenciana,4974969,92,0,12261,1429
2020-07-18,Spain,NA,Comunidad Valenciana,4974969,92,0,12353,1429
2020-07-19,Spain,NA,Comunidad Valenciana,4974969,81,1,12434,1430
2020-07-20,Spain,NA,Comunidad Valenciana,4974969,118,0,12552,1430
2020-07-21,Spain,NA,Comunidad Valenciana,4974969,128,0,12680,1430
2020-07-22,Spain,NA,Comunidad Valenciana,4974969,136,0,12816,1430
2020-07-23,Spain,NA,Comunidad Valenciana,4974969,123,0,12939,1430
2020-07-24,Spain,NA,Comunidad Valenciana,4974969,156,0,13095,1430
2020-07-25,Spain,NA,Comunidad Valenciana,4974969,162,0,13257,1430
2020-07-26,Spain,NA,Comunidad Valenciana,4974969,122,0,13379,1430
2020-07-27,Spain,NA,Comunidad Valenciana,4974969,205,0,13584,1430
2020-07-28,Spain,NA,Comunidad Valenciana,4974969,187,3,13771,1433
2020-07-29,Spain,NA,Comunidad Valenciana,4974969,265,0,14036,1433
2020-07-30,Spain,NA,Comunidad Valenciana,4974969,241,0,14277,1433
2020-07-31,Spain,NA,Comunidad Valenciana,4974969,233,0,14510,1433
2020-08-01,Spain,NA,Comunidad Valenciana,4974969,270,0,14780,1433
2020-08-02,Spain,NA,Comunidad Valenciana,4974969,192,1,14972,1434
2020-08-03,Spain,NA,Comunidad Valenciana,4974969,264,0,15236,1434
2020-08-04,Spain,NA,Comunidad Valenciana,4974969,339,1,15575,1435
2020-08-05,Spain,NA,Comunidad Valenciana,4974969,349,0,15924,1435
2020-08-06,Spain,NA,Comunidad Valenciana,4974969,309,2,16233,1437
2020-08-07,Spain,NA,Comunidad Valenciana,4974969,335,0,16568,1437
2020-08-08,Spain,NA,Comunidad Valenciana,4974969,310,1,16878,1438
2020-08-09,Spain,NA,Comunidad Valenciana,4974969,253,1,17131,1439
2020-08-10,Spain,NA,Comunidad Valenciana,4974969,394,1,17525,1440
2020-08-11,Spain,NA,Comunidad Valenciana,4974969,386,0,17911,1440
2020-08-12,Spain,NA,Comunidad Valenciana,4974969,454,1,18365,1441
2020-08-13,Spain,NA,Comunidad Valenciana,4974969,429,1,18794,1442
2020-08-14,Spain,NA,Comunidad Valenciana,4974969,504,1,19298,1443
2020-08-15,Spain,NA,Comunidad Valenciana,4974969,395,0,19693,1443
2020-08-16,Spain,NA,Comunidad Valenciana,4974969,353,0,20046,1443
2020-08-17,Spain,NA,Comunidad Valenciana,4974969,541,3,20587,1446
2020-08-18,Spain,NA,Comunidad Valenciana,4974969,532,1,21119,1447
2020-08-19,Spain,NA,Comunidad Valenciana,4974969,567,2,21686,1449
2020-08-20,Spain,NA,Comunidad Valenciana,4974969,578,1,22264,1450
2020-08-21,Spain,NA,Comunidad Valenciana,4974969,635,3,22899,1453
2020-08-22,Spain,NA,Comunidad Valenciana,4974969,571,2,23470,1455
2020-08-23,Spain,NA,Comunidad Valenciana,4974969,447,2,23917,1457
2020-08-24,Spain,NA,Comunidad Valenciana,4974969,656,3,24573,1460
2020-08-25,Spain,NA,Comunidad Valenciana,4974969,568,1,25141,1461
2020-08-26,Spain,NA,Comunidad Valenciana,4974969,677,3,25818,1464
2020-08-27,Spain,NA,Comunidad Valenciana,4974969,546,3,26364,1467
2020-08-28,Spain,NA,Comunidad Valenciana,4974969,641,4,27005,1471
2020-08-29,Spain,NA,Comunidad Valenciana,4974969,622,2,27627,1473
2020-08-30,Spain,NA,Comunidad Valenciana,4974969,377,3,28004,1476
2020-08-31,Spain,NA,Comunidad Valenciana,4974969,470,3,28474,1479
2020-09-01,Spain,NA,Comunidad Valenciana,4974969,542,5,29016,1484
2020-09-02,Spain,NA,Comunidad Valenciana,4974969,603,4,29619,1488
2020-09-03,Spain,NA,Comunidad Valenciana,4974969,484,5,30103,1493
2020-09-04,Spain,NA,Comunidad Valenciana,4974969,583,3,30686,1496
2020-09-05,Spain,NA,Comunidad Valenciana,4974969,516,3,31202,1499
2020-09-06,Spain,NA,Comunidad Valenciana,4974969,362,3,31564,1502
2020-09-07,Spain,NA,Comunidad Valenciana,4974969,514,4,32078,1506
2020-09-08,Spain,NA,Comunidad Valenciana,4974969,530,5,32608,1511
2020-09-09,Spain,NA,Comunidad Valenciana,4974969,503,4,33111,1515
2020-09-10,Spain,NA,Comunidad Valenciana,4974969,527,1,33638,1516
2020-09-11,Spain,NA,Comunidad Valenciana,4974969,489,2,34127,1518
2020-09-12,Spain,NA,Comunidad Valenciana,4974969,370,4,34497,1522
2020-09-13,Spain,NA,Comunidad Valenciana,4974969,316,4,34813,1526
2020-09-14,Spain,NA,Comunidad Valenciana,4974969,450,4,35263,1530
2020-09-15,Spain,NA,Comunidad Valenciana,4974969,376,9,35639,1539
2020-09-16,Spain,NA,Comunidad Valenciana,4974969,412,8,36051,1547
2020-09-17,Spain,NA,Comunidad Valenciana,4974969,339,3,36390,1550
2020-09-18,Spain,NA,Comunidad Valenciana,4974969,288,6,36678,1556
2020-09-19,Spain,NA,Comunidad Valenciana,4974969,205,2,36883,1558
2020-09-20,Spain,NA,Comunidad Valenciana,4974969,129,3,37012,1561
2020-09-21,Spain,NA,Comunidad Valenciana,4974969,135,2,37147,1563
2020-09-22,Spain,NA,Comunidad Valenciana,4974969,137,8,37284,1571
2020-09-23,Spain,NA,Comunidad Valenciana,4974969,52,0,37336,1571
2020-02-28,Spain,NA,Extremadura,1065424,4,0,11,0
2020-02-29,Spain,NA,Extremadura,1065424,3,0,14,0
2020-03-01,Spain,NA,Extremadura,1065424,3,0,17,0
2020-03-02,Spain,NA,Extremadura,1065424,6,0,23,0
2020-03-03,Spain,NA,Extremadura,1065424,4,0,27,0
2020-03-04,Spain,NA,Extremadura,1065424,6,0,33,0
2020-03-05,Spain,NA,Extremadura,1065424,5,0,38,0
2020-03-06,Spain,NA,Extremadura,1065424,11,0,49,0
2020-03-07,Spain,NA,Extremadura,1065424,12,0,61,0
2020-03-08,Spain,NA,Extremadura,1065424,12,0,73,0
2020-03-09,Spain,NA,Extremadura,1065424,31,0,104,0
2020-03-10,Spain,NA,Extremadura,1065424,36,0,140,0
2020-03-11,Spain,NA,Extremadura,1065424,57,1,197,1
2020-03-12,Spain,NA,Extremadura,1065424,72,0,269,1
2020-03-13,Spain,NA,Extremadura,1065424,81,0,350,1
2020-03-14,Spain,NA,Extremadura,1065424,71,0,421,1
2020-03-15,Spain,NA,Extremadura,1065424,62,1,483,2
2020-03-16,Spain,NA,Extremadura,1065424,94,2,577,4
2020-03-17,Spain,NA,Extremadura,1065424,95,2,672,6
2020-03-18,Spain,NA,Extremadura,1065424,105,2,777,8
2020-03-19,Spain,NA,Extremadura,1065424,103,3,880,11
2020-03-20,Spain,NA,Extremadura,1065424,140,3,1020,14
2020-03-21,Spain,NA,Extremadura,1065424,111,4,1131,18
2020-03-22,Spain,NA,Extremadura,1065424,116,6,1247,24
2020-03-23,Spain,NA,Extremadura,1065424,209,10,1456,34
2020-03-24,Spain,NA,Extremadura,1065424,137,17,1593,51
2020-03-25,Spain,NA,Extremadura,1065424,121,11,1714,62
2020-03-26,Spain,NA,Extremadura,1065424,120,16,1834,78
2020-03-27,Spain,NA,Extremadura,1065424,91,22,1925,100
2020-03-28,Spain,NA,Extremadura,1065424,72,16,1997,116
2020-03-29,Spain,NA,Extremadura,1065424,51,16,2048,132
2020-03-30,Spain,NA,Extremadura,1065424,66,23,2114,155
2020-03-31,Spain,NA,Extremadura,1065424,37,17,2151,172
2020-04-01,Spain,NA,Extremadura,1065424,89,20,2240,192
2020-04-02,Spain,NA,Extremadura,1065424,51,21,2291,213
2020-04-03,Spain,NA,Extremadura,1065424,65,17,2356,230
2020-04-04,Spain,NA,Extremadura,1065424,47,11,2403,241
2020-04-05,Spain,NA,Extremadura,1065424,25,14,2428,255
2020-04-06,Spain,NA,Extremadura,1065424,37,18,2465,273
2020-04-07,Spain,NA,Extremadura,1065424,27,10,2492,283
2020-04-08,Spain,NA,Extremadura,1065424,36,14,2528,297
2020-04-09,Spain,NA,Extremadura,1065424,21,17,2549,314
2020-04-10,Spain,NA,Extremadura,1065424,39,13,2588,327
2020-04-11,Spain,NA,Extremadura,1065424,27,6,2615,333
2020-04-12,Spain,NA,Extremadura,1065424,21,11,2636,344
2020-04-13,Spain,NA,Extremadura,1065424,24,9,2660,353
2020-04-14,Spain,NA,Extremadura,1065424,28,8,2688,361
2020-04-15,Spain,NA,Extremadura,1065424,25,12,2713,373
2020-04-16,Spain,NA,Extremadura,1065424,23,7,2736,380
2020-04-17,Spain,NA,Extremadura,1065424,28,3,2764,383
2020-04-18,Spain,NA,Extremadura,1065424,18,7,2782,390
2020-04-19,Spain,NA,Extremadura,1065424,11,5,2793,395
2020-04-20,Spain,NA,Extremadura,1065424,31,7,2824,402
2020-04-21,Spain,NA,Extremadura,1065424,16,7,2840,409
2020-04-22,Spain,NA,Extremadura,1065424,27,6,2867,415
2020-04-23,Spain,NA,Extremadura,1065424,14,2,2881,417
2020-04-24,Spain,NA,Extremadura,1065424,16,12,2897,429
2020-04-25,Spain,NA,Extremadura,1065424,23,6,2920,435
2020-04-26,Spain,NA,Extremadura,1065424,12,6,2932,441
2020-04-27,Spain,NA,Extremadura,1065424,10,6,2942,447
2020-04-28,Spain,NA,Extremadura,1065424,5,4,2947,451
2020-04-29,Spain,NA,Extremadura,1065424,15,7,2962,458
2020-04-30,Spain,NA,Extremadura,1065424,13,2,2975,460
2020-05-01,Spain,NA,Extremadura,1065424,23,3,2998,463
2020-05-02,Spain,NA,Extremadura,1065424,13,2,3011,465
2020-05-03,Spain,NA,Extremadura,1065424,5,0,3016,465
2020-05-04,Spain,NA,Extremadura,1065424,12,0,3028,465
2020-05-05,Spain,NA,Extremadura,1065424,1,5,3029,470
2020-05-06,Spain,NA,Extremadura,1065424,5,4,3034,474
2020-05-07,Spain,NA,Extremadura,1065424,2,4,3036,478
2020-05-08,Spain,NA,Extremadura,1065424,3,4,3039,482
2020-05-09,Spain,NA,Extremadura,1065424,2,2,3041,484
2020-05-10,Spain,NA,Extremadura,1065424,3,0,3044,484
2020-05-11,Spain,NA,Extremadura,1065424,5,4,3049,488
2020-05-12,Spain,NA,Extremadura,1065424,7,5,3056,493
2020-05-13,Spain,NA,Extremadura,1065424,6,2,3062,495
2020-05-14,Spain,NA,Extremadura,1065424,1,1,3063,496
2020-05-15,Spain,NA,Extremadura,1065424,2,2,3065,498
2020-05-16,Spain,NA,Extremadura,1065424,1,0,3066,498
2020-05-17,Spain,NA,Extremadura,1065424,2,2,3068,500
2020-05-18,Spain,NA,Extremadura,1065424,3,4,3071,504
2020-05-19,Spain,NA,Extremadura,1065424,2,1,3073,505
2020-05-20,Spain,NA,Extremadura,1065424,3,1,3076,506
2020-05-21,Spain,NA,Extremadura,1065424,2,1,3078,507
2020-05-22,Spain,NA,Extremadura,1065424,3,0,3081,507
2020-05-23,Spain,NA,Extremadura,1065424,0,0,3081,507
2020-05-24,Spain,NA,Extremadura,1065424,1,2,3082,509
2020-05-25,Spain,NA,Extremadura,1065424,5,1,3087,510
2020-05-26,Spain,NA,Extremadura,1065424,2,1,3089,511
2020-05-27,Spain,NA,Extremadura,1065424,2,1,3091,512
2020-05-28,Spain,NA,Extremadura,1065424,0,0,3091,512
2020-05-29,Spain,NA,Extremadura,1065424,3,1,3094,513
2020-05-30,Spain,NA,Extremadura,1065424,2,1,3096,514
2020-05-31,Spain,NA,Extremadura,1065424,1,1,3097,515
2020-06-01,Spain,NA,Extremadura,1065424,3,0,3100,515
2020-06-02,Spain,NA,Extremadura,1065424,4,1,3104,516
2020-06-03,Spain,NA,Extremadura,1065424,0,1,3104,517
2020-06-04,Spain,NA,Extremadura,1065424,3,0,3107,517
2020-06-05,Spain,NA,Extremadura,1065424,0,0,3107,517
2020-06-06,Spain,NA,Extremadura,1065424,0,0,3107,517
2020-06-07,Spain,NA,Extremadura,1065424,1,0,3108,517
2020-06-08,Spain,NA,Extremadura,1065424,1,0,3109,517
2020-06-09,Spain,NA,Extremadura,1065424,2,0,3111,517
2020-06-10,Spain,NA,Extremadura,1065424,1,1,3112,518
2020-06-11,Spain,NA,Extremadura,1065424,0,0,3112,518
2020-06-12,Spain,NA,Extremadura,1065424,1,0,3113,518
2020-06-13,Spain,NA,Extremadura,1065424,1,0,3114,518
2020-06-14,Spain,NA,Extremadura,1065424,0,0,3114,518
2020-06-15,Spain,NA,Extremadura,1065424,5,0,3119,518
2020-06-16,Spain,NA,Extremadura,1065424,2,0,3121,518
2020-06-17,Spain,NA,Extremadura,1065424,7,0,3128,518
2020-06-18,Spain,NA,Extremadura,1065424,4,0,3132,518
2020-06-19,Spain,NA,Extremadura,1065424,2,0,3134,518
2020-06-20,Spain,NA,Extremadura,1065424,1,0,3135,518
2020-06-21,Spain,NA,Extremadura,1065424,5,0,3140,518
2020-06-22,Spain,NA,Extremadura,1065424,1,0,3141,518
2020-06-23,Spain,NA,Extremadura,1065424,5,0,3146,518
2020-06-24,Spain,NA,Extremadura,1065424,1,0,3147,518
2020-06-25,Spain,NA,Extremadura,1065424,4,0,3151,518
2020-06-26,Spain,NA,Extremadura,1065424,0,0,3151,518
2020-06-27,Spain,NA,Extremadura,1065424,5,0,3156,518
2020-06-28,Spain,NA,Extremadura,1065424,3,0,3159,518
2020-06-29,Spain,NA,Extremadura,1065424,6,0,3165,518
2020-06-30,Spain,NA,Extremadura,1065424,7,0,3172,518
2020-07-01,Spain,NA,Extremadura,1065424,9,0,3181,518
2020-07-02,Spain,NA,Extremadura,1065424,4,0,3185,518
2020-07-03,Spain,NA,Extremadura,1065424,8,0,3193,518
2020-07-04,Spain,NA,Extremadura,1065424,4,0,3197,518
2020-07-05,Spain,NA,Extremadura,1065424,6,0,3203,518
2020-07-06,Spain,NA,Extremadura,1065424,1,0,3204,518
2020-07-07,Spain,NA,Extremadura,1065424,16,0,3220,518
2020-07-08,Spain,NA,Extremadura,1065424,6,0,3226,518
2020-07-09,Spain,NA,Extremadura,1065424,23,0,3249,518
2020-07-10,Spain,NA,Extremadura,1065424,45,0,3294,518
2020-07-11,Spain,NA,Extremadura,1065424,18,0,3312,518
2020-07-12,Spain,NA,Extremadura,1065424,12,0,3324,518
2020-07-13,Spain,NA,Extremadura,1065424,13,0,3337,518
2020-07-14,Spain,NA,Extremadura,1065424,3,0,3340,518
2020-07-15,Spain,NA,Extremadura,1065424,13,0,3353,518
2020-07-16,Spain,NA,Extremadura,1065424,22,0,3375,518
2020-07-17,Spain,NA,Extremadura,1065424,5,0,3380,518
2020-07-18,Spain,NA,Extremadura,1065424,5,0,3385,518
2020-07-19,Spain,NA,Extremadura,1065424,6,0,3391,518
2020-07-20,Spain,NA,Extremadura,1065424,9,0,3400,518
2020-07-21,Spain,NA,Extremadura,1065424,17,0,3417,518
2020-07-22,Spain,NA,Extremadura,1065424,6,0,3423,518
2020-07-23,Spain,NA,Extremadura,1065424,4,0,3427,518
2020-07-24,Spain,NA,Extremadura,1065424,11,0,3438,518
2020-07-25,Spain,NA,Extremadura,1065424,4,0,3442,518
2020-07-26,Spain,NA,Extremadura,1065424,7,0,3449,518
2020-07-27,Spain,NA,Extremadura,1065424,9,0,3458,518
2020-07-28,Spain,NA,Extremadura,1065424,21,0,3479,518
2020-07-29,Spain,NA,Extremadura,1065424,17,1,3496,519
2020-07-30,Spain,NA,Extremadura,1065424,20,0,3516,519
2020-07-31,Spain,NA,Extremadura,1065424,38,0,3554,519
2020-08-01,Spain,NA,Extremadura,1065424,18,0,3572,519
2020-08-02,Spain,NA,Extremadura,1065424,21,0,3593,519
2020-08-03,Spain,NA,Extremadura,1065424,21,0,3614,519
2020-08-04,Spain,NA,Extremadura,1065424,16,0,3630,519
2020-08-05,Spain,NA,Extremadura,1065424,34,0,3664,519
2020-08-06,Spain,NA,Extremadura,1065424,32,1,3696,520
2020-08-07,Spain,NA,Extremadura,1065424,46,0,3742,520
2020-08-08,Spain,NA,Extremadura,1065424,20,0,3762,520
2020-08-09,Spain,NA,Extremadura,1065424,11,0,3773,520
2020-08-10,Spain,NA,Extremadura,1065424,26,0,3799,520
2020-08-11,Spain,NA,Extremadura,1065424,34,1,3833,521
2020-08-12,Spain,NA,Extremadura,1065424,73,0,3906,521
2020-08-13,Spain,NA,Extremadura,1065424,66,0,3972,521
2020-08-14,Spain,NA,Extremadura,1065424,47,0,4019,521
2020-08-15,Spain,NA,Extremadura,1065424,29,1,4048,522
2020-08-16,Spain,NA,Extremadura,1065424,38,0,4086,522
2020-08-17,Spain,NA,Extremadura,1065424,53,0,4139,522
2020-08-18,Spain,NA,Extremadura,1065424,78,0,4217,522
2020-08-19,Spain,NA,Extremadura,1065424,100,1,4317,523
2020-08-20,Spain,NA,Extremadura,1065424,81,0,4398,523
2020-08-21,Spain,NA,Extremadura,1065424,91,1,4489,524
2020-08-22,Spain,NA,Extremadura,1065424,88,1,4577,525
2020-08-23,Spain,NA,Extremadura,1065424,72,0,4649,525
2020-08-24,Spain,NA,Extremadura,1065424,77,0,4726,525
2020-08-25,Spain,NA,Extremadura,1065424,112,0,4838,525
2020-08-26,Spain,NA,Extremadura,1065424,93,0,4931,525
2020-08-27,Spain,NA,Extremadura,1065424,83,0,5014,525
2020-08-28,Spain,NA,Extremadura,1065424,140,0,5154,525
2020-08-29,Spain,NA,Extremadura,1065424,91,1,5245,526
2020-08-30,Spain,NA,Extremadura,1065424,119,0,5364,526
2020-08-31,Spain,NA,Extremadura,1065424,96,0,5460,526
2020-09-01,Spain,NA,Extremadura,1065424,130,2,5590,528
2020-09-02,Spain,NA,Extremadura,1065424,150,0,5740,528
2020-09-03,Spain,NA,Extremadura,1065424,170,1,5910,529
2020-09-04,Spain,NA,Extremadura,1065424,147,2,6057,531
2020-09-05,Spain,NA,Extremadura,1065424,136,0,6193,531
2020-09-06,Spain,NA,Extremadura,1065424,127,1,6320,532
2020-09-07,Spain,NA,Extremadura,1065424,139,1,6459,533
2020-09-08,Spain,NA,Extremadura,1065424,136,4,6595,537
2020-09-09,Spain,NA,Extremadura,1065424,205,0,6800,537
2020-09-10,Spain,NA,Extremadura,1065424,214,0,7014,537
2020-09-11,Spain,NA,Extremadura,1065424,204,0,7218,537
2020-09-12,Spain,NA,Extremadura,1065424,211,1,7429,538
2020-09-13,Spain,NA,Extremadura,1065424,200,0,7629,538
2020-09-14,Spain,NA,Extremadura,1065424,260,0,7889,538
2020-09-15,Spain,NA,Extremadura,1065424,273,1,8162,539
2020-09-16,Spain,NA,Extremadura,1065424,290,2,8452,541
2020-09-17,Spain,NA,Extremadura,1065424,287,3,8739,544
2020-09-18,Spain,NA,Extremadura,1065424,261,2,9000,546
2020-09-19,Spain,NA,Extremadura,1065424,159,0,9159,546
2020-09-20,Spain,NA,Extremadura,1065424,206,4,9365,550
2020-09-21,Spain,NA,Extremadura,1065424,124,3,9489,553
2020-09-22,Spain,NA,Extremadura,1065424,128,6,9617,559
2020-09-23,Spain,NA,Extremadura,1065424,43,2,9660,561
2020-02-24,Spain,NA,Galicia,2700441,1,0,11,0
2020-02-25,Spain,NA,Galicia,2700441,2,0,13,0
2020-02-26,Spain,NA,Galicia,2700441,3,0,16,0
2020-02-27,Spain,NA,Galicia,2700441,7,0,23,0
2020-02-28,Spain,NA,Galicia,2700441,6,0,29,0
2020-02-29,Spain,NA,Galicia,2700441,1,0,30,0
2020-03-01,Spain,NA,Galicia,2700441,5,0,35,0
2020-03-02,Spain,NA,Galicia,2700441,19,0,54,0
2020-03-03,Spain,NA,Galicia,2700441,16,0,70,0
2020-03-04,Spain,NA,Galicia,2700441,13,0,83,0
2020-03-05,Spain,NA,Galicia,2700441,18,0,101,0
2020-03-06,Spain,NA,Galicia,2700441,24,0,125,0
2020-03-07,Spain,NA,Galicia,2700441,32,0,157,0
2020-03-08,Spain,NA,Galicia,2700441,35,0,192,0
2020-03-09,Spain,NA,Galicia,2700441,80,0,272,0
2020-03-10,Spain,NA,Galicia,2700441,113,0,385,0
2020-03-11,Spain,NA,Galicia,2700441,129,0,514,0
2020-03-12,Spain,NA,Galicia,2700441,180,0,694,0
2020-03-13,Spain,NA,Galicia,2700441,240,0,934,0
2020-03-14,Spain,NA,Galicia,2700441,238,1,1172,1
2020-03-15,Spain,NA,Galicia,2700441,269,1,1441,2
2020-03-16,Spain,NA,Galicia,2700441,383,1,1824,3
2020-03-17,Spain,NA,Galicia,2700441,323,2,2147,5
2020-03-18,Spain,NA,Galicia,2700441,306,0,2453,5
2020-03-19,Spain,NA,Galicia,2700441,290,1,2743,6
2020-03-20,Spain,NA,Galicia,2700441,462,5,3205,11
2020-03-21,Spain,NA,Galicia,2700441,272,5,3477,16
2020-03-22,Spain,NA,Galicia,2700441,249,4,3726,20
2020-03-23,Spain,NA,Galicia,2700441,377,5,4103,25
2020-03-24,Spain,NA,Galicia,2700441,291,7,4394,32
2020-03-25,Spain,NA,Galicia,2700441,283,7,4677,39
2020-03-26,Spain,NA,Galicia,2700441,295,9,4972,48
2020-03-27,Spain,NA,Galicia,2700441,301,11,5273,59
2020-03-28,Spain,NA,Galicia,2700441,333,19,5606,78
2020-03-29,Spain,NA,Galicia,2700441,196,11,5802,89
2020-03-30,Spain,NA,Galicia,2700441,273,28,6075,117
2020-03-31,Spain,NA,Galicia,2700441,161,19,6236,136
2020-04-01,Spain,NA,Galicia,2700441,233,23,6469,159
2020-04-02,Spain,NA,Galicia,2700441,259,24,6728,183
2020-04-03,Spain,NA,Galicia,2700441,209,27,6937,210
2020-04-04,Spain,NA,Galicia,2700441,133,18,7070,228
2020-04-05,Spain,NA,Galicia,2700441,115,27,7185,255
2020-04-06,Spain,NA,Galicia,2700441,177,16,7362,271
2020-04-07,Spain,NA,Galicia,2700441,148,28,7510,299
2020-04-08,Spain,NA,Galicia,2700441,147,12,7657,311
2020-04-09,Spain,NA,Galicia,2700441,149,22,7806,333
2020-04-10,Spain,NA,Galicia,2700441,71,31,7877,364
2020-04-11,Spain,NA,Galicia,2700441,63,12,7940,376
2020-04-12,Spain,NA,Galicia,2700441,62,13,8002,389
2020-04-13,Spain,NA,Galicia,2700441,103,13,8105,402
2020-04-14,Spain,NA,Galicia,2700441,63,16,8168,418
2020-04-15,Spain,NA,Galicia,2700441,97,12,8265,430
2020-04-16,Spain,NA,Galicia,2700441,69,11,8334,441
2020-04-17,Spain,NA,Galicia,2700441,52,12,8386,453
2020-04-18,Spain,NA,Galicia,2700441,62,19,8448,472
2020-04-19,Spain,NA,Galicia,2700441,47,6,8495,478
2020-04-20,Spain,NA,Galicia,2700441,62,10,8557,488
2020-04-21,Spain,NA,Galicia,2700441,43,14,8600,502
2020-04-22,Spain,NA,Galicia,2700441,48,8,8648,510
2020-04-23,Spain,NA,Galicia,2700441,57,6,8705,516
2020-04-24,Spain,NA,Galicia,2700441,38,13,8743,529
2020-04-25,Spain,NA,Galicia,2700441,25,8,8768,537
2020-04-26,Spain,NA,Galicia,2700441,16,6,8784,543
2020-04-27,Spain,NA,Galicia,2700441,28,9,8812,552
2020-04-28,Spain,NA,Galicia,2700441,20,2,8832,554
2020-04-29,Spain,NA,Galicia,2700441,43,3,8875,557
2020-04-30,Spain,NA,Galicia,2700441,24,8,8899,565
2020-05-01,Spain,NA,Galicia,2700441,19,4,8918,569
2020-05-02,Spain,NA,Galicia,2700441,23,6,8941,575
2020-05-03,Spain,NA,Galicia,2700441,9,6,8950,581
2020-05-04,Spain,NA,Galicia,2700441,14,4,8964,585
2020-05-05,Spain,NA,Galicia,2700441,7,6,8971,591
2020-05-06,Spain,NA,Galicia,2700441,15,3,8986,594
2020-05-07,Spain,NA,Galicia,2700441,9,1,8995,595
2020-05-08,Spain,NA,Galicia,2700441,7,4,9002,599
2020-05-09,Spain,NA,Galicia,2700441,8,1,9010,600
2020-05-10,Spain,NA,Galicia,2700441,7,0,9017,600
2020-05-11,Spain,NA,Galicia,2700441,11,1,9028,601
2020-05-12,Spain,NA,Galicia,2700441,17,1,9045,602
2020-05-13,Spain,NA,Galicia,2700441,8,3,9053,605
2020-05-14,Spain,NA,Galicia,2700441,6,0,9059,605
2020-05-15,Spain,NA,Galicia,2700441,7,1,9066,606
2020-05-16,Spain,NA,Galicia,2700441,3,1,9069,607
2020-05-17,Spain,NA,Galicia,2700441,2,1,9071,608
2020-05-18,Spain,NA,Galicia,2700441,7,0,9078,608
2020-05-19,Spain,NA,Galicia,2700441,7,1,9085,609
2020-05-20,Spain,NA,Galicia,2700441,6,0,9091,609
2020-05-21,Spain,NA,Galicia,2700441,11,2,9102,611
2020-05-22,Spain,NA,Galicia,2700441,3,1,9105,612
2020-05-23,Spain,NA,Galicia,2700441,8,1,9113,613
2020-05-24,Spain,NA,Galicia,2700441,6,1,9119,614
2020-05-25,Spain,NA,Galicia,2700441,4,0,9123,614
2020-05-26,Spain,NA,Galicia,2700441,2,1,9125,615
2020-05-27,Spain,NA,Galicia,2700441,1,0,9126,615
2020-05-28,Spain,NA,Galicia,2700441,2,0,9128,615
2020-05-29,Spain,NA,Galicia,2700441,4,1,9132,616
2020-05-30,Spain,NA,Galicia,2700441,1,0,9133,616
2020-05-31,Spain,NA,Galicia,2700441,1,0,9134,616
2020-06-01,Spain,NA,Galicia,2700441,1,1,9135,617
2020-06-02,Spain,NA,Galicia,2700441,1,1,9136,618
2020-06-03,Spain,NA,Galicia,2700441,1,0,9137,618
2020-06-04,Spain,NA,Galicia,2700441,2,0,9139,618
2020-06-05,Spain,NA,Galicia,2700441,4,0,9143,618
2020-06-06,Spain,NA,Galicia,2700441,1,0,9144,618
2020-06-07,Spain,NA,Galicia,2700441,1,0,9145,618
2020-06-08,Spain,NA,Galicia,2700441,5,0,9150,618
2020-06-09,Spain,NA,Galicia,2700441,1,0,9151,618
2020-06-10,Spain,NA,Galicia,2700441,1,1,9152,619
2020-06-11,Spain,NA,Galicia,2700441,2,0,9154,619
2020-06-12,Spain,NA,Galicia,2700441,2,0,9156,619
2020-06-13,Spain,NA,Galicia,2700441,0,0,9156,619
2020-06-14,Spain,NA,Galicia,2700441,1,0,9157,619
2020-06-15,Spain,NA,Galicia,2700441,3,0,9160,619
2020-06-16,Spain,NA,Galicia,2700441,1,0,9161,619
2020-06-17,Spain,NA,Galicia,2700441,4,0,9165,619
2020-06-18,Spain,NA,Galicia,2700441,0,0,9165,619
2020-06-19,Spain,NA,Galicia,2700441,1,0,9166,619
2020-06-20,Spain,NA,Galicia,2700441,7,0,9173,619
2020-06-21,Spain,NA,Galicia,2700441,3,0,9176,619
2020-06-22,Spain,NA,Galicia,2700441,0,0,9176,619
2020-06-23,Spain,NA,Galicia,2700441,5,0,9181,619
2020-06-24,Spain,NA,Galicia,2700441,5,0,9186,619
2020-06-25,Spain,NA,Galicia,2700441,8,0,9194,619
2020-06-26,Spain,NA,Galicia,2700441,4,0,9198,619
2020-06-27,Spain,NA,Galicia,2700441,9,0,9207,619
2020-06-28,Spain,NA,Galicia,2700441,11,0,9218,619
2020-06-29,Spain,NA,Galicia,2700441,8,0,9226,619
2020-06-30,Spain,NA,Galicia,2700441,22,0,9248,619
2020-07-01,Spain,NA,Galicia,2700441,12,0,9260,619
2020-07-02,Spain,NA,Galicia,2700441,24,0,9284,619
2020-07-03,Spain,NA,Galicia,2700441,31,0,9315,619
2020-07-04,Spain,NA,Galicia,2700441,17,0,9332,619
2020-07-05,Spain,NA,Galicia,2700441,12,0,9344,619
2020-07-06,Spain,NA,Galicia,2700441,18,0,9362,619
2020-07-07,Spain,NA,Galicia,2700441,35,0,9397,619
2020-07-08,Spain,NA,Galicia,2700441,24,0,9421,619
2020-07-09,Spain,NA,Galicia,2700441,16,0,9437,619
2020-07-10,Spain,NA,Galicia,2700441,7,0,9444,619
2020-07-11,Spain,NA,Galicia,2700441,15,0,9459,619
2020-07-12,Spain,NA,Galicia,2700441,3,0,9462,619
2020-07-13,Spain,NA,Galicia,2700441,8,0,9470,619
2020-07-14,Spain,NA,Galicia,2700441,13,0,9483,619
2020-07-15,Spain,NA,Galicia,2700441,17,0,9500,619
2020-07-16,Spain,NA,Galicia,2700441,12,0,9512,619
2020-07-17,Spain,NA,Galicia,2700441,9,0,9521,619
2020-07-18,Spain,NA,Galicia,2700441,10,0,9531,619
2020-07-19,Spain,NA,Galicia,2700441,13,0,9544,619
2020-07-20,Spain,NA,Galicia,2700441,12,0,9556,619
2020-07-21,Spain,NA,Galicia,2700441,15,0,9571,619
2020-07-22,Spain,NA,Galicia,2700441,19,0,9590,619
2020-07-23,Spain,NA,Galicia,2700441,16,0,9606,619
2020-07-24,Spain,NA,Galicia,2700441,29,0,9635,619
2020-07-25,Spain,NA,Galicia,2700441,19,0,9654,619
2020-07-26,Spain,NA,Galicia,2700441,7,0,9661,619
2020-07-27,Spain,NA,Galicia,2700441,16,0,9677,619
2020-07-28,Spain,NA,Galicia,2700441,16,0,9693,619
2020-07-29,Spain,NA,Galicia,2700441,21,0,9714,619
2020-07-30,Spain,NA,Galicia,2700441,35,0,9749,619
2020-07-31,Spain,NA,Galicia,2700441,38,0,9787,619
2020-08-01,Spain,NA,Galicia,2700441,42,0,9829,619
2020-08-02,Spain,NA,Galicia,2700441,34,0,9863,619
2020-08-03,Spain,NA,Galicia,2700441,58,0,9921,619
2020-08-04,Spain,NA,Galicia,2700441,57,0,9978,619
2020-08-05,Spain,NA,Galicia,2700441,43,0,10021,619
2020-08-06,Spain,NA,Galicia,2700441,100,0,10121,619
2020-08-07,Spain,NA,Galicia,2700441,120,1,10241,620
2020-08-08,Spain,NA,Galicia,2700441,82,0,10323,620
2020-08-09,Spain,NA,Galicia,2700441,64,2,10387,622
2020-08-10,Spain,NA,Galicia,2700441,114,0,10501,622
2020-08-11,Spain,NA,Galicia,2700441,114,0,10615,622
2020-08-12,Spain,NA,Galicia,2700441,138,0,10753,622
2020-08-13,Spain,NA,Galicia,2700441,127,1,10880,623
2020-08-14,Spain,NA,Galicia,2700441,161,0,11041,623
2020-08-15,Spain,NA,Galicia,2700441,173,2,11214,625
2020-08-16,Spain,NA,Galicia,2700441,117,0,11331,625
2020-08-17,Spain,NA,Galicia,2700441,204,0,11535,625
2020-08-18,Spain,NA,Galicia,2700441,226,0,11761,625
2020-08-19,Spain,NA,Galicia,2700441,244,1,12005,626
2020-08-20,Spain,NA,Galicia,2700441,211,1,12216,627
2020-08-21,Spain,NA,Galicia,2700441,248,3,12464,630
2020-08-22,Spain,NA,Galicia,2700441,234,2,12698,632
2020-08-23,Spain,NA,Galicia,2700441,210,1,12908,633
2020-08-24,Spain,NA,Galicia,2700441,280,0,13188,633
2020-08-25,Spain,NA,Galicia,2700441,268,0,13456,633
2020-08-26,Spain,NA,Galicia,2700441,289,1,13745,634
2020-08-27,Spain,NA,Galicia,2700441,275,0,14020,634
2020-08-28,Spain,NA,Galicia,2700441,318,3,14338,637
2020-08-29,Spain,NA,Galicia,2700441,272,3,14610,640
2020-08-30,Spain,NA,Galicia,2700441,206,2,14816,642
2020-08-31,Spain,NA,Galicia,2700441,201,2,15017,644
2020-09-01,Spain,NA,Galicia,2700441,257,1,15274,645
2020-09-02,Spain,NA,Galicia,2700441,256,5,15530,650
2020-09-03,Spain,NA,Galicia,2700441,258,4,15788,654
2020-09-04,Spain,NA,Galicia,2700441,235,3,16023,657
2020-09-05,Spain,NA,Galicia,2700441,221,3,16244,660
2020-09-06,Spain,NA,Galicia,2700441,165,2,16409,662
2020-09-07,Spain,NA,Galicia,2700441,322,2,16731,664
2020-09-08,Spain,NA,Galicia,2700441,266,3,16997,667
2020-09-09,Spain,NA,Galicia,2700441,215,8,17212,675
2020-09-10,Spain,NA,Galicia,2700441,248,2,17460,677
2020-09-11,Spain,NA,Galicia,2700441,208,3,17668,680
2020-09-12,Spain,NA,Galicia,2700441,236,2,17904,682
2020-09-13,Spain,NA,Galicia,2700441,232,6,18136,688
2020-09-14,Spain,NA,Galicia,2700441,187,6,18323,694
2020-09-15,Spain,NA,Galicia,2700441,218,3,18541,697
2020-09-16,Spain,NA,Galicia,2700441,212,5,18753,702
2020-09-17,Spain,NA,Galicia,2700441,276,3,19029,705
2020-09-18,Spain,NA,Galicia,2700441,215,5,19244,710
2020-09-19,Spain,NA,Galicia,2700441,187,6,19431,716
2020-09-20,Spain,NA,Galicia,2700441,178,3,19609,719
2020-09-21,Spain,NA,Galicia,2700441,147,1,19756,720
2020-09-22,Spain,NA,Galicia,2700441,216,1,19972,721
2020-09-23,Spain,NA,Galicia,2700441,21,2,19993,723
2020-03-01,Spain,NA,Islas Baleares,1188220,4,0,14,0
2020-03-02,Spain,NA,Islas Baleares,1188220,6,0,20,0
2020-03-03,Spain,NA,Islas Baleares,1188220,8,0,28,0
2020-03-04,Spain,NA,Islas Baleares,1188220,5,0,33,0
2020-03-05,Spain,NA,Islas Baleares,1188220,12,0,45,0
2020-03-06,Spain,NA,Islas Baleares,1188220,10,0,55,0
2020-03-07,Spain,NA,Islas Baleares,1188220,6,0,61,0
2020-03-08,Spain,NA,Islas Baleares,1188220,12,0,73,0
2020-03-09,Spain,NA,Islas Baleares,1188220,16,0,89,0
2020-03-10,Spain,NA,Islas Baleares,1188220,34,0,123,0
2020-03-11,Spain,NA,Islas Baleares,1188220,41,0,164,0
2020-03-12,Spain,NA,Islas Baleares,1188220,39,3,203,3
2020-03-13,Spain,NA,Islas Baleares,1188220,61,0,264,3
2020-03-14,Spain,NA,Islas Baleares,1188220,68,0,332,3
2020-03-15,Spain,NA,Islas Baleares,1188220,83,0,415,3
2020-03-16,Spain,NA,Islas Baleares,1188220,84,0,499,3
2020-03-17,Spain,NA,Islas Baleares,1188220,79,1,578,4
2020-03-18,Spain,NA,Islas Baleares,1188220,80,0,658,4
2020-03-19,Spain,NA,Islas Baleares,1188220,102,1,760,5
2020-03-20,Spain,NA,Islas Baleares,1188220,95,1,855,6
2020-03-21,Spain,NA,Islas Baleares,1188220,61,5,916,11
2020-03-22,Spain,NA,Islas Baleares,1188220,90,3,1006,14
2020-03-23,Spain,NA,Islas Baleares,1188220,79,3,1085,17
2020-03-24,Spain,NA,Islas Baleares,1188220,65,5,1150,22
2020-03-25,Spain,NA,Islas Baleares,1188220,80,3,1230,25
2020-03-26,Spain,NA,Islas Baleares,1188220,68,3,1298,28
2020-03-27,Spain,NA,Islas Baleares,1188220,37,7,1335,35
2020-03-28,Spain,NA,Islas Baleares,1188220,32,6,1367,41
2020-03-29,Spain,NA,Islas Baleares,1188220,36,6,1403,47
2020-03-30,Spain,NA,Islas Baleares,1188220,61,7,1464,54
2020-03-31,Spain,NA,Islas Baleares,1188220,45,8,1509,62
2020-04-01,Spain,NA,Islas Baleares,1188220,81,7,1590,69
2020-04-02,Spain,NA,Islas Baleares,1188220,34,9,1624,78
2020-04-03,Spain,NA,Islas Baleares,1188220,43,5,1667,83
2020-04-04,Spain,NA,Islas Baleares,1188220,23,6,1690,89
2020-04-05,Spain,NA,Islas Baleares,1188220,27,2,1717,91
2020-04-06,Spain,NA,Islas Baleares,1188220,21,2,1738,93
2020-04-07,Spain,NA,Islas Baleares,1188220,18,8,1756,101
2020-04-08,Spain,NA,Islas Baleares,1188220,22,10,1778,111
2020-04-09,Spain,NA,Islas Baleares,1188220,8,5,1786,116
2020-04-10,Spain,NA,Islas Baleares,1188220,17,8,1803,124
2020-04-11,Spain,NA,Islas Baleares,1188220,14,5,1817,129
2020-04-12,Spain,NA,Islas Baleares,1188220,15,2,1832,131
2020-04-13,Spain,NA,Islas Baleares,1188220,10,4,1842,135
2020-04-14,Spain,NA,Islas Baleares,1188220,8,8,1850,143
2020-04-15,Spain,NA,Islas Baleares,1188220,5,8,1855,151
2020-04-16,Spain,NA,Islas Baleares,1188220,15,6,1870,157
2020-04-17,Spain,NA,Islas Baleares,1188220,7,8,1877,165
2020-04-18,Spain,NA,Islas Baleares,1188220,12,3,1889,168
2020-04-19,Spain,NA,Islas Baleares,1188220,8,3,1897,171
2020-04-20,Spain,NA,Islas Baleares,1188220,14,1,1911,172
2020-04-21,Spain,NA,Islas Baleares,1188220,7,3,1918,175
2020-04-22,Spain,NA,Islas Baleares,1188220,5,2,1923,177
2020-04-23,Spain,NA,Islas Baleares,1188220,5,2,1928,179
2020-04-24,Spain,NA,Islas Baleares,1188220,9,1,1937,180
2020-04-25,Spain,NA,Islas Baleares,1188220,10,5,1947,185
2020-04-26,Spain,NA,Islas Baleares,1188220,0,2,1947,187
2020-04-27,Spain,NA,Islas Baleares,1188220,3,2,1950,189
2020-04-28,Spain,NA,Islas Baleares,1188220,4,6,1954,195
2020-04-29,Spain,NA,Islas Baleares,1188220,2,3,1956,198
2020-04-30,Spain,NA,Islas Baleares,1188220,5,4,1961,202
2020-05-01,Spain,NA,Islas Baleares,1188220,8,1,1969,203
2020-05-02,Spain,NA,Islas Baleares,1188220,1,0,1970,203
2020-05-03,Spain,NA,Islas Baleares,1188220,3,1,1973,204
2020-05-04,Spain,NA,Islas Baleares,1188220,2,1,1975,205
2020-05-05,Spain,NA,Islas Baleares,1188220,4,1,1979,206
2020-05-06,Spain,NA,Islas Baleares,1188220,4,0,1983,206
2020-05-07,Spain,NA,Islas Baleares,1188220,2,4,1985,210
2020-05-08,Spain,NA,Islas Baleares,1188220,4,0,1989,210
2020-05-09,Spain,NA,Islas Baleares,1188220,0,0,1989,210
2020-05-10,Spain,NA,Islas Baleares,1188220,6,4,1995,214
2020-05-11,Spain,NA,Islas Baleares,1188220,9,2,2004,216
2020-05-12,Spain,NA,Islas Baleares,1188220,7,0,2011,216
2020-05-13,Spain,NA,Islas Baleares,1188220,10,1,2021,217
2020-05-14,Spain,NA,Islas Baleares,1188220,7,1,2028,218
2020-05-15,Spain,NA,Islas Baleares,1188220,15,1,2043,219
2020-05-16,Spain,NA,Islas Baleares,1188220,0,0,2043,219
2020-05-17,Spain,NA,Islas Baleares,1188220,5,0,2048,219
2020-05-18,Spain,NA,Islas Baleares,1188220,5,2,2053,221
2020-05-19,Spain,NA,Islas Baleares,1188220,12,0,2065,221
2020-05-20,Spain,NA,Islas Baleares,1188220,6,1,2071,222
2020-05-21,Spain,NA,Islas Baleares,1188220,5,0,2076,222
2020-05-22,Spain,NA,Islas Baleares,1188220,3,0,2079,222
2020-05-23,Spain,NA,Islas Baleares,1188220,2,1,2081,223
2020-05-24,Spain,NA,Islas Baleares,1188220,1,0,2082,223
2020-05-25,Spain,NA,Islas Baleares,1188220,3,0,2085,223
2020-05-26,Spain,NA,Islas Baleares,1188220,4,1,2089,224
2020-05-27,Spain,NA,Islas Baleares,1188220,3,0,2092,224
2020-05-28,Spain,NA,Islas Baleares,1188220,13,0,2105,224
2020-05-29,Spain,NA,Islas Baleares,1188220,4,0,2109,224
2020-05-30,Spain,NA,Islas Baleares,1188220,1,0,2110,224
2020-05-31,Spain,NA,Islas Baleares,1188220,2,0,2112,224
2020-06-01,Spain,NA,Islas Baleares,1188220,3,0,2115,224
2020-06-02,Spain,NA,Islas Baleares,1188220,7,0,2122,224
2020-06-03,Spain,NA,Islas Baleares,1188220,3,0,2125,224
2020-06-04,Spain,NA,Islas Baleares,1188220,6,0,2131,224
2020-06-05,Spain,NA,Islas Baleares,1188220,2,0,2133,224
2020-06-06,Spain,NA,Islas Baleares,1188220,2,0,2135,224
2020-06-07,Spain,NA,Islas Baleares,1188220,3,0,2138,224
2020-06-08,Spain,NA,Islas Baleares,1188220,2,0,2140,224
2020-06-09,Spain,NA,Islas Baleares,1188220,1,0,2141,224
2020-06-10,Spain,NA,Islas Baleares,1188220,3,0,2144,224
2020-06-11,Spain,NA,Islas Baleares,1188220,4,0,2148,224
2020-06-12,Spain,NA,Islas Baleares,1188220,6,0,2154,224
2020-06-13,Spain,NA,Islas Baleares,1188220,2,0,2156,224
2020-06-14,Spain,NA,Islas Baleares,1188220,4,0,2160,224
2020-06-15,Spain,NA,Islas Baleares,1188220,3,0,2163,224
2020-06-16,Spain,NA,Islas Baleares,1188220,5,0,2168,224
2020-06-17,Spain,NA,Islas Baleares,1188220,4,0,2172,224
2020-06-18,Spain,NA,Islas Baleares,1188220,5,0,2177,224
2020-06-19,Spain,NA,Islas Baleares,1188220,8,0,2185,224
2020-06-20,Spain,NA,Islas Baleares,1188220,3,0,2188,224
2020-06-21,Spain,NA,Islas Baleares,1188220,2,0,2190,224
2020-06-22,Spain,NA,Islas Baleares,1188220,1,0,2191,224
2020-06-23,Spain,NA,Islas Baleares,1188220,5,0,2196,224
2020-06-24,Spain,NA,Islas Baleares,1188220,3,0,2199,224
2020-06-25,Spain,NA,Islas Baleares,1188220,1,0,2200,224
2020-06-26,Spain,NA,Islas Baleares,1188220,10,0,2210,224
2020-06-27,Spain,NA,Islas Baleares,1188220,5,0,2215,224
2020-06-28,Spain,NA,Islas Baleares,1188220,5,0,2220,224
2020-06-29,Spain,NA,Islas Baleares,1188220,9,0,2229,224
2020-06-30,Spain,NA,Islas Baleares,1188220,3,0,2232,224
2020-07-01,Spain,NA,Islas Baleares,1188220,4,0,2236,224
2020-07-02,Spain,NA,Islas Baleares,1188220,3,0,2239,224
2020-07-03,Spain,NA,Islas Baleares,1188220,4,0,2243,224
2020-07-04,Spain,NA,Islas Baleares,1188220,3,0,2246,224
2020-07-05,Spain,NA,Islas Baleares,1188220,3,0,2249,224
2020-07-06,Spain,NA,Islas Baleares,1188220,3,0,2252,224
2020-07-07,Spain,NA,Islas Baleares,1188220,1,0,2253,224
2020-07-08,Spain,NA,Islas Baleares,1188220,4,0,2257,224
2020-07-09,Spain,NA,Islas Baleares,1188220,6,0,2263,224
2020-07-10,Spain,NA,Islas Baleares,1188220,8,0,2271,224
2020-07-11,Spain,NA,Islas Baleares,1188220,7,0,2278,224
2020-07-12,Spain,NA,Islas Baleares,1188220,4,0,2282,224
2020-07-13,Spain,NA,Islas Baleares,1188220,8,0,2290,224
2020-07-14,Spain,NA,Islas Baleares,1188220,11,0,2301,224
2020-07-15,Spain,NA,Islas Baleares,1188220,14,0,2315,224
2020-07-16,Spain,NA,Islas Baleares,1188220,8,0,2323,224
2020-07-17,Spain,NA,Islas Baleares,1188220,6,0,2329,224
2020-07-18,Spain,NA,Islas Baleares,1188220,7,0,2336,224
2020-07-19,Spain,NA,Islas Baleares,1188220,5,0,2341,224
2020-07-20,Spain,NA,Islas Baleares,1188220,16,0,2357,224
2020-07-21,Spain,NA,Islas Baleares,1188220,13,0,2370,224
2020-07-22,Spain,NA,Islas Baleares,1188220,13,0,2383,224
2020-07-23,Spain,NA,Islas Baleares,1188220,21,0,2404,224
2020-07-24,Spain,NA,Islas Baleares,1188220,26,0,2430,224
2020-07-25,Spain,NA,Islas Baleares,1188220,23,0,2453,224
2020-07-26,Spain,NA,Islas Baleares,1188220,47,0,2500,224
2020-07-27,Spain,NA,Islas Baleares,1188220,40,0,2540,224
2020-07-28,Spain,NA,Islas Baleares,1188220,52,0,2592,224
2020-07-29,Spain,NA,Islas Baleares,1188220,55,0,2647,224
2020-07-30,Spain,NA,Islas Baleares,1188220,76,0,2723,224
2020-07-31,Spain,NA,Islas Baleares,1188220,78,0,2801,224
2020-08-01,Spain,NA,Islas Baleares,1188220,114,0,2915,224
2020-08-02,Spain,NA,Islas Baleares,1188220,96,0,3011,224
2020-08-03,Spain,NA,Islas Baleares,1188220,151,0,3162,224
2020-08-04,Spain,NA,Islas Baleares,1188220,171,0,3333,224
2020-08-05,Spain,NA,Islas Baleares,1188220,157,0,3490,224
2020-08-06,Spain,NA,Islas Baleares,1188220,170,1,3660,225
2020-08-07,Spain,NA,Islas Baleares,1188220,190,0,3850,225
2020-08-08,Spain,NA,Islas Baleares,1188220,187,0,4037,225
2020-08-09,Spain,NA,Islas Baleares,1188220,167,0,4204,225
2020-08-10,Spain,NA,Islas Baleares,1188220,312,0,4516,225
2020-08-11,Spain,NA,Islas Baleares,1188220,257,0,4773,225
2020-08-12,Spain,NA,Islas Baleares,1188220,267,0,5040,225
2020-08-13,Spain,NA,Islas Baleares,1188220,296,0,5336,225
2020-08-14,Spain,NA,Islas Baleares,1188220,294,0,5630,225
2020-08-15,Spain,NA,Islas Baleares,1188220,230,0,5860,225
2020-08-16,Spain,NA,Islas Baleares,1188220,222,1,6082,226
2020-08-17,Spain,NA,Islas Baleares,1188220,363,2,6445,228
2020-08-18,Spain,NA,Islas Baleares,1188220,317,1,6762,229
2020-08-19,Spain,NA,Islas Baleares,1188220,336,1,7098,230
2020-08-20,Spain,NA,Islas Baleares,1188220,350,0,7448,230
2020-08-21,Spain,NA,Islas Baleares,1188220,308,0,7756,230
2020-08-22,Spain,NA,Islas Baleares,1188220,230,0,7986,230
2020-08-23,Spain,NA,Islas Baleares,1188220,195,2,8181,232
2020-08-24,Spain,NA,Islas Baleares,1188220,254,3,8435,235
2020-08-25,Spain,NA,Islas Baleares,1188220,275,0,8710,235
2020-08-26,Spain,NA,Islas Baleares,1188220,293,2,9003,237
2020-08-27,Spain,NA,Islas Baleares,1188220,220,1,9223,238
2020-08-28,Spain,NA,Islas Baleares,1188220,254,2,9477,240
2020-08-29,Spain,NA,Islas Baleares,1188220,204,0,9681,240
2020-08-30,Spain,NA,Islas Baleares,1188220,154,8,9835,248
2020-08-31,Spain,NA,Islas Baleares,1188220,236,2,10071,250
2020-09-01,Spain,NA,Islas Baleares,1188220,220,2,10291,252
2020-09-02,Spain,NA,Islas Baleares,1188220,194,3,10485,255
2020-09-03,Spain,NA,Islas Baleares,1188220,182,2,10667,257
2020-09-04,Spain,NA,Islas Baleares,1188220,139,2,10806,259
2020-09-05,Spain,NA,Islas Baleares,1188220,142,0,10948,259
2020-09-06,Spain,NA,Islas Baleares,1188220,113,1,11061,260
2020-09-07,Spain,NA,Islas Baleares,1188220,180,2,11241,262
2020-09-08,Spain,NA,Islas Baleares,1188220,145,4,11386,266
2020-09-09,Spain,NA,Islas Baleares,1188220,146,2,11532,268
2020-09-10,Spain,NA,Islas Baleares,1188220,167,2,11699,270
2020-09-11,Spain,NA,Islas Baleares,1188220,149,1,11848,271
2020-09-12,Spain,NA,Islas Baleares,1188220,106,3,11954,274
2020-09-13,Spain,NA,Islas Baleares,1188220,123,2,12077,276
2020-09-14,Spain,NA,Islas Baleares,1188220,169,0,12246,276
2020-09-15,Spain,NA,Islas Baleares,1188220,191,1,12437,277
2020-09-16,Spain,NA,Islas Baleares,1188220,165,1,12602,278
2020-09-17,Spain,NA,Islas Baleares,1188220,147,1,12749,279
2020-09-18,Spain,NA,Islas Baleares,1188220,117,2,12866,281
2020-09-19,Spain,NA,Islas Baleares,1188220,85,2,12951,283
2020-09-20,Spain,NA,Islas Baleares,1188220,64,1,13015,284
2020-09-21,Spain,NA,Islas Baleares,1188220,53,2,13068,286
2020-09-22,Spain,NA,Islas Baleares,1188220,57,0,13125,286
2020-09-23,Spain,NA,Islas Baleares,1188220,16,0,13141,286
2020-02-25,Spain,NA,Islas Canarias,2206901,1,0,11,0
2020-02-26,Spain,NA,Islas Canarias,2206901,7,0,18,0
2020-02-27,Spain,NA,Islas Canarias,2206901,1,0,19,0
2020-02-28,Spain,NA,Islas Canarias,2206901,7,0,26,0
2020-02-29,Spain,NA,Islas Canarias,2206901,6,0,32,0
2020-03-01,Spain,NA,Islas Canarias,2206901,7,0,39,0
2020-03-02,Spain,NA,Islas Canarias,2206901,12,0,51,0
2020-03-03,Spain,NA,Islas Canarias,2206901,9,0,60,0
2020-03-04,Spain,NA,Islas Canarias,2206901,14,0,74,0
2020-03-05,Spain,NA,Islas Canarias,2206901,15,0,89,0
2020-03-06,Spain,NA,Islas Canarias,2206901,24,0,113,0
2020-03-07,Spain,NA,Islas Canarias,2206901,18,0,131,0
2020-03-08,Spain,NA,Islas Canarias,2206901,30,0,161,0
2020-03-09,Spain,NA,Islas Canarias,2206901,40,0,201,0
2020-03-10,Spain,NA,Islas Canarias,2206901,50,0,251,0
2020-03-11,Spain,NA,Islas Canarias,2206901,54,0,305,0
2020-03-12,Spain,NA,Islas Canarias,2206901,69,0,374,0
2020-03-13,Spain,NA,Islas Canarias,2206901,100,1,474,1
2020-03-14,Spain,NA,Islas Canarias,2206901,93,0,567,1
2020-03-15,Spain,NA,Islas Canarias,2206901,89,1,656,2
2020-03-16,Spain,NA,Islas Canarias,2206901,117,1,773,3
2020-03-17,Spain,NA,Islas Canarias,2206901,90,1,863,4
2020-03-18,Spain,NA,Islas Canarias,2206901,109,0,972,4
2020-03-19,Spain,NA,Islas Canarias,2206901,70,3,1042,7
2020-03-20,Spain,NA,Islas Canarias,2206901,111,3,1153,10
2020-03-21,Spain,NA,Islas Canarias,2206901,77,0,1230,10
2020-03-22,Spain,NA,Islas Canarias,2206901,73,4,1303,14
2020-03-23,Spain,NA,Islas Canarias,2206901,91,4,1394,18
2020-03-24,Spain,NA,Islas Canarias,2206901,59,5,1453,23
2020-03-25,Spain,NA,Islas Canarias,2206901,54,6,1507,29
2020-03-26,Spain,NA,Islas Canarias,2206901,60,9,1567,38
2020-03-27,Spain,NA,Islas Canarias,2206901,69,10,1636,48
2020-03-28,Spain,NA,Islas Canarias,2206901,35,5,1671,53
2020-03-29,Spain,NA,Islas Canarias,2206901,42,5,1713,58
2020-03-30,Spain,NA,Islas Canarias,2206901,49,4,1762,62
2020-03-31,Spain,NA,Islas Canarias,2206901,27,7,1789,69
2020-04-01,Spain,NA,Islas Canarias,2206901,52,7,1841,76
2020-04-02,Spain,NA,Islas Canarias,2206901,32,7,1873,83
2020-04-03,Spain,NA,Islas Canarias,2206901,17,5,1890,88
2020-04-04,Spain,NA,Islas Canarias,2206901,28,3,1918,91
2020-04-05,Spain,NA,Islas Canarias,2206901,15,2,1933,93
2020-04-06,Spain,NA,Islas Canarias,2206901,13,3,1946,96
2020-04-07,Spain,NA,Islas Canarias,2206901,24,0,1970,96
2020-04-08,Spain,NA,Islas Canarias,2206901,14,4,1984,100
2020-04-09,Spain,NA,Islas Canarias,2206901,23,1,2007,101
2020-04-10,Spain,NA,Islas Canarias,2206901,13,0,2020,101
2020-04-11,Spain,NA,Islas Canarias,2206901,14,2,2034,103
2020-04-12,Spain,NA,Islas Canarias,2206901,8,0,2042,103
2020-04-13,Spain,NA,Islas Canarias,2206901,13,3,2055,106
2020-04-14,Spain,NA,Islas Canarias,2206901,12,2,2067,108
2020-04-15,Spain,NA,Islas Canarias,2206901,15,6,2082,114
2020-04-16,Spain,NA,Islas Canarias,2206901,14,3,2096,117
2020-04-17,Spain,NA,Islas Canarias,2206901,8,3,2104,120
2020-04-18,Spain,NA,Islas Canarias,2206901,9,1,2113,121
2020-04-19,Spain,NA,Islas Canarias,2206901,15,1,2128,122
2020-04-20,Spain,NA,Islas Canarias,2206901,15,1,2143,123
2020-04-21,Spain,NA,Islas Canarias,2206901,7,3,2150,126
2020-04-22,Spain,NA,Islas Canarias,2206901,7,3,2157,129
2020-04-23,Spain,NA,Islas Canarias,2206901,3,3,2160,132
2020-04-24,Spain,NA,Islas Canarias,2206901,10,4,2170,136
2020-04-25,Spain,NA,Islas Canarias,2206901,4,0,2174,136
2020-04-26,Spain,NA,Islas Canarias,2206901,2,1,2176,137
2020-04-27,Spain,NA,Islas Canarias,2206901,3,1,2179,138
2020-04-28,Spain,NA,Islas Canarias,2206901,1,1,2180,139
2020-04-29,Spain,NA,Islas Canarias,2206901,3,1,2183,140
2020-04-30,Spain,NA,Islas Canarias,2206901,4,1,2187,141
2020-05-01,Spain,NA,Islas Canarias,2206901,9,2,2196,143
2020-05-02,Spain,NA,Islas Canarias,2206901,5,1,2201,144
2020-05-03,Spain,NA,Islas Canarias,2206901,0,1,2201,145
2020-05-04,Spain,NA,Islas Canarias,2206901,3,0,2204,145
2020-05-05,Spain,NA,Islas Canarias,2206901,2,1,2206,146
2020-05-06,Spain,NA,Islas Canarias,2206901,0,4,2206,150
2020-05-07,Spain,NA,Islas Canarias,2206901,1,0,2207,150
2020-05-08,Spain,NA,Islas Canarias,2206901,1,1,2208,151
2020-05-09,Spain,NA,Islas Canarias,2206901,2,0,2210,151
2020-05-10,Spain,NA,Islas Canarias,2206901,1,0,2211,151
2020-05-11,Spain,NA,Islas Canarias,2206901,3,1,2214,152
2020-05-12,Spain,NA,Islas Canarias,2206901,4,0,2218,152
2020-05-13,Spain,NA,Islas Canarias,2206901,5,0,2223,152
2020-05-14,Spain,NA,Islas Canarias,2206901,2,0,2225,152
2020-05-15,Spain,NA,Islas Canarias,2206901,3,0,2228,152
2020-05-16,Spain,NA,Islas Canarias,2206901,6,2,2234,154
2020-05-17,Spain,NA,Islas Canarias,2206901,1,2,2235,156
2020-05-18,Spain,NA,Islas Canarias,2206901,4,1,2239,157
2020-05-19,Spain,NA,Islas Canarias,2206901,7,0,2246,157
2020-05-20,Spain,NA,Islas Canarias,2206901,4,0,2250,157
2020-05-21,Spain,NA,Islas Canarias,2206901,5,0,2255,157
2020-05-22,Spain,NA,Islas Canarias,2206901,3,0,2258,157
2020-05-23,Spain,NA,Islas Canarias,2206901,1,0,2259,157
2020-05-24,Spain,NA,Islas Canarias,2206901,2,0,2261,157
2020-05-25,Spain,NA,Islas Canarias,2206901,4,1,2265,158
2020-05-26,Spain,NA,Islas Canarias,2206901,3,1,2268,159
2020-05-27,Spain,NA,Islas Canarias,2206901,2,1,2270,160
2020-05-28,Spain,NA,Islas Canarias,2206901,7,0,2277,160
2020-05-29,Spain,NA,Islas Canarias,2206901,7,0,2284,160
2020-05-30,Spain,NA,Islas Canarias,2206901,3,0,2287,160
2020-05-31,Spain,NA,Islas Canarias,2206901,1,0,2288,160
2020-06-01,Spain,NA,Islas Canarias,2206901,4,0,2292,160
2020-06-02,Spain,NA,Islas Canarias,2206901,4,1,2296,161
2020-06-03,Spain,NA,Islas Canarias,2206901,4,0,2300,161
2020-06-04,Spain,NA,Islas Canarias,2206901,1,0,2301,161
2020-06-05,Spain,NA,Islas Canarias,2206901,1,0,2302,161
2020-06-06,Spain,NA,Islas Canarias,2206901,4,0,2306,161
2020-06-07,Spain,NA,Islas Canarias,2206901,1,0,2307,161
2020-06-08,Spain,NA,Islas Canarias,2206901,2,0,2309,161
2020-06-09,Spain,NA,Islas Canarias,2206901,2,0,2311,161
2020-06-10,Spain,NA,Islas Canarias,2206901,1,1,2312,162
2020-06-11,Spain,NA,Islas Canarias,2206901,2,0,2314,162
2020-06-12,Spain,NA,Islas Canarias,2206901,4,0,2318,162
2020-06-13,Spain,NA,Islas Canarias,2206901,2,0,2320,162
2020-06-14,Spain,NA,Islas Canarias,2206901,1,0,2321,162
2020-06-15,Spain,NA,Islas Canarias,2206901,1,0,2322,162
2020-06-16,Spain,NA,Islas Canarias,2206901,3,0,2325,162
2020-06-17,Spain,NA,Islas Canarias,2206901,14,0,2339,162
2020-06-18,Spain,NA,Islas Canarias,2206901,0,0,2339,162
2020-06-19,Spain,NA,Islas Canarias,2206901,1,0,2340,162
2020-06-20,Spain,NA,Islas Canarias,2206901,11,0,2351,162
2020-06-21,Spain,NA,Islas Canarias,2206901,2,0,2353,162
2020-06-22,Spain,NA,Islas Canarias,2206901,0,0,2353,162
2020-06-23,Spain,NA,Islas Canarias,2206901,6,0,2359,162
2020-06-24,Spain,NA,Islas Canarias,2206901,1,0,2360,162
2020-06-25,Spain,NA,Islas Canarias,2206901,1,0,2361,162
2020-06-26,Spain,NA,Islas Canarias,2206901,1,0,2362,162
2020-06-27,Spain,NA,Islas Canarias,2206901,0,0,2362,162
2020-06-28,Spain,NA,Islas Canarias,2206901,0,0,2362,162
2020-06-29,Spain,NA,Islas Canarias,2206901,0,0,2362,162
2020-06-30,Spain,NA,Islas Canarias,2206901,5,0,2367,162
2020-07-01,Spain,NA,Islas Canarias,2206901,8,0,2375,162
2020-07-02,Spain,NA,Islas Canarias,2206901,1,0,2376,162
2020-07-03,Spain,NA,Islas Canarias,2206901,4,0,2380,162
2020-07-04,Spain,NA,Islas Canarias,2206901,4,0,2384,162
2020-07-05,Spain,NA,Islas Canarias,2206901,1,0,2385,162
2020-07-06,Spain,NA,Islas Canarias,2206901,3,0,2388,162
2020-07-07,Spain,NA,Islas Canarias,2206901,4,0,2392,162
2020-07-08,Spain,NA,Islas Canarias,2206901,8,0,2400,162
2020-07-09,Spain,NA,Islas Canarias,2206901,8,0,2408,162
2020-07-10,Spain,NA,Islas Canarias,2206901,3,0,2411,162
2020-07-11,Spain,NA,Islas Canarias,2206901,1,0,2412,162
2020-07-12,Spain,NA,Islas Canarias,2206901,3,0,2415,162
2020-07-13,Spain,NA,Islas Canarias,2206901,6,0,2421,162
2020-07-14,Spain,NA,Islas Canarias,2206901,2,0,2423,162
2020-07-15,Spain,NA,Islas Canarias,2206901,9,0,2432,162
2020-07-16,Spain,NA,Islas Canarias,2206901,4,0,2436,162
2020-07-17,Spain,NA,Islas Canarias,2206901,7,0,2443,162
2020-07-18,Spain,NA,Islas Canarias,2206901,13,0,2456,162
2020-07-19,Spain,NA,Islas Canarias,2206901,53,0,2509,162
2020-07-20,Spain,NA,Islas Canarias,2206901,3,0,2512,162
2020-07-21,Spain,NA,Islas Canarias,2206901,11,0,2523,162
2020-07-22,Spain,NA,Islas Canarias,2206901,8,0,2531,162
2020-07-23,Spain,NA,Islas Canarias,2206901,11,0,2542,162
2020-07-24,Spain,NA,Islas Canarias,2206901,5,0,2547,162
2020-07-25,Spain,NA,Islas Canarias,2206901,13,0,2560,162
2020-07-26,Spain,NA,Islas Canarias,2206901,7,0,2567,162
2020-07-27,Spain,NA,Islas Canarias,2206901,8,0,2575,162
2020-07-28,Spain,NA,Islas Canarias,2206901,9,0,2584,162
2020-07-29,Spain,NA,Islas Canarias,2206901,7,0,2591,162
2020-07-30,Spain,NA,Islas Canarias,2206901,12,0,2603,162
2020-07-31,Spain,NA,Islas Canarias,2206901,16,0,2619,162
2020-08-01,Spain,NA,Islas Canarias,2206901,29,0,2648,162
2020-08-02,Spain,NA,Islas Canarias,2206901,29,0,2677,162
2020-08-03,Spain,NA,Islas Canarias,2206901,37,0,2714,162
2020-08-04,Spain,NA,Islas Canarias,2206901,54,0,2768,162
2020-08-05,Spain,NA,Islas Canarias,2206901,71,0,2839,162
2020-08-06,Spain,NA,Islas Canarias,2206901,77,0,2916,162
2020-08-07,Spain,NA,Islas Canarias,2206901,68,1,2984,163
2020-08-08,Spain,NA,Islas Canarias,2206901,68,1,3052,164
2020-08-09,Spain,NA,Islas Canarias,2206901,90,0,3142,164
2020-08-10,Spain,NA,Islas Canarias,2206901,139,0,3281,164
2020-08-11,Spain,NA,Islas Canarias,2206901,153,0,3434,164
2020-08-12,Spain,NA,Islas Canarias,2206901,184,0,3618,164
2020-08-13,Spain,NA,Islas Canarias,2206901,149,0,3767,164
2020-08-14,Spain,NA,Islas Canarias,2206901,196,1,3963,165
2020-08-15,Spain,NA,Islas Canarias,2206901,209,0,4172,165
2020-08-16,Spain,NA,Islas Canarias,2206901,148,1,4320,166
2020-08-17,Spain,NA,Islas Canarias,2206901,241,0,4561,166
2020-08-18,Spain,NA,Islas Canarias,2206901,230,0,4791,166
2020-08-19,Spain,NA,Islas Canarias,2206901,194,0,4985,166
2020-08-20,Spain,NA,Islas Canarias,2206901,232,1,5217,167
2020-08-21,Spain,NA,Islas Canarias,2206901,245,0,5462,167
2020-08-22,Spain,NA,Islas Canarias,2206901,268,0,5730,167
2020-08-23,Spain,NA,Islas Canarias,2206901,214,1,5944,168
2020-08-24,Spain,NA,Islas Canarias,2206901,294,0,6238,168
2020-08-25,Spain,NA,Islas Canarias,2206901,296,1,6534,169
2020-08-26,Spain,NA,Islas Canarias,2206901,298,2,6832,171
2020-08-27,Spain,NA,Islas Canarias,2206901,300,1,7132,172
2020-08-28,Spain,NA,Islas Canarias,2206901,279,1,7411,173
2020-08-29,Spain,NA,Islas Canarias,2206901,283,1,7694,174
2020-08-30,Spain,NA,Islas Canarias,2206901,273,0,7967,174
2020-08-31,Spain,NA,Islas Canarias,2206901,292,0,8259,174
2020-09-01,Spain,NA,Islas Canarias,2206901,270,1,8529,175
2020-09-02,Spain,NA,Islas Canarias,2206901,253,3,8782,178
2020-09-03,Spain,NA,Islas Canarias,2206901,260,1,9042,179
2020-09-04,Spain,NA,Islas Canarias,2206901,269,1,9311,180
2020-09-05,Spain,NA,Islas Canarias,2206901,244,4,9555,184
2020-09-06,Spain,NA,Islas Canarias,2206901,185,2,9740,186
2020-09-07,Spain,NA,Islas Canarias,2206901,196,2,9936,188
2020-09-08,Spain,NA,Islas Canarias,2206901,193,3,10129,191
2020-09-09,Spain,NA,Islas Canarias,2206901,227,1,10356,192
2020-09-10,Spain,NA,Islas Canarias,2206901,231,2,10587,194
2020-09-11,Spain,NA,Islas Canarias,2206901,197,3,10784,197
2020-09-12,Spain,NA,Islas Canarias,2206901,211,0,10995,197
2020-09-13,Spain,NA,Islas Canarias,2206901,161,2,11156,199
2020-09-14,Spain,NA,Islas Canarias,2206901,142,6,11298,205
2020-09-15,Spain,NA,Islas Canarias,2206901,174,2,11472,207
2020-09-16,Spain,NA,Islas Canarias,2206901,136,1,11608,208
2020-09-17,Spain,NA,Islas Canarias,2206901,140,2,11748,210
2020-09-18,Spain,NA,Islas Canarias,2206901,156,2,11904,212
2020-09-19,Spain,NA,Islas Canarias,2206901,138,2,12042,214
2020-09-20,Spain,NA,Islas Canarias,2206901,89,1,12131,215
2020-09-21,Spain,NA,Islas Canarias,2206901,111,1,12242,216
2020-09-22,Spain,NA,Islas Canarias,2206901,75,2,12317,218
2020-09-23,Spain,NA,Islas Canarias,2206901,44,0,12361,218
2020-02-26,Spain,NA,La Rioja,313571,4,0,11,0
2020-02-27,Spain,NA,La Rioja,313571,8,0,19,0
2020-02-28,Spain,NA,La Rioja,313571,10,0,29,0
2020-02-29,Spain,NA,La Rioja,313571,13,0,42,0
2020-03-01,Spain,NA,La Rioja,313571,22,0,64,0
2020-03-02,Spain,NA,La Rioja,313571,29,0,93,0
2020-03-03,Spain,NA,La Rioja,313571,27,0,120,0
2020-03-04,Spain,NA,La Rioja,313571,25,0,145,0
2020-03-05,Spain,NA,La Rioja,313571,27,0,172,0
2020-03-06,Spain,NA,La Rioja,313571,44,0,216,0
2020-03-07,Spain,NA,La Rioja,313571,39,0,255,0
2020-03-08,Spain,NA,La Rioja,313571,41,0,296,0
2020-03-09,Spain,NA,La Rioja,313571,59,1,355,1
2020-03-10,Spain,NA,La Rioja,313571,88,1,443,2
2020-03-11,Spain,NA,La Rioja,313571,68,0,511,2
2020-03-12,Spain,NA,La Rioja,313571,72,0,583,2
2020-03-13,Spain,NA,La Rioja,313571,106,1,689,3
2020-03-14,Spain,NA,La Rioja,313571,136,0,825,3
2020-03-15,Spain,NA,La Rioja,313571,109,1,934,4
2020-03-16,Spain,NA,La Rioja,313571,154,2,1088,6
2020-03-17,Spain,NA,La Rioja,313571,117,0,1205,6
2020-03-18,Spain,NA,La Rioja,313571,142,0,1347,6
2020-03-19,Spain,NA,La Rioja,313571,167,4,1514,10
2020-03-20,Spain,NA,La Rioja,313571,190,12,1704,22
2020-03-21,Spain,NA,La Rioja,313571,133,9,1837,31
2020-03-22,Spain,NA,La Rioja,313571,108,0,1945,31
2020-03-23,Spain,NA,La Rioja,313571,155,9,2100,40
2020-03-24,Spain,NA,La Rioja,313571,118,6,2218,46
2020-03-25,Spain,NA,La Rioja,313571,132,13,2350,59
2020-03-26,Spain,NA,La Rioja,313571,112,9,2462,68
2020-03-27,Spain,NA,La Rioja,313571,126,6,2588,74
2020-03-28,Spain,NA,La Rioja,313571,100,6,2688,80
2020-03-29,Spain,NA,La Rioja,313571,85,7,2773,87
2020-03-30,Spain,NA,La Rioja,313571,116,10,2889,97
2020-03-31,Spain,NA,La Rioja,313571,105,13,2994,110
2020-04-01,Spain,NA,La Rioja,313571,107,6,3101,116
2020-04-02,Spain,NA,La Rioja,313571,99,15,3200,131
2020-04-03,Spain,NA,La Rioja,313571,75,16,3275,147
2020-04-04,Spain,NA,La Rioja,313571,53,11,3328,158
2020-04-05,Spain,NA,La Rioja,313571,35,11,3363,169
2020-04-06,Spain,NA,La Rioja,313571,41,14,3404,183
2020-04-07,Spain,NA,La Rioja,313571,51,15,3455,198
2020-04-08,Spain,NA,La Rioja,313571,39,15,3494,213
2020-04-09,Spain,NA,La Rioja,313571,42,7,3536,220
2020-04-10,Spain,NA,La Rioja,313571,39,9,3575,229
2020-04-11,Spain,NA,La Rioja,313571,23,4,3598,233
2020-04-12,Spain,NA,La Rioja,313571,22,5,3620,238
2020-04-13,Spain,NA,La Rioja,313571,25,12,3645,250
2020-04-14,Spain,NA,La Rioja,313571,24,11,3669,261
2020-04-15,Spain,NA,La Rioja,313571,14,8,3683,269
2020-04-16,Spain,NA,La Rioja,313571,28,8,3711,277
2020-04-17,Spain,NA,La Rioja,313571,23,8,3734,285
2020-04-18,Spain,NA,La Rioja,313571,17,5,3751,290
2020-04-19,Spain,NA,La Rioja,313571,14,8,3765,298
2020-04-20,Spain,NA,La Rioja,313571,9,3,3774,301
2020-04-21,Spain,NA,La Rioja,313571,4,5,3778,306
2020-04-22,Spain,NA,La Rioja,313571,14,5,3792,311
2020-04-23,Spain,NA,La Rioja,313571,13,2,3805,313
2020-04-24,Spain,NA,La Rioja,313571,3,5,3808,318
2020-04-25,Spain,NA,La Rioja,313571,5,3,3813,321
2020-04-26,Spain,NA,La Rioja,313571,2,5,3815,326
2020-04-27,Spain,NA,La Rioja,313571,4,4,3819,330
2020-04-28,Spain,NA,La Rioja,313571,10,1,3829,331
2020-04-29,Spain,NA,La Rioja,313571,5,2,3834,333
2020-04-30,Spain,NA,La Rioja,313571,2,1,3836,334
2020-05-01,Spain,NA,La Rioja,313571,1,0,3837,334
2020-05-02,Spain,NA,La Rioja,313571,1,1,3838,335
2020-05-03,Spain,NA,La Rioja,313571,2,1,3840,336
2020-05-04,Spain,NA,La Rioja,313571,2,1,3842,337
2020-05-05,Spain,NA,La Rioja,313571,0,1,3842,338
2020-05-06,Spain,NA,La Rioja,313571,0,1,3842,339
2020-05-07,Spain,NA,La Rioja,313571,1,4,3843,343
2020-05-08,Spain,NA,La Rioja,313571,1,2,3844,345
2020-05-09,Spain,NA,La Rioja,313571,0,2,3844,347
2020-05-10,Spain,NA,La Rioja,313571,1,1,3845,348
2020-05-11,Spain,NA,La Rioja,313571,4,1,3849,349
2020-05-12,Spain,NA,La Rioja,313571,3,0,3852,349
2020-05-13,Spain,NA,La Rioja,313571,5,0,3857,349
2020-05-14,Spain,NA,La Rioja,313571,5,0,3862,349
2020-05-15,Spain,NA,La Rioja,313571,3,1,3865,350
2020-05-16,Spain,NA,La Rioja,313571,2,2,3867,352
2020-05-17,Spain,NA,La Rioja,313571,0,1,3867,353
2020-05-18,Spain,NA,La Rioja,313571,5,1,3872,354
2020-05-19,Spain,NA,La Rioja,313571,5,3,3877,357
2020-05-20,Spain,NA,La Rioja,313571,4,0,3881,357
2020-05-21,Spain,NA,La Rioja,313571,3,3,3884,360
2020-05-22,Spain,NA,La Rioja,313571,3,1,3887,361
2020-05-23,Spain,NA,La Rioja,313571,2,1,3889,362
2020-05-24,Spain,NA,La Rioja,313571,0,0,3889,362
2020-05-25,Spain,NA,La Rioja,313571,3,0,3892,362
2020-05-26,Spain,NA,La Rioja,313571,0,0,3892,362
2020-05-27,Spain,NA,La Rioja,313571,1,0,3893,362
2020-05-28,Spain,NA,La Rioja,313571,1,0,3894,362
2020-05-29,Spain,NA,La Rioja,313571,2,0,3896,362
2020-05-30,Spain,NA,La Rioja,313571,1,1,3897,363
2020-05-31,Spain,NA,La Rioja,313571,0,0,3897,363
2020-06-01,Spain,NA,La Rioja,313571,3,0,3900,363
2020-06-02,Spain,NA,La Rioja,313571,1,0,3901,363
2020-06-03,Spain,NA,La Rioja,313571,2,1,3903,364
2020-06-04,Spain,NA,La Rioja,313571,2,0,3905,364
2020-06-05,Spain,NA,La Rioja,313571,2,1,3907,365
2020-06-06,Spain,NA,La Rioja,313571,2,0,3909,365
2020-06-07,Spain,NA,La Rioja,313571,1,0,3910,365
2020-06-08,Spain,NA,La Rioja,313571,0,0,3910,365
2020-06-09,Spain,NA,La Rioja,313571,1,0,3911,365
2020-06-10,Spain,NA,La Rioja,313571,0,0,3911,365
2020-06-11,Spain,NA,La Rioja,313571,1,0,3912,365
2020-06-12,Spain,NA,La Rioja,313571,0,0,3912,365
2020-06-13,Spain,NA,La Rioja,313571,2,0,3914,365
2020-06-14,Spain,NA,La Rioja,313571,1,0,3915,365
2020-06-15,Spain,NA,La Rioja,313571,0,0,3915,365
2020-06-16,Spain,NA,La Rioja,313571,1,0,3916,365
2020-06-17,Spain,NA,La Rioja,313571,0,0,3916,365
2020-06-18,Spain,NA,La Rioja,313571,1,0,3917,365
2020-06-19,Spain,NA,La Rioja,313571,0,0,3917,365
2020-06-20,Spain,NA,La Rioja,313571,1,0,3918,365
2020-06-21,Spain,NA,La Rioja,313571,0,0,3918,365
2020-06-22,Spain,NA,La Rioja,313571,0,0,3918,365
2020-06-23,Spain,NA,La Rioja,313571,1,0,3919,365
2020-06-24,Spain,NA,La Rioja,313571,1,0,3920,365
2020-06-25,Spain,NA,La Rioja,313571,0,0,3920,365
2020-06-26,Spain,NA,La Rioja,313571,0,1,3920,366
2020-06-27,Spain,NA,La Rioja,313571,0,0,3920,366
2020-06-28,Spain,NA,La Rioja,313571,2,0,3922,366
2020-06-29,Spain,NA,La Rioja,313571,1,0,3923,366
2020-06-30,Spain,NA,La Rioja,313571,0,0,3923,366
2020-07-01,Spain,NA,La Rioja,313571,0,0,3923,366
2020-07-02,Spain,NA,La Rioja,313571,0,0,3923,366
2020-07-03,Spain,NA,La Rioja,313571,0,0,3923,366
2020-07-04,Spain,NA,La Rioja,313571,0,0,3923,366
2020-07-05,Spain,NA,La Rioja,313571,1,0,3924,366
2020-07-06,Spain,NA,La Rioja,313571,0,0,3924,366
2020-07-07,Spain,NA,La Rioja,313571,3,0,3927,366
2020-07-08,Spain,NA,La Rioja,313571,5,0,3932,366
2020-07-09,Spain,NA,La Rioja,313571,1,0,3933,366
2020-07-10,Spain,NA,La Rioja,313571,10,0,3943,366
2020-07-11,Spain,NA,La Rioja,313571,3,0,3946,366
2020-07-12,Spain,NA,La Rioja,313571,2,0,3948,366
2020-07-13,Spain,NA,La Rioja,313571,4,0,3952,366
2020-07-14,Spain,NA,La Rioja,313571,6,0,3958,366
2020-07-15,Spain,NA,La Rioja,313571,2,0,3960,366
2020-07-16,Spain,NA,La Rioja,313571,8,0,3968,366
2020-07-17,Spain,NA,La Rioja,313571,5,0,3973,366
2020-07-18,Spain,NA,La Rioja,313571,5,0,3978,366
2020-07-19,Spain,NA,La Rioja,313571,0,0,3978,366
2020-07-20,Spain,NA,La Rioja,313571,5,0,3983,366
2020-07-21,Spain,NA,La Rioja,313571,17,0,4000,366
2020-07-22,Spain,NA,La Rioja,313571,9,0,4009,366
2020-07-23,Spain,NA,La Rioja,313571,5,0,4014,366
2020-07-24,Spain,NA,La Rioja,313571,11,0,4025,366
2020-07-25,Spain,NA,La Rioja,313571,2,0,4027,366
2020-07-26,Spain,NA,La Rioja,313571,1,0,4028,366
2020-07-27,Spain,NA,La Rioja,313571,8,0,4036,366
2020-07-28,Spain,NA,La Rioja,313571,9,0,4045,366
2020-07-29,Spain,NA,La Rioja,313571,3,0,4048,366
2020-07-30,Spain,NA,La Rioja,313571,1,0,4049,366
2020-07-31,Spain,NA,La Rioja,313571,7,0,4056,366
2020-08-01,Spain,NA,La Rioja,313571,4,0,4060,366
2020-08-02,Spain,NA,La Rioja,313571,4,0,4064,366
2020-08-03,Spain,NA,La Rioja,313571,9,0,4073,366
2020-08-04,Spain,NA,La Rioja,313571,8,0,4081,366
2020-08-05,Spain,NA,La Rioja,313571,26,0,4107,366
2020-08-06,Spain,NA,La Rioja,313571,16,0,4123,366
2020-08-07,Spain,NA,La Rioja,313571,20,0,4143,366
2020-08-08,Spain,NA,La Rioja,313571,12,0,4155,366
2020-08-09,Spain,NA,La Rioja,313571,20,0,4175,366
2020-08-10,Spain,NA,La Rioja,313571,54,0,4229,366
2020-08-11,Spain,NA,La Rioja,313571,71,0,4300,366
2020-08-12,Spain,NA,La Rioja,313571,56,0,4356,366
2020-08-13,Spain,NA,La Rioja,313571,57,0,4413,366
2020-08-14,Spain,NA,La Rioja,313571,59,0,4472,366
2020-08-15,Spain,NA,La Rioja,313571,50,0,4522,366
2020-08-16,Spain,NA,La Rioja,313571,54,0,4576,366
2020-08-17,Spain,NA,La Rioja,313571,75,1,4651,367
2020-08-18,Spain,NA,La Rioja,313571,84,0,4735,367
2020-08-19,Spain,NA,La Rioja,313571,88,0,4823,367
2020-08-20,Spain,NA,La Rioja,313571,78,0,4901,367
2020-08-21,Spain,NA,La Rioja,313571,69,1,4970,368
2020-08-22,Spain,NA,La Rioja,313571,89,0,5059,368
2020-08-23,Spain,NA,La Rioja,313571,94,0,5153,368
2020-08-24,Spain,NA,La Rioja,313571,71,1,5224,369
2020-08-25,Spain,NA,La Rioja,313571,89,0,5313,369
2020-08-26,Spain,NA,La Rioja,313571,128,0,5441,369
2020-08-27,Spain,NA,La Rioja,313571,79,0,5520,369
2020-08-28,Spain,NA,La Rioja,313571,86,0,5606,369
2020-08-29,Spain,NA,La Rioja,313571,84,2,5690,371
2020-08-30,Spain,NA,La Rioja,313571,86,0,5776,371
2020-08-31,Spain,NA,La Rioja,313571,61,1,5837,372
2020-09-01,Spain,NA,La Rioja,313571,93,1,5930,373
2020-09-02,Spain,NA,La Rioja,313571,88,0,6018,373
2020-09-03,Spain,NA,La Rioja,313571,106,1,6124,374
2020-09-04,Spain,NA,La Rioja,313571,95,0,6219,374
2020-09-05,Spain,NA,La Rioja,313571,84,2,6303,376
2020-09-06,Spain,NA,La Rioja,313571,51,1,6354,377
2020-09-07,Spain,NA,La Rioja,313571,100,2,6454,379
2020-09-08,Spain,NA,La Rioja,313571,93,1,6547,380
2020-09-09,Spain,NA,La Rioja,313571,102,2,6649,382
2020-09-10,Spain,NA,La Rioja,313571,84,2,6733,384
2020-09-11,Spain,NA,La Rioja,313571,98,0,6831,384
2020-09-12,Spain,NA,La Rioja,313571,133,0,6964,384
2020-09-13,Spain,NA,La Rioja,313571,108,0,7072,384
2020-09-14,Spain,NA,La Rioja,313571,97,3,7169,387
2020-09-15,Spain,NA,La Rioja,313571,142,2,7311,389
2020-09-16,Spain,NA,La Rioja,313571,118,3,7429,392
2020-09-17,Spain,NA,La Rioja,313571,109,1,7538,393
2020-09-18,Spain,NA,La Rioja,313571,41,1,7579,394
2020-09-19,Spain,NA,La Rioja,313571,45,4,7624,398
2020-09-20,Spain,NA,La Rioja,313571,44,3,7668,401
2020-09-21,Spain,NA,La Rioja,313571,18,4,7686,405
2020-09-22,Spain,NA,La Rioja,313571,36,2,7722,407
2020-09-23,Spain,NA,La Rioja,313571,49,1,7771,408
2020-03-10,Spain,NA,Melilla,84689,5,0,13,0
2020-03-11,Spain,NA,Melilla,84689,3,0,16,0
2020-03-12,Spain,NA,Melilla,84689,1,0,17,0
2020-03-13,Spain,NA,Melilla,84689,9,0,26,0
2020-03-14,Spain,NA,Melilla,84689,3,0,29,0
2020-03-15,Spain,NA,Melilla,84689,3,0,32,0
2020-03-16,Spain,NA,Melilla,84689,2,0,34,0
2020-03-17,Spain,NA,Melilla,84689,3,0,37,0
2020-03-18,Spain,NA,Melilla,84689,5,0,42,0
2020-03-19,Spain,NA,Melilla,84689,3,0,45,0
2020-03-20,Spain,NA,Melilla,84689,4,0,49,0
2020-03-21,Spain,NA,Melilla,84689,1,0,50,0
2020-03-22,Spain,NA,Melilla,84689,4,0,54,0
2020-03-23,Spain,NA,Melilla,84689,4,0,58,0
2020-03-24,Spain,NA,Melilla,84689,1,0,59,0
2020-03-25,Spain,NA,Melilla,84689,3,1,62,1
2020-03-26,Spain,NA,Melilla,84689,5,0,67,1
2020-03-27,Spain,NA,Melilla,84689,3,0,70,1
2020-03-28,Spain,NA,Melilla,84689,3,0,73,1
2020-03-29,Spain,NA,Melilla,84689,4,0,77,1
2020-03-30,Spain,NA,Melilla,84689,3,0,80,1
2020-03-31,Spain,NA,Melilla,84689,3,0,83,1
2020-04-01,Spain,NA,Melilla,84689,5,0,88,1
2020-04-02,Spain,NA,Melilla,84689,3,1,91,2
2020-04-03,Spain,NA,Melilla,84689,3,0,94,2
2020-04-04,Spain,NA,Melilla,84689,2,0,96,2
2020-04-05,Spain,NA,Melilla,84689,0,0,96,2
2020-04-06,Spain,NA,Melilla,84689,0,0,96,2
2020-04-07,Spain,NA,Melilla,84689,2,0,98,2
2020-04-08,Spain,NA,Melilla,84689,0,0,98,2
2020-04-09,Spain,NA,Melilla,84689,0,0,98,2
2020-04-10,Spain,NA,Melilla,84689,1,0,99,2
2020-04-11,Spain,NA,Melilla,84689,0,0,99,2
2020-04-12,Spain,NA,Melilla,84689,1,0,100,2
2020-04-13,Spain,NA,Melilla,84689,1,0,101,2
2020-04-14,Spain,NA,Melilla,84689,0,0,101,2
2020-04-15,Spain,NA,Melilla,84689,0,0,101,2
2020-04-16,Spain,NA,Melilla,84689,0,0,101,2
2020-04-17,Spain,NA,Melilla,84689,0,0,101,2
2020-04-18,Spain,NA,Melilla,84689,0,0,101,2
2020-04-19,Spain,NA,Melilla,84689,0,0,101,2
2020-04-20,Spain,NA,Melilla,84689,2,0,103,2
2020-04-21,Spain,NA,Melilla,84689,0,0,103,2
2020-04-22,Spain,NA,Melilla,84689,1,0,104,2
2020-04-23,Spain,NA,Melilla,84689,0,0,104,2
2020-04-24,Spain,NA,Melilla,84689,1,0,105,2
2020-04-25,Spain,NA,Melilla,84689,1,0,106,2
2020-04-26,Spain,NA,Melilla,84689,0,0,106,2
2020-04-27,Spain,NA,Melilla,84689,0,0,106,2
2020-04-28,Spain,NA,Melilla,84689,0,0,106,2
2020-04-29,Spain,NA,Melilla,84689,1,0,107,2
2020-04-30,Spain,NA,Melilla,84689,1,0,108,2
2020-05-01,Spain,NA,Melilla,84689,0,0,108,2
2020-05-02,Spain,NA,Melilla,84689,0,0,108,2
2020-05-03,Spain,NA,Melilla,84689,0,0,108,2
2020-05-04,Spain,NA,Melilla,84689,0,0,108,2
2020-05-05,Spain,NA,Melilla,84689,0,0,108,2
2020-05-06,Spain,NA,Melilla,84689,0,0,108,2
2020-05-07,Spain,NA,Melilla,84689,0,0,108,2
2020-05-08,Spain,NA,Melilla,84689,0,0,108,2
2020-05-09,Spain,NA,Melilla,84689,0,0,108,2
2020-05-10,Spain,NA,Melilla,84689,0,0,108,2
2020-05-11,Spain,NA,Melilla,84689,0,0,108,2
2020-05-12,Spain,NA,Melilla,84689,0,0,108,2
2020-05-13,Spain,NA,Melilla,84689,0,0,108,2
2020-05-14,Spain,NA,Melilla,84689,0,0,108,2
2020-05-15,Spain,NA,Melilla,84689,0,0,108,2
2020-05-16,Spain,NA,Melilla,84689,0,0,108,2
2020-05-17,Spain,NA,Melilla,84689,0,0,108,2
2020-05-18,Spain,NA,Melilla,84689,1,0,109,2
2020-05-19,Spain,NA,Melilla,84689,0,0,109,2
2020-05-20,Spain,NA,Melilla,84689,0,0,109,2
2020-05-21,Spain,NA,Melilla,84689,0,0,109,2
2020-05-22,Spain,NA,Melilla,84689,0,0,109,2
2020-05-23,Spain,NA,Melilla,84689,0,0,109,2
2020-05-24,Spain,NA,Melilla,84689,0,0,109,2
2020-05-25,Spain,NA,Melilla,84689,0,0,109,2
2020-05-26,Spain,NA,Melilla,84689,0,0,109,2
2020-05-27,Spain,NA,Melilla,84689,0,0,109,2
2020-05-28,Spain,NA,Melilla,84689,0,0,109,2
2020-05-29,Spain,NA,Melilla,84689,0,0,109,2
2020-05-30,Spain,NA,Melilla,84689,0,0,109,2
2020-05-31,Spain,NA,Melilla,84689,0,0,109,2
2020-06-01,Spain,NA,Melilla,84689,1,0,110,2
2020-06-02,Spain,NA,Melilla,84689,0,0,110,2
2020-06-03,Spain,NA,Melilla,84689,0,0,110,2
2020-06-04,Spain,NA,Melilla,84689,0,0,110,2
2020-06-05,Spain,NA,Melilla,84689,0,0,110,2
2020-06-06,Spain,NA,Melilla,84689,0,0,110,2
2020-06-07,Spain,NA,Melilla,84689,0,0,110,2
2020-06-08,Spain,NA,Melilla,84689,0,0,110,2
2020-06-09,Spain,NA,Melilla,84689,1,0,111,2
2020-06-10,Spain,NA,Melilla,84689,0,0,111,2
2020-06-11,Spain,NA,Melilla,84689,0,0,111,2
2020-06-12,Spain,NA,Melilla,84689,0,0,111,2
2020-06-13,Spain,NA,Melilla,84689,0,0,111,2
2020-06-14,Spain,NA,Melilla,84689,0,0,111,2
2020-06-15,Spain,NA,Melilla,84689,1,0,112,2
2020-06-16,Spain,NA,Melilla,84689,0,0,112,2
2020-06-17,Spain,NA,Melilla,84689,0,0,112,2
2020-06-18,Spain,NA,Melilla,84689,0,0,112,2
2020-06-19,Spain,NA,Melilla,84689,0,0,112,2
2020-06-20,Spain,NA,Melilla,84689,0,0,112,2
2020-06-21,Spain,NA,Melilla,84689,2,0,114,2
2020-06-22,Spain,NA,Melilla,84689,0,0,114,2
2020-06-23,Spain,NA,Melilla,84689,0,0,114,2
2020-06-24,Spain,NA,Melilla,84689,0,0,114,2
2020-06-25,Spain,NA,Melilla,84689,0,0,114,2
2020-06-26,Spain,NA,Melilla,84689,0,0,114,2
2020-06-27,Spain,NA,Melilla,84689,0,0,114,2
2020-06-28,Spain,NA,Melilla,84689,0,0,114,2
2020-06-29,Spain,NA,Melilla,84689,0,0,114,2
2020-06-30,Spain,NA,Melilla,84689,0,0,114,2
2020-07-01,Spain,NA,Melilla,84689,0,0,114,2
2020-07-02,Spain,NA,Melilla,84689,0,0,114,2
2020-07-03,Spain,NA,Melilla,84689,0,0,114,2
2020-07-04,Spain,NA,Melilla,84689,0,0,114,2
2020-07-05,Spain,NA,Melilla,84689,0,0,114,2
2020-07-06,Spain,NA,Melilla,84689,0,0,114,2
2020-07-07,Spain,NA,Melilla,84689,0,0,114,2
2020-07-08,Spain,NA,Melilla,84689,0,0,114,2
2020-07-09,Spain,NA,Melilla,84689,0,0,114,2
2020-07-10,Spain,NA,Melilla,84689,0,0,114,2
2020-07-11,Spain,NA,Melilla,84689,0,0,114,2
2020-07-12,Spain,NA,Melilla,84689,2,0,116,2
2020-07-13,Spain,NA,Melilla,84689,0,0,116,2
2020-07-14,Spain,NA,Melilla,84689,0,0,116,2
2020-07-15,Spain,NA,Melilla,84689,0,0,116,2
2020-07-16,Spain,NA,Melilla,84689,0,0,116,2
2020-07-17,Spain,NA,Melilla,84689,0,0,116,2
2020-07-18,Spain,NA,Melilla,84689,0,0,116,2
2020-07-19,Spain,NA,Melilla,84689,0,0,116,2
2020-07-20,Spain,NA,Melilla,84689,0,0,116,2
2020-07-21,Spain,NA,Melilla,84689,0,0,116,2
2020-07-22,Spain,NA,Melilla,84689,0,0,116,2
2020-07-23,Spain,NA,Melilla,84689,0,0,116,2
2020-07-24,Spain,NA,Melilla,84689,0,0,116,2
2020-07-25,Spain,NA,Melilla,84689,0,0,116,2
2020-07-26,Spain,NA,Melilla,84689,4,0,120,2
2020-07-27,Spain,NA,Melilla,84689,1,0,121,2
2020-07-28,Spain,NA,Melilla,84689,1,0,122,2
2020-07-29,Spain,NA,Melilla,84689,1,0,123,2
2020-07-30,Spain,NA,Melilla,84689,4,0,127,2
2020-07-31,Spain,NA,Melilla,84689,0,0,127,2
2020-08-01,Spain,NA,Melilla,84689,8,0,135,2
2020-08-02,Spain,NA,Melilla,84689,4,0,139,2
2020-08-03,Spain,NA,Melilla,84689,4,0,143,2
2020-08-04,Spain,NA,Melilla,84689,5,0,148,2
2020-08-05,Spain,NA,Melilla,84689,1,0,149,2
2020-08-06,Spain,NA,Melilla,84689,3,0,152,2
2020-08-07,Spain,NA,Melilla,84689,5,0,157,2
2020-08-08,Spain,NA,Melilla,84689,3,0,160,2
2020-08-09,Spain,NA,Melilla,84689,5,0,165,2
2020-08-10,Spain,NA,Melilla,84689,13,0,178,2
2020-08-11,Spain,NA,Melilla,84689,7,0,185,2
2020-08-12,Spain,NA,Melilla,84689,8,0,193,2
2020-08-13,Spain,NA,Melilla,84689,1,0,194,2
2020-08-14,Spain,NA,Melilla,84689,6,0,200,2
2020-08-15,Spain,NA,Melilla,84689,12,0,212,2
2020-08-16,Spain,NA,Melilla,84689,4,0,216,2
2020-08-17,Spain,NA,Melilla,84689,10,0,226,2
2020-08-18,Spain,NA,Melilla,84689,8,0,234,2
2020-08-19,Spain,NA,Melilla,84689,7,0,241,2
2020-08-20,Spain,NA,Melilla,84689,8,0,249,2
2020-08-21,Spain,NA,Melilla,84689,13,0,262,2
2020-08-22,Spain,NA,Melilla,84689,6,0,268,2
2020-08-23,Spain,NA,Melilla,84689,15,0,283,2
2020-08-24,Spain,NA,Melilla,84689,14,0,297,2
2020-08-25,Spain,NA,Melilla,84689,15,0,312,2
2020-08-26,Spain,NA,Melilla,84689,10,0,322,2
2020-08-27,Spain,NA,Melilla,84689,6,0,328,2
2020-08-28,Spain,NA,Melilla,84689,14,0,342,2
2020-08-29,Spain,NA,Melilla,84689,19,0,361,2
2020-08-30,Spain,NA,Melilla,84689,10,0,371,2
2020-08-31,Spain,NA,Melilla,84689,15,0,386,2
2020-09-01,Spain,NA,Melilla,84689,29,0,415,2
2020-09-02,Spain,NA,Melilla,84689,25,0,440,2
2020-09-03,Spain,NA,Melilla,84689,17,1,457,3
2020-09-04,Spain,NA,Melilla,84689,19,0,476,3
2020-09-05,Spain,NA,Melilla,84689,11,0,487,3
2020-09-06,Spain,NA,Melilla,84689,16,0,503,3
2020-09-07,Spain,NA,Melilla,84689,15,0,518,3
2020-09-08,Spain,NA,Melilla,84689,24,0,542,3
2020-09-09,Spain,NA,Melilla,84689,36,0,578,3
2020-09-10,Spain,NA,Melilla,84689,30,0,608,3
2020-09-11,Spain,NA,Melilla,84689,24,0,632,3
2020-09-12,Spain,NA,Melilla,84689,25,1,657,4
2020-09-13,Spain,NA,Melilla,84689,13,0,670,4
2020-09-14,Spain,NA,Melilla,84689,18,0,688,4
2020-09-15,Spain,NA,Melilla,84689,6,0,694,4
2020-09-16,Spain,NA,Melilla,84689,6,0,700,4
2020-09-17,Spain,NA,Melilla,84689,6,0,706,4
2020-09-18,Spain,NA,Melilla,84689,4,0,710,4
2020-09-19,Spain,NA,Melilla,84689,11,0,721,4
2020-09-20,Spain,NA,Melilla,84689,8,0,729,4
2020-09-21,Spain,NA,Melilla,84689,11,0,740,4
2020-09-22,Spain,NA,Melilla,84689,16,0,756,4
2020-09-23,Spain,NA,Melilla,84689,3,0,759,4
2020-02-26,Spain,NA,Navarra,649946,2,0,11,0
2020-02-27,Spain,NA,Navarra,649946,4,0,15,0
2020-02-28,Spain,NA,Navarra,649946,2,0,17,0
2020-02-29,Spain,NA,Navarra,649946,4,0,21,0
2020-03-01,Spain,NA,Navarra,649946,8,0,29,0
2020-03-02,Spain,NA,Navarra,649946,11,0,40,0
2020-03-03,Spain,NA,Navarra,649946,14,0,54,0
2020-03-04,Spain,NA,Navarra,649946,18,0,72,0
2020-03-05,Spain,NA,Navarra,649946,19,0,91,0
2020-03-06,Spain,NA,Navarra,649946,19,0,110,0
2020-03-07,Spain,NA,Navarra,649946,42,0,152,0
2020-03-08,Spain,NA,Navarra,649946,38,0,190,0
2020-03-09,Spain,NA,Navarra,649946,77,0,267,0
2020-03-10,Spain,NA,Navarra,649946,84,0,351,0
2020-03-11,Spain,NA,Navarra,649946,109,0,460,0
2020-03-12,Spain,NA,Navarra,649946,140,0,600,0
2020-03-13,Spain,NA,Navarra,649946,138,0,738,0
2020-03-14,Spain,NA,Navarra,649946,121,1,859,1
2020-03-15,Spain,NA,Navarra,649946,166,1,1025,2
2020-03-16,Spain,NA,Navarra,649946,156,1,1181,3
2020-03-17,Spain,NA,Navarra,649946,169,1,1350,4
2020-03-18,Spain,NA,Navarra,649946,176,3,1526,7
2020-03-19,Spain,NA,Navarra,649946,153,2,1679,9
2020-03-20,Spain,NA,Navarra,649946,229,5,1908,14
2020-03-21,Spain,NA,Navarra,649946,152,4,2060,18
2020-03-22,Spain,NA,Navarra,649946,141,9,2201,27
2020-03-23,Spain,NA,Navarra,649946,161,9,2362,36
2020-03-24,Spain,NA,Navarra,649946,198,10,2560,46
2020-03-25,Spain,NA,Navarra,649946,182,12,2742,58
2020-03-26,Spain,NA,Navarra,649946,117,17,2859,75
2020-03-27,Spain,NA,Navarra,649946,115,12,2974,87
2020-03-28,Spain,NA,Navarra,649946,108,22,3082,109
2020-03-29,Spain,NA,Navarra,649946,79,13,3161,122
2020-03-30,Spain,NA,Navarra,649946,211,15,3372,137
2020-03-31,Spain,NA,Navarra,649946,125,15,3497,152
2020-04-01,Spain,NA,Navarra,649946,195,11,3692,163
2020-04-02,Spain,NA,Navarra,649946,126,13,3818,176
2020-04-03,Spain,NA,Navarra,649946,126,18,3944,194
2020-04-04,Spain,NA,Navarra,649946,76,7,4020,201
2020-04-05,Spain,NA,Navarra,649946,86,19,4106,220
2020-04-06,Spain,NA,Navarra,649946,132,16,4238,236
2020-04-07,Spain,NA,Navarra,649946,84,20,4322,256
2020-04-08,Spain,NA,Navarra,649946,93,12,4415,268
2020-04-09,Spain,NA,Navarra,649946,79,17,4494,285
2020-04-10,Spain,NA,Navarra,649946,69,13,4563,298
2020-04-11,Spain,NA,Navarra,649946,45,19,4608,317
2020-04-12,Spain,NA,Navarra,649946,59,11,4667,328
2020-04-13,Spain,NA,Navarra,649946,56,22,4723,350
2020-04-14,Spain,NA,Navarra,649946,48,11,4771,361
2020-04-15,Spain,NA,Navarra,649946,35,15,4806,376
2020-04-16,Spain,NA,Navarra,649946,30,10,4836,386
2020-04-17,Spain,NA,Navarra,649946,44,14,4880,400
2020-04-18,Spain,NA,Navarra,649946,39,14,4919,414
2020-04-19,Spain,NA,Navarra,649946,35,11,4954,425
2020-04-20,Spain,NA,Navarra,649946,31,5,4985,430
2020-04-21,Spain,NA,Navarra,649946,11,10,4996,440
2020-04-22,Spain,NA,Navarra,649946,21,8,5017,448
2020-04-23,Spain,NA,Navarra,649946,19,8,5036,456
2020-04-24,Spain,NA,Navarra,649946,21,6,5057,462
2020-04-25,Spain,NA,Navarra,649946,21,6,5078,468
2020-04-26,Spain,NA,Navarra,649946,8,3,5086,471
2020-04-27,Spain,NA,Navarra,649946,20,6,5106,477
2020-04-28,Spain,NA,Navarra,649946,13,6,5119,483
2020-04-29,Spain,NA,Navarra,649946,18,2,5137,485
2020-04-30,Spain,NA,Navarra,649946,16,3,5153,488
2020-05-01,Spain,NA,Navarra,649946,21,5,5174,493
2020-05-02,Spain,NA,Navarra,649946,16,3,5190,496
2020-05-03,Spain,NA,Navarra,649946,10,6,5200,502
2020-05-04,Spain,NA,Navarra,649946,13,1,5213,503
2020-05-05,Spain,NA,Navarra,649946,5,4,5218,507
2020-05-06,Spain,NA,Navarra,649946,7,3,5225,510
2020-05-07,Spain,NA,Navarra,649946,2,4,5227,514
2020-05-08,Spain,NA,Navarra,649946,7,1,5234,515
2020-05-09,Spain,NA,Navarra,649946,3,1,5237,516
2020-05-10,Spain,NA,Navarra,649946,4,4,5241,520
2020-05-11,Spain,NA,Navarra,649946,12,2,5253,522
2020-05-12,Spain,NA,Navarra,649946,2,1,5255,523
2020-05-13,Spain,NA,Navarra,649946,9,2,5264,525
2020-05-14,Spain,NA,Navarra,649946,19,0,5283,525
2020-05-15,Spain,NA,Navarra,649946,11,0,5294,525
2020-05-16,Spain,NA,Navarra,649946,4,0,5298,525
2020-05-17,Spain,NA,Navarra,649946,21,0,5319,525
2020-05-18,Spain,NA,Navarra,649946,6,0,5325,525
2020-05-19,Spain,NA,Navarra,649946,9,0,5334,525
2020-05-20,Spain,NA,Navarra,649946,4,2,5338,527
2020-05-21,Spain,NA,Navarra,649946,3,0,5341,527
2020-05-22,Spain,NA,Navarra,649946,6,0,5347,527
2020-05-23,Spain,NA,Navarra,649946,12,0,5359,527
2020-05-24,Spain,NA,Navarra,649946,2,0,5361,527
2020-05-25,Spain,NA,Navarra,649946,5,0,5366,527
2020-05-26,Spain,NA,Navarra,649946,4,0,5370,527
2020-05-27,Spain,NA,Navarra,649946,11,1,5381,528
2020-05-28,Spain,NA,Navarra,649946,9,0,5390,528
2020-05-29,Spain,NA,Navarra,649946,5,0,5395,528
2020-05-30,Spain,NA,Navarra,649946,7,0,5402,528
2020-05-31,Spain,NA,Navarra,649946,3,0,5405,528
2020-06-01,Spain,NA,Navarra,649946,1,0,5406,528
2020-06-02,Spain,NA,Navarra,649946,3,0,5409,528
2020-06-03,Spain,NA,Navarra,649946,6,0,5415,528
2020-06-04,Spain,NA,Navarra,649946,7,0,5422,528
2020-06-05,Spain,NA,Navarra,649946,6,0,5428,528
2020-06-06,Spain,NA,Navarra,649946,1,0,5429,528
2020-06-07,Spain,NA,Navarra,649946,2,0,5431,528
2020-06-08,Spain,NA,Navarra,649946,0,0,5431,528
2020-06-09,Spain,NA,Navarra,649946,5,0,5436,528
2020-06-10,Spain,NA,Navarra,649946,4,0,5440,528
2020-06-11,Spain,NA,Navarra,649946,1,0,5441,528
2020-06-12,Spain,NA,Navarra,649946,1,0,5442,528
2020-06-13,Spain,NA,Navarra,649946,1,0,5443,528
2020-06-14,Spain,NA,Navarra,649946,2,0,5445,528
2020-06-15,Spain,NA,Navarra,649946,4,0,5449,528
2020-06-16,Spain,NA,Navarra,649946,12,0,5461,528
2020-06-17,Spain,NA,Navarra,649946,3,0,5464,528
2020-06-18,Spain,NA,Navarra,649946,6,0,5470,528
2020-06-19,Spain,NA,Navarra,649946,9,0,5479,528
2020-06-20,Spain,NA,Navarra,649946,4,0,5483,528
2020-06-21,Spain,NA,Navarra,649946,15,0,5498,528
2020-06-22,Spain,NA,Navarra,649946,18,0,5516,528
2020-06-23,Spain,NA,Navarra,649946,8,0,5524,528
2020-06-24,Spain,NA,Navarra,649946,11,0,5535,528
2020-06-25,Spain,NA,Navarra,649946,6,0,5541,528
2020-06-26,Spain,NA,Navarra,649946,5,0,5546,528
2020-06-27,Spain,NA,Navarra,649946,7,0,5553,528
2020-06-28,Spain,NA,Navarra,649946,2,0,5555,528
2020-06-29,Spain,NA,Navarra,649946,1,0,5556,528
2020-06-30,Spain,NA,Navarra,649946,3,0,5559,528
2020-07-01,Spain,NA,Navarra,649946,6,0,5565,528
2020-07-02,Spain,NA,Navarra,649946,4,0,5569,528
2020-07-03,Spain,NA,Navarra,649946,7,0,5576,528
2020-07-04,Spain,NA,Navarra,649946,5,0,5581,528
2020-07-05,Spain,NA,Navarra,649946,1,0,5582,528
2020-07-06,Spain,NA,Navarra,649946,12,0,5594,528
2020-07-07,Spain,NA,Navarra,649946,13,0,5607,528
2020-07-08,Spain,NA,Navarra,649946,7,0,5614,528
2020-07-09,Spain,NA,Navarra,649946,29,0,5643,528
2020-07-10,Spain,NA,Navarra,649946,20,0,5663,528
2020-07-11,Spain,NA,Navarra,649946,35,0,5698,528
2020-07-12,Spain,NA,Navarra,649946,23,0,5721,528
2020-07-13,Spain,NA,Navarra,649946,40,0,5761,528
2020-07-14,Spain,NA,Navarra,649946,51,0,5812,528
2020-07-15,Spain,NA,Navarra,649946,43,1,5855,529
2020-07-16,Spain,NA,Navarra,649946,47,0,5902,529
2020-07-17,Spain,NA,Navarra,649946,73,0,5975,529
2020-07-18,Spain,NA,Navarra,649946,78,0,6053,529
2020-07-19,Spain,NA,Navarra,649946,51,0,6104,529
2020-07-20,Spain,NA,Navarra,649946,102,0,6206,529
2020-07-21,Spain,NA,Navarra,649946,119,0,6325,529
2020-07-22,Spain,NA,Navarra,649946,65,0,6390,529
2020-07-23,Spain,NA,Navarra,649946,67,0,6457,529
2020-07-24,Spain,NA,Navarra,649946,56,0,6513,529
2020-07-25,Spain,NA,Navarra,649946,82,0,6595,529
2020-07-26,Spain,NA,Navarra,649946,79,0,6674,529
2020-07-27,Spain,NA,Navarra,649946,52,0,6726,529
2020-07-28,Spain,NA,Navarra,649946,40,0,6766,529
2020-07-29,Spain,NA,Navarra,649946,62,0,6828,529
2020-07-30,Spain,NA,Navarra,649946,52,0,6880,529
2020-07-31,Spain,NA,Navarra,649946,72,0,6952,529
2020-08-01,Spain,NA,Navarra,649946,88,0,7040,529
2020-08-02,Spain,NA,Navarra,649946,84,0,7124,529
2020-08-03,Spain,NA,Navarra,649946,106,0,7230,529
2020-08-04,Spain,NA,Navarra,649946,84,0,7314,529
2020-08-05,Spain,NA,Navarra,649946,82,0,7396,529
2020-08-06,Spain,NA,Navarra,649946,87,0,7483,529
2020-08-07,Spain,NA,Navarra,649946,114,1,7597,530
2020-08-08,Spain,NA,Navarra,649946,91,0,7688,530
2020-08-09,Spain,NA,Navarra,649946,118,0,7806,530
2020-08-10,Spain,NA,Navarra,649946,97,1,7903,531
2020-08-11,Spain,NA,Navarra,649946,123,0,8026,531
2020-08-12,Spain,NA,Navarra,649946,94,1,8120,532
2020-08-13,Spain,NA,Navarra,649946,90,0,8210,532
2020-08-14,Spain,NA,Navarra,649946,87,0,8297,532
2020-08-15,Spain,NA,Navarra,649946,122,0,8419,532
2020-08-16,Spain,NA,Navarra,649946,80,0,8499,532
2020-08-17,Spain,NA,Navarra,649946,91,0,8590,532
2020-08-18,Spain,NA,Navarra,649946,103,0,8693,532
2020-08-19,Spain,NA,Navarra,649946,114,0,8807,532
2020-08-20,Spain,NA,Navarra,649946,102,0,8909,532
2020-08-21,Spain,NA,Navarra,649946,147,0,9056,532
2020-08-22,Spain,NA,Navarra,649946,109,1,9165,533
2020-08-23,Spain,NA,Navarra,649946,122,0,9287,533
2020-08-24,Spain,NA,Navarra,649946,134,0,9421,533
2020-08-25,Spain,NA,Navarra,649946,151,0,9572,533
2020-08-26,Spain,NA,Navarra,649946,277,0,9849,533
2020-08-27,Spain,NA,Navarra,649946,149,0,9998,533
2020-08-28,Spain,NA,Navarra,649946,157,0,10155,533
2020-08-29,Spain,NA,Navarra,649946,158,1,10313,534
2020-08-30,Spain,NA,Navarra,649946,103,0,10416,534
2020-08-31,Spain,NA,Navarra,649946,204,1,10620,535
2020-09-01,Spain,NA,Navarra,649946,213,1,10833,536
2020-09-02,Spain,NA,Navarra,649946,177,0,11010,536
2020-09-03,Spain,NA,Navarra,649946,204,0,11214,536
2020-09-04,Spain,NA,Navarra,649946,213,3,11427,539
2020-09-05,Spain,NA,Navarra,649946,245,0,11672,539
2020-09-06,Spain,NA,Navarra,649946,191,1,11863,540
2020-09-07,Spain,NA,Navarra,649946,321,0,12184,540
2020-09-08,Spain,NA,Navarra,649946,273,0,12457,540
2020-09-09,Spain,NA,Navarra,649946,304,1,12761,541
2020-09-10,Spain,NA,Navarra,649946,308,1,13069,542
2020-09-11,Spain,NA,Navarra,649946,309,0,13378,542
2020-09-12,Spain,NA,Navarra,649946,280,3,13658,545
2020-09-13,Spain,NA,Navarra,649946,315,2,13973,547
2020-09-14,Spain,NA,Navarra,649946,345,1,14318,548
2020-09-15,Spain,NA,Navarra,649946,311,1,14629,549
2020-09-16,Spain,NA,Navarra,649946,299,1,14928,550
2020-09-17,Spain,NA,Navarra,649946,266,3,15194,553
2020-09-18,Spain,NA,Navarra,649946,273,2,15467,555
2020-09-19,Spain,NA,Navarra,649946,159,1,15626,556
2020-09-20,Spain,NA,Navarra,649946,185,0,15811,556
2020-09-21,Spain,NA,Navarra,649946,196,5,16007,561
2020-09-22,Spain,NA,Navarra,649946,175,1,16182,562
2020-09-23,Spain,NA,Navarra,649946,133,0,16315,562
2020-02-21,Spain,NA,Pais Vasco,2177880,3,0,13,0
2020-02-22,Spain,NA,Pais Vasco,2177880,4,0,17,0
2020-02-23,Spain,NA,Pais Vasco,2177880,1,0,18,0
2020-02-24,Spain,NA,Pais Vasco,2177880,6,0,24,0
2020-02-25,Spain,NA,Pais Vasco,2177880,11,0,35,0
2020-02-26,Spain,NA,Pais Vasco,2177880,11,0,46,0
2020-02-27,Spain,NA,Pais Vasco,2177880,13,0,59,0
2020-02-28,Spain,NA,Pais Vasco,2177880,31,0,90,0
2020-02-29,Spain,NA,Pais Vasco,2177880,25,0,115,0
2020-03-01,Spain,NA,Pais Vasco,2177880,47,0,162,0
2020-03-02,Spain,NA,Pais Vasco,2177880,54,0,216,0
2020-03-03,Spain,NA,Pais Vasco,2177880,57,0,273,0
2020-03-04,Spain,NA,Pais Vasco,2177880,69,1,342,1
2020-03-05,Spain,NA,Pais Vasco,2177880,75,0,417,1
2020-03-06,Spain,NA,Pais Vasco,2177880,80,0,497,1
2020-03-07,Spain,NA,Pais Vasco,2177880,87,1,584,2
2020-03-08,Spain,NA,Pais Vasco,2177880,98,2,682,4
2020-03-09,Spain,NA,Pais Vasco,2177880,140,2,822,6
2020-03-10,Spain,NA,Pais Vasco,2177880,225,0,1047,6
2020-03-11,Spain,NA,Pais Vasco,2177880,221,5,1268,11
2020-03-12,Spain,NA,Pais Vasco,2177880,265,3,1533,14
2020-03-13,Spain,NA,Pais Vasco,2177880,410,6,1943,20
2020-03-14,Spain,NA,Pais Vasco,2177880,410,2,2353,22
2020-03-15,Spain,NA,Pais Vasco,2177880,417,14,2770,36
2020-03-16,Spain,NA,Pais Vasco,2177880,579,5,3349,41
2020-03-17,Spain,NA,Pais Vasco,2177880,519,11,3868,52
2020-03-18,Spain,NA,Pais Vasco,2177880,544,19,4412,71
2020-03-19,Spain,NA,Pais Vasco,2177880,450,16,4862,87
2020-03-20,Spain,NA,Pais Vasco,2177880,583,16,5445,103
2020-03-21,Spain,NA,Pais Vasco,2177880,423,21,5868,124
2020-03-22,Spain,NA,Pais Vasco,2177880,383,21,6251,145
2020-03-23,Spain,NA,Pais Vasco,2177880,460,17,6711,162
2020-03-24,Spain,NA,Pais Vasco,2177880,377,25,7088,187
2020-03-25,Spain,NA,Pais Vasco,2177880,391,35,7479,222
2020-03-26,Spain,NA,Pais Vasco,2177880,351,26,7830,248
2020-03-27,Spain,NA,Pais Vasco,2177880,389,32,8219,280
2020-03-28,Spain,NA,Pais Vasco,2177880,279,36,8498,316
2020-03-29,Spain,NA,Pais Vasco,2177880,240,39,8738,355
2020-03-30,Spain,NA,Pais Vasco,2177880,304,41,9042,396
2020-03-31,Spain,NA,Pais Vasco,2177880,249,42,9291,438
2020-04-01,Spain,NA,Pais Vasco,2177880,266,43,9557,481
2020-04-02,Spain,NA,Pais Vasco,2177880,240,33,9797,514
2020-04-03,Spain,NA,Pais Vasco,2177880,309,50,10106,564
2020-04-04,Spain,NA,Pais Vasco,2177880,200,51,10306,615
2020-04-05,Spain,NA,Pais Vasco,2177880,218,46,10524,661
2020-04-06,Spain,NA,Pais Vasco,2177880,285,51,10809,712
2020-04-07,Spain,NA,Pais Vasco,2177880,223,47,11032,759
2020-04-08,Spain,NA,Pais Vasco,2177880,218,39,11250,798
2020-04-09,Spain,NA,Pais Vasco,2177880,193,49,11443,847
2020-04-10,Spain,NA,Pais Vasco,2177880,176,38,11619,885
2020-04-11,Spain,NA,Pais Vasco,2177880,124,42,11743,927
2020-04-12,Spain,NA,Pais Vasco,2177880,142,32,11885,959
2020-04-13,Spain,NA,Pais Vasco,2177880,109,45,11994,1004
2020-04-14,Spain,NA,Pais Vasco,2177880,89,32,12083,1036
2020-04-15,Spain,NA,Pais Vasco,2177880,99,29,12182,1065
2020-04-16,Spain,NA,Pais Vasco,2177880,108,27,12290,1092
2020-04-17,Spain,NA,Pais Vasco,2177880,132,31,12422,1123
2020-04-18,Spain,NA,Pais Vasco,2177880,97,26,12519,1149
2020-04-19,Spain,NA,Pais Vasco,2177880,50,23,12569,1172
2020-04-20,Spain,NA,Pais Vasco,2177880,78,15,12647,1187
2020-04-21,Spain,NA,Pais Vasco,2177880,70,28,12717,1215
2020-04-22,Spain,NA,Pais Vasco,2177880,50,14,12767,1229
2020-04-23,Spain,NA,Pais Vasco,2177880,58,16,12825,1245
2020-04-24,Spain,NA,Pais Vasco,2177880,85,13,12910,1258
2020-04-25,Spain,NA,Pais Vasco,2177880,38,15,12948,1273
2020-04-26,Spain,NA,Pais Vasco,2177880,31,9,12979,1282
2020-04-27,Spain,NA,Pais Vasco,2177880,29,13,13008,1295
2020-04-28,Spain,NA,Pais Vasco,2177880,38,18,13046,1313
2020-04-29,Spain,NA,Pais Vasco,2177880,31,8,13077,1321
2020-04-30,Spain,NA,Pais Vasco,2177880,26,10,13103,1331
2020-05-01,Spain,NA,Pais Vasco,2177880,32,12,13135,1343
2020-05-02,Spain,NA,Pais Vasco,2177880,41,11,13176,1354
2020-05-03,Spain,NA,Pais Vasco,2177880,28,12,13204,1366
2020-05-04,Spain,NA,Pais Vasco,2177880,13,12,13217,1378
2020-05-05,Spain,NA,Pais Vasco,2177880,19,9,13236,1387
2020-05-06,Spain,NA,Pais Vasco,2177880,13,5,13249,1392
2020-05-07,Spain,NA,Pais Vasco,2177880,12,10,13261,1402
2020-05-08,Spain,NA,Pais Vasco,2177880,19,9,13280,1411
2020-05-09,Spain,NA,Pais Vasco,2177880,13,7,13293,1418
2020-05-10,Spain,NA,Pais Vasco,2177880,6,5,13299,1423
2020-05-11,Spain,NA,Pais Vasco,2177880,22,8,13321,1431
2020-05-12,Spain,NA,Pais Vasco,2177880,18,8,13339,1439
2020-05-13,Spain,NA,Pais Vasco,2177880,23,1,13362,1440
2020-05-14,Spain,NA,Pais Vasco,2177880,12,3,13374,1443
2020-05-15,Spain,NA,Pais Vasco,2177880,12,5,13386,1448
2020-05-16,Spain,NA,Pais Vasco,2177880,7,8,13393,1456
2020-05-17,Spain,NA,Pais Vasco,2177880,6,2,13399,1458
2020-05-18,Spain,NA,Pais Vasco,2177880,13,6,13412,1464
2020-05-19,Spain,NA,Pais Vasco,2177880,11,4,13423,1468
2020-05-20,Spain,NA,Pais Vasco,2177880,8,4,13431,1472
2020-05-21,Spain,NA,Pais Vasco,2177880,8,4,13439,1476
2020-05-22,Spain,NA,Pais Vasco,2177880,6,7,13445,1483
2020-05-23,Spain,NA,Pais Vasco,2177880,6,3,13451,1486
2020-05-24,Spain,NA,Pais Vasco,2177880,2,9,13453,1495
2020-05-25,Spain,NA,Pais Vasco,2177880,6,3,13459,1498
2020-05-26,Spain,NA,Pais Vasco,2177880,9,3,13468,1501
2020-05-27,Spain,NA,Pais Vasco,2177880,2,2,13470,1503
2020-05-28,Spain,NA,Pais Vasco,2177880,4,4,13474,1507
2020-05-29,Spain,NA,Pais Vasco,2177880,3,6,13477,1513
2020-05-30,Spain,NA,Pais Vasco,2177880,3,4,13480,1517
2020-05-31,Spain,NA,Pais Vasco,2177880,0,2,13480,1519
2020-06-01,Spain,NA,Pais Vasco,2177880,7,3,13487,1522
2020-06-02,Spain,NA,Pais Vasco,2177880,11,5,13498,1527
2020-06-03,Spain,NA,Pais Vasco,2177880,7,2,13505,1529
2020-06-04,Spain,NA,Pais Vasco,2177880,6,5,13511,1534
2020-06-05,Spain,NA,Pais Vasco,2177880,9,4,13520,1538
2020-06-06,Spain,NA,Pais Vasco,2177880,9,4,13529,1542
2020-06-07,Spain,NA,Pais Vasco,2177880,13,2,13542,1544
2020-06-08,Spain,NA,Pais Vasco,2177880,14,2,13556,1546
2020-06-09,Spain,NA,Pais Vasco,2177880,11,1,13567,1547
2020-06-10,Spain,NA,Pais Vasco,2177880,7,3,13574,1550
2020-06-11,Spain,NA,Pais Vasco,2177880,10,2,13584,1552
2020-06-12,Spain,NA,Pais Vasco,2177880,17,0,13601,1552
2020-06-13,Spain,NA,Pais Vasco,2177880,9,2,13610,1554
2020-06-14,Spain,NA,Pais Vasco,2177880,6,0,13616,1554
2020-06-15,Spain,NA,Pais Vasco,2177880,15,0,13631,1554
2020-06-16,Spain,NA,Pais Vasco,2177880,10,0,13641,1554
2020-06-17,Spain,NA,Pais Vasco,2177880,8,0,13649,1554
2020-06-18,Spain,NA,Pais Vasco,2177880,12,1,13661,1555
2020-06-19,Spain,NA,Pais Vasco,2177880,11,0,13672,1555
2020-06-20,Spain,NA,Pais Vasco,2177880,4,0,13676,1555
2020-06-21,Spain,NA,Pais Vasco,2177880,6,0,13682,1555
2020-06-22,Spain,NA,Pais Vasco,2177880,8,0,13690,1555
2020-06-23,Spain,NA,Pais Vasco,2177880,5,1,13695,1556
2020-06-24,Spain,NA,Pais Vasco,2177880,13,0,13708,1556
2020-06-25,Spain,NA,Pais Vasco,2177880,5,1,13713,1557
2020-06-26,Spain,NA,Pais Vasco,2177880,10,0,13723,1557
2020-06-27,Spain,NA,Pais Vasco,2177880,5,0,13728,1557
2020-06-28,Spain,NA,Pais Vasco,2177880,6,1,13734,1558
2020-06-29,Spain,NA,Pais Vasco,2177880,8,1,13742,1559
2020-06-30,Spain,NA,Pais Vasco,2177880,15,0,13757,1559
2020-07-01,Spain,NA,Pais Vasco,2177880,7,2,13764,1561
2020-07-02,Spain,NA,Pais Vasco,2177880,8,0,13772,1561
2020-07-03,Spain,NA,Pais Vasco,2177880,13,0,13785,1561
2020-07-04,Spain,NA,Pais Vasco,2177880,7,0,13792,1561
2020-07-05,Spain,NA,Pais Vasco,2177880,17,0,13809,1561
2020-07-06,Spain,NA,Pais Vasco,2177880,33,0,13842,1561
2020-07-07,Spain,NA,Pais Vasco,2177880,31,0,13873,1561
2020-07-08,Spain,NA,Pais Vasco,2177880,37,0,13910,1561
2020-07-09,Spain,NA,Pais Vasco,2177880,34,0,13944,1561
2020-07-10,Spain,NA,Pais Vasco,2177880,25,0,13969,1561
2020-07-11,Spain,NA,Pais Vasco,2177880,41,0,14010,1561
2020-07-12,Spain,NA,Pais Vasco,2177880,43,1,14053,1562
2020-07-13,Spain,NA,Pais Vasco,2177880,52,0,14105,1562
2020-07-14,Spain,NA,Pais Vasco,2177880,80,1,14185,1563
2020-07-15,Spain,NA,Pais Vasco,2177880,94,0,14279,1563
2020-07-16,Spain,NA,Pais Vasco,2177880,127,0,14406,1563
2020-07-17,Spain,NA,Pais Vasco,2177880,101,0,14507,1563
2020-07-18,Spain,NA,Pais Vasco,2177880,185,1,14692,1564
2020-07-19,Spain,NA,Pais Vasco,2177880,92,0,14784,1564
2020-07-20,Spain,NA,Pais Vasco,2177880,112,0,14896,1564
2020-07-21,Spain,NA,Pais Vasco,2177880,120,0,15016,1564
2020-07-22,Spain,NA,Pais Vasco,2177880,158,0,15174,1564
2020-07-23,Spain,NA,Pais Vasco,2177880,122,0,15296,1564
2020-07-24,Spain,NA,Pais Vasco,2177880,112,0,15408,1564
2020-07-25,Spain,NA,Pais Vasco,2177880,171,0,15579,1564
2020-07-26,Spain,NA,Pais Vasco,2177880,165,0,15744,1564
2020-07-27,Spain,NA,Pais Vasco,2177880,217,0,15961,1564
2020-07-28,Spain,NA,Pais Vasco,2177880,222,0,16183,1564
2020-07-29,Spain,NA,Pais Vasco,2177880,205,0,16388,1564
2020-07-30,Spain,NA,Pais Vasco,2177880,145,1,16533,1565
2020-07-31,Spain,NA,Pais Vasco,2177880,176,1,16709,1566
2020-08-01,Spain,NA,Pais Vasco,2177880,222,1,16931,1567
2020-08-02,Spain,NA,Pais Vasco,2177880,298,1,17229,1568
2020-08-03,Spain,NA,Pais Vasco,2177880,406,0,17635,1568
2020-08-04,Spain,NA,Pais Vasco,2177880,365,1,18000,1569
2020-08-05,Spain,NA,Pais Vasco,2177880,371,0,18371,1569
2020-08-06,Spain,NA,Pais Vasco,2177880,351,1,18722,1570
2020-08-07,Spain,NA,Pais Vasco,2177880,268,1,18990,1571
2020-08-08,Spain,NA,Pais Vasco,2177880,292,2,19282,1573
2020-08-09,Spain,NA,Pais Vasco,2177880,516,1,19798,1574
2020-08-10,Spain,NA,Pais Vasco,2177880,494,1,20292,1575
2020-08-11,Spain,NA,Pais Vasco,2177880,551,2,20843,1577
2020-08-12,Spain,NA,Pais Vasco,2177880,556,1,21399,1578
2020-08-13,Spain,NA,Pais Vasco,2177880,373,0,21772,1578
2020-08-14,Spain,NA,Pais Vasco,2177880,289,1,22061,1579
2020-08-15,Spain,NA,Pais Vasco,2177880,517,1,22578,1580
2020-08-16,Spain,NA,Pais Vasco,2177880,525,0,23103,1580
2020-08-17,Spain,NA,Pais Vasco,2177880,680,1,23783,1581
2020-08-18,Spain,NA,Pais Vasco,2177880,557,1,24340,1582
2020-08-19,Spain,NA,Pais Vasco,2177880,651,5,24991,1587
2020-08-20,Spain,NA,Pais Vasco,2177880,433,3,25424,1590
2020-08-21,Spain,NA,Pais Vasco,2177880,374,4,25798,1594
2020-08-22,Spain,NA,Pais Vasco,2177880,522,6,26320,1600
2020-08-23,Spain,NA,Pais Vasco,2177880,686,3,27006,1603
2020-08-24,Spain,NA,Pais Vasco,2177880,750,6,27756,1609
2020-08-25,Spain,NA,Pais Vasco,2177880,825,5,28581,1614
2020-08-26,Spain,NA,Pais Vasco,2177880,686,10,29267,1624
2020-08-27,Spain,NA,Pais Vasco,2177880,450,2,29717,1626
2020-08-28,Spain,NA,Pais Vasco,2177880,459,9,30176,1635
2020-08-29,Spain,NA,Pais Vasco,2177880,521,6,30697,1641
2020-08-30,Spain,NA,Pais Vasco,2177880,571,3,31268,1644
2020-08-31,Spain,NA,Pais Vasco,2177880,689,3,31957,1647
2020-09-01,Spain,NA,Pais Vasco,2177880,731,10,32688,1657
2020-09-02,Spain,NA,Pais Vasco,2177880,612,6,33300,1663
2020-09-03,Spain,NA,Pais Vasco,2177880,493,8,33793,1671
2020-09-04,Spain,NA,Pais Vasco,2177880,401,8,34194,1679
2020-09-05,Spain,NA,Pais Vasco,2177880,612,11,34806,1690
2020-09-06,Spain,NA,Pais Vasco,2177880,617,6,35423,1696
2020-09-07,Spain,NA,Pais Vasco,2177880,602,7,36025,1703
2020-09-08,Spain,NA,Pais Vasco,2177880,678,9,36703,1712
2020-09-09,Spain,NA,Pais Vasco,2177880,521,6,37224,1718
2020-09-10,Spain,NA,Pais Vasco,2177880,315,8,37539,1726
2020-09-11,Spain,NA,Pais Vasco,2177880,304,9,37843,1735
2020-09-12,Spain,NA,Pais Vasco,2177880,432,10,38275,1745
2020-09-13,Spain,NA,Pais Vasco,2177880,540,7,38815,1752
2020-09-14,Spain,NA,Pais Vasco,2177880,515,8,39330,1760
2020-09-15,Spain,NA,Pais Vasco,2177880,596,11,39926,1771
2020-09-16,Spain,NA,Pais Vasco,2177880,450,13,40376,1784
2020-09-17,Spain,NA,Pais Vasco,2177880,373,22,40749,1806
2020-09-18,Spain,NA,Pais Vasco,2177880,297,6,41046,1812
2020-09-19,Spain,NA,Pais Vasco,2177880,380,8,41426,1820
2020-09-20,Spain,NA,Pais Vasco,2177880,491,5,41917,1825
2020-09-21,Spain,NA,Pais Vasco,2177880,43,0,41960,1825
2020-09-22,Spain,NA,Pais Vasco,2177880,7,0,41967,1825
2020-09-23,Spain,NA,Pais Vasco,2177880,1,1,41968,1826
2020-03-01,Spain,NA,Region de Murcia,1487663,4,0,12,0
2020-03-02,Spain,NA,Region de Murcia,1487663,6,0,18,0
2020-03-03,Spain,NA,Region de Murcia,1487663,3,0,21,0
2020-03-04,Spain,NA,Region de Murcia,1487663,5,0,26,0
2020-03-05,Spain,NA,Region de Murcia,1487663,10,0,36,0
2020-03-06,Spain,NA,Region de Murcia,1487663,10,0,46,0
2020-03-07,Spain,NA,Region de Murcia,1487663,15,0,61,0
2020-03-08,Spain,NA,Region de Murcia,1487663,14,0,75,0
2020-03-09,Spain,NA,Region de Murcia,1487663,24,0,99,0
2020-03-10,Spain,NA,Region de Murcia,1487663,48,0,147,0
2020-03-11,Spain,NA,Region de Murcia,1487663,56,0,203,0
2020-03-12,Spain,NA,Region de Murcia,1487663,40,0,243,0
2020-03-13,Spain,NA,Region de Murcia,1487663,70,0,313,0
2020-03-14,Spain,NA,Region de Murcia,1487663,80,0,393,0
2020-03-15,Spain,NA,Region de Murcia,1487663,70,0,463,0
2020-03-16,Spain,NA,Region de Murcia,1487663,98,0,561,0
2020-03-17,Spain,NA,Region de Murcia,1487663,79,0,640,0
2020-03-18,Spain,NA,Region de Murcia,1487663,91,0,731,0
2020-03-19,Spain,NA,Region de Murcia,1487663,80,0,811,0
2020-03-20,Spain,NA,Region de Murcia,1487663,86,1,897,1
2020-03-21,Spain,NA,Region de Murcia,1487663,67,0,964,1
2020-03-22,Spain,NA,Region de Murcia,1487663,64,2,1028,3
2020-03-23,Spain,NA,Region de Murcia,1487663,100,0,1128,3
2020-03-24,Spain,NA,Region de Murcia,1487663,61,4,1189,7
2020-03-25,Spain,NA,Region de Murcia,1487663,65,4,1254,11
2020-03-26,Spain,NA,Region de Murcia,1487663,36,8,1290,19
2020-03-27,Spain,NA,Region de Murcia,1487663,36,6,1326,25
2020-03-28,Spain,NA,Region de Murcia,1487663,29,6,1355,31
2020-03-29,Spain,NA,Region de Murcia,1487663,23,9,1378,40
2020-03-30,Spain,NA,Region de Murcia,1487663,26,3,1404,43
2020-03-31,Spain,NA,Region de Murcia,1487663,23,6,1427,49
2020-04-01,Spain,NA,Region de Murcia,1487663,19,3,1446,52
2020-04-02,Spain,NA,Region de Murcia,1487663,21,7,1467,59
2020-04-03,Spain,NA,Region de Murcia,1487663,14,7,1481,66
2020-04-04,Spain,NA,Region de Murcia,1487663,19,5,1500,71
2020-04-05,Spain,NA,Region de Murcia,1487663,11,13,1511,84
2020-04-06,Spain,NA,Region de Murcia,1487663,6,5,1517,89
2020-04-07,Spain,NA,Region de Murcia,1487663,4,4,1521,93
2020-04-08,Spain,NA,Region de Murcia,1487663,16,6,1537,99
2020-04-09,Spain,NA,Region de Murcia,1487663,5,2,1542,101
2020-04-10,Spain,NA,Region de Murcia,1487663,5,3,1547,104
2020-04-11,Spain,NA,Region de Murcia,1487663,5,4,1552,108
2020-04-12,Spain,NA,Region de Murcia,1487663,4,4,1556,112
2020-04-13,Spain,NA,Region de Murcia,1487663,1,2,1557,114
2020-04-14,Spain,NA,Region de Murcia,1487663,5,3,1562,117
2020-04-15,Spain,NA,Region de Murcia,1487663,5,0,1567,117
2020-04-16,Spain,NA,Region de Murcia,1487663,1,2,1568,119
2020-04-17,Spain,NA,Region de Murcia,1487663,3,4,1571,123
2020-04-18,Spain,NA,Region de Murcia,1487663,0,1,1571,124
2020-04-19,Spain,NA,Region de Murcia,1487663,3,2,1574,126
2020-04-20,Spain,NA,Region de Murcia,1487663,1,0,1575,126
2020-04-21,Spain,NA,Region de Murcia,1487663,2,2,1577,128
2020-04-22,Spain,NA,Region de Murcia,1487663,3,1,1580,129
2020-04-23,Spain,NA,Region de Murcia,1487663,3,1,1583,130
2020-04-24,Spain,NA,Region de Murcia,1487663,0,1,1583,131
2020-04-25,Spain,NA,Region de Murcia,1487663,2,1,1585,132
2020-04-26,Spain,NA,Region de Murcia,1487663,3,2,1588,134
2020-04-27,Spain,NA,Region de Murcia,1487663,0,0,1588,134
2020-04-28,Spain,NA,Region de Murcia,1487663,0,0,1588,134
2020-04-29,Spain,NA,Region de Murcia,1487663,2,0,1590,134
2020-04-30,Spain,NA,Region de Murcia,1487663,1,2,1591,136
2020-05-01,Spain,NA,Region de Murcia,1487663,1,1,1592,137
2020-05-02,Spain,NA,Region de Murcia,1487663,1,3,1593,140
2020-05-03,Spain,NA,Region de Murcia,1487663,1,0,1594,140
2020-05-04,Spain,NA,Region de Murcia,1487663,2,0,1596,140
2020-05-05,Spain,NA,Region de Murcia,1487663,1,1,1597,141
2020-05-06,Spain,NA,Region de Murcia,1487663,2,0,1599,141
2020-05-07,Spain,NA,Region de Murcia,1487663,2,1,1601,142
2020-05-08,Spain,NA,Region de Murcia,1487663,1,0,1602,142
2020-05-09,Spain,NA,Region de Murcia,1487663,1,0,1603,142
2020-05-10,Spain,NA,Region de Murcia,1487663,1,0,1604,142
2020-05-11,Spain,NA,Region de Murcia,1487663,2,0,1606,142
2020-05-12,Spain,NA,Region de Murcia,1487663,3,1,1609,143
2020-05-13,Spain,NA,Region de Murcia,1487663,5,0,1614,143
2020-05-14,Spain,NA,Region de Murcia,1487663,2,1,1616,144
2020-05-15,Spain,NA,Region de Murcia,1487663,0,0,1616,144
2020-05-16,Spain,NA,Region de Murcia,1487663,1,0,1617,144
2020-05-17,Spain,NA,Region de Murcia,1487663,1,1,1618,145
2020-05-18,Spain,NA,Region de Murcia,1487663,2,0,1620,145
2020-05-19,Spain,NA,Region de Murcia,1487663,2,0,1622,145
2020-05-20,Spain,NA,Region de Murcia,1487663,0,0,1622,145
2020-05-21,Spain,NA,Region de Murcia,1487663,1,1,1623,146
2020-05-22,Spain,NA,Region de Murcia,1487663,1,0,1624,146
2020-05-23,Spain,NA,Region de Murcia,1487663,2,0,1626,146
2020-05-24,Spain,NA,Region de Murcia,1487663,0,0,1626,146
2020-05-25,Spain,NA,Region de Murcia,1487663,1,0,1627,146
2020-05-26,Spain,NA,Region de Murcia,1487663,0,0,1627,146
2020-05-27,Spain,NA,Region de Murcia,1487663,4,0,1631,146
2020-05-28,Spain,NA,Region de Murcia,1487663,2,0,1633,146
2020-05-29,Spain,NA,Region de Murcia,1487663,1,0,1634,146
2020-05-30,Spain,NA,Region de Murcia,1487663,1,0,1635,146
2020-05-31,Spain,NA,Region de Murcia,1487663,0,0,1635,146
2020-06-01,Spain,NA,Region de Murcia,1487663,4,0,1639,146
2020-06-02,Spain,NA,Region de Murcia,1487663,2,0,1641,146
2020-06-03,Spain,NA,Region de Murcia,1487663,2,0,1643,146
2020-06-04,Spain,NA,Region de Murcia,1487663,2,0,1645,146
2020-06-05,Spain,NA,Region de Murcia,1487663,1,0,1646,146
2020-06-06,Spain,NA,Region de Murcia,1487663,3,0,1649,146
2020-06-07,Spain,NA,Region de Murcia,1487663,0,0,1649,146
2020-06-08,Spain,NA,Region de Murcia,1487663,2,1,1651,147
2020-06-09,Spain,NA,Region de Murcia,1487663,2,0,1653,147
2020-06-10,Spain,NA,Region de Murcia,1487663,1,0,1654,147
2020-06-11,Spain,NA,Region de Murcia,1487663,0,0,1654,147
2020-06-12,Spain,NA,Region de Murcia,1487663,0,0,1654,147
2020-06-13,Spain,NA,Region de Murcia,1487663,1,0,1655,147
2020-06-14,Spain,NA,Region de Murcia,1487663,3,0,1658,147
2020-06-15,Spain,NA,Region de Murcia,1487663,2,0,1660,147
2020-06-16,Spain,NA,Region de Murcia,1487663,1,0,1661,147
2020-06-17,Spain,NA,Region de Murcia,1487663,2,0,1663,147
2020-06-18,Spain,NA,Region de Murcia,1487663,2,0,1665,147
2020-06-19,Spain,NA,Region de Murcia,1487663,3,0,1668,147
2020-06-20,Spain,NA,Region de Murcia,1487663,3,0,1671,147
2020-06-21,Spain,NA,Region de Murcia,1487663,5,0,1676,147
2020-06-22,Spain,NA,Region de Murcia,1487663,4,0,1680,147
2020-06-23,Spain,NA,Region de Murcia,1487663,5,0,1685,147
2020-06-24,Spain,NA,Region de Murcia,1487663,7,0,1692,147
2020-06-25,Spain,NA,Region de Murcia,1487663,5,0,1697,147
2020-06-26,Spain,NA,Region de Murcia,1487663,7,0,1704,147
2020-06-27,Spain,NA,Region de Murcia,1487663,6,0,1710,147
2020-06-28,Spain,NA,Region de Murcia,1487663,3,0,1713,147
2020-06-29,Spain,NA,Region de Murcia,1487663,10,0,1723,147
2020-06-30,Spain,NA,Region de Murcia,1487663,3,0,1726,147
2020-07-01,Spain,NA,Region de Murcia,1487663,5,0,1731,147
2020-07-02,Spain,NA,Region de Murcia,1487663,2,0,1733,147
2020-07-03,Spain,NA,Region de Murcia,1487663,3,0,1736,147
2020-07-04,Spain,NA,Region de Murcia,1487663,6,0,1742,147
2020-07-05,Spain,NA,Region de Murcia,1487663,7,0,1749,147
2020-07-06,Spain,NA,Region de Murcia,1487663,8,0,1757,147
2020-07-07,Spain,NA,Region de Murcia,1487663,13,0,1770,147
2020-07-08,Spain,NA,Region de Murcia,1487663,16,0,1786,147
2020-07-09,Spain,NA,Region de Murcia,1487663,6,0,1792,147
2020-07-10,Spain,NA,Region de Murcia,1487663,9,0,1801,147
2020-07-11,Spain,NA,Region de Murcia,1487663,17,0,1818,147
2020-07-12,Spain,NA,Region de Murcia,1487663,12,0,1830,147
2020-07-13,Spain,NA,Region de Murcia,1487663,13,0,1843,147
2020-07-14,Spain,NA,Region de Murcia,1487663,21,0,1864,147
2020-07-15,Spain,NA,Region de Murcia,1487663,31,0,1895,147
2020-07-16,Spain,NA,Region de Murcia,1487663,24,0,1919,147
2020-07-17,Spain,NA,Region de Murcia,1487663,31,0,1950,147
2020-07-18,Spain,NA,Region de Murcia,1487663,21,0,1971,147
2020-07-19,Spain,NA,Region de Murcia,1487663,26,0,1997,147
2020-07-20,Spain,NA,Region de Murcia,1487663,38,0,2035,147
2020-07-21,Spain,NA,Region de Murcia,1487663,49,0,2084,147
2020-07-22,Spain,NA,Region de Murcia,1487663,58,0,2142,147
2020-07-23,Spain,NA,Region de Murcia,1487663,48,0,2190,147
2020-07-24,Spain,NA,Region de Murcia,1487663,72,0,2262,147
2020-07-25,Spain,NA,Region de Murcia,1487663,84,0,2346,147
2020-07-26,Spain,NA,Region de Murcia,1487663,50,0,2396,147
2020-07-27,Spain,NA,Region de Murcia,1487663,60,0,2456,147
2020-07-28,Spain,NA,Region de Murcia,1487663,74,0,2530,147
2020-07-29,Spain,NA,Region de Murcia,1487663,90,0,2620,147
2020-07-30,Spain,NA,Region de Murcia,1487663,63,0,2683,147
2020-07-31,Spain,NA,Region de Murcia,1487663,55,0,2738,147
2020-08-01,Spain,NA,Region de Murcia,1487663,83,0,2821,147
2020-08-02,Spain,NA,Region de Murcia,1487663,61,0,2882,147
2020-08-03,Spain,NA,Region de Murcia,1487663,74,0,2956,147
2020-08-04,Spain,NA,Region de Murcia,1487663,97,0,3053,147
2020-08-05,Spain,NA,Region de Murcia,1487663,63,0,3116,147
2020-08-06,Spain,NA,Region de Murcia,1487663,61,0,3177,147
2020-08-07,Spain,NA,Region de Murcia,1487663,109,0,3286,147
2020-08-08,Spain,NA,Region de Murcia,1487663,87,0,3373,147
2020-08-09,Spain,NA,Region de Murcia,1487663,94,0,3467,147
2020-08-10,Spain,NA,Region de Murcia,1487663,124,0,3591,147
2020-08-11,Spain,NA,Region de Murcia,1487663,122,0,3713,147
2020-08-12,Spain,NA,Region de Murcia,1487663,141,0,3854,147
2020-08-13,Spain,NA,Region de Murcia,1487663,192,0,4046,147
2020-08-14,Spain,NA,Region de Murcia,1487663,179,0,4225,147
2020-08-15,Spain,NA,Region de Murcia,1487663,177,2,4402,149
2020-08-16,Spain,NA,Region de Murcia,1487663,130,0,4532,149
2020-08-17,Spain,NA,Region de Murcia,1487663,219,0,4751,149
2020-08-18,Spain,NA,Region de Murcia,1487663,186,0,4937,149
2020-08-19,Spain,NA,Region de Murcia,1487663,205,0,5142,149
2020-08-20,Spain,NA,Region de Murcia,1487663,234,1,5376,150
2020-08-21,Spain,NA,Region de Murcia,1487663,279,0,5655,150
2020-08-22,Spain,NA,Region de Murcia,1487663,272,0,5927,150
2020-08-23,Spain,NA,Region de Murcia,1487663,240,0,6167,150
2020-08-24,Spain,NA,Region de Murcia,1487663,261,1,6428,151
2020-08-25,Spain,NA,Region de Murcia,1487663,299,1,6727,152
2020-08-26,Spain,NA,Region de Murcia,1487663,314,0,7041,152
2020-08-27,Spain,NA,Region de Murcia,1487663,396,0,7437,152
2020-08-28,Spain,NA,Region de Murcia,1487663,335,0,7772,152
2020-08-29,Spain,NA,Region de Murcia,1487663,325,0,8097,152
2020-08-30,Spain,NA,Region de Murcia,1487663,318,0,8415,152
2020-08-31,Spain,NA,Region de Murcia,1487663,325,0,8740,152
2020-09-01,Spain,NA,Region de Murcia,1487663,377,0,9117,152
2020-09-02,Spain,NA,Region de Murcia,1487663,382,0,9499,152
2020-09-03,Spain,NA,Region de Murcia,1487663,343,0,9842,152
2020-09-04,Spain,NA,Region de Murcia,1487663,362,0,10204,152
2020-09-05,Spain,NA,Region de Murcia,1487663,377,0,10581,152
2020-09-06,Spain,NA,Region de Murcia,1487663,305,1,10886,153
2020-09-07,Spain,NA,Region de Murcia,1487663,379,0,11265,153
2020-09-08,Spain,NA,Region de Murcia,1487663,422,1,11687,154
2020-09-09,Spain,NA,Region de Murcia,1487663,386,0,12073,154
2020-09-10,Spain,NA,Region de Murcia,1487663,415,1,12488,155
2020-09-11,Spain,NA,Region de Murcia,1487663,442,1,12930,156
2020-09-12,Spain,NA,Region de Murcia,1487663,419,1,13349,157
2020-09-13,Spain,NA,Region de Murcia,1487663,362,0,13711,157
2020-09-14,Spain,NA,Region de Murcia,1487663,518,0,14229,157
2020-09-15,Spain,NA,Region de Murcia,1487663,464,1,14693,158
2020-09-16,Spain,NA,Region de Murcia,1487663,411,0,15104,158
2020-09-17,Spain,NA,Region de Murcia,1487663,367,0,15471,158
2020-09-18,Spain,NA,Region de Murcia,1487663,366,0,15837,158
2020-09-19,Spain,NA,Region de Murcia,1487663,329,0,16166,158
2020-09-20,Spain,NA,Region de Murcia,1487663,160,0,16326,158
2020-09-21,Spain,NA,Region de Murcia,1487663,153,0,16479,158
2020-09-22,Spain,NA,Region de Murcia,1487663,152,0,16631,158
2020-09-23,Spain,NA,Region de Murcia,1487663,29,0,16660,158
2020-03-29,Ukraine,NA,Cherkasy,1220363,43,0,46,0
2020-03-30,Ukraine,NA,Cherkasy,1220363,4,0,50,0
2020-03-31,Ukraine,NA,Cherkasy,1220363,1,0,51,0
2020-04-01,Ukraine,NA,Cherkasy,1220363,3,0,54,0
2020-04-02,Ukraine,NA,Cherkasy,1220363,1,0,55,0
2020-04-03,Ukraine,NA,Cherkasy,1220363,4,1,59,1
2020-04-04,Ukraine,NA,Cherkasy,1220363,1,0,60,1
2020-04-05,Ukraine,NA,Cherkasy,1220363,0,0,60,1
2020-04-06,Ukraine,NA,Cherkasy,1220363,2,0,62,1
2020-04-07,Ukraine,NA,Cherkasy,1220363,0,0,62,1
2020-04-08,Ukraine,NA,Cherkasy,1220363,18,0,80,1
2020-04-09,Ukraine,NA,Cherkasy,1220363,0,0,80,1
2020-04-10,Ukraine,NA,Cherkasy,1220363,6,0,86,1
2020-04-11,Ukraine,NA,Cherkasy,1220363,7,0,93,1
2020-04-12,Ukraine,NA,Cherkasy,1220363,6,1,99,2
2020-04-13,Ukraine,NA,Cherkasy,1220363,3,0,102,2
2020-04-14,Ukraine,NA,Cherkasy,1220363,3,0,105,2
2020-04-15,Ukraine,NA,Cherkasy,1220363,0,0,105,2
2020-04-16,Ukraine,NA,Cherkasy,1220363,5,0,110,2
2020-04-17,Ukraine,NA,Cherkasy,1220363,27,0,137,2
2020-04-18,Ukraine,NA,Cherkasy,1220363,4,0,141,2
2020-04-19,Ukraine,NA,Cherkasy,1220363,10,0,151,2
2020-04-20,Ukraine,NA,Cherkasy,1220363,14,0,165,2
2020-04-21,Ukraine,NA,Cherkasy,1220363,21,1,186,3
2020-04-22,Ukraine,NA,Cherkasy,1220363,20,0,206,3
2020-04-23,Ukraine,NA,Cherkasy,1220363,14,0,220,3
2020-04-24,Ukraine,NA,Cherkasy,1220363,14,0,234,3
2020-04-25,Ukraine,NA,Cherkasy,1220363,15,0,249,3
2020-04-26,Ukraine,NA,Cherkasy,1220363,8,1,257,4
2020-04-27,Ukraine,NA,Cherkasy,1220363,10,3,267,7
2020-04-28,Ukraine,NA,Cherkasy,1220363,9,1,276,8
2020-04-29,Ukraine,NA,Cherkasy,1220363,6,0,282,8
2020-04-30,Ukraine,NA,Cherkasy,1220363,8,0,290,8
2020-05-01,Ukraine,NA,Cherkasy,1220363,6,1,296,9
2020-05-02,Ukraine,NA,Cherkasy,1220363,8,0,304,9
2020-05-03,Ukraine,NA,Cherkasy,1220363,4,0,308,9
2020-05-04,Ukraine,NA,Cherkasy,1220363,4,0,312,9
2020-05-05,Ukraine,NA,Cherkasy,1220363,2,0,314,9
2020-05-06,Ukraine,NA,Cherkasy,1220363,0,1,314,10
2020-05-07,Ukraine,NA,Cherkasy,1220363,10,0,324,10
2020-05-08,Ukraine,NA,Cherkasy,1220363,7,1,331,11
2020-05-09,Ukraine,NA,Cherkasy,1220363,2,1,333,12
2020-05-10,Ukraine,NA,Cherkasy,1220363,8,0,341,12
2020-05-11,Ukraine,NA,Cherkasy,1220363,1,1,342,13
2020-05-12,Ukraine,NA,Cherkasy,1220363,1,0,343,13
2020-05-13,Ukraine,NA,Cherkasy,1220363,3,1,346,14
2020-05-14,Ukraine,NA,Cherkasy,1220363,2,1,348,15
2020-05-15,Ukraine,NA,Cherkasy,1220363,2,0,350,15
2020-05-16,Ukraine,NA,Cherkasy,1220363,13,1,363,16
2020-05-17,Ukraine,NA,Cherkasy,1220363,9,0,372,16
2020-05-18,Ukraine,NA,Cherkasy,1220363,0,0,372,16
2020-05-19,Ukraine,NA,Cherkasy,1220363,4,0,376,16
2020-05-20,Ukraine,NA,Cherkasy,1220363,5,0,381,16
2020-05-21,Ukraine,NA,Cherkasy,1220363,0,0,381,16
2020-05-22,Ukraine,NA,Cherkasy,1220363,2,0,383,16
2020-05-23,Ukraine,NA,Cherkasy,1220363,4,0,387,16
2020-05-24,Ukraine,NA,Cherkasy,1220363,1,0,388,16
2020-05-25,Ukraine,NA,Cherkasy,1220363,3,0,391,16
2020-05-26,Ukraine,NA,Cherkasy,1220363,1,0,392,16
2020-05-27,Ukraine,NA,Cherkasy,1220363,1,0,393,16
2020-05-28,Ukraine,NA,Cherkasy,1220363,8,0,401,16
2020-05-29,Ukraine,NA,Cherkasy,1220363,0,0,401,16
2020-05-30,Ukraine,NA,Cherkasy,1220363,0,0,401,16
2020-05-31,Ukraine,NA,Cherkasy,1220363,1,0,402,16
2020-06-01,Ukraine,NA,Cherkasy,1220363,4,0,406,16
2020-06-02,Ukraine,NA,Cherkasy,1220363,5,0,411,16
2020-06-03,Ukraine,NA,Cherkasy,1220363,5,0,416,16
2020-06-04,Ukraine,NA,Cherkasy,1220363,13,0,429,16
2020-06-05,Ukraine,NA,Cherkasy,1220363,3,0,432,16
2020-06-06,Ukraine,NA,Cherkasy,1220363,16,1,448,17
2020-06-07,Ukraine,NA,Cherkasy,1220363,12,1,460,18
2020-06-08,Ukraine,NA,Cherkasy,1220363,9,0,469,18
2020-06-09,Ukraine,NA,Cherkasy,1220363,21,0,490,18
2020-06-10,Ukraine,NA,Cherkasy,1220363,11,1,501,19
2020-06-11,Ukraine,NA,Cherkasy,1220363,5,0,506,19
2020-06-12,Ukraine,NA,Cherkasy,1220363,11,0,517,19
2020-06-13,Ukraine,NA,Cherkasy,1220363,19,0,536,19
2020-06-14,Ukraine,NA,Cherkasy,1220363,7,0,543,19
2020-06-15,Ukraine,NA,Cherkasy,1220363,9,0,552,19
2020-06-16,Ukraine,NA,Cherkasy,1220363,10,1,562,20
2020-06-17,Ukraine,NA,Cherkasy,1220363,2,1,564,21
2020-06-18,Ukraine,NA,Cherkasy,1220363,4,0,568,21
2020-06-19,Ukraine,NA,Cherkasy,1220363,17,0,585,21
2020-06-20,Ukraine,NA,Cherkasy,1220363,7,0,592,21
2020-06-21,Ukraine,NA,Cherkasy,1220363,11,0,603,21
2020-06-22,Ukraine,NA,Cherkasy,1220363,0,0,603,21
2020-06-23,Ukraine,NA,Cherkasy,1220363,2,0,605,21
2020-06-24,Ukraine,NA,Cherkasy,1220363,9,1,614,22
2020-06-25,Ukraine,NA,Cherkasy,1220363,2,0,616,22
2020-06-26,Ukraine,NA,Cherkasy,1220363,11,1,627,23
2020-06-27,Ukraine,NA,Cherkasy,1220363,8,1,635,24
2020-06-28,Ukraine,NA,Cherkasy,1220363,7,0,642,24
2020-06-29,Ukraine,NA,Cherkasy,1220363,0,0,642,24
2020-06-30,Ukraine,NA,Cherkasy,1220363,0,0,642,24
2020-07-01,Ukraine,NA,Cherkasy,1220363,3,1,645,25
2020-07-02,Ukraine,NA,Cherkasy,1220363,0,1,645,26
2020-07-03,Ukraine,NA,Cherkasy,1220363,8,0,653,26
2020-07-04,Ukraine,NA,Cherkasy,1220363,4,0,657,26
2020-07-05,Ukraine,NA,Cherkasy,1220363,4,0,661,26
2020-07-06,Ukraine,NA,Cherkasy,1220363,9,0,670,26
2020-07-07,Ukraine,NA,Cherkasy,1220363,8,0,678,26
2020-07-08,Ukraine,NA,Cherkasy,1220363,17,1,695,27
2020-07-09,Ukraine,NA,Cherkasy,1220363,12,1,707,28
2020-07-10,Ukraine,NA,Cherkasy,1220363,18,0,725,28
2020-07-11,Ukraine,NA,Cherkasy,1220363,13,1,738,29
2020-07-12,Ukraine,NA,Cherkasy,1220363,10,1,748,30
2020-07-13,Ukraine,NA,Cherkasy,1220363,6,1,754,31
2020-07-14,Ukraine,NA,Cherkasy,1220363,1,0,755,31
2020-07-15,Ukraine,NA,Cherkasy,1220363,16,1,771,32
2020-07-16,Ukraine,NA,Cherkasy,1220363,12,0,783,32
2020-07-17,Ukraine,NA,Cherkasy,1220363,17,0,800,32
2020-07-18,Ukraine,NA,Cherkasy,1220363,18,1,818,33
2020-07-19,Ukraine,NA,Cherkasy,1220363,15,1,833,34
2020-07-20,Ukraine,NA,Cherkasy,1220363,12,0,845,34
2020-07-21,Ukraine,NA,Cherkasy,1220363,2,1,847,35
2020-07-22,Ukraine,NA,Cherkasy,1220363,6,1,853,36
2020-07-23,Ukraine,NA,Cherkasy,1220363,17,0,870,36
2020-07-24,Ukraine,NA,Cherkasy,1220363,18,0,888,36
2020-07-25,Ukraine,NA,Cherkasy,1220363,9,0,897,36
2020-07-26,Ukraine,NA,Cherkasy,1220363,0,0,897,36
2020-07-27,Ukraine,NA,Cherkasy,1220363,5,0,902,36
2020-07-28,Ukraine,NA,Cherkasy,1220363,4,0,906,36
2020-07-29,Ukraine,NA,Cherkasy,1220363,4,1,910,37
2020-07-30,Ukraine,NA,Cherkasy,1220363,9,0,919,37
2020-07-31,Ukraine,NA,Cherkasy,1220363,5,0,924,37
2020-08-01,Ukraine,NA,Cherkasy,1220363,18,0,942,37
2020-08-02,Ukraine,NA,Cherkasy,1220363,7,0,949,37
2020-08-03,Ukraine,NA,Cherkasy,1220363,5,0,954,37
2020-08-04,Ukraine,NA,Cherkasy,1220363,1,0,955,37
2020-08-05,Ukraine,NA,Cherkasy,1220363,4,0,959,37
2020-08-06,Ukraine,NA,Cherkasy,1220363,10,0,969,37
2020-08-07,Ukraine,NA,Cherkasy,1220363,6,0,975,37
2020-08-08,Ukraine,NA,Cherkasy,1220363,21,0,996,37
2020-08-09,Ukraine,NA,Cherkasy,1220363,26,0,1022,37
2020-08-10,Ukraine,NA,Cherkasy,1220363,14,0,1036,37
2020-08-11,Ukraine,NA,Cherkasy,1220363,3,0,1039,37
2020-08-12,Ukraine,NA,Cherkasy,1220363,10,0,1049,37
2020-08-13,Ukraine,NA,Cherkasy,1220363,18,0,1067,37
2020-08-14,Ukraine,NA,Cherkasy,1220363,25,0,1092,37
2020-08-15,Ukraine,NA,Cherkasy,1220363,22,0,1114,37
2020-08-16,Ukraine,NA,Cherkasy,1220363,34,0,1148,37
2020-08-17,Ukraine,NA,Cherkasy,1220363,17,0,1165,37
2020-08-18,Ukraine,NA,Cherkasy,1220363,2,0,1167,37
2020-08-19,Ukraine,NA,Cherkasy,1220363,8,0,1175,37
2020-08-20,Ukraine,NA,Cherkasy,1220363,25,0,1200,37
2020-08-21,Ukraine,NA,Cherkasy,1220363,19,0,1219,37
2020-08-22,Ukraine,NA,Cherkasy,1220363,29,0,1248,37
2020-08-23,Ukraine,NA,Cherkasy,1220363,38,0,1286,37
2020-08-24,Ukraine,NA,Cherkasy,1220363,11,0,1297,37
2020-08-25,Ukraine,NA,Cherkasy,1220363,3,0,1300,37
2020-08-26,Ukraine,NA,Cherkasy,1220363,5,1,1305,38
2020-08-27,Ukraine,NA,Cherkasy,1220363,13,0,1318,38
2020-08-28,Ukraine,NA,Cherkasy,1220363,72,0,1390,38
2020-08-29,Ukraine,NA,Cherkasy,1220363,92,0,1482,38
2020-08-30,Ukraine,NA,Cherkasy,1220363,56,0,1538,38
2020-08-31,Ukraine,NA,Cherkasy,1220363,35,0,1573,38
2020-09-01,Ukraine,NA,Cherkasy,1220363,21,0,1594,38
2020-09-02,Ukraine,NA,Cherkasy,1220363,48,0,1642,38
2020-09-03,Ukraine,NA,Cherkasy,1220363,28,1,1670,39
2020-09-04,Ukraine,NA,Cherkasy,1220363,86,1,1756,40
2020-09-05,Ukraine,NA,Cherkasy,1220363,93,1,1849,41
2020-09-06,Ukraine,NA,Cherkasy,1220363,45,0,1894,41
2020-09-07,Ukraine,NA,Cherkasy,1220363,56,0,1950,41
2020-09-08,Ukraine,NA,Cherkasy,1220363,96,0,2046,41
2020-09-09,Ukraine,NA,Cherkasy,1220363,75,0,2121,41
2020-09-10,Ukraine,NA,Cherkasy,1220363,56,0,2177,41
2020-09-11,Ukraine,NA,Cherkasy,1220363,117,0,2294,41
2020-09-12,Ukraine,NA,Cherkasy,1220363,90,1,2384,42
2020-09-13,Ukraine,NA,Cherkasy,1220363,111,1,2495,43
2020-09-14,Ukraine,NA,Cherkasy,1220363,84,0,2579,43
2020-09-15,Ukraine,NA,Cherkasy,1220363,109,0,2688,43
2020-09-16,Ukraine,NA,Cherkasy,1220363,51,2,2739,45
2020-09-17,Ukraine,NA,Cherkasy,1220363,81,2,2820,47
2020-09-18,Ukraine,NA,Cherkasy,1220363,71,0,2891,47
2020-09-19,Ukraine,NA,Cherkasy,1220363,92,1,2983,48
2020-09-20,Ukraine,NA,Cherkasy,1220363,52,0,3035,48
2020-09-21,Ukraine,NA,Cherkasy,1220363,61,0,3096,48
2020-09-22,Ukraine,NA,Cherkasy,1220363,49,1,3145,49
2020-09-23,Ukraine,NA,Cherkasy,1220363,93,1,3238,50
2020-04-16,Ukraine,NA,Chernihiv,1020078,1,0,11,1
2020-04-17,Ukraine,NA,Chernihiv,1020078,1,0,12,1
2020-04-18,Ukraine,NA,Chernihiv,1020078,0,0,12,1
2020-04-19,Ukraine,NA,Chernihiv,1020078,0,0,12,1
2020-04-20,Ukraine,NA,Chernihiv,1020078,0,0,12,1
2020-04-21,Ukraine,NA,Chernihiv,1020078,1,0,13,1
2020-04-22,Ukraine,NA,Chernihiv,1020078,0,0,13,1
2020-04-23,Ukraine,NA,Chernihiv,1020078,4,0,17,1
2020-04-24,Ukraine,NA,Chernihiv,1020078,2,0,19,1
2020-04-25,Ukraine,NA,Chernihiv,1020078,3,1,22,2
2020-04-26,Ukraine,NA,Chernihiv,1020078,10,0,32,2
2020-04-27,Ukraine,NA,Chernihiv,1020078,3,0,35,2
2020-04-28,Ukraine,NA,Chernihiv,1020078,4,2,39,4
2020-04-29,Ukraine,NA,Chernihiv,1020078,2,0,41,4
2020-04-30,Ukraine,NA,Chernihiv,1020078,9,0,50,4
2020-05-01,Ukraine,NA,Chernihiv,1020078,0,0,50,4
2020-05-02,Ukraine,NA,Chernihiv,1020078,1,0,51,4
2020-05-03,Ukraine,NA,Chernihiv,1020078,3,1,54,5
2020-05-04,Ukraine,NA,Chernihiv,1020078,10,0,64,5
2020-05-05,Ukraine,NA,Chernihiv,1020078,0,0,64,5
2020-05-06,Ukraine,NA,Chernihiv,1020078,1,0,65,5
2020-05-07,Ukraine,NA,Chernihiv,1020078,3,1,68,6
2020-05-08,Ukraine,NA,Chernihiv,1020078,1,0,69,6
2020-05-09,Ukraine,NA,Chernihiv,1020078,4,0,73,6
2020-05-10,Ukraine,NA,Chernihiv,1020078,0,0,73,6
2020-05-11,Ukraine,NA,Chernihiv,1020078,4,0,77,6
2020-05-12,Ukraine,NA,Chernihiv,1020078,2,0,79,6
2020-05-13,Ukraine,NA,Chernihiv,1020078,0,0,79,6
2020-05-14,Ukraine,NA,Chernihiv,1020078,5,0,84,6
2020-05-15,Ukraine,NA,Chernihiv,1020078,12,0,96,6
2020-05-16,Ukraine,NA,Chernihiv,1020078,9,0,105,6
2020-05-17,Ukraine,NA,Chernihiv,1020078,3,0,108,6
2020-05-18,Ukraine,NA,Chernihiv,1020078,0,0,108,6
2020-05-19,Ukraine,NA,Chernihiv,1020078,2,0,110,6
2020-05-20,Ukraine,NA,Chernihiv,1020078,5,0,115,6
2020-05-21,Ukraine,NA,Chernihiv,1020078,2,0,117,6
2020-05-22,Ukraine,NA,Chernihiv,1020078,2,0,119,6
2020-05-23,Ukraine,NA,Chernihiv,1020078,8,0,127,6
2020-05-24,Ukraine,NA,Chernihiv,1020078,2,0,129,6
2020-05-25,Ukraine,NA,Chernihiv,1020078,2,0,131,6
2020-05-26,Ukraine,NA,Chernihiv,1020078,3,0,134,6
2020-05-27,Ukraine,NA,Chernihiv,1020078,3,0,137,6
2020-05-28,Ukraine,NA,Chernihiv,1020078,3,0,140,6
2020-05-29,Ukraine,NA,Chernihiv,1020078,10,0,150,6
2020-05-30,Ukraine,NA,Chernihiv,1020078,9,0,159,6
2020-05-31,Ukraine,NA,Chernihiv,1020078,8,0,167,6
2020-06-01,Ukraine,NA,Chernihiv,1020078,10,0,177,6
2020-06-02,Ukraine,NA,Chernihiv,1020078,11,0,188,6
2020-06-03,Ukraine,NA,Chernihiv,1020078,15,0,203,6
2020-06-04,Ukraine,NA,Chernihiv,1020078,35,1,238,7
2020-06-05,Ukraine,NA,Chernihiv,1020078,12,1,250,8
2020-06-06,Ukraine,NA,Chernihiv,1020078,7,0,257,8
2020-06-07,Ukraine,NA,Chernihiv,1020078,22,0,279,8
2020-06-08,Ukraine,NA,Chernihiv,1020078,20,0,299,8
2020-06-09,Ukraine,NA,Chernihiv,1020078,5,0,304,8
2020-06-10,Ukraine,NA,Chernihiv,1020078,16,0,320,8
2020-06-11,Ukraine,NA,Chernihiv,1020078,21,0,341,8
2020-06-12,Ukraine,NA,Chernihiv,1020078,25,0,366,8
2020-06-13,Ukraine,NA,Chernihiv,1020078,19,1,385,9
2020-06-14,Ukraine,NA,Chernihiv,1020078,25,0,410,9
2020-06-15,Ukraine,NA,Chernihiv,1020078,14,1,424,10
2020-06-16,Ukraine,NA,Chernihiv,1020078,3,0,427,10
2020-06-17,Ukraine,NA,Chernihiv,1020078,13,0,440,10
2020-06-18,Ukraine,NA,Chernihiv,1020078,8,0,448,10
2020-06-19,Ukraine,NA,Chernihiv,1020078,11,0,459,10
2020-06-20,Ukraine,NA,Chernihiv,1020078,8,0,467,10
2020-06-21,Ukraine,NA,Chernihiv,1020078,8,0,475,10
2020-06-22,Ukraine,NA,Chernihiv,1020078,5,0,480,10
2020-06-23,Ukraine,NA,Chernihiv,1020078,5,0,485,10
2020-06-24,Ukraine,NA,Chernihiv,1020078,9,0,494,10
2020-06-25,Ukraine,NA,Chernihiv,1020078,12,0,506,10
2020-06-26,Ukraine,NA,Chernihiv,1020078,8,0,514,10
2020-06-27,Ukraine,NA,Chernihiv,1020078,5,0,519,10
2020-06-28,Ukraine,NA,Chernihiv,1020078,7,0,526,10
2020-06-29,Ukraine,NA,Chernihiv,1020078,9,0,535,10
2020-06-30,Ukraine,NA,Chernihiv,1020078,1,0,536,10
2020-07-01,Ukraine,NA,Chernihiv,1020078,2,0,538,10
2020-07-02,Ukraine,NA,Chernihiv,1020078,9,1,547,11
2020-07-03,Ukraine,NA,Chernihiv,1020078,7,0,554,11
2020-07-04,Ukraine,NA,Chernihiv,1020078,6,0,560,11
2020-07-05,Ukraine,NA,Chernihiv,1020078,12,1,572,12
2020-07-06,Ukraine,NA,Chernihiv,1020078,4,0,576,12
2020-07-07,Ukraine,NA,Chernihiv,1020078,0,1,576,13
2020-07-08,Ukraine,NA,Chernihiv,1020078,2,0,578,13
2020-07-09,Ukraine,NA,Chernihiv,1020078,7,0,585,13
2020-07-10,Ukraine,NA,Chernihiv,1020078,7,1,592,14
2020-07-11,Ukraine,NA,Chernihiv,1020078,2,0,594,14
2020-07-12,Ukraine,NA,Chernihiv,1020078,13,0,607,14
2020-07-13,Ukraine,NA,Chernihiv,1020078,1,0,608,14
2020-07-14,Ukraine,NA,Chernihiv,1020078,4,0,612,14
2020-07-15,Ukraine,NA,Chernihiv,1020078,12,0,624,14
2020-07-16,Ukraine,NA,Chernihiv,1020078,4,0,628,14
2020-07-17,Ukraine,NA,Chernihiv,1020078,4,0,632,14
2020-07-18,Ukraine,NA,Chernihiv,1020078,0,0,632,14
2020-07-19,Ukraine,NA,Chernihiv,1020078,10,0,642,14
2020-07-20,Ukraine,NA,Chernihiv,1020078,0,0,642,14
2020-07-21,Ukraine,NA,Chernihiv,1020078,7,1,649,15
2020-07-22,Ukraine,NA,Chernihiv,1020078,5,0,654,15
2020-07-23,Ukraine,NA,Chernihiv,1020078,13,0,667,15
2020-07-24,Ukraine,NA,Chernihiv,1020078,12,2,679,17
2020-07-25,Ukraine,NA,Chernihiv,1020078,11,0,690,17
2020-07-26,Ukraine,NA,Chernihiv,1020078,21,0,711,17
2020-07-27,Ukraine,NA,Chernihiv,1020078,9,0,720,17
2020-07-28,Ukraine,NA,Chernihiv,1020078,6,1,726,18
2020-07-29,Ukraine,NA,Chernihiv,1020078,19,0,745,18
2020-07-30,Ukraine,NA,Chernihiv,1020078,44,0,789,18
2020-07-31,Ukraine,NA,Chernihiv,1020078,34,0,823,18
2020-08-01,Ukraine,NA,Chernihiv,1020078,20,0,843,18
2020-08-02,Ukraine,NA,Chernihiv,1020078,40,0,883,18
2020-08-03,Ukraine,NA,Chernihiv,1020078,17,0,900,18
2020-08-04,Ukraine,NA,Chernihiv,1020078,9,0,909,18
2020-08-05,Ukraine,NA,Chernihiv,1020078,11,0,920,18
2020-08-06,Ukraine,NA,Chernihiv,1020078,17,0,937,18
2020-08-07,Ukraine,NA,Chernihiv,1020078,28,0,965,18
2020-08-08,Ukraine,NA,Chernihiv,1020078,26,0,991,18
2020-08-09,Ukraine,NA,Chernihiv,1020078,23,0,1014,18
2020-08-10,Ukraine,NA,Chernihiv,1020078,10,0,1024,18
2020-08-11,Ukraine,NA,Chernihiv,1020078,14,0,1038,18
2020-08-12,Ukraine,NA,Chernihiv,1020078,42,0,1080,18
2020-08-13,Ukraine,NA,Chernihiv,1020078,27,0,1107,18
2020-08-14,Ukraine,NA,Chernihiv,1020078,47,0,1154,18
2020-08-15,Ukraine,NA,Chernihiv,1020078,20,1,1174,19
2020-08-16,Ukraine,NA,Chernihiv,1020078,32,0,1206,19
2020-08-17,Ukraine,NA,Chernihiv,1020078,27,0,1233,19
2020-08-18,Ukraine,NA,Chernihiv,1020078,17,2,1250,21
2020-08-19,Ukraine,NA,Chernihiv,1020078,28,0,1278,21
2020-08-20,Ukraine,NA,Chernihiv,1020078,36,1,1314,22
2020-08-21,Ukraine,NA,Chernihiv,1020078,52,0,1366,22
2020-08-22,Ukraine,NA,Chernihiv,1020078,57,0,1423,22
2020-08-23,Ukraine,NA,Chernihiv,1020078,45,0,1468,22
2020-08-24,Ukraine,NA,Chernihiv,1020078,52,0,1520,22
2020-08-25,Ukraine,NA,Chernihiv,1020078,32,0,1552,22
2020-08-26,Ukraine,NA,Chernihiv,1020078,18,0,1570,22
2020-08-27,Ukraine,NA,Chernihiv,1020078,48,0,1618,22
2020-08-28,Ukraine,NA,Chernihiv,1020078,58,0,1676,22
2020-08-29,Ukraine,NA,Chernihiv,1020078,69,0,1745,22
2020-08-30,Ukraine,NA,Chernihiv,1020078,32,0,1777,22
2020-08-31,Ukraine,NA,Chernihiv,1020078,117,0,1894,22
2020-09-01,Ukraine,NA,Chernihiv,1020078,47,0,1941,22
2020-09-02,Ukraine,NA,Chernihiv,1020078,49,0,1990,22
2020-09-03,Ukraine,NA,Chernihiv,1020078,60,0,2050,22
2020-09-04,Ukraine,NA,Chernihiv,1020078,100,0,2150,22
2020-09-05,Ukraine,NA,Chernihiv,1020078,80,5,2230,27
2020-09-06,Ukraine,NA,Chernihiv,1020078,56,0,2286,27
2020-09-07,Ukraine,NA,Chernihiv,1020078,86,0,2372,27
2020-09-08,Ukraine,NA,Chernihiv,1020078,78,3,2450,30
2020-09-09,Ukraine,NA,Chernihiv,1020078,65,3,2515,33
2020-09-10,Ukraine,NA,Chernihiv,1020078,30,2,2545,35
2020-09-11,Ukraine,NA,Chernihiv,1020078,29,0,2574,35
2020-09-12,Ukraine,NA,Chernihiv,1020078,80,0,2654,35
2020-09-13,Ukraine,NA,Chernihiv,1020078,60,0,2714,35
2020-09-14,Ukraine,NA,Chernihiv,1020078,74,0,2788,35
2020-09-15,Ukraine,NA,Chernihiv,1020078,58,0,2846,35
2020-09-16,Ukraine,NA,Chernihiv,1020078,76,5,2922,40
2020-09-17,Ukraine,NA,Chernihiv,1020078,112,4,3034,44
2020-09-18,Ukraine,NA,Chernihiv,1020078,99,2,3133,46
2020-09-19,Ukraine,NA,Chernihiv,1020078,55,0,3188,46
2020-09-20,Ukraine,NA,Chernihiv,1020078,75,0,3263,46
2020-09-21,Ukraine,NA,Chernihiv,1020078,78,0,3341,46
2020-09-22,Ukraine,NA,Chernihiv,1020078,70,0,3411,46
2020-09-23,Ukraine,NA,Chernihiv,1020078,126,0,3537,46
2020-03-19,Ukraine,NA,Chernivtsi,906600,5,0,15,1
2020-03-20,Ukraine,NA,Chernivtsi,906600,10,0,25,1
2020-03-21,Ukraine,NA,Chernivtsi,906600,0,0,25,1
2020-03-22,Ukraine,NA,Chernivtsi,906600,0,0,25,1
2020-03-23,Ukraine,NA,Chernivtsi,906600,0,0,25,1
2020-03-24,Ukraine,NA,Chernivtsi,906600,13,0,38,1
2020-03-25,Ukraine,NA,Chernivtsi,906600,0,0,38,1
2020-03-26,Ukraine,NA,Chernivtsi,906600,4,0,42,1
2020-03-27,Ukraine,NA,Chernivtsi,906600,5,0,47,1
2020-03-28,Ukraine,NA,Chernivtsi,906600,0,0,47,1
2020-03-29,Ukraine,NA,Chernivtsi,906600,12,0,59,1
2020-03-30,Ukraine,NA,Chernivtsi,906600,16,0,75,1
2020-03-31,Ukraine,NA,Chernivtsi,906600,29,3,104,4
2020-04-01,Ukraine,NA,Chernivtsi,906600,39,1,143,5
2020-04-02,Ukraine,NA,Chernivtsi,906600,25,0,168,5
2020-04-03,Ukraine,NA,Chernivtsi,906600,35,0,203,5
2020-04-04,Ukraine,NA,Chernivtsi,906600,17,0,220,5
2020-04-05,Ukraine,NA,Chernivtsi,906600,0,0,220,5
2020-04-06,Ukraine,NA,Chernivtsi,906600,0,0,220,5
2020-04-07,Ukraine,NA,Chernivtsi,906600,27,1,247,6
2020-04-08,Ukraine,NA,Chernivtsi,906600,26,0,273,6
2020-04-09,Ukraine,NA,Chernivtsi,906600,29,0,302,6
2020-04-10,Ukraine,NA,Chernivtsi,906600,64,1,366,7
2020-04-11,Ukraine,NA,Chernivtsi,906600,43,1,409,8
2020-04-12,Ukraine,NA,Chernivtsi,906600,23,0,432,8
2020-04-13,Ukraine,NA,Chernivtsi,906600,30,0,462,8
2020-04-14,Ukraine,NA,Chernivtsi,906600,84,0,546,8
2020-04-15,Ukraine,NA,Chernivtsi,906600,43,0,589,8
2020-04-16,Ukraine,NA,Chernivtsi,906600,73,0,662,8
2020-04-17,Ukraine,NA,Chernivtsi,906600,97,3,759,11
2020-04-18,Ukraine,NA,Chernivtsi,906600,81,1,840,12
2020-04-19,Ukraine,NA,Chernivtsi,906600,49,1,889,13
2020-04-20,Ukraine,NA,Chernivtsi,906600,17,0,906,13
2020-04-21,Ukraine,NA,Chernivtsi,906600,82,3,988,16
2020-04-22,Ukraine,NA,Chernivtsi,906600,65,4,1053,20
2020-04-23,Ukraine,NA,Chernivtsi,906600,87,1,1140,21
2020-04-24,Ukraine,NA,Chernivtsi,906600,59,2,1199,23
2020-04-25,Ukraine,NA,Chernivtsi,906600,109,1,1308,24
2020-04-26,Ukraine,NA,Chernivtsi,906600,33,2,1341,26
2020-04-27,Ukraine,NA,Chernivtsi,906600,34,0,1375,26
2020-04-28,Ukraine,NA,Chernivtsi,906600,54,7,1429,33
2020-04-29,Ukraine,NA,Chernivtsi,906600,60,3,1489,36
2020-04-30,Ukraine,NA,Chernivtsi,906600,82,3,1571,39
2020-05-01,Ukraine,NA,Chernivtsi,906600,96,5,1667,44
2020-05-02,Ukraine,NA,Chernivtsi,906600,78,1,1745,45
2020-05-03,Ukraine,NA,Chernivtsi,906600,73,2,1818,47
2020-05-04,Ukraine,NA,Chernivtsi,906600,69,6,1887,53
2020-05-05,Ukraine,NA,Chernivtsi,906600,61,2,1948,55
2020-05-06,Ukraine,NA,Chernivtsi,906600,37,2,1985,57
2020-05-07,Ukraine,NA,Chernivtsi,906600,63,5,2048,62
2020-05-08,Ukraine,NA,Chernivtsi,906600,49,5,2097,67
2020-05-09,Ukraine,NA,Chernivtsi,906600,82,3,2179,70
2020-05-10,Ukraine,NA,Chernivtsi,906600,89,6,2268,76
2020-05-11,Ukraine,NA,Chernivtsi,906600,56,5,2324,81
2020-05-12,Ukraine,NA,Chernivtsi,906600,72,3,2396,84
2020-05-13,Ukraine,NA,Chernivtsi,906600,48,3,2444,87
2020-05-14,Ukraine,NA,Chernivtsi,906600,72,2,2516,89
2020-05-15,Ukraine,NA,Chernivtsi,906600,84,6,2600,95
2020-05-16,Ukraine,NA,Chernivtsi,906600,47,4,2647,99
2020-05-17,Ukraine,NA,Chernivtsi,906600,47,3,2694,102
2020-05-18,Ukraine,NA,Chernivtsi,906600,19,5,2713,107
2020-05-19,Ukraine,NA,Chernivtsi,906600,29,3,2742,110
2020-05-20,Ukraine,NA,Chernivtsi,906600,54,4,2796,114
2020-05-21,Ukraine,NA,Chernivtsi,906600,46,2,2842,116
2020-05-22,Ukraine,NA,Chernivtsi,906600,63,3,2905,119
2020-05-23,Ukraine,NA,Chernivtsi,906600,59,3,2964,122
2020-05-24,Ukraine,NA,Chernivtsi,906600,64,3,3028,125
2020-05-25,Ukraine,NA,Chernivtsi,906600,55,2,3083,127
2020-05-26,Ukraine,NA,Chernivtsi,906600,18,5,3101,132
2020-05-27,Ukraine,NA,Chernivtsi,906600,43,1,3144,133
2020-05-28,Ukraine,NA,Chernivtsi,906600,57,1,3201,134
2020-05-29,Ukraine,NA,Chernivtsi,906600,58,1,3259,135
2020-05-30,Ukraine,NA,Chernivtsi,906600,47,2,3306,137
2020-05-31,Ukraine,NA,Chernivtsi,906600,43,3,3349,140
2020-06-01,Ukraine,NA,Chernivtsi,906600,28,4,3377,144
2020-06-02,Ukraine,NA,Chernivtsi,906600,33,0,3410,144
2020-06-03,Ukraine,NA,Chernivtsi,906600,32,3,3442,147
2020-06-04,Ukraine,NA,Chernivtsi,906600,39,1,3481,148
2020-06-05,Ukraine,NA,Chernivtsi,906600,38,2,3519,150
2020-06-06,Ukraine,NA,Chernivtsi,906600,66,1,3585,151
2020-06-07,Ukraine,NA,Chernivtsi,906600,54,0,3639,151
2020-06-08,Ukraine,NA,Chernivtsi,906600,59,1,3698,152
2020-06-09,Ukraine,NA,Chernivtsi,906600,31,0,3729,152
2020-06-10,Ukraine,NA,Chernivtsi,906600,28,5,3757,157
2020-06-11,Ukraine,NA,Chernivtsi,906600,36,2,3793,159
2020-06-12,Ukraine,NA,Chernivtsi,906600,38,4,3831,163
2020-06-13,Ukraine,NA,Chernivtsi,906600,38,1,3869,164
2020-06-14,Ukraine,NA,Chernivtsi,906600,47,0,3916,164
2020-06-15,Ukraine,NA,Chernivtsi,906600,43,1,3959,165
2020-06-16,Ukraine,NA,Chernivtsi,906600,54,0,4013,165
2020-06-17,Ukraine,NA,Chernivtsi,906600,69,1,4082,166
2020-06-18,Ukraine,NA,Chernivtsi,906600,53,4,4135,170
2020-06-19,Ukraine,NA,Chernivtsi,906600,76,1,4211,171
2020-06-20,Ukraine,NA,Chernivtsi,906600,57,0,4268,171
2020-06-21,Ukraine,NA,Chernivtsi,906600,56,0,4324,171
2020-06-22,Ukraine,NA,Chernivtsi,906600,33,0,4357,171
2020-06-23,Ukraine,NA,Chernivtsi,906600,62,5,4419,176
2020-06-24,Ukraine,NA,Chernivtsi,906600,59,0,4478,176
2020-06-25,Ukraine,NA,Chernivtsi,906600,53,1,4531,177
2020-06-26,Ukraine,NA,Chernivtsi,906600,51,1,4582,178
2020-06-27,Ukraine,NA,Chernivtsi,906600,49,2,4631,180
2020-06-28,Ukraine,NA,Chernivtsi,906600,55,0,4686,180
2020-06-29,Ukraine,NA,Chernivtsi,906600,59,2,4745,182
2020-06-30,Ukraine,NA,Chernivtsi,906600,56,1,4801,183
2020-07-01,Ukraine,NA,Chernivtsi,906600,49,0,4850,183
2020-07-02,Ukraine,NA,Chernivtsi,906600,44,0,4894,183
2020-07-03,Ukraine,NA,Chernivtsi,906600,41,0,4935,183
2020-07-04,Ukraine,NA,Chernivtsi,906600,37,2,4972,185
2020-07-05,Ukraine,NA,Chernivtsi,906600,30,2,5002,187
2020-07-06,Ukraine,NA,Chernivtsi,906600,16,1,5018,188
2020-07-07,Ukraine,NA,Chernivtsi,906600,14,2,5032,190
2020-07-08,Ukraine,NA,Chernivtsi,906600,19,2,5051,192
2020-07-09,Ukraine,NA,Chernivtsi,906600,23,1,5074,193
2020-07-10,Ukraine,NA,Chernivtsi,906600,22,1,5096,194
2020-07-11,Ukraine,NA,Chernivtsi,906600,21,3,5117,197
2020-07-12,Ukraine,NA,Chernivtsi,906600,23,3,5140,200
2020-07-13,Ukraine,NA,Chernivtsi,906600,21,1,5161,201
2020-07-14,Ukraine,NA,Chernivtsi,906600,23,0,5184,201
2020-07-15,Ukraine,NA,Chernivtsi,906600,24,0,5208,201
2020-07-16,Ukraine,NA,Chernivtsi,906600,24,2,5232,203
2020-07-17,Ukraine,NA,Chernivtsi,906600,30,1,5262,204
2020-07-18,Ukraine,NA,Chernivtsi,906600,27,0,5289,204
2020-07-19,Ukraine,NA,Chernivtsi,906600,22,1,5311,205
2020-07-20,Ukraine,NA,Chernivtsi,906600,21,0,5332,205
2020-07-21,Ukraine,NA,Chernivtsi,906600,31,0,5363,205
2020-07-22,Ukraine,NA,Chernivtsi,906600,41,3,5404,208
2020-07-23,Ukraine,NA,Chernivtsi,906600,39,1,5443,209
2020-07-24,Ukraine,NA,Chernivtsi,906600,42,1,5485,210
2020-07-25,Ukraine,NA,Chernivtsi,906600,63,1,5548,211
2020-07-26,Ukraine,NA,Chernivtsi,906600,44,2,5592,213
2020-07-27,Ukraine,NA,Chernivtsi,906600,42,1,5634,214
2020-07-28,Ukraine,NA,Chernivtsi,906600,58,1,5692,215
2020-07-29,Ukraine,NA,Chernivtsi,906600,59,1,5751,216
2020-07-30,Ukraine,NA,Chernivtsi,906600,61,0,5812,216
2020-07-31,Ukraine,NA,Chernivtsi,906600,63,0,5875,216
2020-08-01,Ukraine,NA,Chernivtsi,906600,89,0,5964,216
2020-08-02,Ukraine,NA,Chernivtsi,906600,97,0,6061,216
2020-08-03,Ukraine,NA,Chernivtsi,906600,82,2,6143,218
2020-08-04,Ukraine,NA,Chernivtsi,906600,86,1,6229,219
2020-08-05,Ukraine,NA,Chernivtsi,906600,69,1,6298,220
2020-08-06,Ukraine,NA,Chernivtsi,906600,85,0,6383,220
2020-08-07,Ukraine,NA,Chernivtsi,906600,94,2,6477,222
2020-08-08,Ukraine,NA,Chernivtsi,906600,88,2,6565,224
2020-08-09,Ukraine,NA,Chernivtsi,906600,104,1,6669,225
2020-08-10,Ukraine,NA,Chernivtsi,906600,108,3,6777,228
2020-08-11,Ukraine,NA,Chernivtsi,906600,90,2,6867,230
2020-08-12,Ukraine,NA,Chernivtsi,906600,113,2,6980,232
2020-08-13,Ukraine,NA,Chernivtsi,906600,130,0,7110,232
2020-08-14,Ukraine,NA,Chernivtsi,906600,154,1,7264,233
2020-08-15,Ukraine,NA,Chernivtsi,906600,170,2,7434,235
2020-08-16,Ukraine,NA,Chernivtsi,906600,183,2,7617,237
2020-08-17,Ukraine,NA,Chernivtsi,906600,165,0,7782,237
2020-08-18,Ukraine,NA,Chernivtsi,906600,172,3,7954,240
2020-08-19,Ukraine,NA,Chernivtsi,906600,154,4,8108,244
2020-08-20,Ukraine,NA,Chernivtsi,906600,189,4,8297,248
2020-08-21,Ukraine,NA,Chernivtsi,906600,208,1,8505,249
2020-08-22,Ukraine,NA,Chernivtsi,906600,208,5,8713,254
2020-08-23,Ukraine,NA,Chernivtsi,906600,213,2,8926,256
2020-08-24,Ukraine,NA,Chernivtsi,906600,241,3,9167,259
2020-08-25,Ukraine,NA,Chernivtsi,906600,204,2,9371,261
2020-08-26,Ukraine,NA,Chernivtsi,906600,170,4,9541,265
2020-08-27,Ukraine,NA,Chernivtsi,906600,159,5,9700,270
2020-08-28,Ukraine,NA,Chernivtsi,906600,155,3,9855,273
2020-08-29,Ukraine,NA,Chernivtsi,906600,142,1,9997,274
2020-08-30,Ukraine,NA,Chernivtsi,906600,148,3,10145,277
2020-08-31,Ukraine,NA,Chernivtsi,906600,158,2,10303,279
2020-09-01,Ukraine,NA,Chernivtsi,906600,117,5,10420,284
2020-09-02,Ukraine,NA,Chernivtsi,906600,67,3,10487,287
2020-09-03,Ukraine,NA,Chernivtsi,906600,137,2,10624,289
2020-09-04,Ukraine,NA,Chernivtsi,906600,162,3,10786,292
2020-09-05,Ukraine,NA,Chernivtsi,906600,172,3,10958,295
2020-09-06,Ukraine,NA,Chernivtsi,906600,151,2,11109,297
2020-09-07,Ukraine,NA,Chernivtsi,906600,163,5,11272,302
2020-09-08,Ukraine,NA,Chernivtsi,906600,159,1,11431,303
2020-09-09,Ukraine,NA,Chernivtsi,906600,150,1,11581,304
2020-09-10,Ukraine,NA,Chernivtsi,906600,134,2,11715,306
2020-09-11,Ukraine,NA,Chernivtsi,906600,132,4,11847,310
2020-09-12,Ukraine,NA,Chernivtsi,906600,141,1,11988,311
2020-09-13,Ukraine,NA,Chernivtsi,906600,129,0,12117,311
2020-09-14,Ukraine,NA,Chernivtsi,906600,135,1,12252,312
2020-09-15,Ukraine,NA,Chernivtsi,906600,142,5,12394,317
2020-09-16,Ukraine,NA,Chernivtsi,906600,99,4,12493,321
2020-09-17,Ukraine,NA,Chernivtsi,906600,147,4,12640,325
2020-09-18,Ukraine,NA,Chernivtsi,906600,153,3,12793,328
2020-09-19,Ukraine,NA,Chernivtsi,906600,124,1,12917,329
2020-09-20,Ukraine,NA,Chernivtsi,906600,125,2,13042,331
2020-09-21,Ukraine,NA,Chernivtsi,906600,123,1,13165,332
2020-09-22,Ukraine,NA,Chernivtsi,906600,139,6,13304,338
2020-09-23,Ukraine,NA,Chernivtsi,906600,144,3,13448,341
2020-04-02,Ukraine,NA,Dnipropetrovsk,3231140,2,0,12,0
2020-04-03,Ukraine,NA,Dnipropetrovsk,3231140,2,0,14,0
2020-04-04,Ukraine,NA,Dnipropetrovsk,3231140,0,0,14,0
2020-04-05,Ukraine,NA,Dnipropetrovsk,3231140,0,0,14,0
2020-04-06,Ukraine,NA,Dnipropetrovsk,3231140,0,0,14,0
2020-04-07,Ukraine,NA,Dnipropetrovsk,3231140,1,0,15,0
2020-04-08,Ukraine,NA,Dnipropetrovsk,3231140,26,0,41,0
2020-04-09,Ukraine,NA,Dnipropetrovsk,3231140,0,0,41,0
2020-04-10,Ukraine,NA,Dnipropetrovsk,3231140,11,0,52,0
2020-04-11,Ukraine,NA,Dnipropetrovsk,3231140,3,0,55,0
2020-04-12,Ukraine,NA,Dnipropetrovsk,3231140,3,0,58,0
2020-04-13,Ukraine,NA,Dnipropetrovsk,3231140,2,0,60,0
2020-04-14,Ukraine,NA,Dnipropetrovsk,3231140,11,0,71,0
2020-04-15,Ukraine,NA,Dnipropetrovsk,3231140,3,0,74,0
2020-04-16,Ukraine,NA,Dnipropetrovsk,3231140,4,1,78,1
2020-04-17,Ukraine,NA,Dnipropetrovsk,3231140,11,0,89,1
2020-04-18,Ukraine,NA,Dnipropetrovsk,3231140,15,0,104,1
2020-04-19,Ukraine,NA,Dnipropetrovsk,3231140,6,0,110,1
2020-04-20,Ukraine,NA,Dnipropetrovsk,3231140,8,0,118,1
2020-04-21,Ukraine,NA,Dnipropetrovsk,3231140,4,0,122,1
2020-04-22,Ukraine,NA,Dnipropetrovsk,3231140,28,0,150,1
2020-04-23,Ukraine,NA,Dnipropetrovsk,3231140,36,0,186,1
2020-04-24,Ukraine,NA,Dnipropetrovsk,3231140,9,0,195,1
2020-04-25,Ukraine,NA,Dnipropetrovsk,3231140,45,0,240,1
2020-04-26,Ukraine,NA,Dnipropetrovsk,3231140,52,0,292,1
2020-04-27,Ukraine,NA,Dnipropetrovsk,3231140,18,0,310,1
2020-04-28,Ukraine,NA,Dnipropetrovsk,3231140,8,1,318,2
2020-04-29,Ukraine,NA,Dnipropetrovsk,3231140,5,1,323,3
2020-04-30,Ukraine,NA,Dnipropetrovsk,3231140,24,0,347,3
2020-05-01,Ukraine,NA,Dnipropetrovsk,3231140,17,0,364,3
2020-05-02,Ukraine,NA,Dnipropetrovsk,3231140,72,0,436,3
2020-05-03,Ukraine,NA,Dnipropetrovsk,3231140,12,1,448,4
2020-05-04,Ukraine,NA,Dnipropetrovsk,3231140,12,0,460,4
2020-05-05,Ukraine,NA,Dnipropetrovsk,3231140,18,0,478,4
2020-05-06,Ukraine,NA,Dnipropetrovsk,3231140,90,0,568,4
2020-05-07,Ukraine,NA,Dnipropetrovsk,3231140,56,0,624,4
2020-05-08,Ukraine,NA,Dnipropetrovsk,3231140,28,1,652,5
2020-05-09,Ukraine,NA,Dnipropetrovsk,3231140,29,0,681,5
2020-05-10,Ukraine,NA,Dnipropetrovsk,3231140,23,1,704,6
2020-05-11,Ukraine,NA,Dnipropetrovsk,3231140,27,0,731,6
2020-05-12,Ukraine,NA,Dnipropetrovsk,3231140,17,1,748,7
2020-05-13,Ukraine,NA,Dnipropetrovsk,3231140,25,2,773,9
2020-05-14,Ukraine,NA,Dnipropetrovsk,3231140,8,1,781,10
2020-05-15,Ukraine,NA,Dnipropetrovsk,3231140,10,0,791,10
2020-05-16,Ukraine,NA,Dnipropetrovsk,3231140,15,1,806,11
2020-05-17,Ukraine,NA,Dnipropetrovsk,3231140,31,1,837,12
2020-05-18,Ukraine,NA,Dnipropetrovsk,3231140,6,1,843,13
2020-05-19,Ukraine,NA,Dnipropetrovsk,3231140,0,0,843,13
2020-05-20,Ukraine,NA,Dnipropetrovsk,3231140,6,0,849,13
2020-05-21,Ukraine,NA,Dnipropetrovsk,3231140,7,0,856,13
2020-05-22,Ukraine,NA,Dnipropetrovsk,3231140,3,0,859,13
2020-05-23,Ukraine,NA,Dnipropetrovsk,3231140,6,3,865,16
2020-05-24,Ukraine,NA,Dnipropetrovsk,3231140,4,1,869,17
2020-05-25,Ukraine,NA,Dnipropetrovsk,3231140,6,0,875,17
2020-05-26,Ukraine,NA,Dnipropetrovsk,3231140,20,1,895,18
2020-05-27,Ukraine,NA,Dnipropetrovsk,3231140,10,1,905,19
2020-05-28,Ukraine,NA,Dnipropetrovsk,3231140,15,0,920,19
2020-05-29,Ukraine,NA,Dnipropetrovsk,3231140,10,1,930,20
2020-05-30,Ukraine,NA,Dnipropetrovsk,3231140,3,0,933,20
2020-05-31,Ukraine,NA,Dnipropetrovsk,3231140,9,1,942,21
2020-06-01,Ukraine,NA,Dnipropetrovsk,3231140,0,0,942,21
2020-06-02,Ukraine,NA,Dnipropetrovsk,3231140,1,0,943,21
2020-06-03,Ukraine,NA,Dnipropetrovsk,3231140,7,0,950,21
2020-06-04,Ukraine,NA,Dnipropetrovsk,3231140,7,0,957,21
2020-06-05,Ukraine,NA,Dnipropetrovsk,3231140,3,0,960,21
2020-06-06,Ukraine,NA,Dnipropetrovsk,3231140,5,0,965,21
2020-06-07,Ukraine,NA,Dnipropetrovsk,3231140,6,1,971,22
2020-06-08,Ukraine,NA,Dnipropetrovsk,3231140,0,0,971,22
2020-06-09,Ukraine,NA,Dnipropetrovsk,3231140,0,0,971,22
2020-06-10,Ukraine,NA,Dnipropetrovsk,3231140,2,0,973,22
2020-06-11,Ukraine,NA,Dnipropetrovsk,3231140,8,0,981,22
2020-06-12,Ukraine,NA,Dnipropetrovsk,3231140,2,0,983,22
2020-06-13,Ukraine,NA,Dnipropetrovsk,3231140,7,0,990,22
2020-06-14,Ukraine,NA,Dnipropetrovsk,3231140,8,0,998,22
2020-06-15,Ukraine,NA,Dnipropetrovsk,3231140,0,0,998,22
2020-06-16,Ukraine,NA,Dnipropetrovsk,3231140,6,0,1004,22
2020-06-17,Ukraine,NA,Dnipropetrovsk,3231140,8,1,1012,23
2020-06-18,Ukraine,NA,Dnipropetrovsk,3231140,9,0,1021,23
2020-06-19,Ukraine,NA,Dnipropetrovsk,3231140,0,0,1021,23
2020-06-20,Ukraine,NA,Dnipropetrovsk,3231140,15,0,1036,23
2020-06-21,Ukraine,NA,Dnipropetrovsk,3231140,6,0,1042,23
2020-06-22,Ukraine,NA,Dnipropetrovsk,3231140,0,0,1042,23
2020-06-23,Ukraine,NA,Dnipropetrovsk,3231140,7,0,1049,23
2020-06-24,Ukraine,NA,Dnipropetrovsk,3231140,11,0,1060,23
2020-06-25,Ukraine,NA,Dnipropetrovsk,3231140,9,0,1069,23
2020-06-26,Ukraine,NA,Dnipropetrovsk,3231140,12,0,1081,23
2020-06-27,Ukraine,NA,Dnipropetrovsk,3231140,6,0,1087,23
2020-06-28,Ukraine,NA,Dnipropetrovsk,3231140,0,0,1087,23
2020-06-29,Ukraine,NA,Dnipropetrovsk,3231140,0,0,1087,23
2020-06-30,Ukraine,NA,Dnipropetrovsk,3231140,0,0,1087,23
2020-07-01,Ukraine,NA,Dnipropetrovsk,3231140,3,0,1090,23
2020-07-02,Ukraine,NA,Dnipropetrovsk,3231140,5,0,1095,23
2020-07-03,Ukraine,NA,Dnipropetrovsk,3231140,8,0,1103,23
2020-07-04,Ukraine,NA,Dnipropetrovsk,3231140,7,0,1110,23
2020-07-05,Ukraine,NA,Dnipropetrovsk,3231140,5,0,1115,23
2020-07-06,Ukraine,NA,Dnipropetrovsk,3231140,0,0,1115,23
2020-07-07,Ukraine,NA,Dnipropetrovsk,3231140,1,0,1116,23
2020-07-08,Ukraine,NA,Dnipropetrovsk,3231140,4,0,1120,23
2020-07-09,Ukraine,NA,Dnipropetrovsk,3231140,10,0,1130,23
2020-07-10,Ukraine,NA,Dnipropetrovsk,3231140,7,0,1137,23
2020-07-11,Ukraine,NA,Dnipropetrovsk,3231140,3,0,1140,23
2020-07-12,Ukraine,NA,Dnipropetrovsk,3231140,4,0,1144,23
2020-07-13,Ukraine,NA,Dnipropetrovsk,3231140,0,0,1144,23
2020-07-14,Ukraine,NA,Dnipropetrovsk,3231140,2,0,1146,23
2020-07-15,Ukraine,NA,Dnipropetrovsk,3231140,9,1,1155,24
2020-07-16,Ukraine,NA,Dnipropetrovsk,3231140,8,0,1163,24
2020-07-17,Ukraine,NA,Dnipropetrovsk,3231140,11,0,1174,24
2020-07-18,Ukraine,NA,Dnipropetrovsk,3231140,9,1,1183,25
2020-07-19,Ukraine,NA,Dnipropetrovsk,3231140,24,0,1207,25
2020-07-20,Ukraine,NA,Dnipropetrovsk,3231140,2,0,1209,25
2020-07-21,Ukraine,NA,Dnipropetrovsk,3231140,15,0,1224,25
2020-07-22,Ukraine,NA,Dnipropetrovsk,3231140,36,0,1260,25
2020-07-23,Ukraine,NA,Dnipropetrovsk,3231140,15,1,1275,26
2020-07-24,Ukraine,NA,Dnipropetrovsk,3231140,27,1,1302,27
2020-07-25,Ukraine,NA,Dnipropetrovsk,3231140,15,0,1317,27
2020-07-26,Ukraine,NA,Dnipropetrovsk,3231140,12,0,1329,27
2020-07-27,Ukraine,NA,Dnipropetrovsk,3231140,1,0,1330,27
2020-07-28,Ukraine,NA,Dnipropetrovsk,3231140,4,0,1334,27
2020-07-29,Ukraine,NA,Dnipropetrovsk,3231140,30,0,1364,27
2020-07-30,Ukraine,NA,Dnipropetrovsk,3231140,30,0,1394,27
2020-07-31,Ukraine,NA,Dnipropetrovsk,3231140,8,0,1402,27
2020-08-01,Ukraine,NA,Dnipropetrovsk,3231140,11,1,1413,28
2020-08-02,Ukraine,NA,Dnipropetrovsk,3231140,8,0,1421,28
2020-08-03,Ukraine,NA,Dnipropetrovsk,3231140,17,1,1438,29
2020-08-04,Ukraine,NA,Dnipropetrovsk,3231140,21,1,1459,30
2020-08-05,Ukraine,NA,Dnipropetrovsk,3231140,15,0,1474,30
2020-08-06,Ukraine,NA,Dnipropetrovsk,3231140,18,1,1492,31
2020-08-07,Ukraine,NA,Dnipropetrovsk,3231140,16,0,1508,31
2020-08-08,Ukraine,NA,Dnipropetrovsk,3231140,17,2,1525,33
2020-08-09,Ukraine,NA,Dnipropetrovsk,3231140,22,0,1547,33
2020-08-10,Ukraine,NA,Dnipropetrovsk,3231140,24,0,1571,33
2020-08-11,Ukraine,NA,Dnipropetrovsk,3231140,0,2,1571,35
2020-08-12,Ukraine,NA,Dnipropetrovsk,3231140,31,1,1602,36
2020-08-13,Ukraine,NA,Dnipropetrovsk,3231140,28,1,1630,37
2020-08-14,Ukraine,NA,Dnipropetrovsk,3231140,28,0,1658,37
2020-08-15,Ukraine,NA,Dnipropetrovsk,3231140,41,2,1699,39
2020-08-16,Ukraine,NA,Dnipropetrovsk,3231140,26,0,1725,39
2020-08-17,Ukraine,NA,Dnipropetrovsk,3231140,25,0,1750,39
2020-08-18,Ukraine,NA,Dnipropetrovsk,3231140,22,1,1772,40
2020-08-19,Ukraine,NA,Dnipropetrovsk,3231140,44,0,1816,40
2020-08-20,Ukraine,NA,Dnipropetrovsk,3231140,57,0,1873,40
2020-08-21,Ukraine,NA,Dnipropetrovsk,3231140,21,1,1894,41
2020-08-22,Ukraine,NA,Dnipropetrovsk,3231140,38,0,1932,41
2020-08-23,Ukraine,NA,Dnipropetrovsk,3231140,34,1,1966,42
2020-08-24,Ukraine,NA,Dnipropetrovsk,3231140,39,0,2005,42
2020-08-25,Ukraine,NA,Dnipropetrovsk,3231140,45,0,2050,42
2020-08-26,Ukraine,NA,Dnipropetrovsk,3231140,5,0,2055,42
2020-08-27,Ukraine,NA,Dnipropetrovsk,3231140,40,2,2095,44
2020-08-28,Ukraine,NA,Dnipropetrovsk,3231140,67,1,2162,45
2020-08-29,Ukraine,NA,Dnipropetrovsk,3231140,74,1,2236,46
2020-08-30,Ukraine,NA,Dnipropetrovsk,3231140,70,1,2306,47
2020-08-31,Ukraine,NA,Dnipropetrovsk,3231140,43,0,2349,47
2020-09-01,Ukraine,NA,Dnipropetrovsk,3231140,49,2,2398,49
2020-09-02,Ukraine,NA,Dnipropetrovsk,3231140,56,2,2454,51
2020-09-03,Ukraine,NA,Dnipropetrovsk,3231140,64,1,2518,52
2020-09-04,Ukraine,NA,Dnipropetrovsk,3231140,52,2,2570,54
2020-09-05,Ukraine,NA,Dnipropetrovsk,3231140,55,3,2625,57
2020-09-06,Ukraine,NA,Dnipropetrovsk,3231140,72,3,2697,60
2020-09-07,Ukraine,NA,Dnipropetrovsk,3231140,70,3,2767,63
2020-09-08,Ukraine,NA,Dnipropetrovsk,3231140,76,3,2843,66
2020-09-09,Ukraine,NA,Dnipropetrovsk,3231140,80,2,2923,68
2020-09-10,Ukraine,NA,Dnipropetrovsk,3231140,89,3,3012,71
2020-09-11,Ukraine,NA,Dnipropetrovsk,3231140,81,0,3093,71
2020-09-12,Ukraine,NA,Dnipropetrovsk,3231140,83,4,3176,75
2020-09-13,Ukraine,NA,Dnipropetrovsk,3231140,86,1,3262,76
2020-09-14,Ukraine,NA,Dnipropetrovsk,3231140,80,1,3342,77
2020-09-15,Ukraine,NA,Dnipropetrovsk,3231140,88,1,3430,78
2020-09-16,Ukraine,NA,Dnipropetrovsk,3231140,109,3,3539,81
2020-09-17,Ukraine,NA,Dnipropetrovsk,3231140,114,2,3653,83
2020-09-18,Ukraine,NA,Dnipropetrovsk,3231140,112,3,3765,86
2020-09-19,Ukraine,NA,Dnipropetrovsk,3231140,113,3,3878,89
2020-09-20,Ukraine,NA,Dnipropetrovsk,3231140,104,0,3982,89
2020-09-21,Ukraine,NA,Dnipropetrovsk,3231140,136,0,4118,89
2020-09-22,Ukraine,NA,Dnipropetrovsk,3231140,100,2,4218,91
2020-09-23,Ukraine,NA,Dnipropetrovsk,3231140,176,3,4394,94
2020-04-08,Ukraine,NA,Donetsk,4200461,1,0,11,1
2020-04-09,Ukraine,NA,Donetsk,4200461,0,0,11,1
2020-04-10,Ukraine,NA,Donetsk,4200461,0,0,11,1
2020-04-11,Ukraine,NA,Donetsk,4200461,0,0,11,1
2020-04-12,Ukraine,NA,Donetsk,4200461,0,0,11,1
2020-04-13,Ukraine,NA,Donetsk,4200461,0,0,11,1
2020-04-14,Ukraine,NA,Donetsk,4200461,1,0,12,1
2020-04-15,Ukraine,NA,Donetsk,4200461,0,0,12,1
2020-04-16,Ukraine,NA,Donetsk,4200461,0,0,12,1
2020-04-17,Ukraine,NA,Donetsk,4200461,0,0,12,1
2020-04-18,Ukraine,NA,Donetsk,4200461,2,0,14,1
2020-04-19,Ukraine,NA,Donetsk,4200461,2,0,16,1
2020-04-20,Ukraine,NA,Donetsk,4200461,0,0,16,1
2020-04-21,Ukraine,NA,Donetsk,4200461,0,0,16,1
2020-04-22,Ukraine,NA,Donetsk,4200461,0,0,16,1
2020-04-23,Ukraine,NA,Donetsk,4200461,5,0,21,1
2020-04-24,Ukraine,NA,Donetsk,4200461,3,0,24,1
2020-04-25,Ukraine,NA,Donetsk,4200461,3,0,27,1
2020-04-26,Ukraine,NA,Donetsk,4200461,2,0,29,1
2020-04-27,Ukraine,NA,Donetsk,4200461,23,0,52,1
2020-04-28,Ukraine,NA,Donetsk,4200461,0,0,52,1
2020-04-29,Ukraine,NA,Donetsk,4200461,0,0,52,1
2020-04-30,Ukraine,NA,Donetsk,4200461,16,0,68,1
2020-05-01,Ukraine,NA,Donetsk,4200461,2,0,70,1
2020-05-02,Ukraine,NA,Donetsk,4200461,0,0,70,1
2020-05-03,Ukraine,NA,Donetsk,4200461,0,0,70,1
2020-05-04,Ukraine,NA,Donetsk,4200461,11,0,81,1
2020-05-05,Ukraine,NA,Donetsk,4200461,2,2,83,3
2020-05-06,Ukraine,NA,Donetsk,4200461,2,0,85,3
2020-05-07,Ukraine,NA,Donetsk,4200461,4,0,89,3
2020-05-08,Ukraine,NA,Donetsk,4200461,2,0,91,3
2020-05-09,Ukraine,NA,Donetsk,4200461,8,0,99,3
2020-05-10,Ukraine,NA,Donetsk,4200461,1,0,100,3
2020-05-11,Ukraine,NA,Donetsk,4200461,0,0,100,3
2020-05-12,Ukraine,NA,Donetsk,4200461,0,0,100,3
2020-05-13,Ukraine,NA,Donetsk,4200461,2,0,102,3
2020-05-14,Ukraine,NA,Donetsk,4200461,15,0,117,3
2020-05-15,Ukraine,NA,Donetsk,4200461,4,0,121,3
2020-05-16,Ukraine,NA,Donetsk,4200461,0,0,121,3
2020-05-17,Ukraine,NA,Donetsk,4200461,9,1,130,4
2020-05-18,Ukraine,NA,Donetsk,4200461,1,0,131,4
2020-05-19,Ukraine,NA,Donetsk,4200461,0,0,131,4
2020-05-20,Ukraine,NA,Donetsk,4200461,2,0,133,4
2020-05-21,Ukraine,NA,Donetsk,4200461,5,0,138,4
2020-05-22,Ukraine,NA,Donetsk,4200461,3,0,141,4
2020-05-23,Ukraine,NA,Donetsk,4200461,2,0,143,4
2020-05-24,Ukraine,NA,Donetsk,4200461,0,0,143,4
2020-05-25,Ukraine,NA,Donetsk,4200461,5,0,148,4
2020-05-26,Ukraine,NA,Donetsk,4200461,7,0,155,4
2020-05-27,Ukraine,NA,Donetsk,4200461,0,0,155,4
2020-05-28,Ukraine,NA,Donetsk,4200461,3,0,158,4
2020-05-29,Ukraine,NA,Donetsk,4200461,0,0,158,4
2020-05-30,Ukraine,NA,Donetsk,4200461,0,0,158,4
2020-05-31,Ukraine,NA,Donetsk,4200461,5,0,163,4
2020-06-01,Ukraine,NA,Donetsk,4200461,0,0,163,4
2020-06-02,Ukraine,NA,Donetsk,4200461,1,0,164,4
2020-06-03,Ukraine,NA,Donetsk,4200461,2,1,166,5
2020-06-04,Ukraine,NA,Donetsk,4200461,8,0,174,5
2020-06-05,Ukraine,NA,Donetsk,4200461,21,0,195,5
2020-06-06,Ukraine,NA,Donetsk,4200461,8,0,203,5
2020-06-07,Ukraine,NA,Donetsk,4200461,28,0,231,5
2020-06-08,Ukraine,NA,Donetsk,4200461,0,1,231,6
2020-06-09,Ukraine,NA,Donetsk,4200461,4,0,235,6
2020-06-10,Ukraine,NA,Donetsk,4200461,11,0,246,6
2020-06-11,Ukraine,NA,Donetsk,4200461,23,0,269,6
2020-06-12,Ukraine,NA,Donetsk,4200461,10,0,279,6
2020-06-13,Ukraine,NA,Donetsk,4200461,11,0,290,6
2020-06-14,Ukraine,NA,Donetsk,4200461,2,0,292,6
2020-06-15,Ukraine,NA,Donetsk,4200461,42,0,334,6
2020-06-16,Ukraine,NA,Donetsk,4200461,4,0,338,6
2020-06-17,Ukraine,NA,Donetsk,4200461,0,2,338,8
2020-06-18,Ukraine,NA,Donetsk,4200461,11,0,349,8
2020-06-19,Ukraine,NA,Donetsk,4200461,1,0,350,8
2020-06-20,Ukraine,NA,Donetsk,4200461,5,0,355,8
2020-06-21,Ukraine,NA,Donetsk,4200461,7,0,362,8
2020-06-22,Ukraine,NA,Donetsk,4200461,0,0,362,8
2020-06-23,Ukraine,NA,Donetsk,4200461,6,0,368,8
2020-06-24,Ukraine,NA,Donetsk,4200461,8,0,376,8
2020-06-25,Ukraine,NA,Donetsk,4200461,23,0,399,8
2020-06-26,Ukraine,NA,Donetsk,4200461,13,1,412,9
2020-06-27,Ukraine,NA,Donetsk,4200461,3,0,415,9
2020-06-28,Ukraine,NA,Donetsk,4200461,64,0,479,9
2020-06-29,Ukraine,NA,Donetsk,4200461,2,0,481,9
2020-06-30,Ukraine,NA,Donetsk,4200461,0,0,481,9
2020-07-01,Ukraine,NA,Donetsk,4200461,3,0,484,9
2020-07-02,Ukraine,NA,Donetsk,4200461,78,0,562,9
2020-07-03,Ukraine,NA,Donetsk,4200461,37,0,599,9
2020-07-04,Ukraine,NA,Donetsk,4200461,0,1,599,10
2020-07-05,Ukraine,NA,Donetsk,4200461,81,0,680,10
2020-07-06,Ukraine,NA,Donetsk,4200461,1,0,681,10
2020-07-07,Ukraine,NA,Donetsk,4200461,5,0,686,10
2020-07-08,Ukraine,NA,Donetsk,4200461,27,0,713,10
2020-07-09,Ukraine,NA,Donetsk,4200461,36,0,749,10
2020-07-10,Ukraine,NA,Donetsk,4200461,2,0,751,10
2020-07-11,Ukraine,NA,Donetsk,4200461,7,0,758,10
2020-07-12,Ukraine,NA,Donetsk,4200461,1,0,759,10
2020-07-13,Ukraine,NA,Donetsk,4200461,0,0,759,10
2020-07-14,Ukraine,NA,Donetsk,4200461,6,0,765,10
2020-07-15,Ukraine,NA,Donetsk,4200461,2,0,767,10
2020-07-16,Ukraine,NA,Donetsk,4200461,9,0,776,10
2020-07-17,Ukraine,NA,Donetsk,4200461,5,0,781,10
2020-07-18,Ukraine,NA,Donetsk,4200461,10,0,791,10
2020-07-19,Ukraine,NA,Donetsk,4200461,1,0,792,10
2020-07-20,Ukraine,NA,Donetsk,4200461,2,0,794,10
2020-07-21,Ukraine,NA,Donetsk,4200461,3,1,797,11
2020-07-22,Ukraine,NA,Donetsk,4200461,16,0,813,11
2020-07-23,Ukraine,NA,Donetsk,4200461,5,0,818,11
2020-07-24,Ukraine,NA,Donetsk,4200461,12,0,830,11
2020-07-25,Ukraine,NA,Donetsk,4200461,12,0,842,11
2020-07-26,Ukraine,NA,Donetsk,4200461,8,1,850,12
2020-07-27,Ukraine,NA,Donetsk,4200461,0,0,850,12
2020-07-28,Ukraine,NA,Donetsk,4200461,2,0,852,12
2020-07-29,Ukraine,NA,Donetsk,4200461,9,0,861,12
2020-07-30,Ukraine,NA,Donetsk,4200461,4,0,865,12
2020-07-31,Ukraine,NA,Donetsk,4200461,16,0,881,12
2020-08-01,Ukraine,NA,Donetsk,4200461,8,0,889,12
2020-08-02,Ukraine,NA,Donetsk,4200461,9,0,898,12
2020-08-03,Ukraine,NA,Donetsk,4200461,0,0,898,12
2020-08-04,Ukraine,NA,Donetsk,4200461,5,0,903,12
2020-08-05,Ukraine,NA,Donetsk,4200461,23,0,926,12
2020-08-06,Ukraine,NA,Donetsk,4200461,15,1,941,13
2020-08-07,Ukraine,NA,Donetsk,4200461,4,0,945,13
2020-08-08,Ukraine,NA,Donetsk,4200461,20,0,965,13
2020-08-09,Ukraine,NA,Donetsk,4200461,10,0,975,13
2020-08-10,Ukraine,NA,Donetsk,4200461,1,0,976,13
2020-08-11,Ukraine,NA,Donetsk,4200461,6,0,982,13
2020-08-12,Ukraine,NA,Donetsk,4200461,29,0,1011,13
2020-08-13,Ukraine,NA,Donetsk,4200461,16,0,1027,13
2020-08-14,Ukraine,NA,Donetsk,4200461,22,2,1049,15
2020-08-15,Ukraine,NA,Donetsk,4200461,24,0,1073,15
2020-08-16,Ukraine,NA,Donetsk,4200461,15,0,1088,15
2020-08-17,Ukraine,NA,Donetsk,4200461,6,0,1094,15
2020-08-18,Ukraine,NA,Donetsk,4200461,6,0,1100,15
2020-08-19,Ukraine,NA,Donetsk,4200461,22,0,1122,15
2020-08-20,Ukraine,NA,Donetsk,4200461,34,1,1156,16
2020-08-21,Ukraine,NA,Donetsk,4200461,27,1,1183,17
2020-08-22,Ukraine,NA,Donetsk,4200461,32,2,1215,19
2020-08-23,Ukraine,NA,Donetsk,4200461,19,0,1234,19
2020-08-24,Ukraine,NA,Donetsk,4200461,3,0,1237,19
2020-08-25,Ukraine,NA,Donetsk,4200461,1,1,1238,20
2020-08-26,Ukraine,NA,Donetsk,4200461,18,0,1256,20
2020-08-27,Ukraine,NA,Donetsk,4200461,22,0,1278,20
2020-08-28,Ukraine,NA,Donetsk,4200461,40,0,1318,20
2020-08-29,Ukraine,NA,Donetsk,4200461,51,0,1369,20
2020-08-30,Ukraine,NA,Donetsk,4200461,47,1,1416,21
2020-08-31,Ukraine,NA,Donetsk,4200461,2,0,1418,21
2020-09-01,Ukraine,NA,Donetsk,4200461,30,0,1448,21
2020-09-02,Ukraine,NA,Donetsk,4200461,57,0,1505,21
2020-09-03,Ukraine,NA,Donetsk,4200461,44,2,1549,23
2020-09-04,Ukraine,NA,Donetsk,4200461,27,1,1576,24
2020-09-05,Ukraine,NA,Donetsk,4200461,15,0,1591,24
2020-09-06,Ukraine,NA,Donetsk,4200461,36,0,1627,24
2020-09-07,Ukraine,NA,Donetsk,4200461,3,0,1630,24
2020-09-08,Ukraine,NA,Donetsk,4200461,45,2,1675,26
2020-09-09,Ukraine,NA,Donetsk,4200461,87,1,1762,27
2020-09-10,Ukraine,NA,Donetsk,4200461,90,0,1852,27
2020-09-11,Ukraine,NA,Donetsk,4200461,90,0,1942,27
2020-09-12,Ukraine,NA,Donetsk,4200461,84,4,2026,31
2020-09-13,Ukraine,NA,Donetsk,4200461,69,1,2095,32
2020-09-14,Ukraine,NA,Donetsk,4200461,6,0,2101,32
2020-09-15,Ukraine,NA,Donetsk,4200461,53,0,2154,32
2020-09-16,Ukraine,NA,Donetsk,4200461,26,1,2180,33
2020-09-17,Ukraine,NA,Donetsk,4200461,92,2,2272,35
2020-09-18,Ukraine,NA,Donetsk,4200461,41,0,2313,35
2020-09-19,Ukraine,NA,Donetsk,4200461,58,0,2371,35
2020-09-20,Ukraine,NA,Donetsk,4200461,59,8,2430,43
2020-09-21,Ukraine,NA,Donetsk,4200461,50,0,2480,43
2020-09-22,Ukraine,NA,Donetsk,4200461,25,9,2505,52
2020-09-23,Ukraine,NA,Donetsk,4200461,129,2,2634,54
2020-03-25,Ukraine,NA,Ivano-Frankivsk,1377496,11,1,16,2
2020-03-26,Ukraine,NA,Ivano-Frankivsk,1377496,0,0,16,2
2020-03-27,Ukraine,NA,Ivano-Frankivsk,1377496,8,0,24,2
2020-03-28,Ukraine,NA,Ivano-Frankivsk,1377496,4,1,28,3
2020-03-29,Ukraine,NA,Ivano-Frankivsk,1377496,13,0,41,3
2020-03-30,Ukraine,NA,Ivano-Frankivsk,1377496,0,0,41,3
2020-03-31,Ukraine,NA,Ivano-Frankivsk,1377496,23,0,64,3
2020-04-01,Ukraine,NA,Ivano-Frankivsk,1377496,10,2,74,5
2020-04-02,Ukraine,NA,Ivano-Frankivsk,1377496,1,0,75,5
2020-04-03,Ukraine,NA,Ivano-Frankivsk,1377496,19,1,94,6
2020-04-04,Ukraine,NA,Ivano-Frankivsk,1377496,11,0,105,6
2020-04-05,Ukraine,NA,Ivano-Frankivsk,1377496,0,1,105,7
2020-04-06,Ukraine,NA,Ivano-Frankivsk,1377496,11,0,116,7
2020-04-07,Ukraine,NA,Ivano-Frankivsk,1377496,44,2,160,9
2020-04-08,Ukraine,NA,Ivano-Frankivsk,1377496,38,4,198,13
2020-04-09,Ukraine,NA,Ivano-Frankivsk,1377496,20,2,218,15
2020-04-10,Ukraine,NA,Ivano-Frankivsk,1377496,36,2,254,17
2020-04-11,Ukraine,NA,Ivano-Frankivsk,1377496,20,0,274,17
2020-04-12,Ukraine,NA,Ivano-Frankivsk,1377496,17,4,291,21
2020-04-13,Ukraine,NA,Ivano-Frankivsk,1377496,9,3,300,24
2020-04-14,Ukraine,NA,Ivano-Frankivsk,1377496,32,2,332,26
2020-04-15,Ukraine,NA,Ivano-Frankivsk,1377496,24,1,356,27
2020-04-16,Ukraine,NA,Ivano-Frankivsk,1377496,45,4,401,31
2020-04-17,Ukraine,NA,Ivano-Frankivsk,1377496,26,3,427,34
2020-04-18,Ukraine,NA,Ivano-Frankivsk,1377496,35,2,462,36
2020-04-19,Ukraine,NA,Ivano-Frankivsk,1377496,18,1,480,37
2020-04-20,Ukraine,NA,Ivano-Frankivsk,1377496,32,0,512,37
2020-04-21,Ukraine,NA,Ivano-Frankivsk,1377496,44,0,556,37
2020-04-22,Ukraine,NA,Ivano-Frankivsk,1377496,33,3,589,40
2020-04-23,Ukraine,NA,Ivano-Frankivsk,1377496,55,3,644,43
2020-04-24,Ukraine,NA,Ivano-Frankivsk,1377496,40,2,684,45
2020-04-25,Ukraine,NA,Ivano-Frankivsk,1377496,16,1,700,46
2020-04-26,Ukraine,NA,Ivano-Frankivsk,1377496,31,1,731,47
2020-04-27,Ukraine,NA,Ivano-Frankivsk,1377496,30,0,761,47
2020-04-28,Ukraine,NA,Ivano-Frankivsk,1377496,22,2,783,49
2020-04-29,Ukraine,NA,Ivano-Frankivsk,1377496,38,1,821,50
2020-04-30,Ukraine,NA,Ivano-Frankivsk,1377496,41,0,862,50
2020-05-01,Ukraine,NA,Ivano-Frankivsk,1377496,37,1,899,51
2020-05-02,Ukraine,NA,Ivano-Frankivsk,1377496,43,2,942,53
2020-05-03,Ukraine,NA,Ivano-Frankivsk,1377496,23,1,965,54
2020-05-04,Ukraine,NA,Ivano-Frankivsk,1377496,19,2,984,56
2020-05-05,Ukraine,NA,Ivano-Frankivsk,1377496,31,1,1015,57
2020-05-06,Ukraine,NA,Ivano-Frankivsk,1377496,22,2,1037,59
2020-05-07,Ukraine,NA,Ivano-Frankivsk,1377496,18,0,1055,59
2020-05-08,Ukraine,NA,Ivano-Frankivsk,1377496,23,1,1078,60
2020-05-09,Ukraine,NA,Ivano-Frankivsk,1377496,17,1,1095,61
2020-05-10,Ukraine,NA,Ivano-Frankivsk,1377496,21,0,1116,61
2020-05-11,Ukraine,NA,Ivano-Frankivsk,1377496,10,0,1126,61
2020-05-12,Ukraine,NA,Ivano-Frankivsk,1377496,7,1,1133,62
2020-05-13,Ukraine,NA,Ivano-Frankivsk,1377496,11,1,1144,63
2020-05-14,Ukraine,NA,Ivano-Frankivsk,1377496,22,2,1166,65
2020-05-15,Ukraine,NA,Ivano-Frankivsk,1377496,22,2,1188,67
2020-05-16,Ukraine,NA,Ivano-Frankivsk,1377496,12,1,1200,68
2020-05-17,Ukraine,NA,Ivano-Frankivsk,1377496,10,0,1210,68
2020-05-18,Ukraine,NA,Ivano-Frankivsk,1377496,11,0,1221,68
2020-05-19,Ukraine,NA,Ivano-Frankivsk,1377496,14,2,1235,70
2020-05-20,Ukraine,NA,Ivano-Frankivsk,1377496,11,1,1246,71
2020-05-21,Ukraine,NA,Ivano-Frankivsk,1377496,11,2,1257,73
2020-05-22,Ukraine,NA,Ivano-Frankivsk,1377496,11,0,1268,73
2020-05-23,Ukraine,NA,Ivano-Frankivsk,1377496,6,0,1274,73
2020-05-24,Ukraine,NA,Ivano-Frankivsk,1377496,3,1,1277,74
2020-05-25,Ukraine,NA,Ivano-Frankivsk,1377496,4,0,1281,74
2020-05-26,Ukraine,NA,Ivano-Frankivsk,1377496,25,0,1306,74
2020-05-27,Ukraine,NA,Ivano-Frankivsk,1377496,21,1,1327,75
2020-05-28,Ukraine,NA,Ivano-Frankivsk,1377496,12,0,1339,75
2020-05-29,Ukraine,NA,Ivano-Frankivsk,1377496,21,3,1360,78
2020-05-30,Ukraine,NA,Ivano-Frankivsk,1377496,19,1,1379,79
2020-05-31,Ukraine,NA,Ivano-Frankivsk,1377496,23,2,1402,81
2020-06-01,Ukraine,NA,Ivano-Frankivsk,1377496,18,0,1420,81
2020-06-02,Ukraine,NA,Ivano-Frankivsk,1377496,22,2,1442,83
2020-06-03,Ukraine,NA,Ivano-Frankivsk,1377496,23,0,1465,83
2020-06-04,Ukraine,NA,Ivano-Frankivsk,1377496,26,1,1491,84
2020-06-05,Ukraine,NA,Ivano-Frankivsk,1377496,16,1,1507,85
2020-06-06,Ukraine,NA,Ivano-Frankivsk,1377496,26,1,1533,86
2020-06-07,Ukraine,NA,Ivano-Frankivsk,1377496,29,1,1562,87
2020-06-08,Ukraine,NA,Ivano-Frankivsk,1377496,20,1,1582,88
2020-06-09,Ukraine,NA,Ivano-Frankivsk,1377496,20,0,1602,88
2020-06-10,Ukraine,NA,Ivano-Frankivsk,1377496,20,1,1622,89
2020-06-11,Ukraine,NA,Ivano-Frankivsk,1377496,27,1,1649,90
2020-06-12,Ukraine,NA,Ivano-Frankivsk,1377496,20,0,1669,90
2020-06-13,Ukraine,NA,Ivano-Frankivsk,1377496,26,0,1695,90
2020-06-14,Ukraine,NA,Ivano-Frankivsk,1377496,33,0,1728,90
2020-06-15,Ukraine,NA,Ivano-Frankivsk,1377496,38,1,1766,91
2020-06-16,Ukraine,NA,Ivano-Frankivsk,1377496,43,0,1809,91
2020-06-17,Ukraine,NA,Ivano-Frankivsk,1377496,40,1,1849,92
2020-06-18,Ukraine,NA,Ivano-Frankivsk,1377496,44,0,1893,92
2020-06-19,Ukraine,NA,Ivano-Frankivsk,1377496,47,2,1940,94
2020-06-20,Ukraine,NA,Ivano-Frankivsk,1377496,41,1,1981,95
2020-06-21,Ukraine,NA,Ivano-Frankivsk,1377496,34,1,2015,96
2020-06-22,Ukraine,NA,Ivano-Frankivsk,1377496,41,1,2056,97
2020-06-23,Ukraine,NA,Ivano-Frankivsk,1377496,35,0,2091,97
2020-06-24,Ukraine,NA,Ivano-Frankivsk,1377496,33,0,2124,97
2020-06-25,Ukraine,NA,Ivano-Frankivsk,1377496,47,1,2171,98
2020-06-26,Ukraine,NA,Ivano-Frankivsk,1377496,46,1,2217,99
2020-06-27,Ukraine,NA,Ivano-Frankivsk,1377496,36,1,2253,100
2020-06-28,Ukraine,NA,Ivano-Frankivsk,1377496,47,1,2300,101
2020-06-29,Ukraine,NA,Ivano-Frankivsk,1377496,50,0,2350,101
2020-06-30,Ukraine,NA,Ivano-Frankivsk,1377496,45,0,2395,101
2020-07-01,Ukraine,NA,Ivano-Frankivsk,1377496,43,0,2438,101
2020-07-02,Ukraine,NA,Ivano-Frankivsk,1377496,51,1,2489,102
2020-07-03,Ukraine,NA,Ivano-Frankivsk,1377496,55,1,2544,103
2020-07-04,Ukraine,NA,Ivano-Frankivsk,1377496,54,0,2598,103
2020-07-05,Ukraine,NA,Ivano-Frankivsk,1377496,57,0,2655,103
2020-07-06,Ukraine,NA,Ivano-Frankivsk,1377496,45,0,2700,103
2020-07-07,Ukraine,NA,Ivano-Frankivsk,1377496,44,1,2744,104
2020-07-08,Ukraine,NA,Ivano-Frankivsk,1377496,53,1,2797,105
2020-07-09,Ukraine,NA,Ivano-Frankivsk,1377496,60,1,2857,106
2020-07-10,Ukraine,NA,Ivano-Frankivsk,1377496,58,1,2915,107
2020-07-11,Ukraine,NA,Ivano-Frankivsk,1377496,56,2,2971,109
2020-07-12,Ukraine,NA,Ivano-Frankivsk,1377496,58,0,3029,109
2020-07-13,Ukraine,NA,Ivano-Frankivsk,1377496,42,0,3071,109
2020-07-14,Ukraine,NA,Ivano-Frankivsk,1377496,56,2,3127,111
2020-07-15,Ukraine,NA,Ivano-Frankivsk,1377496,51,2,3178,113
2020-07-16,Ukraine,NA,Ivano-Frankivsk,1377496,64,3,3242,116
2020-07-17,Ukraine,NA,Ivano-Frankivsk,1377496,67,3,3309,119
2020-07-18,Ukraine,NA,Ivano-Frankivsk,1377496,76,1,3385,120
2020-07-19,Ukraine,NA,Ivano-Frankivsk,1377496,79,0,3464,120
2020-07-20,Ukraine,NA,Ivano-Frankivsk,1377496,72,1,3536,121
2020-07-21,Ukraine,NA,Ivano-Frankivsk,1377496,75,2,3611,123
2020-07-22,Ukraine,NA,Ivano-Frankivsk,1377496,78,2,3689,125
2020-07-23,Ukraine,NA,Ivano-Frankivsk,1377496,76,2,3765,127
2020-07-24,Ukraine,NA,Ivano-Frankivsk,1377496,87,3,3852,130
2020-07-25,Ukraine,NA,Ivano-Frankivsk,1377496,85,2,3937,132
2020-07-26,Ukraine,NA,Ivano-Frankivsk,1377496,88,0,4025,132
2020-07-27,Ukraine,NA,Ivano-Frankivsk,1377496,96,2,4121,134
2020-07-28,Ukraine,NA,Ivano-Frankivsk,1377496,103,1,4224,135
2020-07-29,Ukraine,NA,Ivano-Frankivsk,1377496,118,1,4342,136
2020-07-30,Ukraine,NA,Ivano-Frankivsk,1377496,104,0,4446,136
2020-07-31,Ukraine,NA,Ivano-Frankivsk,1377496,111,2,4557,138
2020-08-01,Ukraine,NA,Ivano-Frankivsk,1377496,123,3,4680,141
2020-08-02,Ukraine,NA,Ivano-Frankivsk,1377496,115,0,4795,141
2020-08-03,Ukraine,NA,Ivano-Frankivsk,1377496,119,0,4914,141
2020-08-04,Ukraine,NA,Ivano-Frankivsk,1377496,127,2,5041,143
2020-08-05,Ukraine,NA,Ivano-Frankivsk,1377496,127,2,5168,145
2020-08-06,Ukraine,NA,Ivano-Frankivsk,1377496,127,3,5295,148
2020-08-07,Ukraine,NA,Ivano-Frankivsk,1377496,131,2,5426,150
2020-08-08,Ukraine,NA,Ivano-Frankivsk,1377496,126,3,5552,153
2020-08-09,Ukraine,NA,Ivano-Frankivsk,1377496,124,2,5676,155
2020-08-10,Ukraine,NA,Ivano-Frankivsk,1377496,121,1,5797,156
2020-08-11,Ukraine,NA,Ivano-Frankivsk,1377496,114,2,5911,158
2020-08-12,Ukraine,NA,Ivano-Frankivsk,1377496,128,2,6039,160
2020-08-13,Ukraine,NA,Ivano-Frankivsk,1377496,138,3,6177,163
2020-08-14,Ukraine,NA,Ivano-Frankivsk,1377496,143,2,6320,165
2020-08-15,Ukraine,NA,Ivano-Frankivsk,1377496,148,2,6468,167
2020-08-16,Ukraine,NA,Ivano-Frankivsk,1377496,158,0,6626,167
2020-08-17,Ukraine,NA,Ivano-Frankivsk,1377496,164,4,6790,171
2020-08-18,Ukraine,NA,Ivano-Frankivsk,1377496,169,3,6959,174
2020-08-19,Ukraine,NA,Ivano-Frankivsk,1377496,163,3,7122,177
2020-08-20,Ukraine,NA,Ivano-Frankivsk,1377496,168,4,7290,181
2020-08-21,Ukraine,NA,Ivano-Frankivsk,1377496,172,4,7462,185
2020-08-22,Ukraine,NA,Ivano-Frankivsk,1377496,169,3,7631,188
2020-08-23,Ukraine,NA,Ivano-Frankivsk,1377496,174,2,7805,190
2020-08-24,Ukraine,NA,Ivano-Frankivsk,1377496,170,2,7975,192
2020-08-25,Ukraine,NA,Ivano-Frankivsk,1377496,179,4,8154,196
2020-08-26,Ukraine,NA,Ivano-Frankivsk,1377496,167,4,8321,200
2020-08-27,Ukraine,NA,Ivano-Frankivsk,1377496,164,4,8485,204
2020-08-28,Ukraine,NA,Ivano-Frankivsk,1377496,176,4,8661,208
2020-08-29,Ukraine,NA,Ivano-Frankivsk,1377496,182,4,8843,212
2020-08-30,Ukraine,NA,Ivano-Frankivsk,1377496,171,2,9014,214
2020-08-31,Ukraine,NA,Ivano-Frankivsk,1377496,165,1,9179,215
2020-09-01,Ukraine,NA,Ivano-Frankivsk,1377496,169,4,9348,219
2020-09-02,Ukraine,NA,Ivano-Frankivsk,1377496,174,3,9522,222
2020-09-03,Ukraine,NA,Ivano-Frankivsk,1377496,163,5,9685,227
2020-09-04,Ukraine,NA,Ivano-Frankivsk,1377496,160,4,9845,231
2020-09-05,Ukraine,NA,Ivano-Frankivsk,1377496,166,4,10011,235
2020-09-06,Ukraine,NA,Ivano-Frankivsk,1377496,176,4,10187,239
2020-09-07,Ukraine,NA,Ivano-Frankivsk,1377496,161,3,10348,242
2020-09-08,Ukraine,NA,Ivano-Frankivsk,1377496,160,2,10508,244
2020-09-09,Ukraine,NA,Ivano-Frankivsk,1377496,151,3,10659,247
2020-09-10,Ukraine,NA,Ivano-Frankivsk,1377496,143,3,10802,250
2020-09-11,Ukraine,NA,Ivano-Frankivsk,1377496,151,3,10953,253
2020-09-12,Ukraine,NA,Ivano-Frankivsk,1377496,130,4,11083,257
2020-09-13,Ukraine,NA,Ivano-Frankivsk,1377496,132,4,11215,261
2020-09-14,Ukraine,NA,Ivano-Frankivsk,1377496,142,0,11357,261
2020-09-15,Ukraine,NA,Ivano-Frankivsk,1377496,153,4,11510,265
2020-09-16,Ukraine,NA,Ivano-Frankivsk,1377496,167,4,11677,269
2020-09-17,Ukraine,NA,Ivano-Frankivsk,1377496,179,4,11856,273
2020-09-18,Ukraine,NA,Ivano-Frankivsk,1377496,175,1,12031,274
2020-09-19,Ukraine,NA,Ivano-Frankivsk,1377496,181,3,12212,277
2020-09-20,Ukraine,NA,Ivano-Frankivsk,1377496,170,0,12382,277
2020-09-21,Ukraine,NA,Ivano-Frankivsk,1377496,156,3,12538,280
2020-09-22,Ukraine,NA,Ivano-Frankivsk,1377496,137,4,12675,284
2020-09-23,Ukraine,NA,Ivano-Frankivsk,1377496,136,3,12811,287
2020-04-12,Ukraine,NA,Kharkiv,2694007,3,0,11,0
2020-04-13,Ukraine,NA,Kharkiv,2694007,0,0,11,0
2020-04-14,Ukraine,NA,Kharkiv,2694007,3,0,14,0
2020-04-15,Ukraine,NA,Kharkiv,2694007,11,1,25,1
2020-04-16,Ukraine,NA,Kharkiv,2694007,15,0,40,1
2020-04-17,Ukraine,NA,Kharkiv,2694007,16,0,56,1
2020-04-18,Ukraine,NA,Kharkiv,2694007,6,0,62,1
2020-04-19,Ukraine,NA,Kharkiv,2694007,5,0,67,1
2020-04-20,Ukraine,NA,Kharkiv,2694007,6,0,73,1
2020-04-21,Ukraine,NA,Kharkiv,2694007,4,0,77,1
2020-04-22,Ukraine,NA,Kharkiv,2694007,5,1,82,2
2020-04-23,Ukraine,NA,Kharkiv,2694007,19,0,101,2
2020-04-24,Ukraine,NA,Kharkiv,2694007,17,0,118,2
2020-04-25,Ukraine,NA,Kharkiv,2694007,7,0,125,2
2020-04-26,Ukraine,NA,Kharkiv,2694007,22,0,147,2
2020-04-27,Ukraine,NA,Kharkiv,2694007,49,2,196,4
2020-04-28,Ukraine,NA,Kharkiv,2694007,25,0,221,4
2020-04-29,Ukraine,NA,Kharkiv,2694007,16,0,237,4
2020-04-30,Ukraine,NA,Kharkiv,2694007,12,0,249,4
2020-05-01,Ukraine,NA,Kharkiv,2694007,25,0,274,4
2020-05-02,Ukraine,NA,Kharkiv,2694007,37,2,311,6
2020-05-03,Ukraine,NA,Kharkiv,2694007,37,0,348,6
2020-05-04,Ukraine,NA,Kharkiv,2694007,13,3,361,9
2020-05-05,Ukraine,NA,Kharkiv,2694007,16,1,377,10
2020-05-06,Ukraine,NA,Kharkiv,2694007,26,0,403,10
2020-05-07,Ukraine,NA,Kharkiv,2694007,45,0,448,10
2020-05-08,Ukraine,NA,Kharkiv,2694007,30,1,478,11
2020-05-09,Ukraine,NA,Kharkiv,2694007,50,3,528,14
2020-05-10,Ukraine,NA,Kharkiv,2694007,44,2,572,16
2020-05-11,Ukraine,NA,Kharkiv,2694007,23,3,595,19
2020-05-12,Ukraine,NA,Kharkiv,2694007,28,0,623,19
2020-05-13,Ukraine,NA,Kharkiv,2694007,49,1,672,20
2020-05-14,Ukraine,NA,Kharkiv,2694007,41,1,713,21
2020-05-15,Ukraine,NA,Kharkiv,2694007,44,2,757,23
2020-05-16,Ukraine,NA,Kharkiv,2694007,16,3,773,26
2020-05-17,Ukraine,NA,Kharkiv,2694007,13,3,786,29
2020-05-18,Ukraine,NA,Kharkiv,2694007,3,1,789,30
2020-05-19,Ukraine,NA,Kharkiv,2694007,27,0,816,30
2020-05-20,Ukraine,NA,Kharkiv,2694007,20,2,836,32
2020-05-21,Ukraine,NA,Kharkiv,2694007,15,0,851,32
2020-05-22,Ukraine,NA,Kharkiv,2694007,15,1,866,33
2020-05-23,Ukraine,NA,Kharkiv,2694007,26,3,892,36
2020-05-24,Ukraine,NA,Kharkiv,2694007,18,2,910,38
2020-05-25,Ukraine,NA,Kharkiv,2694007,2,0,912,38
2020-05-26,Ukraine,NA,Kharkiv,2694007,18,0,930,38
2020-05-27,Ukraine,NA,Kharkiv,2694007,29,3,959,41
2020-05-28,Ukraine,NA,Kharkiv,2694007,22,1,981,42
2020-05-29,Ukraine,NA,Kharkiv,2694007,30,1,1011,43
2020-05-30,Ukraine,NA,Kharkiv,2694007,14,2,1025,45
2020-05-31,Ukraine,NA,Kharkiv,2694007,41,2,1066,47
2020-06-01,Ukraine,NA,Kharkiv,2694007,17,0,1083,47
2020-06-02,Ukraine,NA,Kharkiv,2694007,22,1,1105,48
2020-06-03,Ukraine,NA,Kharkiv,2694007,26,0,1131,48
2020-06-04,Ukraine,NA,Kharkiv,2694007,35,1,1166,49
2020-06-05,Ukraine,NA,Kharkiv,2694007,30,2,1196,51
2020-06-06,Ukraine,NA,Kharkiv,2694007,26,0,1222,51
2020-06-07,Ukraine,NA,Kharkiv,2694007,29,1,1251,52
2020-06-08,Ukraine,NA,Kharkiv,2694007,36,0,1287,52
2020-06-09,Ukraine,NA,Kharkiv,2694007,18,2,1305,54
2020-06-10,Ukraine,NA,Kharkiv,2694007,33,0,1338,54
2020-06-11,Ukraine,NA,Kharkiv,2694007,36,1,1374,55
2020-06-12,Ukraine,NA,Kharkiv,2694007,52,2,1426,57
2020-06-13,Ukraine,NA,Kharkiv,2694007,56,0,1482,57
2020-06-14,Ukraine,NA,Kharkiv,2694007,39,1,1521,58
2020-06-15,Ukraine,NA,Kharkiv,2694007,21,1,1542,59
2020-06-16,Ukraine,NA,Kharkiv,2694007,53,3,1595,62
2020-06-17,Ukraine,NA,Kharkiv,2694007,57,0,1652,62
2020-06-18,Ukraine,NA,Kharkiv,2694007,55,4,1707,66
2020-06-19,Ukraine,NA,Kharkiv,2694007,37,0,1744,66
2020-06-20,Ukraine,NA,Kharkiv,2694007,35,2,1779,68
2020-06-21,Ukraine,NA,Kharkiv,2694007,26,1,1805,69
2020-06-22,Ukraine,NA,Kharkiv,2694007,6,0,1811,69
2020-06-23,Ukraine,NA,Kharkiv,2694007,33,0,1844,69
2020-06-24,Ukraine,NA,Kharkiv,2694007,47,2,1891,71
2020-06-25,Ukraine,NA,Kharkiv,2694007,56,0,1947,71
2020-06-26,Ukraine,NA,Kharkiv,2694007,46,3,1993,74
2020-06-27,Ukraine,NA,Kharkiv,2694007,53,1,2046,75
2020-06-28,Ukraine,NA,Kharkiv,2694007,36,3,2082,78
2020-06-29,Ukraine,NA,Kharkiv,2694007,16,2,2098,80
2020-06-30,Ukraine,NA,Kharkiv,2694007,36,0,2134,80
2020-07-01,Ukraine,NA,Kharkiv,2694007,35,3,2169,83
2020-07-02,Ukraine,NA,Kharkiv,2694007,38,1,2207,84
2020-07-03,Ukraine,NA,Kharkiv,2694007,48,3,2255,87
2020-07-04,Ukraine,NA,Kharkiv,2694007,56,3,2311,90
2020-07-05,Ukraine,NA,Kharkiv,2694007,37,3,2348,93
2020-07-06,Ukraine,NA,Kharkiv,2694007,23,0,2371,93
2020-07-07,Ukraine,NA,Kharkiv,2694007,45,1,2416,94
2020-07-08,Ukraine,NA,Kharkiv,2694007,50,5,2466,99
2020-07-09,Ukraine,NA,Kharkiv,2694007,55,2,2521,101
2020-07-10,Ukraine,NA,Kharkiv,2694007,56,1,2577,102
2020-07-11,Ukraine,NA,Kharkiv,2694007,44,1,2621,103
2020-07-12,Ukraine,NA,Kharkiv,2694007,28,2,2649,105
2020-07-13,Ukraine,NA,Kharkiv,2694007,28,4,2677,109
2020-07-14,Ukraine,NA,Kharkiv,2694007,46,2,2723,111
2020-07-15,Ukraine,NA,Kharkiv,2694007,64,0,2787,111
2020-07-16,Ukraine,NA,Kharkiv,2694007,58,3,2845,114
2020-07-17,Ukraine,NA,Kharkiv,2694007,64,0,2909,114
2020-07-18,Ukraine,NA,Kharkiv,2694007,62,2,2971,116
2020-07-19,Ukraine,NA,Kharkiv,2694007,43,1,3014,117
2020-07-20,Ukraine,NA,Kharkiv,2694007,19,1,3033,118
2020-07-21,Ukraine,NA,Kharkiv,2694007,49,0,3082,118
2020-07-22,Ukraine,NA,Kharkiv,2694007,57,1,3139,119
2020-07-23,Ukraine,NA,Kharkiv,2694007,64,1,3203,120
2020-07-24,Ukraine,NA,Kharkiv,2694007,74,1,3277,121
2020-07-25,Ukraine,NA,Kharkiv,2694007,65,0,3342,121
2020-07-26,Ukraine,NA,Kharkiv,2694007,39,1,3381,122
2020-07-27,Ukraine,NA,Kharkiv,2694007,50,0,3431,122
2020-07-28,Ukraine,NA,Kharkiv,2694007,47,0,3478,122
2020-07-29,Ukraine,NA,Kharkiv,2694007,78,2,3556,124
2020-07-30,Ukraine,NA,Kharkiv,2694007,70,3,3626,127
2020-07-31,Ukraine,NA,Kharkiv,2694007,85,0,3711,127
2020-08-01,Ukraine,NA,Kharkiv,2694007,75,0,3786,127
2020-08-02,Ukraine,NA,Kharkiv,2694007,76,5,3862,132
2020-08-03,Ukraine,NA,Kharkiv,2694007,88,0,3950,132
2020-08-04,Ukraine,NA,Kharkiv,2694007,143,2,4093,134
2020-08-05,Ukraine,NA,Kharkiv,2694007,146,2,4239,136
2020-08-06,Ukraine,NA,Kharkiv,2694007,142,0,4381,136
2020-08-07,Ukraine,NA,Kharkiv,2694007,146,2,4527,138
2020-08-08,Ukraine,NA,Kharkiv,2694007,134,3,4661,141
2020-08-09,Ukraine,NA,Kharkiv,2694007,123,1,4784,142
2020-08-10,Ukraine,NA,Kharkiv,2694007,117,2,4901,144
2020-08-11,Ukraine,NA,Kharkiv,2694007,129,2,5030,146
2020-08-12,Ukraine,NA,Kharkiv,2694007,139,4,5169,150
2020-08-13,Ukraine,NA,Kharkiv,2694007,209,1,5378,151
2020-08-14,Ukraine,NA,Kharkiv,2694007,205,4,5583,155
2020-08-15,Ukraine,NA,Kharkiv,2694007,254,4,5837,159
2020-08-16,Ukraine,NA,Kharkiv,2694007,228,0,6065,159
2020-08-17,Ukraine,NA,Kharkiv,2694007,91,2,6156,161
2020-08-18,Ukraine,NA,Kharkiv,2694007,204,1,6360,162
2020-08-19,Ukraine,NA,Kharkiv,2694007,247,4,6607,166
2020-08-20,Ukraine,NA,Kharkiv,2694007,242,5,6849,171
2020-08-21,Ukraine,NA,Kharkiv,2694007,184,2,7033,173
2020-08-22,Ukraine,NA,Kharkiv,2694007,291,4,7324,177
2020-08-23,Ukraine,NA,Kharkiv,2694007,169,3,7493,180
2020-08-24,Ukraine,NA,Kharkiv,2694007,141,1,7634,181
2020-08-25,Ukraine,NA,Kharkiv,2694007,173,5,7807,186
2020-08-26,Ukraine,NA,Kharkiv,2694007,177,5,7984,191
2020-08-27,Ukraine,NA,Kharkiv,2694007,218,5,8202,196
2020-08-28,Ukraine,NA,Kharkiv,2694007,242,1,8444,197
2020-08-29,Ukraine,NA,Kharkiv,2694007,247,2,8691,199
2020-08-30,Ukraine,NA,Kharkiv,2694007,198,4,8889,203
2020-08-31,Ukraine,NA,Kharkiv,2694007,187,1,9076,204
2020-09-01,Ukraine,NA,Kharkiv,2694007,262,3,9338,207
2020-09-02,Ukraine,NA,Kharkiv,2694007,302,6,9640,213
2020-09-03,Ukraine,NA,Kharkiv,2694007,301,5,9941,218
2020-09-04,Ukraine,NA,Kharkiv,2694007,371,2,10312,220
2020-09-05,Ukraine,NA,Kharkiv,2694007,380,5,10692,225
2020-09-06,Ukraine,NA,Kharkiv,2694007,141,6,10833,231
2020-09-07,Ukraine,NA,Kharkiv,2694007,139,4,10972,235
2020-09-08,Ukraine,NA,Kharkiv,2694007,230,6,11202,241
2020-09-09,Ukraine,NA,Kharkiv,2694007,291,4,11493,245
2020-09-10,Ukraine,NA,Kharkiv,2694007,339,6,11832,251
2020-09-11,Ukraine,NA,Kharkiv,2694007,280,6,12112,257
2020-09-12,Ukraine,NA,Kharkiv,2694007,292,6,12404,263
2020-09-13,Ukraine,NA,Kharkiv,2694007,180,3,12584,266
2020-09-14,Ukraine,NA,Kharkiv,2694007,269,6,12853,272
2020-09-15,Ukraine,NA,Kharkiv,2694007,307,3,13160,275
2020-09-16,Ukraine,NA,Kharkiv,2694007,272,7,13432,282
2020-09-17,Ukraine,NA,Kharkiv,2694007,483,5,13915,287
2020-09-18,Ukraine,NA,Kharkiv,2694007,349,4,14264,291
2020-09-19,Ukraine,NA,Kharkiv,2694007,200,4,14464,295
2020-09-20,Ukraine,NA,Kharkiv,2694007,424,5,14888,300
2020-09-21,Ukraine,NA,Kharkiv,2694007,245,1,15133,301
2020-09-22,Ukraine,NA,Kharkiv,2694007,372,7,15505,308
2020-09-23,Ukraine,NA,Kharkiv,2694007,403,7,15908,315
2020-04-07,Ukraine,NA,Kherson,1046981,3,0,13,1
2020-04-08,Ukraine,NA,Kherson,1046981,2,0,15,1
2020-04-09,Ukraine,NA,Kherson,1046981,3,0,18,1
2020-04-10,Ukraine,NA,Kherson,1046981,9,0,27,1
2020-04-11,Ukraine,NA,Kherson,1046981,1,0,28,1
2020-04-12,Ukraine,NA,Kherson,1046981,3,0,31,1
2020-04-13,Ukraine,NA,Kherson,1046981,0,0,31,1
2020-04-14,Ukraine,NA,Kherson,1046981,3,0,34,1
2020-04-15,Ukraine,NA,Kherson,1046981,7,0,41,1
2020-04-16,Ukraine,NA,Kherson,1046981,3,0,44,1
2020-04-17,Ukraine,NA,Kherson,1046981,7,0,51,1
2020-04-18,Ukraine,NA,Kherson,1046981,5,0,56,1
2020-04-19,Ukraine,NA,Kherson,1046981,7,0,63,1
2020-04-20,Ukraine,NA,Kherson,1046981,0,0,63,1
2020-04-21,Ukraine,NA,Kherson,1046981,7,0,70,1
2020-04-22,Ukraine,NA,Kherson,1046981,2,0,72,1
2020-04-23,Ukraine,NA,Kherson,1046981,5,0,77,1
2020-04-24,Ukraine,NA,Kherson,1046981,0,0,77,1
2020-04-25,Ukraine,NA,Kherson,1046981,2,0,79,1
2020-04-26,Ukraine,NA,Kherson,1046981,8,0,87,1
2020-04-27,Ukraine,NA,Kherson,1046981,1,0,88,1
2020-04-28,Ukraine,NA,Kherson,1046981,0,0,88,1
2020-04-29,Ukraine,NA,Kherson,1046981,23,0,111,1
2020-04-30,Ukraine,NA,Kherson,1046981,0,1,111,2
2020-05-01,Ukraine,NA,Kherson,1046981,9,0,120,2
2020-05-02,Ukraine,NA,Kherson,1046981,1,0,121,2
2020-05-03,Ukraine,NA,Kherson,1046981,15,0,136,2
2020-05-04,Ukraine,NA,Kherson,1046981,3,0,139,2
2020-05-05,Ukraine,NA,Kherson,1046981,3,0,142,2
2020-05-06,Ukraine,NA,Kherson,1046981,1,0,143,2
2020-05-07,Ukraine,NA,Kherson,1046981,3,0,146,2
2020-05-08,Ukraine,NA,Kherson,1046981,3,0,149,2
2020-05-09,Ukraine,NA,Kherson,1046981,7,0,156,2
2020-05-10,Ukraine,NA,Kherson,1046981,3,0,159,2
2020-05-11,Ukraine,NA,Kherson,1046981,2,0,161,2
2020-05-12,Ukraine,NA,Kherson,1046981,1,0,162,2
2020-05-13,Ukraine,NA,Kherson,1046981,3,0,165,2
2020-05-14,Ukraine,NA,Kherson,1046981,0,0,165,2
2020-05-15,Ukraine,NA,Kherson,1046981,2,0,167,2
2020-05-16,Ukraine,NA,Kherson,1046981,0,0,167,2
2020-05-17,Ukraine,NA,Kherson,1046981,0,0,167,2
2020-05-18,Ukraine,NA,Kherson,1046981,1,0,168,2
2020-05-19,Ukraine,NA,Kherson,1046981,0,0,168,2
2020-05-20,Ukraine,NA,Kherson,1046981,4,0,172,2
2020-05-21,Ukraine,NA,Kherson,1046981,1,0,173,2
2020-05-22,Ukraine,NA,Kherson,1046981,0,0,173,2
2020-05-23,Ukraine,NA,Kherson,1046981,4,0,177,2
2020-05-24,Ukraine,NA,Kherson,1046981,0,0,177,2
2020-05-25,Ukraine,NA,Kherson,1046981,0,0,177,2
2020-05-26,Ukraine,NA,Kherson,1046981,0,0,177,2
2020-05-27,Ukraine,NA,Kherson,1046981,0,1,177,3
2020-05-28,Ukraine,NA,Kherson,1046981,0,0,177,3
2020-05-29,Ukraine,NA,Kherson,1046981,0,0,177,3
2020-05-30,Ukraine,NA,Kherson,1046981,1,0,178,3
2020-05-31,Ukraine,NA,Kherson,1046981,0,0,178,3
2020-06-01,Ukraine,NA,Kherson,1046981,0,0,178,3
2020-06-02,Ukraine,NA,Kherson,1046981,0,0,178,3
2020-06-03,Ukraine,NA,Kherson,1046981,1,0,179,3
2020-06-04,Ukraine,NA,Kherson,1046981,0,0,179,3
2020-06-05,Ukraine,NA,Kherson,1046981,0,0,179,3
2020-06-06,Ukraine,NA,Kherson,1046981,0,0,179,3
2020-06-07,Ukraine,NA,Kherson,1046981,0,0,179,3
2020-06-08,Ukraine,NA,Kherson,1046981,0,0,179,3
2020-06-09,Ukraine,NA,Kherson,1046981,0,0,179,3
2020-06-10,Ukraine,NA,Kherson,1046981,0,0,179,3
2020-06-11,Ukraine,NA,Kherson,1046981,0,0,179,3
2020-06-12,Ukraine,NA,Kherson,1046981,0,0,179,3
2020-06-13,Ukraine,NA,Kherson,1046981,0,0,179,3
2020-06-14,Ukraine,NA,Kherson,1046981,1,0,180,3
2020-06-15,Ukraine,NA,Kherson,1046981,3,0,183,3
2020-06-16,Ukraine,NA,Kherson,1046981,0,0,183,3
2020-06-17,Ukraine,NA,Kherson,1046981,0,0,183,3
2020-06-18,Ukraine,NA,Kherson,1046981,1,0,184,3
2020-06-19,Ukraine,NA,Kherson,1046981,1,0,185,3
2020-06-20,Ukraine,NA,Kherson,1046981,0,0,185,3
2020-06-21,Ukraine,NA,Kherson,1046981,1,0,186,3
2020-06-22,Ukraine,NA,Kherson,1046981,2,0,188,3
2020-06-23,Ukraine,NA,Kherson,1046981,0,0,188,3
2020-06-24,Ukraine,NA,Kherson,1046981,0,0,188,3
2020-06-25,Ukraine,NA,Kherson,1046981,0,0,188,3
2020-06-26,Ukraine,NA,Kherson,1046981,2,0,190,3
2020-06-27,Ukraine,NA,Kherson,1046981,1,0,191,3
2020-06-28,Ukraine,NA,Kherson,1046981,0,0,191,3
2020-06-29,Ukraine,NA,Kherson,1046981,0,0,191,3
2020-06-30,Ukraine,NA,Kherson,1046981,0,0,191,3
2020-07-01,Ukraine,NA,Kherson,1046981,2,0,193,3
2020-07-02,Ukraine,NA,Kherson,1046981,1,0,194,3
2020-07-03,Ukraine,NA,Kherson,1046981,1,0,195,3
2020-07-04,Ukraine,NA,Kherson,1046981,1,0,196,3
2020-07-05,Ukraine,NA,Kherson,1046981,0,0,196,3
2020-07-06,Ukraine,NA,Kherson,1046981,0,0,196,3
2020-07-07,Ukraine,NA,Kherson,1046981,0,0,196,3
2020-07-08,Ukraine,NA,Kherson,1046981,5,0,201,3
2020-07-09,Ukraine,NA,Kherson,1046981,0,0,201,3
2020-07-10,Ukraine,NA,Kherson,1046981,2,0,203,3
2020-07-11,Ukraine,NA,Kherson,1046981,1,0,204,3
2020-07-12,Ukraine,NA,Kherson,1046981,0,0,204,3
2020-07-13,Ukraine,NA,Kherson,1046981,0,0,204,3
2020-07-14,Ukraine,NA,Kherson,1046981,0,0,204,3
2020-07-15,Ukraine,NA,Kherson,1046981,1,0,205,3
2020-07-16,Ukraine,NA,Kherson,1046981,1,0,206,3
2020-07-17,Ukraine,NA,Kherson,1046981,1,0,207,3
2020-07-18,Ukraine,NA,Kherson,1046981,2,0,209,3
2020-07-19,Ukraine,NA,Kherson,1046981,4,0,213,3
2020-07-20,Ukraine,NA,Kherson,1046981,0,0,213,3
2020-07-21,Ukraine,NA,Kherson,1046981,3,0,216,3
2020-07-22,Ukraine,NA,Kherson,1046981,1,0,217,3
2020-07-23,Ukraine,NA,Kherson,1046981,1,0,218,3
2020-07-24,Ukraine,NA,Kherson,1046981,0,0,218,3
2020-07-25,Ukraine,NA,Kherson,1046981,1,0,219,3
2020-07-26,Ukraine,NA,Kherson,1046981,0,0,219,3
2020-07-27,Ukraine,NA,Kherson,1046981,1,0,220,3
2020-07-28,Ukraine,NA,Kherson,1046981,1,0,221,3
2020-07-29,Ukraine,NA,Kherson,1046981,3,0,224,3
2020-07-30,Ukraine,NA,Kherson,1046981,0,0,224,3
2020-07-31,Ukraine,NA,Kherson,1046981,3,0,227,3
2020-08-01,Ukraine,NA,Kherson,1046981,0,0,227,3
2020-08-02,Ukraine,NA,Kherson,1046981,3,0,230,3
2020-08-03,Ukraine,NA,Kherson,1046981,0,0,230,3
2020-08-04,Ukraine,NA,Kherson,1046981,0,0,230,3
2020-08-05,Ukraine,NA,Kherson,1046981,6,0,236,3
2020-08-06,Ukraine,NA,Kherson,1046981,6,0,242,3
2020-08-07,Ukraine,NA,Kherson,1046981,13,0,255,3
2020-08-08,Ukraine,NA,Kherson,1046981,4,1,259,4
2020-08-09,Ukraine,NA,Kherson,1046981,8,0,267,4
2020-08-10,Ukraine,NA,Kherson,1046981,2,0,269,4
2020-08-11,Ukraine,NA,Kherson,1046981,2,1,271,5
2020-08-12,Ukraine,NA,Kherson,1046981,5,0,276,5
2020-08-13,Ukraine,NA,Kherson,1046981,10,0,286,5
2020-08-14,Ukraine,NA,Kherson,1046981,4,0,290,5
2020-08-15,Ukraine,NA,Kherson,1046981,4,0,294,5
2020-08-16,Ukraine,NA,Kherson,1046981,5,0,299,5
2020-08-17,Ukraine,NA,Kherson,1046981,2,1,301,6
2020-08-18,Ukraine,NA,Kherson,1046981,3,0,304,6
2020-08-19,Ukraine,NA,Kherson,1046981,8,0,312,6
2020-08-20,Ukraine,NA,Kherson,1046981,9,1,321,7
2020-08-21,Ukraine,NA,Kherson,1046981,8,0,329,7
2020-08-22,Ukraine,NA,Kherson,1046981,3,0,332,7
2020-08-23,Ukraine,NA,Kherson,1046981,2,0,334,7
2020-08-24,Ukraine,NA,Kherson,1046981,2,1,336,8
2020-08-25,Ukraine,NA,Kherson,1046981,1,0,337,8
2020-08-26,Ukraine,NA,Kherson,1046981,9,1,346,9
2020-08-27,Ukraine,NA,Kherson,1046981,17,0,363,9
2020-08-28,Ukraine,NA,Kherson,1046981,11,0,374,9
2020-08-29,Ukraine,NA,Kherson,1046981,12,2,386,11
2020-08-30,Ukraine,NA,Kherson,1046981,6,0,392,11
2020-08-31,Ukraine,NA,Kherson,1046981,4,1,396,12
2020-09-01,Ukraine,NA,Kherson,1046981,4,0,400,12
2020-09-02,Ukraine,NA,Kherson,1046981,24,1,424,13
2020-09-03,Ukraine,NA,Kherson,1046981,11,0,435,13
2020-09-04,Ukraine,NA,Kherson,1046981,9,0,444,13
2020-09-05,Ukraine,NA,Kherson,1046981,20,0,464,13
2020-09-06,Ukraine,NA,Kherson,1046981,32,1,496,14
2020-09-07,Ukraine,NA,Kherson,1046981,4,0,500,14
2020-09-08,Ukraine,NA,Kherson,1046981,18,0,518,14
2020-09-09,Ukraine,NA,Kherson,1046981,20,0,538,14
2020-09-10,Ukraine,NA,Kherson,1046981,20,0,558,14
2020-09-11,Ukraine,NA,Kherson,1046981,18,0,576,14
2020-09-12,Ukraine,NA,Kherson,1046981,20,2,596,16
2020-09-13,Ukraine,NA,Kherson,1046981,32,1,628,17
2020-09-14,Ukraine,NA,Kherson,1046981,16,0,644,17
2020-09-15,Ukraine,NA,Kherson,1046981,17,0,661,17
2020-09-16,Ukraine,NA,Kherson,1046981,41,0,702,17
2020-09-17,Ukraine,NA,Kherson,1046981,35,2,737,19
2020-09-18,Ukraine,NA,Kherson,1046981,29,1,766,20
2020-09-19,Ukraine,NA,Kherson,1046981,24,0,790,20
2020-09-20,Ukraine,NA,Kherson,1046981,23,0,813,20
2020-09-21,Ukraine,NA,Kherson,1046981,5,0,818,20
2020-09-22,Ukraine,NA,Kherson,1046981,19,0,837,20
2020-09-23,Ukraine,NA,Kherson,1046981,31,1,868,21
2020-04-08,Ukraine,NA,Khmelnytskyi,1274409,5,0,15,0
2020-04-09,Ukraine,NA,Khmelnytskyi,1274409,1,0,16,0
2020-04-10,Ukraine,NA,Khmelnytskyi,1274409,0,0,16,0
2020-04-11,Ukraine,NA,Khmelnytskyi,1274409,2,1,18,1
2020-04-12,Ukraine,NA,Khmelnytskyi,1274409,1,1,19,2
2020-04-13,Ukraine,NA,Khmelnytskyi,1274409,3,0,22,2
2020-04-14,Ukraine,NA,Khmelnytskyi,1274409,0,0,22,2
2020-04-15,Ukraine,NA,Khmelnytskyi,1274409,12,0,34,2
2020-04-16,Ukraine,NA,Khmelnytskyi,1274409,3,0,37,2
2020-04-17,Ukraine,NA,Khmelnytskyi,1274409,1,0,38,2
2020-04-18,Ukraine,NA,Khmelnytskyi,1274409,3,0,41,2
2020-04-19,Ukraine,NA,Khmelnytskyi,1274409,6,0,47,2
2020-04-20,Ukraine,NA,Khmelnytskyi,1274409,2,0,49,2
2020-04-21,Ukraine,NA,Khmelnytskyi,1274409,0,1,49,3
2020-04-22,Ukraine,NA,Khmelnytskyi,1274409,5,1,54,4
2020-04-23,Ukraine,NA,Khmelnytskyi,1274409,7,1,61,5
2020-04-24,Ukraine,NA,Khmelnytskyi,1274409,4,0,65,5
2020-04-25,Ukraine,NA,Khmelnytskyi,1274409,1,0,66,5
2020-04-26,Ukraine,NA,Khmelnytskyi,1274409,4,0,70,5
2020-04-27,Ukraine,NA,Khmelnytskyi,1274409,2,0,72,5
2020-04-28,Ukraine,NA,Khmelnytskyi,1274409,0,0,72,5
2020-04-29,Ukraine,NA,Khmelnytskyi,1274409,9,0,81,5
2020-04-30,Ukraine,NA,Khmelnytskyi,1274409,1,0,82,5
2020-05-01,Ukraine,NA,Khmelnytskyi,1274409,10,0,92,5
2020-05-02,Ukraine,NA,Khmelnytskyi,1274409,6,0,98,5
2020-05-03,Ukraine,NA,Khmelnytskyi,1274409,17,0,115,5
2020-05-04,Ukraine,NA,Khmelnytskyi,1274409,1,1,116,6
2020-05-05,Ukraine,NA,Khmelnytskyi,1274409,3,0,119,6
2020-05-06,Ukraine,NA,Khmelnytskyi,1274409,15,1,134,7
2020-05-07,Ukraine,NA,Khmelnytskyi,1274409,4,0,138,7
2020-05-08,Ukraine,NA,Khmelnytskyi,1274409,10,0,148,7
2020-05-09,Ukraine,NA,Khmelnytskyi,1274409,17,0,165,7
2020-05-10,Ukraine,NA,Khmelnytskyi,1274409,10,0,175,7
2020-05-11,Ukraine,NA,Khmelnytskyi,1274409,3,0,178,7
2020-05-12,Ukraine,NA,Khmelnytskyi,1274409,4,0,182,7
2020-05-13,Ukraine,NA,Khmelnytskyi,1274409,14,0,196,7
2020-05-14,Ukraine,NA,Khmelnytskyi,1274409,13,1,209,8
2020-05-15,Ukraine,NA,Khmelnytskyi,1274409,13,1,222,9
2020-05-16,Ukraine,NA,Khmelnytskyi,1274409,13,0,235,9
2020-05-17,Ukraine,NA,Khmelnytskyi,1274409,18,0,253,9
2020-05-18,Ukraine,NA,Khmelnytskyi,1274409,14,0,267,9
2020-05-19,Ukraine,NA,Khmelnytskyi,1274409,0,0,267,9
2020-05-20,Ukraine,NA,Khmelnytskyi,1274409,13,0,280,9
2020-05-21,Ukraine,NA,Khmelnytskyi,1274409,14,0,294,9
2020-05-22,Ukraine,NA,Khmelnytskyi,1274409,5,0,299,9
2020-05-23,Ukraine,NA,Khmelnytskyi,1274409,30,0,329,9
2020-05-24,Ukraine,NA,Khmelnytskyi,1274409,17,0,346,9
2020-05-25,Ukraine,NA,Khmelnytskyi,1274409,18,0,364,9
2020-05-26,Ukraine,NA,Khmelnytskyi,1274409,6,1,370,10
2020-05-27,Ukraine,NA,Khmelnytskyi,1274409,11,0,381,10
2020-05-28,Ukraine,NA,Khmelnytskyi,1274409,5,0,386,10
2020-05-29,Ukraine,NA,Khmelnytskyi,1274409,21,0,407,10
2020-05-30,Ukraine,NA,Khmelnytskyi,1274409,25,0,432,10
2020-05-31,Ukraine,NA,Khmelnytskyi,1274409,12,1,444,11
2020-06-01,Ukraine,NA,Khmelnytskyi,1274409,10,0,454,11
2020-06-02,Ukraine,NA,Khmelnytskyi,1274409,4,0,458,11
2020-06-03,Ukraine,NA,Khmelnytskyi,1274409,11,0,469,11
2020-06-04,Ukraine,NA,Khmelnytskyi,1274409,28,0,497,11
2020-06-05,Ukraine,NA,Khmelnytskyi,1274409,4,0,501,11
2020-06-06,Ukraine,NA,Khmelnytskyi,1274409,8,1,509,12
2020-06-07,Ukraine,NA,Khmelnytskyi,1274409,9,1,518,13
2020-06-08,Ukraine,NA,Khmelnytskyi,1274409,0,0,518,13
2020-06-09,Ukraine,NA,Khmelnytskyi,1274409,0,0,518,13
2020-06-10,Ukraine,NA,Khmelnytskyi,1274409,2,1,520,14
2020-06-11,Ukraine,NA,Khmelnytskyi,1274409,3,0,523,14
2020-06-12,Ukraine,NA,Khmelnytskyi,1274409,6,0,529,14
2020-06-13,Ukraine,NA,Khmelnytskyi,1274409,15,0,544,14
2020-06-14,Ukraine,NA,Khmelnytskyi,1274409,12,0,556,14
2020-06-15,Ukraine,NA,Khmelnytskyi,1274409,3,0,559,14
2020-06-16,Ukraine,NA,Khmelnytskyi,1274409,1,0,560,14
2020-06-17,Ukraine,NA,Khmelnytskyi,1274409,17,0,577,14
2020-06-18,Ukraine,NA,Khmelnytskyi,1274409,10,0,587,14
2020-06-19,Ukraine,NA,Khmelnytskyi,1274409,21,0,608,14
2020-06-20,Ukraine,NA,Khmelnytskyi,1274409,4,0,612,14
2020-06-21,Ukraine,NA,Khmelnytskyi,1274409,10,0,622,14
2020-06-22,Ukraine,NA,Khmelnytskyi,1274409,0,1,622,15
2020-06-23,Ukraine,NA,Khmelnytskyi,1274409,0,0,622,15
2020-06-24,Ukraine,NA,Khmelnytskyi,1274409,5,0,627,15
2020-06-25,Ukraine,NA,Khmelnytskyi,1274409,18,0,645,15
2020-06-26,Ukraine,NA,Khmelnytskyi,1274409,79,0,724,15
2020-06-27,Ukraine,NA,Khmelnytskyi,1274409,53,2,777,17
2020-06-28,Ukraine,NA,Khmelnytskyi,1274409,14,0,791,17
2020-06-29,Ukraine,NA,Khmelnytskyi,1274409,7,0,798,17
2020-06-30,Ukraine,NA,Khmelnytskyi,1274409,5,0,803,17
2020-07-01,Ukraine,NA,Khmelnytskyi,1274409,2,1,805,18
2020-07-02,Ukraine,NA,Khmelnytskyi,1274409,3,0,808,18
2020-07-03,Ukraine,NA,Khmelnytskyi,1274409,14,1,822,19
2020-07-04,Ukraine,NA,Khmelnytskyi,1274409,6,0,828,19
2020-07-05,Ukraine,NA,Khmelnytskyi,1274409,11,0,839,19
2020-07-06,Ukraine,NA,Khmelnytskyi,1274409,3,1,842,20
2020-07-07,Ukraine,NA,Khmelnytskyi,1274409,0,0,842,20
2020-07-08,Ukraine,NA,Khmelnytskyi,1274409,21,0,863,20
2020-07-09,Ukraine,NA,Khmelnytskyi,1274409,2,0,865,20
2020-07-10,Ukraine,NA,Khmelnytskyi,1274409,16,0,881,20
2020-07-11,Ukraine,NA,Khmelnytskyi,1274409,7,0,888,20
2020-07-12,Ukraine,NA,Khmelnytskyi,1274409,20,0,908,20
2020-07-13,Ukraine,NA,Khmelnytskyi,1274409,0,0,908,20
2020-07-14,Ukraine,NA,Khmelnytskyi,1274409,1,0,909,20
2020-07-15,Ukraine,NA,Khmelnytskyi,1274409,13,2,922,22
2020-07-16,Ukraine,NA,Khmelnytskyi,1274409,8,0,930,22
2020-07-17,Ukraine,NA,Khmelnytskyi,1274409,12,0,942,22
2020-07-18,Ukraine,NA,Khmelnytskyi,1274409,21,0,963,22
2020-07-19,Ukraine,NA,Khmelnytskyi,1274409,17,0,980,22
2020-07-20,Ukraine,NA,Khmelnytskyi,1274409,0,1,980,23
2020-07-21,Ukraine,NA,Khmelnytskyi,1274409,11,0,991,23
2020-07-22,Ukraine,NA,Khmelnytskyi,1274409,3,0,994,23
2020-07-23,Ukraine,NA,Khmelnytskyi,1274409,14,0,1008,23
2020-07-24,Ukraine,NA,Khmelnytskyi,1274409,13,0,1021,23
2020-07-25,Ukraine,NA,Khmelnytskyi,1274409,16,0,1037,23
2020-07-26,Ukraine,NA,Khmelnytskyi,1274409,22,0,1059,23
2020-07-27,Ukraine,NA,Khmelnytskyi,1274409,0,0,1059,23
2020-07-28,Ukraine,NA,Khmelnytskyi,1274409,10,0,1069,23
2020-07-29,Ukraine,NA,Khmelnytskyi,1274409,17,1,1086,24
2020-07-30,Ukraine,NA,Khmelnytskyi,1274409,23,0,1109,24
2020-07-31,Ukraine,NA,Khmelnytskyi,1274409,29,0,1138,24
2020-08-01,Ukraine,NA,Khmelnytskyi,1274409,25,0,1163,24
2020-08-02,Ukraine,NA,Khmelnytskyi,1274409,17,0,1180,24
2020-08-03,Ukraine,NA,Khmelnytskyi,1274409,9,0,1189,24
2020-08-04,Ukraine,NA,Khmelnytskyi,1274409,11,1,1200,25
2020-08-05,Ukraine,NA,Khmelnytskyi,1274409,32,0,1232,25
2020-08-06,Ukraine,NA,Khmelnytskyi,1274409,25,0,1257,25
2020-08-07,Ukraine,NA,Khmelnytskyi,1274409,29,0,1286,25
2020-08-08,Ukraine,NA,Khmelnytskyi,1274409,37,0,1323,25
2020-08-09,Ukraine,NA,Khmelnytskyi,1274409,23,1,1346,26
2020-08-10,Ukraine,NA,Khmelnytskyi,1274409,22,3,1368,29
2020-08-11,Ukraine,NA,Khmelnytskyi,1274409,8,1,1376,30
2020-08-12,Ukraine,NA,Khmelnytskyi,1274409,37,1,1413,31
2020-08-13,Ukraine,NA,Khmelnytskyi,1274409,55,0,1468,31
2020-08-14,Ukraine,NA,Khmelnytskyi,1274409,46,0,1514,31
2020-08-15,Ukraine,NA,Khmelnytskyi,1274409,25,0,1539,31
2020-08-16,Ukraine,NA,Khmelnytskyi,1274409,42,0,1581,31
2020-08-17,Ukraine,NA,Khmelnytskyi,1274409,37,0,1618,31
2020-08-18,Ukraine,NA,Khmelnytskyi,1274409,10,0,1628,31
2020-08-19,Ukraine,NA,Khmelnytskyi,1274409,50,2,1678,33
2020-08-20,Ukraine,NA,Khmelnytskyi,1274409,90,0,1768,33
2020-08-21,Ukraine,NA,Khmelnytskyi,1274409,60,4,1828,37
2020-08-22,Ukraine,NA,Khmelnytskyi,1274409,76,1,1904,38
2020-08-23,Ukraine,NA,Khmelnytskyi,1274409,42,0,1946,38
2020-08-24,Ukraine,NA,Khmelnytskyi,1274409,64,0,2010,38
2020-08-25,Ukraine,NA,Khmelnytskyi,1274409,37,0,2047,38
2020-08-26,Ukraine,NA,Khmelnytskyi,1274409,15,3,2062,41
2020-08-27,Ukraine,NA,Khmelnytskyi,1274409,40,0,2102,41
2020-08-28,Ukraine,NA,Khmelnytskyi,1274409,92,0,2194,41
2020-08-29,Ukraine,NA,Khmelnytskyi,1274409,103,2,2297,43
2020-08-30,Ukraine,NA,Khmelnytskyi,1274409,105,0,2402,43
2020-08-31,Ukraine,NA,Khmelnytskyi,1274409,79,2,2481,45
2020-09-01,Ukraine,NA,Khmelnytskyi,1274409,38,1,2519,46
2020-09-02,Ukraine,NA,Khmelnytskyi,1274409,111,1,2630,47
2020-09-03,Ukraine,NA,Khmelnytskyi,1274409,110,5,2740,52
2020-09-04,Ukraine,NA,Khmelnytskyi,1274409,108,0,2848,52
2020-09-05,Ukraine,NA,Khmelnytskyi,1274409,131,0,2979,52
2020-09-06,Ukraine,NA,Khmelnytskyi,1274409,121,0,3100,52
2020-09-07,Ukraine,NA,Khmelnytskyi,1274409,95,0,3195,52
2020-09-08,Ukraine,NA,Khmelnytskyi,1274409,58,4,3253,56
2020-09-09,Ukraine,NA,Khmelnytskyi,1274409,102,0,3355,56
2020-09-10,Ukraine,NA,Khmelnytskyi,1274409,142,3,3497,59
2020-09-11,Ukraine,NA,Khmelnytskyi,1274409,198,2,3695,61
2020-09-12,Ukraine,NA,Khmelnytskyi,1274409,155,15,3850,76
2020-09-13,Ukraine,NA,Khmelnytskyi,1274409,118,2,3968,78
2020-09-14,Ukraine,NA,Khmelnytskyi,1274409,40,1,4008,79
2020-09-15,Ukraine,NA,Khmelnytskyi,1274409,50,3,4058,82
2020-09-16,Ukraine,NA,Khmelnytskyi,1274409,75,3,4133,85
2020-09-17,Ukraine,NA,Khmelnytskyi,1274409,65,1,4198,86
2020-09-18,Ukraine,NA,Khmelnytskyi,1274409,141,3,4339,89
2020-09-19,Ukraine,NA,Khmelnytskyi,1274409,142,1,4481,90
2020-09-20,Ukraine,NA,Khmelnytskyi,1274409,150,2,4631,92
2020-09-21,Ukraine,NA,Khmelnytskyi,1274409,192,1,4823,93
2020-09-22,Ukraine,NA,Khmelnytskyi,1274409,114,2,4937,95
2020-09-23,Ukraine,NA,Khmelnytskyi,1274409,112,1,5049,96
2020-03-22,Ukraine,NA,Kiev,2967000,20,0,29,0
2020-03-23,Ukraine,NA,Kiev,2967000,0,0,29,0
2020-03-24,Ukraine,NA,Kiev,2967000,0,0,29,0
2020-03-25,Ukraine,NA,Kiev,2967000,5,0,34,0
2020-03-26,Ukraine,NA,Kiev,2967000,0,0,34,0
2020-03-27,Ukraine,NA,Kiev,2967000,21,0,55,0
2020-03-28,Ukraine,NA,Kiev,2967000,19,0,74,0
2020-03-29,Ukraine,NA,Kiev,2967000,8,0,82,0
2020-03-30,Ukraine,NA,Kiev,2967000,20,0,102,0
2020-03-31,Ukraine,NA,Kiev,2967000,21,0,123,0
2020-04-01,Ukraine,NA,Kiev,2967000,37,0,160,0
2020-04-02,Ukraine,NA,Kiev,2967000,20,0,180,0
2020-04-03,Ukraine,NA,Kiev,2967000,7,0,187,0
2020-04-04,Ukraine,NA,Kiev,2967000,36,3,223,3
2020-04-05,Ukraine,NA,Kiev,2967000,2,1,225,4
2020-04-06,Ukraine,NA,Kiev,2967000,9,0,234,4
2020-04-07,Ukraine,NA,Kiev,2967000,19,0,253,4
2020-04-08,Ukraine,NA,Kiev,2967000,3,1,256,5
2020-04-09,Ukraine,NA,Kiev,2967000,44,0,300,5
2020-04-10,Ukraine,NA,Kiev,2967000,48,1,348,6
2020-04-11,Ukraine,NA,Kiev,2967000,48,0,396,6
2020-04-12,Ukraine,NA,Kiev,2967000,20,0,416,6
2020-04-13,Ukraine,NA,Kiev,2967000,79,3,495,9
2020-04-14,Ukraine,NA,Kiev,2967000,56,1,551,10
2020-04-15,Ukraine,NA,Kiev,2967000,61,1,612,11
2020-04-16,Ukraine,NA,Kiev,2967000,32,1,644,12
2020-04-17,Ukraine,NA,Kiev,2967000,61,0,705,12
2020-04-18,Ukraine,NA,Kiev,2967000,65,2,770,14
2020-04-19,Ukraine,NA,Kiev,2967000,31,1,801,15
2020-04-20,Ukraine,NA,Kiev,2967000,49,2,850,17
2020-04-21,Ukraine,NA,Kiev,2967000,42,2,892,19
2020-04-22,Ukraine,NA,Kiev,2967000,97,0,989,19
2020-04-23,Ukraine,NA,Kiev,2967000,70,1,1059,20
2020-04-24,Ukraine,NA,Kiev,2967000,63,0,1122,20
2020-04-25,Ukraine,NA,Kiev,2967000,37,1,1159,21
2020-04-26,Ukraine,NA,Kiev,2967000,29,1,1188,22
2020-04-27,Ukraine,NA,Kiev,2967000,32,1,1220,23
2020-04-28,Ukraine,NA,Kiev,2967000,78,0,1298,23
2020-04-29,Ukraine,NA,Kiev,2967000,43,1,1341,24
2020-04-30,Ukraine,NA,Kiev,2967000,60,1,1401,25
2020-05-01,Ukraine,NA,Kiev,2967000,52,0,1453,25
2020-05-02,Ukraine,NA,Kiev,2967000,41,0,1494,25
2020-05-03,Ukraine,NA,Kiev,2967000,17,1,1511,26
2020-05-04,Ukraine,NA,Kiev,2967000,24,1,1535,27
2020-05-05,Ukraine,NA,Kiev,2967000,48,1,1583,28
2020-05-06,Ukraine,NA,Kiev,2967000,68,0,1651,28
2020-05-07,Ukraine,NA,Kiev,2967000,24,1,1675,29
2020-05-08,Ukraine,NA,Kiev,2967000,46,3,1721,32
2020-05-09,Ukraine,NA,Kiev,2967000,50,2,1771,34
2020-05-10,Ukraine,NA,Kiev,2967000,34,3,1805,37
2020-05-11,Ukraine,NA,Kiev,2967000,66,0,1871,37
2020-05-12,Ukraine,NA,Kiev,2967000,59,1,1930,38
2020-05-13,Ukraine,NA,Kiev,2967000,30,2,1960,40
2020-05-14,Ukraine,NA,Kiev,2967000,52,2,2012,42
2020-05-15,Ukraine,NA,Kiev,2967000,56,1,2068,43
2020-05-16,Ukraine,NA,Kiev,2967000,153,2,2221,45
2020-05-17,Ukraine,NA,Kiev,2967000,59,3,2280,48
2020-05-18,Ukraine,NA,Kiev,2967000,41,1,2321,49
2020-05-19,Ukraine,NA,Kiev,2967000,38,3,2359,52
2020-05-20,Ukraine,NA,Kiev,2967000,51,2,2410,54
2020-05-21,Ukraine,NA,Kiev,2967000,65,3,2475,57
2020-05-22,Ukraine,NA,Kiev,2967000,47,1,2522,58
2020-05-23,Ukraine,NA,Kiev,2967000,47,0,2569,58
2020-05-24,Ukraine,NA,Kiev,2967000,54,1,2623,59
2020-05-25,Ukraine,NA,Kiev,2967000,29,1,2652,60
2020-05-26,Ukraine,NA,Kiev,2967000,58,1,2710,61
2020-05-27,Ukraine,NA,Kiev,2967000,29,3,2739,64
2020-05-28,Ukraine,NA,Kiev,2967000,54,0,2793,64
2020-05-29,Ukraine,NA,Kiev,2967000,56,1,2849,65
2020-05-30,Ukraine,NA,Kiev,2967000,55,1,2904,66
2020-05-31,Ukraine,NA,Kiev,2967000,81,0,2985,66
2020-06-01,Ukraine,NA,Kiev,2967000,58,2,3043,68
2020-06-02,Ukraine,NA,Kiev,2967000,28,1,3071,69
2020-06-03,Ukraine,NA,Kiev,2967000,62,0,3133,69
2020-06-04,Ukraine,NA,Kiev,2967000,77,0,3210,69
2020-06-05,Ukraine,NA,Kiev,2967000,82,4,3292,73
2020-06-06,Ukraine,NA,Kiev,2967000,83,2,3375,75
2020-06-07,Ukraine,NA,Kiev,2967000,43,2,3418,77
2020-06-08,Ukraine,NA,Kiev,2967000,72,0,3490,77
2020-06-09,Ukraine,NA,Kiev,2967000,33,2,3523,79
2020-06-10,Ukraine,NA,Kiev,2967000,57,1,3580,80
2020-06-11,Ukraine,NA,Kiev,2967000,91,4,3671,84
2020-06-12,Ukraine,NA,Kiev,2967000,95,1,3766,85
2020-06-13,Ukraine,NA,Kiev,2967000,72,2,3838,87
2020-06-14,Ukraine,NA,Kiev,2967000,66,1,3904,88
2020-06-15,Ukraine,NA,Kiev,2967000,53,2,3957,90
2020-06-16,Ukraine,NA,Kiev,2967000,28,2,3985,92
2020-06-17,Ukraine,NA,Kiev,2967000,41,2,4026,94
2020-06-18,Ukraine,NA,Kiev,2967000,58,1,4084,95
2020-06-19,Ukraine,NA,Kiev,2967000,92,1,4176,96
2020-06-20,Ukraine,NA,Kiev,2967000,76,1,4252,97
2020-06-21,Ukraine,NA,Kiev,2967000,73,1,4325,98
2020-06-22,Ukraine,NA,Kiev,2967000,43,0,4368,98
2020-06-23,Ukraine,NA,Kiev,2967000,61,3,4429,101
2020-06-24,Ukraine,NA,Kiev,2967000,99,0,4528,101
2020-06-25,Ukraine,NA,Kiev,2967000,85,0,4613,101
2020-06-26,Ukraine,NA,Kiev,2967000,113,1,4726,102
2020-06-27,Ukraine,NA,Kiev,2967000,140,0,4866,102
2020-06-28,Ukraine,NA,Kiev,2967000,69,4,4935,106
2020-06-29,Ukraine,NA,Kiev,2967000,45,2,4980,108
2020-06-30,Ukraine,NA,Kiev,2967000,57,0,5037,108
2020-07-01,Ukraine,NA,Kiev,2967000,101,0,5138,108
2020-07-02,Ukraine,NA,Kiev,2967000,104,3,5242,111
2020-07-03,Ukraine,NA,Kiev,2967000,105,1,5347,112
2020-07-04,Ukraine,NA,Kiev,2967000,118,2,5465,114
2020-07-05,Ukraine,NA,Kiev,2967000,78,0,5543,114
2020-07-06,Ukraine,NA,Kiev,2967000,59,2,5602,116
2020-07-07,Ukraine,NA,Kiev,2967000,63,3,5665,119
2020-07-08,Ukraine,NA,Kiev,2967000,114,0,5779,119
2020-07-09,Ukraine,NA,Kiev,2967000,93,3,5872,122
2020-07-10,Ukraine,NA,Kiev,2967000,118,0,5990,122
2020-07-11,Ukraine,NA,Kiev,2967000,125,2,6115,124
2020-07-12,Ukraine,NA,Kiev,2967000,67,0,6182,124
2020-07-13,Ukraine,NA,Kiev,2967000,56,0,6238,124
2020-07-14,Ukraine,NA,Kiev,2967000,112,1,6350,125
2020-07-15,Ukraine,NA,Kiev,2967000,147,1,6497,126
2020-07-16,Ukraine,NA,Kiev,2967000,116,0,6613,126
2020-07-17,Ukraine,NA,Kiev,2967000,76,0,6689,126
2020-07-18,Ukraine,NA,Kiev,2967000,108,2,6797,128
2020-07-19,Ukraine,NA,Kiev,2967000,87,0,6884,128
2020-07-20,Ukraine,NA,Kiev,2967000,77,0,6961,128
2020-07-21,Ukraine,NA,Kiev,2967000,73,0,7034,128
2020-07-22,Ukraine,NA,Kiev,2967000,132,0,7166,128
2020-07-23,Ukraine,NA,Kiev,2967000,112,0,7278,128
2020-07-24,Ukraine,NA,Kiev,2967000,118,1,7396,129
2020-07-25,Ukraine,NA,Kiev,2967000,129,0,7525,129
2020-07-26,Ukraine,NA,Kiev,2967000,95,0,7620,129
2020-07-27,Ukraine,NA,Kiev,2967000,70,0,7690,129
2020-07-28,Ukraine,NA,Kiev,2967000,110,1,7800,130
2020-07-29,Ukraine,NA,Kiev,2967000,132,2,7932,132
2020-07-30,Ukraine,NA,Kiev,2967000,199,0,8131,132
2020-07-31,Ukraine,NA,Kiev,2967000,110,0,8241,132
2020-08-01,Ukraine,NA,Kiev,2967000,101,2,8342,134
2020-08-02,Ukraine,NA,Kiev,2967000,110,0,8452,134
2020-08-03,Ukraine,NA,Kiev,2967000,102,1,8554,135
2020-08-04,Ukraine,NA,Kiev,2967000,108,3,8662,138
2020-08-05,Ukraine,NA,Kiev,2967000,150,1,8812,139
2020-08-06,Ukraine,NA,Kiev,2967000,180,3,8992,142
2020-08-07,Ukraine,NA,Kiev,2967000,186,0,9178,142
2020-08-08,Ukraine,NA,Kiev,2967000,200,3,9378,145
2020-08-09,Ukraine,NA,Kiev,2967000,120,2,9498,147
2020-08-10,Ukraine,NA,Kiev,2967000,66,0,9564,147
2020-08-11,Ukraine,NA,Kiev,2967000,123,0,9687,147
2020-08-12,Ukraine,NA,Kiev,2967000,182,0,9869,147
2020-08-13,Ukraine,NA,Kiev,2967000,133,2,10002,149
2020-08-14,Ukraine,NA,Kiev,2967000,158,1,10160,150
2020-08-15,Ukraine,NA,Kiev,2967000,232,1,10392,151
2020-08-16,Ukraine,NA,Kiev,2967000,146,2,10538,153
2020-08-17,Ukraine,NA,Kiev,2967000,104,1,10642,154
2020-08-18,Ukraine,NA,Kiev,2967000,88,1,10730,155
2020-08-19,Ukraine,NA,Kiev,2967000,215,0,10945,155
2020-08-20,Ukraine,NA,Kiev,2967000,227,3,11172,158
2020-08-21,Ukraine,NA,Kiev,2967000,156,0,11328,158
2020-08-22,Ukraine,NA,Kiev,2967000,179,7,11507,165
2020-08-23,Ukraine,NA,Kiev,2967000,307,2,11814,167
2020-08-24,Ukraine,NA,Kiev,2967000,209,3,12023,170
2020-08-25,Ukraine,NA,Kiev,2967000,130,2,12153,172
2020-08-26,Ukraine,NA,Kiev,2967000,95,2,12248,174
2020-08-27,Ukraine,NA,Kiev,2967000,220,4,12468,178
2020-08-28,Ukraine,NA,Kiev,2967000,251,9,12719,187
2020-08-29,Ukraine,NA,Kiev,2967000,265,6,12984,193
2020-08-30,Ukraine,NA,Kiev,2967000,109,9,13093,202
2020-08-31,Ukraine,NA,Kiev,2967000,277,6,13370,208
2020-09-01,Ukraine,NA,Kiev,2967000,176,5,13546,213
2020-09-02,Ukraine,NA,Kiev,2967000,332,5,13878,218
2020-09-03,Ukraine,NA,Kiev,2967000,280,4,14158,222
2020-09-04,Ukraine,NA,Kiev,2967000,319,8,14477,230
2020-09-05,Ukraine,NA,Kiev,2967000,315,4,14792,234
2020-09-06,Ukraine,NA,Kiev,2967000,240,6,15032,240
2020-09-07,Ukraine,NA,Kiev,2967000,244,2,15276,242
2020-09-08,Ukraine,NA,Kiev,2967000,235,4,15511,246
2020-09-09,Ukraine,NA,Kiev,2967000,310,4,15821,250
2020-09-10,Ukraine,NA,Kiev,2967000,298,4,16119,254
2020-09-11,Ukraine,NA,Kiev,2967000,404,7,16523,261
2020-09-12,Ukraine,NA,Kiev,2967000,428,5,16951,266
2020-09-13,Ukraine,NA,Kiev,2967000,310,3,17261,269
2020-09-14,Ukraine,NA,Kiev,2967000,168,3,17429,272
2020-09-15,Ukraine,NA,Kiev,2967000,285,11,17714,283
2020-09-16,Ukraine,NA,Kiev,2967000,356,8,18070,291
2020-09-17,Ukraine,NA,Kiev,2967000,379,5,18449,296
2020-09-18,Ukraine,NA,Kiev,2967000,291,8,18740,304
2020-09-19,Ukraine,NA,Kiev,2967000,400,8,19140,312
2020-09-20,Ukraine,NA,Kiev,2967000,343,4,19483,316
2020-09-21,Ukraine,NA,Kiev,2967000,275,2,19758,318
2020-09-22,Ukraine,NA,Kiev,2967000,270,7,20028,325
2020-09-23,Ukraine,NA,Kiev,2967000,307,5,20335,330
2020-03-24,Ukraine,NA,Kiev Oblast,1754284,10,0,15,0
2020-03-25,Ukraine,NA,Kiev Oblast,1754284,9,0,24,0
2020-03-26,Ukraine,NA,Kiev Oblast,1754284,0,0,24,0
2020-03-27,Ukraine,NA,Kiev Oblast,1754284,8,0,32,0
2020-03-28,Ukraine,NA,Kiev Oblast,1754284,9,0,41,0
2020-03-29,Ukraine,NA,Kiev Oblast,1754284,4,0,45,0
2020-03-30,Ukraine,NA,Kiev Oblast,1754284,4,2,49,2
2020-03-31,Ukraine,NA,Kiev Oblast,1754284,8,1,57,3
2020-04-01,Ukraine,NA,Kiev Oblast,1754284,7,0,64,3
2020-04-02,Ukraine,NA,Kiev Oblast,1754284,3,1,67,4
2020-04-03,Ukraine,NA,Kiev Oblast,1754284,5,0,72,4
2020-04-04,Ukraine,NA,Kiev Oblast,1754284,10,0,82,4
2020-04-05,Ukraine,NA,Kiev Oblast,1754284,0,1,82,5
2020-04-06,Ukraine,NA,Kiev Oblast,1754284,9,0,91,5
2020-04-07,Ukraine,NA,Kiev Oblast,1754284,6,0,97,5
2020-04-08,Ukraine,NA,Kiev Oblast,1754284,23,0,120,5
2020-04-09,Ukraine,NA,Kiev Oblast,1754284,10,0,130,5
2020-04-10,Ukraine,NA,Kiev Oblast,1754284,10,0,140,5
2020-04-11,Ukraine,NA,Kiev Oblast,1754284,9,0,149,5
2020-04-12,Ukraine,NA,Kiev Oblast,1754284,10,0,159,5
2020-04-13,Ukraine,NA,Kiev Oblast,1754284,57,0,216,5
2020-04-14,Ukraine,NA,Kiev Oblast,1754284,8,2,224,7
2020-04-15,Ukraine,NA,Kiev Oblast,1754284,6,2,230,9
2020-04-16,Ukraine,NA,Kiev Oblast,1754284,4,0,234,9
2020-04-17,Ukraine,NA,Kiev Oblast,1754284,19,0,253,9
2020-04-18,Ukraine,NA,Kiev Oblast,1754284,27,0,280,9
2020-04-19,Ukraine,NA,Kiev Oblast,1754284,24,2,304,11
2020-04-20,Ukraine,NA,Kiev Oblast,1754284,29,0,333,11
2020-04-21,Ukraine,NA,Kiev Oblast,1754284,23,0,356,11
2020-04-22,Ukraine,NA,Kiev Oblast,1754284,34,0,390,11
2020-04-23,Ukraine,NA,Kiev Oblast,1754284,61,1,451,12
2020-04-24,Ukraine,NA,Kiev Oblast,1754284,54,0,505,12
2020-04-25,Ukraine,NA,Kiev Oblast,1754284,14,0,519,12
2020-04-26,Ukraine,NA,Kiev Oblast,1754284,23,0,542,12
2020-04-27,Ukraine,NA,Kiev Oblast,1754284,28,1,570,13
2020-04-28,Ukraine,NA,Kiev Oblast,1754284,34,0,604,13
2020-04-29,Ukraine,NA,Kiev Oblast,1754284,39,2,643,15
2020-04-30,Ukraine,NA,Kiev Oblast,1754284,21,0,664,15
2020-05-01,Ukraine,NA,Kiev Oblast,1754284,30,2,694,17
2020-05-02,Ukraine,NA,Kiev Oblast,1754284,53,0,747,17
2020-05-03,Ukraine,NA,Kiev Oblast,1754284,37,0,784,17
2020-05-04,Ukraine,NA,Kiev Oblast,1754284,69,0,853,17
2020-05-05,Ukraine,NA,Kiev Oblast,1754284,13,0,866,17
2020-05-06,Ukraine,NA,Kiev Oblast,1754284,25,0,891,17
2020-05-07,Ukraine,NA,Kiev Oblast,1754284,25,2,916,19
2020-05-08,Ukraine,NA,Kiev Oblast,1754284,19,1,935,20
2020-05-09,Ukraine,NA,Kiev Oblast,1754284,24,0,959,20
2020-05-10,Ukraine,NA,Kiev Oblast,1754284,13,0,972,20
2020-05-11,Ukraine,NA,Kiev Oblast,1754284,28,0,1000,20
2020-05-12,Ukraine,NA,Kiev Oblast,1754284,23,2,1023,22
2020-05-13,Ukraine,NA,Kiev Oblast,1754284,26,2,1049,24
2020-05-14,Ukraine,NA,Kiev Oblast,1754284,18,0,1067,24
2020-05-15,Ukraine,NA,Kiev Oblast,1754284,27,2,1094,26
2020-05-16,Ukraine,NA,Kiev Oblast,1754284,49,0,1143,26
2020-05-17,Ukraine,NA,Kiev Oblast,1754284,54,0,1197,26
2020-05-18,Ukraine,NA,Kiev Oblast,1754284,27,3,1224,29
2020-05-19,Ukraine,NA,Kiev Oblast,1754284,21,0,1245,29
2020-05-20,Ukraine,NA,Kiev Oblast,1754284,16,0,1261,29
2020-05-21,Ukraine,NA,Kiev Oblast,1754284,55,0,1316,29
2020-05-22,Ukraine,NA,Kiev Oblast,1754284,28,1,1344,30
2020-05-23,Ukraine,NA,Kiev Oblast,1754284,31,0,1375,30
2020-05-24,Ukraine,NA,Kiev Oblast,1754284,44,0,1419,30
2020-05-25,Ukraine,NA,Kiev Oblast,1754284,18,0,1437,30
2020-05-26,Ukraine,NA,Kiev Oblast,1754284,21,0,1458,30
2020-05-27,Ukraine,NA,Kiev Oblast,1754284,16,0,1474,30
2020-05-28,Ukraine,NA,Kiev Oblast,1754284,43,0,1517,30
2020-05-29,Ukraine,NA,Kiev Oblast,1754284,18,0,1535,30
2020-05-30,Ukraine,NA,Kiev Oblast,1754284,21,3,1556,33
2020-05-31,Ukraine,NA,Kiev Oblast,1754284,17,1,1573,34
2020-06-01,Ukraine,NA,Kiev Oblast,1754284,27,1,1600,35
2020-06-02,Ukraine,NA,Kiev Oblast,1754284,23,1,1623,36
2020-06-03,Ukraine,NA,Kiev Oblast,1754284,29,0,1652,36
2020-06-04,Ukraine,NA,Kiev Oblast,1754284,21,1,1673,37
2020-06-05,Ukraine,NA,Kiev Oblast,1754284,38,0,1711,37
2020-06-06,Ukraine,NA,Kiev Oblast,1754284,37,0,1748,37
2020-06-07,Ukraine,NA,Kiev Oblast,1754284,36,0,1784,37
2020-06-08,Ukraine,NA,Kiev Oblast,1754284,28,0,1812,37
2020-06-09,Ukraine,NA,Kiev Oblast,1754284,24,0,1836,37
2020-06-10,Ukraine,NA,Kiev Oblast,1754284,29,1,1865,38
2020-06-11,Ukraine,NA,Kiev Oblast,1754284,54,0,1919,38
2020-06-12,Ukraine,NA,Kiev Oblast,1754284,12,0,1931,38
2020-06-13,Ukraine,NA,Kiev Oblast,1754284,30,0,1961,38
2020-06-14,Ukraine,NA,Kiev Oblast,1754284,34,1,1995,39
2020-06-15,Ukraine,NA,Kiev Oblast,1754284,29,0,2024,39
2020-06-16,Ukraine,NA,Kiev Oblast,1754284,25,0,2049,39
2020-06-17,Ukraine,NA,Kiev Oblast,1754284,29,0,2078,39
2020-06-18,Ukraine,NA,Kiev Oblast,1754284,41,4,2119,43
2020-06-19,Ukraine,NA,Kiev Oblast,1754284,23,1,2142,44
2020-06-20,Ukraine,NA,Kiev Oblast,1754284,32,2,2174,46
2020-06-21,Ukraine,NA,Kiev Oblast,1754284,34,0,2208,46
2020-06-22,Ukraine,NA,Kiev Oblast,1754284,28,0,2236,46
2020-06-23,Ukraine,NA,Kiev Oblast,1754284,49,1,2285,47
2020-06-24,Ukraine,NA,Kiev Oblast,1754284,47,0,2332,47
2020-06-25,Ukraine,NA,Kiev Oblast,1754284,41,1,2373,48
2020-06-26,Ukraine,NA,Kiev Oblast,1754284,46,0,2419,48
2020-06-27,Ukraine,NA,Kiev Oblast,1754284,50,1,2469,49
2020-06-28,Ukraine,NA,Kiev Oblast,1754284,37,0,2506,49
2020-06-29,Ukraine,NA,Kiev Oblast,1754284,40,1,2546,50
2020-06-30,Ukraine,NA,Kiev Oblast,1754284,39,0,2585,50
2020-07-01,Ukraine,NA,Kiev Oblast,1754284,25,0,2610,50
2020-07-02,Ukraine,NA,Kiev Oblast,1754284,45,1,2655,51
2020-07-03,Ukraine,NA,Kiev Oblast,1754284,47,0,2702,51
2020-07-04,Ukraine,NA,Kiev Oblast,1754284,45,0,2747,51
2020-07-05,Ukraine,NA,Kiev Oblast,1754284,27,2,2774,53
2020-07-06,Ukraine,NA,Kiev Oblast,1754284,15,1,2789,54
2020-07-07,Ukraine,NA,Kiev Oblast,1754284,20,1,2809,55
2020-07-08,Ukraine,NA,Kiev Oblast,1754284,44,0,2853,55
2020-07-09,Ukraine,NA,Kiev Oblast,1754284,42,0,2895,55
2020-07-10,Ukraine,NA,Kiev Oblast,1754284,45,0,2940,55
2020-07-11,Ukraine,NA,Kiev Oblast,1754284,46,2,2986,57
2020-07-12,Ukraine,NA,Kiev Oblast,1754284,40,0,3026,57
2020-07-13,Ukraine,NA,Kiev Oblast,1754284,42,1,3068,58
2020-07-14,Ukraine,NA,Kiev Oblast,1754284,22,0,3090,58
2020-07-15,Ukraine,NA,Kiev Oblast,1754284,38,0,3128,58
2020-07-16,Ukraine,NA,Kiev Oblast,1754284,16,1,3144,59
2020-07-17,Ukraine,NA,Kiev Oblast,1754284,40,0,3184,59
2020-07-18,Ukraine,NA,Kiev Oblast,1754284,45,0,3229,59
2020-07-19,Ukraine,NA,Kiev Oblast,1754284,42,0,3271,59
2020-07-20,Ukraine,NA,Kiev Oblast,1754284,37,0,3308,59
2020-07-21,Ukraine,NA,Kiev Oblast,1754284,24,0,3332,59
2020-07-22,Ukraine,NA,Kiev Oblast,1754284,27,0,3359,59
2020-07-23,Ukraine,NA,Kiev Oblast,1754284,32,0,3391,59
2020-07-24,Ukraine,NA,Kiev Oblast,1754284,30,0,3421,59
2020-07-25,Ukraine,NA,Kiev Oblast,1754284,40,0,3461,59
2020-07-26,Ukraine,NA,Kiev Oblast,1754284,42,1,3503,60
2020-07-27,Ukraine,NA,Kiev Oblast,1754284,45,0,3548,60
2020-07-28,Ukraine,NA,Kiev Oblast,1754284,42,0,3590,60
2020-07-29,Ukraine,NA,Kiev Oblast,1754284,39,0,3629,60
2020-07-30,Ukraine,NA,Kiev Oblast,1754284,43,2,3672,62
2020-07-31,Ukraine,NA,Kiev Oblast,1754284,44,1,3716,63
2020-08-01,Ukraine,NA,Kiev Oblast,1754284,71,1,3787,64
2020-08-02,Ukraine,NA,Kiev Oblast,1754284,36,0,3823,64
2020-08-03,Ukraine,NA,Kiev Oblast,1754284,22,0,3845,64
2020-08-04,Ukraine,NA,Kiev Oblast,1754284,32,1,3877,65
2020-08-05,Ukraine,NA,Kiev Oblast,1754284,65,1,3942,66
2020-08-06,Ukraine,NA,Kiev Oblast,1754284,38,1,3980,67
2020-08-07,Ukraine,NA,Kiev Oblast,1754284,78,0,4058,67
2020-08-08,Ukraine,NA,Kiev Oblast,1754284,70,1,4128,68
2020-08-09,Ukraine,NA,Kiev Oblast,1754284,48,0,4176,68
2020-08-10,Ukraine,NA,Kiev Oblast,1754284,21,1,4197,69
2020-08-11,Ukraine,NA,Kiev Oblast,1754284,42,1,4239,70
2020-08-12,Ukraine,NA,Kiev Oblast,1754284,68,1,4307,71
2020-08-13,Ukraine,NA,Kiev Oblast,1754284,70,1,4377,72
2020-08-14,Ukraine,NA,Kiev Oblast,1754284,52,4,4429,76
2020-08-15,Ukraine,NA,Kiev Oblast,1754284,66,3,4495,79
2020-08-16,Ukraine,NA,Kiev Oblast,1754284,35,0,4530,79
2020-08-17,Ukraine,NA,Kiev Oblast,1754284,24,0,4554,79
2020-08-18,Ukraine,NA,Kiev Oblast,1754284,66,1,4620,80
2020-08-19,Ukraine,NA,Kiev Oblast,1754284,65,1,4685,81
2020-08-20,Ukraine,NA,Kiev Oblast,1754284,42,2,4727,83
2020-08-21,Ukraine,NA,Kiev Oblast,1754284,78,0,4805,83
2020-08-22,Ukraine,NA,Kiev Oblast,1754284,76,1,4881,84
2020-08-23,Ukraine,NA,Kiev Oblast,1754284,71,0,4952,84
2020-08-24,Ukraine,NA,Kiev Oblast,1754284,73,0,5025,84
2020-08-25,Ukraine,NA,Kiev Oblast,1754284,90,0,5115,84
2020-08-26,Ukraine,NA,Kiev Oblast,1754284,96,1,5211,85
2020-08-27,Ukraine,NA,Kiev Oblast,1754284,94,6,5305,91
2020-08-28,Ukraine,NA,Kiev Oblast,1754284,92,2,5397,93
2020-08-29,Ukraine,NA,Kiev Oblast,1754284,92,2,5489,95
2020-08-30,Ukraine,NA,Kiev Oblast,1754284,91,1,5580,96
2020-08-31,Ukraine,NA,Kiev Oblast,1754284,89,0,5669,96
2020-09-01,Ukraine,NA,Kiev Oblast,1754284,86,1,5755,97
2020-09-02,Ukraine,NA,Kiev Oblast,1754284,87,5,5842,102
2020-09-03,Ukraine,NA,Kiev Oblast,1754284,89,0,5931,102
2020-09-04,Ukraine,NA,Kiev Oblast,1754284,86,7,6017,109
2020-09-05,Ukraine,NA,Kiev Oblast,1754284,88,5,6105,114
2020-09-06,Ukraine,NA,Kiev Oblast,1754284,87,2,6192,116
2020-09-07,Ukraine,NA,Kiev Oblast,1754284,86,0,6278,116
2020-09-08,Ukraine,NA,Kiev Oblast,1754284,92,1,6370,117
2020-09-09,Ukraine,NA,Kiev Oblast,1754284,89,5,6459,122
2020-09-10,Ukraine,NA,Kiev Oblast,1754284,95,2,6554,124
2020-09-11,Ukraine,NA,Kiev Oblast,1754284,94,4,6648,128
2020-09-12,Ukraine,NA,Kiev Oblast,1754284,102,6,6750,134
2020-09-13,Ukraine,NA,Kiev Oblast,1754284,99,1,6849,135
2020-09-14,Ukraine,NA,Kiev Oblast,1754284,112,1,6961,136
2020-09-15,Ukraine,NA,Kiev Oblast,1754284,118,2,7079,138
2020-09-16,Ukraine,NA,Kiev Oblast,1754284,128,4,7207,142
2020-09-17,Ukraine,NA,Kiev Oblast,1754284,135,4,7342,146
2020-09-18,Ukraine,NA,Kiev Oblast,1754284,134,4,7476,150
2020-09-19,Ukraine,NA,Kiev Oblast,1754284,135,6,7611,156
2020-09-20,Ukraine,NA,Kiev Oblast,1754284,133,3,7744,159
2020-09-21,Ukraine,NA,Kiev Oblast,1754284,136,0,7880,159
2020-09-22,Ukraine,NA,Kiev Oblast,1754284,140,2,8020,161
2020-09-23,Ukraine,NA,Kiev Oblast,1754284,128,4,8148,165
2020-04-02,Ukraine,NA,Kirovohrad,956250,6,0,13,0
2020-04-03,Ukraine,NA,Kirovohrad,956250,2,0,15,0
2020-04-04,Ukraine,NA,Kirovohrad,956250,9,0,24,0
2020-04-05,Ukraine,NA,Kirovohrad,956250,13,1,37,1
2020-04-06,Ukraine,NA,Kirovohrad,956250,4,0,41,1
2020-04-07,Ukraine,NA,Kirovohrad,956250,12,0,53,1
2020-04-08,Ukraine,NA,Kirovohrad,956250,4,0,57,1
2020-04-09,Ukraine,NA,Kirovohrad,956250,21,2,78,3
2020-04-10,Ukraine,NA,Kirovohrad,956250,28,3,106,6
2020-04-11,Ukraine,NA,Kirovohrad,956250,0,0,106,6
2020-04-12,Ukraine,NA,Kirovohrad,956250,36,1,142,7
2020-04-13,Ukraine,NA,Kirovohrad,956250,2,0,144,7
2020-04-14,Ukraine,NA,Kirovohrad,956250,48,1,192,8
2020-04-15,Ukraine,NA,Kirovohrad,956250,0,0,192,8
2020-04-16,Ukraine,NA,Kirovohrad,956250,6,1,198,9
2020-04-17,Ukraine,NA,Kirovohrad,956250,20,0,218,9
2020-04-18,Ukraine,NA,Kirovohrad,956250,16,2,234,11
2020-04-19,Ukraine,NA,Kirovohrad,956250,11,1,245,12
2020-04-20,Ukraine,NA,Kirovohrad,956250,1,1,246,13
2020-04-21,Ukraine,NA,Kirovohrad,956250,1,0,247,13
2020-04-22,Ukraine,NA,Kirovohrad,956250,4,0,251,13
2020-04-23,Ukraine,NA,Kirovohrad,956250,7,1,258,14
2020-04-24,Ukraine,NA,Kirovohrad,956250,25,0,283,14
2020-04-25,Ukraine,NA,Kirovohrad,956250,23,1,306,15
2020-04-26,Ukraine,NA,Kirovohrad,956250,17,1,323,16
2020-04-27,Ukraine,NA,Kirovohrad,956250,14,1,337,17
2020-04-28,Ukraine,NA,Kirovohrad,956250,19,0,356,17
2020-04-29,Ukraine,NA,Kirovohrad,956250,21,0,377,17
2020-04-30,Ukraine,NA,Kirovohrad,956250,14,1,391,18
2020-05-01,Ukraine,NA,Kirovohrad,956250,1,1,392,19
2020-05-02,Ukraine,NA,Kirovohrad,956250,2,0,394,19
2020-05-03,Ukraine,NA,Kirovohrad,956250,3,0,397,19
2020-05-04,Ukraine,NA,Kirovohrad,956250,4,0,401,19
2020-05-05,Ukraine,NA,Kirovohrad,956250,0,0,401,19
2020-05-06,Ukraine,NA,Kirovohrad,956250,1,0,402,19
2020-05-07,Ukraine,NA,Kirovohrad,956250,1,0,403,19
2020-05-08,Ukraine,NA,Kirovohrad,956250,5,0,408,19
2020-05-09,Ukraine,NA,Kirovohrad,956250,3,1,411,20
2020-05-10,Ukraine,NA,Kirovohrad,956250,5,0,416,20
2020-05-11,Ukraine,NA,Kirovohrad,956250,4,0,420,20
2020-05-12,Ukraine,NA,Kirovohrad,956250,5,0,425,20
2020-05-13,Ukraine,NA,Kirovohrad,956250,3,0,428,20
2020-05-14,Ukraine,NA,Kirovohrad,956250,4,0,432,20
2020-05-15,Ukraine,NA,Kirovohrad,956250,5,0,437,20
2020-05-16,Ukraine,NA,Kirovohrad,956250,4,0,441,20
2020-05-17,Ukraine,NA,Kirovohrad,956250,2,0,443,20
2020-05-18,Ukraine,NA,Kirovohrad,956250,2,0,445,20
2020-05-19,Ukraine,NA,Kirovohrad,956250,0,0,445,20
2020-05-20,Ukraine,NA,Kirovohrad,956250,5,0,450,20
2020-05-21,Ukraine,NA,Kirovohrad,956250,5,1,455,21
2020-05-22,Ukraine,NA,Kirovohrad,956250,5,1,460,22
2020-05-23,Ukraine,NA,Kirovohrad,956250,6,0,466,22
2020-05-24,Ukraine,NA,Kirovohrad,956250,7,1,473,23
2020-05-25,Ukraine,NA,Kirovohrad,956250,5,0,478,23
2020-05-26,Ukraine,NA,Kirovohrad,956250,4,0,482,23
2020-05-27,Ukraine,NA,Kirovohrad,956250,7,0,489,23
2020-05-28,Ukraine,NA,Kirovohrad,956250,6,1,495,24
2020-05-29,Ukraine,NA,Kirovohrad,956250,8,1,503,25
2020-05-30,Ukraine,NA,Kirovohrad,956250,3,0,506,25
2020-05-31,Ukraine,NA,Kirovohrad,956250,5,0,511,25
2020-06-01,Ukraine,NA,Kirovohrad,956250,3,0,514,25
2020-06-02,Ukraine,NA,Kirovohrad,956250,2,0,516,25
2020-06-03,Ukraine,NA,Kirovohrad,956250,7,1,523,26
2020-06-04,Ukraine,NA,Kirovohrad,956250,3,0,526,26
2020-06-05,Ukraine,NA,Kirovohrad,956250,12,1,538,27
2020-06-06,Ukraine,NA,Kirovohrad,956250,8,0,546,27
2020-06-07,Ukraine,NA,Kirovohrad,956250,7,0,553,27
2020-06-08,Ukraine,NA,Kirovohrad,956250,6,0,559,27
2020-06-09,Ukraine,NA,Kirovohrad,956250,3,1,562,28
2020-06-10,Ukraine,NA,Kirovohrad,956250,0,2,562,30
2020-06-11,Ukraine,NA,Kirovohrad,956250,1,0,563,30
2020-06-12,Ukraine,NA,Kirovohrad,956250,5,0,568,30
2020-06-13,Ukraine,NA,Kirovohrad,956250,9,0,577,30
2020-06-14,Ukraine,NA,Kirovohrad,956250,5,0,582,30
2020-06-15,Ukraine,NA,Kirovohrad,956250,4,0,586,30
2020-06-16,Ukraine,NA,Kirovohrad,956250,4,0,590,30
2020-06-17,Ukraine,NA,Kirovohrad,956250,2,0,592,30
2020-06-18,Ukraine,NA,Kirovohrad,956250,12,0,604,30
2020-06-19,Ukraine,NA,Kirovohrad,956250,0,0,604,30
2020-06-20,Ukraine,NA,Kirovohrad,956250,8,0,612,30
2020-06-21,Ukraine,NA,Kirovohrad,956250,8,0,620,30
2020-06-22,Ukraine,NA,Kirovohrad,956250,7,1,627,31
2020-06-23,Ukraine,NA,Kirovohrad,956250,4,0,631,31
2020-06-24,Ukraine,NA,Kirovohrad,956250,3,0,634,31
2020-06-25,Ukraine,NA,Kirovohrad,956250,2,0,636,31
2020-06-26,Ukraine,NA,Kirovohrad,956250,4,0,640,31
2020-06-27,Ukraine,NA,Kirovohrad,956250,2,0,642,31
2020-06-28,Ukraine,NA,Kirovohrad,956250,4,0,646,31
2020-06-29,Ukraine,NA,Kirovohrad,956250,0,0,646,31
2020-06-30,Ukraine,NA,Kirovohrad,956250,0,0,646,31
2020-07-01,Ukraine,NA,Kirovohrad,956250,1,0,647,31
2020-07-02,Ukraine,NA,Kirovohrad,956250,3,0,650,31
2020-07-03,Ukraine,NA,Kirovohrad,956250,3,0,653,31
2020-07-04,Ukraine,NA,Kirovohrad,956250,4,0,657,31
2020-07-05,Ukraine,NA,Kirovohrad,956250,1,0,658,31
2020-07-06,Ukraine,NA,Kirovohrad,956250,1,1,659,32
2020-07-07,Ukraine,NA,Kirovohrad,956250,4,0,663,32
2020-07-08,Ukraine,NA,Kirovohrad,956250,1,0,664,32
2020-07-09,Ukraine,NA,Kirovohrad,956250,5,0,669,32
2020-07-10,Ukraine,NA,Kirovohrad,956250,1,1,670,33
2020-07-11,Ukraine,NA,Kirovohrad,956250,0,0,670,33
2020-07-12,Ukraine,NA,Kirovohrad,956250,3,0,673,33
2020-07-13,Ukraine,NA,Kirovohrad,956250,1,0,674,33
2020-07-14,Ukraine,NA,Kirovohrad,956250,0,0,674,33
2020-07-15,Ukraine,NA,Kirovohrad,956250,0,0,674,33
2020-07-16,Ukraine,NA,Kirovohrad,956250,1,0,675,33
2020-07-17,Ukraine,NA,Kirovohrad,956250,2,0,677,33
2020-07-18,Ukraine,NA,Kirovohrad,956250,0,0,677,33
2020-07-19,Ukraine,NA,Kirovohrad,956250,4,0,681,33
2020-07-20,Ukraine,NA,Kirovohrad,956250,1,0,682,33
2020-07-21,Ukraine,NA,Kirovohrad,956250,4,0,686,33
2020-07-22,Ukraine,NA,Kirovohrad,956250,2,0,688,33
2020-07-23,Ukraine,NA,Kirovohrad,956250,1,0,689,33
2020-07-24,Ukraine,NA,Kirovohrad,956250,0,0,689,33
2020-07-25,Ukraine,NA,Kirovohrad,956250,1,0,690,33
2020-07-26,Ukraine,NA,Kirovohrad,956250,3,1,693,34
2020-07-27,Ukraine,NA,Kirovohrad,956250,2,0,695,34
2020-07-28,Ukraine,NA,Kirovohrad,956250,2,0,697,34
2020-07-29,Ukraine,NA,Kirovohrad,956250,0,0,697,34
2020-07-30,Ukraine,NA,Kirovohrad,956250,5,1,702,35
2020-07-31,Ukraine,NA,Kirovohrad,956250,1,1,703,36
2020-08-01,Ukraine,NA,Kirovohrad,956250,1,0,704,36
2020-08-02,Ukraine,NA,Kirovohrad,956250,6,0,710,36
2020-08-03,Ukraine,NA,Kirovohrad,956250,1,0,711,36
2020-08-04,Ukraine,NA,Kirovohrad,956250,0,0,711,36
2020-08-05,Ukraine,NA,Kirovohrad,956250,0,0,711,36
2020-08-06,Ukraine,NA,Kirovohrad,956250,2,0,713,36
2020-08-07,Ukraine,NA,Kirovohrad,956250,1,2,714,38
2020-08-08,Ukraine,NA,Kirovohrad,956250,4,1,718,39
2020-08-09,Ukraine,NA,Kirovohrad,956250,3,0,721,39
2020-08-10,Ukraine,NA,Kirovohrad,956250,3,0,724,39
2020-08-11,Ukraine,NA,Kirovohrad,956250,1,0,725,39
2020-08-12,Ukraine,NA,Kirovohrad,956250,3,0,728,39
2020-08-13,Ukraine,NA,Kirovohrad,956250,5,0,733,39
2020-08-14,Ukraine,NA,Kirovohrad,956250,6,0,739,39
2020-08-15,Ukraine,NA,Kirovohrad,956250,0,0,739,39
2020-08-16,Ukraine,NA,Kirovohrad,956250,3,0,742,39
2020-08-17,Ukraine,NA,Kirovohrad,956250,1,0,743,39
2020-08-18,Ukraine,NA,Kirovohrad,956250,3,2,746,41
2020-08-19,Ukraine,NA,Kirovohrad,956250,2,0,748,41
2020-08-20,Ukraine,NA,Kirovohrad,956250,1,3,749,44
2020-08-21,Ukraine,NA,Kirovohrad,956250,2,1,751,45
2020-08-22,Ukraine,NA,Kirovohrad,956250,5,0,756,45
2020-08-23,Ukraine,NA,Kirovohrad,956250,8,0,764,45
2020-08-24,Ukraine,NA,Kirovohrad,956250,4,0,768,45
2020-08-25,Ukraine,NA,Kirovohrad,956250,1,0,769,45
2020-08-26,Ukraine,NA,Kirovohrad,956250,2,0,771,45
2020-08-27,Ukraine,NA,Kirovohrad,956250,9,0,780,45
2020-08-28,Ukraine,NA,Kirovohrad,956250,10,0,790,45
2020-08-29,Ukraine,NA,Kirovohrad,956250,5,0,795,45
2020-08-30,Ukraine,NA,Kirovohrad,956250,15,0,810,45
2020-08-31,Ukraine,NA,Kirovohrad,956250,4,0,814,45
2020-09-01,Ukraine,NA,Kirovohrad,956250,2,1,816,46
2020-09-02,Ukraine,NA,Kirovohrad,956250,10,1,826,47
2020-09-03,Ukraine,NA,Kirovohrad,956250,7,0,833,47
2020-09-04,Ukraine,NA,Kirovohrad,956250,8,0,841,47
2020-09-05,Ukraine,NA,Kirovohrad,956250,5,0,846,47
2020-09-06,Ukraine,NA,Kirovohrad,956250,8,0,854,47
2020-09-07,Ukraine,NA,Kirovohrad,956250,4,0,858,47
2020-09-08,Ukraine,NA,Kirovohrad,956250,9,0,867,47
2020-09-09,Ukraine,NA,Kirovohrad,956250,3,0,870,47
2020-09-10,Ukraine,NA,Kirovohrad,956250,4,0,874,47
2020-09-11,Ukraine,NA,Kirovohrad,956250,11,1,885,48
2020-09-12,Ukraine,NA,Kirovohrad,956250,7,0,892,48
2020-09-13,Ukraine,NA,Kirovohrad,956250,12,1,904,49
2020-09-14,Ukraine,NA,Kirovohrad,956250,5,1,909,50
2020-09-15,Ukraine,NA,Kirovohrad,956250,20,0,929,50
2020-09-16,Ukraine,NA,Kirovohrad,956250,5,0,934,50
2020-09-17,Ukraine,NA,Kirovohrad,956250,17,1,951,51
2020-09-18,Ukraine,NA,Kirovohrad,956250,16,1,967,52
2020-09-19,Ukraine,NA,Kirovohrad,956250,6,0,973,52
2020-09-20,Ukraine,NA,Kirovohrad,956250,12,2,985,54
2020-09-21,Ukraine,NA,Kirovohrad,956250,8,0,993,54
2020-09-22,Ukraine,NA,Kirovohrad,956250,12,0,1005,54
2020-09-23,Ukraine,NA,Kirovohrad,956250,19,1,1024,55
2020-04-19,Ukraine,NA,Luhansk,2167802,15,0,24,0
2020-04-20,Ukraine,NA,Luhansk,2167802,0,0,24,0
2020-04-21,Ukraine,NA,Luhansk,2167802,1,0,25,0
2020-04-22,Ukraine,NA,Luhansk,2167802,1,0,26,0
2020-04-23,Ukraine,NA,Luhansk,2167802,1,0,27,0
2020-04-24,Ukraine,NA,Luhansk,2167802,0,0,27,0
2020-04-25,Ukraine,NA,Luhansk,2167802,1,0,28,0
2020-04-26,Ukraine,NA,Luhansk,2167802,1,0,29,0
2020-04-27,Ukraine,NA,Luhansk,2167802,0,0,29,0
2020-04-28,Ukraine,NA,Luhansk,2167802,3,0,32,0
2020-04-29,Ukraine,NA,Luhansk,2167802,1,0,33,0
2020-04-30,Ukraine,NA,Luhansk,2167802,0,0,33,0
2020-05-01,Ukraine,NA,Luhansk,2167802,2,0,35,0
2020-05-02,Ukraine,NA,Luhansk,2167802,2,0,37,0
2020-05-03,Ukraine,NA,Luhansk,2167802,0,0,37,0
2020-05-04,Ukraine,NA,Luhansk,2167802,0,0,37,0
2020-05-05,Ukraine,NA,Luhansk,2167802,1,0,38,0
2020-05-06,Ukraine,NA,Luhansk,2167802,4,0,42,0
2020-05-07,Ukraine,NA,Luhansk,2167802,0,0,42,0
2020-05-08,Ukraine,NA,Luhansk,2167802,0,0,42,0
2020-05-09,Ukraine,NA,Luhansk,2167802,0,0,42,0
2020-05-10,Ukraine,NA,Luhansk,2167802,0,0,42,0
2020-05-11,Ukraine,NA,Luhansk,2167802,0,0,42,0
2020-05-12,Ukraine,NA,Luhansk,2167802,0,0,42,0
2020-05-13,Ukraine,NA,Luhansk,2167802,0,0,42,0
2020-05-14,Ukraine,NA,Luhansk,2167802,0,0,42,0
2020-05-15,Ukraine,NA,Luhansk,2167802,0,0,42,0
2020-05-16,Ukraine,NA,Luhansk,2167802,0,0,42,0
2020-05-17,Ukraine,NA,Luhansk,2167802,0,0,42,0
2020-05-18,Ukraine,NA,Luhansk,2167802,0,0,42,0
2020-05-19,Ukraine,NA,Luhansk,2167802,0,0,42,0
2020-05-20,Ukraine,NA,Luhansk,2167802,0,0,42,0
2020-05-21,Ukraine,NA,Luhansk,2167802,1,0,43,0
2020-05-22,Ukraine,NA,Luhansk,2167802,0,0,43,0
2020-05-23,Ukraine,NA,Luhansk,2167802,0,0,43,0
2020-05-24,Ukraine,NA,Luhansk,2167802,0,0,43,0
2020-05-25,Ukraine,NA,Luhansk,2167802,0,0,43,0
2020-05-26,Ukraine,NA,Luhansk,2167802,1,0,44,0
2020-05-27,Ukraine,NA,Luhansk,2167802,1,0,45,0
2020-05-28,Ukraine,NA,Luhansk,2167802,0,0,45,0
2020-05-29,Ukraine,NA,Luhansk,2167802,1,0,46,0
2020-05-30,Ukraine,NA,Luhansk,2167802,0,0,46,0
2020-05-31,Ukraine,NA,Luhansk,2167802,1,0,47,0
2020-06-01,Ukraine,NA,Luhansk,2167802,0,0,47,0
2020-06-02,Ukraine,NA,Luhansk,2167802,0,0,47,0
2020-06-03,Ukraine,NA,Luhansk,2167802,2,0,49,0
2020-06-04,Ukraine,NA,Luhansk,2167802,2,0,51,0
2020-06-05,Ukraine,NA,Luhansk,2167802,0,0,51,0
2020-06-06,Ukraine,NA,Luhansk,2167802,1,0,52,0
2020-06-07,Ukraine,NA,Luhansk,2167802,2,0,54,0
2020-06-08,Ukraine,NA,Luhansk,2167802,0,0,54,0
2020-06-09,Ukraine,NA,Luhansk,2167802,0,0,54,0
2020-06-10,Ukraine,NA,Luhansk,2167802,0,0,54,0
2020-06-11,Ukraine,NA,Luhansk,2167802,0,0,54,0
2020-06-12,Ukraine,NA,Luhansk,2167802,0,0,54,0
2020-06-13,Ukraine,NA,Luhansk,2167802,2,0,56,0
2020-06-14,Ukraine,NA,Luhansk,2167802,0,0,56,0
2020-06-15,Ukraine,NA,Luhansk,2167802,1,0,57,0
2020-06-16,Ukraine,NA,Luhansk,2167802,3,0,60,0
2020-06-17,Ukraine,NA,Luhansk,2167802,6,0,66,0
2020-06-18,Ukraine,NA,Luhansk,2167802,2,0,68,0
2020-06-19,Ukraine,NA,Luhansk,2167802,3,0,71,0
2020-06-20,Ukraine,NA,Luhansk,2167802,1,0,72,0
2020-06-21,Ukraine,NA,Luhansk,2167802,0,0,72,0
2020-06-22,Ukraine,NA,Luhansk,2167802,0,0,72,0
2020-06-23,Ukraine,NA,Luhansk,2167802,1,0,73,0
2020-06-24,Ukraine,NA,Luhansk,2167802,2,0,75,0
2020-06-25,Ukraine,NA,Luhansk,2167802,0,0,75,0
2020-06-26,Ukraine,NA,Luhansk,2167802,1,0,76,0
2020-06-27,Ukraine,NA,Luhansk,2167802,0,0,76,0
2020-06-28,Ukraine,NA,Luhansk,2167802,4,0,80,0
2020-06-29,Ukraine,NA,Luhansk,2167802,0,0,80,0
2020-06-30,Ukraine,NA,Luhansk,2167802,0,0,80,0
2020-07-01,Ukraine,NA,Luhansk,2167802,0,0,80,0
2020-07-02,Ukraine,NA,Luhansk,2167802,3,0,83,0
2020-07-03,Ukraine,NA,Luhansk,2167802,1,0,84,0
2020-07-04,Ukraine,NA,Luhansk,2167802,0,0,84,0
2020-07-05,Ukraine,NA,Luhansk,2167802,0,0,84,0
2020-07-06,Ukraine,NA,Luhansk,2167802,0,0,84,0
2020-07-07,Ukraine,NA,Luhansk,2167802,1,0,85,0
2020-07-08,Ukraine,NA,Luhansk,2167802,2,0,87,0
2020-07-09,Ukraine,NA,Luhansk,2167802,3,0,90,0
2020-07-10,Ukraine,NA,Luhansk,2167802,0,0,90,0
2020-07-11,Ukraine,NA,Luhansk,2167802,3,0,93,0
2020-07-12,Ukraine,NA,Luhansk,2167802,0,0,93,0
2020-07-13,Ukraine,NA,Luhansk,2167802,0,0,93,0
2020-07-14,Ukraine,NA,Luhansk,2167802,2,1,95,1
2020-07-15,Ukraine,NA,Luhansk,2167802,2,0,97,1
2020-07-16,Ukraine,NA,Luhansk,2167802,1,0,98,1
2020-07-17,Ukraine,NA,Luhansk,2167802,2,0,100,1
2020-07-18,Ukraine,NA,Luhansk,2167802,5,0,105,1
2020-07-19,Ukraine,NA,Luhansk,2167802,1,0,106,1
2020-07-20,Ukraine,NA,Luhansk,2167802,0,0,106,1
2020-07-21,Ukraine,NA,Luhansk,2167802,4,0,110,1
2020-07-22,Ukraine,NA,Luhansk,2167802,0,0,110,1
2020-07-23,Ukraine,NA,Luhansk,2167802,6,0,116,1
2020-07-24,Ukraine,NA,Luhansk,2167802,2,0,118,1
2020-07-25,Ukraine,NA,Luhansk,2167802,1,0,119,1
2020-07-26,Ukraine,NA,Luhansk,2167802,1,0,120,1
2020-07-27,Ukraine,NA,Luhansk,2167802,0,0,120,1
2020-07-28,Ukraine,NA,Luhansk,2167802,1,0,121,1
2020-07-29,Ukraine,NA,Luhansk,2167802,1,0,122,1
2020-07-30,Ukraine,NA,Luhansk,2167802,0,0,122,1
2020-07-31,Ukraine,NA,Luhansk,2167802,4,0,126,1
2020-08-01,Ukraine,NA,Luhansk,2167802,1,0,127,1
2020-08-02,Ukraine,NA,Luhansk,2167802,1,0,128,1
2020-08-03,Ukraine,NA,Luhansk,2167802,0,0,128,1
2020-08-04,Ukraine,NA,Luhansk,2167802,2,0,130,1
2020-08-05,Ukraine,NA,Luhansk,2167802,5,0,135,1
2020-08-06,Ukraine,NA,Luhansk,2167802,0,0,135,1
2020-08-07,Ukraine,NA,Luhansk,2167802,11,0,146,1
2020-08-08,Ukraine,NA,Luhansk,2167802,6,0,152,1
2020-08-09,Ukraine,NA,Luhansk,2167802,1,0,153,1
2020-08-10,Ukraine,NA,Luhansk,2167802,2,0,155,1
2020-08-11,Ukraine,NA,Luhansk,2167802,2,0,157,1
2020-08-12,Ukraine,NA,Luhansk,2167802,3,0,160,1
2020-08-13,Ukraine,NA,Luhansk,2167802,10,0,170,1
2020-08-14,Ukraine,NA,Luhansk,2167802,1,0,171,1
2020-08-15,Ukraine,NA,Luhansk,2167802,7,0,178,1
2020-08-16,Ukraine,NA,Luhansk,2167802,0,0,178,1
2020-08-17,Ukraine,NA,Luhansk,2167802,6,0,184,1
2020-08-18,Ukraine,NA,Luhansk,2167802,1,0,185,1
2020-08-19,Ukraine,NA,Luhansk,2167802,9,0,194,1
2020-08-20,Ukraine,NA,Luhansk,2167802,10,0,204,1
2020-08-21,Ukraine,NA,Luhansk,2167802,9,0,213,1
2020-08-22,Ukraine,NA,Luhansk,2167802,19,0,232,1
2020-08-23,Ukraine,NA,Luhansk,2167802,11,0,243,1
2020-08-24,Ukraine,NA,Luhansk,2167802,1,0,244,1
2020-08-25,Ukraine,NA,Luhansk,2167802,0,0,244,1
2020-08-26,Ukraine,NA,Luhansk,2167802,3,1,247,2
2020-08-27,Ukraine,NA,Luhansk,2167802,17,0,264,2
2020-08-28,Ukraine,NA,Luhansk,2167802,10,0,274,2
2020-08-29,Ukraine,NA,Luhansk,2167802,21,0,295,2
2020-08-30,Ukraine,NA,Luhansk,2167802,17,0,312,2
2020-08-31,Ukraine,NA,Luhansk,2167802,3,0,315,2
2020-09-01,Ukraine,NA,Luhansk,2167802,5,1,320,3
2020-09-02,Ukraine,NA,Luhansk,2167802,26,0,346,3
2020-09-03,Ukraine,NA,Luhansk,2167802,27,0,373,3
2020-09-04,Ukraine,NA,Luhansk,2167802,20,0,393,3
2020-09-05,Ukraine,NA,Luhansk,2167802,22,0,415,3
2020-09-06,Ukraine,NA,Luhansk,2167802,16,0,431,3
2020-09-07,Ukraine,NA,Luhansk,2167802,3,0,434,3
2020-09-08,Ukraine,NA,Luhansk,2167802,14,1,448,4
2020-09-09,Ukraine,NA,Luhansk,2167802,32,0,480,4
2020-09-10,Ukraine,NA,Luhansk,2167802,23,0,503,4
2020-09-11,Ukraine,NA,Luhansk,2167802,29,0,532,4
2020-09-12,Ukraine,NA,Luhansk,2167802,30,0,562,4
2020-09-13,Ukraine,NA,Luhansk,2167802,24,0,586,4
2020-09-14,Ukraine,NA,Luhansk,2167802,14,0,600,4
2020-09-15,Ukraine,NA,Luhansk,2167802,20,0,620,4
2020-09-16,Ukraine,NA,Luhansk,2167802,33,1,653,5
2020-09-17,Ukraine,NA,Luhansk,2167802,36,0,689,5
2020-09-18,Ukraine,NA,Luhansk,2167802,17,0,706,5
2020-09-19,Ukraine,NA,Luhansk,2167802,29,0,735,5
2020-09-20,Ukraine,NA,Luhansk,2167802,19,0,754,5
2020-09-21,Ukraine,NA,Luhansk,2167802,5,0,759,5
2020-09-22,Ukraine,NA,Luhansk,2167802,8,1,767,6
2020-09-23,Ukraine,NA,Luhansk,2167802,47,0,814,6
2020-04-01,Ukraine,NA,Lviv,2529608,5,0,11,0
2020-04-02,Ukraine,NA,Lviv,2529608,2,0,13,0
2020-04-03,Ukraine,NA,Lviv,2529608,1,0,14,0
2020-04-04,Ukraine,NA,Lviv,2529608,1,0,15,0
2020-04-05,Ukraine,NA,Lviv,2529608,0,0,15,0
2020-04-06,Ukraine,NA,Lviv,2529608,12,0,27,0
2020-04-07,Ukraine,NA,Lviv,2529608,2,0,29,0
2020-04-08,Ukraine,NA,Lviv,2529608,7,1,36,1
2020-04-09,Ukraine,NA,Lviv,2529608,25,1,61,2
2020-04-10,Ukraine,NA,Lviv,2529608,21,1,82,3
2020-04-11,Ukraine,NA,Lviv,2529608,14,1,96,4
2020-04-12,Ukraine,NA,Lviv,2529608,15,1,111,5
2020-04-13,Ukraine,NA,Lviv,2529608,13,0,124,5
2020-04-14,Ukraine,NA,Lviv,2529608,12,0,136,5
2020-04-15,Ukraine,NA,Lviv,2529608,16,1,152,6
2020-04-16,Ukraine,NA,Lviv,2529608,14,0,166,6
2020-04-17,Ukraine,NA,Lviv,2529608,37,2,203,8
2020-04-18,Ukraine,NA,Lviv,2529608,18,0,221,8
2020-04-19,Ukraine,NA,Lviv,2529608,24,0,245,8
2020-04-20,Ukraine,NA,Lviv,2529608,8,2,253,10
2020-04-21,Ukraine,NA,Lviv,2529608,3,0,256,10
2020-04-22,Ukraine,NA,Lviv,2529608,18,0,274,10
2020-04-23,Ukraine,NA,Lviv,2529608,8,2,282,12
2020-04-24,Ukraine,NA,Lviv,2529608,16,0,298,12
2020-04-25,Ukraine,NA,Lviv,2529608,19,0,317,12
2020-04-26,Ukraine,NA,Lviv,2529608,31,0,348,12
2020-04-27,Ukraine,NA,Lviv,2529608,10,0,358,12
2020-04-28,Ukraine,NA,Lviv,2529608,13,1,371,13
2020-04-29,Ukraine,NA,Lviv,2529608,34,0,405,13
2020-04-30,Ukraine,NA,Lviv,2529608,25,1,430,14
2020-05-01,Ukraine,NA,Lviv,2529608,24,0,454,14
2020-05-02,Ukraine,NA,Lviv,2529608,11,0,465,14
2020-05-03,Ukraine,NA,Lviv,2529608,8,1,473,15
2020-05-04,Ukraine,NA,Lviv,2529608,33,0,506,15
2020-05-05,Ukraine,NA,Lviv,2529608,8,1,514,16
2020-05-06,Ukraine,NA,Lviv,2529608,39,0,553,16
2020-05-07,Ukraine,NA,Lviv,2529608,42,1,595,17
2020-05-08,Ukraine,NA,Lviv,2529608,65,1,660,18
2020-05-09,Ukraine,NA,Lviv,2529608,39,0,699,18
2020-05-10,Ukraine,NA,Lviv,2529608,54,1,753,19
2020-05-11,Ukraine,NA,Lviv,2529608,45,1,798,20
2020-05-12,Ukraine,NA,Lviv,2529608,27,2,825,22
2020-05-13,Ukraine,NA,Lviv,2529608,45,0,870,22
2020-05-14,Ukraine,NA,Lviv,2529608,34,0,904,22
2020-05-15,Ukraine,NA,Lviv,2529608,38,1,942,23
2020-05-16,Ukraine,NA,Lviv,2529608,27,4,969,27
2020-05-17,Ukraine,NA,Lviv,2529608,50,0,1019,27
2020-05-18,Ukraine,NA,Lviv,2529608,47,3,1066,30
2020-05-19,Ukraine,NA,Lviv,2529608,32,0,1098,30
2020-05-20,Ukraine,NA,Lviv,2529608,38,1,1136,31
2020-05-21,Ukraine,NA,Lviv,2529608,39,1,1175,32
2020-05-22,Ukraine,NA,Lviv,2529608,65,1,1240,33
2020-05-23,Ukraine,NA,Lviv,2529608,45,0,1285,33
2020-05-24,Ukraine,NA,Lviv,2529608,48,2,1333,35
2020-05-25,Ukraine,NA,Lviv,2529608,27,1,1360,36
2020-05-26,Ukraine,NA,Lviv,2529608,45,6,1405,42
2020-05-27,Ukraine,NA,Lviv,2529608,38,1,1443,43
2020-05-28,Ukraine,NA,Lviv,2529608,70,5,1513,48
2020-05-29,Ukraine,NA,Lviv,2529608,50,1,1563,49
2020-05-30,Ukraine,NA,Lviv,2529608,56,4,1619,53
2020-05-31,Ukraine,NA,Lviv,2529608,50,1,1669,54
2020-06-01,Ukraine,NA,Lviv,2529608,31,1,1700,55
2020-06-02,Ukraine,NA,Lviv,2529608,34,3,1734,58
2020-06-03,Ukraine,NA,Lviv,2529608,96,1,1830,59
2020-06-04,Ukraine,NA,Lviv,2529608,85,3,1915,62
2020-06-05,Ukraine,NA,Lviv,2529608,73,1,1988,63
2020-06-06,Ukraine,NA,Lviv,2529608,65,4,2053,67
2020-06-07,Ukraine,NA,Lviv,2529608,68,2,2121,69
2020-06-08,Ukraine,NA,Lviv,2529608,41,2,2162,71
2020-06-09,Ukraine,NA,Lviv,2529608,49,2,2211,73
2020-06-10,Ukraine,NA,Lviv,2529608,78,4,2289,77
2020-06-11,Ukraine,NA,Lviv,2529608,125,10,2414,87
2020-06-12,Ukraine,NA,Lviv,2529608,112,3,2526,90
2020-06-13,Ukraine,NA,Lviv,2529608,132,2,2658,92
2020-06-14,Ukraine,NA,Lviv,2529608,139,0,2797,92
2020-06-15,Ukraine,NA,Lviv,2529608,136,3,2933,95
2020-06-16,Ukraine,NA,Lviv,2529608,139,1,3072,96
2020-06-17,Ukraine,NA,Lviv,2529608,155,9,3227,105
2020-06-18,Ukraine,NA,Lviv,2529608,171,2,3398,107
2020-06-19,Ukraine,NA,Lviv,2529608,142,4,3540,111
2020-06-20,Ukraine,NA,Lviv,2529608,139,0,3679,111
2020-06-21,Ukraine,NA,Lviv,2529608,101,3,3780,114
2020-06-22,Ukraine,NA,Lviv,2529608,200,0,3980,114
2020-06-23,Ukraine,NA,Lviv,2529608,240,3,4220,117
2020-06-24,Ukraine,NA,Lviv,2529608,203,3,4423,120
2020-06-25,Ukraine,NA,Lviv,2529608,204,3,4627,123
2020-06-26,Ukraine,NA,Lviv,2529608,209,3,4836,126
2020-06-27,Ukraine,NA,Lviv,2529608,168,5,5004,131
2020-06-28,Ukraine,NA,Lviv,2529608,173,6,5177,137
2020-06-29,Ukraine,NA,Lviv,2529608,115,6,5292,143
2020-06-30,Ukraine,NA,Lviv,2529608,143,3,5435,146
2020-07-01,Ukraine,NA,Lviv,2529608,143,0,5578,146
2020-07-02,Ukraine,NA,Lviv,2529608,152,0,5730,146
2020-07-03,Ukraine,NA,Lviv,2529608,153,11,5883,157
2020-07-04,Ukraine,NA,Lviv,2529608,176,2,6059,159
2020-07-05,Ukraine,NA,Lviv,2529608,138,3,6197,162
2020-07-06,Ukraine,NA,Lviv,2529608,104,2,6301,164
2020-07-07,Ukraine,NA,Lviv,2529608,144,0,6445,164
2020-07-08,Ukraine,NA,Lviv,2529608,117,6,6562,170
2020-07-09,Ukraine,NA,Lviv,2529608,119,4,6681,174
2020-07-10,Ukraine,NA,Lviv,2529608,82,4,6763,178
2020-07-11,Ukraine,NA,Lviv,2529608,119,3,6882,181
2020-07-12,Ukraine,NA,Lviv,2529608,121,2,7003,183
2020-07-13,Ukraine,NA,Lviv,2529608,104,3,7107,186
2020-07-14,Ukraine,NA,Lviv,2529608,147,2,7254,188
2020-07-15,Ukraine,NA,Lviv,2529608,171,5,7425,193
2020-07-16,Ukraine,NA,Lviv,2529608,197,6,7622,199
2020-07-17,Ukraine,NA,Lviv,2529608,132,4,7754,203
2020-07-18,Ukraine,NA,Lviv,2529608,137,4,7891,207
2020-07-19,Ukraine,NA,Lviv,2529608,109,1,8000,208
2020-07-20,Ukraine,NA,Lviv,2529608,115,1,8115,209
2020-07-21,Ukraine,NA,Lviv,2529608,114,3,8229,212
2020-07-22,Ukraine,NA,Lviv,2529608,124,0,8353,212
2020-07-23,Ukraine,NA,Lviv,2529608,109,4,8462,216
2020-07-24,Ukraine,NA,Lviv,2529608,126,5,8588,221
2020-07-25,Ukraine,NA,Lviv,2529608,114,6,8702,227
2020-07-26,Ukraine,NA,Lviv,2529608,130,6,8832,233
2020-07-27,Ukraine,NA,Lviv,2529608,120,5,8952,238
2020-07-28,Ukraine,NA,Lviv,2529608,147,7,9099,245
2020-07-29,Ukraine,NA,Lviv,2529608,149,4,9248,249
2020-07-30,Ukraine,NA,Lviv,2529608,131,6,9379,255
2020-07-31,Ukraine,NA,Lviv,2529608,147,5,9526,260
2020-08-01,Ukraine,NA,Lviv,2529608,145,0,9671,260
2020-08-02,Ukraine,NA,Lviv,2529608,112,5,9783,265
2020-08-03,Ukraine,NA,Lviv,2529608,138,2,9921,267
2020-08-04,Ukraine,NA,Lviv,2529608,146,6,10067,273
2020-08-05,Ukraine,NA,Lviv,2529608,156,2,10223,275
2020-08-06,Ukraine,NA,Lviv,2529608,197,8,10420,283
2020-08-07,Ukraine,NA,Lviv,2529608,152,11,10572,294
2020-08-08,Ukraine,NA,Lviv,2529608,154,5,10726,299
2020-08-09,Ukraine,NA,Lviv,2529608,125,3,10851,302
2020-08-10,Ukraine,NA,Lviv,2529608,130,3,10981,305
2020-08-11,Ukraine,NA,Lviv,2529608,161,4,11142,309
2020-08-12,Ukraine,NA,Lviv,2529608,166,1,11308,310
2020-08-13,Ukraine,NA,Lviv,2529608,166,4,11474,314
2020-08-14,Ukraine,NA,Lviv,2529608,184,4,11658,318
2020-08-15,Ukraine,NA,Lviv,2529608,166,6,11824,324
2020-08-16,Ukraine,NA,Lviv,2529608,127,4,11951,328
2020-08-17,Ukraine,NA,Lviv,2529608,128,6,12079,334
2020-08-18,Ukraine,NA,Lviv,2529608,181,3,12260,337
2020-08-19,Ukraine,NA,Lviv,2529608,188,1,12448,338
2020-08-20,Ukraine,NA,Lviv,2529608,183,6,12631,344
2020-08-21,Ukraine,NA,Lviv,2529608,162,3,12793,347
2020-08-22,Ukraine,NA,Lviv,2529608,172,3,12965,350
2020-08-23,Ukraine,NA,Lviv,2529608,146,4,13111,354
2020-08-24,Ukraine,NA,Lviv,2529608,142,4,13253,358
2020-08-25,Ukraine,NA,Lviv,2529608,136,6,13389,364
2020-08-26,Ukraine,NA,Lviv,2529608,171,3,13560,367
2020-08-27,Ukraine,NA,Lviv,2529608,203,7,13763,374
2020-08-28,Ukraine,NA,Lviv,2529608,215,7,13978,381
2020-08-29,Ukraine,NA,Lviv,2529608,190,5,14168,386
2020-08-30,Ukraine,NA,Lviv,2529608,188,3,14356,389
2020-08-31,Ukraine,NA,Lviv,2529608,154,5,14510,394
2020-09-01,Ukraine,NA,Lviv,2529608,193,8,14703,402
2020-09-02,Ukraine,NA,Lviv,2529608,204,10,14907,412
2020-09-03,Ukraine,NA,Lviv,2529608,209,11,15116,423
2020-09-04,Ukraine,NA,Lviv,2529608,196,11,15312,434
2020-09-05,Ukraine,NA,Lviv,2529608,195,6,15507,440
2020-09-06,Ukraine,NA,Lviv,2529608,188,2,15695,442
2020-09-07,Ukraine,NA,Lviv,2529608,186,5,15881,447
2020-09-08,Ukraine,NA,Lviv,2529608,192,5,16073,452
2020-09-09,Ukraine,NA,Lviv,2529608,196,2,16269,454
2020-09-10,Ukraine,NA,Lviv,2529608,183,1,16452,455
2020-09-11,Ukraine,NA,Lviv,2529608,174,7,16626,462
2020-09-12,Ukraine,NA,Lviv,2529608,148,6,16774,468
2020-09-13,Ukraine,NA,Lviv,2529608,140,4,16914,472
2020-09-14,Ukraine,NA,Lviv,2529608,143,2,17057,474
2020-09-15,Ukraine,NA,Lviv,2529608,186,4,17243,478
2020-09-16,Ukraine,NA,Lviv,2529608,187,9,17430,487
2020-09-17,Ukraine,NA,Lviv,2529608,234,10,17664,497
2020-09-18,Ukraine,NA,Lviv,2529608,205,10,17869,507
2020-09-19,Ukraine,NA,Lviv,2529608,260,8,18129,515
2020-09-20,Ukraine,NA,Lviv,2529608,188,6,18317,521
2020-09-21,Ukraine,NA,Lviv,2529608,201,5,18518,526
2020-09-22,Ukraine,NA,Lviv,2529608,275,1,18793,527
2020-09-23,Ukraine,NA,Lviv,2529608,252,5,19045,532
2020-04-15,Ukraine,NA,Mykolaiv,1141324,9,0,14,0
2020-04-16,Ukraine,NA,Mykolaiv,1141324,8,0,22,0
2020-04-17,Ukraine,NA,Mykolaiv,1141324,0,0,22,0
2020-04-18,Ukraine,NA,Mykolaiv,1141324,9,0,31,0
2020-04-19,Ukraine,NA,Mykolaiv,1141324,6,0,37,0
2020-04-20,Ukraine,NA,Mykolaiv,1141324,0,0,37,0
2020-04-21,Ukraine,NA,Mykolaiv,1141324,4,0,41,0
2020-04-22,Ukraine,NA,Mykolaiv,1141324,41,1,82,1
2020-04-23,Ukraine,NA,Mykolaiv,1141324,17,0,99,1
2020-04-24,Ukraine,NA,Mykolaiv,1141324,4,0,103,1
2020-04-25,Ukraine,NA,Mykolaiv,1141324,0,0,103,1
2020-04-26,Ukraine,NA,Mykolaiv,1141324,8,0,111,1
2020-04-27,Ukraine,NA,Mykolaiv,1141324,4,1,115,2
2020-04-28,Ukraine,NA,Mykolaiv,1141324,1,0,116,2
2020-04-29,Ukraine,NA,Mykolaiv,1141324,0,0,116,2
2020-04-30,Ukraine,NA,Mykolaiv,1141324,10,0,126,2
2020-05-01,Ukraine,NA,Mykolaiv,1141324,0,0,126,2
2020-05-02,Ukraine,NA,Mykolaiv,1141324,14,1,140,3
2020-05-03,Ukraine,NA,Mykolaiv,1141324,9,0,149,3
2020-05-04,Ukraine,NA,Mykolaiv,1141324,12,0,161,3
2020-05-05,Ukraine,NA,Mykolaiv,1141324,2,1,163,4
2020-05-06,Ukraine,NA,Mykolaiv,1141324,2,1,165,5
2020-05-07,Ukraine,NA,Mykolaiv,1141324,6,0,171,5
2020-05-08,Ukraine,NA,Mykolaiv,1141324,8,0,179,5
2020-05-09,Ukraine,NA,Mykolaiv,1141324,25,0,204,5
2020-05-10,Ukraine,NA,Mykolaiv,1141324,17,0,221,5
2020-05-11,Ukraine,NA,Mykolaiv,1141324,2,0,223,5
2020-05-12,Ukraine,NA,Mykolaiv,1141324,2,0,225,5
2020-05-13,Ukraine,NA,Mykolaiv,1141324,0,0,225,5
2020-05-14,Ukraine,NA,Mykolaiv,1141324,3,0,228,5
2020-05-15,Ukraine,NA,Mykolaiv,1141324,0,0,228,5
2020-05-16,Ukraine,NA,Mykolaiv,1141324,8,1,236,6
2020-05-17,Ukraine,NA,Mykolaiv,1141324,2,0,238,6
2020-05-18,Ukraine,NA,Mykolaiv,1141324,24,0,262,6
2020-05-19,Ukraine,NA,Mykolaiv,1141324,1,0,263,6
2020-05-20,Ukraine,NA,Mykolaiv,1141324,1,0,264,6
2020-05-21,Ukraine,NA,Mykolaiv,1141324,10,1,274,7
2020-05-22,Ukraine,NA,Mykolaiv,1141324,3,0,277,7
2020-05-23,Ukraine,NA,Mykolaiv,1141324,3,0,280,7
2020-05-24,Ukraine,NA,Mykolaiv,1141324,0,0,280,7
2020-05-25,Ukraine,NA,Mykolaiv,1141324,1,0,281,7
2020-05-26,Ukraine,NA,Mykolaiv,1141324,0,0,281,7
2020-05-27,Ukraine,NA,Mykolaiv,1141324,0,0,281,7
2020-05-28,Ukraine,NA,Mykolaiv,1141324,1,0,282,7
2020-05-29,Ukraine,NA,Mykolaiv,1141324,2,0,284,7
2020-05-30,Ukraine,NA,Mykolaiv,1141324,4,0,288,7
2020-05-31,Ukraine,NA,Mykolaiv,1141324,5,0,293,7
2020-06-01,Ukraine,NA,Mykolaiv,1141324,1,0,294,7
2020-06-02,Ukraine,NA,Mykolaiv,1141324,0,0,294,7
2020-06-03,Ukraine,NA,Mykolaiv,1141324,1,0,295,7
2020-06-04,Ukraine,NA,Mykolaiv,1141324,0,0,295,7
2020-06-05,Ukraine,NA,Mykolaiv,1141324,12,0,307,7
2020-06-06,Ukraine,NA,Mykolaiv,1141324,0,0,307,7
2020-06-07,Ukraine,NA,Mykolaiv,1141324,2,0,309,7
2020-06-08,Ukraine,NA,Mykolaiv,1141324,0,0,309,7
2020-06-09,Ukraine,NA,Mykolaiv,1141324,0,0,309,7
2020-06-10,Ukraine,NA,Mykolaiv,1141324,0,0,309,7
2020-06-11,Ukraine,NA,Mykolaiv,1141324,2,0,311,7
2020-06-12,Ukraine,NA,Mykolaiv,1141324,5,0,316,7
2020-06-13,Ukraine,NA,Mykolaiv,1141324,4,0,320,7
2020-06-14,Ukraine,NA,Mykolaiv,1141324,1,0,321,7
2020-06-15,Ukraine,NA,Mykolaiv,1141324,0,0,321,7
2020-06-16,Ukraine,NA,Mykolaiv,1141324,0,0,321,7
2020-06-17,Ukraine,NA,Mykolaiv,1141324,2,0,323,7
2020-06-18,Ukraine,NA,Mykolaiv,1141324,0,0,323,7
2020-06-19,Ukraine,NA,Mykolaiv,1141324,15,0,338,7
2020-06-20,Ukraine,NA,Mykolaiv,1141324,11,0,349,7
2020-06-21,Ukraine,NA,Mykolaiv,1141324,9,0,358,7
2020-06-22,Ukraine,NA,Mykolaiv,1141324,8,0,366,7
2020-06-23,Ukraine,NA,Mykolaiv,1141324,0,2,366,9
2020-06-24,Ukraine,NA,Mykolaiv,1141324,2,0,368,9
2020-06-25,Ukraine,NA,Mykolaiv,1141324,9,0,377,9
2020-06-26,Ukraine,NA,Mykolaiv,1141324,7,0,384,9
2020-06-27,Ukraine,NA,Mykolaiv,1141324,8,0,392,9
2020-06-28,Ukraine,NA,Mykolaiv,1141324,44,1,436,10
2020-06-29,Ukraine,NA,Mykolaiv,1141324,6,0,442,10
2020-06-30,Ukraine,NA,Mykolaiv,1141324,2,0,444,10
2020-07-01,Ukraine,NA,Mykolaiv,1141324,3,0,447,10
2020-07-02,Ukraine,NA,Mykolaiv,1141324,0,0,447,10
2020-07-03,Ukraine,NA,Mykolaiv,1141324,3,0,450,10
2020-07-04,Ukraine,NA,Mykolaiv,1141324,5,0,455,10
2020-07-05,Ukraine,NA,Mykolaiv,1141324,3,0,458,10
2020-07-06,Ukraine,NA,Mykolaiv,1141324,3,1,461,11
2020-07-07,Ukraine,NA,Mykolaiv,1141324,0,0,461,11
2020-07-08,Ukraine,NA,Mykolaiv,1141324,2,0,463,11
2020-07-09,Ukraine,NA,Mykolaiv,1141324,2,0,465,11
2020-07-10,Ukraine,NA,Mykolaiv,1141324,2,0,467,11
2020-07-11,Ukraine,NA,Mykolaiv,1141324,10,0,477,11
2020-07-12,Ukraine,NA,Mykolaiv,1141324,4,0,481,11
2020-07-13,Ukraine,NA,Mykolaiv,1141324,1,0,482,11
2020-07-14,Ukraine,NA,Mykolaiv,1141324,5,1,487,12
2020-07-15,Ukraine,NA,Mykolaiv,1141324,7,0,494,12
2020-07-16,Ukraine,NA,Mykolaiv,1141324,4,0,498,12
2020-07-17,Ukraine,NA,Mykolaiv,1141324,6,0,504,12
2020-07-18,Ukraine,NA,Mykolaiv,1141324,6,0,510,12
2020-07-19,Ukraine,NA,Mykolaiv,1141324,3,0,513,12
2020-07-20,Ukraine,NA,Mykolaiv,1141324,9,0,522,12
2020-07-21,Ukraine,NA,Mykolaiv,1141324,2,0,524,12
2020-07-22,Ukraine,NA,Mykolaiv,1141324,3,0,527,12
2020-07-23,Ukraine,NA,Mykolaiv,1141324,3,0,530,12
2020-07-24,Ukraine,NA,Mykolaiv,1141324,6,0,536,12
2020-07-25,Ukraine,NA,Mykolaiv,1141324,3,0,539,12
2020-07-26,Ukraine,NA,Mykolaiv,1141324,7,1,546,13
2020-07-27,Ukraine,NA,Mykolaiv,1141324,13,0,559,13
2020-07-28,Ukraine,NA,Mykolaiv,1141324,3,0,562,13
2020-07-29,Ukraine,NA,Mykolaiv,1141324,1,1,563,14
2020-07-30,Ukraine,NA,Mykolaiv,1141324,15,0,578,14
2020-07-31,Ukraine,NA,Mykolaiv,1141324,12,0,590,14
2020-08-01,Ukraine,NA,Mykolaiv,1141324,12,0,602,14
2020-08-02,Ukraine,NA,Mykolaiv,1141324,19,0,621,14
2020-08-03,Ukraine,NA,Mykolaiv,1141324,21,0,642,14
2020-08-04,Ukraine,NA,Mykolaiv,1141324,6,0,648,14
2020-08-05,Ukraine,NA,Mykolaiv,1141324,10,0,658,14
2020-08-06,Ukraine,NA,Mykolaiv,1141324,8,0,666,14
2020-08-07,Ukraine,NA,Mykolaiv,1141324,16,1,682,15
2020-08-08,Ukraine,NA,Mykolaiv,1141324,14,0,696,15
2020-08-09,Ukraine,NA,Mykolaiv,1141324,9,1,705,16
2020-08-10,Ukraine,NA,Mykolaiv,1141324,11,1,716,17
2020-08-11,Ukraine,NA,Mykolaiv,1141324,13,1,729,18
2020-08-12,Ukraine,NA,Mykolaiv,1141324,15,0,744,18
2020-08-13,Ukraine,NA,Mykolaiv,1141324,11,0,755,18
2020-08-14,Ukraine,NA,Mykolaiv,1141324,15,0,770,18
2020-08-15,Ukraine,NA,Mykolaiv,1141324,27,0,797,18
2020-08-16,Ukraine,NA,Mykolaiv,1141324,11,0,808,18
2020-08-17,Ukraine,NA,Mykolaiv,1141324,11,0,819,18
2020-08-18,Ukraine,NA,Mykolaiv,1141324,13,0,832,18
2020-08-19,Ukraine,NA,Mykolaiv,1141324,25,0,857,18
2020-08-20,Ukraine,NA,Mykolaiv,1141324,36,0,893,18
2020-08-21,Ukraine,NA,Mykolaiv,1141324,19,0,912,18
2020-08-22,Ukraine,NA,Mykolaiv,1141324,26,0,938,18
2020-08-23,Ukraine,NA,Mykolaiv,1141324,43,0,981,18
2020-08-24,Ukraine,NA,Mykolaiv,1141324,16,1,997,19
2020-08-25,Ukraine,NA,Mykolaiv,1141324,7,0,1004,19
2020-08-26,Ukraine,NA,Mykolaiv,1141324,19,2,1023,21
2020-08-27,Ukraine,NA,Mykolaiv,1141324,17,1,1040,22
2020-08-28,Ukraine,NA,Mykolaiv,1141324,37,1,1077,23
2020-08-29,Ukraine,NA,Mykolaiv,1141324,41,2,1118,25
2020-08-30,Ukraine,NA,Mykolaiv,1141324,51,1,1169,26
2020-08-31,Ukraine,NA,Mykolaiv,1141324,83,2,1252,28
2020-09-01,Ukraine,NA,Mykolaiv,1141324,32,1,1284,29
2020-09-02,Ukraine,NA,Mykolaiv,1141324,36,2,1320,31
2020-09-03,Ukraine,NA,Mykolaiv,1141324,52,3,1372,34
2020-09-04,Ukraine,NA,Mykolaiv,1141324,74,0,1446,34
2020-09-05,Ukraine,NA,Mykolaiv,1141324,58,2,1504,36
2020-09-06,Ukraine,NA,Mykolaiv,1141324,77,1,1581,37
2020-09-07,Ukraine,NA,Mykolaiv,1141324,84,2,1665,39
2020-09-08,Ukraine,NA,Mykolaiv,1141324,25,1,1690,40
2020-09-09,Ukraine,NA,Mykolaiv,1141324,24,0,1714,40
2020-09-10,Ukraine,NA,Mykolaiv,1141324,52,3,1766,43
2020-09-11,Ukraine,NA,Mykolaiv,1141324,85,2,1851,45
2020-09-12,Ukraine,NA,Mykolaiv,1141324,78,0,1929,45
2020-09-13,Ukraine,NA,Mykolaiv,1141324,24,0,1953,45
2020-09-14,Ukraine,NA,Mykolaiv,1141324,98,3,2051,48
2020-09-15,Ukraine,NA,Mykolaiv,1141324,63,3,2114,51
2020-09-16,Ukraine,NA,Mykolaiv,1141324,57,2,2171,53
2020-09-17,Ukraine,NA,Mykolaiv,1141324,81,0,2252,53
2020-09-18,Ukraine,NA,Mykolaiv,1141324,68,3,2320,56
2020-09-19,Ukraine,NA,Mykolaiv,1141324,54,1,2374,57
2020-09-20,Ukraine,NA,Mykolaiv,1141324,95,4,2469,61
2020-09-21,Ukraine,NA,Mykolaiv,1141324,82,2,2551,63
2020-09-22,Ukraine,NA,Mykolaiv,1141324,21,0,2572,63
2020-09-23,Ukraine,NA,Mykolaiv,1141324,71,5,2643,68
2020-03-31,Ukraine,NA,Odessa,2383075,4,0,12,0
2020-04-01,Ukraine,NA,Odessa,2383075,2,0,14,0
2020-04-02,Ukraine,NA,Odessa,2383075,4,0,18,0
2020-04-03,Ukraine,NA,Odessa,2383075,8,0,26,0
2020-04-04,Ukraine,NA,Odessa,2383075,0,0,26,0
2020-04-05,Ukraine,NA,Odessa,2383075,0,0,26,0
2020-04-06,Ukraine,NA,Odessa,2383075,1,0,27,0
2020-04-07,Ukraine,NA,Odessa,2383075,3,0,30,0
2020-04-08,Ukraine,NA,Odessa,2383075,2,0,32,0
2020-04-09,Ukraine,NA,Odessa,2383075,11,0,43,0
2020-04-10,Ukraine,NA,Odessa,2383075,3,0,46,0
2020-04-11,Ukraine,NA,Odessa,2383075,5,0,51,0
2020-04-12,Ukraine,NA,Odessa,2383075,12,0,63,0
2020-04-13,Ukraine,NA,Odessa,2383075,6,1,69,1
2020-04-14,Ukraine,NA,Odessa,2383075,0,0,69,1
2020-04-15,Ukraine,NA,Odessa,2383075,1,0,70,1
2020-04-16,Ukraine,NA,Odessa,2383075,3,0,73,1
2020-04-17,Ukraine,NA,Odessa,2383075,20,0,93,1
2020-04-18,Ukraine,NA,Odessa,2383075,13,0,106,1
2020-04-19,Ukraine,NA,Odessa,2383075,6,0,112,1
2020-04-20,Ukraine,NA,Odessa,2383075,25,0,137,1
2020-04-21,Ukraine,NA,Odessa,2383075,9,0,146,1
2020-04-22,Ukraine,NA,Odessa,2383075,2,1,148,2
2020-04-23,Ukraine,NA,Odessa,2383075,13,0,161,2
2020-04-24,Ukraine,NA,Odessa,2383075,8,1,169,3
2020-04-25,Ukraine,NA,Odessa,2383075,14,0,183,3
2020-04-26,Ukraine,NA,Odessa,2383075,37,0,220,3
2020-04-27,Ukraine,NA,Odessa,2383075,20,0,240,3
2020-04-28,Ukraine,NA,Odessa,2383075,8,0,248,3
2020-04-29,Ukraine,NA,Odessa,2383075,13,0,261,3
2020-04-30,Ukraine,NA,Odessa,2383075,16,0,277,3
2020-05-01,Ukraine,NA,Odessa,2383075,19,0,296,3
2020-05-02,Ukraine,NA,Odessa,2383075,33,0,329,3
2020-05-03,Ukraine,NA,Odessa,2383075,80,0,409,3
2020-05-04,Ukraine,NA,Odessa,2383075,18,0,427,3
2020-05-05,Ukraine,NA,Odessa,2383075,42,0,469,3
2020-05-06,Ukraine,NA,Odessa,2383075,36,0,505,3
2020-05-07,Ukraine,NA,Odessa,2383075,63,1,568,4
2020-05-08,Ukraine,NA,Odessa,2383075,15,1,583,5
2020-05-09,Ukraine,NA,Odessa,2383075,36,0,619,5
2020-05-10,Ukraine,NA,Odessa,2383075,17,0,636,5
2020-05-11,Ukraine,NA,Odessa,2383075,10,0,646,5
2020-05-12,Ukraine,NA,Odessa,2383075,7,1,653,6
2020-05-13,Ukraine,NA,Odessa,2383075,27,0,680,6
2020-05-14,Ukraine,NA,Odessa,2383075,13,1,693,7
2020-05-15,Ukraine,NA,Odessa,2383075,19,0,712,7
2020-05-16,Ukraine,NA,Odessa,2383075,22,1,734,8
2020-05-17,Ukraine,NA,Odessa,2383075,12,0,746,8
2020-05-18,Ukraine,NA,Odessa,2383075,18,2,764,10
2020-05-19,Ukraine,NA,Odessa,2383075,20,3,784,13
2020-05-20,Ukraine,NA,Odessa,2383075,8,0,792,13
2020-05-21,Ukraine,NA,Odessa,2383075,14,1,806,14
2020-05-22,Ukraine,NA,Odessa,2383075,8,0,814,14
2020-05-23,Ukraine,NA,Odessa,2383075,7,0,821,14
2020-05-24,Ukraine,NA,Odessa,2383075,6,0,827,14
2020-05-25,Ukraine,NA,Odessa,2383075,5,0,832,14
2020-05-26,Ukraine,NA,Odessa,2383075,10,0,842,14
2020-05-27,Ukraine,NA,Odessa,2383075,11,0,853,14
2020-05-28,Ukraine,NA,Odessa,2383075,8,0,861,14
2020-05-29,Ukraine,NA,Odessa,2383075,17,1,878,15
2020-05-30,Ukraine,NA,Odessa,2383075,5,0,883,15
2020-05-31,Ukraine,NA,Odessa,2383075,5,1,888,16
2020-06-01,Ukraine,NA,Odessa,2383075,8,1,896,17
2020-06-02,Ukraine,NA,Odessa,2383075,0,0,896,17
2020-06-03,Ukraine,NA,Odessa,2383075,17,0,913,17
2020-06-04,Ukraine,NA,Odessa,2383075,20,1,933,18
2020-06-05,Ukraine,NA,Odessa,2383075,37,0,970,18
2020-06-06,Ukraine,NA,Odessa,2383075,16,0,986,18
2020-06-07,Ukraine,NA,Odessa,2383075,10,0,996,18
2020-06-08,Ukraine,NA,Odessa,2383075,6,0,1002,18
2020-06-09,Ukraine,NA,Odessa,2383075,8,0,1010,18
2020-06-10,Ukraine,NA,Odessa,2383075,18,0,1028,18
2020-06-11,Ukraine,NA,Odessa,2383075,17,0,1045,18
2020-06-12,Ukraine,NA,Odessa,2383075,20,0,1065,18
2020-06-13,Ukraine,NA,Odessa,2383075,16,0,1081,18
2020-06-14,Ukraine,NA,Odessa,2383075,18,0,1099,18
2020-06-15,Ukraine,NA,Odessa,2383075,18,0,1117,18
2020-06-16,Ukraine,NA,Odessa,2383075,16,0,1133,18
2020-06-17,Ukraine,NA,Odessa,2383075,25,1,1158,19
2020-06-18,Ukraine,NA,Odessa,2383075,30,0,1188,19
2020-06-19,Ukraine,NA,Odessa,2383075,12,0,1200,19
2020-06-20,Ukraine,NA,Odessa,2383075,32,0,1232,19
2020-06-21,Ukraine,NA,Odessa,2383075,34,0,1266,19
2020-06-22,Ukraine,NA,Odessa,2383075,38,2,1304,21
2020-06-23,Ukraine,NA,Odessa,2383075,29,0,1333,21
2020-06-24,Ukraine,NA,Odessa,2383075,37,0,1370,21
2020-06-25,Ukraine,NA,Odessa,2383075,95,0,1465,21
2020-06-26,Ukraine,NA,Odessa,2383075,64,0,1529,21
2020-06-27,Ukraine,NA,Odessa,2383075,38,0,1567,21
2020-06-28,Ukraine,NA,Odessa,2383075,34,0,1601,21
2020-06-29,Ukraine,NA,Odessa,2383075,31,0,1632,21
2020-06-30,Ukraine,NA,Odessa,2383075,66,2,1698,23
2020-07-01,Ukraine,NA,Odessa,2383075,14,1,1712,24
2020-07-02,Ukraine,NA,Odessa,2383075,24,0,1736,24
2020-07-03,Ukraine,NA,Odessa,2383075,56,0,1792,24
2020-07-04,Ukraine,NA,Odessa,2383075,43,0,1835,24
2020-07-05,Ukraine,NA,Odessa,2383075,30,1,1865,25
2020-07-06,Ukraine,NA,Odessa,2383075,18,0,1883,25
2020-07-07,Ukraine,NA,Odessa,2383075,36,0,1919,25
2020-07-08,Ukraine,NA,Odessa,2383075,65,0,1984,25
2020-07-09,Ukraine,NA,Odessa,2383075,68,1,2052,26
2020-07-10,Ukraine,NA,Odessa,2383075,56,1,2108,27
2020-07-11,Ukraine,NA,Odessa,2383075,33,0,2141,27
2020-07-12,Ukraine,NA,Odessa,2383075,33,0,2174,27
2020-07-13,Ukraine,NA,Odessa,2383075,34,3,2208,30
2020-07-14,Ukraine,NA,Odessa,2383075,50,0,2258,30
2020-07-15,Ukraine,NA,Odessa,2383075,56,0,2314,30
2020-07-16,Ukraine,NA,Odessa,2383075,61,2,2375,32
2020-07-17,Ukraine,NA,Odessa,2383075,60,0,2435,32
2020-07-18,Ukraine,NA,Odessa,2383075,57,3,2492,35
2020-07-19,Ukraine,NA,Odessa,2383075,40,0,2532,35
2020-07-20,Ukraine,NA,Odessa,2383075,41,2,2573,37
2020-07-21,Ukraine,NA,Odessa,2383075,65,0,2638,37
2020-07-22,Ukraine,NA,Odessa,2383075,22,1,2660,38
2020-07-23,Ukraine,NA,Odessa,2383075,31,1,2691,39
2020-07-24,Ukraine,NA,Odessa,2383075,58,1,2749,40
2020-07-25,Ukraine,NA,Odessa,2383075,97,2,2846,42
2020-07-26,Ukraine,NA,Odessa,2383075,61,0,2907,42
2020-07-27,Ukraine,NA,Odessa,2383075,53,2,2960,44
2020-07-28,Ukraine,NA,Odessa,2383075,71,0,3031,44
2020-07-29,Ukraine,NA,Odessa,2383075,73,0,3104,44
2020-07-30,Ukraine,NA,Odessa,2383075,46,0,3150,44
2020-07-31,Ukraine,NA,Odessa,2383075,64,1,3214,45
2020-08-01,Ukraine,NA,Odessa,2383075,101,2,3315,47
2020-08-02,Ukraine,NA,Odessa,2383075,99,1,3414,48
2020-08-03,Ukraine,NA,Odessa,2383075,68,0,3482,48
2020-08-04,Ukraine,NA,Odessa,2383075,63,1,3545,49
2020-08-05,Ukraine,NA,Odessa,2383075,93,5,3638,54
2020-08-06,Ukraine,NA,Odessa,2383075,110,8,3748,62
2020-08-07,Ukraine,NA,Odessa,2383075,156,3,3904,65
2020-08-08,Ukraine,NA,Odessa,2383075,165,1,4069,66
2020-08-09,Ukraine,NA,Odessa,2383075,96,1,4165,67
2020-08-10,Ukraine,NA,Odessa,2383075,65,4,4230,71
2020-08-11,Ukraine,NA,Odessa,2383075,134,2,4364,73
2020-08-12,Ukraine,NA,Odessa,2383075,94,0,4458,73
2020-08-13,Ukraine,NA,Odessa,2383075,114,1,4572,74
2020-08-14,Ukraine,NA,Odessa,2383075,160,0,4732,74
2020-08-15,Ukraine,NA,Odessa,2383075,139,5,4871,79
2020-08-16,Ukraine,NA,Odessa,2383075,93,1,4964,80
2020-08-17,Ukraine,NA,Odessa,2383075,98,0,5062,80
2020-08-18,Ukraine,NA,Odessa,2383075,96,1,5158,81
2020-08-19,Ukraine,NA,Odessa,2383075,123,1,5281,82
2020-08-20,Ukraine,NA,Odessa,2383075,127,0,5408,82
2020-08-21,Ukraine,NA,Odessa,2383075,170,3,5578,85
2020-08-22,Ukraine,NA,Odessa,2383075,210,1,5788,86
2020-08-23,Ukraine,NA,Odessa,2383075,121,2,5909,88
2020-08-24,Ukraine,NA,Odessa,2383075,145,0,6054,88
2020-08-25,Ukraine,NA,Odessa,2383075,112,0,6166,88
2020-08-26,Ukraine,NA,Odessa,2383075,186,2,6352,90
2020-08-27,Ukraine,NA,Odessa,2383075,185,3,6537,93
2020-08-28,Ukraine,NA,Odessa,2383075,214,6,6751,99
2020-08-29,Ukraine,NA,Odessa,2383075,170,3,6921,102
2020-08-30,Ukraine,NA,Odessa,2383075,173,0,7094,102
2020-08-31,Ukraine,NA,Odessa,2383075,189,0,7283,102
2020-09-01,Ukraine,NA,Odessa,2383075,211,6,7494,108
2020-09-02,Ukraine,NA,Odessa,2383075,203,2,7697,110
2020-09-03,Ukraine,NA,Odessa,2383075,116,3,7813,113
2020-09-04,Ukraine,NA,Odessa,2383075,225,5,8038,118
2020-09-05,Ukraine,NA,Odessa,2383075,222,4,8260,122
2020-09-06,Ukraine,NA,Odessa,2383075,120,1,8380,123
2020-09-07,Ukraine,NA,Odessa,2383075,145,1,8525,124
2020-09-08,Ukraine,NA,Odessa,2383075,196,11,8721,135
2020-09-09,Ukraine,NA,Odessa,2383075,106,1,8827,136
2020-09-10,Ukraine,NA,Odessa,2383075,47,2,8874,138
2020-09-11,Ukraine,NA,Odessa,2383075,283,4,9157,142
2020-09-12,Ukraine,NA,Odessa,2383075,225,7,9382,149
2020-09-13,Ukraine,NA,Odessa,2383075,100,0,9482,149
2020-09-14,Ukraine,NA,Odessa,2383075,205,0,9687,149
2020-09-15,Ukraine,NA,Odessa,2383075,306,3,9993,152
2020-09-16,Ukraine,NA,Odessa,2383075,284,2,10277,154
2020-09-17,Ukraine,NA,Odessa,2383075,325,1,10602,155
2020-09-18,Ukraine,NA,Odessa,2383075,322,3,10924,158
2020-09-19,Ukraine,NA,Odessa,2383075,281,2,11205,160
2020-09-20,Ukraine,NA,Odessa,2383075,217,0,11422,160
2020-09-21,Ukraine,NA,Odessa,2383075,188,0,11610,160
2020-09-22,Ukraine,NA,Odessa,2383075,233,5,11843,165
2020-09-23,Ukraine,NA,Odessa,2383075,287,2,12130,167
2020-04-06,Ukraine,NA,Poltava,1413829,2,0,11,0
2020-04-07,Ukraine,NA,Poltava,1413829,1,0,12,0
2020-04-08,Ukraine,NA,Poltava,1413829,5,0,17,0
2020-04-09,Ukraine,NA,Poltava,1413829,2,0,19,0
2020-04-10,Ukraine,NA,Poltava,1413829,1,0,20,0
2020-04-11,Ukraine,NA,Poltava,1413829,4,0,24,0
2020-04-12,Ukraine,NA,Poltava,1413829,1,0,25,0
2020-04-13,Ukraine,NA,Poltava,1413829,0,0,25,0
2020-04-14,Ukraine,NA,Poltava,1413829,1,0,26,0
2020-04-15,Ukraine,NA,Poltava,1413829,1,0,27,0
2020-04-16,Ukraine,NA,Poltava,1413829,0,1,27,1
2020-04-17,Ukraine,NA,Poltava,1413829,14,0,41,1
2020-04-18,Ukraine,NA,Poltava,1413829,8,0,49,1
2020-04-19,Ukraine,NA,Poltava,1413829,12,0,61,1
2020-04-20,Ukraine,NA,Poltava,1413829,2,0,63,1
2020-04-21,Ukraine,NA,Poltava,1413829,38,0,101,1
2020-04-22,Ukraine,NA,Poltava,1413829,15,0,116,1
2020-04-23,Ukraine,NA,Poltava,1413829,45,2,161,3
2020-04-24,Ukraine,NA,Poltava,1413829,0,0,161,3
2020-04-25,Ukraine,NA,Poltava,1413829,8,0,169,3
2020-04-26,Ukraine,NA,Poltava,1413829,3,0,172,3
2020-04-27,Ukraine,NA,Poltava,1413829,1,0,173,3
2020-04-28,Ukraine,NA,Poltava,1413829,7,0,180,3
2020-04-29,Ukraine,NA,Poltava,1413829,8,3,188,6
2020-04-30,Ukraine,NA,Poltava,1413829,15,0,203,6
2020-05-01,Ukraine,NA,Poltava,1413829,8,1,211,7
2020-05-02,Ukraine,NA,Poltava,1413829,1,0,212,7
2020-05-03,Ukraine,NA,Poltava,1413829,10,0,222,7
2020-05-04,Ukraine,NA,Poltava,1413829,5,1,227,8
2020-05-05,Ukraine,NA,Poltava,1413829,4,0,231,8
2020-05-06,Ukraine,NA,Poltava,1413829,1,0,232,8
2020-05-07,Ukraine,NA,Poltava,1413829,4,0,236,8
2020-05-08,Ukraine,NA,Poltava,1413829,3,0,239,8
2020-05-09,Ukraine,NA,Poltava,1413829,1,0,240,8
2020-05-10,Ukraine,NA,Poltava,1413829,6,0,246,8
2020-05-11,Ukraine,NA,Poltava,1413829,1,0,247,8
2020-05-12,Ukraine,NA,Poltava,1413829,1,0,248,8
2020-05-13,Ukraine,NA,Poltava,1413829,9,0,257,8
2020-05-14,Ukraine,NA,Poltava,1413829,0,0,257,8
2020-05-15,Ukraine,NA,Poltava,1413829,0,0,257,8
2020-05-16,Ukraine,NA,Poltava,1413829,6,1,263,9
2020-05-17,Ukraine,NA,Poltava,1413829,1,0,264,9
2020-05-18,Ukraine,NA,Poltava,1413829,0,0,264,9
2020-05-19,Ukraine,NA,Poltava,1413829,0,1,264,10
2020-05-20,Ukraine,NA,Poltava,1413829,1,0,265,10
2020-05-21,Ukraine,NA,Poltava,1413829,1,0,266,10
2020-05-22,Ukraine,NA,Poltava,1413829,0,0,266,10
2020-05-23,Ukraine,NA,Poltava,1413829,0,1,266,11
2020-05-24,Ukraine,NA,Poltava,1413829,0,0,266,11
2020-05-25,Ukraine,NA,Poltava,1413829,0,0,266,11
2020-05-26,Ukraine,NA,Poltava,1413829,1,1,267,12
2020-05-27,Ukraine,NA,Poltava,1413829,0,1,267,13
2020-05-28,Ukraine,NA,Poltava,1413829,1,0,268,13
2020-05-29,Ukraine,NA,Poltava,1413829,0,0,268,13
2020-05-30,Ukraine,NA,Poltava,1413829,0,0,268,13
2020-05-31,Ukraine,NA,Poltava,1413829,2,0,270,13
2020-06-01,Ukraine,NA,Poltava,1413829,0,0,270,13
2020-06-02,Ukraine,NA,Poltava,1413829,1,0,271,13
2020-06-03,Ukraine,NA,Poltava,1413829,1,0,272,13
2020-06-04,Ukraine,NA,Poltava,1413829,0,0,272,13
2020-06-05,Ukraine,NA,Poltava,1413829,0,0,272,13
2020-06-06,Ukraine,NA,Poltava,1413829,1,0,273,13
2020-06-07,Ukraine,NA,Poltava,1413829,1,0,274,13
2020-06-08,Ukraine,NA,Poltava,1413829,0,0,274,13
2020-06-09,Ukraine,NA,Poltava,1413829,0,0,274,13
2020-06-10,Ukraine,NA,Poltava,1413829,2,0,276,13
2020-06-11,Ukraine,NA,Poltava,1413829,0,0,276,13
2020-06-12,Ukraine,NA,Poltava,1413829,1,0,277,13
2020-06-13,Ukraine,NA,Poltava,1413829,1,0,278,13
2020-06-14,Ukraine,NA,Poltava,1413829,0,0,278,13
2020-06-15,Ukraine,NA,Poltava,1413829,0,0,278,13
2020-06-16,Ukraine,NA,Poltava,1413829,1,0,279,13
2020-06-17,Ukraine,NA,Poltava,1413829,2,0,281,13
2020-06-18,Ukraine,NA,Poltava,1413829,6,0,287,13
2020-06-19,Ukraine,NA,Poltava,1413829,2,0,289,13
2020-06-20,Ukraine,NA,Poltava,1413829,1,0,290,13
2020-06-21,Ukraine,NA,Poltava,1413829,1,0,291,13
2020-06-22,Ukraine,NA,Poltava,1413829,2,0,293,13
2020-06-23,Ukraine,NA,Poltava,1413829,3,0,296,13
2020-06-24,Ukraine,NA,Poltava,1413829,4,0,300,13
2020-06-25,Ukraine,NA,Poltava,1413829,1,0,301,13
2020-06-26,Ukraine,NA,Poltava,1413829,3,0,304,13
2020-06-27,Ukraine,NA,Poltava,1413829,5,0,309,13
2020-06-28,Ukraine,NA,Poltava,1413829,1,0,310,13
2020-06-29,Ukraine,NA,Poltava,1413829,2,0,312,13
2020-06-30,Ukraine,NA,Poltava,1413829,2,0,314,13
2020-07-01,Ukraine,NA,Poltava,1413829,5,0,319,13
2020-07-02,Ukraine,NA,Poltava,1413829,1,0,320,13
2020-07-03,Ukraine,NA,Poltava,1413829,2,0,322,13
2020-07-04,Ukraine,NA,Poltava,1413829,0,0,322,13
2020-07-05,Ukraine,NA,Poltava,1413829,2,0,324,13
2020-07-06,Ukraine,NA,Poltava,1413829,0,0,324,13
2020-07-07,Ukraine,NA,Poltava,1413829,1,0,325,13
2020-07-08,Ukraine,NA,Poltava,1413829,1,0,326,13
2020-07-09,Ukraine,NA,Poltava,1413829,1,0,327,13
2020-07-10,Ukraine,NA,Poltava,1413829,3,0,330,13
2020-07-11,Ukraine,NA,Poltava,1413829,1,0,331,13
2020-07-12,Ukraine,NA,Poltava,1413829,0,0,331,13
2020-07-13,Ukraine,NA,Poltava,1413829,3,0,334,13
2020-07-14,Ukraine,NA,Poltava,1413829,0,0,334,13
2020-07-15,Ukraine,NA,Poltava,1413829,3,0,337,13
2020-07-16,Ukraine,NA,Poltava,1413829,6,0,343,13
2020-07-17,Ukraine,NA,Poltava,1413829,4,0,347,13
2020-07-18,Ukraine,NA,Poltava,1413829,1,0,348,13
2020-07-19,Ukraine,NA,Poltava,1413829,3,0,351,13
2020-07-20,Ukraine,NA,Poltava,1413829,2,0,353,13
2020-07-21,Ukraine,NA,Poltava,1413829,3,0,356,13
2020-07-22,Ukraine,NA,Poltava,1413829,4,0,360,13
2020-07-23,Ukraine,NA,Poltava,1413829,11,1,371,14
2020-07-24,Ukraine,NA,Poltava,1413829,7,0,378,14
2020-07-25,Ukraine,NA,Poltava,1413829,10,0,388,14
2020-07-26,Ukraine,NA,Poltava,1413829,6,0,394,14
2020-07-27,Ukraine,NA,Poltava,1413829,0,0,394,14
2020-07-28,Ukraine,NA,Poltava,1413829,7,0,401,14
2020-07-29,Ukraine,NA,Poltava,1413829,13,1,414,15
2020-07-30,Ukraine,NA,Poltava,1413829,17,0,431,15
2020-07-31,Ukraine,NA,Poltava,1413829,9,0,440,15
2020-08-01,Ukraine,NA,Poltava,1413829,6,0,446,15
2020-08-02,Ukraine,NA,Poltava,1413829,13,0,459,15
2020-08-03,Ukraine,NA,Poltava,1413829,0,0,459,15
2020-08-04,Ukraine,NA,Poltava,1413829,7,0,466,15
2020-08-05,Ukraine,NA,Poltava,1413829,6,0,472,15
2020-08-06,Ukraine,NA,Poltava,1413829,5,0,477,15
2020-08-07,Ukraine,NA,Poltava,1413829,12,0,489,15
2020-08-08,Ukraine,NA,Poltava,1413829,2,0,491,15
2020-08-09,Ukraine,NA,Poltava,1413829,3,0,494,15
2020-08-10,Ukraine,NA,Poltava,1413829,3,0,497,15
2020-08-11,Ukraine,NA,Poltava,1413829,6,0,503,15
2020-08-12,Ukraine,NA,Poltava,1413829,11,0,514,15
2020-08-13,Ukraine,NA,Poltava,1413829,2,0,516,15
2020-08-14,Ukraine,NA,Poltava,1413829,17,0,533,15
2020-08-15,Ukraine,NA,Poltava,1413829,11,0,544,15
2020-08-16,Ukraine,NA,Poltava,1413829,4,0,548,15
2020-08-17,Ukraine,NA,Poltava,1413829,9,0,557,15
2020-08-18,Ukraine,NA,Poltava,1413829,8,0,565,15
2020-08-19,Ukraine,NA,Poltava,1413829,17,0,582,15
2020-08-20,Ukraine,NA,Poltava,1413829,12,1,594,16
2020-08-21,Ukraine,NA,Poltava,1413829,20,0,614,16
2020-08-22,Ukraine,NA,Poltava,1413829,22,0,636,16
2020-08-23,Ukraine,NA,Poltava,1413829,6,0,642,16
2020-08-24,Ukraine,NA,Poltava,1413829,21,1,663,17
2020-08-25,Ukraine,NA,Poltava,1413829,14,0,677,17
2020-08-26,Ukraine,NA,Poltava,1413829,7,0,684,17
2020-08-27,Ukraine,NA,Poltava,1413829,11,1,695,18
2020-08-28,Ukraine,NA,Poltava,1413829,10,2,705,20
2020-08-29,Ukraine,NA,Poltava,1413829,33,0,738,20
2020-08-30,Ukraine,NA,Poltava,1413829,32,0,770,20
2020-08-31,Ukraine,NA,Poltava,1413829,19,0,789,20
2020-09-01,Ukraine,NA,Poltava,1413829,19,0,808,20
2020-09-02,Ukraine,NA,Poltava,1413829,24,0,832,20
2020-09-03,Ukraine,NA,Poltava,1413829,23,2,855,22
2020-09-04,Ukraine,NA,Poltava,1413829,31,0,886,22
2020-09-05,Ukraine,NA,Poltava,1413829,30,0,916,22
2020-09-06,Ukraine,NA,Poltava,1413829,29,0,945,22
2020-09-07,Ukraine,NA,Poltava,1413829,28,0,973,22
2020-09-08,Ukraine,NA,Poltava,1413829,24,0,997,22
2020-09-09,Ukraine,NA,Poltava,1413829,21,2,1018,24
2020-09-10,Ukraine,NA,Poltava,1413829,51,2,1069,26
2020-09-11,Ukraine,NA,Poltava,1413829,61,0,1130,26
2020-09-12,Ukraine,NA,Poltava,1413829,31,1,1161,27
2020-09-13,Ukraine,NA,Poltava,1413829,34,0,1195,27
2020-09-14,Ukraine,NA,Poltava,1413829,28,1,1223,28
2020-09-15,Ukraine,NA,Poltava,1413829,30,2,1253,30
2020-09-16,Ukraine,NA,Poltava,1413829,54,0,1307,30
2020-09-17,Ukraine,NA,Poltava,1413829,56,3,1363,33
2020-09-18,Ukraine,NA,Poltava,1413829,27,0,1390,33
2020-09-19,Ukraine,NA,Poltava,1413829,71,0,1461,33
2020-09-20,Ukraine,NA,Poltava,1413829,38,0,1499,33
2020-09-21,Ukraine,NA,Poltava,1413829,35,0,1534,33
2020-09-22,Ukraine,NA,Poltava,1413829,41,1,1575,34
2020-09-23,Ukraine,NA,Poltava,1413829,55,0,1630,34
2020-03-30,Ukraine,NA,Rivne,1160647,2,1,11,2
2020-03-31,Ukraine,NA,Rivne,1160647,4,1,15,3
2020-04-01,Ukraine,NA,Rivne,1160647,4,0,19,3
2020-04-02,Ukraine,NA,Rivne,1160647,4,0,23,3
2020-04-03,Ukraine,NA,Rivne,1160647,8,1,31,4
2020-04-04,Ukraine,NA,Rivne,1160647,0,0,31,4
2020-04-05,Ukraine,NA,Rivne,1160647,7,1,38,5
2020-04-06,Ukraine,NA,Rivne,1160647,1,0,39,5
2020-04-07,Ukraine,NA,Rivne,1160647,1,0,40,5
2020-04-08,Ukraine,NA,Rivne,1160647,4,1,44,6
2020-04-09,Ukraine,NA,Rivne,1160647,20,0,64,6
2020-04-10,Ukraine,NA,Rivne,1160647,21,0,85,6
2020-04-11,Ukraine,NA,Rivne,1160647,18,0,103,6
2020-04-12,Ukraine,NA,Rivne,1160647,16,1,119,7
2020-04-13,Ukraine,NA,Rivne,1160647,6,0,125,7
2020-04-14,Ukraine,NA,Rivne,1160647,9,0,134,7
2020-04-15,Ukraine,NA,Rivne,1160647,39,0,173,7
2020-04-16,Ukraine,NA,Rivne,1160647,31,0,204,7
2020-04-17,Ukraine,NA,Rivne,1160647,36,1,240,8
2020-04-18,Ukraine,NA,Rivne,1160647,43,1,283,9
2020-04-19,Ukraine,NA,Rivne,1160647,25,0,308,9
2020-04-20,Ukraine,NA,Rivne,1160647,4,2,312,11
2020-04-21,Ukraine,NA,Rivne,1160647,29,0,341,11
2020-04-22,Ukraine,NA,Rivne,1160647,12,0,353,11
2020-04-23,Ukraine,NA,Rivne,1160647,43,0,396,11
2020-04-24,Ukraine,NA,Rivne,1160647,41,0,437,11
2020-04-25,Ukraine,NA,Rivne,1160647,46,0,483,11
2020-04-26,Ukraine,NA,Rivne,1160647,25,0,508,11
2020-04-27,Ukraine,NA,Rivne,1160647,14,0,522,11
2020-04-28,Ukraine,NA,Rivne,1160647,31,0,553,11
2020-04-29,Ukraine,NA,Rivne,1160647,35,0,588,11
2020-04-30,Ukraine,NA,Rivne,1160647,49,0,637,11
2020-05-01,Ukraine,NA,Rivne,1160647,21,0,658,11
2020-05-02,Ukraine,NA,Rivne,1160647,31,0,689,11
2020-05-03,Ukraine,NA,Rivne,1160647,37,1,726,12
2020-05-04,Ukraine,NA,Rivne,1160647,24,0,750,12
2020-05-05,Ukraine,NA,Rivne,1160647,29,0,779,12
2020-05-06,Ukraine,NA,Rivne,1160647,8,0,787,12
2020-05-07,Ukraine,NA,Rivne,1160647,30,0,817,12
2020-05-08,Ukraine,NA,Rivne,1160647,38,2,855,14
2020-05-09,Ukraine,NA,Rivne,1160647,22,2,877,16
2020-05-10,Ukraine,NA,Rivne,1160647,49,0,926,16
2020-05-11,Ukraine,NA,Rivne,1160647,52,5,978,21
2020-05-12,Ukraine,NA,Rivne,1160647,50,1,1028,22
2020-05-13,Ukraine,NA,Rivne,1160647,17,1,1045,23
2020-05-14,Ukraine,NA,Rivne,1160647,17,1,1062,24
2020-05-15,Ukraine,NA,Rivne,1160647,12,0,1074,24
2020-05-16,Ukraine,NA,Rivne,1160647,30,0,1104,24
2020-05-17,Ukraine,NA,Rivne,1160647,22,1,1126,25
2020-05-18,Ukraine,NA,Rivne,1160647,41,3,1167,28
2020-05-19,Ukraine,NA,Rivne,1160647,21,1,1188,29
2020-05-20,Ukraine,NA,Rivne,1160647,29,0,1217,29
2020-05-21,Ukraine,NA,Rivne,1160647,70,0,1287,29
2020-05-22,Ukraine,NA,Rivne,1160647,36,0,1323,29
2020-05-23,Ukraine,NA,Rivne,1160647,45,1,1368,30
2020-05-24,Ukraine,NA,Rivne,1160647,49,1,1417,31
2020-05-25,Ukraine,NA,Rivne,1160647,17,0,1434,31
2020-05-26,Ukraine,NA,Rivne,1160647,41,3,1475,34
2020-05-27,Ukraine,NA,Rivne,1160647,39,0,1514,34
2020-05-28,Ukraine,NA,Rivne,1160647,74,1,1588,35
2020-05-29,Ukraine,NA,Rivne,1160647,40,0,1628,35
2020-05-30,Ukraine,NA,Rivne,1160647,52,2,1680,37
2020-05-31,Ukraine,NA,Rivne,1160647,33,0,1713,37
2020-06-01,Ukraine,NA,Rivne,1160647,57,1,1770,38
2020-06-02,Ukraine,NA,Rivne,1160647,53,1,1823,39
2020-06-03,Ukraine,NA,Rivne,1160647,50,1,1873,40
2020-06-04,Ukraine,NA,Rivne,1160647,32,0,1905,40
2020-06-05,Ukraine,NA,Rivne,1160647,57,0,1962,40
2020-06-06,Ukraine,NA,Rivne,1160647,52,0,2014,40
2020-06-07,Ukraine,NA,Rivne,1160647,32,0,2046,40
2020-06-08,Ukraine,NA,Rivne,1160647,25,0,2071,40
2020-06-09,Ukraine,NA,Rivne,1160647,23,4,2094,44
2020-06-10,Ukraine,NA,Rivne,1160647,28,1,2122,45
2020-06-11,Ukraine,NA,Rivne,1160647,53,0,2175,45
2020-06-12,Ukraine,NA,Rivne,1160647,56,1,2231,46
2020-06-13,Ukraine,NA,Rivne,1160647,66,0,2297,46
2020-06-14,Ukraine,NA,Rivne,1160647,44,0,2341,46
2020-06-15,Ukraine,NA,Rivne,1160647,28,0,2369,46
2020-06-16,Ukraine,NA,Rivne,1160647,104,1,2473,47
2020-06-17,Ukraine,NA,Rivne,1160647,26,3,2499,50
2020-06-18,Ukraine,NA,Rivne,1160647,73,1,2572,51
2020-06-19,Ukraine,NA,Rivne,1160647,121,2,2693,53
2020-06-20,Ukraine,NA,Rivne,1160647,83,2,2776,55
2020-06-21,Ukraine,NA,Rivne,1160647,96,2,2872,57
2020-06-22,Ukraine,NA,Rivne,1160647,91,0,2963,57
2020-06-23,Ukraine,NA,Rivne,1160647,75,1,3038,58
2020-06-24,Ukraine,NA,Rivne,1160647,126,3,3164,61
2020-06-25,Ukraine,NA,Rivne,1160647,84,3,3248,64
2020-06-26,Ukraine,NA,Rivne,1160647,116,2,3364,66
2020-06-27,Ukraine,NA,Rivne,1160647,111,0,3475,66
2020-06-28,Ukraine,NA,Rivne,1160647,93,0,3568,66
2020-06-29,Ukraine,NA,Rivne,1160647,70,2,3638,68
2020-06-30,Ukraine,NA,Rivne,1160647,74,2,3712,70
2020-07-01,Ukraine,NA,Rivne,1160647,72,0,3784,70
2020-07-02,Ukraine,NA,Rivne,1160647,93,0,3877,70
2020-07-03,Ukraine,NA,Rivne,1160647,73,4,3950,74
2020-07-04,Ukraine,NA,Rivne,1160647,91,1,4041,75
2020-07-05,Ukraine,NA,Rivne,1160647,67,2,4108,77
2020-07-06,Ukraine,NA,Rivne,1160647,82,0,4190,77
2020-07-07,Ukraine,NA,Rivne,1160647,38,1,4228,78
2020-07-08,Ukraine,NA,Rivne,1160647,76,0,4304,78
2020-07-09,Ukraine,NA,Rivne,1160647,76,1,4380,79
2020-07-10,Ukraine,NA,Rivne,1160647,74,0,4454,79
2020-07-11,Ukraine,NA,Rivne,1160647,66,1,4520,80
2020-07-12,Ukraine,NA,Rivne,1160647,78,0,4598,80
2020-07-13,Ukraine,NA,Rivne,1160647,99,0,4697,80
2020-07-14,Ukraine,NA,Rivne,1160647,43,2,4740,82
2020-07-15,Ukraine,NA,Rivne,1160647,42,1,4782,83
2020-07-16,Ukraine,NA,Rivne,1160647,70,0,4852,83
2020-07-17,Ukraine,NA,Rivne,1160647,88,1,4940,84
2020-07-18,Ukraine,NA,Rivne,1160647,75,3,5015,87
2020-07-19,Ukraine,NA,Rivne,1160647,67,0,5082,87
2020-07-20,Ukraine,NA,Rivne,1160647,62,2,5144,89
2020-07-21,Ukraine,NA,Rivne,1160647,39,0,5183,89
2020-07-22,Ukraine,NA,Rivne,1160647,49,2,5232,91
2020-07-23,Ukraine,NA,Rivne,1160647,71,0,5303,91
2020-07-24,Ukraine,NA,Rivne,1160647,96,0,5399,91
2020-07-25,Ukraine,NA,Rivne,1160647,143,0,5542,91
2020-07-26,Ukraine,NA,Rivne,1160647,81,1,5623,92
2020-07-27,Ukraine,NA,Rivne,1160647,78,0,5701,92
2020-07-28,Ukraine,NA,Rivne,1160647,83,0,5784,92
2020-07-29,Ukraine,NA,Rivne,1160647,53,0,5837,92
2020-07-30,Ukraine,NA,Rivne,1160647,105,1,5942,93
2020-07-31,Ukraine,NA,Rivne,1160647,82,0,6024,93
2020-08-01,Ukraine,NA,Rivne,1160647,87,0,6111,93
2020-08-02,Ukraine,NA,Rivne,1160647,84,1,6195,94
2020-08-03,Ukraine,NA,Rivne,1160647,75,3,6270,97
2020-08-04,Ukraine,NA,Rivne,1160647,85,2,6355,99
2020-08-05,Ukraine,NA,Rivne,1160647,87,1,6442,100
2020-08-06,Ukraine,NA,Rivne,1160647,96,1,6538,101
2020-08-07,Ukraine,NA,Rivne,1160647,100,2,6638,103
2020-08-08,Ukraine,NA,Rivne,1160647,109,0,6747,103
2020-08-09,Ukraine,NA,Rivne,1160647,93,0,6840,103
2020-08-10,Ukraine,NA,Rivne,1160647,83,1,6923,104
2020-08-11,Ukraine,NA,Rivne,1160647,95,1,7018,105
2020-08-12,Ukraine,NA,Rivne,1160647,96,1,7114,106
2020-08-13,Ukraine,NA,Rivne,1160647,92,0,7206,106
2020-08-14,Ukraine,NA,Rivne,1160647,120,0,7326,106
2020-08-15,Ukraine,NA,Rivne,1160647,107,1,7433,107
2020-08-16,Ukraine,NA,Rivne,1160647,105,1,7538,108
2020-08-17,Ukraine,NA,Rivne,1160647,178,2,7716,110
2020-08-18,Ukraine,NA,Rivne,1160647,112,0,7828,110
2020-08-19,Ukraine,NA,Rivne,1160647,125,5,7953,115
2020-08-20,Ukraine,NA,Rivne,1160647,138,0,8091,115
2020-08-21,Ukraine,NA,Rivne,1160647,147,0,8238,115
2020-08-22,Ukraine,NA,Rivne,1160647,145,1,8383,116
2020-08-23,Ukraine,NA,Rivne,1160647,77,3,8460,119
2020-08-24,Ukraine,NA,Rivne,1160647,99,0,8559,119
2020-08-25,Ukraine,NA,Rivne,1160647,85,0,8644,119
2020-08-26,Ukraine,NA,Rivne,1160647,93,2,8737,121
2020-08-27,Ukraine,NA,Rivne,1160647,81,3,8818,124
2020-08-28,Ukraine,NA,Rivne,1160647,103,2,8921,126
2020-08-29,Ukraine,NA,Rivne,1160647,98,1,9019,127
2020-08-30,Ukraine,NA,Rivne,1160647,79,2,9098,129
2020-08-31,Ukraine,NA,Rivne,1160647,84,1,9182,130
2020-09-01,Ukraine,NA,Rivne,1160647,87,1,9269,131
2020-09-02,Ukraine,NA,Rivne,1160647,127,1,9396,132
2020-09-03,Ukraine,NA,Rivne,1160647,80,2,9476,134
2020-09-04,Ukraine,NA,Rivne,1160647,59,1,9535,135
2020-09-05,Ukraine,NA,Rivne,1160647,99,0,9634,135
2020-09-06,Ukraine,NA,Rivne,1160647,26,0,9660,135
2020-09-07,Ukraine,NA,Rivne,1160647,102,1,9762,136
2020-09-08,Ukraine,NA,Rivne,1160647,98,2,9860,138
2020-09-09,Ukraine,NA,Rivne,1160647,83,0,9943,138
2020-09-10,Ukraine,NA,Rivne,1160647,130,3,10073,141
2020-09-11,Ukraine,NA,Rivne,1160647,144,1,10217,142
2020-09-12,Ukraine,NA,Rivne,1160647,152,0,10369,142
2020-09-13,Ukraine,NA,Rivne,1160647,100,0,10469,142
2020-09-14,Ukraine,NA,Rivne,1160647,86,1,10555,143
2020-09-15,Ukraine,NA,Rivne,1160647,80,1,10635,144
2020-09-16,Ukraine,NA,Rivne,1160647,72,3,10707,147
2020-09-17,Ukraine,NA,Rivne,1160647,90,1,10797,148
2020-09-18,Ukraine,NA,Rivne,1160647,120,1,10917,149
2020-09-19,Ukraine,NA,Rivne,1160647,98,2,11015,151
2020-09-20,Ukraine,NA,Rivne,1160647,109,0,11124,151
2020-09-21,Ukraine,NA,Rivne,1160647,118,0,11242,151
2020-09-22,Ukraine,NA,Rivne,1160647,111,0,11353,151
2020-09-23,Ukraine,NA,Rivne,1160647,106,4,11459,155
2020-03-31,Ukraine,NA,Sumy,1094284,8,1,17,2
2020-04-01,Ukraine,NA,Sumy,1094284,2,0,19,2
2020-04-02,Ukraine,NA,Sumy,1094284,7,0,26,2
2020-04-03,Ukraine,NA,Sumy,1094284,11,0,37,2
2020-04-04,Ukraine,NA,Sumy,1094284,12,0,49,2
2020-04-05,Ukraine,NA,Sumy,1094284,0,0,49,2
2020-04-06,Ukraine,NA,Sumy,1094284,2,0,51,2
2020-04-07,Ukraine,NA,Sumy,1094284,0,0,51,2
2020-04-08,Ukraine,NA,Sumy,1094284,5,0,56,2
2020-04-09,Ukraine,NA,Sumy,1094284,0,0,56,2
2020-04-10,Ukraine,NA,Sumy,1094284,7,0,63,2
2020-04-11,Ukraine,NA,Sumy,1094284,6,0,69,2
2020-04-12,Ukraine,NA,Sumy,1094284,4,1,73,3
2020-04-13,Ukraine,NA,Sumy,1094284,1,1,74,4
2020-04-14,Ukraine,NA,Sumy,1094284,0,0,74,4
2020-04-15,Ukraine,NA,Sumy,1094284,3,0,77,4
2020-04-16,Ukraine,NA,Sumy,1094284,3,0,80,4
2020-04-17,Ukraine,NA,Sumy,1094284,1,0,81,4
2020-04-18,Ukraine,NA,Sumy,1094284,1,0,82,4
2020-04-19,Ukraine,NA,Sumy,1094284,1,0,83,4
2020-04-20,Ukraine,NA,Sumy,1094284,0,0,83,4
2020-04-21,Ukraine,NA,Sumy,1094284,1,0,84,4
2020-04-22,Ukraine,NA,Sumy,1094284,2,0,86,4
2020-04-23,Ukraine,NA,Sumy,1094284,3,0,89,4
2020-04-24,Ukraine,NA,Sumy,1094284,1,0,90,4
2020-04-25,Ukraine,NA,Sumy,1094284,4,0,94,4
2020-04-26,Ukraine,NA,Sumy,1094284,1,0,95,4
2020-04-27,Ukraine,NA,Sumy,1094284,0,0,95,4
2020-04-28,Ukraine,NA,Sumy,1094284,0,0,95,4
2020-04-29,Ukraine,NA,Sumy,1094284,3,0,98,4
2020-04-30,Ukraine,NA,Sumy,1094284,4,0,102,4
2020-05-01,Ukraine,NA,Sumy,1094284,1,0,103,4
2020-05-02,Ukraine,NA,Sumy,1094284,2,0,105,4
2020-05-03,Ukraine,NA,Sumy,1094284,5,0,110,4
2020-05-04,Ukraine,NA,Sumy,1094284,2,0,112,4
2020-05-05,Ukraine,NA,Sumy,1094284,0,0,112,4
2020-05-06,Ukraine,NA,Sumy,1094284,18,0,130,4
2020-05-07,Ukraine,NA,Sumy,1094284,1,0,131,4
2020-05-08,Ukraine,NA,Sumy,1094284,16,0,147,4
2020-05-09,Ukraine,NA,Sumy,1094284,5,0,152,4
2020-05-10,Ukraine,NA,Sumy,1094284,2,0,154,4
2020-05-11,Ukraine,NA,Sumy,1094284,0,0,154,4
2020-05-12,Ukraine,NA,Sumy,1094284,3,0,157,4
2020-05-13,Ukraine,NA,Sumy,1094284,0,0,157,4
2020-05-14,Ukraine,NA,Sumy,1094284,1,0,158,4
2020-05-15,Ukraine,NA,Sumy,1094284,0,0,158,4
2020-05-16,Ukraine,NA,Sumy,1094284,3,0,161,4
2020-05-17,Ukraine,NA,Sumy,1094284,1,0,162,4
2020-05-18,Ukraine,NA,Sumy,1094284,1,0,163,4
2020-05-19,Ukraine,NA,Sumy,1094284,1,0,164,4
2020-05-20,Ukraine,NA,Sumy,1094284,0,0,164,4
2020-05-21,Ukraine,NA,Sumy,1094284,1,0,165,4
2020-05-22,Ukraine,NA,Sumy,1094284,1,0,166,4
2020-05-23,Ukraine,NA,Sumy,1094284,0,0,166,4
2020-05-24,Ukraine,NA,Sumy,1094284,0,0,166,4
2020-05-25,Ukraine,NA,Sumy,1094284,0,0,166,4
2020-05-26,Ukraine,NA,Sumy,1094284,0,0,166,4
2020-05-27,Ukraine,NA,Sumy,1094284,0,0,166,4
2020-05-28,Ukraine,NA,Sumy,1094284,0,0,166,4
2020-05-29,Ukraine,NA,Sumy,1094284,1,0,167,4
2020-05-30,Ukraine,NA,Sumy,1094284,1,0,168,4
2020-05-31,Ukraine,NA,Sumy,1094284,0,0,168,4
2020-06-01,Ukraine,NA,Sumy,1094284,2,0,170,4
2020-06-02,Ukraine,NA,Sumy,1094284,3,0,173,4
2020-06-03,Ukraine,NA,Sumy,1094284,1,0,174,4
2020-06-04,Ukraine,NA,Sumy,1094284,3,0,177,4
2020-06-05,Ukraine,NA,Sumy,1094284,11,0,188,4
2020-06-06,Ukraine,NA,Sumy,1094284,4,1,192,5
2020-06-07,Ukraine,NA,Sumy,1094284,1,0,193,5
2020-06-08,Ukraine,NA,Sumy,1094284,0,0,193,5
2020-06-09,Ukraine,NA,Sumy,1094284,5,0,198,5
2020-06-10,Ukraine,NA,Sumy,1094284,0,0,198,5
2020-06-11,Ukraine,NA,Sumy,1094284,5,0,203,5
2020-06-12,Ukraine,NA,Sumy,1094284,1,0,204,5
2020-06-13,Ukraine,NA,Sumy,1094284,4,0,208,5
2020-06-14,Ukraine,NA,Sumy,1094284,7,0,215,5
2020-06-15,Ukraine,NA,Sumy,1094284,12,0,227,5
2020-06-16,Ukraine,NA,Sumy,1094284,1,0,228,5
2020-06-17,Ukraine,NA,Sumy,1094284,2,0,230,5
2020-06-18,Ukraine,NA,Sumy,1094284,6,0,236,5
2020-06-19,Ukraine,NA,Sumy,1094284,10,0,246,5
2020-06-20,Ukraine,NA,Sumy,1094284,6,0,252,5
2020-06-21,Ukraine,NA,Sumy,1094284,5,0,257,5
2020-06-22,Ukraine,NA,Sumy,1094284,1,0,258,5
2020-06-23,Ukraine,NA,Sumy,1094284,5,0,263,5
2020-06-24,Ukraine,NA,Sumy,1094284,9,0,272,5
2020-06-25,Ukraine,NA,Sumy,1094284,5,0,277,5
2020-06-26,Ukraine,NA,Sumy,1094284,7,0,284,5
2020-06-27,Ukraine,NA,Sumy,1094284,3,0,287,5
2020-06-28,Ukraine,NA,Sumy,1094284,8,0,295,5
2020-06-29,Ukraine,NA,Sumy,1094284,1,0,296,5
2020-06-30,Ukraine,NA,Sumy,1094284,1,0,297,5
2020-07-01,Ukraine,NA,Sumy,1094284,0,0,297,5
2020-07-02,Ukraine,NA,Sumy,1094284,5,0,302,5
2020-07-03,Ukraine,NA,Sumy,1094284,2,0,304,5
2020-07-04,Ukraine,NA,Sumy,1094284,4,0,308,5
2020-07-05,Ukraine,NA,Sumy,1094284,9,0,317,5
2020-07-06,Ukraine,NA,Sumy,1094284,4,0,321,5
2020-07-07,Ukraine,NA,Sumy,1094284,0,0,321,5
2020-07-08,Ukraine,NA,Sumy,1094284,2,0,323,5
2020-07-09,Ukraine,NA,Sumy,1094284,5,0,328,5
2020-07-10,Ukraine,NA,Sumy,1094284,4,0,332,5
2020-07-11,Ukraine,NA,Sumy,1094284,5,0,337,5
2020-07-12,Ukraine,NA,Sumy,1094284,3,0,340,5
2020-07-13,Ukraine,NA,Sumy,1094284,1,1,341,6
2020-07-14,Ukraine,NA,Sumy,1094284,0,0,341,6
2020-07-15,Ukraine,NA,Sumy,1094284,5,0,346,6
2020-07-16,Ukraine,NA,Sumy,1094284,2,0,348,6
2020-07-17,Ukraine,NA,Sumy,1094284,4,0,352,6
2020-07-18,Ukraine,NA,Sumy,1094284,3,0,355,6
2020-07-19,Ukraine,NA,Sumy,1094284,15,0,370,6
2020-07-20,Ukraine,NA,Sumy,1094284,1,0,371,6
2020-07-21,Ukraine,NA,Sumy,1094284,0,0,371,6
2020-07-22,Ukraine,NA,Sumy,1094284,12,1,383,7
2020-07-23,Ukraine,NA,Sumy,1094284,10,0,393,7
2020-07-24,Ukraine,NA,Sumy,1094284,4,0,397,7
2020-07-25,Ukraine,NA,Sumy,1094284,14,0,411,7
2020-07-26,Ukraine,NA,Sumy,1094284,19,0,430,7
2020-07-27,Ukraine,NA,Sumy,1094284,15,0,445,7
2020-07-28,Ukraine,NA,Sumy,1094284,9,0,454,7
2020-07-29,Ukraine,NA,Sumy,1094284,13,0,467,7
2020-07-30,Ukraine,NA,Sumy,1094284,17,1,484,8
2020-07-31,Ukraine,NA,Sumy,1094284,1,0,485,8
2020-08-01,Ukraine,NA,Sumy,1094284,24,0,509,8
2020-08-02,Ukraine,NA,Sumy,1094284,20,0,529,8
2020-08-03,Ukraine,NA,Sumy,1094284,12,0,541,8
2020-08-04,Ukraine,NA,Sumy,1094284,19,0,560,8
2020-08-05,Ukraine,NA,Sumy,1094284,10,0,570,8
2020-08-06,Ukraine,NA,Sumy,1094284,24,0,594,8
2020-08-07,Ukraine,NA,Sumy,1094284,42,1,636,9
2020-08-08,Ukraine,NA,Sumy,1094284,17,0,653,9
2020-08-09,Ukraine,NA,Sumy,1094284,15,0,668,9
2020-08-10,Ukraine,NA,Sumy,1094284,31,0,699,9
2020-08-11,Ukraine,NA,Sumy,1094284,3,1,702,10
2020-08-12,Ukraine,NA,Sumy,1094284,14,0,716,10
2020-08-13,Ukraine,NA,Sumy,1094284,38,0,754,10
2020-08-14,Ukraine,NA,Sumy,1094284,29,0,783,10
2020-08-15,Ukraine,NA,Sumy,1094284,32,0,815,10
2020-08-16,Ukraine,NA,Sumy,1094284,39,3,854,13
2020-08-17,Ukraine,NA,Sumy,1094284,37,0,891,13
2020-08-18,Ukraine,NA,Sumy,1094284,75,2,966,15
2020-08-19,Ukraine,NA,Sumy,1094284,57,1,1023,16
2020-08-20,Ukraine,NA,Sumy,1094284,55,0,1078,16
2020-08-21,Ukraine,NA,Sumy,1094284,46,2,1124,18
2020-08-22,Ukraine,NA,Sumy,1094284,21,2,1145,20
2020-08-23,Ukraine,NA,Sumy,1094284,20,0,1165,20
2020-08-24,Ukraine,NA,Sumy,1094284,22,0,1187,20
2020-08-25,Ukraine,NA,Sumy,1094284,59,0,1246,20
2020-08-26,Ukraine,NA,Sumy,1094284,23,0,1269,20
2020-08-27,Ukraine,NA,Sumy,1094284,33,0,1302,20
2020-08-28,Ukraine,NA,Sumy,1094284,59,2,1361,22
2020-08-29,Ukraine,NA,Sumy,1094284,37,2,1398,24
2020-08-30,Ukraine,NA,Sumy,1094284,58,0,1456,24
2020-08-31,Ukraine,NA,Sumy,1094284,14,0,1470,24
2020-09-01,Ukraine,NA,Sumy,1094284,62,0,1532,24
2020-09-02,Ukraine,NA,Sumy,1094284,39,1,1571,25
2020-09-03,Ukraine,NA,Sumy,1094284,58,2,1629,27
2020-09-04,Ukraine,NA,Sumy,1094284,51,0,1680,27
2020-09-05,Ukraine,NA,Sumy,1094284,89,2,1769,29
2020-09-06,Ukraine,NA,Sumy,1094284,89,0,1858,29
2020-09-07,Ukraine,NA,Sumy,1094284,105,0,1963,29
2020-09-08,Ukraine,NA,Sumy,1094284,107,2,2070,31
2020-09-09,Ukraine,NA,Sumy,1094284,73,2,2143,33
2020-09-10,Ukraine,NA,Sumy,1094284,44,1,2187,34
2020-09-11,Ukraine,NA,Sumy,1094284,42,2,2229,36
2020-09-12,Ukraine,NA,Sumy,1094284,94,0,2323,36
2020-09-13,Ukraine,NA,Sumy,1094284,78,0,2401,36
2020-09-14,Ukraine,NA,Sumy,1094284,101,1,2502,37
2020-09-15,Ukraine,NA,Sumy,1094284,51,2,2553,39
2020-09-16,Ukraine,NA,Sumy,1094284,87,3,2640,42
2020-09-17,Ukraine,NA,Sumy,1094284,84,0,2724,42
2020-09-18,Ukraine,NA,Sumy,1094284,83,7,2807,49
2020-09-19,Ukraine,NA,Sumy,1094284,109,1,2916,50
2020-09-20,Ukraine,NA,Sumy,1094284,107,0,3023,50
2020-09-21,Ukraine,NA,Sumy,1094284,94,1,3117,51
2020-09-22,Ukraine,NA,Sumy,1094284,67,1,3184,52
2020-09-23,Ukraine,NA,Sumy,1094284,96,3,3280,55
2020-03-26,Ukraine,NA,Ternopil,1052312,7,0,15,1
2020-03-27,Ukraine,NA,Ternopil,1052312,11,0,26,1
2020-03-28,Ukraine,NA,Ternopil,1052312,17,0,43,1
2020-03-29,Ukraine,NA,Ternopil,1052312,14,0,57,1
2020-03-30,Ukraine,NA,Ternopil,1052312,3,0,60,1
2020-03-31,Ukraine,NA,Ternopil,1052312,38,0,98,1
2020-04-01,Ukraine,NA,Ternopil,1052312,8,0,106,1
2020-04-02,Ukraine,NA,Ternopil,1052312,8,0,114,1
2020-04-03,Ukraine,NA,Ternopil,1052312,19,1,133,2
2020-04-04,Ukraine,NA,Ternopil,1052312,27,0,160,2
2020-04-05,Ukraine,NA,Ternopil,1052312,0,0,160,2
2020-04-06,Ukraine,NA,Ternopil,1052312,0,0,160,2
2020-04-07,Ukraine,NA,Ternopil,1052312,8,1,168,3
2020-04-08,Ukraine,NA,Ternopil,1052312,0,0,168,3
2020-04-09,Ukraine,NA,Ternopil,1052312,1,0,169,3
2020-04-10,Ukraine,NA,Ternopil,1052312,27,2,196,5
2020-04-11,Ukraine,NA,Ternopil,1052312,12,0,208,5
2020-04-12,Ukraine,NA,Ternopil,1052312,35,0,243,5
2020-04-13,Ukraine,NA,Ternopil,1052312,30,0,273,5
2020-04-14,Ukraine,NA,Ternopil,1052312,7,0,280,5
2020-04-15,Ukraine,NA,Ternopil,1052312,7,0,287,5
2020-04-16,Ukraine,NA,Ternopil,1052312,46,0,333,5
2020-04-17,Ukraine,NA,Ternopil,1052312,20,0,353,5
2020-04-18,Ukraine,NA,Ternopil,1052312,13,0,366,5
2020-04-19,Ukraine,NA,Ternopil,1052312,24,0,390,5
2020-04-20,Ukraine,NA,Ternopil,1052312,24,1,414,6
2020-04-21,Ukraine,NA,Ternopil,1052312,21,1,435,7
2020-04-22,Ukraine,NA,Ternopil,1052312,36,0,471,7
2020-04-23,Ukraine,NA,Ternopil,1052312,28,0,499,7
2020-04-24,Ukraine,NA,Ternopil,1052312,33,0,532,7
2020-04-25,Ukraine,NA,Ternopil,1052312,33,1,565,8
2020-04-26,Ukraine,NA,Ternopil,1052312,42,1,607,9
2020-04-27,Ukraine,NA,Ternopil,1052312,5,1,612,10
2020-04-28,Ukraine,NA,Ternopil,1052312,52,2,664,12
2020-04-29,Ukraine,NA,Ternopil,1052312,44,0,708,12
2020-04-30,Ukraine,NA,Ternopil,1052312,71,2,779,14
2020-05-01,Ukraine,NA,Ternopil,1052312,14,0,793,14
2020-05-02,Ukraine,NA,Ternopil,1052312,30,1,823,15
2020-05-03,Ukraine,NA,Ternopil,1052312,45,0,868,15
2020-05-04,Ukraine,NA,Ternopil,1052312,28,0,896,15
2020-05-05,Ukraine,NA,Ternopil,1052312,27,0,923,15
2020-05-06,Ukraine,NA,Ternopil,1052312,12,0,935,15
2020-05-07,Ukraine,NA,Ternopil,1052312,16,2,951,17
2020-05-08,Ukraine,NA,Ternopil,1052312,8,0,959,17
2020-05-09,Ukraine,NA,Ternopil,1052312,18,1,977,18
2020-05-10,Ukraine,NA,Ternopil,1052312,22,0,999,18
2020-05-11,Ukraine,NA,Ternopil,1052312,19,0,1018,18
2020-05-12,Ukraine,NA,Ternopil,1052312,3,2,1021,20
2020-05-13,Ukraine,NA,Ternopil,1052312,7,0,1028,20
2020-05-14,Ukraine,NA,Ternopil,1052312,5,1,1033,21
2020-05-15,Ukraine,NA,Ternopil,1052312,27,1,1060,22
2020-05-16,Ukraine,NA,Ternopil,1052312,5,0,1065,22
2020-05-17,Ukraine,NA,Ternopil,1052312,13,0,1078,22
2020-05-18,Ukraine,NA,Ternopil,1052312,3,0,1081,22
2020-05-19,Ukraine,NA,Ternopil,1052312,0,0,1081,22
2020-05-20,Ukraine,NA,Ternopil,1052312,8,0,1089,22
2020-05-21,Ukraine,NA,Ternopil,1052312,9,1,1098,23
2020-05-22,Ukraine,NA,Ternopil,1052312,7,0,1105,23
2020-05-23,Ukraine,NA,Ternopil,1052312,3,1,1108,24
2020-05-24,Ukraine,NA,Ternopil,1052312,7,0,1115,24
2020-05-25,Ukraine,NA,Ternopil,1052312,6,0,1121,24
2020-05-26,Ukraine,NA,Ternopil,1052312,3,1,1124,25
2020-05-27,Ukraine,NA,Ternopil,1052312,2,1,1126,26
2020-05-28,Ukraine,NA,Ternopil,1052312,5,0,1131,26
2020-05-29,Ukraine,NA,Ternopil,1052312,14,0,1145,26
2020-05-30,Ukraine,NA,Ternopil,1052312,15,0,1160,26
2020-05-31,Ukraine,NA,Ternopil,1052312,9,0,1169,26
2020-06-01,Ukraine,NA,Ternopil,1052312,7,0,1176,26
2020-06-02,Ukraine,NA,Ternopil,1052312,4,0,1180,26
2020-06-03,Ukraine,NA,Ternopil,1052312,20,0,1200,26
2020-06-04,Ukraine,NA,Ternopil,1052312,20,0,1220,26
2020-06-05,Ukraine,NA,Ternopil,1052312,13,0,1233,26
2020-06-06,Ukraine,NA,Ternopil,1052312,22,0,1255,26
2020-06-07,Ukraine,NA,Ternopil,1052312,20,0,1275,26
2020-06-08,Ukraine,NA,Ternopil,1052312,19,0,1294,26
2020-06-09,Ukraine,NA,Ternopil,1052312,11,0,1305,26
2020-06-10,Ukraine,NA,Ternopil,1052312,8,0,1313,26
2020-06-11,Ukraine,NA,Ternopil,1052312,36,0,1349,26
2020-06-12,Ukraine,NA,Ternopil,1052312,23,0,1372,26
2020-06-13,Ukraine,NA,Ternopil,1052312,31,0,1403,26
2020-06-14,Ukraine,NA,Ternopil,1052312,24,0,1427,26
2020-06-15,Ukraine,NA,Ternopil,1052312,40,0,1467,26
2020-06-16,Ukraine,NA,Ternopil,1052312,16,0,1483,26
2020-06-17,Ukraine,NA,Ternopil,1052312,27,1,1510,27
2020-06-18,Ukraine,NA,Ternopil,1052312,32,0,1542,27
2020-06-19,Ukraine,NA,Ternopil,1052312,63,0,1605,27
2020-06-20,Ukraine,NA,Ternopil,1052312,38,0,1643,27
2020-06-21,Ukraine,NA,Ternopil,1052312,45,0,1688,27
2020-06-22,Ukraine,NA,Ternopil,1052312,40,0,1728,27
2020-06-23,Ukraine,NA,Ternopil,1052312,16,0,1744,27
2020-06-24,Ukraine,NA,Ternopil,1052312,42,0,1786,27
2020-06-25,Ukraine,NA,Ternopil,1052312,29,0,1815,27
2020-06-26,Ukraine,NA,Ternopil,1052312,42,0,1857,27
2020-06-27,Ukraine,NA,Ternopil,1052312,19,1,1876,28
2020-06-28,Ukraine,NA,Ternopil,1052312,17,0,1893,28
2020-06-29,Ukraine,NA,Ternopil,1052312,20,0,1913,28
2020-06-30,Ukraine,NA,Ternopil,1052312,6,0,1919,28
2020-07-01,Ukraine,NA,Ternopil,1052312,11,1,1930,29
2020-07-02,Ukraine,NA,Ternopil,1052312,28,0,1958,29
2020-07-03,Ukraine,NA,Ternopil,1052312,32,0,1990,29
2020-07-04,Ukraine,NA,Ternopil,1052312,35,0,2025,29
2020-07-05,Ukraine,NA,Ternopil,1052312,44,1,2069,30
2020-07-06,Ukraine,NA,Ternopil,1052312,32,0,2101,30
2020-07-07,Ukraine,NA,Ternopil,1052312,7,1,2108,31
2020-07-08,Ukraine,NA,Ternopil,1052312,34,0,2142,31
2020-07-09,Ukraine,NA,Ternopil,1052312,11,0,2153,31
2020-07-10,Ukraine,NA,Ternopil,1052312,21,1,2174,32
2020-07-11,Ukraine,NA,Ternopil,1052312,43,1,2217,33
2020-07-12,Ukraine,NA,Ternopil,1052312,14,1,2231,34
2020-07-13,Ukraine,NA,Ternopil,1052312,29,0,2260,34
2020-07-14,Ukraine,NA,Ternopil,1052312,16,0,2276,34
2020-07-15,Ukraine,NA,Ternopil,1052312,16,0,2292,34
2020-07-16,Ukraine,NA,Ternopil,1052312,45,0,2337,34
2020-07-17,Ukraine,NA,Ternopil,1052312,21,0,2358,34
2020-07-18,Ukraine,NA,Ternopil,1052312,36,0,2394,34
2020-07-19,Ukraine,NA,Ternopil,1052312,36,0,2430,34
2020-07-20,Ukraine,NA,Ternopil,1052312,26,0,2456,34
2020-07-21,Ukraine,NA,Ternopil,1052312,10,1,2466,35
2020-07-22,Ukraine,NA,Ternopil,1052312,42,0,2508,35
2020-07-23,Ukraine,NA,Ternopil,1052312,40,1,2548,36
2020-07-24,Ukraine,NA,Ternopil,1052312,56,0,2604,36
2020-07-25,Ukraine,NA,Ternopil,1052312,68,3,2672,39
2020-07-26,Ukraine,NA,Ternopil,1052312,53,0,2725,39
2020-07-27,Ukraine,NA,Ternopil,1052312,48,0,2773,39
2020-07-28,Ukraine,NA,Ternopil,1052312,49,0,2822,39
2020-07-29,Ukraine,NA,Ternopil,1052312,30,0,2852,39
2020-07-30,Ukraine,NA,Ternopil,1052312,70,0,2922,39
2020-07-31,Ukraine,NA,Ternopil,1052312,54,0,2976,39
2020-08-01,Ukraine,NA,Ternopil,1052312,59,0,3035,39
2020-08-02,Ukraine,NA,Ternopil,1052312,51,0,3086,39
2020-08-03,Ukraine,NA,Ternopil,1052312,27,0,3113,39
2020-08-04,Ukraine,NA,Ternopil,1052312,8,0,3121,39
2020-08-05,Ukraine,NA,Ternopil,1052312,28,1,3149,40
2020-08-06,Ukraine,NA,Ternopil,1052312,28,0,3177,40
2020-08-07,Ukraine,NA,Ternopil,1052312,35,1,3212,41
2020-08-08,Ukraine,NA,Ternopil,1052312,45,0,3257,41
2020-08-09,Ukraine,NA,Ternopil,1052312,32,0,3289,41
2020-08-10,Ukraine,NA,Ternopil,1052312,35,0,3324,41
2020-08-11,Ukraine,NA,Ternopil,1052312,51,3,3375,44
2020-08-12,Ukraine,NA,Ternopil,1052312,38,0,3413,44
2020-08-13,Ukraine,NA,Ternopil,1052312,76,0,3489,44
2020-08-14,Ukraine,NA,Ternopil,1052312,49,0,3538,44
2020-08-15,Ukraine,NA,Ternopil,1052312,97,1,3635,45
2020-08-16,Ukraine,NA,Ternopil,1052312,97,2,3732,47
2020-08-17,Ukraine,NA,Ternopil,1052312,85,0,3817,47
2020-08-18,Ukraine,NA,Ternopil,1052312,85,0,3902,47
2020-08-19,Ukraine,NA,Ternopil,1052312,99,0,4001,47
2020-08-20,Ukraine,NA,Ternopil,1052312,115,3,4116,50
2020-08-21,Ukraine,NA,Ternopil,1052312,185,1,4301,51
2020-08-22,Ukraine,NA,Ternopil,1052312,206,0,4507,51
2020-08-23,Ukraine,NA,Ternopil,1052312,119,3,4626,54
2020-08-24,Ukraine,NA,Ternopil,1052312,139,4,4765,58
2020-08-25,Ukraine,NA,Ternopil,1052312,158,2,4923,60
2020-08-26,Ukraine,NA,Ternopil,1052312,181,1,5104,61
2020-08-27,Ukraine,NA,Ternopil,1052312,141,0,5245,61
2020-08-28,Ukraine,NA,Ternopil,1052312,233,3,5478,64
2020-08-29,Ukraine,NA,Ternopil,1052312,227,2,5705,66
2020-08-30,Ukraine,NA,Ternopil,1052312,160,3,5865,69
2020-08-31,Ukraine,NA,Ternopil,1052312,149,2,6014,71
2020-09-01,Ukraine,NA,Ternopil,1052312,180,1,6194,72
2020-09-02,Ukraine,NA,Ternopil,1052312,201,4,6395,76
2020-09-03,Ukraine,NA,Ternopil,1052312,242,3,6637,79
2020-09-04,Ukraine,NA,Ternopil,1052312,204,1,6841,80
2020-09-05,Ukraine,NA,Ternopil,1052312,226,2,7067,82
2020-09-06,Ukraine,NA,Ternopil,1052312,158,2,7225,84
2020-09-07,Ukraine,NA,Ternopil,1052312,165,1,7390,85
2020-09-08,Ukraine,NA,Ternopil,1052312,190,2,7580,87
2020-09-09,Ukraine,NA,Ternopil,1052312,244,4,7824,91
2020-09-10,Ukraine,NA,Ternopil,1052312,251,4,8075,95
2020-09-11,Ukraine,NA,Ternopil,1052312,302,3,8377,98
2020-09-12,Ukraine,NA,Ternopil,1052312,280,2,8657,100
2020-09-13,Ukraine,NA,Ternopil,1052312,225,2,8882,102
2020-09-14,Ukraine,NA,Ternopil,1052312,352,7,9234,109
2020-09-15,Ukraine,NA,Ternopil,1052312,390,5,9624,114
2020-09-16,Ukraine,NA,Ternopil,1052312,380,7,10004,121
2020-09-17,Ukraine,NA,Ternopil,1052312,390,1,10394,122
2020-09-18,Ukraine,NA,Ternopil,1052312,311,6,10705,128
2020-09-19,Ukraine,NA,Ternopil,1052312,311,5,11016,133
2020-09-20,Ukraine,NA,Ternopil,1052312,231,4,11247,137
2020-09-21,Ukraine,NA,Ternopil,1052312,192,2,11439,139
2020-09-22,Ukraine,NA,Ternopil,1052312,293,2,11732,141
2020-09-23,Ukraine,NA,Ternopil,1052312,337,5,12069,146
2020-03-28,Ukraine,NA,Vinnytsia,1575808,7,0,16,0
2020-03-29,Ukraine,NA,Vinnytsia,1575808,6,0,22,0
2020-03-30,Ukraine,NA,Vinnytsia,1575808,1,0,23,0
2020-03-31,Ukraine,NA,Vinnytsia,1575808,19,0,42,0
2020-04-01,Ukraine,NA,Vinnytsia,1575808,9,0,51,0
2020-04-02,Ukraine,NA,Vinnytsia,1575808,10,0,61,0
2020-04-03,Ukraine,NA,Vinnytsia,1575808,5,0,66,0
2020-04-04,Ukraine,NA,Vinnytsia,1575808,9,0,75,0
2020-04-05,Ukraine,NA,Vinnytsia,1575808,0,0,75,0
2020-04-06,Ukraine,NA,Vinnytsia,1575808,0,0,75,0
2020-04-07,Ukraine,NA,Vinnytsia,1575808,2,0,77,0
2020-04-08,Ukraine,NA,Vinnytsia,1575808,12,0,89,0
2020-04-09,Ukraine,NA,Vinnytsia,1575808,13,0,102,0
2020-04-10,Ukraine,NA,Vinnytsia,1575808,17,0,119,0
2020-04-11,Ukraine,NA,Vinnytsia,1575808,32,0,151,0
2020-04-12,Ukraine,NA,Vinnytsia,1575808,23,0,174,0
2020-04-13,Ukraine,NA,Vinnytsia,1575808,20,0,194,0
2020-04-14,Ukraine,NA,Vinnytsia,1575808,6,0,200,0
2020-04-15,Ukraine,NA,Vinnytsia,1575808,41,0,241,0
2020-04-16,Ukraine,NA,Vinnytsia,1575808,38,0,279,0
2020-04-17,Ukraine,NA,Vinnytsia,1575808,17,0,296,0
2020-04-18,Ukraine,NA,Vinnytsia,1575808,23,0,319,0
2020-04-19,Ukraine,NA,Vinnytsia,1575808,11,0,330,0
2020-04-20,Ukraine,NA,Vinnytsia,1575808,0,1,330,1
2020-04-21,Ukraine,NA,Vinnytsia,1575808,8,0,338,1
2020-04-22,Ukraine,NA,Vinnytsia,1575808,11,2,349,3
2020-04-23,Ukraine,NA,Vinnytsia,1575808,4,0,353,3
2020-04-24,Ukraine,NA,Vinnytsia,1575808,17,0,370,3
2020-04-25,Ukraine,NA,Vinnytsia,1575808,7,0,377,3
2020-04-26,Ukraine,NA,Vinnytsia,1575808,11,0,388,3
2020-04-27,Ukraine,NA,Vinnytsia,1575808,10,0,398,3
2020-04-28,Ukraine,NA,Vinnytsia,1575808,8,0,406,3
2020-04-29,Ukraine,NA,Vinnytsia,1575808,6,0,412,3
2020-04-30,Ukraine,NA,Vinnytsia,1575808,5,0,417,3
2020-05-01,Ukraine,NA,Vinnytsia,1575808,8,0,425,3
2020-05-02,Ukraine,NA,Vinnytsia,1575808,2,0,427,3
2020-05-03,Ukraine,NA,Vinnytsia,1575808,8,0,435,3
2020-05-04,Ukraine,NA,Vinnytsia,1575808,1,0,436,3
2020-05-05,Ukraine,NA,Vinnytsia,1575808,18,2,454,5
2020-05-06,Ukraine,NA,Vinnytsia,1575808,18,0,472,5
2020-05-07,Ukraine,NA,Vinnytsia,1575808,13,0,485,5
2020-05-08,Ukraine,NA,Vinnytsia,1575808,29,0,514,5
2020-05-09,Ukraine,NA,Vinnytsia,1575808,8,0,522,5
2020-05-10,Ukraine,NA,Vinnytsia,1575808,22,1,544,6
2020-05-11,Ukraine,NA,Vinnytsia,1575808,9,0,553,6
2020-05-12,Ukraine,NA,Vinnytsia,1575808,27,0,580,6
2020-05-13,Ukraine,NA,Vinnytsia,1575808,48,0,628,6
2020-05-14,Ukraine,NA,Vinnytsia,1575808,26,0,654,6
2020-05-15,Ukraine,NA,Vinnytsia,1575808,20,1,674,7
2020-05-16,Ukraine,NA,Vinnytsia,1575808,26,1,700,8
2020-05-17,Ukraine,NA,Vinnytsia,1575808,15,3,715,11
2020-05-18,Ukraine,NA,Vinnytsia,1575808,18,0,733,11
2020-05-19,Ukraine,NA,Vinnytsia,1575808,18,0,751,11
2020-05-20,Ukraine,NA,Vinnytsia,1575808,15,2,766,13
2020-05-21,Ukraine,NA,Vinnytsia,1575808,22,0,788,13
2020-05-22,Ukraine,NA,Vinnytsia,1575808,36,1,824,14
2020-05-23,Ukraine,NA,Vinnytsia,1575808,29,1,853,15
2020-05-24,Ukraine,NA,Vinnytsia,1575808,36,0,889,15
2020-05-25,Ukraine,NA,Vinnytsia,1575808,3,0,892,15
2020-05-26,Ukraine,NA,Vinnytsia,1575808,18,0,910,15
2020-05-27,Ukraine,NA,Vinnytsia,1575808,22,0,932,15
2020-05-28,Ukraine,NA,Vinnytsia,1575808,15,1,947,16
2020-05-29,Ukraine,NA,Vinnytsia,1575808,10,0,957,16
2020-05-30,Ukraine,NA,Vinnytsia,1575808,1,0,958,16
2020-05-31,Ukraine,NA,Vinnytsia,1575808,35,0,993,16
2020-06-01,Ukraine,NA,Vinnytsia,1575808,12,0,1005,16
2020-06-02,Ukraine,NA,Vinnytsia,1575808,24,0,1029,16
2020-06-03,Ukraine,NA,Vinnytsia,1575808,21,0,1050,16
2020-06-04,Ukraine,NA,Vinnytsia,1575808,27,0,1077,16
2020-06-05,Ukraine,NA,Vinnytsia,1575808,16,1,1093,17
2020-06-06,Ukraine,NA,Vinnytsia,1575808,23,0,1116,17
2020-06-07,Ukraine,NA,Vinnytsia,1575808,20,1,1136,18
2020-06-08,Ukraine,NA,Vinnytsia,1575808,14,1,1150,19
2020-06-09,Ukraine,NA,Vinnytsia,1575808,25,1,1175,20
2020-06-10,Ukraine,NA,Vinnytsia,1575808,17,0,1192,20
2020-06-11,Ukraine,NA,Vinnytsia,1575808,44,0,1236,20
2020-06-12,Ukraine,NA,Vinnytsia,1575808,81,0,1317,20
2020-06-13,Ukraine,NA,Vinnytsia,1575808,52,1,1369,21
2020-06-14,Ukraine,NA,Vinnytsia,1575808,24,2,1393,23
2020-06-15,Ukraine,NA,Vinnytsia,1575808,30,0,1423,23
2020-06-16,Ukraine,NA,Vinnytsia,1575808,32,0,1455,23
2020-06-17,Ukraine,NA,Vinnytsia,1575808,45,1,1500,24
2020-06-18,Ukraine,NA,Vinnytsia,1575808,63,0,1563,24
2020-06-19,Ukraine,NA,Vinnytsia,1575808,33,4,1596,28
2020-06-20,Ukraine,NA,Vinnytsia,1575808,31,0,1627,28
2020-06-21,Ukraine,NA,Vinnytsia,1575808,20,0,1647,28
2020-06-22,Ukraine,NA,Vinnytsia,1575808,13,0,1660,28
2020-06-23,Ukraine,NA,Vinnytsia,1575808,30,0,1690,28
2020-06-24,Ukraine,NA,Vinnytsia,1575808,33,0,1723,28
2020-06-25,Ukraine,NA,Vinnytsia,1575808,30,0,1753,28
2020-06-26,Ukraine,NA,Vinnytsia,1575808,35,0,1788,28
2020-06-27,Ukraine,NA,Vinnytsia,1575808,23,0,1811,28
2020-06-28,Ukraine,NA,Vinnytsia,1575808,22,0,1833,28
2020-06-29,Ukraine,NA,Vinnytsia,1575808,13,0,1846,28
2020-06-30,Ukraine,NA,Vinnytsia,1575808,18,0,1864,28
2020-07-01,Ukraine,NA,Vinnytsia,1575808,12,1,1876,29
2020-07-02,Ukraine,NA,Vinnytsia,1575808,19,1,1895,30
2020-07-03,Ukraine,NA,Vinnytsia,1575808,20,0,1915,30
2020-07-04,Ukraine,NA,Vinnytsia,1575808,21,0,1936,30
2020-07-05,Ukraine,NA,Vinnytsia,1575808,15,0,1951,30
2020-07-06,Ukraine,NA,Vinnytsia,1575808,16,0,1967,30
2020-07-07,Ukraine,NA,Vinnytsia,1575808,12,2,1979,32
2020-07-08,Ukraine,NA,Vinnytsia,1575808,23,1,2002,33
2020-07-09,Ukraine,NA,Vinnytsia,1575808,19,1,2021,34
2020-07-10,Ukraine,NA,Vinnytsia,1575808,39,0,2060,34
2020-07-11,Ukraine,NA,Vinnytsia,1575808,21,2,2081,36
2020-07-12,Ukraine,NA,Vinnytsia,1575808,16,1,2097,37
2020-07-13,Ukraine,NA,Vinnytsia,1575808,25,1,2122,38
2020-07-14,Ukraine,NA,Vinnytsia,1575808,26,0,2148,38
2020-07-15,Ukraine,NA,Vinnytsia,1575808,46,0,2194,38
2020-07-16,Ukraine,NA,Vinnytsia,1575808,27,0,2221,38
2020-07-17,Ukraine,NA,Vinnytsia,1575808,32,0,2253,38
2020-07-18,Ukraine,NA,Vinnytsia,1575808,18,1,2271,39
2020-07-19,Ukraine,NA,Vinnytsia,1575808,28,0,2299,39
2020-07-20,Ukraine,NA,Vinnytsia,1575808,18,1,2317,40
2020-07-21,Ukraine,NA,Vinnytsia,1575808,13,2,2330,42
2020-07-22,Ukraine,NA,Vinnytsia,1575808,34,0,2364,42
2020-07-23,Ukraine,NA,Vinnytsia,1575808,52,1,2416,43
2020-07-24,Ukraine,NA,Vinnytsia,1575808,46,3,2462,46
2020-07-25,Ukraine,NA,Vinnytsia,1575808,50,0,2512,46
2020-07-26,Ukraine,NA,Vinnytsia,1575808,37,0,2549,46
2020-07-27,Ukraine,NA,Vinnytsia,1575808,40,0,2589,46
2020-07-28,Ukraine,NA,Vinnytsia,1575808,38,1,2627,47
2020-07-29,Ukraine,NA,Vinnytsia,1575808,33,2,2660,49
2020-07-30,Ukraine,NA,Vinnytsia,1575808,38,1,2698,50
2020-07-31,Ukraine,NA,Vinnytsia,1575808,38,1,2736,51
2020-08-01,Ukraine,NA,Vinnytsia,1575808,30,1,2766,52
2020-08-02,Ukraine,NA,Vinnytsia,1575808,24,0,2790,52
2020-08-03,Ukraine,NA,Vinnytsia,1575808,25,3,2815,55
2020-08-04,Ukraine,NA,Vinnytsia,1575808,33,0,2848,55
2020-08-05,Ukraine,NA,Vinnytsia,1575808,32,0,2880,55
2020-08-06,Ukraine,NA,Vinnytsia,1575808,18,2,2898,57
2020-08-07,Ukraine,NA,Vinnytsia,1575808,34,1,2932,58
2020-08-08,Ukraine,NA,Vinnytsia,1575808,23,2,2955,60
2020-08-09,Ukraine,NA,Vinnytsia,1575808,19,2,2974,62
2020-08-10,Ukraine,NA,Vinnytsia,1575808,11,0,2985,62
2020-08-11,Ukraine,NA,Vinnytsia,1575808,17,1,3002,63
2020-08-12,Ukraine,NA,Vinnytsia,1575808,41,0,3043,63
2020-08-13,Ukraine,NA,Vinnytsia,1575808,43,2,3086,65
2020-08-14,Ukraine,NA,Vinnytsia,1575808,43,0,3129,65
2020-08-15,Ukraine,NA,Vinnytsia,1575808,46,0,3175,65
2020-08-16,Ukraine,NA,Vinnytsia,1575808,38,1,3213,66
2020-08-17,Ukraine,NA,Vinnytsia,1575808,21,1,3234,67
2020-08-18,Ukraine,NA,Vinnytsia,1575808,38,3,3272,70
2020-08-19,Ukraine,NA,Vinnytsia,1575808,51,1,3323,71
2020-08-20,Ukraine,NA,Vinnytsia,1575808,82,1,3405,72
2020-08-21,Ukraine,NA,Vinnytsia,1575808,73,0,3478,72
2020-08-22,Ukraine,NA,Vinnytsia,1575808,75,1,3553,73
2020-08-23,Ukraine,NA,Vinnytsia,1575808,39,0,3592,73
2020-08-24,Ukraine,NA,Vinnytsia,1575808,32,1,3624,74
2020-08-25,Ukraine,NA,Vinnytsia,1575808,25,0,3649,74
2020-08-26,Ukraine,NA,Vinnytsia,1575808,28,2,3677,76
2020-08-27,Ukraine,NA,Vinnytsia,1575808,59,1,3736,77
2020-08-28,Ukraine,NA,Vinnytsia,1575808,64,3,3800,80
2020-08-29,Ukraine,NA,Vinnytsia,1575808,72,0,3872,80
2020-08-30,Ukraine,NA,Vinnytsia,1575808,76,1,3948,81
2020-08-31,Ukraine,NA,Vinnytsia,1575808,45,2,3993,83
2020-09-01,Ukraine,NA,Vinnytsia,1575808,51,2,4044,85
2020-09-02,Ukraine,NA,Vinnytsia,1575808,65,0,4109,85
2020-09-03,Ukraine,NA,Vinnytsia,1575808,85,0,4194,85
2020-09-04,Ukraine,NA,Vinnytsia,1575808,75,1,4269,86
2020-09-05,Ukraine,NA,Vinnytsia,1575808,55,1,4324,87
2020-09-06,Ukraine,NA,Vinnytsia,1575808,51,1,4375,88
2020-09-07,Ukraine,NA,Vinnytsia,1575808,31,2,4406,90
2020-09-08,Ukraine,NA,Vinnytsia,1575808,44,0,4450,90
2020-09-09,Ukraine,NA,Vinnytsia,1575808,53,2,4503,92
2020-09-10,Ukraine,NA,Vinnytsia,1575808,103,0,4606,92
2020-09-11,Ukraine,NA,Vinnytsia,1575808,84,0,4690,92
2020-09-12,Ukraine,NA,Vinnytsia,1575808,66,2,4756,94
2020-09-13,Ukraine,NA,Vinnytsia,1575808,52,2,4808,96
2020-09-14,Ukraine,NA,Vinnytsia,1575808,36,0,4844,96
2020-09-15,Ukraine,NA,Vinnytsia,1575808,43,0,4887,96
2020-09-16,Ukraine,NA,Vinnytsia,1575808,89,1,4976,97
2020-09-17,Ukraine,NA,Vinnytsia,1575808,63,1,5039,98
2020-09-18,Ukraine,NA,Vinnytsia,1575808,75,0,5114,98
2020-09-19,Ukraine,NA,Vinnytsia,1575808,86,0,5200,98
2020-09-20,Ukraine,NA,Vinnytsia,1575808,68,0,5268,98
2020-09-21,Ukraine,NA,Vinnytsia,1575808,54,3,5322,101
2020-09-22,Ukraine,NA,Vinnytsia,1575808,55,1,5377,102
2020-09-23,Ukraine,NA,Vinnytsia,1575808,78,1,5455,103
2020-04-03,Ukraine,NA,Volyn,1038457,7,0,17,1
2020-04-04,Ukraine,NA,Volyn,1038457,0,1,17,2
2020-04-05,Ukraine,NA,Volyn,1038457,2,0,19,2
2020-04-06,Ukraine,NA,Volyn,1038457,5,0,24,2
2020-04-07,Ukraine,NA,Volyn,1038457,10,0,34,2
2020-04-08,Ukraine,NA,Volyn,1038457,2,0,36,2
2020-04-09,Ukraine,NA,Volyn,1038457,2,0,38,2
2020-04-10,Ukraine,NA,Volyn,1038457,3,0,41,2
2020-04-11,Ukraine,NA,Volyn,1038457,11,0,52,2
2020-04-12,Ukraine,NA,Volyn,1038457,19,0,71,2
2020-04-13,Ukraine,NA,Volyn,1038457,7,1,78,3
2020-04-14,Ukraine,NA,Volyn,1038457,2,0,80,3
2020-04-15,Ukraine,NA,Volyn,1038457,20,1,100,4
2020-04-16,Ukraine,NA,Volyn,1038457,9,0,109,4
2020-04-17,Ukraine,NA,Volyn,1038457,13,0,122,4
2020-04-18,Ukraine,NA,Volyn,1038457,12,0,134,4
2020-04-19,Ukraine,NA,Volyn,1038457,16,0,150,4
2020-04-20,Ukraine,NA,Volyn,1038457,8,0,158,4
2020-04-21,Ukraine,NA,Volyn,1038457,16,0,174,4
2020-04-22,Ukraine,NA,Volyn,1038457,2,0,176,4
2020-04-23,Ukraine,NA,Volyn,1038457,12,0,188,4
2020-04-24,Ukraine,NA,Volyn,1038457,15,0,203,4
2020-04-25,Ukraine,NA,Volyn,1038457,9,1,212,5
2020-04-26,Ukraine,NA,Volyn,1038457,29,1,241,6
2020-04-27,Ukraine,NA,Volyn,1038457,13,0,254,6
2020-04-28,Ukraine,NA,Volyn,1038457,6,0,260,6
2020-04-29,Ukraine,NA,Volyn,1038457,11,0,271,6
2020-04-30,Ukraine,NA,Volyn,1038457,9,0,280,6
2020-05-01,Ukraine,NA,Volyn,1038457,27,0,307,6
2020-05-02,Ukraine,NA,Volyn,1038457,8,0,315,6
2020-05-03,Ukraine,NA,Volyn,1038457,9,0,324,6
2020-05-04,Ukraine,NA,Volyn,1038457,16,1,340,7
2020-05-05,Ukraine,NA,Volyn,1038457,3,0,343,7
2020-05-06,Ukraine,NA,Volyn,1038457,16,2,359,9
2020-05-07,Ukraine,NA,Volyn,1038457,34,0,393,9
2020-05-08,Ukraine,NA,Volyn,1038457,31,1,424,10
2020-05-09,Ukraine,NA,Volyn,1038457,21,0,445,10
2020-05-10,Ukraine,NA,Volyn,1038457,25,0,470,10
2020-05-11,Ukraine,NA,Volyn,1038457,12,1,482,11
2020-05-12,Ukraine,NA,Volyn,1038457,14,0,496,11
2020-05-13,Ukraine,NA,Volyn,1038457,14,1,510,12
2020-05-14,Ukraine,NA,Volyn,1038457,25,3,535,15
2020-05-15,Ukraine,NA,Volyn,1038457,47,1,582,16
2020-05-16,Ukraine,NA,Volyn,1038457,17,0,599,16
2020-05-17,Ukraine,NA,Volyn,1038457,16,0,615,16
2020-05-18,Ukraine,NA,Volyn,1038457,10,1,625,17
2020-05-19,Ukraine,NA,Volyn,1038457,10,0,635,17
2020-05-20,Ukraine,NA,Volyn,1038457,41,4,676,21
2020-05-21,Ukraine,NA,Volyn,1038457,22,0,698,21
2020-05-22,Ukraine,NA,Volyn,1038457,42,0,740,21
2020-05-23,Ukraine,NA,Volyn,1038457,19,1,759,22
2020-05-24,Ukraine,NA,Volyn,1038457,12,0,771,22
2020-05-25,Ukraine,NA,Volyn,1038457,12,1,783,23
2020-05-26,Ukraine,NA,Volyn,1038457,22,1,805,24
2020-05-27,Ukraine,NA,Volyn,1038457,9,0,814,24
2020-05-28,Ukraine,NA,Volyn,1038457,37,1,851,25
2020-05-29,Ukraine,NA,Volyn,1038457,12,0,863,25
2020-05-30,Ukraine,NA,Volyn,1038457,24,1,887,26
2020-05-31,Ukraine,NA,Volyn,1038457,21,0,908,26
2020-06-01,Ukraine,NA,Volyn,1038457,24,0,932,26
2020-06-02,Ukraine,NA,Volyn,1038457,10,0,942,26
2020-06-03,Ukraine,NA,Volyn,1038457,17,1,959,27
2020-06-04,Ukraine,NA,Volyn,1038457,27,2,986,29
2020-06-05,Ukraine,NA,Volyn,1038457,22,1,1008,30
2020-06-06,Ukraine,NA,Volyn,1038457,29,2,1037,32
2020-06-07,Ukraine,NA,Volyn,1038457,15,0,1052,32
2020-06-08,Ukraine,NA,Volyn,1038457,27,1,1079,33
2020-06-09,Ukraine,NA,Volyn,1038457,34,1,1113,34
2020-06-10,Ukraine,NA,Volyn,1038457,101,3,1214,37
2020-06-11,Ukraine,NA,Volyn,1038457,52,1,1266,38
2020-06-12,Ukraine,NA,Volyn,1038457,47,2,1313,40
2020-06-13,Ukraine,NA,Volyn,1038457,41,1,1354,41
2020-06-14,Ukraine,NA,Volyn,1038457,44,1,1398,42
2020-06-15,Ukraine,NA,Volyn,1038457,40,1,1438,43
2020-06-16,Ukraine,NA,Volyn,1038457,61,2,1499,45
2020-06-17,Ukraine,NA,Volyn,1038457,55,3,1554,48
2020-06-18,Ukraine,NA,Volyn,1038457,56,2,1610,50
2020-06-19,Ukraine,NA,Volyn,1038457,63,2,1673,52
2020-06-20,Ukraine,NA,Volyn,1038457,70,0,1743,52
2020-06-21,Ukraine,NA,Volyn,1038457,39,0,1782,52
2020-06-22,Ukraine,NA,Volyn,1038457,70,0,1852,52
2020-06-23,Ukraine,NA,Volyn,1038457,42,2,1894,54
2020-06-24,Ukraine,NA,Volyn,1038457,61,3,1955,57
2020-06-25,Ukraine,NA,Volyn,1038457,69,0,2024,57
2020-06-26,Ukraine,NA,Volyn,1038457,72,2,2096,59
2020-06-27,Ukraine,NA,Volyn,1038457,65,1,2161,60
2020-06-28,Ukraine,NA,Volyn,1038457,67,0,2228,60
2020-06-29,Ukraine,NA,Volyn,1038457,84,0,2312,60
2020-06-30,Ukraine,NA,Volyn,1038457,56,0,2368,60
2020-07-01,Ukraine,NA,Volyn,1038457,59,2,2427,62
2020-07-02,Ukraine,NA,Volyn,1038457,81,0,2508,62
2020-07-03,Ukraine,NA,Volyn,1038457,63,1,2571,63
2020-07-04,Ukraine,NA,Volyn,1038457,92,4,2663,67
2020-07-05,Ukraine,NA,Volyn,1038457,42,1,2705,68
2020-07-06,Ukraine,NA,Volyn,1038457,47,1,2752,69
2020-07-07,Ukraine,NA,Volyn,1038457,36,1,2788,70
2020-07-08,Ukraine,NA,Volyn,1038457,37,1,2825,71
2020-07-09,Ukraine,NA,Volyn,1038457,50,0,2875,71
2020-07-10,Ukraine,NA,Volyn,1038457,57,0,2932,71
2020-07-11,Ukraine,NA,Volyn,1038457,55,1,2987,72
2020-07-12,Ukraine,NA,Volyn,1038457,55,0,3042,72
2020-07-13,Ukraine,NA,Volyn,1038457,29,0,3071,72
2020-07-14,Ukraine,NA,Volyn,1038457,9,2,3080,74
2020-07-15,Ukraine,NA,Volyn,1038457,37,0,3117,74
2020-07-16,Ukraine,NA,Volyn,1038457,30,0,3147,74
2020-07-17,Ukraine,NA,Volyn,1038457,41,0,3188,74
2020-07-18,Ukraine,NA,Volyn,1038457,31,0,3219,74
2020-07-19,Ukraine,NA,Volyn,1038457,32,0,3251,74
2020-07-20,Ukraine,NA,Volyn,1038457,30,1,3281,75
2020-07-21,Ukraine,NA,Volyn,1038457,37,2,3318,77
2020-07-22,Ukraine,NA,Volyn,1038457,41,2,3359,79
2020-07-23,Ukraine,NA,Volyn,1038457,42,1,3401,80
2020-07-24,Ukraine,NA,Volyn,1038457,45,0,3446,80
2020-07-25,Ukraine,NA,Volyn,1038457,57,3,3503,83
2020-07-26,Ukraine,NA,Volyn,1038457,57,0,3560,83
2020-07-27,Ukraine,NA,Volyn,1038457,56,0,3616,83
2020-07-28,Ukraine,NA,Volyn,1038457,32,1,3648,84
2020-07-29,Ukraine,NA,Volyn,1038457,46,0,3694,84
2020-07-30,Ukraine,NA,Volyn,1038457,41,0,3735,84
2020-07-31,Ukraine,NA,Volyn,1038457,48,0,3783,84
2020-08-01,Ukraine,NA,Volyn,1038457,45,0,3828,84
2020-08-02,Ukraine,NA,Volyn,1038457,60,0,3888,84
2020-08-03,Ukraine,NA,Volyn,1038457,61,0,3949,84
2020-08-04,Ukraine,NA,Volyn,1038457,59,2,4008,86
2020-08-05,Ukraine,NA,Volyn,1038457,56,2,4064,88
2020-08-06,Ukraine,NA,Volyn,1038457,44,1,4108,89
2020-08-07,Ukraine,NA,Volyn,1038457,54,1,4162,90
2020-08-08,Ukraine,NA,Volyn,1038457,64,0,4226,90
2020-08-09,Ukraine,NA,Volyn,1038457,56,1,4282,91
2020-08-10,Ukraine,NA,Volyn,1038457,45,2,4327,93
2020-08-11,Ukraine,NA,Volyn,1038457,48,1,4375,94
2020-08-12,Ukraine,NA,Volyn,1038457,48,1,4423,95
2020-08-13,Ukraine,NA,Volyn,1038457,48,1,4471,96
2020-08-14,Ukraine,NA,Volyn,1038457,58,1,4529,97
2020-08-15,Ukraine,NA,Volyn,1038457,61,1,4590,98
2020-08-16,Ukraine,NA,Volyn,1038457,54,3,4644,101
2020-08-17,Ukraine,NA,Volyn,1038457,63,3,4707,104
2020-08-18,Ukraine,NA,Volyn,1038457,85,2,4792,106
2020-08-19,Ukraine,NA,Volyn,1038457,86,1,4878,107
2020-08-20,Ukraine,NA,Volyn,1038457,51,1,4929,108
2020-08-21,Ukraine,NA,Volyn,1038457,60,0,4989,108
2020-08-22,Ukraine,NA,Volyn,1038457,63,1,5052,109
2020-08-23,Ukraine,NA,Volyn,1038457,50,1,5102,110
2020-08-24,Ukraine,NA,Volyn,1038457,45,1,5147,111
2020-08-25,Ukraine,NA,Volyn,1038457,40,2,5187,113
2020-08-26,Ukraine,NA,Volyn,1038457,34,1,5221,114
2020-08-27,Ukraine,NA,Volyn,1038457,47,2,5268,116
2020-08-28,Ukraine,NA,Volyn,1038457,52,0,5320,116
2020-08-29,Ukraine,NA,Volyn,1038457,50,1,5370,117
2020-08-30,Ukraine,NA,Volyn,1038457,47,0,5417,117
2020-08-31,Ukraine,NA,Volyn,1038457,54,2,5471,119
2020-09-01,Ukraine,NA,Volyn,1038457,52,2,5523,121
2020-09-02,Ukraine,NA,Volyn,1038457,66,2,5589,123
2020-09-03,Ukraine,NA,Volyn,1038457,73,0,5662,123
2020-09-04,Ukraine,NA,Volyn,1038457,61,3,5723,126
2020-09-05,Ukraine,NA,Volyn,1038457,68,1,5791,127
2020-09-06,Ukraine,NA,Volyn,1038457,37,0,5828,127
2020-09-07,Ukraine,NA,Volyn,1038457,55,0,5883,127
2020-09-08,Ukraine,NA,Volyn,1038457,60,2,5943,129
2020-09-09,Ukraine,NA,Volyn,1038457,72,1,6015,130
2020-09-10,Ukraine,NA,Volyn,1038457,77,0,6092,130
2020-09-11,Ukraine,NA,Volyn,1038457,69,2,6161,132
2020-09-12,Ukraine,NA,Volyn,1038457,63,1,6224,133
2020-09-13,Ukraine,NA,Volyn,1038457,65,2,6289,135
2020-09-14,Ukraine,NA,Volyn,1038457,64,0,6353,135
2020-09-15,Ukraine,NA,Volyn,1038457,75,1,6428,136
2020-09-16,Ukraine,NA,Volyn,1038457,76,2,6504,138
2020-09-17,Ukraine,NA,Volyn,1038457,89,2,6593,140
2020-09-18,Ukraine,NA,Volyn,1038457,96,3,6689,143
2020-09-19,Ukraine,NA,Volyn,1038457,94,0,6783,143
2020-09-20,Ukraine,NA,Volyn,1038457,73,0,6856,143
2020-09-21,Ukraine,NA,Volyn,1038457,80,3,6936,146
2020-09-22,Ukraine,NA,Volyn,1038457,95,3,7031,149
2020-09-23,Ukraine,NA,Volyn,1038457,101,1,7132,150
2020-04-03,Ukraine,NA,Zakarpattia,1258155,23,0,24,0
2020-04-04,Ukraine,NA,Zakarpattia,1258155,4,0,28,0
2020-04-05,Ukraine,NA,Zakarpattia,1258155,0,0,28,0
2020-04-06,Ukraine,NA,Zakarpattia,1258155,7,0,35,0
2020-04-07,Ukraine,NA,Zakarpattia,1258155,3,2,38,2
2020-04-08,Ukraine,NA,Zakarpattia,1258155,5,0,43,2
2020-04-09,Ukraine,NA,Zakarpattia,1258155,8,0,51,2
2020-04-10,Ukraine,NA,Zakarpattia,1258155,5,1,56,3
2020-04-11,Ukraine,NA,Zakarpattia,1258155,4,1,60,4
2020-04-12,Ukraine,NA,Zakarpattia,1258155,22,0,82,4
2020-04-13,Ukraine,NA,Zakarpattia,1258155,10,0,92,4
2020-04-14,Ukraine,NA,Zakarpattia,1258155,7,0,99,4
2020-04-15,Ukraine,NA,Zakarpattia,1258155,11,0,110,4
2020-04-16,Ukraine,NA,Zakarpattia,1258155,6,0,116,4
2020-04-17,Ukraine,NA,Zakarpattia,1258155,34,0,150,4
2020-04-18,Ukraine,NA,Zakarpattia,1258155,16,0,166,4
2020-04-19,Ukraine,NA,Zakarpattia,1258155,16,2,182,6
2020-04-20,Ukraine,NA,Zakarpattia,1258155,14,0,196,6
2020-04-21,Ukraine,NA,Zakarpattia,1258155,9,0,205,6
2020-04-22,Ukraine,NA,Zakarpattia,1258155,13,0,218,6
2020-04-23,Ukraine,NA,Zakarpattia,1258155,12,0,230,6
2020-04-24,Ukraine,NA,Zakarpattia,1258155,30,0,260,6
2020-04-25,Ukraine,NA,Zakarpattia,1258155,26,1,286,7
2020-04-26,Ukraine,NA,Zakarpattia,1258155,43,0,329,7
2020-04-27,Ukraine,NA,Zakarpattia,1258155,46,0,375,7
2020-04-28,Ukraine,NA,Zakarpattia,1258155,12,2,387,9
2020-04-29,Ukraine,NA,Zakarpattia,1258155,16,0,403,9
2020-04-30,Ukraine,NA,Zakarpattia,1258155,16,0,419,9
2020-05-01,Ukraine,NA,Zakarpattia,1258155,13,0,432,9
2020-05-02,Ukraine,NA,Zakarpattia,1258155,64,0,496,9
2020-05-03,Ukraine,NA,Zakarpattia,1258155,12,1,508,10
2020-05-04,Ukraine,NA,Zakarpattia,1258155,23,0,531,10
2020-05-05,Ukraine,NA,Zakarpattia,1258155,15,2,546,12
2020-05-06,Ukraine,NA,Zakarpattia,1258155,26,1,572,13
2020-05-07,Ukraine,NA,Zakarpattia,1258155,28,0,600,13
2020-05-08,Ukraine,NA,Zakarpattia,1258155,44,1,644,14
2020-05-09,Ukraine,NA,Zakarpattia,1258155,34,1,678,15
2020-05-10,Ukraine,NA,Zakarpattia,1258155,17,1,695,16
2020-05-11,Ukraine,NA,Zakarpattia,1258155,35,1,730,17
2020-05-12,Ukraine,NA,Zakarpattia,1258155,18,1,748,18
2020-05-13,Ukraine,NA,Zakarpattia,1258155,16,0,764,18
2020-05-14,Ukraine,NA,Zakarpattia,1258155,27,1,791,19
2020-05-15,Ukraine,NA,Zakarpattia,1258155,25,2,816,21
2020-05-16,Ukraine,NA,Zakarpattia,1258155,42,1,858,22
2020-05-17,Ukraine,NA,Zakarpattia,1258155,27,2,885,24
2020-05-18,Ukraine,NA,Zakarpattia,1258155,16,0,901,24
2020-05-19,Ukraine,NA,Zakarpattia,1258155,10,0,911,24
2020-05-20,Ukraine,NA,Zakarpattia,1258155,11,0,922,24
2020-05-21,Ukraine,NA,Zakarpattia,1258155,42,0,964,24
2020-05-22,Ukraine,NA,Zakarpattia,1258155,39,0,1003,24
2020-05-23,Ukraine,NA,Zakarpattia,1258155,39,2,1042,26
2020-05-24,Ukraine,NA,Zakarpattia,1258155,19,0,1061,26
2020-05-25,Ukraine,NA,Zakarpattia,1258155,21,1,1082,27
2020-05-26,Ukraine,NA,Zakarpattia,1258155,10,0,1092,27
2020-05-27,Ukraine,NA,Zakarpattia,1258155,12,0,1104,27
2020-05-28,Ukraine,NA,Zakarpattia,1258155,20,0,1124,27
2020-05-29,Ukraine,NA,Zakarpattia,1258155,23,0,1147,27
2020-05-30,Ukraine,NA,Zakarpattia,1258155,24,1,1171,28
2020-05-31,Ukraine,NA,Zakarpattia,1258155,18,0,1189,28
2020-06-01,Ukraine,NA,Zakarpattia,1258155,17,0,1206,28
2020-06-02,Ukraine,NA,Zakarpattia,1258155,10,0,1216,28
2020-06-03,Ukraine,NA,Zakarpattia,1258155,20,0,1236,28
2020-06-04,Ukraine,NA,Zakarpattia,1258155,21,0,1257,28
2020-06-05,Ukraine,NA,Zakarpattia,1258155,23,0,1280,28
2020-06-06,Ukraine,NA,Zakarpattia,1258155,21,2,1301,30
2020-06-07,Ukraine,NA,Zakarpattia,1258155,21,0,1322,30
2020-06-08,Ukraine,NA,Zakarpattia,1258155,64,2,1386,32
2020-06-09,Ukraine,NA,Zakarpattia,1258155,39,0,1425,32
2020-06-10,Ukraine,NA,Zakarpattia,1258155,23,1,1448,33
2020-06-11,Ukraine,NA,Zakarpattia,1258155,23,2,1471,35
2020-06-12,Ukraine,NA,Zakarpattia,1258155,35,3,1506,38
2020-06-13,Ukraine,NA,Zakarpattia,1258155,77,1,1583,39
2020-06-14,Ukraine,NA,Zakarpattia,1258155,49,1,1632,40
2020-06-15,Ukraine,NA,Zakarpattia,1258155,48,2,1680,42
2020-06-16,Ukraine,NA,Zakarpattia,1258155,46,0,1726,42
2020-06-17,Ukraine,NA,Zakarpattia,1258155,82,4,1808,46
2020-06-18,Ukraine,NA,Zakarpattia,1258155,74,5,1882,51
2020-06-19,Ukraine,NA,Zakarpattia,1258155,78,2,1960,53
2020-06-20,Ukraine,NA,Zakarpattia,1258155,109,1,2069,54
2020-06-21,Ukraine,NA,Zakarpattia,1258155,80,0,2149,54
2020-06-22,Ukraine,NA,Zakarpattia,1258155,39,3,2188,57
2020-06-23,Ukraine,NA,Zakarpattia,1258155,103,4,2291,61
2020-06-24,Ukraine,NA,Zakarpattia,1258155,78,4,2369,65
2020-06-25,Ukraine,NA,Zakarpattia,1258155,85,5,2454,70
2020-06-26,Ukraine,NA,Zakarpattia,1258155,93,3,2547,73
2020-06-27,Ukraine,NA,Zakarpattia,1258155,93,9,2640,82
2020-06-28,Ukraine,NA,Zakarpattia,1258155,86,2,2726,84
2020-06-29,Ukraine,NA,Zakarpattia,1258155,66,3,2792,87
2020-06-30,Ukraine,NA,Zakarpattia,1258155,97,4,2889,91
2020-07-01,Ukraine,NA,Zakarpattia,1258155,72,4,2961,95
2020-07-02,Ukraine,NA,Zakarpattia,1258155,85,2,3046,97
2020-07-03,Ukraine,NA,Zakarpattia,1258155,80,5,3126,102
2020-07-04,Ukraine,NA,Zakarpattia,1258155,88,0,3214,102
2020-07-05,Ukraine,NA,Zakarpattia,1258155,107,6,3321,108
2020-07-06,Ukraine,NA,Zakarpattia,1258155,54,3,3375,111
2020-07-07,Ukraine,NA,Zakarpattia,1258155,83,6,3458,117
2020-07-08,Ukraine,NA,Zakarpattia,1258155,75,4,3533,121
2020-07-09,Ukraine,NA,Zakarpattia,1258155,89,5,3622,126
2020-07-10,Ukraine,NA,Zakarpattia,1258155,112,6,3734,132
2020-07-11,Ukraine,NA,Zakarpattia,1258155,108,6,3842,138
2020-07-12,Ukraine,NA,Zakarpattia,1258155,67,1,3909,139
2020-07-13,Ukraine,NA,Zakarpattia,1258155,79,0,3988,139
2020-07-14,Ukraine,NA,Zakarpattia,1258155,67,1,4055,140
2020-07-15,Ukraine,NA,Zakarpattia,1258155,57,2,4112,142
2020-07-16,Ukraine,NA,Zakarpattia,1258155,54,1,4166,143
2020-07-17,Ukraine,NA,Zakarpattia,1258155,63,2,4229,145
2020-07-18,Ukraine,NA,Zakarpattia,1258155,89,3,4318,148
2020-07-19,Ukraine,NA,Zakarpattia,1258155,36,4,4354,152
2020-07-20,Ukraine,NA,Zakarpattia,1258155,86,3,4440,155
2020-07-21,Ukraine,NA,Zakarpattia,1258155,78,5,4518,160
2020-07-22,Ukraine,NA,Zakarpattia,1258155,60,3,4578,163
2020-07-23,Ukraine,NA,Zakarpattia,1258155,63,3,4641,166
2020-07-24,Ukraine,NA,Zakarpattia,1258155,65,2,4706,168
2020-07-25,Ukraine,NA,Zakarpattia,1258155,68,2,4774,170
2020-07-26,Ukraine,NA,Zakarpattia,1258155,67,1,4841,171
2020-07-27,Ukraine,NA,Zakarpattia,1258155,33,1,4874,172
2020-07-28,Ukraine,NA,Zakarpattia,1258155,66,0,4940,172
2020-07-29,Ukraine,NA,Zakarpattia,1258155,68,4,5008,176
2020-07-30,Ukraine,NA,Zakarpattia,1258155,70,7,5078,183
2020-07-31,Ukraine,NA,Zakarpattia,1258155,68,9,5146,192
2020-08-01,Ukraine,NA,Zakarpattia,1258155,64,6,5210,198
2020-08-02,Ukraine,NA,Zakarpattia,1258155,57,3,5267,201
2020-08-03,Ukraine,NA,Zakarpattia,1258155,51,1,5318,202
2020-08-04,Ukraine,NA,Zakarpattia,1258155,66,4,5384,206
2020-08-05,Ukraine,NA,Zakarpattia,1258155,78,4,5462,210
2020-08-06,Ukraine,NA,Zakarpattia,1258155,77,2,5539,212
2020-08-07,Ukraine,NA,Zakarpattia,1258155,76,4,5615,216
2020-08-08,Ukraine,NA,Zakarpattia,1258155,82,2,5697,218
2020-08-09,Ukraine,NA,Zakarpattia,1258155,68,2,5765,220
2020-08-10,Ukraine,NA,Zakarpattia,1258155,44,2,5809,222
2020-08-11,Ukraine,NA,Zakarpattia,1258155,66,1,5875,223
2020-08-12,Ukraine,NA,Zakarpattia,1258155,71,3,5946,226
2020-08-13,Ukraine,NA,Zakarpattia,1258155,63,4,6009,230
2020-08-14,Ukraine,NA,Zakarpattia,1258155,71,0,6080,230
2020-08-15,Ukraine,NA,Zakarpattia,1258155,90,4,6170,234
2020-08-16,Ukraine,NA,Zakarpattia,1258155,76,3,6246,237
2020-08-17,Ukraine,NA,Zakarpattia,1258155,83,1,6329,238
2020-08-18,Ukraine,NA,Zakarpattia,1258155,106,1,6435,239
2020-08-19,Ukraine,NA,Zakarpattia,1258155,117,3,6552,242
2020-08-20,Ukraine,NA,Zakarpattia,1258155,110,1,6662,243
2020-08-21,Ukraine,NA,Zakarpattia,1258155,109,0,6771,243
2020-08-22,Ukraine,NA,Zakarpattia,1258155,114,3,6885,246
2020-08-23,Ukraine,NA,Zakarpattia,1258155,102,1,6987,247
2020-08-24,Ukraine,NA,Zakarpattia,1258155,39,0,7026,247
2020-08-25,Ukraine,NA,Zakarpattia,1258155,37,1,7063,248
2020-08-26,Ukraine,NA,Zakarpattia,1258155,80,1,7143,249
2020-08-27,Ukraine,NA,Zakarpattia,1258155,82,3,7225,252
2020-08-28,Ukraine,NA,Zakarpattia,1258155,77,2,7302,254
2020-08-29,Ukraine,NA,Zakarpattia,1258155,83,5,7385,259
2020-08-30,Ukraine,NA,Zakarpattia,1258155,71,0,7456,259
2020-08-31,Ukraine,NA,Zakarpattia,1258155,60,3,7516,262
2020-09-01,Ukraine,NA,Zakarpattia,1258155,84,1,7600,263
2020-09-02,Ukraine,NA,Zakarpattia,1258155,97,2,7697,265
2020-09-03,Ukraine,NA,Zakarpattia,1258155,91,2,7788,267
2020-09-04,Ukraine,NA,Zakarpattia,1258155,100,1,7888,268
2020-09-05,Ukraine,NA,Zakarpattia,1258155,100,1,7988,269
2020-09-06,Ukraine,NA,Zakarpattia,1258155,61,2,8049,271
2020-09-07,Ukraine,NA,Zakarpattia,1258155,42,0,8091,271
2020-09-08,Ukraine,NA,Zakarpattia,1258155,89,2,8180,273
2020-09-09,Ukraine,NA,Zakarpattia,1258155,97,3,8277,276
2020-09-10,Ukraine,NA,Zakarpattia,1258155,82,1,8359,277
2020-09-11,Ukraine,NA,Zakarpattia,1258155,94,3,8453,280
2020-09-12,Ukraine,NA,Zakarpattia,1258155,79,2,8532,282
2020-09-13,Ukraine,NA,Zakarpattia,1258155,93,1,8625,283
2020-09-14,Ukraine,NA,Zakarpattia,1258155,50,3,8675,286
2020-09-15,Ukraine,NA,Zakarpattia,1258155,81,0,8756,286
2020-09-16,Ukraine,NA,Zakarpattia,1258155,73,1,8829,287
2020-09-17,Ukraine,NA,Zakarpattia,1258155,102,2,8931,289
2020-09-18,Ukraine,NA,Zakarpattia,1258155,100,0,9031,289
2020-09-19,Ukraine,NA,Zakarpattia,1258155,79,1,9110,290
2020-09-20,Ukraine,NA,Zakarpattia,1258155,44,1,9154,291
2020-09-21,Ukraine,NA,Zakarpattia,1258155,35,1,9189,292
2020-09-22,Ukraine,NA,Zakarpattia,1258155,76,1,9265,293
2020-09-23,Ukraine,NA,Zakarpattia,1258155,78,1,9343,294
2020-03-29,Ukraine,NA,Zaporizhzhya,1723171,1,0,11,0
2020-03-30,Ukraine,NA,Zaporizhzhya,1723171,0,0,11,0
2020-03-31,Ukraine,NA,Zaporizhzhya,1723171,2,0,13,0
2020-04-01,Ukraine,NA,Zaporizhzhya,1723171,6,0,19,0
2020-04-02,Ukraine,NA,Zaporizhzhya,1723171,3,0,22,0
2020-04-03,Ukraine,NA,Zaporizhzhya,1723171,6,0,28,0
2020-04-04,Ukraine,NA,Zaporizhzhya,1723171,11,0,39,0
2020-04-05,Ukraine,NA,Zaporizhzhya,1723171,0,0,39,0
2020-04-06,Ukraine,NA,Zaporizhzhya,1723171,2,0,41,0
2020-04-07,Ukraine,NA,Zaporizhzhya,1723171,0,0,41,0
2020-04-08,Ukraine,NA,Zaporizhzhya,1723171,4,0,45,0
2020-04-09,Ukraine,NA,Zaporizhzhya,1723171,2,0,47,0
2020-04-10,Ukraine,NA,Zaporizhzhya,1723171,7,1,54,1
2020-04-11,Ukraine,NA,Zaporizhzhya,1723171,10,0,64,1
2020-04-12,Ukraine,NA,Zaporizhzhya,1723171,19,0,83,1
2020-04-13,Ukraine,NA,Zaporizhzhya,1723171,2,0,85,1
2020-04-14,Ukraine,NA,Zaporizhzhya,1723171,4,0,89,1
2020-04-15,Ukraine,NA,Zaporizhzhya,1723171,10,1,99,2
2020-04-16,Ukraine,NA,Zaporizhzhya,1723171,16,0,115,2
2020-04-17,Ukraine,NA,Zaporizhzhya,1723171,3,0,118,2
2020-04-18,Ukraine,NA,Zaporizhzhya,1723171,9,0,127,2
2020-04-19,Ukraine,NA,Zaporizhzhya,1723171,4,0,131,2
2020-04-20,Ukraine,NA,Zaporizhzhya,1723171,3,0,134,2
2020-04-21,Ukraine,NA,Zaporizhzhya,1723171,3,1,137,3
2020-04-22,Ukraine,NA,Zaporizhzhya,1723171,4,0,141,3
2020-04-23,Ukraine,NA,Zaporizhzhya,1723171,5,1,146,4
2020-04-24,Ukraine,NA,Zaporizhzhya,1723171,17,0,163,4
2020-04-25,Ukraine,NA,Zaporizhzhya,1723171,8,0,171,4
2020-04-26,Ukraine,NA,Zaporizhzhya,1723171,11,0,182,4
2020-04-27,Ukraine,NA,Zaporizhzhya,1723171,22,1,204,5
2020-04-28,Ukraine,NA,Zaporizhzhya,1723171,4,0,208,5
2020-04-29,Ukraine,NA,Zaporizhzhya,1723171,20,0,228,5
2020-04-30,Ukraine,NA,Zaporizhzhya,1723171,15,0,243,5
2020-05-01,Ukraine,NA,Zaporizhzhya,1723171,17,0,260,5
2020-05-02,Ukraine,NA,Zaporizhzhya,1723171,7,0,267,5
2020-05-03,Ukraine,NA,Zaporizhzhya,1723171,8,0,275,5
2020-05-04,Ukraine,NA,Zaporizhzhya,1723171,10,0,285,5
2020-05-05,Ukraine,NA,Zaporizhzhya,1723171,2,0,287,5
2020-05-06,Ukraine,NA,Zaporizhzhya,1723171,11,0,298,5
2020-05-07,Ukraine,NA,Zaporizhzhya,1723171,2,0,300,5
2020-05-08,Ukraine,NA,Zaporizhzhya,1723171,12,2,312,7
2020-05-09,Ukraine,NA,Zaporizhzhya,1723171,8,0,320,7
2020-05-10,Ukraine,NA,Zaporizhzhya,1723171,8,0,328,7
2020-05-11,Ukraine,NA,Zaporizhzhya,1723171,1,0,329,7
2020-05-12,Ukraine,NA,Zaporizhzhya,1723171,2,1,331,8
2020-05-13,Ukraine,NA,Zaporizhzhya,1723171,0,0,331,8
2020-05-14,Ukraine,NA,Zaporizhzhya,1723171,16,0,347,8
2020-05-15,Ukraine,NA,Zaporizhzhya,1723171,9,0,356,8
2020-05-16,Ukraine,NA,Zaporizhzhya,1723171,9,0,365,8
2020-05-17,Ukraine,NA,Zaporizhzhya,1723171,13,0,378,8
2020-05-18,Ukraine,NA,Zaporizhzhya,1723171,4,1,382,9
2020-05-19,Ukraine,NA,Zaporizhzhya,1723171,3,0,385,9
2020-05-20,Ukraine,NA,Zaporizhzhya,1723171,0,0,385,9
2020-05-21,Ukraine,NA,Zaporizhzhya,1723171,13,2,398,11
2020-05-22,Ukraine,NA,Zaporizhzhya,1723171,3,0,401,11
2020-05-23,Ukraine,NA,Zaporizhzhya,1723171,2,1,403,12
2020-05-24,Ukraine,NA,Zaporizhzhya,1723171,7,0,410,12
2020-05-25,Ukraine,NA,Zaporizhzhya,1723171,5,0,415,12
2020-05-26,Ukraine,NA,Zaporizhzhya,1723171,1,0,416,12
2020-05-27,Ukraine,NA,Zaporizhzhya,1723171,4,1,420,13
2020-05-28,Ukraine,NA,Zaporizhzhya,1723171,5,0,425,13
2020-05-29,Ukraine,NA,Zaporizhzhya,1723171,6,0,431,13
2020-05-30,Ukraine,NA,Zaporizhzhya,1723171,9,0,440,13
2020-05-31,Ukraine,NA,Zaporizhzhya,1723171,4,0,444,13
2020-06-01,Ukraine,NA,Zaporizhzhya,1723171,3,0,447,13
2020-06-02,Ukraine,NA,Zaporizhzhya,1723171,3,0,450,13
2020-06-03,Ukraine,NA,Zaporizhzhya,1723171,13,0,463,13
2020-06-04,Ukraine,NA,Zaporizhzhya,1723171,6,1,469,14
2020-06-05,Ukraine,NA,Zaporizhzhya,1723171,8,0,477,14
2020-06-06,Ukraine,NA,Zaporizhzhya,1723171,11,0,488,14
2020-06-07,Ukraine,NA,Zaporizhzhya,1723171,7,0,495,14
2020-06-08,Ukraine,NA,Zaporizhzhya,1723171,1,0,496,14
2020-06-09,Ukraine,NA,Zaporizhzhya,1723171,3,0,499,14
2020-06-10,Ukraine,NA,Zaporizhzhya,1723171,3,1,502,15
2020-06-11,Ukraine,NA,Zaporizhzhya,1723171,8,0,510,15
2020-06-12,Ukraine,NA,Zaporizhzhya,1723171,5,0,515,15
2020-06-13,Ukraine,NA,Zaporizhzhya,1723171,6,1,521,16
2020-06-14,Ukraine,NA,Zaporizhzhya,1723171,6,0,527,16
2020-06-15,Ukraine,NA,Zaporizhzhya,1723171,2,0,529,16
2020-06-16,Ukraine,NA,Zaporizhzhya,1723171,2,0,531,16
2020-06-17,Ukraine,NA,Zaporizhzhya,1723171,7,0,538,16
2020-06-18,Ukraine,NA,Zaporizhzhya,1723171,3,0,541,16
2020-06-19,Ukraine,NA,Zaporizhzhya,1723171,6,0,547,16
2020-06-20,Ukraine,NA,Zaporizhzhya,1723171,4,0,551,16
2020-06-21,Ukraine,NA,Zaporizhzhya,1723171,3,0,554,16
2020-06-22,Ukraine,NA,Zaporizhzhya,1723171,1,0,555,16
2020-06-23,Ukraine,NA,Zaporizhzhya,1723171,0,1,555,17
2020-06-24,Ukraine,NA,Zaporizhzhya,1723171,4,0,559,17
2020-06-25,Ukraine,NA,Zaporizhzhya,1723171,2,0,561,17
2020-06-26,Ukraine,NA,Zaporizhzhya,1723171,0,0,561,17
2020-06-27,Ukraine,NA,Zaporizhzhya,1723171,4,0,565,17
2020-06-28,Ukraine,NA,Zaporizhzhya,1723171,3,0,568,17
2020-06-29,Ukraine,NA,Zaporizhzhya,1723171,2,0,570,17
2020-06-30,Ukraine,NA,Zaporizhzhya,1723171,2,0,572,17
2020-07-01,Ukraine,NA,Zaporizhzhya,1723171,0,0,572,17
2020-07-02,Ukraine,NA,Zaporizhzhya,1723171,4,0,576,17
2020-07-03,Ukraine,NA,Zaporizhzhya,1723171,3,0,579,17
2020-07-04,Ukraine,NA,Zaporizhzhya,1723171,9,0,588,17
2020-07-05,Ukraine,NA,Zaporizhzhya,1723171,9,0,597,17
2020-07-06,Ukraine,NA,Zaporizhzhya,1723171,0,0,597,17
2020-07-07,Ukraine,NA,Zaporizhzhya,1723171,1,1,598,18
2020-07-08,Ukraine,NA,Zaporizhzhya,1723171,1,0,599,18
2020-07-09,Ukraine,NA,Zaporizhzhya,1723171,6,1,605,19
2020-07-10,Ukraine,NA,Zaporizhzhya,1723171,5,0,610,19
2020-07-11,Ukraine,NA,Zaporizhzhya,1723171,2,1,612,20
2020-07-12,Ukraine,NA,Zaporizhzhya,1723171,9,0,621,20
2020-07-13,Ukraine,NA,Zaporizhzhya,1723171,1,0,622,20
2020-07-14,Ukraine,NA,Zaporizhzhya,1723171,0,0,622,20
2020-07-15,Ukraine,NA,Zaporizhzhya,1723171,9,0,631,20
2020-07-16,Ukraine,NA,Zaporizhzhya,1723171,11,0,642,20
2020-07-17,Ukraine,NA,Zaporizhzhya,1723171,16,0,658,20
2020-07-18,Ukraine,NA,Zaporizhzhya,1723171,7,0,665,20
2020-07-19,Ukraine,NA,Zaporizhzhya,1723171,4,0,669,20
2020-07-20,Ukraine,NA,Zaporizhzhya,1723171,9,0,678,20
2020-07-21,Ukraine,NA,Zaporizhzhya,1723171,4,1,682,21
2020-07-22,Ukraine,NA,Zaporizhzhya,1723171,9,0,691,21
2020-07-23,Ukraine,NA,Zaporizhzhya,1723171,9,0,700,21
2020-07-24,Ukraine,NA,Zaporizhzhya,1723171,12,0,712,21
2020-07-25,Ukraine,NA,Zaporizhzhya,1723171,13,0,725,21
2020-07-26,Ukraine,NA,Zaporizhzhya,1723171,9,0,734,21
2020-07-27,Ukraine,NA,Zaporizhzhya,1723171,16,0,750,21
2020-07-28,Ukraine,NA,Zaporizhzhya,1723171,3,0,753,21
2020-07-29,Ukraine,NA,Zaporizhzhya,1723171,14,0,767,21
2020-07-30,Ukraine,NA,Zaporizhzhya,1723171,12,0,779,21
2020-07-31,Ukraine,NA,Zaporizhzhya,1723171,11,0,790,21
2020-08-01,Ukraine,NA,Zaporizhzhya,1723171,10,0,800,21
2020-08-02,Ukraine,NA,Zaporizhzhya,1723171,23,0,823,21
2020-08-03,Ukraine,NA,Zaporizhzhya,1723171,23,0,846,21
2020-08-04,Ukraine,NA,Zaporizhzhya,1723171,5,0,851,21
2020-08-05,Ukraine,NA,Zaporizhzhya,1723171,20,0,871,21
2020-08-06,Ukraine,NA,Zaporizhzhya,1723171,19,0,890,21
2020-08-07,Ukraine,NA,Zaporizhzhya,1723171,5,0,895,21
2020-08-08,Ukraine,NA,Zaporizhzhya,1723171,24,0,919,21
2020-08-09,Ukraine,NA,Zaporizhzhya,1723171,18,1,937,22
2020-08-10,Ukraine,NA,Zaporizhzhya,1723171,16,0,953,22
2020-08-11,Ukraine,NA,Zaporizhzhya,1723171,6,0,959,22
2020-08-12,Ukraine,NA,Zaporizhzhya,1723171,12,0,971,22
2020-08-13,Ukraine,NA,Zaporizhzhya,1723171,39,1,1010,23
2020-08-14,Ukraine,NA,Zaporizhzhya,1723171,28,0,1038,23
2020-08-15,Ukraine,NA,Zaporizhzhya,1723171,14,0,1052,23
2020-08-16,Ukraine,NA,Zaporizhzhya,1723171,33,0,1085,23
2020-08-17,Ukraine,NA,Zaporizhzhya,1723171,33,0,1118,23
2020-08-18,Ukraine,NA,Zaporizhzhya,1723171,36,0,1154,23
2020-08-19,Ukraine,NA,Zaporizhzhya,1723171,25,1,1179,24
2020-08-20,Ukraine,NA,Zaporizhzhya,1723171,34,0,1213,24
2020-08-21,Ukraine,NA,Zaporizhzhya,1723171,21,0,1234,24
2020-08-22,Ukraine,NA,Zaporizhzhya,1723171,53,0,1287,24
2020-08-23,Ukraine,NA,Zaporizhzhya,1723171,44,0,1331,24
2020-08-24,Ukraine,NA,Zaporizhzhya,1723171,46,0,1377,24
2020-08-25,Ukraine,NA,Zaporizhzhya,1723171,30,0,1407,24
2020-08-26,Ukraine,NA,Zaporizhzhya,1723171,32,0,1439,24
2020-08-27,Ukraine,NA,Zaporizhzhya,1723171,15,1,1454,25
2020-08-28,Ukraine,NA,Zaporizhzhya,1723171,33,0,1487,25
2020-08-29,Ukraine,NA,Zaporizhzhya,1723171,33,0,1520,25
2020-08-30,Ukraine,NA,Zaporizhzhya,1723171,38,0,1558,25
2020-08-31,Ukraine,NA,Zaporizhzhya,1723171,38,0,1596,25
2020-09-01,Ukraine,NA,Zaporizhzhya,1723171,31,0,1627,25
2020-09-02,Ukraine,NA,Zaporizhzhya,1723171,30,0,1657,25
2020-09-03,Ukraine,NA,Zaporizhzhya,1723171,51,0,1708,25
2020-09-04,Ukraine,NA,Zaporizhzhya,1723171,60,0,1768,25
2020-09-05,Ukraine,NA,Zaporizhzhya,1723171,80,0,1848,25
2020-09-06,Ukraine,NA,Zaporizhzhya,1723171,34,0,1882,25
2020-09-07,Ukraine,NA,Zaporizhzhya,1723171,49,0,1931,25
2020-09-08,Ukraine,NA,Zaporizhzhya,1723171,50,2,1981,27
2020-09-09,Ukraine,NA,Zaporizhzhya,1723171,60,2,2041,29
2020-09-10,Ukraine,NA,Zaporizhzhya,1723171,40,1,2081,30
2020-09-11,Ukraine,NA,Zaporizhzhya,1723171,55,0,2136,30
2020-09-12,Ukraine,NA,Zaporizhzhya,1723171,106,2,2242,32
2020-09-13,Ukraine,NA,Zaporizhzhya,1723171,105,1,2347,33
2020-09-14,Ukraine,NA,Zaporizhzhya,1723171,56,0,2403,33
2020-09-15,Ukraine,NA,Zaporizhzhya,1723171,100,0,2503,33
2020-09-16,Ukraine,NA,Zaporizhzhya,1723171,88,2,2591,35
2020-09-17,Ukraine,NA,Zaporizhzhya,1723171,82,2,2673,37
2020-09-18,Ukraine,NA,Zaporizhzhya,1723171,75,5,2748,42
2020-09-19,Ukraine,NA,Zaporizhzhya,1723171,81,0,2829,42
2020-09-20,Ukraine,NA,Zaporizhzhya,1723171,50,0,2879,42
2020-09-21,Ukraine,NA,Zaporizhzhya,1723171,55,0,2934,42
2020-09-22,Ukraine,NA,Zaporizhzhya,1723171,100,2,3034,44
2020-09-23,Ukraine,NA,Zaporizhzhya,1723171,115,5,3149,49
2020-04-05,Ukraine,NA,Zhytomyr,1231239,2,0,11,2
2020-04-06,Ukraine,NA,Zhytomyr,1231239,0,0,11,2
2020-04-07,Ukraine,NA,Zhytomyr,1231239,0,0,11,2
2020-04-08,Ukraine,NA,Zhytomyr,1231239,10,0,21,2
2020-04-09,Ukraine,NA,Zhytomyr,1231239,10,0,31,2
2020-04-10,Ukraine,NA,Zhytomyr,1231239,10,1,41,3
2020-04-11,Ukraine,NA,Zhytomyr,1231239,33,0,74,3
2020-04-12,Ukraine,NA,Zhytomyr,1231239,0,0,74,3
2020-04-13,Ukraine,NA,Zhytomyr,1231239,20,0,94,3
2020-04-14,Ukraine,NA,Zhytomyr,1231239,18,0,112,3
2020-04-15,Ukraine,NA,Zhytomyr,1231239,18,1,130,4
2020-04-16,Ukraine,NA,Zhytomyr,1231239,32,0,162,4
2020-04-17,Ukraine,NA,Zhytomyr,1231239,15,0,177,4
2020-04-18,Ukraine,NA,Zhytomyr,1231239,20,0,197,4
2020-04-19,Ukraine,NA,Zhytomyr,1231239,14,0,211,4
2020-04-20,Ukraine,NA,Zhytomyr,1231239,15,1,226,5
2020-04-21,Ukraine,NA,Zhytomyr,1231239,44,1,270,6
2020-04-22,Ukraine,NA,Zhytomyr,1231239,17,0,287,6
2020-04-23,Ukraine,NA,Zhytomyr,1231239,17,0,304,6
2020-04-24,Ukraine,NA,Zhytomyr,1231239,5,1,309,7
2020-04-25,Ukraine,NA,Zhytomyr,1231239,28,0,337,7
2020-04-26,Ukraine,NA,Zhytomyr,1231239,11,0,348,7
2020-04-27,Ukraine,NA,Zhytomyr,1231239,3,0,351,7
2020-04-28,Ukraine,NA,Zhytomyr,1231239,3,1,354,8
2020-04-29,Ukraine,NA,Zhytomyr,1231239,3,0,357,8
2020-04-30,Ukraine,NA,Zhytomyr,1231239,17,2,374,10
2020-05-01,Ukraine,NA,Zhytomyr,1231239,16,0,390,10
2020-05-02,Ukraine,NA,Zhytomyr,1231239,3,0,393,10
2020-05-03,Ukraine,NA,Zhytomyr,1231239,30,0,423,10
2020-05-04,Ukraine,NA,Zhytomyr,1231239,7,0,430,10
2020-05-05,Ukraine,NA,Zhytomyr,1231239,18,0,448,10
2020-05-06,Ukraine,NA,Zhytomyr,1231239,8,1,456,11
2020-05-07,Ukraine,NA,Zhytomyr,1231239,12,0,468,11
2020-05-08,Ukraine,NA,Zhytomyr,1231239,12,0,480,11
2020-05-09,Ukraine,NA,Zhytomyr,1231239,5,0,485,11
2020-05-10,Ukraine,NA,Zhytomyr,1231239,32,0,517,11
2020-05-11,Ukraine,NA,Zhytomyr,1231239,6,0,523,11
2020-05-12,Ukraine,NA,Zhytomyr,1231239,2,1,525,12
2020-05-13,Ukraine,NA,Zhytomyr,1231239,5,0,530,12
2020-05-14,Ukraine,NA,Zhytomyr,1231239,3,0,533,12
2020-05-15,Ukraine,NA,Zhytomyr,1231239,5,0,538,12
2020-05-16,Ukraine,NA,Zhytomyr,1231239,2,0,540,12
2020-05-17,Ukraine,NA,Zhytomyr,1231239,6,0,546,12
2020-05-18,Ukraine,NA,Zhytomyr,1231239,18,0,564,12
2020-05-19,Ukraine,NA,Zhytomyr,1231239,9,0,573,12
2020-05-20,Ukraine,NA,Zhytomyr,1231239,10,0,583,12
2020-05-21,Ukraine,NA,Zhytomyr,1231239,6,1,589,13
2020-05-22,Ukraine,NA,Zhytomyr,1231239,18,0,607,13
2020-05-23,Ukraine,NA,Zhytomyr,1231239,11,0,618,13
2020-05-24,Ukraine,NA,Zhytomyr,1231239,8,0,626,13
2020-05-25,Ukraine,NA,Zhytomyr,1231239,15,0,641,13
2020-05-26,Ukraine,NA,Zhytomyr,1231239,6,1,647,14
2020-05-27,Ukraine,NA,Zhytomyr,1231239,13,0,660,14
2020-05-28,Ukraine,NA,Zhytomyr,1231239,13,0,673,14
2020-05-29,Ukraine,NA,Zhytomyr,1231239,21,0,694,14
2020-05-30,Ukraine,NA,Zhytomyr,1231239,5,0,699,14
2020-05-31,Ukraine,NA,Zhytomyr,1231239,40,0,739,14
2020-06-01,Ukraine,NA,Zhytomyr,1231239,3,0,742,14
2020-06-02,Ukraine,NA,Zhytomyr,1231239,34,0,776,14
2020-06-03,Ukraine,NA,Zhytomyr,1231239,4,0,780,14
2020-06-04,Ukraine,NA,Zhytomyr,1231239,53,0,833,14
2020-06-05,Ukraine,NA,Zhytomyr,1231239,22,1,855,15
2020-06-06,Ukraine,NA,Zhytomyr,1231239,15,0,870,15
2020-06-07,Ukraine,NA,Zhytomyr,1231239,11,1,881,16
2020-06-08,Ukraine,NA,Zhytomyr,1231239,16,0,897,16
2020-06-09,Ukraine,NA,Zhytomyr,1231239,38,0,935,16
2020-06-10,Ukraine,NA,Zhytomyr,1231239,38,1,973,17
2020-06-11,Ukraine,NA,Zhytomyr,1231239,19,0,992,17
2020-06-12,Ukraine,NA,Zhytomyr,1231239,21,0,1013,17
2020-06-13,Ukraine,NA,Zhytomyr,1231239,19,0,1032,17
2020-06-14,Ukraine,NA,Zhytomyr,1231239,13,2,1045,19
2020-06-15,Ukraine,NA,Zhytomyr,1231239,42,0,1087,19
2020-06-16,Ukraine,NA,Zhytomyr,1231239,14,1,1101,20
2020-06-17,Ukraine,NA,Zhytomyr,1231239,46,1,1147,21
2020-06-18,Ukraine,NA,Zhytomyr,1231239,7,0,1154,21
2020-06-19,Ukraine,NA,Zhytomyr,1231239,47,0,1201,21
2020-06-20,Ukraine,NA,Zhytomyr,1231239,28,0,1229,21
2020-06-21,Ukraine,NA,Zhytomyr,1231239,28,0,1257,21
2020-06-22,Ukraine,NA,Zhytomyr,1231239,13,2,1270,23
2020-06-23,Ukraine,NA,Zhytomyr,1231239,25,1,1295,24
2020-06-24,Ukraine,NA,Zhytomyr,1231239,9,0,1304,24
2020-06-25,Ukraine,NA,Zhytomyr,1231239,33,2,1337,26
2020-06-26,Ukraine,NA,Zhytomyr,1231239,29,1,1366,27
2020-06-27,Ukraine,NA,Zhytomyr,1231239,5,0,1371,27
2020-06-28,Ukraine,NA,Zhytomyr,1231239,25,2,1396,29
2020-06-29,Ukraine,NA,Zhytomyr,1231239,8,0,1404,29
2020-06-30,Ukraine,NA,Zhytomyr,1231239,0,0,1404,29
2020-07-01,Ukraine,NA,Zhytomyr,1231239,4,0,1408,29
2020-07-02,Ukraine,NA,Zhytomyr,1231239,13,1,1421,30
2020-07-03,Ukraine,NA,Zhytomyr,1231239,14,0,1435,30
2020-07-04,Ukraine,NA,Zhytomyr,1231239,12,0,1447,30
2020-07-05,Ukraine,NA,Zhytomyr,1231239,14,0,1461,30
2020-07-06,Ukraine,NA,Zhytomyr,1231239,7,0,1468,30
2020-07-07,Ukraine,NA,Zhytomyr,1231239,1,0,1469,30
2020-07-08,Ukraine,NA,Zhytomyr,1231239,15,2,1484,32
2020-07-09,Ukraine,NA,Zhytomyr,1231239,16,0,1500,32
2020-07-10,Ukraine,NA,Zhytomyr,1231239,12,1,1512,33
2020-07-11,Ukraine,NA,Zhytomyr,1231239,9,1,1521,34
2020-07-12,Ukraine,NA,Zhytomyr,1231239,11,0,1532,34
2020-07-13,Ukraine,NA,Zhytomyr,1231239,10,0,1542,34
2020-07-14,Ukraine,NA,Zhytomyr,1231239,0,0,1542,34
2020-07-15,Ukraine,NA,Zhytomyr,1231239,8,0,1550,34
2020-07-16,Ukraine,NA,Zhytomyr,1231239,19,0,1569,34
2020-07-17,Ukraine,NA,Zhytomyr,1231239,11,0,1580,34
2020-07-18,Ukraine,NA,Zhytomyr,1231239,4,0,1584,34
2020-07-19,Ukraine,NA,Zhytomyr,1231239,9,0,1593,34
2020-07-20,Ukraine,NA,Zhytomyr,1231239,9,0,1602,34
2020-07-21,Ukraine,NA,Zhytomyr,1231239,7,1,1609,35
2020-07-22,Ukraine,NA,Zhytomyr,1231239,25,0,1634,35
2020-07-23,Ukraine,NA,Zhytomyr,1231239,20,0,1654,35
2020-07-24,Ukraine,NA,Zhytomyr,1231239,16,0,1670,35
2020-07-25,Ukraine,NA,Zhytomyr,1231239,21,0,1691,35
2020-07-26,Ukraine,NA,Zhytomyr,1231239,18,0,1709,35
2020-07-27,Ukraine,NA,Zhytomyr,1231239,14,0,1723,35
2020-07-28,Ukraine,NA,Zhytomyr,1231239,21,0,1744,35
2020-07-29,Ukraine,NA,Zhytomyr,1231239,20,1,1764,36
2020-07-30,Ukraine,NA,Zhytomyr,1231239,43,1,1807,37
2020-07-31,Ukraine,NA,Zhytomyr,1231239,43,0,1850,37
2020-08-01,Ukraine,NA,Zhytomyr,1231239,46,0,1896,37
2020-08-02,Ukraine,NA,Zhytomyr,1231239,25,1,1921,38
2020-08-03,Ukraine,NA,Zhytomyr,1231239,27,0,1948,38
2020-08-04,Ukraine,NA,Zhytomyr,1231239,19,0,1967,38
2020-08-05,Ukraine,NA,Zhytomyr,1231239,42,2,2009,40
2020-08-06,Ukraine,NA,Zhytomyr,1231239,27,0,2036,40
2020-08-07,Ukraine,NA,Zhytomyr,1231239,28,0,2064,40
2020-08-08,Ukraine,NA,Zhytomyr,1231239,37,1,2101,41
2020-08-09,Ukraine,NA,Zhytomyr,1231239,30,0,2131,41
2020-08-10,Ukraine,NA,Zhytomyr,1231239,23,2,2154,43
2020-08-11,Ukraine,NA,Zhytomyr,1231239,24,3,2178,46
2020-08-12,Ukraine,NA,Zhytomyr,1231239,37,2,2215,48
2020-08-13,Ukraine,NA,Zhytomyr,1231239,51,1,2266,49
2020-08-14,Ukraine,NA,Zhytomyr,1231239,67,0,2333,49
2020-08-15,Ukraine,NA,Zhytomyr,1231239,44,0,2377,49
2020-08-16,Ukraine,NA,Zhytomyr,1231239,53,2,2430,51
2020-08-17,Ukraine,NA,Zhytomyr,1231239,49,0,2479,51
2020-08-18,Ukraine,NA,Zhytomyr,1231239,18,1,2497,52
2020-08-19,Ukraine,NA,Zhytomyr,1231239,39,0,2536,52
2020-08-20,Ukraine,NA,Zhytomyr,1231239,61,3,2597,55
2020-08-21,Ukraine,NA,Zhytomyr,1231239,98,0,2695,55
2020-08-22,Ukraine,NA,Zhytomyr,1231239,39,2,2734,57
2020-08-23,Ukraine,NA,Zhytomyr,1231239,87,3,2821,60
2020-08-24,Ukraine,NA,Zhytomyr,1231239,43,0,2864,60
2020-08-25,Ukraine,NA,Zhytomyr,1231239,59,0,2923,60
2020-08-26,Ukraine,NA,Zhytomyr,1231239,36,0,2959,60
2020-08-27,Ukraine,NA,Zhytomyr,1231239,39,1,2998,61
2020-08-28,Ukraine,NA,Zhytomyr,1231239,65,0,3063,61
2020-08-29,Ukraine,NA,Zhytomyr,1231239,92,0,3155,61
2020-08-30,Ukraine,NA,Zhytomyr,1231239,58,4,3213,65
2020-08-31,Ukraine,NA,Zhytomyr,1231239,89,0,3302,65
2020-09-01,Ukraine,NA,Zhytomyr,1231239,80,3,3382,68
2020-09-02,Ukraine,NA,Zhytomyr,1231239,60,0,3442,68
2020-09-03,Ukraine,NA,Zhytomyr,1231239,29,1,3471,69
2020-09-04,Ukraine,NA,Zhytomyr,1231239,79,0,3550,69
2020-09-05,Ukraine,NA,Zhytomyr,1231239,72,1,3622,70
2020-09-06,Ukraine,NA,Zhytomyr,1231239,56,2,3678,72
2020-09-07,Ukraine,NA,Zhytomyr,1231239,68,2,3746,74
2020-09-08,Ukraine,NA,Zhytomyr,1231239,66,1,3812,75
2020-09-09,Ukraine,NA,Zhytomyr,1231239,67,3,3879,78
2020-09-10,Ukraine,NA,Zhytomyr,1231239,59,1,3938,79
2020-09-11,Ukraine,NA,Zhytomyr,1231239,117,2,4055,81
2020-09-12,Ukraine,NA,Zhytomyr,1231239,139,1,4194,82
2020-09-13,Ukraine,NA,Zhytomyr,1231239,98,0,4292,82
2020-09-14,Ukraine,NA,Zhytomyr,1231239,98,1,4390,83
2020-09-15,Ukraine,NA,Zhytomyr,1231239,80,3,4470,86
2020-09-16,Ukraine,NA,Zhytomyr,1231239,73,2,4543,88
2020-09-17,Ukraine,NA,Zhytomyr,1231239,113,1,4656,89
2020-09-18,Ukraine,NA,Zhytomyr,1231239,118,0,4774,89
2020-09-19,Ukraine,NA,Zhytomyr,1231239,157,1,4931,90
2020-09-20,Ukraine,NA,Zhytomyr,1231239,57,0,4988,90
2020-09-21,Ukraine,NA,Zhytomyr,1231239,71,1,5059,91
2020-09-22,Ukraine,NA,Zhytomyr,1231239,62,1,5121,92
2020-09-23,Ukraine,NA,Zhytomyr,1231239,70,0,5191,92
2020-03-03,United Kingdom,NA,East Midlands,4811065,7,1,14,1
2020-03-04,United Kingdom,NA,East Midlands,4811065,2,0,16,1
2020-03-05,United Kingdom,NA,East Midlands,4811065,3,0,19,1
2020-03-06,United Kingdom,NA,East Midlands,4811065,7,0,26,1
2020-03-07,United Kingdom,NA,East Midlands,4811065,5,0,31,1
2020-03-08,United Kingdom,NA,East Midlands,4811065,1,0,32,1
2020-03-09,United Kingdom,NA,East Midlands,4811065,10,0,42,1
2020-03-10,United Kingdom,NA,East Midlands,4811065,12,0,54,1
2020-03-11,United Kingdom,NA,East Midlands,4811065,25,0,79,1
2020-03-12,United Kingdom,NA,East Midlands,4811065,18,1,97,2
2020-03-13,United Kingdom,NA,East Midlands,4811065,22,1,119,3
2020-03-14,United Kingdom,NA,East Midlands,4811065,19,1,138,4
2020-03-15,United Kingdom,NA,East Midlands,4811065,26,0,164,4
2020-03-16,United Kingdom,NA,East Midlands,4811065,34,4,198,8
2020-03-17,United Kingdom,NA,East Midlands,4811065,33,0,231,8
2020-03-18,United Kingdom,NA,East Midlands,4811065,49,3,280,11
2020-03-19,United Kingdom,NA,East Midlands,4811065,66,1,346,12
2020-03-20,United Kingdom,NA,East Midlands,4811065,53,4,399,16
2020-03-21,United Kingdom,NA,East Midlands,4811065,69,2,468,18
2020-03-22,United Kingdom,NA,East Midlands,4811065,99,15,567,33
2020-03-23,United Kingdom,NA,East Midlands,4811065,117,11,684,44
2020-03-24,United Kingdom,NA,East Midlands,4811065,136,14,820,58
2020-03-25,United Kingdom,NA,East Midlands,4811065,116,12,936,70
2020-03-26,United Kingdom,NA,East Midlands,4811065,154,18,1090,88
2020-03-27,United Kingdom,NA,East Midlands,4811065,137,21,1227,109
2020-03-28,United Kingdom,NA,East Midlands,4811065,159,23,1386,132
2020-03-29,United Kingdom,NA,East Midlands,4811065,129,25,1515,157
2020-03-30,United Kingdom,NA,East Midlands,4811065,206,25,1721,182
2020-03-31,United Kingdom,NA,East Midlands,4811065,277,35,1998,217
2020-04-01,United Kingdom,NA,East Midlands,4811065,296,44,2294,261
2020-04-02,United Kingdom,NA,East Midlands,4811065,213,43,2507,304
2020-04-03,United Kingdom,NA,East Midlands,4811065,259,53,2766,357
2020-04-04,United Kingdom,NA,East Midlands,4811065,189,51,2955,408
2020-04-05,United Kingdom,NA,East Midlands,4811065,148,61,3103,469
2020-04-06,United Kingdom,NA,East Midlands,4811065,215,67,3318,536
2020-04-07,United Kingdom,NA,East Midlands,4811065,227,48,3545,584
2020-04-08,United Kingdom,NA,East Midlands,4811065,188,66,3733,650
2020-04-09,United Kingdom,NA,East Midlands,4811065,233,65,3966,715
2020-04-10,United Kingdom,NA,East Midlands,4811065,173,57,4139,772
2020-04-11,United Kingdom,NA,East Midlands,4811065,174,63,4313,835
2020-04-12,United Kingdom,NA,East Midlands,4811065,214,58,4527,893
2020-04-13,United Kingdom,NA,East Midlands,4811065,172,48,4699,939
2020-04-14,United Kingdom,NA,East Midlands,4811065,210,60,4909,981
2020-04-15,United Kingdom,NA,East Midlands,4811065,218,65,5127,1025
2020-04-16,United Kingdom,NA,East Midlands,4811065,267,32,5394,1078
2020-04-17,United Kingdom,NA,East Midlands,4811065,255,60,5649,1129
2020-04-18,United Kingdom,NA,East Midlands,4811065,195,49,5844,1168
2020-04-19,United Kingdom,NA,East Midlands,4811065,246,50,6090,1218
2020-04-20,United Kingdom,NA,East Midlands,4811065,187,63,6277,1255
2020-04-21,United Kingdom,NA,East Midlands,4811065,219,37,6496,1299
2020-04-22,United Kingdom,NA,East Midlands,4811065,334,38,6830,1366
2020-04-23,United Kingdom,NA,East Midlands,4811065,269,50,7099,1419
2020-04-24,United Kingdom,NA,East Midlands,4811065,298,41,7397,1479
2020-04-25,United Kingdom,NA,East Midlands,4811065,245,41,7642,1527
2020-04-26,United Kingdom,NA,East Midlands,4811065,243,45,7885,1572
2020-04-27,United Kingdom,NA,East Midlands,4811065,319,45,8204,1617
2020-04-28,United Kingdom,NA,East Midlands,4811065,272,43,8476,1660
2020-04-29,United Kingdom,NA,East Midlands,4811065,378,50,8854,1710
2020-04-30,United Kingdom,NA,East Midlands,4811065,294,42,9148,1752
2020-05-01,United Kingdom,NA,East Midlands,4811065,294,40,9442,1792
2020-05-02,United Kingdom,NA,East Midlands,4811065,198,33,9640,1825
2020-05-03,United Kingdom,NA,East Midlands,4811065,169,40,9809,1865
2020-05-04,United Kingdom,NA,East Midlands,4811065,235,42,10044,1907
2020-05-05,United Kingdom,NA,East Midlands,4811065,284,38,10328,1945
2020-05-06,United Kingdom,NA,East Midlands,4811065,334,35,10662,1980
2020-05-07,United Kingdom,NA,East Midlands,4811065,313,32,10975,2012
2020-05-08,United Kingdom,NA,East Midlands,4811065,269,30,11244,2042
2020-05-09,United Kingdom,NA,East Midlands,4811065,176,35,11420,2077
2020-05-10,United Kingdom,NA,East Midlands,4811065,197,24,11617,2101
2020-05-11,United Kingdom,NA,East Midlands,4811065,308,29,11925,2130
2020-05-12,United Kingdom,NA,East Midlands,4811065,320,32,12245,2162
2020-05-13,United Kingdom,NA,East Midlands,4811065,298,15,12543,2177
2020-05-14,United Kingdom,NA,East Midlands,4811065,226,30,12769,2207
2020-05-15,United Kingdom,NA,East Midlands,4811065,252,18,13021,2225
2020-05-16,United Kingdom,NA,East Midlands,4811065,256,23,13277,2248
2020-05-17,United Kingdom,NA,East Midlands,4811065,203,16,13480,2264
2020-05-18,United Kingdom,NA,East Midlands,4811065,272,27,13752,2291
2020-05-19,United Kingdom,NA,East Midlands,4811065,293,22,14045,2313
2020-05-20,United Kingdom,NA,East Midlands,4811065,274,23,14319,2336
2020-05-21,United Kingdom,NA,East Midlands,4811065,281,25,14600,2361
2020-05-22,United Kingdom,NA,East Midlands,4811065,240,21,14840,2382
2020-05-23,United Kingdom,NA,East Midlands,4811065,164,28,15004,2410
2020-05-24,United Kingdom,NA,East Midlands,4811065,145,14,15149,2424
2020-05-25,United Kingdom,NA,East Midlands,4811065,192,19,15341,2443
2020-05-26,United Kingdom,NA,East Midlands,4811065,160,23,15501,2466
2020-05-27,United Kingdom,NA,East Midlands,4811065,197,20,15698,2486
2020-05-28,United Kingdom,NA,East Midlands,4811065,191,19,15889,2505
2020-05-29,United Kingdom,NA,East Midlands,4811065,170,11,16059,2516
2020-05-30,United Kingdom,NA,East Midlands,4811065,139,17,16198,2533
2020-05-31,United Kingdom,NA,East Midlands,4811065,149,13,16347,2546
2020-06-01,United Kingdom,NA,East Midlands,4811065,217,17,16564,2563
2020-06-02,United Kingdom,NA,East Midlands,4811065,219,13,16783,2576
2020-06-03,United Kingdom,NA,East Midlands,4811065,171,19,16954,2595
2020-06-04,United Kingdom,NA,East Midlands,4811065,143,14,17097,2609
2020-06-05,United Kingdom,NA,East Midlands,4811065,154,8,17251,2617
2020-06-06,United Kingdom,NA,East Midlands,4811065,105,16,17356,2633
2020-06-07,United Kingdom,NA,East Midlands,4811065,128,12,17484,2645
2020-06-08,United Kingdom,NA,East Midlands,4811065,173,16,17657,2661
2020-06-09,United Kingdom,NA,East Midlands,4811065,177,12,17834,2673
2020-06-10,United Kingdom,NA,East Midlands,4811065,166,11,18000,2684
2020-06-11,United Kingdom,NA,East Midlands,4811065,182,18,18182,2702
2020-06-12,United Kingdom,NA,East Midlands,4811065,174,12,18356,2714
2020-06-13,United Kingdom,NA,East Midlands,4811065,132,5,18488,2719
2020-06-14,United Kingdom,NA,East Midlands,4811065,145,14,18633,2733
2020-06-15,United Kingdom,NA,East Midlands,4811065,165,8,18798,2741
2020-06-16,United Kingdom,NA,East Midlands,4811065,161,6,18959,2747
2020-06-17,United Kingdom,NA,East Midlands,4811065,164,6,19123,2753
2020-06-18,United Kingdom,NA,East Midlands,4811065,169,12,19292,2765
2020-06-19,United Kingdom,NA,East Midlands,4811065,153,9,19445,2774
2020-06-20,United Kingdom,NA,East Midlands,4811065,145,12,19590,2786
2020-06-21,United Kingdom,NA,East Midlands,4811065,131,7,19721,2793
2020-06-22,United Kingdom,NA,East Midlands,4811065,177,7,19898,2800
2020-06-23,United Kingdom,NA,East Midlands,4811065,169,6,20067,2806
2020-06-24,United Kingdom,NA,East Midlands,4811065,173,13,20240,2819
2020-06-25,United Kingdom,NA,East Midlands,4811065,125,11,20365,2830
2020-06-26,United Kingdom,NA,East Midlands,4811065,114,5,20479,2835
2020-06-27,United Kingdom,NA,East Midlands,4811065,87,6,20566,2841
2020-06-28,United Kingdom,NA,East Midlands,4811065,78,4,20644,2845
2020-06-29,United Kingdom,NA,East Midlands,4811065,129,5,20773,2850
2020-06-30,United Kingdom,NA,East Midlands,4811065,129,5,20902,2855
2020-07-01,United Kingdom,NA,East Midlands,4811065,120,4,21022,2859
2020-07-02,United Kingdom,NA,East Midlands,4811065,105,4,21127,2863
2020-07-03,United Kingdom,NA,East Midlands,4811065,108,1,21235,2864
2020-07-04,United Kingdom,NA,East Midlands,4811065,86,2,21321,2866
2020-07-05,United Kingdom,NA,East Midlands,4811065,127,4,21448,2870
2020-07-06,United Kingdom,NA,East Midlands,4811065,139,3,21587,2873
2020-07-07,United Kingdom,NA,East Midlands,4811065,108,2,21695,2875
2020-07-08,United Kingdom,NA,East Midlands,4811065,110,2,21805,2877
2020-07-09,United Kingdom,NA,East Midlands,4811065,95,5,21900,2882
2020-07-10,United Kingdom,NA,East Midlands,4811065,99,2,21999,2884
2020-07-11,United Kingdom,NA,East Midlands,4811065,94,2,22093,2886
2020-07-12,United Kingdom,NA,East Midlands,4811065,46,2,22139,2888
2020-07-13,United Kingdom,NA,East Midlands,4811065,105,1,22244,2889
2020-07-14,United Kingdom,NA,East Midlands,4811065,89,2,22333,2891
2020-07-15,United Kingdom,NA,East Midlands,4811065,113,4,22446,2895
2020-07-16,United Kingdom,NA,East Midlands,4811065,92,4,22538,2899
2020-07-17,United Kingdom,NA,East Midlands,4811065,80,2,22618,2901
2020-07-18,United Kingdom,NA,East Midlands,4811065,63,1,22681,2902
2020-07-19,United Kingdom,NA,East Midlands,4811065,48,3,22729,2905
2020-07-20,United Kingdom,NA,East Midlands,4811065,82,2,22811,2907
2020-07-21,United Kingdom,NA,East Midlands,4811065,68,5,22879,2912
2020-07-22,United Kingdom,NA,East Midlands,4811065,88,0,22967,2912
2020-07-23,United Kingdom,NA,East Midlands,4811065,94,1,23061,2913
2020-07-24,United Kingdom,NA,East Midlands,4811065,81,0,23142,2913
2020-07-25,United Kingdom,NA,East Midlands,4811065,44,2,23186,2915
2020-07-26,United Kingdom,NA,East Midlands,4811065,38,5,23224,2920
2020-07-27,United Kingdom,NA,East Midlands,4811065,92,1,23316,2921
2020-07-28,United Kingdom,NA,East Midlands,4811065,76,1,23392,2922
2020-07-29,United Kingdom,NA,East Midlands,4811065,108,1,23500,2923
2020-07-30,United Kingdom,NA,East Midlands,4811065,109,1,23609,2924
2020-07-31,United Kingdom,NA,East Midlands,4811065,75,0,23684,2924
2020-08-01,United Kingdom,NA,East Midlands,4811065,69,0,23753,2924
2020-08-02,United Kingdom,NA,East Midlands,4811065,54,2,23807,2926
2020-08-03,United Kingdom,NA,East Midlands,4811065,108,1,23915,2927
2020-08-04,United Kingdom,NA,East Midlands,4811065,88,2,24003,2929
2020-08-05,United Kingdom,NA,East Midlands,4811065,115,0,24118,2929
2020-08-06,United Kingdom,NA,East Midlands,4811065,113,0,24231,2929
2020-08-07,United Kingdom,NA,East Midlands,4811065,91,0,24322,2929
2020-08-08,United Kingdom,NA,East Midlands,4811065,73,1,24395,2930
2020-08-09,United Kingdom,NA,East Midlands,4811065,72,0,24467,2930
2020-08-10,United Kingdom,NA,East Midlands,4811065,210,2,24677,2932
2020-08-11,United Kingdom,NA,East Midlands,4811065,176,2,24853,2934
2020-08-12,United Kingdom,NA,East Midlands,4811065,119,1,24972,2935
2020-08-13,United Kingdom,NA,East Midlands,4811065,109,1,25081,2936
2020-08-14,United Kingdom,NA,East Midlands,4811065,87,0,25168,2936
2020-08-15,United Kingdom,NA,East Midlands,4811065,55,0,25223,2936
2020-08-16,United Kingdom,NA,East Midlands,4811065,58,0,25281,2936
2020-08-17,United Kingdom,NA,East Midlands,4811065,138,0,25419,2936
2020-08-18,United Kingdom,NA,East Midlands,4811065,77,0,25496,2936
2020-08-19,United Kingdom,NA,East Midlands,4811065,101,0,25597,2936
2020-08-20,United Kingdom,NA,East Midlands,4811065,100,1,25697,2937
2020-08-21,United Kingdom,NA,East Midlands,4811065,101,1,25798,2938
2020-08-22,United Kingdom,NA,East Midlands,4811065,49,1,25847,2939
2020-08-23,United Kingdom,NA,East Midlands,4811065,52,0,25899,2939
2020-08-24,United Kingdom,NA,East Midlands,4811065,83,0,25982,2939
2020-08-25,United Kingdom,NA,East Midlands,4811065,73,2,26055,2941
2020-08-26,United Kingdom,NA,East Midlands,4811065,91,0,26146,2941
2020-08-27,United Kingdom,NA,East Midlands,4811065,84,1,26230,2942
2020-08-28,United Kingdom,NA,East Midlands,4811065,96,0,26326,2942
2020-08-29,United Kingdom,NA,East Midlands,4811065,49,0,26375,2942
2020-08-30,United Kingdom,NA,East Midlands,4811065,61,1,26436,2943
2020-08-31,United Kingdom,NA,East Midlands,4811065,87,1,26523,2944
2020-09-01,United Kingdom,NA,East Midlands,4811065,152,0,26675,2944
2020-09-02,United Kingdom,NA,East Midlands,4811065,250,1,26925,2945
2020-09-03,United Kingdom,NA,East Midlands,4811065,239,0,27164,2945
2020-09-04,United Kingdom,NA,East Midlands,4811065,182,2,27346,2947
2020-09-05,United Kingdom,NA,East Midlands,4811065,171,0,27517,2947
2020-09-06,United Kingdom,NA,East Midlands,4811065,139,1,27656,2948
2020-09-07,United Kingdom,NA,East Midlands,4811065,350,1,28006,2949
2020-09-08,United Kingdom,NA,East Midlands,4811065,313,0,28319,2949
2020-09-09,United Kingdom,NA,East Midlands,4811065,262,1,28581,2950
2020-09-10,United Kingdom,NA,East Midlands,4811065,213,0,28794,2950
2020-09-11,United Kingdom,NA,East Midlands,4811065,222,0,29016,2950
2020-09-12,United Kingdom,NA,East Midlands,4811065,144,4,29160,2954
2020-09-13,United Kingdom,NA,East Midlands,4811065,122,1,29282,2955
2020-09-14,United Kingdom,NA,East Midlands,4811065,200,1,29482,2956
2020-09-15,United Kingdom,NA,East Midlands,4811065,206,0,29688,2956
2020-09-16,United Kingdom,NA,East Midlands,4811065,245,1,29933,2957
2020-09-17,United Kingdom,NA,East Midlands,4811065,243,0,30176,2957
2020-09-18,United Kingdom,NA,East Midlands,4811065,256,1,30432,2958
2020-09-19,United Kingdom,NA,East Midlands,4811065,240,2,30672,2960
2020-09-20,United Kingdom,NA,East Midlands,4811065,181,0,30853,2960
2020-09-21,United Kingdom,NA,East Midlands,4811065,242,2,31095,2962
2020-09-22,United Kingdom,NA,East Midlands,4811065,159,2,31254,2964
2020-09-23,United Kingdom,NA,East Midlands,4811065,3,0,31257,2964
2020-03-03,United Kingdom,NA,East of England,6235410,7,0,12,1
2020-03-04,United Kingdom,NA,East of England,6235410,7,0,19,1
2020-03-05,United Kingdom,NA,East of England,6235410,1,0,20,1
2020-03-06,United Kingdom,NA,East of England,6235410,5,0,25,1
2020-03-07,United Kingdom,NA,East of England,6235410,3,0,28,1
2020-03-08,United Kingdom,NA,East of England,6235410,2,0,30,1
2020-03-09,United Kingdom,NA,East of England,6235410,4,1,34,2
2020-03-10,United Kingdom,NA,East of England,6235410,16,0,50,2
2020-03-11,United Kingdom,NA,East of England,6235410,14,0,64,2
2020-03-12,United Kingdom,NA,East of England,6235410,18,0,82,2
2020-03-13,United Kingdom,NA,East of England,6235410,37,1,119,3
2020-03-14,United Kingdom,NA,East of England,6235410,16,0,135,3
2020-03-15,United Kingdom,NA,East of England,6235410,35,2,170,5
2020-03-16,United Kingdom,NA,East of England,6235410,23,2,193,7
2020-03-17,United Kingdom,NA,East of England,6235410,38,2,231,9
2020-03-18,United Kingdom,NA,East of England,6235410,74,3,305,12
2020-03-19,United Kingdom,NA,East of England,6235410,56,5,361,17
2020-03-20,United Kingdom,NA,East of England,6235410,71,2,432,19
2020-03-21,United Kingdom,NA,East of England,6235410,77,9,509,28
2020-03-22,United Kingdom,NA,East of England,6235410,91,13,600,41
2020-03-23,United Kingdom,NA,East of England,6235410,196,13,796,54
2020-03-24,United Kingdom,NA,East of England,6235410,165,21,961,75
2020-03-25,United Kingdom,NA,East of England,6235410,188,22,1149,97
2020-03-26,United Kingdom,NA,East of England,6235410,216,35,1365,132
2020-03-27,United Kingdom,NA,East of England,6235410,243,40,1608,172
2020-03-28,United Kingdom,NA,East of England,6235410,183,37,1791,209
2020-03-29,United Kingdom,NA,East of England,6235410,209,49,2000,258
2020-03-30,United Kingdom,NA,East of England,6235410,300,49,2300,307
2020-03-31,United Kingdom,NA,East of England,6235410,322,73,2622,380
2020-04-01,United Kingdom,NA,East of England,6235410,333,74,2955,454
2020-04-02,United Kingdom,NA,East of England,6235410,372,70,3327,524
2020-04-03,United Kingdom,NA,East of England,6235410,352,86,3679,610
2020-04-04,United Kingdom,NA,East of England,6235410,269,71,3948,681
2020-04-05,United Kingdom,NA,East of England,6235410,281,90,4229,771
2020-04-06,United Kingdom,NA,East of England,6235410,385,76,4614,847
2020-04-07,United Kingdom,NA,East of England,6235410,389,111,5003,958
2020-04-08,United Kingdom,NA,East of England,6235410,409,114,5412,1072
2020-04-09,United Kingdom,NA,East of England,6235410,325,96,5737,1147
2020-04-10,United Kingdom,NA,East of England,6235410,319,71,6056,1211
2020-04-11,United Kingdom,NA,East of England,6235410,270,103,6326,1265
2020-04-12,United Kingdom,NA,East of England,6235410,260,101,6586,1317
2020-04-13,United Kingdom,NA,East of England,6235410,292,82,6878,1375
2020-04-14,United Kingdom,NA,East of England,6235410,289,73,7167,1433
2020-04-15,United Kingdom,NA,East of England,6235410,296,86,7463,1492
2020-04-16,United Kingdom,NA,East of England,6235410,337,84,7800,1560
2020-04-17,United Kingdom,NA,East of England,6235410,365,87,8165,1633
2020-04-18,United Kingdom,NA,East of England,6235410,329,76,8494,1698
2020-04-19,United Kingdom,NA,East of England,6235410,316,75,8810,1762
2020-04-20,United Kingdom,NA,East of England,6235410,362,72,9172,1834
2020-04-21,United Kingdom,NA,East of England,6235410,406,79,9578,1915
2020-04-22,United Kingdom,NA,East of England,6235410,522,77,10100,2020
2020-04-23,United Kingdom,NA,East of England,6235410,475,60,10575,2115
2020-04-24,United Kingdom,NA,East of England,6235410,422,85,10997,2199
2020-04-25,United Kingdom,NA,East of England,6235410,377,59,11374,2274
2020-04-26,United Kingdom,NA,East of England,6235410,357,64,11731,2346
2020-04-27,United Kingdom,NA,East of England,6235410,511,58,12242,2448
2020-04-28,United Kingdom,NA,East of England,6235410,464,67,12706,2541
2020-04-29,United Kingdom,NA,East of England,6235410,474,46,13180,2636
2020-04-30,United Kingdom,NA,East of England,6235410,424,67,13604,2720
2020-05-01,United Kingdom,NA,East of England,6235410,494,72,14098,2812
2020-05-02,United Kingdom,NA,East of England,6235410,302,38,14400,2850
2020-05-03,United Kingdom,NA,East of England,6235410,317,54,14717,2904
2020-05-04,United Kingdom,NA,East of England,6235410,391,36,15108,2940
2020-05-05,United Kingdom,NA,East of England,6235410,332,48,15440,2988
2020-05-06,United Kingdom,NA,East of England,6235410,388,51,15828,3039
2020-05-07,United Kingdom,NA,East of England,6235410,396,49,16224,3088
2020-05-08,United Kingdom,NA,East of England,6235410,229,36,16453,3124
2020-05-09,United Kingdom,NA,East of England,6235410,203,40,16656,3164
2020-05-10,United Kingdom,NA,East of England,6235410,208,34,16864,3198
2020-05-11,United Kingdom,NA,East of England,6235410,390,25,17254,3223
2020-05-12,United Kingdom,NA,East of England,6235410,315,35,17569,3258
2020-05-13,United Kingdom,NA,East of England,6235410,329,35,17898,3293
2020-05-14,United Kingdom,NA,East of England,6235410,217,33,18115,3326
2020-05-15,United Kingdom,NA,East of England,6235410,210,30,18325,3356
2020-05-16,United Kingdom,NA,East of England,6235410,174,35,18499,3391
2020-05-17,United Kingdom,NA,East of England,6235410,153,34,18652,3425
2020-05-18,United Kingdom,NA,East of England,6235410,283,39,18935,3464
2020-05-19,United Kingdom,NA,East of England,6235410,254,22,19189,3486
2020-05-20,United Kingdom,NA,East of England,6235410,243,41,19432,3527
2020-05-21,United Kingdom,NA,East of England,6235410,245,24,19677,3551
2020-05-22,United Kingdom,NA,East of England,6235410,190,24,19867,3575
2020-05-23,United Kingdom,NA,East of England,6235410,149,26,20016,3601
2020-05-24,United Kingdom,NA,East of England,6235410,102,25,20118,3626
2020-05-25,United Kingdom,NA,East of England,6235410,147,27,20265,3653
2020-05-26,United Kingdom,NA,East of England,6235410,150,22,20415,3675
2020-05-27,United Kingdom,NA,East of England,6235410,149,19,20564,3694
2020-05-28,United Kingdom,NA,East of England,6235410,163,25,20727,3719
2020-05-29,United Kingdom,NA,East of England,6235410,160,27,20887,3746
2020-05-30,United Kingdom,NA,East of England,6235410,83,17,20970,3763
2020-05-31,United Kingdom,NA,East of England,6235410,61,10,21031,3773
2020-06-01,United Kingdom,NA,East of England,6235410,137,15,21168,3788
2020-06-02,United Kingdom,NA,East of England,6235410,131,21,21299,3809
2020-06-03,United Kingdom,NA,East of England,6235410,123,14,21422,3823
2020-06-04,United Kingdom,NA,East of England,6235410,93,15,21515,3838
2020-06-05,United Kingdom,NA,East of England,6235410,109,16,21624,3854
2020-06-06,United Kingdom,NA,East of England,6235410,93,9,21717,3863
2020-06-07,United Kingdom,NA,East of England,6235410,46,11,21763,3874
2020-06-08,United Kingdom,NA,East of England,6235410,95,11,21858,3885
2020-06-09,United Kingdom,NA,East of England,6235410,130,8,21988,3893
2020-06-10,United Kingdom,NA,East of England,6235410,118,14,22106,3907
2020-06-11,United Kingdom,NA,East of England,6235410,71,4,22177,3911
2020-06-12,United Kingdom,NA,East of England,6235410,66,8,22243,3919
2020-06-13,United Kingdom,NA,East of England,6235410,89,6,22332,3925
2020-06-14,United Kingdom,NA,East of England,6235410,73,7,22405,3932
2020-06-15,United Kingdom,NA,East of England,6235410,112,7,22517,3939
2020-06-16,United Kingdom,NA,East of England,6235410,107,4,22624,3943
2020-06-17,United Kingdom,NA,East of England,6235410,77,8,22701,3951
2020-06-18,United Kingdom,NA,East of England,6235410,82,5,22783,3956
2020-06-19,United Kingdom,NA,East of England,6235410,74,8,22857,3964
2020-06-20,United Kingdom,NA,East of England,6235410,31,8,22888,3972
2020-06-21,United Kingdom,NA,East of England,6235410,57,6,22945,3978
2020-06-22,United Kingdom,NA,East of England,6235410,74,11,23019,3989
2020-06-23,United Kingdom,NA,East of England,6235410,44,4,23063,3993
2020-06-24,United Kingdom,NA,East of England,6235410,61,8,23124,4001
2020-06-25,United Kingdom,NA,East of England,6235410,38,2,23162,4003
2020-06-26,United Kingdom,NA,East of England,6235410,59,5,23221,4008
2020-06-27,United Kingdom,NA,East of England,6235410,20,7,23241,4015
2020-06-28,United Kingdom,NA,East of England,6235410,25,7,23266,4022
2020-06-29,United Kingdom,NA,East of England,6235410,50,5,23316,4027
2020-06-30,United Kingdom,NA,East of England,6235410,34,5,23350,4032
2020-07-01,United Kingdom,NA,East of England,6235410,39,4,23389,4036
2020-07-02,United Kingdom,NA,East of England,6235410,62,8,23451,4044
2020-07-03,United Kingdom,NA,East of England,6235410,60,2,23511,4046
2020-07-04,United Kingdom,NA,East of England,6235410,43,7,23554,4053
2020-07-05,United Kingdom,NA,East of England,6235410,36,5,23590,4058
2020-07-06,United Kingdom,NA,East of England,6235410,56,3,23646,4061
2020-07-07,United Kingdom,NA,East of England,6235410,39,5,23685,4066
2020-07-08,United Kingdom,NA,East of England,6235410,77,2,23762,4068
2020-07-09,United Kingdom,NA,East of England,6235410,55,6,23817,4074
2020-07-10,United Kingdom,NA,East of England,6235410,50,5,23867,4079
2020-07-11,United Kingdom,NA,East of England,6235410,42,3,23909,4082
2020-07-12,United Kingdom,NA,East of England,6235410,34,1,23943,4083
2020-07-13,United Kingdom,NA,East of England,6235410,64,7,24007,4090
2020-07-14,United Kingdom,NA,East of England,6235410,81,2,24088,4092
2020-07-15,United Kingdom,NA,East of England,6235410,55,1,24143,4093
2020-07-16,United Kingdom,NA,East of England,6235410,62,1,24205,4094
2020-07-17,United Kingdom,NA,East of England,6235410,51,2,24256,4096
2020-07-18,United Kingdom,NA,East of England,6235410,28,2,24284,4098
2020-07-19,United Kingdom,NA,East of England,6235410,21,2,24305,4100
2020-07-20,United Kingdom,NA,East of England,6235410,81,3,24386,4103
2020-07-21,United Kingdom,NA,East of England,6235410,66,1,24452,4104
2020-07-22,United Kingdom,NA,East of England,6235410,54,3,24506,4107
2020-07-23,United Kingdom,NA,East of England,6235410,51,1,24557,4108
2020-07-24,United Kingdom,NA,East of England,6235410,79,1,24636,4109
2020-07-25,United Kingdom,NA,East of England,6235410,28,1,24664,4110
2020-07-26,United Kingdom,NA,East of England,6235410,26,1,24690,4111
2020-07-27,United Kingdom,NA,East of England,6235410,65,2,24755,4113
2020-07-28,United Kingdom,NA,East of England,6235410,56,1,24811,4114
2020-07-29,United Kingdom,NA,East of England,6235410,66,0,24877,4114
2020-07-30,United Kingdom,NA,East of England,6235410,52,1,24929,4115
2020-07-31,United Kingdom,NA,East of England,6235410,31,1,24960,4116
2020-08-01,United Kingdom,NA,East of England,6235410,22,1,24982,4117
2020-08-02,United Kingdom,NA,East of England,6235410,36,0,25018,4117
2020-08-03,United Kingdom,NA,East of England,6235410,68,0,25086,4117
2020-08-04,United Kingdom,NA,East of England,6235410,56,2,25142,4119
2020-08-05,United Kingdom,NA,East of England,6235410,53,0,25195,4119
2020-08-06,United Kingdom,NA,East of England,6235410,44,0,25239,4119
2020-08-07,United Kingdom,NA,East of England,6235410,70,1,25309,4120
2020-08-08,United Kingdom,NA,East of England,6235410,44,0,25353,4120
2020-08-09,United Kingdom,NA,East of England,6235410,23,1,25376,4121
2020-08-10,United Kingdom,NA,East of England,6235410,67,0,25443,4121
2020-08-11,United Kingdom,NA,East of England,6235410,47,2,25490,4123
2020-08-12,United Kingdom,NA,East of England,6235410,66,1,25556,4124
2020-08-13,United Kingdom,NA,East of England,6235410,61,0,25617,4124
2020-08-14,United Kingdom,NA,East of England,6235410,68,1,25685,4125
2020-08-15,United Kingdom,NA,East of England,6235410,31,0,25716,4125
2020-08-16,United Kingdom,NA,East of England,6235410,27,0,25743,4125
2020-08-17,United Kingdom,NA,East of England,6235410,63,1,25806,4126
2020-08-18,United Kingdom,NA,East of England,6235410,59,2,25865,4128
2020-08-19,United Kingdom,NA,East of England,6235410,63,0,25928,4128
2020-08-20,United Kingdom,NA,East of England,6235410,82,2,26010,4130
2020-08-21,United Kingdom,NA,East of England,6235410,63,0,26073,4130
2020-08-22,United Kingdom,NA,East of England,6235410,50,0,26123,4130
2020-08-23,United Kingdom,NA,East of England,6235410,52,1,26175,4131
2020-08-24,United Kingdom,NA,East of England,6235410,102,1,26277,4132
2020-08-25,United Kingdom,NA,East of England,6235410,101,0,26378,4132
2020-08-26,United Kingdom,NA,East of England,6235410,93,1,26471,4133
2020-08-27,United Kingdom,NA,East of England,6235410,122,1,26593,4134
2020-08-28,United Kingdom,NA,East of England,6235410,101,0,26694,4134
2020-08-29,United Kingdom,NA,East of England,6235410,79,0,26773,4134
2020-08-30,United Kingdom,NA,East of England,6235410,88,0,26861,4134
2020-08-31,United Kingdom,NA,East of England,6235410,101,0,26962,4134
2020-09-01,United Kingdom,NA,East of England,6235410,122,0,27084,4134
2020-09-02,United Kingdom,NA,East of England,6235410,170,1,27254,4135
2020-09-03,United Kingdom,NA,East of England,6235410,149,1,27403,4136
2020-09-04,United Kingdom,NA,East of England,6235410,122,0,27525,4136
2020-09-05,United Kingdom,NA,East of England,6235410,95,0,27620,4136
2020-09-06,United Kingdom,NA,East of England,6235410,80,1,27700,4137
2020-09-07,United Kingdom,NA,East of England,6235410,158,0,27858,4137
2020-09-08,United Kingdom,NA,East of England,6235410,166,0,28024,4137
2020-09-09,United Kingdom,NA,East of England,6235410,125,0,28149,4137
2020-09-10,United Kingdom,NA,East of England,6235410,165,0,28314,4137
2020-09-11,United Kingdom,NA,East of England,6235410,128,0,28442,4137
2020-09-12,United Kingdom,NA,East of England,6235410,83,0,28525,4137
2020-09-13,United Kingdom,NA,East of England,6235410,60,1,28585,4138
2020-09-14,United Kingdom,NA,East of England,6235410,136,1,28721,4139
2020-09-15,United Kingdom,NA,East of England,6235410,144,0,28865,4139
2020-09-16,United Kingdom,NA,East of England,6235410,142,1,29007,4140
2020-09-17,United Kingdom,NA,East of England,6235410,146,1,29153,4141
2020-09-18,United Kingdom,NA,East of England,6235410,203,0,29356,4141
2020-09-19,United Kingdom,NA,East of England,6235410,132,0,29488,4141
2020-09-20,United Kingdom,NA,East of England,6235410,157,2,29645,4143
2020-09-21,United Kingdom,NA,East of England,6235410,143,0,29788,4143
2020-09-22,United Kingdom,NA,East of England,6235410,133,3,29921,4146
2020-09-23,United Kingdom,NA,East of England,6235410,2,0,29923,4146
2020-02-23,United Kingdom,NA,England,53012456,1,0,11,0
2020-02-24,United Kingdom,NA,England,53012456,2,0,13,0
2020-02-25,United Kingdom,NA,England,53012456,5,0,18,0
2020-02-26,United Kingdom,NA,England,53012456,4,0,22,0
2020-02-27,United Kingdom,NA,England,53012456,7,0,29,0
2020-02-28,United Kingdom,NA,England,53012456,11,0,40,0
2020-02-29,United Kingdom,NA,England,53012456,5,0,45,0
2020-03-01,United Kingdom,NA,England,53012456,20,0,65,0
2020-03-02,United Kingdom,NA,England,53012456,39,1,104,1
2020-03-03,United Kingdom,NA,England,53012456,52,2,156,3
2020-03-04,United Kingdom,NA,England,53012456,49,0,205,3
2020-03-05,United Kingdom,NA,England,53012456,47,3,252,6
2020-03-06,United Kingdom,NA,England,53012456,73,0,325,6
2020-03-07,United Kingdom,NA,England,53012456,53,0,378,6
2020-03-08,United Kingdom,NA,England,53012456,50,3,428,9
2020-03-09,United Kingdom,NA,England,53012456,124,5,552,14
2020-03-10,United Kingdom,NA,England,53012456,223,3,775,17
2020-03-11,United Kingdom,NA,England,53012456,353,8,1128,25
2020-03-12,United Kingdom,NA,England,53012456,415,12,1543,37
2020-03-13,United Kingdom,NA,England,53012456,392,16,1935,53
2020-03-14,United Kingdom,NA,England,53012456,314,20,2249,73
2020-03-15,United Kingdom,NA,England,53012456,398,32,2647,105
2020-03-16,United Kingdom,NA,England,53012456,547,42,3194,147
2020-03-17,United Kingdom,NA,England,53012456,680,50,3874,197
2020-03-18,United Kingdom,NA,England,53012456,909,67,4783,264
2020-03-19,United Kingdom,NA,England,53012456,930,67,5713,331
2020-03-20,United Kingdom,NA,England,53012456,1083,102,6796,433
2020-03-21,United Kingdom,NA,England,53012456,1035,117,7831,550
2020-03-22,United Kingdom,NA,England,53012456,1209,155,9040,705
2020-03-23,United Kingdom,NA,England,53012456,2018,173,11058,878
2020-03-24,United Kingdom,NA,England,53012456,2024,219,13082,1097
2020-03-25,United Kingdom,NA,England,53012456,2266,278,15348,1375
2020-03-26,United Kingdom,NA,England,53012456,2617,335,17965,1710
2020-03-27,United Kingdom,NA,England,53012456,2658,374,20623,2084
2020-03-28,United Kingdom,NA,England,53012456,2376,385,22999,2469
2020-03-29,United Kingdom,NA,England,53012456,2441,466,25440,2935
2020-03-30,United Kingdom,NA,England,53012456,3523,537,28963,3472
2020-03-31,United Kingdom,NA,England,53012456,3787,603,32750,4075
2020-04-01,United Kingdom,NA,England,53012456,4099,697,36849,4772
2020-04-02,United Kingdom,NA,England,53012456,4068,732,40917,5504
2020-04-03,United Kingdom,NA,England,53012456,4109,744,45026,6248
2020-04-04,United Kingdom,NA,England,53012456,3381,837,48407,7085
2020-04-05,United Kingdom,NA,England,53012456,3081,830,51488,7915
2020-04-06,United Kingdom,NA,England,53012456,4390,805,55878,8720
2020-04-07,United Kingdom,NA,England,53012456,4579,910,60457,9630
2020-04-08,United Kingdom,NA,England,53012456,4298,975,64755,10605
2020-04-09,United Kingdom,NA,England,53012456,4065,874,68820,11479
2020-04-10,United Kingdom,NA,England,53012456,3583,850,72403,12329
2020-04-11,United Kingdom,NA,England,53012456,3078,861,75481,13190
2020-04-12,United Kingdom,NA,England,53012456,2945,857,78426,14047
2020-04-13,United Kingdom,NA,England,53012456,3439,802,81865,14849
2020-04-14,United Kingdom,NA,England,53012456,3563,770,85428,15619
2020-04-15,United Kingdom,NA,England,53012456,4234,783,89662,16402
2020-04-16,United Kingdom,NA,England,53012456,4364,751,94026,17153
2020-04-17,United Kingdom,NA,England,53012456,4081,744,98107,17897
2020-04-18,United Kingdom,NA,England,53012456,4124,706,102231,18603
2020-04-19,United Kingdom,NA,England,53012456,3476,681,105707,19284
2020-04-20,United Kingdom,NA,England,53012456,3690,683,109397,19967
2020-04-21,United Kingdom,NA,England,53012456,3971,648,113368,20615
2020-04-22,United Kingdom,NA,England,53012456,4794,642,118162,21257
2020-04-23,United Kingdom,NA,England,53012456,4562,592,122724,21849
2020-04-24,United Kingdom,NA,England,53012456,4361,601,127085,22450
2020-04-25,United Kingdom,NA,England,53012456,3377,555,130462,23005
2020-04-26,United Kingdom,NA,England,53012456,3134,558,133596,23563
2020-04-27,United Kingdom,NA,England,53012456,4036,506,137632,24069
2020-04-28,United Kingdom,NA,England,53012456,4120,498,141752,24567
2020-04-29,United Kingdom,NA,England,53012456,4744,494,146496,25061
2020-04-30,United Kingdom,NA,England,53012456,4311,480,150807,25541
2020-05-01,United Kingdom,NA,England,53012456,4094,477,154901,26018
2020-05-02,United Kingdom,NA,England,53012456,2745,423,157646,26441
2020-05-03,United Kingdom,NA,England,53012456,2627,388,160273,26829
2020-05-04,United Kingdom,NA,England,53012456,2844,411,163117,27240
2020-05-05,United Kingdom,NA,England,53012456,3146,390,166263,27630
2020-05-06,United Kingdom,NA,England,53012456,3268,392,169531,28022
2020-05-07,United Kingdom,NA,England,53012456,3202,398,172733,28420
2020-05-08,United Kingdom,NA,England,53012456,2622,328,175355,28748
2020-05-09,United Kingdom,NA,England,53012456,1793,329,177148,29077
2020-05-10,United Kingdom,NA,England,53012456,2006,300,179154,29377
2020-05-11,United Kingdom,NA,England,53012456,3069,260,182223,29637
2020-05-12,United Kingdom,NA,England,53012456,2926,274,185149,29911
2020-05-13,United Kingdom,NA,England,53012456,2884,254,188033,30165
2020-05-14,United Kingdom,NA,England,53012456,2208,278,190241,30443
2020-05-15,United Kingdom,NA,England,53012456,2128,268,192369,30711
2020-05-16,United Kingdom,NA,England,53012456,1766,269,194135,30980
2020-05-17,United Kingdom,NA,England,53012456,1591,222,195726,31202
2020-05-18,United Kingdom,NA,England,53012456,2213,253,197939,31455
2020-05-19,United Kingdom,NA,England,53012456,2583,229,200522,31684
2020-05-20,United Kingdom,NA,England,53012456,2353,235,202875,31919
2020-05-21,United Kingdom,NA,England,53012456,2274,201,205149,32120
2020-05-22,United Kingdom,NA,England,53012456,1799,195,206948,32315
2020-05-23,United Kingdom,NA,England,53012456,1299,198,208247,32513
2020-05-24,United Kingdom,NA,England,53012456,1197,169,209444,32682
2020-05-25,United Kingdom,NA,England,53012456,1382,176,210826,32858
2020-05-26,United Kingdom,NA,England,53012456,1460,187,212286,33045
2020-05-27,United Kingdom,NA,England,53012456,1613,169,213899,33214
2020-05-28,United Kingdom,NA,England,53012456,1572,183,215471,33397
2020-05-29,United Kingdom,NA,England,53012456,1371,163,216842,33560
2020-05-30,United Kingdom,NA,England,53012456,997,144,217839,33704
2020-05-31,United Kingdom,NA,England,53012456,986,112,218825,33816
2020-06-01,United Kingdom,NA,England,53012456,1310,122,220135,33938
2020-06-02,United Kingdom,NA,England,53012456,1357,157,221492,34095
2020-06-03,United Kingdom,NA,England,53012456,1243,138,222735,34233
2020-06-04,United Kingdom,NA,England,53012456,1143,120,223878,34353
2020-06-05,United Kingdom,NA,England,53012456,1022,108,224900,34461
2020-06-06,United Kingdom,NA,England,53012456,723,98,225623,34559
2020-06-07,United Kingdom,NA,England,53012456,665,111,226288,34670
2020-06-08,United Kingdom,NA,England,53012456,987,111,227275,34781
2020-06-09,United Kingdom,NA,England,53012456,1057,85,228332,34866
2020-06-10,United Kingdom,NA,England,53012456,1084,97,229416,34963
2020-06-11,United Kingdom,NA,England,53012456,916,71,230332,35034
2020-06-12,United Kingdom,NA,England,53012456,937,72,231269,35106
2020-06-13,United Kingdom,NA,England,53012456,786,52,232055,35158
2020-06-14,United Kingdom,NA,England,53012456,746,76,232801,35234
2020-06-15,United Kingdom,NA,England,53012456,937,61,233738,35295
2020-06-16,United Kingdom,NA,England,53012456,993,69,234731,35364
2020-06-17,United Kingdom,NA,England,53012456,912,53,235643,35417
2020-06-18,United Kingdom,NA,England,53012456,943,57,236586,35474
2020-06-19,United Kingdom,NA,England,53012456,814,47,237400,35521
2020-06-20,United Kingdom,NA,England,53012456,628,54,238028,35575
2020-06-21,United Kingdom,NA,England,53012456,550,47,238578,35622
2020-06-22,United Kingdom,NA,England,53012456,815,58,239393,35680
2020-06-23,United Kingdom,NA,England,53012456,728,60,240121,35740
2020-06-24,United Kingdom,NA,England,53012456,730,68,240851,35808
2020-06-25,United Kingdom,NA,England,53012456,635,57,241486,35865
2020-06-26,United Kingdom,NA,England,53012456,645,38,242131,35903
2020-06-27,United Kingdom,NA,England,53012456,504,39,242635,35942
2020-06-28,United Kingdom,NA,England,53012456,411,42,243046,35984
2020-06-29,United Kingdom,NA,England,53012456,668,33,243714,36017
2020-06-30,United Kingdom,NA,England,53012456,571,43,244285,36060
2020-07-01,United Kingdom,NA,England,53012456,608,22,244893,36082
2020-07-02,United Kingdom,NA,England,53012456,563,40,245456,36122
2020-07-03,United Kingdom,NA,England,53012456,540,26,245996,36148
2020-07-04,United Kingdom,NA,England,53012456,387,31,246383,36179
2020-07-05,United Kingdom,NA,England,53012456,539,24,246922,36203
2020-07-06,United Kingdom,NA,England,53012456,655,33,247577,36236
2020-07-07,United Kingdom,NA,England,53012456,559,26,248136,36262
2020-07-08,United Kingdom,NA,England,53012456,673,23,248809,36285
2020-07-09,United Kingdom,NA,England,53012456,682,35,249491,36320
2020-07-10,United Kingdom,NA,England,53012456,520,21,250011,36341
2020-07-11,United Kingdom,NA,England,53012456,420,21,250431,36362
2020-07-12,United Kingdom,NA,England,53012456,351,12,250782,36374
2020-07-13,United Kingdom,NA,England,53012456,688,22,251470,36396
2020-07-14,United Kingdom,NA,England,53012456,651,20,252121,36416
2020-07-15,United Kingdom,NA,England,53012456,722,20,252843,36436
2020-07-16,United Kingdom,NA,England,53012456,639,12,253482,36448
2020-07-17,United Kingdom,NA,England,53012456,548,18,254030,36466
2020-07-18,United Kingdom,NA,England,53012456,467,14,254497,36480
2020-07-19,United Kingdom,NA,England,53012456,413,14,254910,36494
2020-07-20,United Kingdom,NA,England,53012456,753,12,255663,36506
2020-07-21,United Kingdom,NA,England,53012456,690,19,256353,36525
2020-07-22,United Kingdom,NA,England,53012456,748,16,257101,36541
2020-07-23,United Kingdom,NA,England,53012456,734,16,257835,36557
2020-07-24,United Kingdom,NA,England,53012456,715,6,258550,36563
2020-07-25,United Kingdom,NA,England,53012456,490,13,259040,36576
2020-07-26,United Kingdom,NA,England,53012456,514,14,259554,36590
2020-07-27,United Kingdom,NA,England,53012456,809,10,260363,36600
2020-07-28,United Kingdom,NA,England,53012456,780,10,261143,36610
2020-07-29,United Kingdom,NA,England,53012456,970,8,262113,36618
2020-07-30,United Kingdom,NA,England,53012456,855,8,262968,36626
2020-07-31,United Kingdom,NA,England,53012456,623,10,263591,36636
2020-08-01,United Kingdom,NA,England,53012456,494,9,264085,36645
2020-08-02,United Kingdom,NA,England,53012456,512,8,264597,36653
2020-08-03,United Kingdom,NA,England,53012456,939,15,265536,36668
2020-08-04,United Kingdom,NA,England,53012456,921,11,266457,36679
2020-08-05,United Kingdom,NA,England,53012456,944,3,267401,36682
2020-08-06,United Kingdom,NA,England,53012456,979,9,268380,36691
2020-08-07,United Kingdom,NA,England,53012456,865,7,269245,36698
2020-08-08,United Kingdom,NA,England,53012456,638,11,269883,36709
2020-08-09,United Kingdom,NA,England,53012456,557,8,270440,36717
2020-08-10,United Kingdom,NA,England,53012456,1352,11,271792,36728
2020-08-11,United Kingdom,NA,England,53012456,1213,10,273005,36738
2020-08-12,United Kingdom,NA,England,53012456,1092,6,274097,36744
2020-08-13,United Kingdom,NA,England,53012456,1018,7,275115,36751
2020-08-14,United Kingdom,NA,England,53012456,1044,6,276159,36757
2020-08-15,United Kingdom,NA,England,53012456,647,12,276806,36769
2020-08-16,United Kingdom,NA,England,53012456,527,4,277333,36773
2020-08-17,United Kingdom,NA,England,53012456,1138,12,278471,36785
2020-08-18,United Kingdom,NA,England,53012456,927,8,279398,36793
2020-08-19,United Kingdom,NA,England,53012456,1074,2,280472,36795
2020-08-20,United Kingdom,NA,England,53012456,1219,8,281691,36803
2020-08-21,United Kingdom,NA,England,53012456,1004,7,282695,36810
2020-08-22,United Kingdom,NA,England,53012456,715,5,283410,36815
2020-08-23,United Kingdom,NA,England,53012456,693,13,284103,36828
2020-08-24,United Kingdom,NA,England,53012456,1082,5,285185,36833
2020-08-25,United Kingdom,NA,England,53012456,1061,11,286246,36844
2020-08-26,United Kingdom,NA,England,53012456,1142,11,287388,36855
2020-08-27,United Kingdom,NA,England,53012456,1336,8,288724,36863
2020-08-28,United Kingdom,NA,England,53012456,1380,7,290104,36870
2020-08-29,United Kingdom,NA,England,53012456,1037,4,291141,36874
2020-08-30,United Kingdom,NA,England,53012456,966,7,292107,36881
2020-08-31,United Kingdom,NA,England,53012456,1255,6,293362,36887
2020-09-01,United Kingdom,NA,England,53012456,1915,2,295277,36889
2020-09-02,United Kingdom,NA,England,53012456,2614,8,297891,36897
2020-09-03,United Kingdom,NA,England,53012456,2661,6,300552,36903
2020-09-04,United Kingdom,NA,England,53012456,2583,6,303135,36909
2020-09-05,United Kingdom,NA,England,53012456,2184,11,305319,36920
2020-09-06,United Kingdom,NA,England,53012456,2053,8,307372,36928
2020-09-07,United Kingdom,NA,England,53012456,3459,13,310831,36941
2020-09-08,United Kingdom,NA,England,53012456,2997,9,313828,36950
2020-09-09,United Kingdom,NA,England,53012456,2850,9,316678,36959
2020-09-10,United Kingdom,NA,England,53012456,3098,12,319776,36971
2020-09-11,United Kingdom,NA,England,53012456,2849,10,322625,36981
2020-09-12,United Kingdom,NA,England,53012456,2202,17,324827,36998
2020-09-13,United Kingdom,NA,England,53012456,1704,13,326531,37011
2020-09-14,United Kingdom,NA,England,53012456,2881,15,329412,37026
2020-09-15,United Kingdom,NA,England,53012456,3021,16,332433,37042
2020-09-16,United Kingdom,NA,England,53012456,3712,22,336145,37064
2020-09-17,United Kingdom,NA,England,53012456,3898,21,340043,37085
2020-09-18,United Kingdom,NA,England,53012456,4147,20,344190,37105
2020-09-19,United Kingdom,NA,England,53012456,4015,19,348205,37124
2020-09-20,United Kingdom,NA,England,53012456,3505,26,351710,37150
2020-09-21,United Kingdom,NA,England,53012456,3823,18,355533,37168
2020-09-22,United Kingdom,NA,England,53012456,2968,25,358501,37193
2020-09-23,United Kingdom,NA,England,53012456,56,16,358557,37209
2020-02-28,United Kingdom,NA,Greater London,8982256,3,0,12,0
2020-02-29,United Kingdom,NA,Greater London,8982256,1,0,13,0
2020-03-01,United Kingdom,NA,Greater London,8982256,4,0,17,0
2020-03-02,United Kingdom,NA,Greater London,8982256,12,0,29,0
2020-03-03,United Kingdom,NA,Greater London,8982256,6,0,35,0
2020-03-04,United Kingdom,NA,Greater London,8982256,18,0,53,0
2020-03-05,United Kingdom,NA,Greater London,8982256,14,0,67,0
2020-03-06,United Kingdom,NA,Greater London,8982256,23,0,90,0
2020-03-07,United Kingdom,NA,Greater London,8982256,14,0,104,0
2020-03-08,United Kingdom,NA,Greater London,8982256,22,0,126,0
2020-03-09,United Kingdom,NA,Greater London,8982256,53,2,179,2
2020-03-10,United Kingdom,NA,Greater London,8982256,91,1,270,3
2020-03-11,United Kingdom,NA,Greater London,8982256,183,4,453,7
2020-03-12,United Kingdom,NA,Greater London,8982256,165,6,618,13
2020-03-13,United Kingdom,NA,Greater London,8982256,136,6,754,19
2020-03-14,United Kingdom,NA,Greater London,8982256,149,11,903,30
2020-03-15,United Kingdom,NA,Greater London,8982256,165,9,1068,39
2020-03-16,United Kingdom,NA,Greater London,8982256,234,14,1302,53
2020-03-17,United Kingdom,NA,Greater London,8982256,310,23,1612,76
2020-03-18,United Kingdom,NA,Greater London,8982256,356,25,1968,101
2020-03-19,United Kingdom,NA,Greater London,8982256,333,25,2301,126
2020-03-20,United Kingdom,NA,Greater London,8982256,426,45,2727,171
2020-03-21,United Kingdom,NA,Greater London,8982256,351,47,3078,218
2020-03-22,United Kingdom,NA,Greater London,8982256,437,53,3515,271
2020-03-23,United Kingdom,NA,Greater London,8982256,689,56,4204,327
2020-03-24,United Kingdom,NA,Greater London,8982256,636,88,4840,415
2020-03-25,United Kingdom,NA,Greater London,8982256,759,116,5599,531
2020-03-26,United Kingdom,NA,Greater London,8982256,766,121,6365,652
2020-03-27,United Kingdom,NA,Greater London,8982256,822,126,7187,778
2020-03-28,United Kingdom,NA,Greater London,8982256,577,120,7764,898
2020-03-29,United Kingdom,NA,Greater London,8982256,595,141,8359,1039
2020-03-30,United Kingdom,NA,Greater London,8982256,869,150,9228,1189
2020-03-31,United Kingdom,NA,Greater London,8982256,936,178,10164,1367
2020-04-01,United Kingdom,NA,Greater London,8982256,979,189,11143,1556
2020-04-02,United Kingdom,NA,Greater London,8982256,1070,195,12213,1751
2020-04-03,United Kingdom,NA,Greater London,8982256,983,190,13196,1941
2020-04-04,United Kingdom,NA,Greater London,8982256,765,225,13961,2166
2020-04-05,United Kingdom,NA,Greater London,8982256,634,196,14595,2362
2020-04-06,United Kingdom,NA,Greater London,8982256,859,195,15454,2557
2020-04-07,United Kingdom,NA,Greater London,8982256,952,222,16406,2779
2020-04-08,United Kingdom,NA,Greater London,8982256,875,231,17281,3010
2020-04-09,United Kingdom,NA,Greater London,8982256,799,198,18080,3208
2020-04-10,United Kingdom,NA,Greater London,8982256,614,175,18694,3383
2020-04-11,United Kingdom,NA,Greater London,8982256,518,164,19212,3547
2020-04-12,United Kingdom,NA,Greater London,8982256,500,169,19712,3716
2020-04-13,United Kingdom,NA,Greater London,8982256,602,170,20314,3886
2020-04-14,United Kingdom,NA,Greater London,8982256,605,144,20919,4030
2020-04-15,United Kingdom,NA,Greater London,8982256,660,146,21579,4176
2020-04-16,United Kingdom,NA,Greater London,8982256,578,139,22157,4315
2020-04-17,United Kingdom,NA,Greater London,8982256,578,109,22735,4424
2020-04-18,United Kingdom,NA,Greater London,8982256,401,116,23136,4540
2020-04-19,United Kingdom,NA,Greater London,8982256,396,115,23532,4655
2020-04-20,United Kingdom,NA,Greater London,8982256,436,97,23968,4752
2020-04-21,United Kingdom,NA,Greater London,8982256,468,103,24436,4855
2020-04-22,United Kingdom,NA,Greater London,8982256,396,110,24832,4965
2020-04-23,United Kingdom,NA,Greater London,8982256,523,76,25355,5041
2020-04-24,United Kingdom,NA,Greater London,8982256,378,73,25733,5114
2020-04-25,United Kingdom,NA,Greater London,8982256,333,60,26066,5174
2020-04-26,United Kingdom,NA,Greater London,8982256,309,63,26375,5237
2020-04-27,United Kingdom,NA,Greater London,8982256,418,53,26793,5290
2020-04-28,United Kingdom,NA,Greater London,8982256,311,58,27104,5348
2020-04-29,United Kingdom,NA,Greater London,8982256,431,52,27535,5400
2020-04-30,United Kingdom,NA,Greater London,8982256,424,44,27959,5444
2020-05-01,United Kingdom,NA,Greater London,8982256,356,42,28315,5486
2020-05-02,United Kingdom,NA,Greater London,8982256,249,53,28564,5539
2020-05-03,United Kingdom,NA,Greater London,8982256,168,42,28732,5581
2020-05-04,United Kingdom,NA,Greater London,8982256,245,37,28977,5618
2020-05-05,United Kingdom,NA,Greater London,8982256,221,33,29198,5651
2020-05-06,United Kingdom,NA,Greater London,8982256,267,42,29465,5693
2020-05-07,United Kingdom,NA,Greater London,8982256,271,28,29736,5721
2020-05-08,United Kingdom,NA,Greater London,8982256,206,29,29942,5750
2020-05-09,United Kingdom,NA,Greater London,8982256,127,25,30069,5775
2020-05-10,United Kingdom,NA,Greater London,8982256,124,27,30193,5802
2020-05-11,United Kingdom,NA,Greater London,8982256,159,23,30352,5825
2020-05-12,United Kingdom,NA,Greater London,8982256,194,15,30546,5840
2020-05-13,United Kingdom,NA,Greater London,8982256,204,12,30750,5852
2020-05-14,United Kingdom,NA,Greater London,8982256,157,18,30907,5870
2020-05-15,United Kingdom,NA,Greater London,8982256,131,17,31038,5887
2020-05-16,United Kingdom,NA,Greater London,8982256,73,10,31111,5897
2020-05-17,United Kingdom,NA,Greater London,8982256,79,15,31190,5912
2020-05-18,United Kingdom,NA,Greater London,8982256,111,13,31301,5925
2020-05-19,United Kingdom,NA,Greater London,8982256,132,18,31433,5943
2020-05-20,United Kingdom,NA,Greater London,8982256,144,16,31577,5959
2020-05-21,United Kingdom,NA,Greater London,8982256,158,12,31735,5971
2020-05-22,United Kingdom,NA,Greater London,8982256,85,8,31820,5979
2020-05-23,United Kingdom,NA,Greater London,8982256,65,5,31885,5984
2020-05-24,United Kingdom,NA,Greater London,8982256,50,6,31935,5990
2020-05-25,United Kingdom,NA,Greater London,8982256,58,9,31993,5999
2020-05-26,United Kingdom,NA,Greater London,8982256,66,10,32059,6009
2020-05-27,United Kingdom,NA,Greater London,8982256,84,8,32143,6017
2020-05-28,United Kingdom,NA,Greater London,8982256,74,9,32217,6026
2020-05-29,United Kingdom,NA,Greater London,8982256,57,5,32274,6031
2020-05-30,United Kingdom,NA,Greater London,8982256,39,7,32313,6038
2020-05-31,United Kingdom,NA,Greater London,8982256,38,5,32351,6043
2020-06-01,United Kingdom,NA,Greater London,8982256,49,6,32400,6049
2020-06-02,United Kingdom,NA,Greater London,8982256,49,7,32449,6056
2020-06-03,United Kingdom,NA,Greater London,8982256,79,6,32528,6062
2020-06-04,United Kingdom,NA,Greater London,8982256,57,6,32585,6068
2020-06-05,United Kingdom,NA,Greater London,8982256,47,2,32632,6070
2020-06-06,United Kingdom,NA,Greater London,8982256,46,3,32678,6073
2020-06-07,United Kingdom,NA,Greater London,8982256,45,5,32723,6078
2020-06-08,United Kingdom,NA,Greater London,8982256,56,8,32779,6086
2020-06-09,United Kingdom,NA,Greater London,8982256,71,2,32850,6088
2020-06-10,United Kingdom,NA,Greater London,8982256,53,5,32903,6093
2020-06-11,United Kingdom,NA,Greater London,8982256,47,5,32950,6098
2020-06-12,United Kingdom,NA,Greater London,8982256,54,5,33004,6103
2020-06-13,United Kingdom,NA,Greater London,8982256,39,1,33043,6104
2020-06-14,United Kingdom,NA,Greater London,8982256,31,2,33074,6106
2020-06-15,United Kingdom,NA,Greater London,8982256,41,2,33115,6108
2020-06-16,United Kingdom,NA,Greater London,8982256,47,1,33162,6109
2020-06-17,United Kingdom,NA,Greater London,8982256,43,1,33205,6110
2020-06-18,United Kingdom,NA,Greater London,8982256,46,0,33251,6110
2020-06-19,United Kingdom,NA,Greater London,8982256,37,2,33288,6112
2020-06-20,United Kingdom,NA,Greater London,8982256,28,2,33316,6114
2020-06-21,United Kingdom,NA,Greater London,8982256,27,2,33343,6116
2020-06-22,United Kingdom,NA,Greater London,8982256,51,3,33394,6119
2020-06-23,United Kingdom,NA,Greater London,8982256,49,0,33443,6119
2020-06-24,United Kingdom,NA,Greater London,8982256,46,4,33489,6123
2020-06-25,United Kingdom,NA,Greater London,8982256,57,1,33546,6124
2020-06-26,United Kingdom,NA,Greater London,8982256,48,0,33594,6124
2020-06-27,United Kingdom,NA,Greater London,8982256,32,0,33626,6124
2020-06-28,United Kingdom,NA,Greater London,8982256,22,1,33648,6125
2020-06-29,United Kingdom,NA,Greater London,8982256,58,1,33706,6126
2020-06-30,United Kingdom,NA,Greater London,8982256,52,1,33758,6127
2020-07-01,United Kingdom,NA,Greater London,8982256,42,1,33800,6128
2020-07-02,United Kingdom,NA,Greater London,8982256,40,2,33840,6130
2020-07-03,United Kingdom,NA,Greater London,8982256,38,1,33878,6131
2020-07-04,United Kingdom,NA,Greater London,8982256,32,1,33910,6132
2020-07-05,United Kingdom,NA,Greater London,8982256,51,3,33961,6135
2020-07-06,United Kingdom,NA,Greater London,8982256,53,2,34014,6137
2020-07-07,United Kingdom,NA,Greater London,8982256,60,1,34074,6138
2020-07-08,United Kingdom,NA,Greater London,8982256,57,3,34131,6141
2020-07-09,United Kingdom,NA,Greater London,8982256,54,2,34185,6143
2020-07-10,United Kingdom,NA,Greater London,8982256,40,0,34225,6143
2020-07-11,United Kingdom,NA,Greater London,8982256,19,3,34244,6146
2020-07-12,United Kingdom,NA,Greater London,8982256,37,1,34281,6147
2020-07-13,United Kingdom,NA,Greater London,8982256,85,1,34366,6148
2020-07-14,United Kingdom,NA,Greater London,8982256,62,0,34428,6148
2020-07-15,United Kingdom,NA,Greater London,8982256,76,1,34504,6149
2020-07-16,United Kingdom,NA,Greater London,8982256,70,0,34574,6149
2020-07-17,United Kingdom,NA,Greater London,8982256,48,2,34622,6151
2020-07-18,United Kingdom,NA,Greater London,8982256,48,0,34670,6151
2020-07-19,United Kingdom,NA,Greater London,8982256,41,0,34711,6151
2020-07-20,United Kingdom,NA,Greater London,8982256,97,0,34808,6151
2020-07-21,United Kingdom,NA,Greater London,8982256,82,0,34890,6151
2020-07-22,United Kingdom,NA,Greater London,8982256,81,0,34971,6151
2020-07-23,United Kingdom,NA,Greater London,8982256,70,2,35041,6153
2020-07-24,United Kingdom,NA,Greater London,8982256,83,0,35124,6153
2020-07-25,United Kingdom,NA,Greater London,8982256,54,0,35178,6153
2020-07-26,United Kingdom,NA,Greater London,8982256,65,0,35243,6153
2020-07-27,United Kingdom,NA,Greater London,8982256,100,1,35343,6154
2020-07-28,United Kingdom,NA,Greater London,8982256,98,0,35441,6154
2020-07-29,United Kingdom,NA,Greater London,8982256,98,0,35539,6154
2020-07-30,United Kingdom,NA,Greater London,8982256,101,0,35640,6154
2020-07-31,United Kingdom,NA,Greater London,8982256,73,2,35713,6156
2020-08-01,United Kingdom,NA,Greater London,8982256,58,2,35771,6158
2020-08-02,United Kingdom,NA,Greater London,8982256,75,1,35846,6159
2020-08-03,United Kingdom,NA,Greater London,8982256,86,0,35932,6159
2020-08-04,United Kingdom,NA,Greater London,8982256,104,0,36036,6159
2020-08-05,United Kingdom,NA,Greater London,8982256,114,0,36150,6159
2020-08-06,United Kingdom,NA,Greater London,8982256,104,0,36254,6159
2020-08-07,United Kingdom,NA,Greater London,8982256,121,0,36375,6159
2020-08-08,United Kingdom,NA,Greater London,8982256,56,1,36431,6160
2020-08-09,United Kingdom,NA,Greater London,8982256,67,0,36498,6160
2020-08-10,United Kingdom,NA,Greater London,8982256,142,0,36640,6160
2020-08-11,United Kingdom,NA,Greater London,8982256,149,1,36789,6161
2020-08-12,United Kingdom,NA,Greater London,8982256,157,0,36946,6161
2020-08-13,United Kingdom,NA,Greater London,8982256,124,2,37070,6163
2020-08-14,United Kingdom,NA,Greater London,8982256,127,0,37197,6163
2020-08-15,United Kingdom,NA,Greater London,8982256,105,0,37302,6163
2020-08-16,United Kingdom,NA,Greater London,8982256,87,0,37389,6163
2020-08-17,United Kingdom,NA,Greater London,8982256,189,2,37578,6165
2020-08-18,United Kingdom,NA,Greater London,8982256,182,1,37760,6166
2020-08-19,United Kingdom,NA,Greater London,8982256,152,0,37912,6166
2020-08-20,United Kingdom,NA,Greater London,8982256,202,1,38114,6167
2020-08-21,United Kingdom,NA,Greater London,8982256,167,0,38281,6167
2020-08-22,United Kingdom,NA,Greater London,8982256,118,1,38399,6168
2020-08-23,United Kingdom,NA,Greater London,8982256,143,0,38542,6168
2020-08-24,United Kingdom,NA,Greater London,8982256,197,0,38739,6168
2020-08-25,United Kingdom,NA,Greater London,8982256,169,1,38908,6169
2020-08-26,United Kingdom,NA,Greater London,8982256,164,0,39072,6169
2020-08-27,United Kingdom,NA,Greater London,8982256,229,0,39301,6169
2020-08-28,United Kingdom,NA,Greater London,8982256,221,0,39522,6169
2020-08-29,United Kingdom,NA,Greater London,8982256,137,0,39659,6169
2020-08-30,United Kingdom,NA,Greater London,8982256,128,0,39787,6169
2020-08-31,United Kingdom,NA,Greater London,8982256,214,1,40001,6170
2020-09-01,United Kingdom,NA,Greater London,8982256,308,0,40309,6170
2020-09-02,United Kingdom,NA,Greater London,8982256,333,1,40642,6171
2020-09-03,United Kingdom,NA,Greater London,8982256,347,1,40989,6172
2020-09-04,United Kingdom,NA,Greater London,8982256,355,0,41344,6172
2020-09-05,United Kingdom,NA,Greater London,8982256,272,0,41616,6172
2020-09-06,United Kingdom,NA,Greater London,8982256,204,2,41820,6174
2020-09-07,United Kingdom,NA,Greater London,8982256,450,0,42270,6174
2020-09-08,United Kingdom,NA,Greater London,8982256,331,0,42601,6174
2020-09-09,United Kingdom,NA,Greater London,8982256,335,0,42936,6174
2020-09-10,United Kingdom,NA,Greater London,8982256,392,2,43328,6176
2020-09-11,United Kingdom,NA,Greater London,8982256,322,3,43650,6179
2020-09-12,United Kingdom,NA,Greater London,8982256,230,0,43880,6179
2020-09-13,United Kingdom,NA,Greater London,8982256,115,0,43995,6179
2020-09-14,United Kingdom,NA,Greater London,8982256,296,0,44291,6179
2020-09-15,United Kingdom,NA,Greater London,8982256,267,1,44558,6180
2020-09-16,United Kingdom,NA,Greater London,8982256,299,2,44857,6182
2020-09-17,United Kingdom,NA,Greater London,8982256,316,3,45173,6185
2020-09-18,United Kingdom,NA,Greater London,8982256,370,1,45543,6186
2020-09-19,United Kingdom,NA,Greater London,8982256,345,3,45888,6189
2020-09-20,United Kingdom,NA,Greater London,8982256,365,4,46253,6193
2020-09-21,United Kingdom,NA,Greater London,8982256,347,3,46600,6196
2020-09-22,United Kingdom,NA,Greater London,8982256,300,4,46900,6200
2020-03-10,United Kingdom,NA,North East,2656980,4,0,14,0
2020-03-11,United Kingdom,NA,North East,2656980,1,0,15,0
2020-03-12,United Kingdom,NA,North East,2656980,2,0,17,0
2020-03-13,United Kingdom,NA,North East,2656980,6,0,23,0
2020-03-14,United Kingdom,NA,North East,2656980,6,0,29,0
2020-03-15,United Kingdom,NA,North East,2656980,10,1,39,1
2020-03-16,United Kingdom,NA,North East,2656980,7,0,46,1
2020-03-17,United Kingdom,NA,North East,2656980,16,0,62,1
2020-03-18,United Kingdom,NA,North East,2656980,14,1,76,2
2020-03-19,United Kingdom,NA,North East,2656980,19,1,95,3
2020-03-20,United Kingdom,NA,North East,2656980,26,3,121,6
2020-03-21,United Kingdom,NA,North East,2656980,23,3,144,9
2020-03-22,United Kingdom,NA,North East,2656980,20,6,164,15
2020-03-23,United Kingdom,NA,North East,2656980,58,4,222,19
2020-03-24,United Kingdom,NA,North East,2656980,76,1,298,20
2020-03-25,United Kingdom,NA,North East,2656980,76,5,374,25
2020-03-26,United Kingdom,NA,North East,2656980,97,6,471,31
2020-03-27,United Kingdom,NA,North East,2656980,101,11,572,42
2020-03-28,United Kingdom,NA,North East,2656980,114,8,686,50
2020-03-29,United Kingdom,NA,North East,2656980,107,10,793,60
2020-03-30,United Kingdom,NA,North East,2656980,176,34,969,94
2020-03-31,United Kingdom,NA,North East,2656980,210,25,1179,119
2020-04-01,United Kingdom,NA,North East,2656980,308,33,1487,152
2020-04-02,United Kingdom,NA,North East,2656980,219,32,1706,184
2020-04-03,United Kingdom,NA,North East,2656980,261,43,1967,227
2020-04-04,United Kingdom,NA,North East,2656980,254,46,2221,273
2020-04-05,United Kingdom,NA,North East,2656980,221,45,2442,318
2020-04-06,United Kingdom,NA,North East,2656980,375,43,2817,361
2020-04-07,United Kingdom,NA,North East,2656980,351,41,3168,402
2020-04-08,United Kingdom,NA,North East,2656980,291,45,3459,447
2020-04-09,United Kingdom,NA,North East,2656980,314,47,3773,494
2020-04-10,United Kingdom,NA,North East,2656980,245,56,4018,550
2020-04-11,United Kingdom,NA,North East,2656980,267,49,4285,599
2020-04-12,United Kingdom,NA,North East,2656980,201,46,4486,645
2020-04-13,United Kingdom,NA,North East,2656980,232,37,4718,682
2020-04-14,United Kingdom,NA,North East,2656980,256,52,4974,734
2020-04-15,United Kingdom,NA,North East,2656980,284,32,5258,766
2020-04-16,United Kingdom,NA,North East,2656980,295,25,5553,791
2020-04-17,United Kingdom,NA,North East,2656980,293,37,5846,828
2020-04-18,United Kingdom,NA,North East,2656980,379,50,6225,878
2020-04-19,United Kingdom,NA,North East,2656980,276,45,6501,923
2020-04-20,United Kingdom,NA,North East,2656980,315,43,6816,966
2020-04-21,United Kingdom,NA,North East,2656980,288,37,7104,1003
2020-04-22,United Kingdom,NA,North East,2656980,361,38,7465,1041
2020-04-23,United Kingdom,NA,North East,2656980,333,34,7798,1075
2020-04-24,United Kingdom,NA,North East,2656980,332,29,8130,1104
2020-04-25,United Kingdom,NA,North East,2656980,215,49,8345,1153
2020-04-26,United Kingdom,NA,North East,2656980,159,34,8504,1187
2020-04-27,United Kingdom,NA,North East,2656980,282,32,8786,1219
2020-04-28,United Kingdom,NA,North East,2656980,361,42,9147,1261
2020-04-29,United Kingdom,NA,North East,2656980,359,29,9506,1290
2020-04-30,United Kingdom,NA,North East,2656980,384,32,9890,1322
2020-05-01,United Kingdom,NA,North East,2656980,273,39,10163,1361
2020-05-02,United Kingdom,NA,North East,2656980,183,40,10346,1401
2020-05-03,United Kingdom,NA,North East,2656980,162,29,10508,1430
2020-05-04,United Kingdom,NA,North East,2656980,234,28,10742,1458
2020-05-05,United Kingdom,NA,North East,2656980,252,27,10994,1485
2020-05-06,United Kingdom,NA,North East,2656980,243,25,11237,1510
2020-05-07,United Kingdom,NA,North East,2656980,199,33,11436,1543
2020-05-08,United Kingdom,NA,North East,2656980,159,26,11595,1569
2020-05-09,United Kingdom,NA,North East,2656980,151,25,11746,1594
2020-05-10,United Kingdom,NA,North East,2656980,150,18,11896,1612
2020-05-11,United Kingdom,NA,North East,2656980,229,25,12125,1637
2020-05-12,United Kingdom,NA,North East,2656980,220,18,12345,1655
2020-05-13,United Kingdom,NA,North East,2656980,143,29,12488,1684
2020-05-14,United Kingdom,NA,North East,2656980,139,22,12627,1706
2020-05-15,United Kingdom,NA,North East,2656980,137,21,12764,1727
2020-05-16,United Kingdom,NA,North East,2656980,126,32,12890,1759
2020-05-17,United Kingdom,NA,North East,2656980,98,27,12988,1786
2020-05-18,United Kingdom,NA,North East,2656980,147,31,13135,1817
2020-05-19,United Kingdom,NA,North East,2656980,123,20,13258,1837
2020-05-20,United Kingdom,NA,North East,2656980,131,15,13389,1852
2020-05-21,United Kingdom,NA,North East,2656980,130,20,13519,1872
2020-05-22,United Kingdom,NA,North East,2656980,95,13,13614,1885
2020-05-23,United Kingdom,NA,North East,2656980,75,14,13689,1899
2020-05-24,United Kingdom,NA,North East,2656980,77,14,13766,1913
2020-05-25,United Kingdom,NA,North East,2656980,60,7,13826,1920
2020-05-26,United Kingdom,NA,North East,2656980,100,15,13926,1935
2020-05-27,United Kingdom,NA,North East,2656980,115,10,14041,1945
2020-05-28,United Kingdom,NA,North East,2656980,49,14,14090,1959
2020-05-29,United Kingdom,NA,North East,2656980,70,21,14160,1980
2020-05-30,United Kingdom,NA,North East,2656980,47,8,14207,1988
2020-05-31,United Kingdom,NA,North East,2656980,46,8,14253,1996
2020-06-01,United Kingdom,NA,North East,2656980,70,3,14323,1999
2020-06-02,United Kingdom,NA,North East,2656980,59,14,14382,2013
2020-06-03,United Kingdom,NA,North East,2656980,51,8,14433,2021
2020-06-04,United Kingdom,NA,North East,2656980,60,9,14493,2030
2020-06-05,United Kingdom,NA,North East,2656980,42,11,14535,2041
2020-06-06,United Kingdom,NA,North East,2656980,28,2,14563,2043
2020-06-07,United Kingdom,NA,North East,2656980,17,9,14580,2052
2020-06-08,United Kingdom,NA,North East,2656980,33,7,14613,2059
2020-06-09,United Kingdom,NA,North East,2656980,41,3,14654,2062
2020-06-10,United Kingdom,NA,North East,2656980,37,6,14691,2068
2020-06-11,United Kingdom,NA,North East,2656980,23,3,14714,2071
2020-06-12,United Kingdom,NA,North East,2656980,40,4,14754,2075
2020-06-13,United Kingdom,NA,North East,2656980,31,1,14785,2076
2020-06-14,United Kingdom,NA,North East,2656980,31,3,14816,2079
2020-06-15,United Kingdom,NA,North East,2656980,32,0,14848,2079
2020-06-16,United Kingdom,NA,North East,2656980,18,7,14866,2086
2020-06-17,United Kingdom,NA,North East,2656980,19,0,14885,2086
2020-06-18,United Kingdom,NA,North East,2656980,23,4,14908,2090
2020-06-19,United Kingdom,NA,North East,2656980,14,0,14922,2090
2020-06-20,United Kingdom,NA,North East,2656980,17,2,14939,2092
2020-06-21,United Kingdom,NA,North East,2656980,4,5,14943,2097
2020-06-22,United Kingdom,NA,North East,2656980,24,4,14967,2101
2020-06-23,United Kingdom,NA,North East,2656980,26,3,14993,2104
2020-06-24,United Kingdom,NA,North East,2656980,11,2,15004,2106
2020-06-25,United Kingdom,NA,North East,2656980,12,3,15016,2109
2020-06-26,United Kingdom,NA,North East,2656980,8,1,15024,2110
2020-06-27,United Kingdom,NA,North East,2656980,14,2,15038,2112
2020-06-28,United Kingdom,NA,North East,2656980,9,2,15047,2114
2020-06-29,United Kingdom,NA,North East,2656980,11,0,15058,2114
2020-06-30,United Kingdom,NA,North East,2656980,11,0,15069,2114
2020-07-01,United Kingdom,NA,North East,2656980,7,0,15076,2114
2020-07-02,United Kingdom,NA,North East,2656980,9,1,15085,2115
2020-07-03,United Kingdom,NA,North East,2656980,8,0,15093,2115
2020-07-04,United Kingdom,NA,North East,2656980,9,1,15102,2116
2020-07-05,United Kingdom,NA,North East,2656980,4,0,15106,2116
2020-07-06,United Kingdom,NA,North East,2656980,11,0,15117,2116
2020-07-07,United Kingdom,NA,North East,2656980,12,0,15129,2116
2020-07-08,United Kingdom,NA,North East,2656980,12,0,15141,2116
2020-07-09,United Kingdom,NA,North East,2656980,17,0,15158,2116
2020-07-10,United Kingdom,NA,North East,2656980,10,0,15168,2116
2020-07-11,United Kingdom,NA,North East,2656980,7,0,15175,2116
2020-07-12,United Kingdom,NA,North East,2656980,3,0,15178,2116
2020-07-13,United Kingdom,NA,North East,2656980,8,0,15186,2116
2020-07-14,United Kingdom,NA,North East,2656980,12,0,15198,2116
2020-07-15,United Kingdom,NA,North East,2656980,16,0,15214,2116
2020-07-16,United Kingdom,NA,North East,2656980,15,0,15229,2116
2020-07-17,United Kingdom,NA,North East,2656980,10,1,15239,2117
2020-07-18,United Kingdom,NA,North East,2656980,4,0,15243,2117
2020-07-19,United Kingdom,NA,North East,2656980,7,1,15250,2118
2020-07-20,United Kingdom,NA,North East,2656980,11,0,15261,2118
2020-07-21,United Kingdom,NA,North East,2656980,14,0,15275,2118
2020-07-22,United Kingdom,NA,North East,2656980,16,0,15291,2118
2020-07-23,United Kingdom,NA,North East,2656980,8,0,15299,2118
2020-07-24,United Kingdom,NA,North East,2656980,7,0,15306,2118
2020-07-25,United Kingdom,NA,North East,2656980,5,0,15311,2118
2020-07-26,United Kingdom,NA,North East,2656980,7,0,15318,2118
2020-07-27,United Kingdom,NA,North East,2656980,9,0,15327,2118
2020-07-28,United Kingdom,NA,North East,2656980,5,0,15332,2118
2020-07-29,United Kingdom,NA,North East,2656980,21,0,15353,2118
2020-07-30,United Kingdom,NA,North East,2656980,15,0,15368,2118
2020-07-31,United Kingdom,NA,North East,2656980,12,0,15380,2118
2020-08-01,United Kingdom,NA,North East,2656980,9,0,15389,2118
2020-08-02,United Kingdom,NA,North East,2656980,16,0,15405,2118
2020-08-03,United Kingdom,NA,North East,2656980,19,0,15424,2118
2020-08-04,United Kingdom,NA,North East,2656980,20,0,15444,2118
2020-08-05,United Kingdom,NA,North East,2656980,31,0,15475,2118
2020-08-06,United Kingdom,NA,North East,2656980,24,0,15499,2118
2020-08-07,United Kingdom,NA,North East,2656980,15,0,15514,2118
2020-08-08,United Kingdom,NA,North East,2656980,12,0,15526,2118
2020-08-09,United Kingdom,NA,North East,2656980,15,0,15541,2118
2020-08-10,United Kingdom,NA,North East,2656980,21,0,15562,2118
2020-08-11,United Kingdom,NA,North East,2656980,45,1,15607,2119
2020-08-12,United Kingdom,NA,North East,2656980,39,0,15646,2119
2020-08-13,United Kingdom,NA,North East,2656980,53,0,15699,2119
2020-08-14,United Kingdom,NA,North East,2656980,31,0,15730,2119
2020-08-15,United Kingdom,NA,North East,2656980,18,1,15748,2120
2020-08-16,United Kingdom,NA,North East,2656980,11,0,15759,2120
2020-08-17,United Kingdom,NA,North East,2656980,32,1,15791,2121
2020-08-18,United Kingdom,NA,North East,2656980,36,1,15827,2122
2020-08-19,United Kingdom,NA,North East,2656980,46,0,15873,2122
2020-08-20,United Kingdom,NA,North East,2656980,44,0,15917,2122
2020-08-21,United Kingdom,NA,North East,2656980,42,0,15959,2122
2020-08-22,United Kingdom,NA,North East,2656980,33,0,15992,2122
2020-08-23,United Kingdom,NA,North East,2656980,23,0,16015,2122
2020-08-24,United Kingdom,NA,North East,2656980,39,0,16054,2122
2020-08-25,United Kingdom,NA,North East,2656980,49,0,16103,2122
2020-08-26,United Kingdom,NA,North East,2656980,69,0,16172,2122
2020-08-27,United Kingdom,NA,North East,2656980,66,0,16238,2122
2020-08-28,United Kingdom,NA,North East,2656980,66,0,16304,2122
2020-08-29,United Kingdom,NA,North East,2656980,78,1,16382,2123
2020-08-30,United Kingdom,NA,North East,2656980,59,0,16441,2123
2020-08-31,United Kingdom,NA,North East,2656980,91,0,16532,2123
2020-09-01,United Kingdom,NA,North East,2656980,117,0,16649,2123
2020-09-02,United Kingdom,NA,North East,2656980,132,0,16781,2123
2020-09-03,United Kingdom,NA,North East,2656980,201,0,16982,2123
2020-09-04,United Kingdom,NA,North East,2656980,173,0,17155,2123
2020-09-05,United Kingdom,NA,North East,2656980,231,1,17386,2124
2020-09-06,United Kingdom,NA,North East,2656980,173,1,17559,2125
2020-09-07,United Kingdom,NA,North East,2656980,202,1,17761,2126
2020-09-08,United Kingdom,NA,North East,2656980,224,0,17985,2126
2020-09-09,United Kingdom,NA,North East,2656980,236,0,18221,2126
2020-09-10,United Kingdom,NA,North East,2656980,237,0,18458,2126
2020-09-11,United Kingdom,NA,North East,2656980,195,1,18653,2127
2020-09-12,United Kingdom,NA,North East,2656980,152,0,18805,2127
2020-09-13,United Kingdom,NA,North East,2656980,145,1,18950,2128
2020-09-14,United Kingdom,NA,North East,2656980,196,1,19146,2129
2020-09-15,United Kingdom,NA,North East,2656980,262,1,19408,2130
2020-09-16,United Kingdom,NA,North East,2656980,319,2,19727,2132
2020-09-17,United Kingdom,NA,North East,2656980,369,4,20096,2136
2020-09-18,United Kingdom,NA,North East,2656980,458,3,20554,2139
2020-09-19,United Kingdom,NA,North East,2656980,414,1,20968,2140
2020-09-20,United Kingdom,NA,North East,2656980,527,3,21495,2143
2020-09-21,United Kingdom,NA,North East,2656980,564,4,22059,2147
2020-09-22,United Kingdom,NA,North East,2656980,413,1,22472,2148
2020-09-23,United Kingdom,NA,North East,2656980,11,2,22483,2150
2020-03-02,United Kingdom,NA,North West,7300075,6,0,14,0
2020-03-03,United Kingdom,NA,North West,7300075,7,0,21,0
2020-03-04,United Kingdom,NA,North West,7300075,2,0,23,0
2020-03-05,United Kingdom,NA,North West,7300075,10,0,33,0
2020-03-06,United Kingdom,NA,North West,7300075,2,0,35,0
2020-03-07,United Kingdom,NA,North West,7300075,7,0,42,0
2020-03-08,United Kingdom,NA,North West,7300075,5,1,47,1
2020-03-09,United Kingdom,NA,North West,7300075,7,0,54,1
2020-03-10,United Kingdom,NA,North West,7300075,15,0,69,1
2020-03-11,United Kingdom,NA,North West,7300075,17,1,86,2
2020-03-12,United Kingdom,NA,North West,7300075,40,0,126,2
2020-03-13,United Kingdom,NA,North West,7300075,41,3,167,5
2020-03-14,United Kingdom,NA,North West,7300075,25,1,192,6
2020-03-15,United Kingdom,NA,North West,7300075,24,4,216,10
2020-03-16,United Kingdom,NA,North West,7300075,56,2,272,12
2020-03-17,United Kingdom,NA,North West,7300075,55,4,327,16
2020-03-18,United Kingdom,NA,North West,7300075,84,7,411,23
2020-03-19,United Kingdom,NA,North West,7300075,98,10,509,33
2020-03-20,United Kingdom,NA,North West,7300075,82,9,591,42
2020-03-21,United Kingdom,NA,North West,7300075,114,13,705,55
2020-03-22,United Kingdom,NA,North West,7300075,117,12,822,67
2020-03-23,United Kingdom,NA,North West,7300075,176,21,998,88
2020-03-24,United Kingdom,NA,North West,7300075,254,22,1252,110
2020-03-25,United Kingdom,NA,North West,7300075,255,23,1507,133
2020-03-26,United Kingdom,NA,North West,7300075,358,32,1865,165
2020-03-27,United Kingdom,NA,North West,7300075,332,40,2197,205
2020-03-28,United Kingdom,NA,North West,7300075,322,38,2519,243
2020-03-29,United Kingdom,NA,North West,7300075,359,46,2878,289
2020-03-30,United Kingdom,NA,North West,7300075,508,72,3386,361
2020-03-31,United Kingdom,NA,North West,7300075,556,63,3942,424
2020-04-01,United Kingdom,NA,North West,7300075,618,93,4560,517
2020-04-02,United Kingdom,NA,North West,7300075,678,112,5238,629
2020-04-03,United Kingdom,NA,North West,7300075,682,111,5920,740
2020-04-04,United Kingdom,NA,North West,7300075,600,102,6520,842
2020-04-05,United Kingdom,NA,North West,7300075,623,120,7143,962
2020-04-06,United Kingdom,NA,North West,7300075,871,109,8014,1071
2020-04-07,United Kingdom,NA,North West,7300075,792,157,8806,1228
2020-04-08,United Kingdom,NA,North West,7300075,850,138,9656,1366
2020-04-09,United Kingdom,NA,North West,7300075,804,129,10460,1495
2020-04-10,United Kingdom,NA,North West,7300075,602,140,11062,1635
2020-04-11,United Kingdom,NA,North West,7300075,611,152,11673,1787
2020-04-12,United Kingdom,NA,North West,7300075,488,155,12161,1942
2020-04-13,United Kingdom,NA,North West,7300075,608,145,12769,2087
2020-04-14,United Kingdom,NA,North West,7300075,633,152,13402,2239
2020-04-15,United Kingdom,NA,North West,7300075,694,128,14096,2367
2020-04-16,United Kingdom,NA,North West,7300075,778,166,14874,2533
2020-04-17,United Kingdom,NA,North West,7300075,580,118,15454,2651
2020-04-18,United Kingdom,NA,North West,7300075,862,134,16316,2785
2020-04-19,United Kingdom,NA,North West,7300075,608,93,16924,2878
2020-04-20,United Kingdom,NA,North West,7300075,674,103,17598,2981
2020-04-21,United Kingdom,NA,North West,7300075,692,106,18290,3087
2020-04-22,United Kingdom,NA,North West,7300075,911,127,19201,3214
2020-04-23,United Kingdom,NA,North West,7300075,858,111,20059,3325
2020-04-24,United Kingdom,NA,North West,7300075,750,105,20809,3430
2020-04-25,United Kingdom,NA,North West,7300075,549,91,21358,3521
2020-04-26,United Kingdom,NA,North West,7300075,428,92,21786,3613
2020-04-27,United Kingdom,NA,North West,7300075,623,90,22409,3703
2020-04-28,United Kingdom,NA,North West,7300075,708,82,23117,3785
2020-04-29,United Kingdom,NA,North West,7300075,796,82,23913,3867
2020-04-30,United Kingdom,NA,North West,7300075,772,89,24685,3956
2020-05-01,United Kingdom,NA,North West,7300075,727,71,25412,4027
2020-05-02,United Kingdom,NA,North West,7300075,411,78,25823,4105
2020-05-03,United Kingdom,NA,North West,7300075,492,77,26315,4182
2020-05-04,United Kingdom,NA,North West,7300075,427,76,26742,4258
2020-05-05,United Kingdom,NA,North West,7300075,576,60,27318,4318
2020-05-06,United Kingdom,NA,North West,7300075,584,66,27902,4384
2020-05-07,United Kingdom,NA,North West,7300075,508,75,28410,4459
2020-05-08,United Kingdom,NA,North West,7300075,484,66,28894,4525
2020-05-09,United Kingdom,NA,North West,7300075,344,48,29238,4573
2020-05-10,United Kingdom,NA,North West,7300075,346,70,29584,4643
2020-05-11,United Kingdom,NA,North West,7300075,529,52,30113,4695
2020-05-12,United Kingdom,NA,North West,7300075,548,62,30661,4757
2020-05-13,United Kingdom,NA,North West,7300075,523,35,31184,4792
2020-05-14,United Kingdom,NA,North West,7300075,425,39,31609,4831
2020-05-15,United Kingdom,NA,North West,7300075,392,58,32001,4889
2020-05-16,United Kingdom,NA,North West,7300075,406,52,32407,4941
2020-05-17,United Kingdom,NA,North West,7300075,303,37,32710,4978
2020-05-18,United Kingdom,NA,North West,7300075,409,36,33119,5014
2020-05-19,United Kingdom,NA,North West,7300075,579,49,33698,5063
2020-05-20,United Kingdom,NA,North West,7300075,498,35,34196,5098
2020-05-21,United Kingdom,NA,North West,7300075,427,42,34623,5140
2020-05-22,United Kingdom,NA,North West,7300075,375,29,34998,5169
2020-05-23,United Kingdom,NA,North West,7300075,288,38,35286,5207
2020-05-24,United Kingdom,NA,North West,7300075,262,35,35548,5242
2020-05-25,United Kingdom,NA,North West,7300075,268,35,35816,5277
2020-05-26,United Kingdom,NA,North West,7300075,309,30,36125,5307
2020-05-27,United Kingdom,NA,North West,7300075,294,33,36419,5340
2020-05-28,United Kingdom,NA,North West,7300075,325,39,36744,5379
2020-05-29,United Kingdom,NA,North West,7300075,303,27,37047,5406
2020-05-30,United Kingdom,NA,North West,7300075,215,28,37262,5434
2020-05-31,United Kingdom,NA,North West,7300075,234,18,37496,5452
2020-06-01,United Kingdom,NA,North West,7300075,261,23,37757,5475
2020-06-02,United Kingdom,NA,North West,7300075,286,26,38043,5501
2020-06-03,United Kingdom,NA,North West,7300075,257,29,38300,5530
2020-06-04,United Kingdom,NA,North West,7300075,238,30,38538,5560
2020-06-05,United Kingdom,NA,North West,7300075,204,24,38742,5584
2020-06-06,United Kingdom,NA,North West,7300075,132,29,38874,5613
2020-06-07,United Kingdom,NA,North West,7300075,130,26,39004,5639
2020-06-08,United Kingdom,NA,North West,7300075,165,28,39169,5667
2020-06-09,United Kingdom,NA,North West,7300075,218,18,39387,5685
2020-06-10,United Kingdom,NA,North West,7300075,224,18,39611,5703
2020-06-11,United Kingdom,NA,North West,7300075,176,16,39787,5719
2020-06-12,United Kingdom,NA,North West,7300075,168,15,39955,5734
2020-06-13,United Kingdom,NA,North West,7300075,128,13,40083,5747
2020-06-14,United Kingdom,NA,North West,7300075,148,15,40231,5762
2020-06-15,United Kingdom,NA,North West,7300075,164,15,40395,5777
2020-06-16,United Kingdom,NA,North West,7300075,211,19,40606,5796
2020-06-17,United Kingdom,NA,North West,7300075,183,14,40789,5810
2020-06-18,United Kingdom,NA,North West,7300075,178,14,40967,5824
2020-06-19,United Kingdom,NA,North West,7300075,167,8,41134,5832
2020-06-20,United Kingdom,NA,North West,7300075,118,11,41252,5843
2020-06-21,United Kingdom,NA,North West,7300075,99,8,41351,5851
2020-06-22,United Kingdom,NA,North West,7300075,159,10,41510,5861
2020-06-23,United Kingdom,NA,North West,7300075,127,20,41637,5881
2020-06-24,United Kingdom,NA,North West,7300075,159,13,41796,5894
2020-06-25,United Kingdom,NA,North West,7300075,125,16,41921,5910
2020-06-26,United Kingdom,NA,North West,7300075,106,6,42027,5916
2020-06-27,United Kingdom,NA,North West,7300075,93,8,42120,5924
2020-06-28,United Kingdom,NA,North West,7300075,95,10,42215,5934
2020-06-29,United Kingdom,NA,North West,7300075,123,10,42338,5944
2020-06-30,United Kingdom,NA,North West,7300075,103,9,42441,5953
2020-07-01,United Kingdom,NA,North West,7300075,114,4,42555,5957
2020-07-02,United Kingdom,NA,North West,7300075,99,5,42654,5962
2020-07-03,United Kingdom,NA,North West,7300075,96,6,42750,5968
2020-07-04,United Kingdom,NA,North West,7300075,71,4,42821,5972
2020-07-05,United Kingdom,NA,North West,7300075,115,4,42936,5976
2020-07-06,United Kingdom,NA,North West,7300075,142,11,43078,5987
2020-07-07,United Kingdom,NA,North West,7300075,94,5,43172,5992
2020-07-08,United Kingdom,NA,North West,7300075,115,4,43287,5996
2020-07-09,United Kingdom,NA,North West,7300075,129,7,43416,6003
2020-07-10,United Kingdom,NA,North West,7300075,87,4,43503,6007
2020-07-11,United Kingdom,NA,North West,7300075,77,5,43580,6012
2020-07-12,United Kingdom,NA,North West,7300075,54,2,43634,6014
2020-07-13,United Kingdom,NA,North West,7300075,104,5,43738,6019
2020-07-14,United Kingdom,NA,North West,7300075,109,6,43847,6025
2020-07-15,United Kingdom,NA,North West,7300075,146,5,43993,6030
2020-07-16,United Kingdom,NA,North West,7300075,149,2,44142,6032
2020-07-17,United Kingdom,NA,North West,7300075,111,4,44253,6036
2020-07-18,United Kingdom,NA,North West,7300075,106,3,44359,6039
2020-07-19,United Kingdom,NA,North West,7300075,93,2,44452,6041
2020-07-20,United Kingdom,NA,North West,7300075,164,2,44616,6043
2020-07-21,United Kingdom,NA,North West,7300075,156,3,44772,6046
2020-07-22,United Kingdom,NA,North West,7300075,208,5,44980,6051
2020-07-23,United Kingdom,NA,North West,7300075,183,3,45163,6054
2020-07-24,United Kingdom,NA,North West,7300075,159,1,45322,6055
2020-07-25,United Kingdom,NA,North West,7300075,137,3,45459,6058
2020-07-26,United Kingdom,NA,North West,7300075,157,3,45616,6061
2020-07-27,United Kingdom,NA,North West,7300075,189,2,45805,6063
2020-07-28,United Kingdom,NA,North West,7300075,200,2,46005,6065
2020-07-29,United Kingdom,NA,North West,7300075,288,4,46293,6069
2020-07-30,United Kingdom,NA,North West,7300075,221,4,46514,6073
2020-07-31,United Kingdom,NA,North West,7300075,178,1,46692,6074
2020-08-01,United Kingdom,NA,North West,7300075,158,1,46850,6075
2020-08-02,United Kingdom,NA,North West,7300075,167,2,47017,6077
2020-08-03,United Kingdom,NA,North West,7300075,299,10,47316,6087
2020-08-04,United Kingdom,NA,North West,7300075,278,2,47594,6089
2020-08-05,United Kingdom,NA,North West,7300075,263,1,47857,6090
2020-08-06,United Kingdom,NA,North West,7300075,278,3,48135,6093
2020-08-07,United Kingdom,NA,North West,7300075,240,3,48375,6096
2020-08-08,United Kingdom,NA,North West,7300075,216,6,48591,6102
2020-08-09,United Kingdom,NA,North West,7300075,159,4,48750,6106
2020-08-10,United Kingdom,NA,North West,7300075,358,3,49108,6109
2020-08-11,United Kingdom,NA,North West,7300075,310,3,49418,6112
2020-08-12,United Kingdom,NA,North West,7300075,275,2,49693,6114
2020-08-13,United Kingdom,NA,North West,7300075,236,2,49929,6116
2020-08-14,United Kingdom,NA,North West,7300075,240,1,50169,6117
2020-08-15,United Kingdom,NA,North West,7300075,156,7,50325,6124
2020-08-16,United Kingdom,NA,North West,7300075,116,1,50441,6125
2020-08-17,United Kingdom,NA,North West,7300075,282,3,50723,6128
2020-08-18,United Kingdom,NA,North West,7300075,192,2,50915,6130
2020-08-19,United Kingdom,NA,North West,7300075,254,0,51169,6130
2020-08-20,United Kingdom,NA,North West,7300075,224,1,51393,6131
2020-08-21,United Kingdom,NA,North West,7300075,209,4,51602,6135
2020-08-22,United Kingdom,NA,North West,7300075,173,2,51775,6137
2020-08-23,United Kingdom,NA,North West,7300075,117,7,51892,6144
2020-08-24,United Kingdom,NA,North West,7300075,230,4,52122,6148
2020-08-25,United Kingdom,NA,North West,7300075,213,4,52335,6152
2020-08-26,United Kingdom,NA,North West,7300075,284,5,52619,6157
2020-08-27,United Kingdom,NA,North West,7300075,288,0,52907,6157
2020-08-28,United Kingdom,NA,North West,7300075,359,2,53266,6159
2020-08-29,United Kingdom,NA,North West,7300075,245,0,53511,6159
2020-08-30,United Kingdom,NA,North West,7300075,256,2,53767,6161
2020-08-31,United Kingdom,NA,North West,7300075,261,2,54028,6163
2020-09-01,United Kingdom,NA,North West,7300075,445,1,54473,6164
2020-09-02,United Kingdom,NA,North West,7300075,659,1,55132,6165
2020-09-03,United Kingdom,NA,North West,7300075,621,2,55753,6167
2020-09-04,United Kingdom,NA,North West,7300075,631,0,56384,6167
2020-09-05,United Kingdom,NA,North West,7300075,530,7,56914,6174
2020-09-06,United Kingdom,NA,North West,7300075,571,3,57485,6177
2020-09-07,United Kingdom,NA,North West,7300075,949,8,58434,6185
2020-09-08,United Kingdom,NA,North West,7300075,857,6,59291,6191
2020-09-09,United Kingdom,NA,North West,7300075,830,5,60121,6196
2020-09-10,United Kingdom,NA,North West,7300075,902,5,61023,6201
2020-09-11,United Kingdom,NA,North West,7300075,870,2,61893,6203
2020-09-12,United Kingdom,NA,North West,7300075,754,8,62647,6211
2020-09-13,United Kingdom,NA,North West,7300075,607,1,63254,6212
2020-09-14,United Kingdom,NA,North West,7300075,1044,6,64298,6218
2020-09-15,United Kingdom,NA,North West,7300075,1060,6,65358,6224
2020-09-16,United Kingdom,NA,North West,7300075,1426,10,66784,6234
2020-09-17,United Kingdom,NA,North West,7300075,1380,6,68164,6240
2020-09-18,United Kingdom,NA,North West,7300075,1382,7,69546,6247
2020-09-19,United Kingdom,NA,North West,7300075,1403,4,70949,6251
2020-09-20,United Kingdom,NA,North West,7300075,1040,3,71989,6254
2020-09-21,United Kingdom,NA,North West,7300075,1046,3,73035,6257
2020-09-22,United Kingdom,NA,North West,7300075,947,7,73982,6264
2020-09-23,United Kingdom,NA,North West,7300075,6,9,73988,6273
2020-03-08,United Kingdom,NA,Northern Ireland,1885189,3,0,12,0
2020-03-09,United Kingdom,NA,Northern Ireland,1885189,3,0,15,0
2020-03-10,United Kingdom,NA,Northern Ireland,1885189,5,0,20,0
2020-03-11,United Kingdom,NA,Northern Ireland,1885189,11,0,31,0
2020-03-12,United Kingdom,NA,Northern Ireland,1885189,4,0,35,0
2020-03-13,United Kingdom,NA,Northern Ireland,1885189,11,0,46,0
2020-03-14,United Kingdom,NA,Northern Ireland,1885189,10,0,56,0
2020-03-15,United Kingdom,NA,Northern Ireland,1885189,2,0,58,0
2020-03-16,United Kingdom,NA,Northern Ireland,1885189,8,0,66,0
2020-03-17,United Kingdom,NA,Northern Ireland,1885189,9,0,75,0
2020-03-18,United Kingdom,NA,Northern Ireland,1885189,13,1,88,1
2020-03-19,United Kingdom,NA,Northern Ireland,1885189,14,1,102,2
2020-03-20,United Kingdom,NA,Northern Ireland,1885189,17,0,119,2
2020-03-21,United Kingdom,NA,Northern Ireland,1885189,21,1,140,3
2020-03-22,United Kingdom,NA,Northern Ireland,1885189,18,1,158,4
2020-03-23,United Kingdom,NA,Northern Ireland,1885189,41,5,199,9
2020-03-24,United Kingdom,NA,Northern Ireland,1885189,41,2,240,11
2020-03-25,United Kingdom,NA,Northern Ireland,1885189,57,4,297,15
2020-03-26,United Kingdom,NA,Northern Ireland,1885189,76,2,373,17
2020-03-27,United Kingdom,NA,Northern Ireland,1885189,68,3,441,20
2020-03-28,United Kingdom,NA,Northern Ireland,1885189,76,8,517,28
2020-03-29,United Kingdom,NA,Northern Ireland,1885189,62,4,579,32
2020-03-30,United Kingdom,NA,Northern Ireland,1885189,84,4,663,36
2020-03-31,United Kingdom,NA,Northern Ireland,1885189,112,5,775,41
2020-04-01,United Kingdom,NA,Northern Ireland,1885189,103,4,878,45
2020-04-02,United Kingdom,NA,Northern Ireland,1885189,105,10,983,55
2020-04-03,United Kingdom,NA,Northern Ireland,1885189,103,10,1086,65
2020-04-04,United Kingdom,NA,Northern Ireland,1885189,87,9,1173,74
2020-04-05,United Kingdom,NA,Northern Ireland,1885189,60,11,1233,85
2020-04-06,United Kingdom,NA,Northern Ireland,1885189,106,6,1339,91
2020-04-07,United Kingdom,NA,Northern Ireland,1885189,130,8,1469,99
2020-04-08,United Kingdom,NA,Northern Ireland,1885189,103,4,1572,103
2020-04-09,United Kingdom,NA,Northern Ireland,1885189,101,18,1673,121
2020-04-10,United Kingdom,NA,Northern Ireland,1885189,95,11,1768,132
2020-04-11,United Kingdom,NA,Northern Ireland,1885189,67,11,1835,143
2020-04-12,United Kingdom,NA,Northern Ireland,1885189,73,16,1908,159
2020-04-13,United Kingdom,NA,Northern Ireland,1885189,107,7,2015,166
2020-04-14,United Kingdom,NA,Northern Ireland,1885189,96,12,2111,178
2020-04-15,United Kingdom,NA,Northern Ireland,1885189,134,16,2245,194
2020-04-16,United Kingdom,NA,Northern Ireland,1885189,138,11,2383,205
2020-04-17,United Kingdom,NA,Northern Ireland,1885189,156,9,2539,214
2020-04-18,United Kingdom,NA,Northern Ireland,1885189,86,10,2625,224
2020-04-19,United Kingdom,NA,Northern Ireland,1885189,41,10,2666,234
2020-04-20,United Kingdom,NA,Northern Ireland,1885189,112,12,2778,246
2020-04-21,United Kingdom,NA,Northern Ireland,1885189,131,13,2909,259
2020-04-22,United Kingdom,NA,Northern Ireland,1885189,99,19,3008,278
2020-04-23,United Kingdom,NA,Northern Ireland,1885189,73,16,3081,294
2020-04-24,United Kingdom,NA,Northern Ireland,1885189,83,11,3164,305
2020-04-25,United Kingdom,NA,Northern Ireland,1885189,54,15,3218,320
2020-04-26,United Kingdom,NA,Northern Ireland,1885189,45,14,3263,334
2020-04-27,United Kingdom,NA,Northern Ireland,1885189,71,13,3334,347
2020-04-28,United Kingdom,NA,Northern Ireland,1885189,75,6,3409,353
2020-04-29,United Kingdom,NA,Northern Ireland,1885189,93,14,3502,367
2020-04-30,United Kingdom,NA,Northern Ireland,1885189,116,8,3618,375
2020-05-01,United Kingdom,NA,Northern Ireland,1885189,100,12,3718,387
2020-05-02,United Kingdom,NA,Northern Ireland,1885189,91,12,3809,399
2020-05-03,United Kingdom,NA,Northern Ireland,1885189,55,11,3864,410
2020-05-04,United Kingdom,NA,Northern Ireland,1885189,75,9,3939,419
2020-05-05,United Kingdom,NA,Northern Ireland,1885189,75,6,4014,425
2020-05-06,United Kingdom,NA,Northern Ireland,1885189,80,3,4094,428
2020-05-07,United Kingdom,NA,Northern Ireland,1885189,97,3,4191,431
2020-05-08,United Kingdom,NA,Northern Ireland,1885189,72,6,4263,437
2020-05-09,United Kingdom,NA,Northern Ireland,1885189,54,7,4317,444
2020-05-10,United Kingdom,NA,Northern Ireland,1885189,62,10,4379,454
2020-05-11,United Kingdom,NA,Northern Ireland,1885189,77,2,4456,456
2020-05-12,United Kingdom,NA,Northern Ireland,1885189,93,4,4549,460
2020-05-13,United Kingdom,NA,Northern Ireland,1885189,75,3,4624,463
2020-05-14,United Kingdom,NA,Northern Ireland,1885189,74,10,4698,473
2020-05-15,United Kingdom,NA,Northern Ireland,1885189,66,3,4764,476
2020-05-16,United Kingdom,NA,Northern Ireland,1885189,40,4,4804,480
2020-05-17,United Kingdom,NA,Northern Ireland,1885189,38,7,4842,487
2020-05-18,United Kingdom,NA,Northern Ireland,1885189,63,7,4905,494
2020-05-19,United Kingdom,NA,Northern Ireland,1885189,73,5,4978,499
2020-05-20,United Kingdom,NA,Northern Ireland,1885189,76,5,5054,504
2020-05-21,United Kingdom,NA,Northern Ireland,1885189,56,4,5110,508
2020-05-22,United Kingdom,NA,Northern Ireland,1885189,33,1,5143,509
2020-05-23,United Kingdom,NA,Northern Ireland,1885189,54,2,5197,511
2020-05-24,United Kingdom,NA,Northern Ireland,1885189,31,7,5228,518
2020-05-25,United Kingdom,NA,Northern Ireland,1885189,41,1,5269,519
2020-05-26,United Kingdom,NA,Northern Ireland,1885189,28,1,5297,520
2020-05-27,United Kingdom,NA,Northern Ireland,1885189,33,4,5330,524
2020-05-28,United Kingdom,NA,Northern Ireland,1885189,28,3,5358,527
2020-05-29,United Kingdom,NA,Northern Ireland,1885189,20,1,5378,528
2020-05-30,United Kingdom,NA,Northern Ireland,1885189,13,2,5391,530
2020-05-31,United Kingdom,NA,Northern Ireland,1885189,26,1,5417,531
2020-06-01,United Kingdom,NA,Northern Ireland,1885189,24,1,5441,532
2020-06-02,United Kingdom,NA,Northern Ireland,1885189,21,2,5462,534
2020-06-03,United Kingdom,NA,Northern Ireland,1885189,11,2,5473,536
2020-06-04,United Kingdom,NA,Northern Ireland,1885189,11,0,5484,536
2020-06-05,United Kingdom,NA,Northern Ireland,1885189,24,1,5508,537
2020-06-06,United Kingdom,NA,Northern Ireland,1885189,8,0,5516,537
2020-06-07,United Kingdom,NA,Northern Ireland,1885189,5,0,5521,537
2020-06-08,United Kingdom,NA,Northern Ireland,1885189,14,0,5535,537
2020-06-09,United Kingdom,NA,Northern Ireland,1885189,11,0,5546,537
2020-06-10,United Kingdom,NA,Northern Ireland,1885189,16,0,5562,537
2020-06-11,United Kingdom,NA,Northern Ireland,1885189,10,2,5572,539
2020-06-12,United Kingdom,NA,Northern Ireland,1885189,10,1,5582,540
2020-06-13,United Kingdom,NA,Northern Ireland,1885189,10,1,5592,541
2020-06-14,United Kingdom,NA,Northern Ireland,1885189,8,0,5600,541
2020-06-15,United Kingdom,NA,Northern Ireland,1885189,19,0,5619,541
2020-06-16,United Kingdom,NA,Northern Ireland,1885189,11,1,5630,542
2020-06-17,United Kingdom,NA,Northern Ireland,1885189,5,1,5635,543
2020-06-18,United Kingdom,NA,Northern Ireland,1885189,7,1,5642,544
2020-06-19,United Kingdom,NA,Northern Ireland,1885189,14,1,5656,545
2020-06-20,United Kingdom,NA,Northern Ireland,1885189,5,0,5661,545
2020-06-21,United Kingdom,NA,Northern Ireland,1885189,3,0,5664,545
2020-06-22,United Kingdom,NA,Northern Ireland,1885189,4,1,5668,546
2020-06-23,United Kingdom,NA,Northern Ireland,1885189,8,1,5676,547
2020-06-24,United Kingdom,NA,Northern Ireland,1885189,4,0,5680,547
2020-06-25,United Kingdom,NA,Northern Ireland,1885189,5,1,5685,548
2020-06-26,United Kingdom,NA,Northern Ireland,1885189,3,2,5688,550
2020-06-27,United Kingdom,NA,Northern Ireland,1885189,4,0,5692,550
2020-06-28,United Kingdom,NA,Northern Ireland,1885189,5,0,5697,550
2020-06-29,United Kingdom,NA,Northern Ireland,1885189,4,1,5701,551
2020-06-30,United Kingdom,NA,Northern Ireland,1885189,2,0,5703,551
2020-07-01,United Kingdom,NA,Northern Ireland,1885189,4,1,5707,552
2020-07-02,United Kingdom,NA,Northern Ireland,1885189,3,0,5710,552
2020-07-03,United Kingdom,NA,Northern Ireland,1885189,8,2,5718,554
2020-07-04,United Kingdom,NA,Northern Ireland,1885189,1,0,5719,554
2020-07-05,United Kingdom,NA,Northern Ireland,1885189,2,0,5721,554
2020-07-06,United Kingdom,NA,Northern Ireland,1885189,8,0,5729,554
2020-07-07,United Kingdom,NA,Northern Ireland,1885189,5,0,5734,554
2020-07-08,United Kingdom,NA,Northern Ireland,1885189,6,0,5740,554
2020-07-09,United Kingdom,NA,Northern Ireland,1885189,5,1,5745,555
2020-07-10,United Kingdom,NA,Northern Ireland,1885189,4,0,5749,555
2020-07-11,United Kingdom,NA,Northern Ireland,1885189,6,0,5755,555
2020-07-12,United Kingdom,NA,Northern Ireland,1885189,4,1,5759,556
2020-07-13,United Kingdom,NA,Northern Ireland,1885189,3,0,5762,556
2020-07-14,United Kingdom,NA,Northern Ireland,1885189,7,0,5769,556
2020-07-15,United Kingdom,NA,Northern Ireland,1885189,15,0,5784,556
2020-07-16,United Kingdom,NA,Northern Ireland,1885189,19,0,5803,556
2020-07-17,United Kingdom,NA,Northern Ireland,1885189,9,0,5812,556
2020-07-18,United Kingdom,NA,Northern Ireland,1885189,7,0,5819,556
2020-07-19,United Kingdom,NA,Northern Ireland,1885189,3,0,5822,556
2020-07-20,United Kingdom,NA,Northern Ireland,1885189,3,0,5825,556
2020-07-21,United Kingdom,NA,Northern Ireland,1885189,12,0,5837,556
2020-07-22,United Kingdom,NA,Northern Ireland,1885189,8,0,5845,556
2020-07-23,United Kingdom,NA,Northern Ireland,1885189,12,0,5857,556
2020-07-24,United Kingdom,NA,Northern Ireland,1885189,14,0,5871,556
2020-07-25,United Kingdom,NA,Northern Ireland,1885189,4,0,5875,556
2020-07-26,United Kingdom,NA,Northern Ireland,1885189,1,0,5876,556
2020-07-27,United Kingdom,NA,Northern Ireland,1885189,12,0,5888,556
2020-07-28,United Kingdom,NA,Northern Ireland,1885189,13,0,5901,556
2020-07-29,United Kingdom,NA,Northern Ireland,1885189,11,0,5912,556
2020-07-30,United Kingdom,NA,Northern Ireland,1885189,11,0,5923,556
2020-07-31,United Kingdom,NA,Northern Ireland,1885189,14,0,5937,556
2020-08-01,United Kingdom,NA,Northern Ireland,1885189,10,0,5947,556
2020-08-02,United Kingdom,NA,Northern Ireland,1885189,9,0,5956,556
2020-08-03,United Kingdom,NA,Northern Ireland,1885189,18,0,5974,556
2020-08-04,United Kingdom,NA,Northern Ireland,1885189,19,0,5993,556
2020-08-05,United Kingdom,NA,Northern Ireland,1885189,29,0,6022,556
2020-08-06,United Kingdom,NA,Northern Ireland,1885189,18,0,6040,556
2020-08-07,United Kingdom,NA,Northern Ireland,1885189,17,0,6057,556
2020-08-08,United Kingdom,NA,Northern Ireland,1885189,28,1,6085,557
2020-08-09,United Kingdom,NA,Northern Ireland,1885189,25,0,6110,557
2020-08-10,United Kingdom,NA,Northern Ireland,1885189,44,0,6154,557
2020-08-11,United Kingdom,NA,Northern Ireland,1885189,38,0,6192,557
2020-08-12,United Kingdom,NA,Northern Ireland,1885189,40,0,6232,557
2020-08-13,United Kingdom,NA,Northern Ireland,1885189,51,1,6283,558
2020-08-14,United Kingdom,NA,Northern Ireland,1885189,57,0,6340,558
2020-08-15,United Kingdom,NA,Northern Ireland,1885189,22,1,6362,559
2020-08-16,United Kingdom,NA,Northern Ireland,1885189,21,0,6383,559
2020-08-17,United Kingdom,NA,Northern Ireland,1885189,53,0,6436,559
2020-08-18,United Kingdom,NA,Northern Ireland,1885189,43,0,6479,559
2020-08-19,United Kingdom,NA,Northern Ireland,1885189,41,0,6520,559
2020-08-20,United Kingdom,NA,Northern Ireland,1885189,72,0,6592,559
2020-08-21,United Kingdom,NA,Northern Ireland,1885189,80,0,6672,559
2020-08-22,United Kingdom,NA,Northern Ireland,1885189,43,0,6715,559
2020-08-23,United Kingdom,NA,Northern Ireland,1885189,52,0,6767,559
2020-08-24,United Kingdom,NA,Northern Ireland,1885189,45,0,6812,559
2020-08-25,United Kingdom,NA,Northern Ireland,1885189,65,1,6877,560
2020-08-26,United Kingdom,NA,Northern Ireland,1885189,70,0,6947,560
2020-08-27,United Kingdom,NA,Northern Ireland,1885189,81,0,7028,560
2020-08-28,United Kingdom,NA,Northern Ireland,1885189,89,1,7117,561
2020-08-29,United Kingdom,NA,Northern Ireland,1885189,44,0,7161,561
2020-08-30,United Kingdom,NA,Northern Ireland,1885189,35,0,7196,561
2020-08-31,United Kingdom,NA,Northern Ireland,1885189,54,0,7250,561
2020-09-01,United Kingdom,NA,Northern Ireland,1885189,66,1,7316,562
2020-09-02,United Kingdom,NA,Northern Ireland,1885189,92,0,7408,562
2020-09-03,United Kingdom,NA,Northern Ireland,1885189,108,2,7516,564
2020-09-04,United Kingdom,NA,Northern Ireland,1885189,131,0,7647,564
2020-09-05,United Kingdom,NA,Northern Ireland,1885189,92,1,7739,565
2020-09-06,United Kingdom,NA,Northern Ireland,1885189,107,0,7846,565
2020-09-07,United Kingdom,NA,Northern Ireland,1885189,73,2,7919,567
2020-09-08,United Kingdom,NA,Northern Ireland,1885189,56,0,7975,567
2020-09-09,United Kingdom,NA,Northern Ireland,1885189,100,0,8075,567
2020-09-10,United Kingdom,NA,Northern Ireland,1885189,84,1,8159,568
2020-09-11,United Kingdom,NA,Northern Ireland,1885189,75,2,8234,570
2020-09-12,United Kingdom,NA,Northern Ireland,1885189,109,0,8343,570
2020-09-13,United Kingdom,NA,Northern Ireland,1885189,94,0,8437,570
2020-09-14,United Kingdom,NA,Northern Ireland,1885189,126,1,8563,571
2020-09-15,United Kingdom,NA,Northern Ireland,1885189,113,1,8676,572
2020-09-16,United Kingdom,NA,Northern Ireland,1885189,146,2,8822,574
2020-09-17,United Kingdom,NA,Northern Ireland,1885189,180,0,9002,574
2020-09-18,United Kingdom,NA,Northern Ireland,1885189,172,1,9174,575
2020-09-19,United Kingdom,NA,Northern Ireland,1885189,173,2,9347,577
2020-09-20,United Kingdom,NA,Northern Ireland,1885189,135,0,9482,577
2020-09-21,United Kingdom,NA,Northern Ireland,1885189,143,0,9625,577
2020-09-22,United Kingdom,NA,Northern Ireland,1885189,182,0,9807,577
2020-09-23,United Kingdom,NA,Northern Ireland,1885189,143,0,9950,577
2020-03-04,United Kingdom,NA,Scotland,5454238,6,0,13,0
2020-03-05,United Kingdom,NA,Scotland,5454238,2,0,15,0
2020-03-06,United Kingdom,NA,Scotland,5454238,6,0,21,0
2020-03-07,United Kingdom,NA,Scotland,5454238,6,0,27,0
2020-03-08,United Kingdom,NA,Scotland,5454238,3,0,30,0
2020-03-09,United Kingdom,NA,Scotland,5454238,16,0,46,0
2020-03-10,United Kingdom,NA,Scotland,5454238,21,0,67,0
2020-03-11,United Kingdom,NA,Scotland,5454238,26,0,93,0
2020-03-12,United Kingdom,NA,Scotland,5454238,38,1,131,1
2020-03-13,United Kingdom,NA,Scotland,5454238,48,0,179,1
2020-03-14,United Kingdom,NA,Scotland,5454238,19,2,198,3
2020-03-15,United Kingdom,NA,Scotland,5454238,12,0,210,3
2020-03-16,United Kingdom,NA,Scotland,5454238,21,1,231,4
2020-03-17,United Kingdom,NA,Scotland,5454238,43,2,274,6
2020-03-18,United Kingdom,NA,Scotland,5454238,41,0,315,6
2020-03-19,United Kingdom,NA,Scotland,5454238,49,3,364,9
2020-03-20,United Kingdom,NA,Scotland,5454238,83,5,447,14
2020-03-21,United Kingdom,NA,Scotland,5454238,66,6,513,20
2020-03-22,United Kingdom,NA,Scotland,5454238,75,5,588,25
2020-03-23,United Kingdom,NA,Scotland,5454238,138,4,726,29
2020-03-24,United Kingdom,NA,Scotland,5454238,167,7,893,36
2020-03-25,United Kingdom,NA,Scotland,5454238,187,10,1080,46
2020-03-26,United Kingdom,NA,Scotland,5454238,223,11,1303,57
2020-03-27,United Kingdom,NA,Scotland,5454238,274,11,1577,68
2020-03-28,United Kingdom,NA,Scotland,5454238,205,29,1782,97
2020-03-29,United Kingdom,NA,Scotland,5454238,197,20,1979,117
2020-03-30,United Kingdom,NA,Scotland,5454238,321,27,2300,144
2020-03-31,United Kingdom,NA,Scotland,5454238,340,38,2640,182
2020-04-01,United Kingdom,NA,Scotland,5454238,384,44,3024,226
2020-04-02,United Kingdom,NA,Scotland,5454238,355,36,3379,262
2020-04-03,United Kingdom,NA,Scotland,5454238,379,57,3758,319
2020-04-04,United Kingdom,NA,Scotland,5454238,260,27,4018,346
2020-04-05,United Kingdom,NA,Scotland,5454238,225,44,4243,390
2020-04-06,United Kingdom,NA,Scotland,5454238,404,62,4647,452
2020-04-07,United Kingdom,NA,Scotland,5454238,351,47,4998,499
2020-04-08,United Kingdom,NA,Scotland,5454238,343,52,5341,551
2020-04-09,United Kingdom,NA,Scotland,5454238,304,63,5645,614
2020-04-10,United Kingdom,NA,Scotland,5454238,329,55,5974,669
2020-04-11,United Kingdom,NA,Scotland,5454238,185,51,6159,720
2020-04-12,United Kingdom,NA,Scotland,5454238,220,46,6379,766
2020-04-13,United Kingdom,NA,Scotland,5454238,359,39,6738,805
2020-04-14,United Kingdom,NA,Scotland,5454238,346,50,7084,855
2020-04-15,United Kingdom,NA,Scotland,5454238,331,41,7415,896
2020-04-16,United Kingdom,NA,Scotland,5454238,428,41,7843,937
2020-04-17,United Kingdom,NA,Scotland,5454238,394,37,8237,974
2020-04-18,United Kingdom,NA,Scotland,5454238,264,51,8501,1025
2020-04-19,United Kingdom,NA,Scotland,5454238,159,44,8660,1069
2020-04-20,United Kingdom,NA,Scotland,5454238,776,61,9436,1130
2020-04-21,United Kingdom,NA,Scotland,5454238,399,50,9835,1180
2020-04-22,United Kingdom,NA,Scotland,5454238,340,44,10175,1224
2020-04-23,United Kingdom,NA,Scotland,5454238,314,48,10489,1272
2020-04-24,United Kingdom,NA,Scotland,5454238,305,38,10794,1310
2020-04-25,United Kingdom,NA,Scotland,5454238,184,47,10978,1357
2020-04-26,United Kingdom,NA,Scotland,5454238,172,43,11150,1400
2020-04-27,United Kingdom,NA,Scotland,5454238,430,60,11580,1460
2020-04-28,United Kingdom,NA,Scotland,5454238,380,40,11960,1500
2020-04-29,United Kingdom,NA,Scotland,5454238,430,37,12390,1537
2020-04-30,United Kingdom,NA,Scotland,5454238,335,43,12725,1580
2020-05-01,United Kingdom,NA,Scotland,5454238,368,48,13093,1628
2020-05-02,United Kingdom,NA,Scotland,5454238,217,44,13310,1672
2020-05-03,United Kingdom,NA,Scotland,5454238,189,36,13499,1708
2020-05-04,United Kingdom,NA,Scotland,5454238,329,40,13828,1748
2020-05-05,United Kingdom,NA,Scotland,5454238,288,50,14116,1798
2020-05-06,United Kingdom,NA,Scotland,5454238,306,43,14422,1841
2020-05-07,United Kingdom,NA,Scotland,5454238,290,39,14712,1880
2020-05-08,United Kingdom,NA,Scotland,5454238,254,34,14966,1914
2020-05-09,United Kingdom,NA,Scotland,5454238,177,34,15143,1948
2020-05-10,United Kingdom,NA,Scotland,5454238,150,27,15293,1975
2020-05-11,United Kingdom,NA,Scotland,5454238,261,32,15554,2007
2020-05-12,United Kingdom,NA,Scotland,5454238,231,30,15785,2037
2020-05-13,United Kingdom,NA,Scotland,5454238,198,42,15983,2079
2020-05-14,United Kingdom,NA,Scotland,5454238,212,34,16195,2113
2020-05-15,United Kingdom,NA,Scotland,5454238,152,24,16347,2137
2020-05-16,United Kingdom,NA,Scotland,5454238,103,28,16450,2165
2020-05-17,United Kingdom,NA,Scotland,5454238,92,26,16542,2191
2020-05-18,United Kingdom,NA,Scotland,5454238,140,23,16682,2214
2020-05-19,United Kingdom,NA,Scotland,5454238,182,28,16864,2242
2020-05-20,United Kingdom,NA,Scotland,5454238,121,21,16985,2263
2020-05-21,United Kingdom,NA,Scotland,5454238,111,23,17096,2286
2020-05-22,United Kingdom,NA,Scotland,5454238,92,16,17188,2302
2020-05-23,United Kingdom,NA,Scotland,5454238,50,9,17238,2311
2020-05-24,United Kingdom,NA,Scotland,5454238,54,7,17292,2318
2020-05-25,United Kingdom,NA,Scotland,5454238,97,14,17389,2332
2020-05-26,United Kingdom,NA,Scotland,5454238,77,13,17466,2345
2020-05-27,United Kingdom,NA,Scotland,5454238,66,16,17532,2361
2020-05-28,United Kingdom,NA,Scotland,5454238,55,16,17587,2377
2020-05-29,United Kingdom,NA,Scotland,5454238,29,11,17616,2388
2020-05-30,United Kingdom,NA,Scotland,5454238,40,6,17656,2394
2020-05-31,United Kingdom,NA,Scotland,5454238,23,6,17679,2400
2020-06-01,United Kingdom,NA,Scotland,5454238,38,3,17717,2403
2020-06-02,United Kingdom,NA,Scotland,5454238,45,6,17762,2409
2020-06-03,United Kingdom,NA,Scotland,5454238,35,8,17797,2417
2020-06-04,United Kingdom,NA,Scotland,5454238,35,2,17832,2419
2020-06-05,United Kingdom,NA,Scotland,5454238,24,9,17856,2428
2020-06-06,United Kingdom,NA,Scotland,5454238,22,3,17878,2431
2020-06-07,United Kingdom,NA,Scotland,5454238,17,7,17895,2438
2020-06-08,United Kingdom,NA,Scotland,5454238,18,5,17913,2443
2020-06-09,United Kingdom,NA,Scotland,5454238,27,1,17940,2444
2020-06-10,United Kingdom,NA,Scotland,5454238,29,5,17969,2449
2020-06-11,United Kingdom,NA,Scotland,5454238,21,2,17990,2451
2020-06-12,United Kingdom,NA,Scotland,5454238,30,2,18020,2453
2020-06-13,United Kingdom,NA,Scotland,5454238,23,3,18043,2456
2020-06-14,United Kingdom,NA,Scotland,5454238,13,4,18056,2460
2020-06-15,United Kingdom,NA,Scotland,5454238,21,3,18077,2463
2020-06-16,United Kingdom,NA,Scotland,5454238,17,6,18094,2469
2020-06-17,United Kingdom,NA,Scotland,5454238,33,3,18127,2472
2020-06-18,United Kingdom,NA,Scotland,5454238,14,3,18141,2475
2020-06-19,United Kingdom,NA,Scotland,5454238,23,0,18164,2475
2020-06-20,United Kingdom,NA,Scotland,5454238,6,3,18170,2478
2020-06-21,United Kingdom,NA,Scotland,5454238,9,2,18179,2480
2020-06-22,United Kingdom,NA,Scotland,5454238,11,3,18190,2483
2020-06-23,United Kingdom,NA,Scotland,5454238,20,1,18210,2484
2020-06-24,United Kingdom,NA,Scotland,5454238,8,1,18218,2485
2020-06-25,United Kingdom,NA,Scotland,5454238,19,0,18237,2485
2020-06-26,United Kingdom,NA,Scotland,5454238,6,0,18243,2485
2020-06-27,United Kingdom,NA,Scotland,5454238,4,4,18247,2489
2020-06-28,United Kingdom,NA,Scotland,5454238,3,0,18250,2489
2020-06-29,United Kingdom,NA,Scotland,5454238,14,1,18264,2490
2020-06-30,United Kingdom,NA,Scotland,5454238,8,0,18272,2490
2020-07-01,United Kingdom,NA,Scotland,5454238,11,0,18283,2490
2020-07-02,United Kingdom,NA,Scotland,5454238,13,0,18296,2490
2020-07-03,United Kingdom,NA,Scotland,5454238,6,1,18302,2491
2020-07-04,United Kingdom,NA,Scotland,5454238,5,0,18307,2491
2020-07-05,United Kingdom,NA,Scotland,5454238,2,1,18309,2492
2020-07-06,United Kingdom,NA,Scotland,5454238,8,0,18317,2492
2020-07-07,United Kingdom,NA,Scotland,5454238,11,0,18328,2492
2020-07-08,United Kingdom,NA,Scotland,5454238,10,0,18338,2492
2020-07-09,United Kingdom,NA,Scotland,5454238,8,0,18346,2492
2020-07-10,United Kingdom,NA,Scotland,5454238,12,0,18358,2492
2020-07-11,United Kingdom,NA,Scotland,5454238,9,0,18367,2492
2020-07-12,United Kingdom,NA,Scotland,5454238,2,0,18369,2492
2020-07-13,United Kingdom,NA,Scotland,5454238,17,0,18386,2492
2020-07-14,United Kingdom,NA,Scotland,5454238,10,0,18396,2492
2020-07-15,United Kingdom,NA,Scotland,5454238,16,0,18412,2492
2020-07-16,United Kingdom,NA,Scotland,5454238,21,0,18433,2492
2020-07-17,United Kingdom,NA,Scotland,5454238,8,0,18441,2492
2020-07-18,United Kingdom,NA,Scotland,5454238,13,0,18454,2492
2020-07-19,United Kingdom,NA,Scotland,5454238,17,0,18471,2492
2020-07-20,United Kingdom,NA,Scotland,5454238,13,0,18484,2492
2020-07-21,United Kingdom,NA,Scotland,5454238,19,0,18503,2492
2020-07-22,United Kingdom,NA,Scotland,5454238,16,0,18519,2492
2020-07-23,United Kingdom,NA,Scotland,5454238,23,0,18542,2492
2020-07-24,United Kingdom,NA,Scotland,5454238,11,0,18553,2492
2020-07-25,United Kingdom,NA,Scotland,5454238,3,0,18556,2492
2020-07-26,United Kingdom,NA,Scotland,5454238,7,0,18563,2492
2020-07-27,United Kingdom,NA,Scotland,5454238,13,0,18576,2492
2020-07-28,United Kingdom,NA,Scotland,5454238,22,0,18598,2492
2020-07-29,United Kingdom,NA,Scotland,5454238,28,0,18626,2492
2020-07-30,United Kingdom,NA,Scotland,5454238,27,0,18653,2492
2020-07-31,United Kingdom,NA,Scotland,5454238,21,0,18674,2492
2020-08-01,United Kingdom,NA,Scotland,5454238,23,0,18697,2492
2020-08-02,United Kingdom,NA,Scotland,5454238,19,0,18716,2492
2020-08-03,United Kingdom,NA,Scotland,5454238,62,0,18778,2492
2020-08-04,United Kingdom,NA,Scotland,5454238,58,0,18836,2492
2020-08-05,United Kingdom,NA,Scotland,5454238,67,0,18903,2492
2020-08-06,United Kingdom,NA,Scotland,5454238,65,0,18968,2492
2020-08-07,United Kingdom,NA,Scotland,5454238,46,0,19014,2492
2020-08-08,United Kingdom,NA,Scotland,5454238,27,0,19041,2492
2020-08-09,United Kingdom,NA,Scotland,5454238,26,0,19067,2492
2020-08-10,United Kingdom,NA,Scotland,5454238,59,0,19126,2492
2020-08-11,United Kingdom,NA,Scotland,5454238,63,0,19189,2492
2020-08-12,United Kingdom,NA,Scotland,5454238,49,0,19238,2492
2020-08-13,United Kingdom,NA,Scotland,5454238,59,0,19297,2492
2020-08-14,United Kingdom,NA,Scotland,5454238,50,0,19347,2492
2020-08-15,United Kingdom,NA,Scotland,5454238,20,0,19367,2492
2020-08-16,United Kingdom,NA,Scotland,5454238,33,0,19400,2492
2020-08-17,United Kingdom,NA,Scotland,5454238,75,0,19475,2492
2020-08-18,United Kingdom,NA,Scotland,5454238,78,0,19553,2492
2020-08-19,United Kingdom,NA,Scotland,5454238,93,1,19646,2493
2020-08-20,United Kingdom,NA,Scotland,5454238,141,0,19787,2493
2020-08-21,United Kingdom,NA,Scotland,5454238,91,0,19878,2493
2020-08-22,United Kingdom,NA,Scotland,5454238,51,1,19929,2494
2020-08-23,United Kingdom,NA,Scotland,5454238,67,1,19996,2495
2020-08-24,United Kingdom,NA,Scotland,5454238,59,0,20055,2495
2020-08-25,United Kingdom,NA,Scotland,5454238,72,0,20127,2495
2020-08-26,United Kingdom,NA,Scotland,5454238,98,0,20225,2495
2020-08-27,United Kingdom,NA,Scotland,5454238,97,0,20322,2495
2020-08-28,United Kingdom,NA,Scotland,5454238,105,1,20427,2496
2020-08-29,United Kingdom,NA,Scotland,5454238,94,0,20521,2496
2020-08-30,United Kingdom,NA,Scotland,5454238,102,0,20623,2496
2020-08-31,United Kingdom,NA,Scotland,5454238,143,0,20766,2496
2020-09-01,United Kingdom,NA,Scotland,5454238,199,0,20965,2496
2020-09-02,United Kingdom,NA,Scotland,5454238,191,1,21156,2497
2020-09-03,United Kingdom,NA,Scotland,5454238,201,1,21357,2498
2020-09-04,United Kingdom,NA,Scotland,5454238,170,1,21527,2499
2020-09-05,United Kingdom,NA,Scotland,5454238,137,0,21664,2499
2020-09-06,United Kingdom,NA,Scotland,5454238,154,0,21818,2499
2020-09-07,United Kingdom,NA,Scotland,5454238,165,0,21983,2499
2020-09-08,United Kingdom,NA,Scotland,5454238,103,0,22086,2499
2020-09-09,United Kingdom,NA,Scotland,5454238,223,0,22309,2499
2020-09-10,United Kingdom,NA,Scotland,5454238,231,0,22540,2499
2020-09-11,United Kingdom,NA,Scotland,5454238,216,0,22756,2499
2020-09-12,United Kingdom,NA,Scotland,5454238,214,0,22970,2499
2020-09-13,United Kingdom,NA,Scotland,5454238,178,1,23148,2500
2020-09-14,United Kingdom,NA,Scotland,5454238,186,3,23334,2503
2020-09-15,United Kingdom,NA,Scotland,5454238,238,0,23572,2503
2020-09-16,United Kingdom,NA,Scotland,5454238,280,0,23852,2503
2020-09-17,United Kingdom,NA,Scotland,5454238,263,1,24115,2504
2020-09-18,United Kingdom,NA,Scotland,5454238,268,1,24383,2505
2020-09-19,United Kingdom,NA,Scotland,5454238,236,0,24619,2505
2020-09-20,United Kingdom,NA,Scotland,5454238,319,2,24938,2507
2020-09-21,United Kingdom,NA,Scotland,5454238,450,2,25388,2509
2020-09-22,United Kingdom,NA,Scotland,5454238,469,1,25857,2510
2020-09-23,United Kingdom,NA,Scotland,5454238,102,0,25959,2510
2020-02-27,United Kingdom,NA,South East,9175033,2,0,11,0
2020-02-28,United Kingdom,NA,South East,9175033,2,0,13,0
2020-02-29,United Kingdom,NA,South East,9175033,2,0,15,0
2020-03-01,United Kingdom,NA,South East,9175033,0,0,15,0
2020-03-02,United Kingdom,NA,South East,9175033,1,0,16,0
2020-03-03,United Kingdom,NA,South East,9175033,9,1,25,1
2020-03-04,United Kingdom,NA,South East,9175033,7,0,32,1
2020-03-05,United Kingdom,NA,South East,9175033,4,2,36,3
2020-03-06,United Kingdom,NA,South East,9175033,16,0,52,3
2020-03-07,United Kingdom,NA,South East,9175033,5,0,57,3
2020-03-08,United Kingdom,NA,South East,9175033,10,1,67,4
2020-03-09,United Kingdom,NA,South East,9175033,24,1,91,5
2020-03-10,United Kingdom,NA,South East,9175033,34,1,125,6
2020-03-11,United Kingdom,NA,South East,9175033,50,1,175,7
2020-03-12,United Kingdom,NA,South East,9175033,85,0,260,7
2020-03-13,United Kingdom,NA,South East,9175033,53,2,313,9
2020-03-14,United Kingdom,NA,South East,9175033,41,3,354,12
2020-03-15,United Kingdom,NA,South East,9175033,53,7,407,19
2020-03-16,United Kingdom,NA,South East,9175033,78,8,485,27
2020-03-17,United Kingdom,NA,South East,9175033,89,8,574,35
2020-03-18,United Kingdom,NA,South East,9175033,122,13,696,48
2020-03-19,United Kingdom,NA,South East,9175033,127,8,823,56
2020-03-20,United Kingdom,NA,South East,9175033,126,15,949,71
2020-03-21,United Kingdom,NA,South East,9175033,129,14,1078,85
2020-03-22,United Kingdom,NA,South East,9175033,169,28,1247,113
2020-03-23,United Kingdom,NA,South East,9175033,281,24,1528,137
2020-03-24,United Kingdom,NA,South East,9175033,235,30,1763,167
2020-03-25,United Kingdom,NA,South East,9175033,305,40,2068,207
2020-03-26,United Kingdom,NA,South East,9175033,320,44,2388,251
2020-03-27,United Kingdom,NA,South East,9175033,331,47,2719,298
2020-03-28,United Kingdom,NA,South East,9175033,339,38,3058,336
2020-03-29,United Kingdom,NA,South East,9175033,296,62,3354,398
2020-03-30,United Kingdom,NA,South East,9175033,476,68,3830,466
2020-03-31,United Kingdom,NA,South East,9175033,471,70,4301,536
2020-04-01,United Kingdom,NA,South East,9175033,546,85,4847,621
2020-04-02,United Kingdom,NA,South East,9175033,485,79,5332,700
2020-04-03,United Kingdom,NA,South East,9175033,519,84,5851,784
2020-04-04,United Kingdom,NA,South East,9175033,456,113,6307,897
2020-04-05,United Kingdom,NA,South East,9175033,424,104,6731,1001
2020-04-06,United Kingdom,NA,South East,9175033,592,104,7323,1105
2020-04-07,United Kingdom,NA,South East,9175033,716,118,8039,1223
2020-04-08,United Kingdom,NA,South East,9175033,566,113,8605,1336
2020-04-09,United Kingdom,NA,South East,9175033,522,128,9127,1464
2020-04-10,United Kingdom,NA,South East,9175033,576,110,9703,1574
2020-04-11,United Kingdom,NA,South East,9175033,382,110,10085,1684
2020-04-12,United Kingdom,NA,South East,9175033,484,117,10569,1801
2020-04-13,United Kingdom,NA,South East,9175033,576,104,11145,1905
2020-04-14,United Kingdom,NA,South East,9175033,553,94,11698,1999
2020-04-15,United Kingdom,NA,South East,9175033,710,93,12408,2092
2020-04-16,United Kingdom,NA,South East,9175033,655,87,13063,2179
2020-04-17,United Kingdom,NA,South East,9175033,705,108,13768,2287
2020-04-18,United Kingdom,NA,South East,9175033,523,77,14291,2364
2020-04-19,United Kingdom,NA,South East,9175033,414,106,14705,2470
2020-04-20,United Kingdom,NA,South East,9175033,489,113,15194,2583
2020-04-21,United Kingdom,NA,South East,9175033,633,90,15827,2673
2020-04-22,United Kingdom,NA,South East,9175033,693,83,16520,2756
2020-04-23,United Kingdom,NA,South East,9175033,684,89,17204,2845
2020-04-24,United Kingdom,NA,South East,9175033,656,92,17860,2937
2020-04-25,United Kingdom,NA,South East,9175033,518,90,18378,3027
2020-04-26,United Kingdom,NA,South East,9175033,501,76,18879,3103
2020-04-27,United Kingdom,NA,South East,9175033,555,59,19434,3162
2020-04-28,United Kingdom,NA,South East,9175033,657,68,20091,3230
2020-04-29,United Kingdom,NA,South East,9175033,690,70,20781,3300
2020-04-30,United Kingdom,NA,South East,9175033,651,52,21432,3352
2020-05-01,United Kingdom,NA,South East,9175033,521,76,21953,3428
2020-05-02,United Kingdom,NA,South East,9175033,417,54,22370,3482
2020-05-03,United Kingdom,NA,South East,9175033,363,33,22733,3515
2020-05-04,United Kingdom,NA,South East,9175033,489,58,23222,3573
2020-05-05,United Kingdom,NA,South East,9175033,473,52,23695,3625
2020-05-06,United Kingdom,NA,South East,9175033,444,43,24139,3668
2020-05-07,United Kingdom,NA,South East,9175033,419,47,24558,3715
2020-05-08,United Kingdom,NA,South East,9175033,354,43,24912,3758
2020-05-09,United Kingdom,NA,South East,9175033,248,55,25160,3813
2020-05-10,United Kingdom,NA,South East,9175033,309,32,25469,3845
2020-05-11,United Kingdom,NA,South East,9175033,481,39,25950,3884
2020-05-12,United Kingdom,NA,South East,9175033,412,46,26362,3930
2020-05-13,United Kingdom,NA,South East,9175033,484,37,26846,3967
2020-05-14,United Kingdom,NA,South East,9175033,294,49,27140,4016
2020-05-15,United Kingdom,NA,South East,9175033,262,39,27402,4055
2020-05-16,United Kingdom,NA,South East,9175033,192,34,27594,4089
2020-05-17,United Kingdom,NA,South East,9175033,223,29,27817,4118
2020-05-18,United Kingdom,NA,South East,9175033,362,31,28179,4149
2020-05-19,United Kingdom,NA,South East,9175033,385,29,28564,4178
2020-05-20,United Kingdom,NA,South East,9175033,343,38,28907,4216
2020-05-21,United Kingdom,NA,South East,9175033,303,18,29210,4234
2020-05-22,United Kingdom,NA,South East,9175033,246,38,29456,4272
2020-05-23,United Kingdom,NA,South East,9175033,121,32,29577,4304
2020-05-24,United Kingdom,NA,South East,9175033,150,26,29727,4330
2020-05-25,United Kingdom,NA,South East,9175033,188,17,29915,4347
2020-05-26,United Kingdom,NA,South East,9175033,180,27,30095,4374
2020-05-27,United Kingdom,NA,South East,9175033,203,24,30298,4398
2020-05-28,United Kingdom,NA,South East,9175033,202,22,30500,4420
2020-05-29,United Kingdom,NA,South East,9175033,163,24,30663,4444
2020-05-30,United Kingdom,NA,South East,9175033,131,23,30794,4467
2020-05-31,United Kingdom,NA,South East,9175033,134,19,30928,4486
2020-06-01,United Kingdom,NA,South East,9175033,185,19,31113,4505
2020-06-02,United Kingdom,NA,South East,9175033,221,26,31334,4531
2020-06-03,United Kingdom,NA,South East,9175033,137,22,31471,4553
2020-06-04,United Kingdom,NA,South East,9175033,158,18,31629,4571
2020-06-05,United Kingdom,NA,South East,9175033,140,15,31769,4586
2020-06-06,United Kingdom,NA,South East,9175033,85,11,31854,4597
2020-06-07,United Kingdom,NA,South East,9175033,61,15,31915,4612
2020-06-08,United Kingdom,NA,South East,9175033,123,12,32038,4624
2020-06-09,United Kingdom,NA,South East,9175033,113,17,32151,4641
2020-06-10,United Kingdom,NA,South East,9175033,127,14,32278,4655
2020-06-11,United Kingdom,NA,South East,9175033,93,9,32371,4664
2020-06-12,United Kingdom,NA,South East,9175033,86,8,32457,4672
2020-06-13,United Kingdom,NA,South East,9175033,66,11,32523,4683
2020-06-14,United Kingdom,NA,South East,9175033,72,9,32595,4692
2020-06-15,United Kingdom,NA,South East,9175033,99,8,32694,4700
2020-06-16,United Kingdom,NA,South East,9175033,97,13,32791,4713
2020-06-17,United Kingdom,NA,South East,9175033,82,10,32873,4723
2020-06-18,United Kingdom,NA,South East,9175033,75,4,32948,4727
2020-06-19,United Kingdom,NA,South East,9175033,80,9,33028,4736
2020-06-20,United Kingdom,NA,South East,9175033,65,7,33093,4743
2020-06-21,United Kingdom,NA,South East,9175033,67,6,33160,4749
2020-06-22,United Kingdom,NA,South East,9175033,78,6,33238,4755
2020-06-23,United Kingdom,NA,South East,9175033,60,7,33298,4762
2020-06-24,United Kingdom,NA,South East,9175033,44,10,33342,4772
2020-06-25,United Kingdom,NA,South East,9175033,64,9,33406,4781
2020-06-26,United Kingdom,NA,South East,9175033,66,8,33472,4789
2020-06-27,United Kingdom,NA,South East,9175033,54,8,33526,4797
2020-06-28,United Kingdom,NA,South East,9175033,45,8,33571,4805
2020-06-29,United Kingdom,NA,South East,9175033,79,5,33650,4810
2020-06-30,United Kingdom,NA,South East,9175033,57,5,33707,4815
2020-07-01,United Kingdom,NA,South East,9175033,70,5,33777,4820
2020-07-02,United Kingdom,NA,South East,9175033,61,7,33838,4827
2020-07-03,United Kingdom,NA,South East,9175033,61,4,33899,4831
2020-07-04,United Kingdom,NA,South East,9175033,29,10,33928,4841
2020-07-05,United Kingdom,NA,South East,9175033,58,3,33986,4844
2020-07-06,United Kingdom,NA,South East,9175033,45,6,34031,4850
2020-07-07,United Kingdom,NA,South East,9175033,55,5,34086,4855
2020-07-08,United Kingdom,NA,South East,9175033,82,5,34168,4860
2020-07-09,United Kingdom,NA,South East,9175033,82,9,34250,4869
2020-07-10,United Kingdom,NA,South East,9175033,76,5,34326,4874
2020-07-11,United Kingdom,NA,South East,9175033,34,6,34360,4880
2020-07-12,United Kingdom,NA,South East,9175033,31,3,34391,4883
2020-07-13,United Kingdom,NA,South East,9175033,69,5,34460,4888
2020-07-14,United Kingdom,NA,South East,9175033,59,7,34519,4895
2020-07-15,United Kingdom,NA,South East,9175033,63,4,34582,4899
2020-07-16,United Kingdom,NA,South East,9175033,63,3,34645,4902
2020-07-17,United Kingdom,NA,South East,9175033,49,4,34694,4906
2020-07-18,United Kingdom,NA,South East,9175033,54,3,34748,4909
2020-07-19,United Kingdom,NA,South East,9175033,46,4,34794,4913
2020-07-20,United Kingdom,NA,South East,9175033,87,4,34881,4917
2020-07-21,United Kingdom,NA,South East,9175033,77,5,34958,4922
2020-07-22,United Kingdom,NA,South East,9175033,77,2,35035,4924
2020-07-23,United Kingdom,NA,South East,9175033,76,3,35111,4927
2020-07-24,United Kingdom,NA,South East,9175033,65,1,35176,4928
2020-07-25,United Kingdom,NA,South East,9175033,47,2,35223,4930
2020-07-26,United Kingdom,NA,South East,9175033,37,3,35260,4933
2020-07-27,United Kingdom,NA,South East,9175033,85,1,35345,4934
2020-07-28,United Kingdom,NA,South East,9175033,65,4,35410,4938
2020-07-29,United Kingdom,NA,South East,9175033,79,3,35489,4941
2020-07-30,United Kingdom,NA,South East,9175033,63,1,35552,4942
2020-07-31,United Kingdom,NA,South East,9175033,41,5,35593,4947
2020-08-01,United Kingdom,NA,South East,9175033,30,2,35623,4949
2020-08-02,United Kingdom,NA,South East,9175033,21,2,35644,4951
2020-08-03,United Kingdom,NA,South East,9175033,76,2,35720,4953
2020-08-04,United Kingdom,NA,South East,9175033,66,0,35786,4953
2020-08-05,United Kingdom,NA,South East,9175033,65,2,35851,4955
2020-08-06,United Kingdom,NA,South East,9175033,61,3,35912,4958
2020-08-07,United Kingdom,NA,South East,9175033,54,0,35966,4958
2020-08-08,United Kingdom,NA,South East,9175033,31,1,35997,4959
2020-08-09,United Kingdom,NA,South East,9175033,29,2,36026,4961
2020-08-10,United Kingdom,NA,South East,9175033,113,4,36139,4965
2020-08-11,United Kingdom,NA,South East,9175033,76,0,36215,4965
2020-08-12,United Kingdom,NA,South East,9175033,83,0,36298,4965
2020-08-13,United Kingdom,NA,South East,9175033,76,1,36374,4966
2020-08-14,United Kingdom,NA,South East,9175033,95,2,36469,4968
2020-08-15,United Kingdom,NA,South East,9175033,46,1,36515,4969
2020-08-16,United Kingdom,NA,South East,9175033,36,1,36551,4970
2020-08-17,United Kingdom,NA,South East,9175033,109,0,36660,4970
2020-08-18,United Kingdom,NA,South East,9175033,78,1,36738,4971
2020-08-19,United Kingdom,NA,South East,9175033,115,0,36853,4971
2020-08-20,United Kingdom,NA,South East,9175033,130,1,36983,4972
2020-08-21,United Kingdom,NA,South East,9175033,110,0,37093,4972
2020-08-22,United Kingdom,NA,South East,9175033,78,0,37171,4972
2020-08-23,United Kingdom,NA,South East,9175033,85,1,37256,4973
2020-08-24,United Kingdom,NA,South East,9175033,93,0,37349,4973
2020-08-25,United Kingdom,NA,South East,9175033,89,2,37438,4975
2020-08-26,United Kingdom,NA,South East,9175033,115,0,37553,4975
2020-08-27,United Kingdom,NA,South East,9175033,127,3,37680,4978
2020-08-28,United Kingdom,NA,South East,9175033,115,1,37795,4979
2020-08-29,United Kingdom,NA,South East,9175033,101,1,37896,4980
2020-08-30,United Kingdom,NA,South East,9175033,100,0,37996,4980
2020-08-31,United Kingdom,NA,South East,9175033,117,2,38113,4982
2020-09-01,United Kingdom,NA,South East,9175033,130,1,38243,4983
2020-09-02,United Kingdom,NA,South East,9175033,209,1,38452,4984
2020-09-03,United Kingdom,NA,South East,9175033,226,1,38678,4985
2020-09-04,United Kingdom,NA,South East,9175033,232,1,38910,4986
2020-09-05,United Kingdom,NA,South East,9175033,160,0,39070,4986
2020-09-06,United Kingdom,NA,South East,9175033,180,0,39250,4986
2020-09-07,United Kingdom,NA,South East,9175033,204,0,39454,4986
2020-09-08,United Kingdom,NA,South East,9175033,192,0,39646,4986
2020-09-09,United Kingdom,NA,South East,9175033,170,0,39816,4986
2020-09-10,United Kingdom,NA,South East,9175033,211,1,40027,4987
2020-09-11,United Kingdom,NA,South East,9175033,166,0,40193,4987
2020-09-12,United Kingdom,NA,South East,9175033,140,2,40333,4989
2020-09-13,United Kingdom,NA,South East,9175033,68,2,40401,4991
2020-09-14,United Kingdom,NA,South East,9175033,153,1,40554,4992
2020-09-15,United Kingdom,NA,South East,9175033,141,2,40695,4994
2020-09-16,United Kingdom,NA,South East,9175033,143,2,40838,4996
2020-09-17,United Kingdom,NA,South East,9175033,163,1,41001,4997
2020-09-18,United Kingdom,NA,South East,9175033,180,1,41181,4998
2020-09-19,United Kingdom,NA,South East,9175033,172,3,41353,5001
2020-09-20,United Kingdom,NA,South East,9175033,160,0,41513,5001
2020-09-21,United Kingdom,NA,South East,9175033,176,1,41689,5002
2020-09-22,United Kingdom,NA,South East,9175033,153,0,41842,5002
2020-09-23,United Kingdom,NA,South East,9175033,5,1,41847,5003
2020-03-02,United Kingdom,NA,South West,5616381,8,0,13,0
2020-03-03,United Kingdom,NA,South West,5616381,10,0,23,0
2020-03-04,United Kingdom,NA,South West,5616381,6,0,29,0
2020-03-05,United Kingdom,NA,South West,5616381,4,0,33,0
2020-03-06,United Kingdom,NA,South West,5616381,11,0,44,0
2020-03-07,United Kingdom,NA,South West,5616381,4,0,48,0
2020-03-08,United Kingdom,NA,South West,5616381,3,0,51,0
2020-03-09,United Kingdom,NA,South West,5616381,5,1,56,1
2020-03-10,United Kingdom,NA,South West,5616381,10,0,66,1
2020-03-11,United Kingdom,NA,South West,5616381,14,1,80,2
2020-03-12,United Kingdom,NA,South West,5616381,18,0,98,2
2020-03-13,United Kingdom,NA,South West,5616381,30,0,128,2
2020-03-14,United Kingdom,NA,South West,5616381,10,1,138,3
2020-03-15,United Kingdom,NA,South West,5616381,17,1,155,4
2020-03-16,United Kingdom,NA,South West,5616381,18,0,173,4
2020-03-17,United Kingdom,NA,South West,5616381,21,2,194,6
2020-03-18,United Kingdom,NA,South West,5616381,43,4,237,10
2020-03-19,United Kingdom,NA,South West,5616381,21,4,258,14
2020-03-20,United Kingdom,NA,South West,5616381,43,3,301,17
2020-03-21,United Kingdom,NA,South West,5616381,42,8,343,25
2020-03-22,United Kingdom,NA,South West,5616381,44,6,387,31
2020-03-23,United Kingdom,NA,South West,5616381,62,9,449,40
2020-03-24,United Kingdom,NA,South West,5616381,68,6,517,46
2020-03-25,United Kingdom,NA,South West,5616381,104,10,621,56
2020-03-26,United Kingdom,NA,South West,5616381,119,11,740,67
2020-03-27,United Kingdom,NA,South West,5616381,129,13,869,80
2020-03-28,United Kingdom,NA,South West,5616381,102,23,971,103
2020-03-29,United Kingdom,NA,South West,5616381,101,24,1072,127
2020-03-30,United Kingdom,NA,South West,5616381,163,28,1235,155
2020-03-31,United Kingdom,NA,South West,5616381,140,26,1375,181
2020-04-01,United Kingdom,NA,South West,5616381,183,24,1558,205
2020-04-02,United Kingdom,NA,South West,5616381,183,31,1741,236
2020-04-03,United Kingdom,NA,South West,5616381,187,32,1928,268
2020-04-04,United Kingdom,NA,South West,5616381,174,41,2102,309
2020-04-05,United Kingdom,NA,South West,5616381,153,37,2255,346
2020-04-06,United Kingdom,NA,South West,5616381,186,42,2441,388
2020-04-07,United Kingdom,NA,South West,5616381,212,45,2653,433
2020-04-08,United Kingdom,NA,South West,5616381,236,51,2889,484
2020-04-09,United Kingdom,NA,South West,5616381,246,31,3135,515
2020-04-10,United Kingdom,NA,South West,5616381,234,62,3369,577
2020-04-11,United Kingdom,NA,South West,5616381,173,42,3542,619
2020-04-12,United Kingdom,NA,South West,5616381,178,37,3720,656
2020-04-13,United Kingdom,NA,South West,5616381,194,45,3914,701
2020-04-14,United Kingdom,NA,South West,5616381,185,35,4099,736
2020-04-15,United Kingdom,NA,South West,5616381,211,41,4310,777
2020-04-16,United Kingdom,NA,South West,5616381,262,38,4572,815
2020-04-17,United Kingdom,NA,South West,5616381,240,49,4812,864
2020-04-18,United Kingdom,NA,South West,5616381,168,41,4980,905
2020-04-19,United Kingdom,NA,South West,5616381,201,49,5181,954
2020-04-20,United Kingdom,NA,South West,5616381,183,41,5364,995
2020-04-21,United Kingdom,NA,South West,5616381,227,46,5591,1041
2020-04-22,United Kingdom,NA,South West,5616381,286,31,5877,1072
2020-04-23,United Kingdom,NA,South West,5616381,281,35,6158,1107
2020-04-24,United Kingdom,NA,South West,5616381,250,37,6408,1144
2020-04-25,United Kingdom,NA,South West,5616381,200,27,6608,1171
2020-04-26,United Kingdom,NA,South West,5616381,254,37,6862,1208
2020-04-27,United Kingdom,NA,South West,5616381,321,33,7183,1241
2020-04-28,United Kingdom,NA,South West,5616381,276,28,7459,1269
2020-04-29,United Kingdom,NA,South West,5616381,348,33,7807,1302
2020-04-30,United Kingdom,NA,South West,5616381,244,38,8051,1340
2020-05-01,United Kingdom,NA,South West,5616381,264,11,8315,1351
2020-05-02,United Kingdom,NA,South West,5616381,208,24,8523,1375
2020-05-03,United Kingdom,NA,South West,5616381,176,19,8699,1394
2020-05-04,United Kingdom,NA,South West,5616381,166,30,8865,1424
2020-05-05,United Kingdom,NA,South West,5616381,173,31,9038,1455
2020-05-06,United Kingdom,NA,South West,5616381,201,32,9239,1487
2020-05-07,United Kingdom,NA,South West,5616381,180,29,9419,1516
2020-05-08,United Kingdom,NA,South West,5616381,178,14,9597,1530
2020-05-09,United Kingdom,NA,South West,5616381,106,24,9703,1554
2020-05-10,United Kingdom,NA,South West,5616381,134,13,9837,1567
2020-05-11,United Kingdom,NA,South West,5616381,255,12,10092,1579
2020-05-12,United Kingdom,NA,South West,5616381,177,6,10269,1585
2020-05-13,United Kingdom,NA,South West,5616381,176,15,10445,1600
2020-05-14,United Kingdom,NA,South West,5616381,93,13,10538,1613
2020-05-15,United Kingdom,NA,South West,5616381,103,7,10641,1620
2020-05-16,United Kingdom,NA,South West,5616381,91,10,10732,1630
2020-05-17,United Kingdom,NA,South West,5616381,97,11,10829,1641
2020-05-18,United Kingdom,NA,South West,5616381,119,10,10948,1651
2020-05-19,United Kingdom,NA,South West,5616381,108,14,11056,1665
2020-05-20,United Kingdom,NA,South West,5616381,137,9,11193,1674
2020-05-21,United Kingdom,NA,South West,5616381,87,10,11280,1684
2020-05-22,United Kingdom,NA,South West,5616381,82,10,11362,1694
2020-05-23,United Kingdom,NA,South West,5616381,41,11,11403,1705
2020-05-24,United Kingdom,NA,South West,5616381,59,8,11462,1713
2020-05-25,United Kingdom,NA,South West,5616381,61,11,11523,1724
2020-05-26,United Kingdom,NA,South West,5616381,81,12,11604,1736
2020-05-27,United Kingdom,NA,South West,5616381,104,8,11708,1744
2020-05-28,United Kingdom,NA,South West,5616381,115,13,11823,1757
2020-05-29,United Kingdom,NA,South West,5616381,73,11,11896,1768
2020-05-30,United Kingdom,NA,South West,5616381,51,6,11947,1774
2020-05-31,United Kingdom,NA,South West,5616381,62,5,12009,1779
2020-06-01,United Kingdom,NA,South West,5616381,51,8,12060,1787
2020-06-02,United Kingdom,NA,South West,5616381,51,4,12111,1791
2020-06-03,United Kingdom,NA,South West,5616381,69,8,12180,1799
2020-06-04,United Kingdom,NA,South West,5616381,65,6,12245,1805
2020-06-05,United Kingdom,NA,South West,5616381,51,3,12296,1808
2020-06-06,United Kingdom,NA,South West,5616381,23,3,12319,1811
2020-06-07,United Kingdom,NA,South West,5616381,18,10,12337,1821
2020-06-08,United Kingdom,NA,South West,5616381,23,4,12360,1825
2020-06-09,United Kingdom,NA,South West,5616381,25,1,12385,1826
2020-06-10,United Kingdom,NA,South West,5616381,31,4,12416,1830
2020-06-11,United Kingdom,NA,South West,5616381,25,4,12441,1834
2020-06-12,United Kingdom,NA,South West,5616381,19,2,12460,1836
2020-06-13,United Kingdom,NA,South West,5616381,14,2,12474,1838
2020-06-14,United Kingdom,NA,South West,5616381,9,2,12483,1840
2020-06-15,United Kingdom,NA,South West,5616381,20,2,12503,1842
2020-06-16,United Kingdom,NA,South West,5616381,15,4,12518,1846
2020-06-17,United Kingdom,NA,South West,5616381,16,2,12534,1848
2020-06-18,United Kingdom,NA,South West,5616381,13,1,12547,1849
2020-06-19,United Kingdom,NA,South West,5616381,24,1,12571,1850
2020-06-20,United Kingdom,NA,South West,5616381,8,1,12579,1851
2020-06-21,United Kingdom,NA,South West,5616381,8,2,12587,1853
2020-06-22,United Kingdom,NA,South West,5616381,19,1,12606,1854
2020-06-23,United Kingdom,NA,South West,5616381,15,4,12621,1858
2020-06-24,United Kingdom,NA,South West,5616381,16,2,12637,1860
2020-06-25,United Kingdom,NA,South West,5616381,8,0,12645,1860
2020-06-26,United Kingdom,NA,South West,5616381,12,1,12657,1861
2020-06-27,United Kingdom,NA,South West,5616381,8,0,12665,1861
2020-06-28,United Kingdom,NA,South West,5616381,11,0,12676,1861
2020-06-29,United Kingdom,NA,South West,5616381,16,1,12692,1862
2020-06-30,United Kingdom,NA,South West,5616381,18,3,12710,1865
2020-07-01,United Kingdom,NA,South West,5616381,23,0,12733,1865
2020-07-02,United Kingdom,NA,South West,5616381,11,0,12744,1865
2020-07-03,United Kingdom,NA,South West,5616381,8,1,12752,1866
2020-07-04,United Kingdom,NA,South West,5616381,10,0,12762,1866
2020-07-05,United Kingdom,NA,South West,5616381,17,1,12779,1867
2020-07-06,United Kingdom,NA,South West,5616381,22,0,12801,1867
2020-07-07,United Kingdom,NA,South West,5616381,17,0,12818,1867
2020-07-08,United Kingdom,NA,South West,5616381,15,0,12833,1867
2020-07-09,United Kingdom,NA,South West,5616381,17,0,12850,1867
2020-07-10,United Kingdom,NA,South West,5616381,13,1,12863,1868
2020-07-11,United Kingdom,NA,South West,5616381,6,0,12869,1868
2020-07-12,United Kingdom,NA,South West,5616381,5,0,12874,1868
2020-07-13,United Kingdom,NA,South West,5616381,18,1,12892,1869
2020-07-14,United Kingdom,NA,South West,5616381,19,0,12911,1869
2020-07-15,United Kingdom,NA,South West,5616381,17,1,12928,1870
2020-07-16,United Kingdom,NA,South West,5616381,27,1,12955,1871
2020-07-17,United Kingdom,NA,South West,5616381,20,0,12975,1871
2020-07-18,United Kingdom,NA,South West,5616381,12,1,12987,1872
2020-07-19,United Kingdom,NA,South West,5616381,9,1,12996,1873
2020-07-20,United Kingdom,NA,South West,5616381,23,0,13019,1873
2020-07-21,United Kingdom,NA,South West,5616381,35,2,13054,1875
2020-07-22,United Kingdom,NA,South West,5616381,30,0,13084,1875
2020-07-23,United Kingdom,NA,South West,5616381,39,0,13123,1875
2020-07-24,United Kingdom,NA,South West,5616381,34,0,13157,1875
2020-07-25,United Kingdom,NA,South West,5616381,17,0,13174,1875
2020-07-26,United Kingdom,NA,South West,5616381,20,0,13194,1875
2020-07-27,United Kingdom,NA,South West,5616381,40,0,13234,1875
2020-07-28,United Kingdom,NA,South West,5616381,34,0,13268,1875
2020-07-29,United Kingdom,NA,South West,5616381,53,0,13321,1875
2020-07-30,United Kingdom,NA,South West,5616381,63,1,13384,1876
2020-07-31,United Kingdom,NA,South West,5616381,29,0,13413,1876
2020-08-01,United Kingdom,NA,South West,5616381,9,0,13422,1876
2020-08-02,United Kingdom,NA,South West,5616381,9,0,13431,1876
2020-08-03,United Kingdom,NA,South West,5616381,43,0,13474,1876
2020-08-04,United Kingdom,NA,South West,5616381,54,1,13528,1877
2020-08-05,United Kingdom,NA,South West,5616381,40,0,13568,1877
2020-08-06,United Kingdom,NA,South West,5616381,45,0,13613,1877
2020-08-07,United Kingdom,NA,South West,5616381,42,0,13655,1877
2020-08-08,United Kingdom,NA,South West,5616381,25,0,13680,1877
2020-08-09,United Kingdom,NA,South West,5616381,15,0,13695,1877
2020-08-10,United Kingdom,NA,South West,5616381,42,0,13737,1877
2020-08-11,United Kingdom,NA,South West,5616381,41,0,13778,1877
2020-08-12,United Kingdom,NA,South West,5616381,42,1,13820,1878
2020-08-13,United Kingdom,NA,South West,5616381,53,0,13873,1878
2020-08-14,United Kingdom,NA,South West,5616381,55,1,13928,1879
2020-08-15,United Kingdom,NA,South West,5616381,25,0,13953,1879
2020-08-16,United Kingdom,NA,South West,5616381,37,0,13990,1879
2020-08-17,United Kingdom,NA,South West,5616381,48,2,14038,1881
2020-08-18,United Kingdom,NA,South West,5616381,58,0,14096,1881
2020-08-19,United Kingdom,NA,South West,5616381,69,0,14165,1881
2020-08-20,United Kingdom,NA,South West,5616381,85,1,14250,1882
2020-08-21,United Kingdom,NA,South West,5616381,64,0,14314,1882
2020-08-22,United Kingdom,NA,South West,5616381,39,0,14353,1882
2020-08-23,United Kingdom,NA,South West,5616381,41,1,14394,1883
2020-08-24,United Kingdom,NA,South West,5616381,49,0,14443,1883
2020-08-25,United Kingdom,NA,South West,5616381,50,1,14493,1884
2020-08-26,United Kingdom,NA,South West,5616381,62,0,14555,1884
2020-08-27,United Kingdom,NA,South West,5616381,57,1,14612,1885
2020-08-28,United Kingdom,NA,South West,5616381,72,1,14684,1886
2020-08-29,United Kingdom,NA,South West,5616381,50,0,14734,1886
2020-08-30,United Kingdom,NA,South West,5616381,33,0,14767,1886
2020-08-31,United Kingdom,NA,South West,5616381,57,0,14824,1886
2020-09-01,United Kingdom,NA,South West,5616381,99,0,14923,1886
2020-09-02,United Kingdom,NA,South West,5616381,123,0,15046,1886
2020-09-03,United Kingdom,NA,South West,5616381,150,0,15196,1886
2020-09-04,United Kingdom,NA,South West,5616381,134,1,15330,1887
2020-09-05,United Kingdom,NA,South West,5616381,82,1,15412,1888
2020-09-06,United Kingdom,NA,South West,5616381,78,0,15490,1888
2020-09-07,United Kingdom,NA,South West,5616381,105,0,15595,1888
2020-09-08,United Kingdom,NA,South West,5616381,81,0,15676,1888
2020-09-09,United Kingdom,NA,South West,5616381,76,0,15752,1888
2020-09-10,United Kingdom,NA,South West,5616381,92,1,15844,1889
2020-09-11,United Kingdom,NA,South West,5616381,98,0,15942,1889
2020-09-12,United Kingdom,NA,South West,5616381,63,0,16005,1889
2020-09-13,United Kingdom,NA,South West,5616381,58,1,16063,1890
2020-09-14,United Kingdom,NA,South West,5616381,80,0,16143,1890
2020-09-15,United Kingdom,NA,South West,5616381,89,2,16232,1892
2020-09-16,United Kingdom,NA,South West,5616381,75,0,16307,1892
2020-09-17,United Kingdom,NA,South West,5616381,113,1,16420,1893
2020-09-18,United Kingdom,NA,South West,5616381,115,1,16535,1894
2020-09-19,United Kingdom,NA,South West,5616381,129,0,16664,1894
2020-09-20,United Kingdom,NA,South West,5616381,131,1,16795,1895
2020-09-21,United Kingdom,NA,South West,5616381,125,0,16920,1895
2020-09-22,United Kingdom,NA,South West,5616381,68,0,16988,1895
2020-09-23,United Kingdom,NA,South West,5616381,4,0,16992,1895
2020-03-10,United Kingdom,NA,Wales,3136383,12,0,20,0
2020-03-11,United Kingdom,NA,Wales,3136383,15,0,35,0
2020-03-12,United Kingdom,NA,Wales,3136383,25,0,60,0
2020-03-13,United Kingdom,NA,Wales,3136383,28,0,88,0
2020-03-14,United Kingdom,NA,Wales,3136383,19,0,107,0
2020-03-15,United Kingdom,NA,Wales,3136383,32,0,139,0
2020-03-16,United Kingdom,NA,Wales,3136383,37,3,176,3
2020-03-17,United Kingdom,NA,Wales,3136383,37,0,213,3
2020-03-18,United Kingdom,NA,Wales,3136383,36,0,249,3
2020-03-19,United Kingdom,NA,Wales,3136383,60,3,309,6
2020-03-20,United Kingdom,NA,Wales,3136383,73,2,382,8
2020-03-21,United Kingdom,NA,Wales,3136383,75,7,457,15
2020-03-22,United Kingdom,NA,Wales,3136383,76,5,533,20
2020-03-23,United Kingdom,NA,Wales,3136383,133,4,666,24
2020-03-24,United Kingdom,NA,Wales,3136383,141,9,807,33
2020-03-25,United Kingdom,NA,Wales,3136383,190,10,997,43
2020-03-26,United Kingdom,NA,Wales,3136383,177,11,1174,54
2020-03-27,United Kingdom,NA,Wales,3136383,193,10,1367,64
2020-03-28,United Kingdom,NA,Wales,3136383,167,15,1534,79
2020-03-29,United Kingdom,NA,Wales,3136383,159,18,1693,97
2020-03-30,United Kingdom,NA,Wales,3136383,343,16,2036,113
2020-03-31,United Kingdom,NA,Wales,3136383,277,15,2313,128
2020-04-01,United Kingdom,NA,Wales,3136383,327,21,2640,149
2020-04-02,United Kingdom,NA,Wales,3136383,336,28,2976,177
2020-04-03,United Kingdom,NA,Wales,3136383,330,29,3306,206
2020-04-04,United Kingdom,NA,Wales,3136383,282,31,3588,237
2020-04-05,United Kingdom,NA,Wales,3136383,223,30,3811,267
2020-04-06,United Kingdom,NA,Wales,3136383,383,20,4194,287
2020-04-07,United Kingdom,NA,Wales,3136383,386,32,4580,319
2020-04-08,United Kingdom,NA,Wales,3136383,386,42,4966,361
2020-04-09,United Kingdom,NA,Wales,3136383,391,43,5357,404
2020-04-10,United Kingdom,NA,Wales,3136383,308,25,5665,429
2020-04-11,United Kingdom,NA,Wales,3136383,247,31,5912,460
2020-04-12,United Kingdom,NA,Wales,3136383,247,37,6159,497
2020-04-13,United Kingdom,NA,Wales,3136383,273,43,6432,540
2020-04-14,United Kingdom,NA,Wales,3136383,317,26,6749,566
2020-04-15,United Kingdom,NA,Wales,3136383,361,38,7110,604
2020-04-16,United Kingdom,NA,Wales,3136383,363,35,7473,639
2020-04-17,United Kingdom,NA,Wales,3136383,324,29,7797,668
2020-04-18,United Kingdom,NA,Wales,3136383,247,32,8044,700
2020-04-19,United Kingdom,NA,Wales,3136383,181,26,8225,726
2020-04-20,United Kingdom,NA,Wales,3136383,281,25,8506,751
2020-04-21,United Kingdom,NA,Wales,3136383,259,30,8765,781
2020-04-22,United Kingdom,NA,Wales,3136383,253,23,9018,804
2020-04-23,United Kingdom,NA,Wales,3136383,201,18,9219,822
2020-04-24,United Kingdom,NA,Wales,3136383,213,31,9432,853
2020-04-25,United Kingdom,NA,Wales,3136383,136,29,9568,882
2020-04-26,United Kingdom,NA,Wales,3136383,121,16,9689,898
2020-04-27,United Kingdom,NA,Wales,3136383,172,16,9861,914
2020-04-28,United Kingdom,NA,Wales,3136383,153,15,10014,929
2020-04-29,United Kingdom,NA,Wales,3136383,176,26,10190,955
2020-04-30,United Kingdom,NA,Wales,3136383,200,16,10390,971
2020-05-01,United Kingdom,NA,Wales,3136383,176,29,10566,1000
2020-05-02,United Kingdom,NA,Wales,3136383,179,14,10745,1014
2020-05-03,United Kingdom,NA,Wales,3136383,105,14,10850,1028
2020-05-04,United Kingdom,NA,Wales,3136383,139,23,10989,1051
2020-05-05,United Kingdom,NA,Wales,3136383,175,17,11164,1068
2020-05-06,United Kingdom,NA,Wales,3136383,171,23,11335,1091
2020-05-07,United Kingdom,NA,Wales,3136383,176,19,11511,1110
2020-05-08,United Kingdom,NA,Wales,3136383,115,13,11626,1123
2020-05-09,United Kingdom,NA,Wales,3136383,136,7,11762,1130
2020-05-10,United Kingdom,NA,Wales,3136383,107,10,11869,1140
2020-05-11,United Kingdom,NA,Wales,3136383,178,15,12047,1155
2020-05-12,United Kingdom,NA,Wales,3136383,150,11,12197,1166
2020-05-13,United Kingdom,NA,Wales,3136383,153,16,12350,1182
2020-05-14,United Kingdom,NA,Wales,3136383,132,12,12482,1194
2020-05-15,United Kingdom,NA,Wales,3136383,179,16,12661,1210
2020-05-16,United Kingdom,NA,Wales,3136383,166,13,12827,1223
2020-05-17,United Kingdom,NA,Wales,3136383,118,11,12945,1234
2020-05-18,United Kingdom,NA,Wales,3136383,168,10,13113,1244
2020-05-19,United Kingdom,NA,Wales,3136383,213,11,13326,1255
2020-05-20,United Kingdom,NA,Wales,3136383,166,7,13492,1262
2020-05-21,United Kingdom,NA,Wales,3136383,132,9,13624,1271
2020-05-22,United Kingdom,NA,Wales,3136383,137,10,13761,1281
2020-05-23,United Kingdom,NA,Wales,3136383,123,7,13884,1288
2020-05-24,United Kingdom,NA,Wales,3136383,82,12,13966,1300
2020-05-25,United Kingdom,NA,Wales,3136383,105,10,14071,1310
2020-05-26,United Kingdom,NA,Wales,3136383,102,10,14173,1320
2020-05-27,United Kingdom,NA,Wales,3136383,118,6,14291,1326
2020-05-28,United Kingdom,NA,Wales,3136383,102,16,14393,1342
2020-05-29,United Kingdom,NA,Wales,3136383,107,11,14500,1353
2020-05-30,United Kingdom,NA,Wales,3136383,70,10,14570,1363
2020-05-31,United Kingdom,NA,Wales,3136383,46,7,14616,1370
2020-06-01,United Kingdom,NA,Wales,3136383,64,9,14680,1379
2020-06-02,United Kingdom,NA,Wales,3136383,73,5,14753,1384
2020-06-03,United Kingdom,NA,Wales,3136383,75,7,14828,1391
2020-06-04,United Kingdom,NA,Wales,3136383,60,12,14888,1403
2020-06-05,United Kingdom,NA,Wales,3136383,55,4,14943,1407
2020-06-06,United Kingdom,NA,Wales,3136383,53,9,14996,1416
2020-06-07,United Kingdom,NA,Wales,3136383,34,8,15030,1424
2020-06-08,United Kingdom,NA,Wales,3136383,74,7,15104,1431
2020-06-09,United Kingdom,NA,Wales,3136383,62,4,15166,1435
2020-06-10,United Kingdom,NA,Wales,3136383,67,7,15233,1442
2020-06-11,United Kingdom,NA,Wales,3136383,66,5,15299,1447
2020-06-12,United Kingdom,NA,Wales,3136383,75,4,15374,1451
2020-06-13,United Kingdom,NA,Wales,3136383,70,6,15444,1457
2020-06-14,United Kingdom,NA,Wales,3136383,54,7,15498,1464
2020-06-15,United Kingdom,NA,Wales,3136383,66,6,15564,1470
2020-06-16,United Kingdom,NA,Wales,3136383,82,8,15646,1478
2020-06-17,United Kingdom,NA,Wales,3136383,64,1,15710,1479
2020-06-18,United Kingdom,NA,Wales,3136383,62,0,15772,1479
2020-06-19,United Kingdom,NA,Wales,3136383,140,4,15912,1483
2020-06-20,United Kingdom,NA,Wales,3136383,47,3,15959,1486
2020-06-21,United Kingdom,NA,Wales,3136383,76,5,16035,1491
2020-06-22,United Kingdom,NA,Wales,3136383,66,2,16101,1493
2020-06-23,United Kingdom,NA,Wales,3136383,131,1,16232,1494
2020-06-24,United Kingdom,NA,Wales,3136383,37,6,16269,1500
2020-06-25,United Kingdom,NA,Wales,3136383,60,9,16329,1509
2020-06-26,United Kingdom,NA,Wales,3136383,19,2,16348,1511
2020-06-27,United Kingdom,NA,Wales,3136383,140,6,16488,1517
2020-06-28,United Kingdom,NA,Wales,3136383,28,2,16516,1519
2020-06-29,United Kingdom,NA,Wales,3136383,43,3,16559,1522
2020-06-30,United Kingdom,NA,Wales,3136383,35,4,16594,1526
2020-07-01,United Kingdom,NA,Wales,3136383,27,4,16621,1530
2020-07-02,United Kingdom,NA,Wales,3136383,28,3,16649,1533
2020-07-03,United Kingdom,NA,Wales,3136383,19,0,16668,1533
2020-07-04,United Kingdom,NA,Wales,3136383,9,2,16677,1535
2020-07-05,United Kingdom,NA,Wales,3136383,12,2,16689,1537
2020-07-06,United Kingdom,NA,Wales,3136383,35,2,16724,1539
2020-07-07,United Kingdom,NA,Wales,3136383,28,1,16752,1540
2020-07-08,United Kingdom,NA,Wales,3136383,14,1,16766,1541
2020-07-09,United Kingdom,NA,Wales,3136383,22,1,16788,1542
2020-07-10,United Kingdom,NA,Wales,3136383,29,0,16817,1542
2020-07-11,United Kingdom,NA,Wales,3136383,12,1,16829,1543
2020-07-12,United Kingdom,NA,Wales,3136383,10,0,16839,1543
2020-07-13,United Kingdom,NA,Wales,3136383,24,2,16863,1545
2020-07-14,United Kingdom,NA,Wales,3136383,23,1,16886,1546
2020-07-15,United Kingdom,NA,Wales,3136383,18,0,16904,1546
2020-07-16,United Kingdom,NA,Wales,3136383,25,1,16929,1547
2020-07-17,United Kingdom,NA,Wales,3136383,17,0,16946,1547
2020-07-18,United Kingdom,NA,Wales,3136383,11,0,16957,1547
2020-07-19,United Kingdom,NA,Wales,3136383,10,0,16967,1547
2020-07-20,United Kingdom,NA,Wales,3136383,43,0,17010,1547
2020-07-21,United Kingdom,NA,Wales,3136383,61,1,17071,1548
2020-07-22,United Kingdom,NA,Wales,3136383,25,1,17096,1549
2020-07-23,United Kingdom,NA,Wales,3136383,31,0,17127,1549
2020-07-24,United Kingdom,NA,Wales,3136383,30,1,17157,1550
2020-07-25,United Kingdom,NA,Wales,3136383,24,2,17181,1552
2020-07-26,United Kingdom,NA,Wales,3136383,35,2,17216,1554
2020-07-27,United Kingdom,NA,Wales,3136383,23,1,17239,1555
2020-07-28,United Kingdom,NA,Wales,3136383,27,2,17266,1557
2020-07-29,United Kingdom,NA,Wales,3136383,27,4,17293,1561
2020-07-30,United Kingdom,NA,Wales,3136383,30,2,17323,1563
2020-07-31,United Kingdom,NA,Wales,3136383,16,4,17339,1567
2020-08-01,United Kingdom,NA,Wales,3136383,16,2,17355,1569
2020-08-02,United Kingdom,NA,Wales,3136383,14,2,17369,1571
2020-08-03,United Kingdom,NA,Wales,3136383,22,1,17391,1572
2020-08-04,United Kingdom,NA,Wales,3136383,24,4,17415,1576
2020-08-05,United Kingdom,NA,Wales,3136383,22,3,17437,1579
2020-08-06,United Kingdom,NA,Wales,3136383,22,0,17459,1579
2020-08-07,United Kingdom,NA,Wales,3136383,15,5,17474,1584
2020-08-08,United Kingdom,NA,Wales,3136383,5,2,17479,1586
2020-08-09,United Kingdom,NA,Wales,3136383,8,0,17487,1586
2020-08-10,United Kingdom,NA,Wales,3136383,19,2,17506,1588
2020-08-11,United Kingdom,NA,Wales,3136383,27,0,17533,1588
2020-08-12,United Kingdom,NA,Wales,3136383,24,1,17557,1589
2020-08-13,United Kingdom,NA,Wales,3136383,17,1,17574,1590
2020-08-14,United Kingdom,NA,Wales,3136383,17,1,17591,1591
2020-08-15,United Kingdom,NA,Wales,3136383,10,0,17601,1591
2020-08-16,United Kingdom,NA,Wales,3136383,18,0,17619,1591
2020-08-17,United Kingdom,NA,Wales,3136383,19,0,17638,1591
2020-08-18,United Kingdom,NA,Wales,3136383,38,2,17676,1593
2020-08-19,United Kingdom,NA,Wales,3136383,35,0,17711,1593
2020-08-20,United Kingdom,NA,Wales,3136383,31,0,17742,1593
2020-08-21,United Kingdom,NA,Wales,3136383,23,0,17765,1593
2020-08-22,United Kingdom,NA,Wales,3136383,19,1,17784,1594
2020-08-23,United Kingdom,NA,Wales,3136383,11,0,17795,1594
2020-08-24,United Kingdom,NA,Wales,3136383,36,1,17831,1595
2020-08-25,United Kingdom,NA,Wales,3136383,50,0,17881,1595
2020-08-26,United Kingdom,NA,Wales,3136383,44,0,17925,1595
2020-08-27,United Kingdom,NA,Wales,3136383,50,0,17975,1595
2020-08-28,United Kingdom,NA,Wales,3136383,52,0,18027,1595
2020-08-29,United Kingdom,NA,Wales,3136383,44,0,18071,1595
2020-08-30,United Kingdom,NA,Wales,3136383,46,0,18117,1595
2020-08-31,United Kingdom,NA,Wales,3136383,44,2,18161,1597
2020-09-01,United Kingdom,NA,Wales,3136383,57,0,18218,1597
2020-09-02,United Kingdom,NA,Wales,3136383,95,0,18313,1597
2020-09-03,United Kingdom,NA,Wales,3136383,125,0,18438,1597
2020-09-04,United Kingdom,NA,Wales,3136383,149,0,18587,1597
2020-09-05,United Kingdom,NA,Wales,3136383,128,0,18715,1597
2020-09-06,United Kingdom,NA,Wales,3136383,131,0,18846,1597
2020-09-07,United Kingdom,NA,Wales,3136383,159,0,19005,1597
2020-09-08,United Kingdom,NA,Wales,3136383,143,0,19148,1597
2020-09-09,United Kingdom,NA,Wales,3136383,158,0,19306,1597
2020-09-10,United Kingdom,NA,Wales,3136383,186,0,19492,1597
2020-09-11,United Kingdom,NA,Wales,3136383,145,1,19637,1598
2020-09-12,United Kingdom,NA,Wales,3136383,140,0,19777,1598
2020-09-13,United Kingdom,NA,Wales,3136383,165,1,19942,1599
2020-09-14,United Kingdom,NA,Wales,3136383,191,0,20133,1599
2020-09-15,United Kingdom,NA,Wales,3136383,164,1,20297,1600
2020-09-16,United Kingdom,NA,Wales,3136383,207,2,20504,1602
2020-09-17,United Kingdom,NA,Wales,3136383,261,2,20765,1604
2020-09-18,United Kingdom,NA,Wales,3136383,244,0,21009,1604
2020-09-19,United Kingdom,NA,Wales,3136383,277,0,21286,1604
2020-09-20,United Kingdom,NA,Wales,3136383,222,1,21508,1605
2020-09-21,United Kingdom,NA,Wales,3136383,244,1,21752,1606
2020-09-22,United Kingdom,NA,Wales,3136383,143,0,21895,1606
2020-09-23,United Kingdom,NA,Wales,3136383,1,0,21896,1606
2020-03-05,United Kingdom,NA,West Midlands,5907872,6,0,16,0
2020-03-06,United Kingdom,NA,West Midlands,5907872,2,0,18,0
2020-03-07,United Kingdom,NA,West Midlands,5907872,6,0,24,0
2020-03-08,United Kingdom,NA,West Midlands,5907872,4,1,28,1
2020-03-09,United Kingdom,NA,West Midlands,5907872,8,0,36,1
2020-03-10,United Kingdom,NA,West Midlands,5907872,17,1,53,2
2020-03-11,United Kingdom,NA,West Midlands,5907872,29,1,82,3
2020-03-12,United Kingdom,NA,West Midlands,5907872,46,4,128,7
2020-03-13,United Kingdom,NA,West Midlands,5907872,40,3,168,10
2020-03-14,United Kingdom,NA,West Midlands,5907872,31,3,199,13
2020-03-15,United Kingdom,NA,West Midlands,5907872,44,4,243,17
2020-03-16,United Kingdom,NA,West Midlands,5907872,56,9,299,26
2020-03-17,United Kingdom,NA,West Midlands,5907872,69,9,368,35
2020-03-18,United Kingdom,NA,West Midlands,5907872,99,9,467,44
2020-03-19,United Kingdom,NA,West Midlands,5907872,123,11,590,55
2020-03-20,United Kingdom,NA,West Midlands,5907872,151,19,741,74
2020-03-21,United Kingdom,NA,West Midlands,5907872,125,15,866,89
2020-03-22,United Kingdom,NA,West Midlands,5907872,112,20,978,109
2020-03-23,United Kingdom,NA,West Midlands,5907872,239,27,1217,136
2020-03-24,United Kingdom,NA,West Midlands,5907872,250,25,1467,161
2020-03-25,United Kingdom,NA,West Midlands,5907872,240,39,1707,200
2020-03-26,United Kingdom,NA,West Midlands,5907872,313,51,2020,251
2020-03-27,United Kingdom,NA,West Midlands,5907872,279,53,2299,304
2020-03-28,United Kingdom,NA,West Midlands,5907872,323,72,2622,376
2020-03-29,United Kingdom,NA,West Midlands,5907872,366,71,2988,447
2020-03-30,United Kingdom,NA,West Midlands,5907872,431,75,3419,522
2020-03-31,United Kingdom,NA,West Midlands,5907872,411,92,3830,614
2020-04-01,United Kingdom,NA,West Midlands,5907872,410,108,4240,722
2020-04-02,United Kingdom,NA,West Midlands,5907872,447,119,4687,841
2020-04-03,United Kingdom,NA,West Midlands,5907872,372,86,5059,927
2020-04-04,United Kingdom,NA,West Midlands,5907872,346,108,5405,1035
2020-04-05,United Kingdom,NA,West Midlands,5907872,290,117,5695,1139
2020-04-06,United Kingdom,NA,West Midlands,5907872,360,101,6055,1211
2020-04-07,United Kingdom,NA,West Midlands,5907872,387,101,6442,1288
2020-04-08,United Kingdom,NA,West Midlands,5907872,361,135,6803,1360
2020-04-09,United Kingdom,NA,West Midlands,5907872,345,97,7148,1429
2020-04-10,United Kingdom,NA,West Midlands,5907872,362,103,7510,1502
2020-04-11,United Kingdom,NA,West Midlands,5907872,253,110,7763,1552
2020-04-12,United Kingdom,NA,West Midlands,5907872,239,106,8002,1600
2020-04-13,United Kingdom,NA,West Midlands,5907872,281,95,8283,1656
2020-04-14,United Kingdom,NA,West Midlands,5907872,321,82,8604,1720
2020-04-15,United Kingdom,NA,West Midlands,5907872,387,108,8991,1798
2020-04-16,United Kingdom,NA,West Midlands,5907872,511,89,9502,1900
2020-04-17,United Kingdom,NA,West Midlands,5907872,445,99,9947,1989
2020-04-18,United Kingdom,NA,West Midlands,5907872,547,96,10494,2098
2020-04-19,United Kingdom,NA,West Midlands,5907872,340,79,10834,2166
2020-04-20,United Kingdom,NA,West Midlands,5907872,401,76,11235,2247
2020-04-21,United Kingdom,NA,West Midlands,5907872,492,79,11727,2345
2020-04-22,United Kingdom,NA,West Midlands,5907872,578,67,12305,2461
2020-04-23,United Kingdom,NA,West Midlands,5907872,551,83,12856,2571
2020-04-24,United Kingdom,NA,West Midlands,5907872,481,67,13337,2667
2020-04-25,United Kingdom,NA,West Midlands,5907872,386,74,13723,2744
2020-04-26,United Kingdom,NA,West Midlands,5907872,315,79,14038,2807
2020-04-27,United Kingdom,NA,West Midlands,5907872,418,65,14456,2891
2020-04-28,United Kingdom,NA,West Midlands,5907872,376,50,14832,2966
2020-04-29,United Kingdom,NA,West Midlands,5907872,440,58,15272,3054
2020-04-30,United Kingdom,NA,West Midlands,5907872,451,56,15723,3144
2020-05-01,United Kingdom,NA,West Midlands,5907872,469,66,16192,3238
2020-05-02,United Kingdom,NA,West Midlands,5907872,318,46,16510,3302
2020-05-03,United Kingdom,NA,West Midlands,5907872,298,47,16808,3361
2020-05-04,United Kingdom,NA,West Midlands,5907872,235,47,17043,3408
2020-05-05,United Kingdom,NA,West Midlands,5907872,318,48,17361,3472
2020-05-06,United Kingdom,NA,West Midlands,5907872,314,46,17675,3535
2020-05-07,United Kingdom,NA,West Midlands,5907872,369,42,18044,3608
2020-05-08,United Kingdom,NA,West Midlands,5907872,341,36,18385,3677
2020-05-09,United Kingdom,NA,West Midlands,5907872,163,35,18548,3709
2020-05-10,United Kingdom,NA,West Midlands,5907872,217,35,18765,3753
2020-05-11,United Kingdom,NA,West Midlands,5907872,250,25,19015,3780
2020-05-12,United Kingdom,NA,West Midlands,5907872,309,31,19324,3811
2020-05-13,United Kingdom,NA,West Midlands,5907872,244,37,19568,3848
2020-05-14,United Kingdom,NA,West Midlands,5907872,258,31,19826,3879
2020-05-15,United Kingdom,NA,West Midlands,5907872,263,33,20089,3912
2020-05-16,United Kingdom,NA,West Midlands,5907872,175,37,20264,3949
2020-05-17,United Kingdom,NA,West Midlands,5907872,172,30,20436,3979
2020-05-18,United Kingdom,NA,West Midlands,5907872,207,33,20643,4012
2020-05-19,United Kingdom,NA,West Midlands,5907872,278,27,20921,4039
2020-05-20,United Kingdom,NA,West Midlands,5907872,252,26,21173,4065
2020-05-21,United Kingdom,NA,West Midlands,5907872,225,23,21398,4088
2020-05-22,United Kingdom,NA,West Midlands,5907872,195,24,21593,4112
2020-05-23,United Kingdom,NA,West Midlands,5907872,148,20,21741,4132
2020-05-24,United Kingdom,NA,West Midlands,5907872,134,15,21875,4147
2020-05-25,United Kingdom,NA,West Midlands,5907872,138,20,22013,4167
2020-05-26,United Kingdom,NA,West Midlands,5907872,151,25,22164,4192
2020-05-27,United Kingdom,NA,West Midlands,5907872,194,20,22358,4212
2020-05-28,United Kingdom,NA,West Midlands,5907872,154,16,22512,4228
2020-05-29,United Kingdom,NA,West Midlands,5907872,156,16,22668,4244
2020-05-30,United Kingdom,NA,West Midlands,5907872,116,9,22784,4253
2020-05-31,United Kingdom,NA,West Midlands,5907872,77,13,22861,4266
2020-06-01,United Kingdom,NA,West Midlands,5907872,125,6,22986,4272
2020-06-02,United Kingdom,NA,West Midlands,5907872,126,19,23112,4291
2020-06-03,United Kingdom,NA,West Midlands,5907872,125,11,23237,4302
2020-06-04,United Kingdom,NA,West Midlands,5907872,136,8,23373,4310
2020-06-05,United Kingdom,NA,West Midlands,5907872,103,16,23476,4326
2020-06-06,United Kingdom,NA,West Midlands,5907872,77,7,23553,4333
2020-06-07,United Kingdom,NA,West Midlands,5907872,64,10,23617,4343
2020-06-08,United Kingdom,NA,West Midlands,5907872,120,13,23737,4356
2020-06-09,United Kingdom,NA,West Midlands,5907872,101,9,23838,4365
2020-06-10,United Kingdom,NA,West Midlands,5907872,92,7,23930,4372
2020-06-11,United Kingdom,NA,West Midlands,5907872,92,2,24022,4374
2020-06-12,United Kingdom,NA,West Midlands,5907872,76,7,24098,4381
2020-06-13,United Kingdom,NA,West Midlands,5907872,86,4,24184,4385
2020-06-14,United Kingdom,NA,West Midlands,5907872,75,11,24259,4396
2020-06-15,United Kingdom,NA,West Midlands,5907872,102,9,24361,4405
2020-06-16,United Kingdom,NA,West Midlands,5907872,104,9,24465,4414
2020-06-17,United Kingdom,NA,West Midlands,5907872,80,7,24545,4421
2020-06-18,United Kingdom,NA,West Midlands,5907872,83,5,24628,4426
2020-06-19,United Kingdom,NA,West Midlands,5907872,52,6,24680,4432
2020-06-20,United Kingdom,NA,West Midlands,5907872,48,5,24728,4437
2020-06-21,United Kingdom,NA,West Midlands,5907872,37,5,24765,4442
2020-06-22,United Kingdom,NA,West Midlands,5907872,67,8,24832,4450
2020-06-23,United Kingdom,NA,West Midlands,5907872,53,9,24885,4459
2020-06-24,United Kingdom,NA,West Midlands,5907872,55,3,24940,4462
2020-06-25,United Kingdom,NA,West Midlands,5907872,56,10,24996,4472
2020-06-26,United Kingdom,NA,West Midlands,5907872,69,4,25065,4476
2020-06-27,United Kingdom,NA,West Midlands,5907872,44,4,25109,4480
2020-06-28,United Kingdom,NA,West Midlands,5907872,26,4,25135,4484
2020-06-29,United Kingdom,NA,West Midlands,5907872,56,3,25191,4487
2020-06-30,United Kingdom,NA,West Midlands,5907872,51,6,25242,4493
2020-07-01,United Kingdom,NA,West Midlands,5907872,50,1,25292,4494
2020-07-02,United Kingdom,NA,West Midlands,5907872,55,5,25347,4499
2020-07-03,United Kingdom,NA,West Midlands,5907872,41,4,25388,4503
2020-07-04,United Kingdom,NA,West Midlands,5907872,23,4,25411,4507
2020-07-05,United Kingdom,NA,West Midlands,5907872,36,2,25447,4509
2020-07-06,United Kingdom,NA,West Midlands,5907872,52,5,25499,4514
2020-07-07,United Kingdom,NA,West Midlands,5907872,61,4,25560,4518
2020-07-08,United Kingdom,NA,West Midlands,5907872,65,0,25625,4518
2020-07-09,United Kingdom,NA,West Midlands,5907872,123,6,25748,4524
2020-07-10,United Kingdom,NA,West Midlands,5907872,43,1,25791,4525
2020-07-11,United Kingdom,NA,West Midlands,5907872,40,0,25831,4525
2020-07-12,United Kingdom,NA,West Midlands,5907872,38,0,25869,4525
2020-07-13,United Kingdom,NA,West Midlands,5907872,78,0,25947,4525
2020-07-14,United Kingdom,NA,West Midlands,5907872,71,0,26018,4525
2020-07-15,United Kingdom,NA,West Midlands,5907872,107,2,26125,4527
2020-07-16,United Kingdom,NA,West Midlands,5907872,65,0,26190,4527
2020-07-17,United Kingdom,NA,West Midlands,5907872,67,1,26257,4528
2020-07-18,United Kingdom,NA,West Midlands,5907872,51,0,26308,4528
2020-07-19,United Kingdom,NA,West Midlands,5907872,40,0,26348,4528
2020-07-20,United Kingdom,NA,West Midlands,5907872,83,1,26431,4529
2020-07-21,United Kingdom,NA,West Midlands,5907872,80,0,26511,4529
2020-07-22,United Kingdom,NA,West Midlands,5907872,77,3,26588,4532
2020-07-23,United Kingdom,NA,West Midlands,5907872,90,3,26678,4535
2020-07-24,United Kingdom,NA,West Midlands,5907872,78,0,26756,4535
2020-07-25,United Kingdom,NA,West Midlands,5907872,67,3,26823,4538
2020-07-26,United Kingdom,NA,West Midlands,5907872,66,0,26889,4538
2020-07-27,United Kingdom,NA,West Midlands,5907872,77,2,26966,4540
2020-07-28,United Kingdom,NA,West Midlands,5907872,88,0,27054,4540
2020-07-29,United Kingdom,NA,West Midlands,5907872,90,0,27144,4540
2020-07-30,United Kingdom,NA,West Midlands,5907872,80,0,27224,4540
2020-07-31,United Kingdom,NA,West Midlands,5907872,81,1,27305,4541
2020-08-01,United Kingdom,NA,West Midlands,5907872,54,0,27359,4541
2020-08-02,United Kingdom,NA,West Midlands,5907872,42,0,27401,4541
2020-08-03,United Kingdom,NA,West Midlands,5907872,89,0,27490,4541
2020-08-04,United Kingdom,NA,West Midlands,5907872,98,2,27588,4543
2020-08-05,United Kingdom,NA,West Midlands,5907872,93,0,27681,4543
2020-08-06,United Kingdom,NA,West Midlands,5907872,114,0,27795,4543
2020-08-07,United Kingdom,NA,West Midlands,5907872,105,3,27900,4546
2020-08-08,United Kingdom,NA,West Midlands,5907872,74,1,27974,4547
2020-08-09,United Kingdom,NA,West Midlands,5907872,77,0,28051,4547
2020-08-10,United Kingdom,NA,West Midlands,5907872,157,0,28208,4547
2020-08-11,United Kingdom,NA,West Midlands,5907872,165,1,28373,4548
2020-08-12,United Kingdom,NA,West Midlands,5907872,133,0,28506,4548
2020-08-13,United Kingdom,NA,West Midlands,5907872,117,0,28623,4548
2020-08-14,United Kingdom,NA,West Midlands,5907872,171,1,28794,4549
2020-08-15,United Kingdom,NA,West Midlands,5907872,96,1,28890,4550
2020-08-16,United Kingdom,NA,West Midlands,5907872,73,0,28963,4550
2020-08-17,United Kingdom,NA,West Midlands,5907872,138,0,29101,4550
2020-08-18,United Kingdom,NA,West Midlands,5907872,109,1,29210,4551
2020-08-19,United Kingdom,NA,West Midlands,5907872,118,0,29328,4551
2020-08-20,United Kingdom,NA,West Midlands,5907872,162,0,29490,4551
2020-08-21,United Kingdom,NA,West Midlands,5907872,106,0,29596,4551
2020-08-22,United Kingdom,NA,West Midlands,5907872,76,0,29672,4551
2020-08-23,United Kingdom,NA,West Midlands,5907872,82,0,29754,4551
2020-08-24,United Kingdom,NA,West Midlands,5907872,130,0,29884,4551
2020-08-25,United Kingdom,NA,West Midlands,5907872,142,0,30026,4551
2020-08-26,United Kingdom,NA,West Midlands,5907872,125,4,30151,4555
2020-08-27,United Kingdom,NA,West Midlands,5907872,143,1,30294,4556
2020-08-28,United Kingdom,NA,West Midlands,5907872,156,2,30450,4558
2020-08-29,United Kingdom,NA,West Midlands,5907872,113,0,30563,4558
2020-08-30,United Kingdom,NA,West Midlands,5907872,94,3,30657,4561
2020-08-31,United Kingdom,NA,West Midlands,5907872,127,0,30784,4561
2020-09-01,United Kingdom,NA,West Midlands,5907872,256,0,31040,4561
2020-09-02,United Kingdom,NA,West Midlands,5907872,336,0,31376,4561
2020-09-03,United Kingdom,NA,West Midlands,5907872,366,0,31742,4561
2020-09-04,United Kingdom,NA,West Midlands,5907872,422,1,32164,4562
2020-09-05,United Kingdom,NA,West Midlands,5907872,314,0,32478,4562
2020-09-06,United Kingdom,NA,West Midlands,5907872,318,0,32796,4562
2020-09-07,United Kingdom,NA,West Midlands,5907872,486,2,33282,4564
2020-09-08,United Kingdom,NA,West Midlands,5907872,426,3,33708,4567
2020-09-09,United Kingdom,NA,West Midlands,5907872,388,0,34096,4567
2020-09-10,United Kingdom,NA,West Midlands,5907872,385,1,34481,4568
2020-09-11,United Kingdom,NA,West Midlands,5907872,349,1,34830,4569
2020-09-12,United Kingdom,NA,West Midlands,5907872,292,0,35122,4569
2020-09-13,United Kingdom,NA,West Midlands,5907872,214,3,35336,4572
2020-09-14,United Kingdom,NA,West Midlands,5907872,320,3,35656,4575
2020-09-15,United Kingdom,NA,West Midlands,5907872,362,1,36018,4576
2020-09-16,United Kingdom,NA,West Midlands,5907872,448,3,36466,4579
2020-09-17,United Kingdom,NA,West Midlands,5907872,504,2,36970,4581
2020-09-18,United Kingdom,NA,West Midlands,5907872,577,4,37547,4585
2020-09-19,United Kingdom,NA,West Midlands,5907872,579,3,38126,4588
2020-09-20,United Kingdom,NA,West Midlands,5907872,478,7,38604,4595
2020-09-21,United Kingdom,NA,West Midlands,5907872,595,3,39199,4598
2020-09-22,United Kingdom,NA,West Midlands,5907872,380,3,39579,4601
2020-09-23,United Kingdom,NA,West Midlands,5907872,8,2,39587,4603
2020-03-03,United Kingdom,NA,Yorkshire and the Humber,5486230,4,0,13,0
2020-03-04,United Kingdom,NA,Yorkshire and the Humber,5486230,2,0,15,0
2020-03-05,United Kingdom,NA,Yorkshire and the Humber,5486230,2,0,17,0
2020-03-06,United Kingdom,NA,Yorkshire and the Humber,5486230,2,0,19,0
2020-03-07,United Kingdom,NA,Yorkshire and the Humber,5486230,5,0,24,0
2020-03-08,United Kingdom,NA,Yorkshire and the Humber,5486230,3,0,27,0
2020-03-09,United Kingdom,NA,Yorkshire and the Humber,5486230,7,0,34,0
2020-03-10,United Kingdom,NA,Yorkshire and the Humber,5486230,18,0,52,0
2020-03-11,United Kingdom,NA,Yorkshire and the Humber,5486230,10,0,62,0
2020-03-12,United Kingdom,NA,Yorkshire and the Humber,5486230,14,1,76,1
2020-03-13,United Kingdom,NA,Yorkshire and the Humber,5486230,12,0,88,1
2020-03-14,United Kingdom,NA,Yorkshire and the Humber,5486230,12,0,100,1
2020-03-15,United Kingdom,NA,Yorkshire and the Humber,5486230,10,2,110,3
2020-03-16,United Kingdom,NA,Yorkshire and the Humber,5486230,28,2,138,5
2020-03-17,United Kingdom,NA,Yorkshire and the Humber,5486230,31,2,169,7
2020-03-18,United Kingdom,NA,Yorkshire and the Humber,5486230,46,2,215,9
2020-03-19,United Kingdom,NA,Yorkshire and the Humber,5486230,55,1,270,10
2020-03-20,United Kingdom,NA,Yorkshire and the Humber,5486230,59,2,329,12
2020-03-21,United Kingdom,NA,Yorkshire and the Humber,5486230,77,2,406,14
2020-03-22,United Kingdom,NA,Yorkshire and the Humber,5486230,95,2,501,16
2020-03-23,United Kingdom,NA,Yorkshire and the Humber,5486230,145,6,646,22
2020-03-24,United Kingdom,NA,Yorkshire and the Humber,5486230,156,7,802,29
2020-03-25,United Kingdom,NA,Yorkshire and the Humber,5486230,151,9,953,38
2020-03-26,United Kingdom,NA,Yorkshire and the Humber,5486230,179,15,1132,53
2020-03-27,United Kingdom,NA,Yorkshire and the Humber,5486230,154,20,1286,73
2020-03-28,United Kingdom,NA,Yorkshire and the Humber,5486230,207,23,1493,96
2020-03-29,United Kingdom,NA,Yorkshire and the Humber,5486230,229,28,1722,124
2020-03-30,United Kingdom,NA,Yorkshire and the Humber,5486230,285,30,2007,154
2020-03-31,United Kingdom,NA,Yorkshire and the Humber,5486230,320,37,2327,191
2020-04-01,United Kingdom,NA,Yorkshire and the Humber,5486230,297,42,2624,233
2020-04-02,United Kingdom,NA,Yorkshire and the Humber,5486230,243,43,2867,276
2020-04-03,United Kingdom,NA,Yorkshire and the Humber,5486230,293,53,3160,329
2020-04-04,United Kingdom,NA,Yorkshire and the Humber,5486230,203,69,3363,398
2020-04-05,United Kingdom,NA,Yorkshire and the Humber,5486230,219,52,3582,450
2020-04-06,United Kingdom,NA,Yorkshire and the Humber,5486230,321,56,3903,506
2020-04-07,United Kingdom,NA,Yorkshire and the Humber,5486230,337,60,4240,566
2020-04-08,United Kingdom,NA,Yorkshire and the Humber,5486230,318,76,4558,642
2020-04-09,United Kingdom,NA,Yorkshire and the Humber,5486230,304,71,4862,713
2020-04-10,United Kingdom,NA,Yorkshire and the Humber,5486230,299,71,5161,784
2020-04-11,United Kingdom,NA,Yorkshire and the Humber,5486230,261,59,5422,843
2020-04-12,United Kingdom,NA,Yorkshire and the Humber,5486230,269,60,5691,903
2020-04-13,United Kingdom,NA,Yorkshire and the Humber,5486230,326,63,6017,966
2020-04-14,United Kingdom,NA,Yorkshire and the Humber,5486230,315,62,6332,1028
2020-04-15,United Kingdom,NA,Yorkshire and the Humber,5486230,474,80,6806,1108
2020-04-16,United Kingdom,NA,Yorkshire and the Humber,5486230,375,82,7181,1190
2020-04-17,United Kingdom,NA,Yorkshire and the Humber,5486230,351,71,7532,1261
2020-04-18,United Kingdom,NA,Yorkshire and the Humber,5486230,365,62,7897,1323
2020-04-19,United Kingdom,NA,Yorkshire and the Humber,5486230,417,63,8314,1386
2020-04-20,United Kingdom,NA,Yorkshire and the Humber,5486230,401,73,8715,1459
2020-04-21,United Kingdom,NA,Yorkshire and the Humber,5486230,350,65,9065,1524
2020-04-22,United Kingdom,NA,Yorkshire and the Humber,5486230,563,68,9628,1592
2020-04-23,United Kingdom,NA,Yorkshire and the Humber,5486230,449,52,10077,1644
2020-04-24,United Kingdom,NA,Yorkshire and the Humber,5486230,591,71,10668,1715
2020-04-25,United Kingdom,NA,Yorkshire and the Humber,5486230,414,61,11082,1776
2020-04-26,United Kingdom,NA,Yorkshire and the Humber,5486230,421,63,11503,1839
2020-04-27,United Kingdom,NA,Yorkshire and the Humber,5486230,511,67,12014,1906
2020-04-28,United Kingdom,NA,Yorkshire and the Humber,5486230,486,58,12500,1964
2020-04-29,United Kingdom,NA,Yorkshire and the Humber,5486230,712,73,13212,2037
2020-04-30,United Kingdom,NA,Yorkshire and the Humber,5486230,578,58,13790,2095
2020-05-01,United Kingdom,NA,Yorkshire and the Humber,5486230,621,55,14411,2150
2020-05-02,United Kingdom,NA,Yorkshire and the Humber,5486230,385,57,14796,2207
2020-05-03,United Kingdom,NA,Yorkshire and the Humber,5486230,383,46,15179,2253
2020-05-04,United Kingdom,NA,Yorkshire and the Humber,5486230,350,54,15529,2307
2020-05-05,United Kingdom,NA,Yorkshire and the Humber,5486230,440,51,15969,2358
2020-05-06,United Kingdom,NA,Yorkshire and the Humber,5486230,413,51,16382,2409
2020-05-07,United Kingdom,NA,Yorkshire and the Humber,5486230,458,58,16840,2467
2020-05-08,United Kingdom,NA,Yorkshire and the Humber,5486230,352,47,17192,2514
2020-05-09,United Kingdom,NA,Yorkshire and the Humber,5486230,245,37,17437,2551
2020-05-10,United Kingdom,NA,Yorkshire and the Humber,5486230,296,47,17733,2598
2020-05-11,United Kingdom,NA,Yorkshire and the Humber,5486230,426,29,18159,2627
2020-05-12,United Kingdom,NA,Yorkshire and the Humber,5486230,375,28,18534,2655
2020-05-13,United Kingdom,NA,Yorkshire and the Humber,5486230,404,36,18938,2691
2020-05-14,United Kingdom,NA,Yorkshire and the Humber,5486230,355,40,19293,2731
2020-05-15,United Kingdom,NA,Yorkshire and the Humber,5486230,336,43,19629,2774
2020-05-16,United Kingdom,NA,Yorkshire and the Humber,5486230,258,34,19887,2808
2020-05-17,United Kingdom,NA,Yorkshire and the Humber,5486230,244,23,20131,2831
2020-05-18,United Kingdom,NA,Yorkshire and the Humber,5486230,261,33,20392,2864
2020-05-19,United Kingdom,NA,Yorkshire and the Humber,5486230,386,27,20778,2891
2020-05-20,United Kingdom,NA,Yorkshire and the Humber,5486230,296,29,21074,2920
2020-05-21,United Kingdom,NA,Yorkshire and the Humber,5486230,383,26,21457,2946
2020-05-22,United Kingdom,NA,Yorkshire and the Humber,5486230,268,27,21725,2973
2020-05-23,United Kingdom,NA,Yorkshire and the Humber,5486230,235,23,21960,2996
2020-05-24,United Kingdom,NA,Yorkshire and the Humber,5486230,204,24,22164,3020
2020-05-25,United Kingdom,NA,Yorkshire and the Humber,5486230,253,31,22417,3051
2020-05-26,United Kingdom,NA,Yorkshire and the Humber,5486230,232,22,22649,3073
2020-05-27,United Kingdom,NA,Yorkshire and the Humber,5486230,254,25,22903,3098
2020-05-28,United Kingdom,NA,Yorkshire and the Humber,5486230,274,26,23177,3124
2020-05-29,United Kingdom,NA,Yorkshire and the Humber,5486230,200,20,23377,3144
2020-05-30,United Kingdom,NA,Yorkshire and the Humber,5486230,163,27,23540,3171
2020-05-31,United Kingdom,NA,Yorkshire and the Humber,5486230,176,21,23716,3192
2020-06-01,United Kingdom,NA,Yorkshire and the Humber,5486230,191,25,23907,3217
2020-06-02,United Kingdom,NA,Yorkshire and the Humber,5486230,197,23,24104,3240
2020-06-03,United Kingdom,NA,Yorkshire and the Humber,5486230,206,20,24310,3260
2020-06-04,United Kingdom,NA,Yorkshire and the Humber,5486230,178,14,24488,3274
2020-06-05,United Kingdom,NA,Yorkshire and the Humber,5486230,155,12,24643,3286
2020-06-06,United Kingdom,NA,Yorkshire and the Humber,5486230,121,18,24764,3304
2020-06-07,United Kingdom,NA,Yorkshire and the Humber,5486230,149,12,24913,3316
2020-06-08,United Kingdom,NA,Yorkshire and the Humber,5486230,188,12,25101,3328
2020-06-09,United Kingdom,NA,Yorkshire and the Humber,5486230,171,14,25272,3342
2020-06-10,United Kingdom,NA,Yorkshire and the Humber,5486230,226,18,25498,3360
2020-06-11,United Kingdom,NA,Yorkshire and the Humber,5486230,197,10,25695,3370
2020-06-12,United Kingdom,NA,Yorkshire and the Humber,5486230,247,10,25942,3380
2020-06-13,United Kingdom,NA,Yorkshire and the Humber,5486230,193,9,26135,3389
2020-06-14,United Kingdom,NA,Yorkshire and the Humber,5486230,159,11,26294,3400
2020-06-15,United Kingdom,NA,Yorkshire and the Humber,5486230,189,10,26483,3410
2020-06-16,United Kingdom,NA,Yorkshire and the Humber,5486230,216,5,26699,3415
2020-06-17,United Kingdom,NA,Yorkshire and the Humber,5486230,230,5,26929,3420
2020-06-18,United Kingdom,NA,Yorkshire and the Humber,5486230,257,10,27186,3430
2020-06-19,United Kingdom,NA,Yorkshire and the Humber,5486230,202,4,27388,3434
2020-06-20,United Kingdom,NA,Yorkshire and the Humber,5486230,162,6,27550,3440
2020-06-21,United Kingdom,NA,Yorkshire and the Humber,5486230,116,6,27666,3446
2020-06-22,United Kingdom,NA,Yorkshire and the Humber,5486230,156,8,27822,3454
2020-06-23,United Kingdom,NA,Yorkshire and the Humber,5486230,172,7,27994,3461
2020-06-24,United Kingdom,NA,Yorkshire and the Humber,5486230,157,13,28151,3474
2020-06-25,United Kingdom,NA,Yorkshire and the Humber,5486230,143,4,28294,3478
2020-06-26,United Kingdom,NA,Yorkshire and the Humber,5486230,152,7,28446,3485
2020-06-27,United Kingdom,NA,Yorkshire and the Humber,5486230,149,4,28595,3489
2020-06-28,United Kingdom,NA,Yorkshire and the Humber,5486230,97,5,28692,3494
2020-06-29,United Kingdom,NA,Yorkshire and the Humber,5486230,133,3,28825,3497
2020-06-30,United Kingdom,NA,Yorkshire and the Humber,5486230,112,9,28937,3506
2020-07-01,United Kingdom,NA,Yorkshire and the Humber,5486230,132,3,29069,3509
2020-07-02,United Kingdom,NA,Yorkshire and the Humber,5486230,104,8,29173,3517
2020-07-03,United Kingdom,NA,Yorkshire and the Humber,5486230,108,7,29281,3524
2020-07-04,United Kingdom,NA,Yorkshire and the Humber,5486230,77,2,29358,3526
2020-07-05,United Kingdom,NA,Yorkshire and the Humber,5486230,90,2,29448,3528
2020-07-06,United Kingdom,NA,Yorkshire and the Humber,5486230,120,3,29568,3531
2020-07-07,United Kingdom,NA,Yorkshire and the Humber,5486230,103,4,29671,3535
2020-07-08,United Kingdom,NA,Yorkshire and the Humber,5486230,126,5,29797,3540
2020-07-09,United Kingdom,NA,Yorkshire and the Humber,5486230,98,0,29895,3540
2020-07-10,United Kingdom,NA,Yorkshire and the Humber,5486230,92,3,29987,3543
2020-07-11,United Kingdom,NA,Yorkshire and the Humber,5486230,87,1,30074,3544
2020-07-12,United Kingdom,NA,Yorkshire and the Humber,5486230,98,3,30172,3547
2020-07-13,United Kingdom,NA,Yorkshire and the Humber,5486230,135,1,30307,3548
2020-07-14,United Kingdom,NA,Yorkshire and the Humber,5486230,133,3,30440,3551
2020-07-15,United Kingdom,NA,Yorkshire and the Humber,5486230,119,2,30559,3553
2020-07-16,United Kingdom,NA,Yorkshire and the Humber,5486230,86,1,30645,3554
2020-07-17,United Kingdom,NA,Yorkshire and the Humber,5486230,100,2,30745,3556
2020-07-18,United Kingdom,NA,Yorkshire and the Humber,5486230,98,4,30843,3560
2020-07-19,United Kingdom,NA,Yorkshire and the Humber,5486230,101,1,30944,3561
2020-07-20,United Kingdom,NA,Yorkshire and the Humber,5486230,115,0,31059,3561
2020-07-21,United Kingdom,NA,Yorkshire and the Humber,5486230,98,3,31157,3564
2020-07-22,United Kingdom,NA,Yorkshire and the Humber,5486230,103,3,31260,3567
2020-07-23,United Kingdom,NA,Yorkshire and the Humber,5486230,106,3,31366,3570
2020-07-24,United Kingdom,NA,Yorkshire and the Humber,5486230,108,3,31474,3573
2020-07-25,United Kingdom,NA,Yorkshire and the Humber,5486230,88,2,31562,3575
2020-07-26,United Kingdom,NA,Yorkshire and the Humber,5486230,91,2,31653,3577
2020-07-27,United Kingdom,NA,Yorkshire and the Humber,5486230,143,1,31796,3578
2020-07-28,United Kingdom,NA,Yorkshire and the Humber,5486230,149,2,31945,3580
2020-07-29,United Kingdom,NA,Yorkshire and the Humber,5486230,163,0,32108,3580
2020-07-30,United Kingdom,NA,Yorkshire and the Humber,5486230,141,0,32249,3580
2020-07-31,United Kingdom,NA,Yorkshire and the Humber,5486230,98,0,32347,3580
2020-08-01,United Kingdom,NA,Yorkshire and the Humber,5486230,81,3,32428,3583
2020-08-02,United Kingdom,NA,Yorkshire and the Humber,5486230,85,1,32513,3584
2020-08-03,United Kingdom,NA,Yorkshire and the Humber,5486230,144,2,32657,3586
2020-08-04,United Kingdom,NA,Yorkshire and the Humber,5486230,146,2,32803,3588
2020-08-05,United Kingdom,NA,Yorkshire and the Humber,5486230,156,0,32959,3588
2020-08-06,United Kingdom,NA,Yorkshire and the Humber,5486230,176,3,33135,3591
2020-08-07,United Kingdom,NA,Yorkshire and the Humber,5486230,120,0,33255,3591
2020-08-08,United Kingdom,NA,Yorkshire and the Humber,5486230,104,1,33359,3592
2020-08-09,United Kingdom,NA,Yorkshire and the Humber,5486230,97,1,33456,3593
2020-08-10,United Kingdom,NA,Yorkshire and the Humber,5486230,222,2,33678,3595
2020-08-11,United Kingdom,NA,Yorkshire and the Humber,5486230,185,0,33863,3595
2020-08-12,United Kingdom,NA,Yorkshire and the Humber,5486230,171,1,34034,3596
2020-08-13,United Kingdom,NA,Yorkshire and the Humber,5486230,179,1,34213,3597
2020-08-14,United Kingdom,NA,Yorkshire and the Humber,5486230,161,0,34374,3597
2020-08-15,United Kingdom,NA,Yorkshire and the Humber,5486230,108,1,34482,3598
2020-08-16,United Kingdom,NA,Yorkshire and the Humber,5486230,79,1,34561,3599
2020-08-17,United Kingdom,NA,Yorkshire and the Humber,5486230,126,3,34687,3602
2020-08-18,United Kingdom,NA,Yorkshire and the Humber,5486230,122,0,34809,3602
2020-08-19,United Kingdom,NA,Yorkshire and the Humber,5486230,140,0,34949,3602
2020-08-20,United Kingdom,NA,Yorkshire and the Humber,5486230,165,1,35114,3603
2020-08-21,United Kingdom,NA,Yorkshire and the Humber,5486230,129,2,35243,3605
2020-08-22,United Kingdom,NA,Yorkshire and the Humber,5486230,89,1,35332,3606
2020-08-23,United Kingdom,NA,Yorkshire and the Humber,5486230,92,2,35424,3608
2020-08-24,United Kingdom,NA,Yorkshire and the Humber,5486230,131,0,35555,3608
2020-08-25,United Kingdom,NA,Yorkshire and the Humber,5486230,135,1,35690,3609
2020-08-26,United Kingdom,NA,Yorkshire and the Humber,5486230,119,1,35809,3610
2020-08-27,United Kingdom,NA,Yorkshire and the Humber,5486230,198,1,36007,3611
2020-08-28,United Kingdom,NA,Yorkshire and the Humber,5486230,159,1,36166,3612
2020-08-29,United Kingdom,NA,Yorkshire and the Humber,5486230,168,2,36334,3614
2020-08-30,United Kingdom,NA,Yorkshire and the Humber,5486230,139,1,36473,3615
2020-08-31,United Kingdom,NA,Yorkshire and the Humber,5486230,192,0,36665,3615
2020-09-01,United Kingdom,NA,Yorkshire and the Humber,5486230,264,0,36929,3615
2020-09-02,United Kingdom,NA,Yorkshire and the Humber,5486230,369,3,37298,3618
2020-09-03,United Kingdom,NA,Yorkshire and the Humber,5486230,332,1,37630,3619
2020-09-04,United Kingdom,NA,Yorkshire and the Humber,5486230,307,1,37937,3620
2020-09-05,United Kingdom,NA,Yorkshire and the Humber,5486230,307,2,38244,3622
2020-09-06,United Kingdom,NA,Yorkshire and the Humber,5486230,297,0,38541,3622
2020-09-07,United Kingdom,NA,Yorkshire and the Humber,5486230,523,1,39064,3623
2020-09-08,United Kingdom,NA,Yorkshire and the Humber,5486230,374,0,39438,3623
2020-09-09,United Kingdom,NA,Yorkshire and the Humber,5486230,392,3,39830,3626
2020-09-10,United Kingdom,NA,Yorkshire and the Humber,5486230,455,2,40285,3628
2020-09-11,United Kingdom,NA,Yorkshire and the Humber,5486230,386,2,40671,3630
2020-09-12,United Kingdom,NA,Yorkshire and the Humber,5486230,312,3,40983,3633
2020-09-13,United Kingdom,NA,Yorkshire and the Humber,5486230,291,3,41274,3636
2020-09-14,United Kingdom,NA,Yorkshire and the Humber,5486230,382,2,41656,3638
2020-09-15,United Kingdom,NA,Yorkshire and the Humber,5486230,415,2,42071,3640
2020-09-16,United Kingdom,NA,Yorkshire and the Humber,5486230,549,1,42620,3641
2020-09-17,United Kingdom,NA,Yorkshire and the Humber,5486230,568,3,43188,3644
2020-09-18,United Kingdom,NA,Yorkshire and the Humber,5486230,542,1,43730,3645
2020-09-19,United Kingdom,NA,Yorkshire and the Humber,5486230,535,2,44265,3647
2020-09-20,United Kingdom,NA,Yorkshire and the Humber,5486230,436,5,44701,3652
2020-09-21,United Kingdom,NA,Yorkshire and the Humber,5486230,534,1,45235,3653
2020-09-22,United Kingdom,NA,Yorkshire and the Humber,5486230,387,4,45622,3657
2020-09-23,United Kingdom,NA,Yorkshire and the Humber,5486230,16,1,45638,3658
